"diff_id","del","ins","mod","total","dummy"
"3",0,4,0,4,"dummy"
"7",0,2,3,5,"dummy"
"13",0,0,0,0,"dummy"
"14",2,6,1,9,"dummy"
"15",0,0,0,0,"dummy"
"18",0,3,0,3,"dummy"
"19",3,1,0,4,"dummy"
"20",1,6,0,7,"dummy"
"21",3,1,0,4,"dummy"
"23",0,0,1,1,"dummy"
"24",0,1,0,1,"dummy"
"27",1,2,3,6,"dummy"
"28",0,2,2,4,"dummy"
"29",0,2,0,2,"dummy"
"30",0,9,0,9,"dummy"
"31",0,0,1,1,"dummy"
"32",3,7,5,15,"dummy"
"33",7,5,0,12,"dummy"
"36",6,0,2,8,"dummy"
"37",0,7,0,7,"dummy"
"39",9,0,1,10,"dummy"
"40",0,0,0,0,"dummy"
"41",0,0,0,0,"dummy"
"42",0,0,0,0,"dummy"
"43",0,0,0,0,"dummy"
"45",1,16,0,17,"dummy"
"46",7,3,0,10,"dummy"
"47",0,4,0,4,"dummy"
"48",0,0,1,1,"dummy"
"49",0,0,1,1,"dummy"
"50",0,2,0,2,"dummy"
"52",17,0,0,17,"dummy"
"53",1,2,2,5,"dummy"
"54",1,2,0,3,"dummy"
"55",4,2,1,7,"dummy"
"56",1,1,0,2,"dummy"
"65",0,0,1,1,"dummy"
"66",4,1,0,5,"dummy"
"67",0,4,0,4,"dummy"
"70",2,7,0,9,"dummy"
"73",0,0,1,1,"dummy"
"75",0,0,1,1,"dummy"
"78",2,6,1,9,"dummy"
"79",1,0,0,1,"dummy"
"80",6,4,1,11,"dummy"
"85",2,2,0,4,"dummy"
"86",0,0,0,0,"dummy"
"87",5,0,2,7,"dummy"
"88",0,5,2,7,"dummy"
"91",0,4,4,8,"dummy"
"92",10,1,3,14,"dummy"
"93",0,0,2,2,"dummy"
"94",1,3,0,4,"dummy"
"95",2,0,0,2,"dummy"
"96",0,1,2,3,"dummy"
"97",0,1,4,5,"dummy"
"98",0,4,0,4,"dummy"
"99",0,1,0,1,"dummy"
"100",0,0,2,2,"dummy"
"101",4,0,0,4,"dummy"
"102",0,0,2,2,"dummy"
"103",0,0,2,2,"dummy"
"104",2,8,5,15,"dummy"
"105",0,0,1,1,"dummy"
"106",0,0,1,1,"dummy"
"107",0,0,1,1,"dummy"
"108",0,0,0,0,"dummy"
"109",0,1,0,1,"dummy"
"115",1,6,0,7,"dummy"
"116",0,1,1,2,"dummy"
"117",0,2,0,2,"dummy"
"118",3,5,0,8,"dummy"
"119",4,0,3,7,"dummy"
"120",1,3,1,5,"dummy"
"121",2,1,2,5,"dummy"
"122",3,0,0,3,"dummy"
"123",0,0,1,1,"dummy"
"124",2,6,1,9,"dummy"
"125",2,2,1,5,"dummy"
"127",0,0,0,0,"dummy"
"131",0,3,0,3,"dummy"
"132",0,15,0,15,"dummy"
"133",9,0,0,9,"dummy"
"134",10,0,0,10,"dummy"
"135",0,1,0,1,"dummy"
"136",0,3,0,3,"dummy"
"139",2,0,1,3,"dummy"
"140",0,0,0,0,"dummy"
"141",0,1,0,1,"dummy"
"142",8,1,0,9,"dummy"
"143",0,0,0,0,"dummy"
"144",0,0,0,0,"dummy"
"145",1,10,0,11,"dummy"
"146",7,1,0,8,"dummy"
"147",2,0,3,5,"dummy"
"151",0,4,0,4,"dummy"
"152",6,0,2,8,"dummy"
"153",1,0,0,1,"dummy"
"156",2,4,0,6,"dummy"
"157",0,2,0,2,"dummy"
"158",0,2,0,2,"dummy"
"159",10,2,0,12,"dummy"
"160",0,2,0,2,"dummy"
"161",0,0,0,0,"dummy"
"163",4,2,0,6,"dummy"
"165",0,1,0,1,"dummy"
"171",0,0,1,1,"dummy"
"172",0,4,2,6,"dummy"
"173",0,4,1,5,"dummy"
"174",11,0,3,14,"dummy"
"175",1,3,1,5,"dummy"
"176",0,0,2,2,"dummy"
"177",1,1,0,2,"dummy"
"179",0,27,2,29,"dummy"
"180",17,0,3,20,"dummy"
"181",1,1,1,3,"dummy"
"182",1,8,2,11,"dummy"
"183",2,14,1,17,"dummy"
"185",26,2,2,30,"dummy"
"186",0,0,1,1,"dummy"
"187",0,0,1,1,"dummy"
"188",0,1,0,1,"dummy"
"189",0,0,1,1,"dummy"
"191",0,1,0,1,"dummy"
"192",2,2,1,5,"dummy"
"193",2,0,1,3,"dummy"
"194",0,0,1,1,"dummy"
"195",0,0,1,1,"dummy"
"196",0,0,2,2,"dummy"
"197",0,0,2,2,"dummy"
"199",0,0,1,1,"dummy"
"200",1,2,0,3,"dummy"
"201",5,5,0,10,"dummy"
"202",0,1,0,1,"dummy"
"204",4,8,2,14,"dummy"
"205",13,17,2,32,"dummy"
"206",1,1,0,2,"dummy"
"207",0,1,0,1,"dummy"
"208",1,1,0,2,"dummy"
"209",1,2,3,6,"dummy"
"210",1,2,0,3,"dummy"
"211",14,1,0,15,"dummy"
"212",2,5,0,7,"dummy"
"214",0,0,1,1,"dummy"
"218",2,15,1,18,"dummy"
"219",4,4,1,9,"dummy"
"220",0,1,0,1,"dummy"
"221",0,0,2,2,"dummy"
"222",2,0,2,4,"dummy"
"224",0,7,2,9,"dummy"
"226",0,0,1,1,"dummy"
"231",0,10,0,10,"dummy"
"232",9,2,2,13,"dummy"
"233",0,1,0,1,"dummy"
"234",0,1,0,1,"dummy"
"236",5,6,2,13,"dummy"
"237",1,1,0,2,"dummy"
"241",0,2,0,2,"dummy"
"242",0,5,0,5,"dummy"
"244",56,15,4,75,"dummy"
"246",3,3,1,7,"dummy"
"248",0,1,1,2,"dummy"
"249",6,6,1,13,"dummy"
"250",0,1,0,1,"dummy"
"251",0,0,0,0,"dummy"
"252",0,0,0,0,"dummy"
"253",1,0,0,1,"dummy"
"259",0,3,1,4,"dummy"
"260",0,1,0,1,"dummy"
"261",0,2,0,2,"dummy"
"262",0,2,1,3,"dummy"
"263",3,11,1,15,"dummy"
"264",0,1,0,1,"dummy"
"265",0,1,0,1,"dummy"
"273",1,0,0,1,"dummy"
"275",2,3,2,7,"dummy"
"276",6,5,2,13,"dummy"
"278",4,0,3,7,"dummy"
"280",1,0,0,1,"dummy"
"281",0,1,0,1,"dummy"
"283",0,0,1,1,"dummy"
"284",0,0,1,1,"dummy"
"293",1,6,1,8,"dummy"
"294",0,4,0,4,"dummy"
"295",0,3,0,3,"dummy"
"296",2,12,2,16,"dummy"
"297",0,1,0,1,"dummy"
"298",0,1,0,1,"dummy"
"299",13,0,1,14,"dummy"
"300",10,2,1,13,"dummy"
"301",7,9,4,20,"dummy"
"302",0,2,0,2,"dummy"
"303",2,1,3,6,"dummy"
"304",0,0,3,3,"dummy"
"305",1,2,0,3,"dummy"
"306",2,11,0,13,"dummy"
"307",6,1,3,10,"dummy"
"308",0,2,0,2,"dummy"
"309",5,6,3,14,"dummy"
"310",16,1,4,21,"dummy"
"311",0,0,0,0,"dummy"
"313",0,2,2,4,"dummy"
"314",0,0,0,0,"dummy"
"315",0,0,2,2,"dummy"
"316",0,0,2,2,"dummy"
"317",0,0,2,2,"dummy"
"326",0,0,4,4,"dummy"
"327",0,0,2,2,"dummy"
"329",0,0,0,0,"dummy"
"330",4,0,0,4,"dummy"
"334",0,1,0,1,"dummy"
"339",1,2,0,3,"dummy"
"341",0,0,0,0,"dummy"
"342",0,0,0,0,"dummy"
"351",0,0,1,1,"dummy"
"352",0,0,1,1,"dummy"
"353",0,0,1,1,"dummy"
"356",0,0,1,1,"dummy"
"357",0,1,1,2,"dummy"
"358",0,0,0,0,"dummy"
"359",0,0,1,1,"dummy"
"360",0,0,1,1,"dummy"
"361",0,0,1,1,"dummy"
"363",14,26,3,43,"dummy"
"364",0,4,0,4,"dummy"
"367",0,0,1,1,"dummy"
"368",0,6,2,8,"dummy"
"369",2,4,0,6,"dummy"
"370",4,2,0,6,"dummy"
"382",0,0,1,1,"dummy"
"383",0,0,1,1,"dummy"
"384",6,16,2,24,"dummy"
"385",0,0,2,2,"dummy"
"386",0,0,1,1,"dummy"
"387",0,0,1,1,"dummy"
"388",4,5,0,9,"dummy"
"389",5,4,1,10,"dummy"
"390",4,5,0,9,"dummy"
"391",0,0,1,1,"dummy"
"392",0,0,1,1,"dummy"
"393",0,0,2,2,"dummy"
"394",0,0,1,1,"dummy"
"395",6,2,4,12,"dummy"
"396",0,0,1,1,"dummy"
"427",2,2,0,4,"dummy"
"432",0,2,0,2,"dummy"
"434",0,0,0,0,"dummy"
"435",1,1,0,2,"dummy"
"436",15,0,0,15,"dummy"
"463",0,1,0,1,"dummy"
"464",0,1,0,1,"dummy"
"465",0,0,1,1,"dummy"
"466",0,1,0,1,"dummy"
"467",1,0,0,1,"dummy"
"468",0,1,0,1,"dummy"
"470",8,8,0,16,"dummy"
"471",3,3,0,6,"dummy"
"472",1,1,1,3,"dummy"
"473",0,0,1,1,"dummy"
"474",2,3,1,6,"dummy"
"475",0,0,2,2,"dummy"
"476",1,0,0,1,"dummy"
"477",0,1,0,1,"dummy"
"478",0,1,0,1,"dummy"
"479",0,0,2,2,"dummy"
"485",0,31,2,33,"dummy"
"489",1,0,0,1,"dummy"
"490",1,4,0,5,"dummy"
"491",4,2,0,6,"dummy"
"492",0,0,1,1,"dummy"
"496",4,1,3,8,"dummy"
"497",0,3,2,5,"dummy"
"498",1,1,2,4,"dummy"
"500",1,1,0,2,"dummy"
"505",0,1,0,1,"dummy"
"509",2,20,2,24,"dummy"
"510",0,1,0,1,"dummy"
"511",9,3,2,14,"dummy"
"512",8,9,2,19,"dummy"
"513",6,1,0,7,"dummy"
"514",0,0,1,1,"dummy"
"515",1,3,1,5,"dummy"
"516",3,7,0,10,"dummy"
"517",0,0,2,2,"dummy"
"518",0,0,2,2,"dummy"
"519",0,2,0,2,"dummy"
"520",1,0,1,2,"dummy"
"524",1,1,3,5,"dummy"
"525",0,0,1,1,"dummy"
"526",0,4,0,4,"dummy"
"527",0,0,1,1,"dummy"
"528",3,1,1,5,"dummy"
"529",0,0,1,1,"dummy"
"530",0,0,1,1,"dummy"
"531",0,1,0,1,"dummy"
"532",0,1,0,1,"dummy"
"533",1,1,0,2,"dummy"
"534",4,4,1,9,"dummy"
"535",5,1,0,6,"dummy"
"536",0,0,1,1,"dummy"
"537",1,2,0,3,"dummy"
"538",0,0,1,1,"dummy"
"539",1,0,0,1,"dummy"
"540",0,0,1,1,"dummy"
"541",0,0,1,1,"dummy"
"542",1,1,1,3,"dummy"
"543",0,0,1,1,"dummy"
"544",0,0,1,1,"dummy"
"545",0,0,1,1,"dummy"
"546",0,2,1,3,"dummy"
"547",0,1,0,1,"dummy"
"548",1,1,0,2,"dummy"
"549",4,1,0,5,"dummy"
"550",0,0,1,1,"dummy"
"551",1,1,1,3,"dummy"
"552",0,0,1,1,"dummy"
"553",0,1,1,2,"dummy"
"554",0,0,1,1,"dummy"
"555",1,1,1,3,"dummy"
"556",0,0,1,1,"dummy"
"557",0,0,2,2,"dummy"
"558",0,0,1,1,"dummy"
"559",0,0,1,1,"dummy"
"560",0,0,1,1,"dummy"
"561",7,2,2,11,"dummy"
"562",0,0,1,1,"dummy"
"563",0,0,3,3,"dummy"
"564",0,0,2,2,"dummy"
"565",0,0,1,1,"dummy"
"566",2,1,0,3,"dummy"
"567",0,0,1,1,"dummy"
"568",0,0,1,1,"dummy"
"569",0,0,1,1,"dummy"
"570",0,0,1,1,"dummy"
"571",0,1,1,2,"dummy"
"572",0,0,1,1,"dummy"
"573",0,0,1,1,"dummy"
"576",0,0,1,1,"dummy"
"577",0,0,1,1,"dummy"
"628",4,9,4,17,"dummy"
"629",0,0,3,3,"dummy"
"522",0,1,0,1,"dummy"
"635",0,1,1,2,"dummy"
"636",0,1,0,1,"dummy"
"638",0,1,0,1,"dummy"
"639",0,2,0,2,"dummy"
"640",0,0,1,1,"dummy"
"641",0,1,0,1,"dummy"
"642",0,0,0,0,"dummy"
"643",1,0,0,1,"dummy"
"664",0,1,0,1,"dummy"
"671",0,0,1,1,"dummy"
"672",0,1,1,2,"dummy"
"673",3,10,0,13,"dummy"
"674",2,1,0,3,"dummy"
"675",0,4,3,7,"dummy"
"676",0,0,1,1,"dummy"
"677",0,12,3,15,"dummy"
"678",4,1,1,6,"dummy"
"679",5,1,2,8,"dummy"
"682",0,0,3,3,"dummy"
"685",0,0,0,0,"dummy"
"686",0,0,1,1,"dummy"
"687",0,4,0,4,"dummy"
"688",0,2,0,2,"dummy"
"689",0,0,1,1,"dummy"
"690",0,1,3,4,"dummy"
"692",0,1,0,1,"dummy"
"695",0,2,0,2,"dummy"
"696",0,1,0,1,"dummy"
"697",5,24,0,29,"dummy"
"698",0,1,0,1,"dummy"
"699",0,1,1,2,"dummy"
"701",0,0,0,0,"dummy"
"704",0,0,0,0,"dummy"
"706",0,0,1,1,"dummy"
"707",0,0,1,1,"dummy"
"708",0,0,2,2,"dummy"
"715",3,0,0,3,"dummy"
"716",0,1,0,1,"dummy"
"717",0,2,0,2,"dummy"
"718",0,0,2,2,"dummy"
"719",0,0,1,1,"dummy"
"721",2,7,2,11,"dummy"
"722",0,1,0,1,"dummy"
"723",1,0,0,1,"dummy"
"724",0,1,3,4,"dummy"
"725",0,1,0,1,"dummy"
"726",1,0,0,1,"dummy"
"730",0,1,0,1,"dummy"
"732",0,0,1,1,"dummy"
"734",0,0,1,1,"dummy"
"736",0,0,1,1,"dummy"
"737",29,2,1,32,"dummy"
"738",1,0,0,1,"dummy"
"740",2,0,0,2,"dummy"
"741",0,2,0,2,"dummy"
"742",1,0,0,1,"dummy"
"743",0,1,0,1,"dummy"
"744",1,3,0,4,"dummy"
"745",0,0,0,0,"dummy"
"746",0,0,0,0,"dummy"
"752",1,8,0,9,"dummy"
"754",0,1,1,2,"dummy"
"767",0,16,0,16,"dummy"
"768",2,1,0,3,"dummy"
"795",0,24,0,24,"dummy"
"796",0,1,0,1,"dummy"
"797",0,0,1,1,"dummy"
"798",0,0,1,1,"dummy"
"799",0,0,0,0,"dummy"
"800",0,0,0,0,"dummy"
"801",0,0,1,1,"dummy"
"813",0,0,1,1,"dummy"
"827",0,2,0,2,"dummy"
"848",0,5,0,5,"dummy"
"849",0,1,0,1,"dummy"
"850",0,2,0,2,"dummy"
"851",0,2,0,2,"dummy"
"852",0,0,1,1,"dummy"
"853",4,0,0,4,"dummy"
"854",0,0,1,1,"dummy"
"770",0,0,1,1,"dummy"
"771",0,0,1,1,"dummy"
"772",0,0,2,2,"dummy"
"773",26,3,7,36,"dummy"
"778",1,0,0,1,"dummy"
"779",0,1,2,3,"dummy"
"780",1,3,0,4,"dummy"
"781",0,0,1,1,"dummy"
"782",1,0,0,1,"dummy"
"783",0,1,0,1,"dummy"
"786",2,1,1,4,"dummy"
"787",0,3,0,3,"dummy"
"788",3,5,0,8,"dummy"
"789",0,4,0,4,"dummy"
"790",0,2,0,2,"dummy"
"791",0,1,1,2,"dummy"
"792",14,0,0,14,"dummy"
"793",0,1,0,1,"dummy"
"803",0,2,1,3,"dummy"
"804",0,2,0,2,"dummy"
"805",1,0,0,1,"dummy"
"806",2,0,2,4,"dummy"
"807",1,1,0,2,"dummy"
"808",2,0,0,2,"dummy"
"809",1,1,0,2,"dummy"
"810",1,0,0,1,"dummy"
"811",0,1,0,1,"dummy"
"815",1,5,1,7,"dummy"
"816",0,0,1,1,"dummy"
"825",2,0,0,2,"dummy"
"846",0,0,3,3,"dummy"
"856",0,0,2,2,"dummy"
"857",0,0,6,6,"dummy"
"858",0,1,0,1,"dummy"
"859",0,1,2,3,"dummy"
"864",1,2,0,3,"dummy"
"865",0,0,0,0,"dummy"
"866",0,1,0,1,"dummy"
"867",1,1,0,2,"dummy"
"868",52,57,7,116,"dummy"
"869",1,16,0,17,"dummy"
"870",5,1,3,9,"dummy"
"871",1,1,1,3,"dummy"
"872",6,5,1,12,"dummy"
"883",0,4,0,4,"dummy"
"885",13,1,1,15,"dummy"
"891",0,0,1,1,"dummy"
"892",0,0,1,1,"dummy"
"893",0,0,0,0,"dummy"
"894",1,0,0,1,"dummy"
"895",1,0,0,1,"dummy"
"896",0,0,0,0,"dummy"
"901",26,0,1,27,"dummy"
"904",2,2,0,4,"dummy"
"905",0,1,0,1,"dummy"
"906",1,0,0,1,"dummy"
"907",2,0,0,2,"dummy"
"908",0,0,1,1,"dummy"
"909",0,1,0,1,"dummy"
"910",0,0,1,1,"dummy"
"911",0,2,0,2,"dummy"
"912",0,0,1,1,"dummy"
"913",0,1,0,1,"dummy"
"914",0,0,0,0,"dummy"
"915",0,0,1,1,"dummy"
"916",0,0,0,0,"dummy"
"917",0,0,1,1,"dummy"
"920",0,0,1,1,"dummy"
"921",1,2,0,3,"dummy"
"933",0,1,0,1,"dummy"
"934",0,0,1,1,"dummy"
"939",0,2,0,2,"dummy"
"940",0,2,0,2,"dummy"
"941",4,1,0,5,"dummy"
"942",1,0,0,1,"dummy"
"943",0,0,0,0,"dummy"
"944",0,0,0,0,"dummy"
"945",0,0,0,0,"dummy"
"957",1,0,1,2,"dummy"
"960",0,1,0,1,"dummy"
"961",4,3,0,7,"dummy"
"962",1,8,0,9,"dummy"
"963",0,1,0,1,"dummy"
"964",4,12,0,16,"dummy"
"965",21,2,4,27,"dummy"
"1172",7,2,0,9,"dummy"
"1176",1,0,0,1,"dummy"
"1177",0,1,0,1,"dummy"
"1178",1,1,0,2,"dummy"
"1179",9,8,2,19,"dummy"
"1180",0,2,0,2,"dummy"
"1204",0,16,1,17,"dummy"
"1205",1,1,1,3,"dummy"
"1206",15,5,0,20,"dummy"
"1207",5,1,0,6,"dummy"
"1208",0,1,0,1,"dummy"
"1216",0,0,1,1,"dummy"
"1217",0,6,1,7,"dummy"
"1218",0,1,0,1,"dummy"
"1230",0,2,3,5,"dummy"
"1231",0,0,1,1,"dummy"
"1232",0,12,3,15,"dummy"
"1233",0,0,1,1,"dummy"
"1234",0,0,0,0,"dummy"
"1235",0,3,0,3,"dummy"
"1236",2,0,0,2,"dummy"
"1237",3,5,0,8,"dummy"
"1238",0,0,1,1,"dummy"
"1239",0,2,1,3,"dummy"
"1247",0,2,0,2,"dummy"
"1248",0,1,0,1,"dummy"
"1249",1,4,8,13,"dummy"
"1250",0,2,0,2,"dummy"
"1251",2,2,1,5,"dummy"
"1252",2,5,4,11,"dummy"
"1257",0,2,1,3,"dummy"
"1258",4,1,0,5,"dummy"
"1259",0,0,0,0,"dummy"
"1262",0,0,1,1,"dummy"
"1263",0,0,1,1,"dummy"
"923",0,0,1,1,"dummy"
"929",0,0,0,0,"dummy"
"930",0,0,0,0,"dummy"
"931",0,0,0,0,"dummy"
"955",0,0,1,1,"dummy"
"1174",1,6,4,11,"dummy"
"1198",0,11,0,11,"dummy"
"1199",2,14,1,17,"dummy"
"1200",0,4,1,5,"dummy"
"1201",0,2,0,2,"dummy"
"1202",0,1,0,1,"dummy"
"1212",0,10,0,10,"dummy"
"1213",10,0,0,10,"dummy"
"1214",0,10,0,10,"dummy"
"1220",0,0,1,1,"dummy"
"1221",0,0,1,1,"dummy"
"1222",0,0,2,2,"dummy"
"1223",0,0,1,1,"dummy"
"1224",0,0,1,1,"dummy"
"1254",0,8,0,8,"dummy"
"1255",0,0,2,2,"dummy"
"1271",0,0,2,2,"dummy"
"1272",0,0,1,1,"dummy"
"1286",0,0,1,1,"dummy"
"1287",0,5,1,6,"dummy"
"1288",0,3,0,3,"dummy"
"1289",0,0,2,2,"dummy"
"1290",15,0,1,16,"dummy"
"1291",0,0,1,1,"dummy"
"1292",0,0,1,1,"dummy"
"1293",0,1,0,1,"dummy"
"1294",0,2,0,2,"dummy"
"1295",0,0,1,1,"dummy"
"1296",0,0,1,1,"dummy"
"1297",0,0,1,1,"dummy"
"1298",2,4,0,6,"dummy"
"1299",4,6,0,10,"dummy"
"1300",6,7,0,13,"dummy"
"1301",0,2,0,2,"dummy"
"1305",1,1,0,2,"dummy"
"1308",2,1,1,4,"dummy"
"1312",2,1,1,4,"dummy"
"1313",0,5,0,5,"dummy"
"1315",0,1,1,2,"dummy"
"1316",0,0,1,1,"dummy"
"1317",0,5,2,7,"dummy"
"1318",0,0,1,1,"dummy"
"1328",0,0,1,1,"dummy"
"1333",1,0,0,1,"dummy"
"1334",0,0,0,0,"dummy"
"1335",1,0,0,1,"dummy"
"1336",1,0,1,2,"dummy"
"1342",0,2,1,3,"dummy"
"1343",0,0,1,1,"dummy"
"1350",0,3,0,3,"dummy"
"1351",0,1,0,1,"dummy"
"1368",0,4,0,4,"dummy"
"1369",0,0,2,2,"dummy"
"1370",0,10,0,10,"dummy"
"1371",0,1,0,1,"dummy"
"1372",0,0,3,3,"dummy"
"1373",0,1,0,1,"dummy"
"1374",0,0,4,4,"dummy"
"1375",0,1,3,4,"dummy"
"1376",1,2,0,3,"dummy"
"1377",0,1,0,1,"dummy"
"1378",0,7,0,7,"dummy"
"1379",0,0,1,1,"dummy"
"1380",0,0,1,1,"dummy"
"1383",6,15,0,21,"dummy"
"1385",6,2,0,8,"dummy"
"1387",0,6,0,6,"dummy"
"1388",2,9,0,11,"dummy"
"1390",0,1,0,1,"dummy"
"1392",2,3,0,5,"dummy"
"1395",3,13,1,17,"dummy"
"1396",1,0,1,2,"dummy"
"1397",2,22,0,24,"dummy"
"1398",0,4,0,4,"dummy"
"1399",0,1,0,1,"dummy"
"1402",6,5,4,15,"dummy"
"1403",0,0,1,1,"dummy"
"1404",6,0,4,10,"dummy"
"1413",0,0,4,4,"dummy"
"1414",0,1,0,1,"dummy"
"1416",0,6,1,7,"dummy"
"1417",0,1,0,1,"dummy"
"1420",0,1,0,1,"dummy"
"1421",0,0,0,0,"dummy"
"1422",2,2,0,4,"dummy"
"1424",0,1,0,1,"dummy"
"1426",4,3,3,10,"dummy"
"1428",0,1,0,1,"dummy"
"1429",1,3,0,4,"dummy"
"1430",6,5,1,12,"dummy"
"1431",0,1,1,2,"dummy"
"1434",0,1,0,1,"dummy"
"1435",0,3,5,8,"dummy"
"1436",0,0,1,1,"dummy"
"1437",2,0,1,3,"dummy"
"1440",0,1,0,1,"dummy"
"1441",1,1,0,2,"dummy"
"1442",0,0,1,1,"dummy"
"1443",0,0,1,1,"dummy"
"1444",10,17,0,27,"dummy"
"1445",2,1,0,3,"dummy"
"1446",3,6,1,10,"dummy"
"1447",2,2,0,4,"dummy"
"1448",0,2,0,2,"dummy"
"1450",2,4,0,6,"dummy"
"1451",2,0,0,2,"dummy"
"1452",3,0,0,3,"dummy"
"1453",0,1,0,1,"dummy"
"1454",0,2,2,4,"dummy"
"1455",0,9,0,9,"dummy"
"1456",2,0,0,2,"dummy"
"1457",0,2,0,2,"dummy"
"1461",0,2,0,2,"dummy"
"1462",0,0,1,1,"dummy"
"1464",0,0,1,1,"dummy"
"1465",0,2,0,2,"dummy"
"1467",0,0,2,2,"dummy"
"1468",0,0,2,2,"dummy"
"1469",4,12,3,19,"dummy"
"1470",4,4,5,13,"dummy"
"1471",2,2,3,7,"dummy"
"1472",2,2,3,7,"dummy"
"1473",2,2,3,7,"dummy"
"1474",0,3,0,3,"dummy"
"1475",2,2,4,8,"dummy"
"1476",3,3,0,6,"dummy"
"1478",0,0,2,2,"dummy"
"1480",1,4,0,5,"dummy"
"1481",5,7,3,15,"dummy"
"1482",0,1,0,1,"dummy"
"1483",2,3,0,5,"dummy"
"1492",0,3,0,3,"dummy"
"1493",0,2,0,2,"dummy"
"1494",1,0,1,2,"dummy"
"1495",5,0,2,7,"dummy"
"1497",0,1,0,1,"dummy"
"1500",0,0,0,0,"dummy"
"1501",1,0,0,1,"dummy"
"1503",0,0,2,2,"dummy"
"1504",2,0,0,2,"dummy"
"1505",0,1,0,1,"dummy"
"1511",0,1,2,3,"dummy"
"1512",0,0,0,0,"dummy"
"1514",0,0,1,1,"dummy"
"1515",0,0,0,0,"dummy"
"1517",0,0,1,1,"dummy"
"1541",1,0,0,1,"dummy"
"1542",0,1,0,1,"dummy"
"1543",1,0,0,1,"dummy"
"1544",2,1,1,4,"dummy"
"1545",0,5,0,5,"dummy"
"1547",1,0,0,1,"dummy"
"1548",2,2,6,10,"dummy"
"1549",1,0,2,3,"dummy"
"1550",0,1,2,3,"dummy"
"1551",0,1,0,1,"dummy"
"1552",0,0,0,0,"dummy"
"1553",0,0,1,1,"dummy"
"1554",0,0,3,3,"dummy"
"1555",0,0,3,3,"dummy"
"1556",0,0,6,6,"dummy"
"1557",0,0,4,4,"dummy"
"1558",2,3,1,6,"dummy"
"1560",0,1,1,2,"dummy"
"1561",3,8,5,16,"dummy"
"1562",2,1,2,5,"dummy"
"1563",1,6,2,9,"dummy"
"1564",0,0,1,1,"dummy"
"1565",0,0,2,2,"dummy"
"1566",0,0,1,1,"dummy"
"1573",0,4,0,4,"dummy"
"1574",2,1,1,4,"dummy"
"1575",0,0,1,1,"dummy"
"1600",2,3,2,7,"dummy"
"1601",2,3,0,5,"dummy"
"1602",0,2,0,2,"dummy"
"1603",1,1,0,2,"dummy"
"1604",0,0,1,1,"dummy"
"1605",1,6,0,7,"dummy"
"1606",0,0,0,0,"dummy"
"1607",10,3,1,14,"dummy"
"1608",6,3,0,9,"dummy"
"1609",15,20,2,37,"dummy"
"1610",0,1,0,1,"dummy"
"1611",5,3,1,9,"dummy"
"1612",0,0,1,1,"dummy"
"1613",6,6,0,12,"dummy"
"1614",6,8,0,14,"dummy"
"1615",0,0,3,3,"dummy"
"1616",3,9,0,12,"dummy"
"1617",0,0,2,2,"dummy"
"1618",0,0,2,2,"dummy"
"1619",0,1,0,1,"dummy"
"1620",0,1,0,1,"dummy"
"1621",2,1,0,3,"dummy"
"1622",0,2,0,2,"dummy"
"1623",0,0,1,1,"dummy"
"1624",0,1,0,1,"dummy"
"1625",0,1,0,1,"dummy"
"1626",0,0,1,1,"dummy"
"1627",2,5,0,7,"dummy"
"1628",0,1,0,1,"dummy"
"1629",1,2,0,3,"dummy"
"1630",1,3,1,5,"dummy"
"1631",0,1,0,1,"dummy"
"1632",12,3,0,15,"dummy"
"1633",0,0,2,2,"dummy"
"1634",1,0,1,2,"dummy"
"1635",0,1,0,1,"dummy"
"1636",0,0,1,1,"dummy"
"1637",0,0,1,1,"dummy"
"1638",0,2,0,2,"dummy"
"1640",0,0,4,4,"dummy"
"1641",1,0,0,1,"dummy"
"1642",0,1,0,1,"dummy"
"1643",3,2,0,5,"dummy"
"1644",0,1,0,1,"dummy"
"1645",5,3,0,8,"dummy"
"1647",0,4,0,4,"dummy"
"1648",0,2,0,2,"dummy"
"1649",1,9,0,10,"dummy"
"1650",0,0,2,2,"dummy"
"1651",0,1,0,1,"dummy"
"1652",0,8,0,8,"dummy"
"1653",0,1,0,1,"dummy"
"1654",0,1,0,1,"dummy"
"1655",15,6,0,21,"dummy"
"1656",0,0,0,0,"dummy"
"1657",0,0,1,1,"dummy"
"1658",0,0,0,0,"dummy"
"1659",0,0,0,0,"dummy"
"1660",2,1,1,4,"dummy"
"1661",1,0,1,2,"dummy"
"1662",0,0,0,0,"dummy"
"1663",0,0,1,1,"dummy"
"1664",0,0,1,1,"dummy"
"1665",0,0,1,1,"dummy"
"1666",0,0,1,1,"dummy"
"1667",0,0,1,1,"dummy"
"1668",0,0,1,1,"dummy"
"1669",0,0,1,1,"dummy"
"1670",0,0,1,1,"dummy"
"1675",5,0,0,5,"dummy"
"1677",0,4,0,4,"dummy"
"1680",0,0,0,0,"dummy"
"1681",0,0,1,1,"dummy"
"1682",0,2,0,2,"dummy"
"1683",0,4,0,4,"dummy"
"1684",0,1,0,1,"dummy"
"1685",0,3,1,4,"dummy"
"1688",0,1,0,1,"dummy"
"1691",8,0,1,9,"dummy"
"1693",0,1,0,1,"dummy"
"1694",0,0,0,0,"dummy"
"1695",0,5,0,5,"dummy"
"1696",0,2,0,2,"dummy"
"1697",0,0,0,0,"dummy"
"1698",7,5,1,13,"dummy"
"1699",0,3,0,3,"dummy"
"1700",0,3,0,3,"dummy"
"1701",0,1,0,1,"dummy"
"1702",1,2,1,4,"dummy"
"1703",5,4,0,9,"dummy"
"1704",18,19,3,40,"dummy"
"1714",0,1,0,1,"dummy"
"1715",1,4,0,5,"dummy"
"1716",0,14,0,14,"dummy"
"1718",0,0,0,0,"dummy"
"1719",0,0,0,0,"dummy"
"1739",0,3,0,3,"dummy"
"1740",0,0,0,0,"dummy"
"1741",0,0,0,0,"dummy"
"1742",3,0,0,3,"dummy"
"1743",0,0,2,2,"dummy"
"1744",0,0,1,1,"dummy"
"1745",2,1,0,3,"dummy"
"1746",0,0,0,0,"dummy"
"1747",2,3,1,6,"dummy"
"1749",2,0,0,2,"dummy"
"1750",0,1,0,1,"dummy"
"1751",0,1,0,1,"dummy"
"1752",1,1,4,6,"dummy"
"1753",0,1,0,1,"dummy"
"1754",0,0,1,1,"dummy"
"1755",0,0,2,2,"dummy"
"1756",0,3,0,3,"dummy"
"1757",3,0,4,7,"dummy"
"1758",0,0,1,1,"dummy"
"1759",0,0,1,1,"dummy"
"1760",0,1,0,1,"dummy"
"1761",1,0,1,2,"dummy"
"1763",0,0,4,4,"dummy"
"1765",0,4,1,5,"dummy"
"1766",0,1,0,1,"dummy"
"1767",0,2,1,3,"dummy"
"1768",0,2,1,3,"dummy"
"1769",0,0,1,1,"dummy"
"1770",0,0,1,1,"dummy"
"1771",0,3,0,3,"dummy"
"1772",0,1,0,1,"dummy"
"1774",5,5,1,11,"dummy"
"1775",0,0,1,1,"dummy"
"1776",0,0,2,2,"dummy"
"1777",0,7,4,11,"dummy"
"1778",7,0,0,7,"dummy"
"1781",0,0,1,1,"dummy"
"1782",0,2,0,2,"dummy"
"1783",0,0,1,1,"dummy"
"1785",0,2,3,5,"dummy"
"1786",0,5,0,5,"dummy"
"1787",0,5,0,5,"dummy"
"1788",4,0,0,4,"dummy"
"1789",0,2,0,2,"dummy"
"1790",2,4,0,6,"dummy"
"1791",1,0,0,1,"dummy"
"1792",0,2,0,2,"dummy"
"1793",0,1,0,1,"dummy"
"1794",0,0,1,1,"dummy"
"1795",0,1,0,1,"dummy"
"1796",3,1,0,4,"dummy"
"1797",0,4,0,4,"dummy"
"1799",5,14,4,23,"dummy"
"1800",14,4,3,21,"dummy"
"1801",4,14,3,21,"dummy"
"1803",0,3,1,4,"dummy"
"1804",0,1,0,1,"dummy"
"1807",0,3,0,3,"dummy"
"1808",2,4,0,6,"dummy"
"1809",0,0,2,2,"dummy"
"1810",0,0,1,1,"dummy"
"1811",8,4,1,13,"dummy"
"1812",0,0,1,1,"dummy"
"1813",1,0,0,1,"dummy"
"1814",0,8,0,8,"dummy"
"1815",2,2,0,4,"dummy"
"1816",0,0,1,1,"dummy"
"1817",0,0,2,2,"dummy"
"1818",0,1,0,1,"dummy"
"1819",0,0,2,2,"dummy"
"1820",0,9,0,9,"dummy"
"1821",0,10,0,10,"dummy"
"1822",0,7,0,7,"dummy"
"1823",16,2,0,18,"dummy"
"1824",2,16,0,18,"dummy"
"1825",0,11,2,13,"dummy"
"1826",1,3,0,4,"dummy"
"1827",0,0,1,1,"dummy"
"1828",0,1,1,2,"dummy"
"1829",0,2,0,2,"dummy"
"1830",0,1,0,1,"dummy"
"1831",1,3,0,4,"dummy"
"1832",1,0,0,1,"dummy"
"1833",0,0,2,2,"dummy"
"1836",6,0,4,10,"dummy"
"1837",0,2,0,2,"dummy"
"1838",0,3,0,3,"dummy"
"1839",0,7,0,7,"dummy"
"1840",0,5,0,5,"dummy"
"1841",0,2,0,2,"dummy"
"1842",0,1,0,1,"dummy"
"1843",0,2,0,2,"dummy"
"1844",1,2,0,3,"dummy"
"1845",11,8,6,25,"dummy"
"1846",0,2,0,2,"dummy"
"1848",0,0,1,1,"dummy"
"1868",4,3,2,9,"dummy"
"1869",3,2,2,7,"dummy"
"1870",0,3,0,3,"dummy"
"1871",2,0,1,3,"dummy"
"1872",0,0,1,1,"dummy"
"1873",0,0,0,0,"dummy"
"1875",0,3,3,6,"dummy"
"1879",0,2,1,3,"dummy"
"1883",0,2,0,2,"dummy"
"1885",0,0,1,1,"dummy"
"1886",0,1,0,1,"dummy"
"1889",0,0,2,2,"dummy"
"1890",0,0,0,0,"dummy"
"1891",0,0,2,2,"dummy"
"1892",0,4,0,4,"dummy"
"1893",0,1,0,1,"dummy"
"1895",1,1,0,2,"dummy"
"1896",0,0,0,0,"dummy"
"1898",0,1,0,1,"dummy"
"1899",0,1,0,1,"dummy"
"1900",0,1,0,1,"dummy"
"1901",7,3,1,11,"dummy"
"1902",1,2,0,3,"dummy"
"1903",0,10,3,13,"dummy"
"1904",0,2,0,2,"dummy"
"1905",1,0,0,1,"dummy"
"1906",1,2,0,3,"dummy"
"1907",0,1,0,1,"dummy"
"1909",0,0,0,0,"dummy"
"1913",0,3,0,3,"dummy"
"1914",0,0,0,0,"dummy"
"1924",1,0,1,2,"dummy"
"1925",0,1,0,1,"dummy"
"1926",5,2,1,8,"dummy"
"1927",0,2,0,2,"dummy"
"1928",0,0,1,1,"dummy"
"1929",2,0,0,2,"dummy"
"1964",0,1,0,1,"dummy"
"1965",1,4,0,5,"dummy"
"1967",2,0,3,5,"dummy"
"1972",1,7,1,9,"dummy"
"1973",0,1,0,1,"dummy"
"1974",0,1,0,1,"dummy"
"1975",0,1,0,1,"dummy"
"1976",15,1,0,16,"dummy"
"1987",0,0,0,0,"dummy"
"1988",0,1,0,1,"dummy"
"1989",1,1,0,2,"dummy"
"1990",0,0,0,0,"dummy"
"1991",0,0,2,2,"dummy"
"1992",0,1,0,1,"dummy"
"1993",1,0,0,1,"dummy"
"1995",0,0,0,0,"dummy"
"1996",7,0,0,7,"dummy"
"1997",0,0,0,0,"dummy"
"1998",1,0,0,1,"dummy"
"1999",0,0,1,1,"dummy"
"2003",0,0,0,0,"dummy"
"2006",0,1,0,1,"dummy"
"2007",1,0,2,3,"dummy"
"2008",0,1,0,1,"dummy"
"2009",0,1,2,3,"dummy"
"2010",0,0,1,1,"dummy"
"2013",2,9,3,14,"dummy"
"2017",2,4,1,7,"dummy"
"2018",1,2,0,3,"dummy"
"2019",4,2,1,7,"dummy"
"2020",2,4,1,7,"dummy"
"2021",4,3,0,7,"dummy"
"2022",0,2,0,2,"dummy"
"2023",2,1,1,4,"dummy"
"2024",0,0,2,2,"dummy"
"2025",0,5,0,5,"dummy"
"2027",0,15,0,15,"dummy"
"2042",0,0,1,1,"dummy"
"2043",1,1,0,2,"dummy"
"2045",6,0,4,10,"dummy"
"2048",1,1,0,2,"dummy"
"2049",0,0,2,2,"dummy"
"2050",0,0,1,1,"dummy"
"2051",2,0,0,2,"dummy"
"2052",0,0,2,2,"dummy"
"2053",0,0,0,0,"dummy"
"2054",0,0,0,0,"dummy"
"2062",2,2,1,5,"dummy"
"2064",12,14,4,30,"dummy"
"2065",0,0,2,2,"dummy"
"2066",0,1,0,1,"dummy"
"2067",1,0,1,2,"dummy"
"2068",0,1,1,2,"dummy"
"2069",2,0,2,4,"dummy"
"2070",0,2,1,3,"dummy"
"2071",0,0,1,1,"dummy"
"2072",4,2,1,7,"dummy"
"2073",0,0,0,0,"dummy"
"2076",6,0,0,6,"dummy"
"2077",0,7,0,7,"dummy"
"2078",7,0,0,7,"dummy"
"2098",0,3,1,4,"dummy"
"2099",0,0,1,1,"dummy"
"2100",2,1,0,3,"dummy"
"2101",0,1,0,1,"dummy"
"2102",0,0,1,1,"dummy"
"2103",0,0,1,1,"dummy"
"2106",1,2,0,3,"dummy"
"2107",4,4,0,8,"dummy"
"2131",0,0,0,0,"dummy"
"2132",0,4,0,4,"dummy"
"2133",0,0,1,1,"dummy"
"2135",0,0,1,1,"dummy"
"2136",1,0,0,1,"dummy"
"2137",0,1,0,1,"dummy"
"2138",0,0,1,1,"dummy"
"2140",4,3,3,10,"dummy"
"2142",11,1,0,12,"dummy"
"2143",0,2,0,2,"dummy"
"2145",0,0,1,1,"dummy"
"2149",0,4,0,4,"dummy"
"2153",0,12,0,12,"dummy"
"2156",0,2,0,2,"dummy"
"2160",0,0,1,1,"dummy"
"2162",0,1,0,1,"dummy"
"2164",0,0,1,1,"dummy"
"2165",0,1,2,3,"dummy"
"2179",0,1,1,2,"dummy"
"2180",1,1,1,3,"dummy"
"2181",0,0,0,0,"dummy"
"2182",0,0,0,0,"dummy"
"2183",0,0,0,0,"dummy"
"2184",0,0,0,0,"dummy"
"2186",0,0,1,1,"dummy"
"2197",0,0,1,1,"dummy"
"2198",0,0,1,1,"dummy"
"2199",0,0,2,2,"dummy"
"2200",26,3,7,36,"dummy"
"2202",0,2,0,2,"dummy"
"2204",0,1,0,1,"dummy"
"2205",1,0,0,1,"dummy"
"2206",0,5,0,5,"dummy"
"2207",0,1,0,1,"dummy"
"2208",1,0,0,1,"dummy"
"2209",0,2,0,2,"dummy"
"2210",0,1,0,1,"dummy"
"2212",10,14,3,27,"dummy"
"2213",0,0,3,3,"dummy"
"2214",0,1,0,1,"dummy"
"2215",0,2,0,2,"dummy"
"2217",1,0,0,1,"dummy"
"2221",0,0,1,1,"dummy"
"2222",0,4,1,5,"dummy"
"2223",0,0,1,1,"dummy"
"2224",0,0,1,1,"dummy"
"2227",0,0,1,1,"dummy"
"2228",0,0,1,1,"dummy"
"2229",0,0,1,1,"dummy"
"2230",0,0,1,1,"dummy"
"2231",0,0,1,1,"dummy"
"2232",0,0,1,1,"dummy"
"2233",0,0,1,1,"dummy"
"2234",0,0,1,1,"dummy"
"2235",0,0,1,1,"dummy"
"2236",0,0,1,1,"dummy"
"2237",0,0,1,1,"dummy"
"2238",0,0,1,1,"dummy"
"2239",0,0,1,1,"dummy"
"2240",0,0,1,1,"dummy"
"2241",0,0,1,1,"dummy"
"2242",0,0,1,1,"dummy"
"2243",0,0,1,1,"dummy"
"2244",0,0,1,1,"dummy"
"2245",0,0,1,1,"dummy"
"2246",0,0,1,1,"dummy"
"2264",0,0,0,0,"dummy"
"2266",0,4,0,4,"dummy"
"2270",4,0,2,6,"dummy"
"2271",0,0,2,2,"dummy"
"2272",0,0,2,2,"dummy"
"2273",0,0,2,2,"dummy"
"2274",0,0,2,2,"dummy"
"2275",0,2,2,4,"dummy"
"2280",0,0,1,1,"dummy"
"2281",10,9,2,21,"dummy"
"2282",0,1,0,1,"dummy"
"2283",0,1,0,1,"dummy"
"2285",2,0,7,9,"dummy"
"2286",0,0,1,1,"dummy"
"2287",0,2,0,2,"dummy"
"2288",0,0,0,0,"dummy"
"2290",3,8,0,11,"dummy"
"2292",0,1,0,1,"dummy"
"2293",0,2,0,2,"dummy"
"2294",0,0,1,1,"dummy"
"2295",0,0,1,1,"dummy"
"2298",18,6,1,25,"dummy"
"2299",6,15,3,24,"dummy"
"2301",0,0,1,1,"dummy"
"2302",1,8,4,13,"dummy"
"2303",0,1,0,1,"dummy"
"2304",0,1,0,1,"dummy"
"2306",0,1,0,1,"dummy"
"2308",0,0,1,1,"dummy"
"2316",0,2,0,2,"dummy"
"2317",0,1,0,1,"dummy"
"2319",0,0,0,0,"dummy"
"2323",0,0,4,4,"dummy"
"2328",0,0,1,1,"dummy"
"2329",0,0,2,2,"dummy"
"2330",0,1,0,1,"dummy"
"2331",0,1,0,1,"dummy"
"2332",0,0,2,2,"dummy"
"2334",0,2,0,2,"dummy"
"2335",1,0,1,2,"dummy"
"2336",0,1,0,1,"dummy"
"2337",0,6,0,6,"dummy"
"2357",0,1,0,1,"dummy"
"2361",0,0,1,1,"dummy"
"2362",6,2,0,8,"dummy"
"2363",0,1,0,1,"dummy"
"2364",7,10,0,17,"dummy"
"2371",0,0,0,0,"dummy"
"2372",0,0,0,0,"dummy"
"2373",0,0,0,0,"dummy"
"2374",0,0,0,0,"dummy"
"2376",0,0,0,0,"dummy"
"2377",0,0,2,2,"dummy"
"2378",0,0,6,6,"dummy"
"2379",0,0,2,2,"dummy"
"2380",0,0,2,2,"dummy"
"2383",0,0,1,1,"dummy"
"2385",0,0,1,1,"dummy"
"2386",0,0,1,1,"dummy"
"2387",0,0,1,1,"dummy"
"2388",0,2,2,4,"dummy"
"2389",0,3,0,3,"dummy"
"2390",1,2,0,3,"dummy"
"2391",6,5,3,14,"dummy"
"2400",0,1,0,1,"dummy"
"2404",11,1,2,14,"dummy"
"2405",0,3,0,3,"dummy"
"2406",0,0,0,0,"dummy"
"2409",0,0,2,2,"dummy"
"2410",0,0,1,1,"dummy"
"2411",0,0,2,2,"dummy"
"2415",0,0,1,1,"dummy"
"2416",0,0,0,0,"dummy"
"2419",0,7,0,7,"dummy"
"2420",0,2,0,2,"dummy"
"2421",0,2,5,7,"dummy"
"2422",0,2,0,2,"dummy"
"2423",0,2,0,2,"dummy"
"2424",0,0,1,1,"dummy"
"2425",0,0,1,1,"dummy"
"2426",0,0,1,1,"dummy"
"2427",1,6,4,11,"dummy"
"2428",1,0,0,1,"dummy"
"2429",0,0,3,3,"dummy"
"2430",1,0,0,1,"dummy"
"2437",0,5,0,5,"dummy"
"2438",0,0,5,5,"dummy"
"2439",0,2,0,2,"dummy"
"2440",15,2,3,20,"dummy"
"2441",0,0,2,2,"dummy"
"2442",0,0,0,0,"dummy"
"2445",0,0,1,1,"dummy"
"2446",0,0,0,0,"dummy"
"2447",1,5,0,6,"dummy"
"2448",8,0,0,8,"dummy"
"2449",0,0,0,0,"dummy"
"2450",0,0,0,0,"dummy"
"2451",0,1,0,1,"dummy"
"2452",0,0,0,0,"dummy"
"2453",0,0,1,1,"dummy"
"2455",1,1,0,2,"dummy"
"2460",0,1,0,1,"dummy"
"2462",0,2,0,2,"dummy"
"2465",0,1,0,1,"dummy"
"2467",0,4,0,4,"dummy"
"2468",1,0,0,1,"dummy"
"2469",0,0,5,5,"dummy"
"2471",2,0,0,2,"dummy"
"2472",1,2,3,6,"dummy"
"2473",0,0,3,3,"dummy"
"2505",0,7,0,7,"dummy"
"2506",0,1,0,1,"dummy"
"2508",0,2,1,3,"dummy"
"2511",0,0,1,1,"dummy"
"2512",1,1,2,4,"dummy"
"2516",0,0,1,1,"dummy"
"2517",0,8,0,8,"dummy"
"2518",0,1,0,1,"dummy"
"2519",0,1,1,2,"dummy"
"2527",0,0,1,1,"dummy"
"2528",0,2,0,2,"dummy"
"2529",0,0,1,1,"dummy"
"2544",0,0,1,1,"dummy"
"2545",0,0,0,0,"dummy"
"2550",1,3,1,5,"dummy"
"2551",3,1,0,4,"dummy"
"2552",0,2,2,4,"dummy"
"2553",0,1,0,1,"dummy"
"2554",0,1,1,2,"dummy"
"2555",0,2,0,2,"dummy"
"2556",0,0,1,1,"dummy"
"2557",1,0,0,1,"dummy"
"2558",0,1,0,1,"dummy"
"2559",1,2,0,3,"dummy"
"2560",0,1,0,1,"dummy"
"2570",1,8,0,9,"dummy"
"2571",4,6,2,12,"dummy"
"2572",0,6,0,6,"dummy"
"2573",0,1,0,1,"dummy"
"2574",1,2,0,3,"dummy"
"2575",2,3,0,5,"dummy"
"2576",0,0,1,1,"dummy"
"2577",1,0,0,1,"dummy"
"2578",1,15,2,18,"dummy"
"2625",4,11,4,19,"dummy"
"2635",2,0,2,4,"dummy"
"2636",0,1,3,4,"dummy"
"2662",0,2,1,3,"dummy"
"2663",0,0,1,1,"dummy"
"2670",0,0,1,1,"dummy"
"2674",0,0,1,1,"dummy"
"2675",0,2,1,3,"dummy"
"2676",1,2,0,3,"dummy"
"2677",2,2,0,4,"dummy"
"2678",1,2,0,3,"dummy"
"2679",0,0,1,1,"dummy"
"2680",2,0,0,2,"dummy"
"2681",0,1,0,1,"dummy"
"2682",5,0,3,8,"dummy"
"2683",0,4,0,4,"dummy"
"2684",1,2,0,3,"dummy"
"2699",0,1,0,1,"dummy"
"2700",0,1,0,1,"dummy"
"2703",0,0,1,1,"dummy"
"2704",0,0,1,1,"dummy"
"2705",0,0,2,2,"dummy"
"2706",0,0,2,2,"dummy"
"2707",0,2,2,4,"dummy"
"2713",0,0,1,1,"dummy"
"2714",29,2,1,32,"dummy"
"2715",1,0,0,1,"dummy"
"2721",0,0,1,1,"dummy"
"2722",2,0,0,2,"dummy"
"2726",10,18,5,33,"dummy"
"2727",12,11,3,26,"dummy"
"2580",5,6,1,12,"dummy"
"2587",0,0,1,1,"dummy"
"2588",0,1,1,2,"dummy"
"2591",1,1,1,3,"dummy"
"2592",3,4,1,8,"dummy"
"2593",6,4,0,10,"dummy"
"2594",0,0,2,2,"dummy"
"2595",2,2,8,12,"dummy"
"2596",0,0,7,7,"dummy"
"2597",0,1,0,1,"dummy"
"2598",0,0,2,2,"dummy"
"2599",0,0,2,2,"dummy"
"2600",0,0,2,2,"dummy"
"2601",0,0,1,1,"dummy"
"2602",0,0,1,1,"dummy"
"2603",3,6,5,14,"dummy"
"2604",0,11,5,16,"dummy"
"2605",1,3,0,4,"dummy"
"2606",1,1,0,2,"dummy"
"2607",1,3,1,5,"dummy"
"2608",3,1,1,5,"dummy"
"2609",0,4,0,4,"dummy"
"2610",1,1,0,2,"dummy"
"2611",1,1,0,2,"dummy"
"2612",1,1,0,2,"dummy"
"2613",4,2,1,7,"dummy"
"2614",2,4,4,10,"dummy"
"2615",1,1,0,2,"dummy"
"2616",0,1,0,1,"dummy"
"2617",1,1,0,2,"dummy"
"2618",0,0,1,1,"dummy"
"2619",0,3,0,3,"dummy"
"2620",5,1,0,6,"dummy"
"2621",6,6,2,14,"dummy"
"2622",5,3,1,9,"dummy"
"2623",0,3,2,5,"dummy"
"2629",0,2,0,2,"dummy"
"2630",0,1,0,1,"dummy"
"2631",1,1,0,2,"dummy"
"2632",1,0,0,1,"dummy"
"2633",1,1,0,2,"dummy"
"2638",0,5,0,5,"dummy"
"2639",5,1,1,7,"dummy"
"2640",0,1,0,1,"dummy"
"2641",0,0,1,1,"dummy"
"2642",0,0,0,0,"dummy"
"2643",0,0,1,1,"dummy"
"2644",0,5,0,5,"dummy"
"2645",3,0,0,3,"dummy"
"2646",0,1,0,1,"dummy"
"2647",1,3,3,7,"dummy"
"2648",0,1,1,2,"dummy"
"2649",1,2,1,4,"dummy"
"2658",2,0,0,2,"dummy"
"2659",0,1,0,1,"dummy"
"2660",1,1,0,2,"dummy"
"2688",3,8,5,16,"dummy"
"2689",1,0,1,2,"dummy"
"2692",1,1,0,2,"dummy"
"2693",0,3,1,4,"dummy"
"2694",0,1,0,1,"dummy"
"2695",1,0,0,1,"dummy"
"2696",3,0,0,3,"dummy"
"2697",0,3,0,3,"dummy"
"2709",0,0,2,2,"dummy"
"2710",1,0,1,2,"dummy"
"2711",0,0,1,1,"dummy"
"2717",0,1,2,3,"dummy"
"2718",1,0,0,1,"dummy"
"2719",0,0,2,2,"dummy"
"2724",0,36,0,36,"dummy"
"2732",1,0,0,1,"dummy"
"2733",0,0,0,0,"dummy"
"2735",0,0,0,0,"dummy"
"2742",2,1,0,3,"dummy"
"2745",0,1,0,1,"dummy"
"2746",0,2,1,3,"dummy"
"2750",1,1,0,2,"dummy"
"2751",0,3,1,4,"dummy"
"2752",0,1,0,1,"dummy"
"2753",1,0,0,1,"dummy"
"2754",3,0,0,3,"dummy"
"2755",0,3,0,3,"dummy"
"2757",11,1,3,15,"dummy"
"2759",0,2,0,2,"dummy"
"2761",0,1,0,1,"dummy"
"2762",2,4,0,6,"dummy"
"2765",0,1,0,1,"dummy"
"2766",0,0,1,1,"dummy"
"2767",2,5,0,7,"dummy"
"2768",0,2,1,3,"dummy"
"2769",0,2,0,2,"dummy"
"2770",5,2,0,7,"dummy"
"2771",1,0,0,1,"dummy"
"2772",0,2,0,2,"dummy"
"2773",0,1,0,1,"dummy"
"2774",1,0,0,1,"dummy"
"2776",4,1,0,5,"dummy"
"2777",0,3,1,4,"dummy"
"2778",0,1,1,2,"dummy"
"2779",1,0,0,1,"dummy"
"2780",0,1,0,1,"dummy"
"2781",2,6,0,8,"dummy"
"2784",0,0,1,1,"dummy"
"2785",2,1,0,3,"dummy"
"2786",0,0,1,1,"dummy"
"2787",0,0,1,1,"dummy"
"2788",0,0,0,0,"dummy"
"2790",0,9,0,9,"dummy"
"2791",0,0,0,0,"dummy"
"2792",0,1,0,1,"dummy"
"2794",0,0,1,1,"dummy"
"2795",0,0,1,1,"dummy"
"2796",0,0,1,1,"dummy"
"2797",0,0,1,1,"dummy"
"2798",0,0,1,1,"dummy"
"2799",0,0,1,1,"dummy"
"2800",0,0,1,1,"dummy"
"2801",0,0,1,1,"dummy"
"2802",0,0,1,1,"dummy"
"2803",0,0,1,1,"dummy"
"2804",0,0,1,1,"dummy"
"2805",0,0,1,1,"dummy"
"2806",0,0,1,1,"dummy"
"2807",0,0,1,1,"dummy"
"2808",0,0,1,1,"dummy"
"2809",0,0,0,0,"dummy"
"2810",4,3,0,7,"dummy"
"2812",0,2,0,2,"dummy"
"2813",1,2,1,4,"dummy"
"2814",0,1,1,2,"dummy"
"2817",1,0,0,1,"dummy"
"2818",0,0,1,1,"dummy"
"2819",0,2,0,2,"dummy"
"2820",4,0,0,4,"dummy"
"2822",0,1,0,1,"dummy"
"2824",0,2,0,2,"dummy"
"2825",0,1,0,1,"dummy"
"2826",0,1,0,1,"dummy"
"2827",0,2,0,2,"dummy"
"2829",6,0,0,6,"dummy"
"2830",2,5,2,9,"dummy"
"2832",1,0,1,2,"dummy"
"2833",8,1,1,10,"dummy"
"2836",0,0,1,1,"dummy"
"2837",0,0,0,0,"dummy"
"2839",0,0,1,1,"dummy"
"2843",0,0,1,1,"dummy"
"2844",0,0,1,1,"dummy"
"2845",0,0,1,1,"dummy"
"2847",0,0,1,1,"dummy"
"2848",0,0,1,1,"dummy"
"2849",0,0,2,2,"dummy"
"2850",0,0,1,1,"dummy"
"2851",0,0,1,1,"dummy"
"2852",0,0,1,1,"dummy"
"2853",2,1,1,4,"dummy"
"2854",2,2,0,4,"dummy"
"2855",0,1,1,2,"dummy"
"2856",0,0,1,1,"dummy"
"2857",0,0,1,1,"dummy"
"2858",0,0,1,1,"dummy"
"2859",0,0,1,1,"dummy"
"2860",0,0,1,1,"dummy"
"2861",0,0,2,2,"dummy"
"2862",0,0,1,1,"dummy"
"2863",0,0,1,1,"dummy"
"2864",0,0,1,1,"dummy"
"2867",4,6,0,10,"dummy"
"2868",1,0,1,2,"dummy"
"2869",0,1,0,1,"dummy"
"2897",2,0,3,5,"dummy"
"2899",0,2,0,2,"dummy"
"2900",0,1,0,1,"dummy"
"2901",0,8,1,9,"dummy"
"2902",0,3,0,3,"dummy"
"2903",0,0,1,1,"dummy"
"2904",0,1,0,1,"dummy"
"2905",0,1,0,1,"dummy"
"2906",0,1,0,1,"dummy"
"2907",1,2,0,3,"dummy"
"2908",10,14,0,24,"dummy"
"2910",0,1,3,4,"dummy"
"2911",0,1,4,5,"dummy"
"2912",2,0,3,5,"dummy"
"2913",0,1,3,4,"dummy"
"2914",1,0,3,4,"dummy"
"2915",0,2,3,5,"dummy"
"2916",2,2,3,7,"dummy"
"2920",2,0,1,3,"dummy"
"2924",0,0,1,1,"dummy"
"2941",2,2,0,4,"dummy"
"2942",1,3,0,4,"dummy"
"2944",1,6,0,7,"dummy"
"2945",0,0,1,1,"dummy"
"2946",0,1,0,1,"dummy"
"2948",0,2,2,4,"dummy"
"2949",1,1,0,2,"dummy"
"2950",4,4,4,12,"dummy"
"2951",2,0,1,3,"dummy"
"2952",0,2,1,3,"dummy"
"2954",0,1,0,1,"dummy"
"2955",0,1,0,1,"dummy"
"2956",0,4,1,5,"dummy"
"2957",0,3,0,3,"dummy"
"2962",1,7,3,11,"dummy"
"2963",0,0,1,1,"dummy"
"2966",0,9,0,9,"dummy"
"2968",2,0,0,2,"dummy"
"2972",2,2,1,5,"dummy"
"2974",0,1,0,1,"dummy"
"2975",0,4,0,4,"dummy"
"2976",0,1,0,1,"dummy"
"2978",5,1,1,7,"dummy"
"2979",0,1,0,1,"dummy"
"2980",0,0,1,1,"dummy"
"2981",0,0,2,2,"dummy"
"2982",0,0,1,1,"dummy"
"2983",0,0,2,2,"dummy"
"2984",0,0,1,1,"dummy"
"2985",0,0,2,2,"dummy"
"2986",2,0,0,2,"dummy"
"2993",1,1,2,4,"dummy"
"2994",0,0,1,1,"dummy"
"2996",0,0,1,1,"dummy"
"2997",0,0,1,1,"dummy"
"2998",0,0,1,1,"dummy"
"3000",0,2,1,3,"dummy"
"3001",0,1,0,1,"dummy"
"3002",0,2,1,3,"dummy"
"3003",0,0,1,1,"dummy"
"3014",2,1,1,4,"dummy"
"3015",0,0,1,1,"dummy"
"3016",0,1,0,1,"dummy"
"3017",0,2,0,2,"dummy"
"3024",0,0,0,0,"dummy"
"3028",0,1,0,1,"dummy"
"3029",1,4,2,7,"dummy"
"3030",0,0,1,1,"dummy"
"3033",0,0,0,0,"dummy"
"3034",0,0,0,0,"dummy"
"3036",0,2,0,2,"dummy"
"3037",0,0,1,1,"dummy"
"3038",0,1,0,1,"dummy"
"3039",0,0,1,1,"dummy"
"3040",0,0,4,4,"dummy"
"3041",0,0,2,2,"dummy"
"3042",3,1,1,5,"dummy"
"3044",0,1,0,1,"dummy"
"3045",1,0,0,1,"dummy"
"3046",0,3,0,3,"dummy"
"3047",2,13,2,17,"dummy"
"3048",1,3,1,5,"dummy"
"3049",1,2,0,3,"dummy"
"3050",0,1,0,1,"dummy"
"3051",2,0,1,3,"dummy"
"3053",4,1,0,5,"dummy"
"3056",1,0,0,1,"dummy"
"3058",0,0,0,0,"dummy"
"3059",0,20,0,20,"dummy"
"3060",2,2,0,4,"dummy"
"3061",16,0,2,18,"dummy"
"3062",0,1,0,1,"dummy"
"3063",2,2,1,5,"dummy"
"3064",0,0,1,1,"dummy"
"3066",0,1,0,1,"dummy"
"3070",1,0,1,2,"dummy"
"3071",0,0,0,0,"dummy"
"3072",0,0,0,0,"dummy"
"3076",0,0,0,0,"dummy"
"3077",0,0,2,2,"dummy"
"3078",0,0,0,0,"dummy"
"3079",4,0,0,4,"dummy"
"3080",0,0,1,1,"dummy"
"3081",0,0,1,1,"dummy"
"3083",0,0,0,0,"dummy"
"3085",3,0,0,3,"dummy"
"3086",1,3,1,5,"dummy"
"3088",0,2,0,2,"dummy"
"3092",0,2,1,3,"dummy"
"3093",0,1,0,1,"dummy"
"3102",11,4,1,16,"dummy"
"3103",2,15,3,20,"dummy"
"3104",13,11,2,26,"dummy"
"3105",11,13,2,26,"dummy"
"3136",0,1,0,1,"dummy"
"3137",6,1,0,7,"dummy"
"3139",0,0,0,0,"dummy"
"3140",0,0,1,1,"dummy"
"3141",0,1,0,1,"dummy"
"3142",0,1,0,1,"dummy"
"3146",41,4,4,49,"dummy"
"3147",0,0,0,0,"dummy"
"3150",14,15,0,29,"dummy"
"3151",2,2,0,4,"dummy"
"3158",2,2,0,4,"dummy"
"3159",0,1,0,1,"dummy"
"3162",4,4,1,9,"dummy"
"3164",1,1,0,2,"dummy"
"3165",10,0,0,10,"dummy"
"3166",0,1,0,1,"dummy"
"3167",0,1,0,1,"dummy"
"3168",0,1,0,1,"dummy"
"3169",0,0,1,1,"dummy"
"3170",0,3,0,3,"dummy"
"3171",0,2,0,2,"dummy"
"3175",2,0,0,2,"dummy"
"3178",0,0,2,2,"dummy"
"3179",0,0,2,2,"dummy"
"3248",0,1,0,1,"dummy"
"3249",0,0,1,1,"dummy"
"3251",1,1,0,2,"dummy"
"3252",4,3,1,8,"dummy"
"3253",2,14,0,16,"dummy"
"3254",0,7,0,7,"dummy"
"3255",0,1,0,1,"dummy"
"3256",0,0,1,1,"dummy"
"3257",10,3,1,14,"dummy"
"3258",0,2,0,2,"dummy"
"3259",1,7,3,11,"dummy"
"3274",0,0,1,1,"dummy"
"3275",0,1,0,1,"dummy"
"3276",0,1,0,1,"dummy"
"3277",0,0,1,1,"dummy"
"3278",0,0,0,0,"dummy"
"3279",0,1,0,1,"dummy"
"3280",0,0,1,1,"dummy"
"3281",0,2,0,2,"dummy"
"3282",0,1,1,2,"dummy"
"3283",2,1,1,4,"dummy"
"3284",1,2,1,4,"dummy"
"3285",2,0,0,2,"dummy"
"3286",0,0,1,1,"dummy"
"3287",0,0,2,2,"dummy"
"3288",1,0,0,1,"dummy"
"3289",1,1,0,2,"dummy"
"3290",2,0,1,3,"dummy"
"3291",0,1,0,1,"dummy"
"3292",1,0,0,1,"dummy"
"3293",0,0,0,0,"dummy"
"3294",2,0,0,2,"dummy"
"3295",0,0,0,0,"dummy"
"3296",0,1,0,1,"dummy"
"3297",0,0,0,0,"dummy"
"3298",0,1,1,2,"dummy"
"3299",0,0,1,1,"dummy"
"3300",0,0,1,1,"dummy"
"3301",2,1,1,4,"dummy"
"3309",0,0,1,1,"dummy"
"3310",0,1,1,2,"dummy"
"3311",0,2,0,2,"dummy"
"3312",0,0,1,1,"dummy"
"3313",1,11,0,12,"dummy"
"3315",0,12,0,12,"dummy"
"3318",0,1,0,1,"dummy"
"3319",0,2,0,2,"dummy"
"3320",0,2,0,2,"dummy"
"3321",0,1,0,1,"dummy"
"3322",0,0,1,1,"dummy"
"3323",1,0,0,1,"dummy"
"3324",12,10,3,25,"dummy"
"3325",1,0,0,1,"dummy"
"3332",0,0,1,1,"dummy"
"3333",4,0,1,5,"dummy"
"3334",4,8,0,12,"dummy"
"3335",0,0,3,3,"dummy"
"3336",1,1,4,6,"dummy"
"3338",2,0,0,2,"dummy"
"3339",0,3,1,4,"dummy"
"3340",0,0,1,1,"dummy"
"3341",3,1,0,4,"dummy"
"3342",2,0,0,2,"dummy"
"3346",1,0,0,1,"dummy"
"3347",0,1,0,1,"dummy"
"3348",2,3,0,5,"dummy"
"3349",2,2,0,4,"dummy"
"3351",0,0,1,1,"dummy"
"3352",1,1,0,2,"dummy"
"3358",0,0,1,1,"dummy"
"3359",0,0,1,1,"dummy"
"3361",7,10,0,17,"dummy"
"3362",23,1,1,25,"dummy"
"3363",0,1,0,1,"dummy"
"3369",0,1,0,1,"dummy"
"3370",0,3,0,3,"dummy"
"3371",0,3,0,3,"dummy"
"3372",1,3,0,4,"dummy"
"3373",1,0,0,1,"dummy"
"3374",4,1,0,5,"dummy"
"3375",0,0,0,0,"dummy"
"3376",1,0,0,1,"dummy"
"3377",0,0,0,0,"dummy"
"3378",0,3,0,3,"dummy"
"3379",0,0,0,0,"dummy"
"3380",0,0,1,1,"dummy"
"3382",1,2,3,6,"dummy"
"3385",0,2,0,2,"dummy"
"3386",0,0,1,1,"dummy"
"3389",15,3,0,18,"dummy"
"3390",0,1,0,1,"dummy"
"3391",2,0,0,2,"dummy"
"3394",0,3,0,3,"dummy"
"3398",1,0,0,1,"dummy"
"3399",0,1,0,1,"dummy"
"3400",0,1,0,1,"dummy"
"3401",0,0,1,1,"dummy"
"3402",1,14,0,15,"dummy"
"3405",0,1,0,1,"dummy"
"3406",0,3,2,5,"dummy"
"3407",0,1,0,1,"dummy"
"3408",0,0,3,3,"dummy"
"3410",0,1,0,1,"dummy"
"3411",1,1,0,2,"dummy"
"3415",3,9,0,12,"dummy"
"3416",0,1,0,1,"dummy"
"3417",3,3,2,8,"dummy"
"3418",0,0,1,1,"dummy"
"3419",0,2,2,4,"dummy"
"3420",0,6,0,6,"dummy"
"3421",2,4,0,6,"dummy"
"3422",4,3,1,8,"dummy"
"3423",2,4,0,6,"dummy"
"3424",0,1,0,1,"dummy"
"3425",0,3,0,3,"dummy"
"3426",0,0,2,2,"dummy"
"3427",0,0,2,2,"dummy"
"3428",0,0,0,0,"dummy"
"3429",2,5,1,8,"dummy"
"3430",0,0,0,0,"dummy"
"3437",0,0,1,1,"dummy"
"3439",0,3,1,4,"dummy"
"3440",3,3,1,7,"dummy"
"3441",1,0,0,1,"dummy"
"3442",0,0,0,0,"dummy"
"3444",1,1,0,2,"dummy"
"3445",1,4,0,5,"dummy"
"3446",9,0,1,10,"dummy"
"3448",2,6,0,8,"dummy"
"3453",0,0,2,2,"dummy"
"3455",0,3,0,3,"dummy"
"3456",0,0,5,5,"dummy"
"3457",0,0,3,3,"dummy"
"3458",0,1,4,5,"dummy"
"3461",3,2,0,5,"dummy"
"3462",4,3,0,7,"dummy"
"3463",0,4,1,5,"dummy"
"3464",4,0,0,4,"dummy"
"3467",2,1,4,7,"dummy"
"3470",3,12,0,15,"dummy"
"3471",0,0,1,1,"dummy"
"3472",0,0,1,1,"dummy"
"3476",0,0,0,0,"dummy"
"3477",0,6,3,9,"dummy"
"3479",0,0,0,0,"dummy"
"3492",0,0,1,1,"dummy"
"3493",0,0,1,1,"dummy"
"3494",0,0,1,1,"dummy"
"3495",0,0,1,1,"dummy"
"3498",0,1,1,2,"dummy"
"3499",2,9,1,12,"dummy"
"3500",0,0,1,1,"dummy"
"3502",0,1,0,1,"dummy"
"3503",0,2,0,2,"dummy"
"3504",0,0,0,0,"dummy"
"3507",0,0,0,0,"dummy"
"3508",1,0,0,1,"dummy"
"3509",0,0,1,1,"dummy"
"3510",1,1,0,2,"dummy"
"3511",0,0,1,1,"dummy"
"3512",0,0,1,1,"dummy"
"3513",2,0,0,2,"dummy"
"3514",0,2,0,2,"dummy"
"3515",0,1,0,1,"dummy"
"3516",1,0,0,1,"dummy"
"3517",0,1,0,1,"dummy"
"3518",0,0,0,0,"dummy"
"3519",4,1,0,5,"dummy"
"3520",1,0,0,1,"dummy"
"3521",0,0,0,0,"dummy"
"3522",0,0,0,0,"dummy"
"3530",2,0,1,3,"dummy"
"3531",0,0,0,0,"dummy"
"3532",0,2,0,2,"dummy"
"3534",0,1,0,1,"dummy"
"3535",0,0,0,0,"dummy"
"3536",0,2,0,2,"dummy"
"3538",0,0,1,1,"dummy"
"3539",0,0,1,1,"dummy"
"3541",2,0,2,4,"dummy"
"3542",5,0,0,5,"dummy"
"3543",0,1,0,1,"dummy"
"3544",0,2,0,2,"dummy"
"3549",1,2,2,5,"dummy"
"3550",0,2,0,2,"dummy"
"3552",1,0,0,1,"dummy"
"3553",0,0,1,1,"dummy"
"3555",0,0,1,1,"dummy"
"3559",2,1,1,4,"dummy"
"3560",0,0,1,1,"dummy"
"3561",0,0,1,1,"dummy"
"3562",0,0,1,1,"dummy"
"3564",4,21,3,28,"dummy"
"3565",25,10,5,40,"dummy"
"3566",0,1,2,3,"dummy"
"3567",0,4,2,6,"dummy"
"3568",6,3,2,11,"dummy"
"3569",4,0,1,5,"dummy"
"3570",0,3,0,3,"dummy"
"3571",0,1,1,2,"dummy"
"3573",0,0,1,1,"dummy"
"3579",0,0,0,0,"dummy"
"3580",0,2,0,2,"dummy"
"3581",0,0,1,1,"dummy"
"3582",4,0,2,6,"dummy"
"3583",2,0,2,4,"dummy"
"3585",8,8,0,16,"dummy"
"3586",25,21,8,54,"dummy"
"3587",7,1,0,8,"dummy"
"3611",1,0,1,2,"dummy"
"3612",0,1,1,2,"dummy"
"3613",0,0,0,0,"dummy"
"3614",1,0,0,1,"dummy"
"3615",0,0,1,1,"dummy"
"3616",0,0,1,1,"dummy"
"3617",0,0,1,1,"dummy"
"3618",0,0,1,1,"dummy"
"3619",0,0,1,1,"dummy"
"3620",0,0,1,1,"dummy"
"3652",0,5,0,5,"dummy"
"3653",3,9,0,12,"dummy"
"3654",2,2,0,4,"dummy"
"3655",0,4,2,6,"dummy"
"3656",0,2,0,2,"dummy"
"3657",0,1,0,1,"dummy"
"3658",5,5,0,10,"dummy"
"3659",0,1,0,1,"dummy"
"3660",0,0,1,1,"dummy"
"3662",0,1,0,1,"dummy"
"3663",1,0,0,1,"dummy"
"3664",3,1,0,4,"dummy"
"3665",0,1,0,1,"dummy"
"3666",0,0,0,0,"dummy"
"3667",3,2,0,5,"dummy"
"3673",1,5,1,7,"dummy"
"3674",2,0,0,2,"dummy"
"3675",0,1,1,2,"dummy"
"3677",0,0,0,0,"dummy"
"3680",5,8,0,13,"dummy"
"3682",0,1,2,3,"dummy"
"3683",1,1,0,2,"dummy"
"3684",1,0,0,1,"dummy"
"3685",0,0,1,1,"dummy"
"3694",2,6,1,9,"dummy"
"3696",0,0,0,0,"dummy"
"3698",0,11,0,11,"dummy"
"3699",2,1,0,3,"dummy"
"3702",0,0,0,0,"dummy"
"3703",0,1,0,1,"dummy"
"3704",0,0,1,1,"dummy"
"3705",0,1,1,2,"dummy"
"3706",0,0,1,1,"dummy"
"3707",0,0,3,3,"dummy"
"3708",0,0,1,1,"dummy"
"3710",0,4,0,4,"dummy"
"3711",0,2,0,2,"dummy"
"3712",0,0,0,0,"dummy"
"3713",0,0,0,0,"dummy"
"3715",1,0,0,1,"dummy"
"3716",3,3,1,7,"dummy"
"3717",1,2,1,4,"dummy"
"3718",0,0,1,1,"dummy"
"3719",0,0,0,0,"dummy"
"3720",0,1,0,1,"dummy"
"3721",2,3,0,5,"dummy"
"3722",7,8,0,15,"dummy"
"3723",1,1,0,2,"dummy"
"3724",3,4,2,9,"dummy"
"3725",0,1,1,2,"dummy"
"3766",0,0,1,1,"dummy"
"3767",0,1,0,1,"dummy"
"3768",0,0,0,0,"dummy"
"3769",0,1,1,2,"dummy"
"3770",0,0,1,1,"dummy"
"3773",0,0,1,1,"dummy"
"3776",2,1,3,6,"dummy"
"3782",2,0,0,2,"dummy"
"3783",0,4,0,4,"dummy"
"3784",4,1,0,5,"dummy"
"3785",6,0,0,6,"dummy"
"3786",0,0,1,1,"dummy"
"3787",4,1,1,6,"dummy"
"3788",0,0,1,1,"dummy"
"3789",0,2,0,2,"dummy"
"3790",0,2,0,2,"dummy"
"3792",1,0,0,1,"dummy"
"3793",16,6,3,25,"dummy"
"3794",1,2,6,9,"dummy"
"3795",3,3,2,8,"dummy"
"3796",3,2,2,7,"dummy"
"3798",0,0,0,0,"dummy"
"3800",1,4,0,5,"dummy"
"3801",1,3,2,6,"dummy"
"3802",1,0,1,2,"dummy"
"3803",4,2,3,9,"dummy"
"3806",0,0,1,1,"dummy"
"3807",1,1,0,2,"dummy"
"3808",0,0,4,4,"dummy"
"3810",0,1,0,1,"dummy"
"3811",1,0,0,1,"dummy"
"3818",0,1,0,1,"dummy"
"3825",0,0,1,1,"dummy"
"3828",0,8,0,8,"dummy"
"3829",0,1,0,1,"dummy"
"3830",0,0,0,0,"dummy"
"3833",0,0,0,0,"dummy"
"3834",0,0,0,0,"dummy"
"3835",2,0,0,2,"dummy"
"3837",0,2,0,2,"dummy"
"3838",0,0,2,2,"dummy"
"3839",0,0,2,2,"dummy"
"3845",0,0,1,1,"dummy"
"3847",3,8,2,13,"dummy"
"3848",0,2,0,2,"dummy"
"3849",49,0,2,51,"dummy"
"3850",0,0,1,1,"dummy"
"3851",4,6,2,12,"dummy"
"3852",2,2,2,6,"dummy"
"3853",0,1,1,2,"dummy"
"3854",15,2,1,18,"dummy"
"3855",0,0,2,2,"dummy"
"3856",0,0,1,1,"dummy"
"3858",0,0,0,0,"dummy"
"3863",0,0,1,1,"dummy"
"3864",1,0,1,2,"dummy"
"3867",2,2,3,7,"dummy"
"3898",0,0,0,0,"dummy"
"3901",0,2,0,2,"dummy"
"3904",0,12,0,12,"dummy"
"3905",1,6,0,7,"dummy"
"3906",0,0,1,1,"dummy"
"3907",1,2,0,3,"dummy"
"3908",0,2,0,2,"dummy"
"3909",0,0,0,0,"dummy"
"3910",7,6,1,14,"dummy"
"3911",0,0,0,0,"dummy"
"3912",0,4,0,4,"dummy"
"3913",3,4,0,7,"dummy"
"3914",0,1,0,1,"dummy"
"3915",0,1,0,1,"dummy"
"3916",3,3,0,6,"dummy"
"3917",4,2,1,7,"dummy"
"3918",0,1,1,2,"dummy"
"3919",1,0,1,2,"dummy"
"3920",0,1,0,1,"dummy"
"3922",0,3,1,4,"dummy"
"3923",0,1,0,1,"dummy"
"3924",0,2,0,2,"dummy"
"3925",0,0,1,1,"dummy"
"3926",0,0,1,1,"dummy"
"3927",0,1,1,2,"dummy"
"3930",4,8,0,12,"dummy"
"3931",0,1,0,1,"dummy"
"3932",0,0,1,1,"dummy"
"3934",0,1,1,2,"dummy"
"3935",2,4,2,8,"dummy"
"3936",0,2,0,2,"dummy"
"3937",0,2,0,2,"dummy"
"3938",0,0,1,1,"dummy"
"3943",0,0,1,1,"dummy"
"3944",0,0,1,1,"dummy"
"3945",0,0,1,1,"dummy"
"3946",0,0,1,1,"dummy"
"3947",0,0,1,1,"dummy"
"3948",0,0,0,0,"dummy"
"3949",0,0,1,1,"dummy"
"3950",0,0,1,1,"dummy"
"3951",0,0,1,1,"dummy"
"3952",0,0,1,1,"dummy"
"3953",0,0,1,1,"dummy"
"3954",0,0,1,1,"dummy"
"3955",0,0,1,1,"dummy"
"3956",0,0,1,1,"dummy"
"3957",0,0,1,1,"dummy"
"3958",0,0,1,1,"dummy"
"3960",0,2,1,3,"dummy"
"3961",4,0,1,5,"dummy"
"3962",0,1,0,1,"dummy"
"3981",4,5,2,11,"dummy"
"3982",1,0,3,4,"dummy"
"3983",0,0,1,1,"dummy"
"3984",0,2,1,3,"dummy"
"3985",0,0,1,1,"dummy"
"3990",4,5,3,12,"dummy"
"3991",0,4,0,4,"dummy"
"3994",0,1,3,4,"dummy"
"3995",3,2,1,6,"dummy"
"3998",0,0,1,1,"dummy"
"3999",0,0,1,1,"dummy"
"4000",0,1,0,1,"dummy"
"4001",0,1,0,1,"dummy"
"4002",0,0,3,3,"dummy"
"4004",0,0,1,1,"dummy"
"4005",0,0,1,1,"dummy"
"4006",3,1,3,7,"dummy"
"4009",0,0,1,1,"dummy"
"4010",0,0,0,0,"dummy"
"4012",2,2,3,7,"dummy"
"4013",9,5,1,15,"dummy"
"4022",18,8,2,28,"dummy"
"4023",2,3,1,6,"dummy"
"4024",0,0,0,0,"dummy"
"4025",0,0,0,0,"dummy"
"4026",0,0,0,0,"dummy"
"4027",0,0,0,0,"dummy"
"4028",0,0,1,1,"dummy"
"4029",0,0,1,1,"dummy"
"4030",0,0,1,1,"dummy"
"4031",5,0,2,7,"dummy"
"4032",0,0,1,1,"dummy"
"4033",6,0,4,10,"dummy"
"4036",0,0,0,0,"dummy"
"4037",0,0,3,3,"dummy"
"4038",0,0,3,3,"dummy"
"4039",0,0,0,0,"dummy"
"4041",0,1,0,1,"dummy"
"4042",0,3,0,3,"dummy"
"4043",2,3,1,6,"dummy"
"4044",0,1,0,1,"dummy"
"4045",0,1,1,2,"dummy"
"4046",4,1,0,5,"dummy"
"4047",12,6,1,19,"dummy"
"4048",1,1,0,2,"dummy"
"4049",2,3,0,5,"dummy"
"4050",3,1,3,7,"dummy"
"4051",0,4,0,4,"dummy"
"4052",0,4,0,4,"dummy"
"4053",0,5,0,5,"dummy"
"4054",0,1,0,1,"dummy"
"4055",0,4,0,4,"dummy"
"4056",0,1,0,1,"dummy"
"4057",1,0,2,3,"dummy"
"4058",0,3,0,3,"dummy"
"4059",3,3,0,6,"dummy"
"4060",0,2,0,2,"dummy"
"4061",0,0,1,1,"dummy"
"4062",0,2,0,2,"dummy"
"4063",0,1,0,1,"dummy"
"4064",0,1,0,1,"dummy"
"4065",0,2,0,2,"dummy"
"4066",0,2,0,2,"dummy"
"4067",0,2,0,2,"dummy"
"4068",0,1,0,1,"dummy"
"4069",0,0,1,1,"dummy"
"4070",0,25,0,25,"dummy"
"4071",4,4,0,8,"dummy"
"4072",25,19,0,44,"dummy"
"4073",0,0,0,0,"dummy"
"4074",3,3,0,6,"dummy"
"4075",3,0,0,3,"dummy"
"4076",2,2,0,4,"dummy"
"4077",0,2,0,2,"dummy"
"4078",1,0,0,1,"dummy"
"4079",2,0,0,2,"dummy"
"4080",1,1,0,2,"dummy"
"4081",0,0,1,1,"dummy"
"4082",2,0,1,3,"dummy"
"4083",1,4,1,6,"dummy"
"4084",2,1,0,3,"dummy"
"4085",0,1,0,1,"dummy"
"4086",0,2,0,2,"dummy"
"4087",0,0,1,1,"dummy"
"4088",0,1,0,1,"dummy"
"4089",0,0,1,1,"dummy"
"4092",0,0,1,1,"dummy"
"4094",0,0,1,1,"dummy"
"4095",0,0,1,1,"dummy"
"4096",4,2,0,6,"dummy"
"4097",0,0,1,1,"dummy"
"4098",0,2,0,2,"dummy"
"4154",0,0,1,1,"dummy"
"4156",1,0,0,1,"dummy"
"4157",0,0,0,0,"dummy"
"4159",2,1,0,3,"dummy"
"4166",0,1,0,1,"dummy"
"4167",0,2,1,3,"dummy"
"4169",0,0,0,0,"dummy"
"4172",1,1,0,2,"dummy"
"4173",0,3,1,4,"dummy"
"4174",0,1,0,1,"dummy"
"4175",1,0,0,1,"dummy"
"4176",3,0,0,3,"dummy"
"4177",0,3,0,3,"dummy"
"4181",11,1,3,15,"dummy"
"4183",0,2,0,2,"dummy"
"4185",0,1,0,1,"dummy"
"4186",2,4,0,6,"dummy"
"4189",0,1,0,1,"dummy"
"4190",0,0,1,1,"dummy"
"4191",2,5,0,7,"dummy"
"4192",0,2,1,3,"dummy"
"4193",0,2,0,2,"dummy"
"4194",5,2,0,7,"dummy"
"4195",1,0,0,1,"dummy"
"4196",0,2,0,2,"dummy"
"4197",0,1,0,1,"dummy"
"4198",1,0,0,1,"dummy"
"4200",4,1,0,5,"dummy"
"4201",0,3,1,4,"dummy"
"4202",0,1,1,2,"dummy"
"4203",1,0,0,1,"dummy"
"4204",0,1,0,1,"dummy"
"4205",2,6,0,8,"dummy"
"4208",0,0,1,1,"dummy"
"4209",2,1,0,3,"dummy"
"4210",0,0,1,1,"dummy"
"4211",0,0,1,1,"dummy"
"4212",0,0,0,0,"dummy"
"4214",0,9,0,9,"dummy"
"4215",0,0,0,0,"dummy"
"4216",0,1,0,1,"dummy"
"4218",0,0,1,1,"dummy"
"4219",0,0,1,1,"dummy"
"4220",0,0,1,1,"dummy"
"4221",0,0,1,1,"dummy"
"4222",0,0,1,1,"dummy"
"4223",0,0,1,1,"dummy"
"4224",0,0,1,1,"dummy"
"4225",0,0,1,1,"dummy"
"4226",0,0,1,1,"dummy"
"4227",0,0,1,1,"dummy"
"4228",0,0,1,1,"dummy"
"4229",0,0,1,1,"dummy"
"4230",0,0,1,1,"dummy"
"4231",0,0,1,1,"dummy"
"4232",0,0,1,1,"dummy"
"4233",0,0,0,0,"dummy"
"4234",4,3,0,7,"dummy"
"4236",0,0,1,1,"dummy"
"4237",0,0,1,1,"dummy"
"4238",0,0,2,2,"dummy"
"4239",0,0,1,1,"dummy"
"4240",0,0,1,1,"dummy"
"4241",0,0,1,1,"dummy"
"4242",2,1,1,4,"dummy"
"4243",2,2,0,4,"dummy"
"4244",0,1,1,2,"dummy"
"4245",0,0,1,1,"dummy"
"4246",0,0,1,1,"dummy"
"4247",0,0,1,1,"dummy"
"4248",0,0,1,1,"dummy"
"4249",0,0,1,1,"dummy"
"4250",0,0,2,2,"dummy"
"4251",0,0,1,1,"dummy"
"4252",0,0,1,1,"dummy"
"4253",0,0,1,1,"dummy"
"4255",0,0,1,1,"dummy"
"4256",0,0,0,0,"dummy"
"4258",0,0,1,1,"dummy"
"4259",0,0,1,1,"dummy"
"4260",0,0,1,1,"dummy"
"4263",0,2,0,2,"dummy"
"4264",0,1,0,1,"dummy"
"4265",0,1,0,1,"dummy"
"4266",0,2,0,2,"dummy"
"4268",6,0,0,6,"dummy"
"4269",2,5,2,9,"dummy"
"4271",1,0,1,2,"dummy"
"4272",8,1,1,10,"dummy"
"4276",0,2,0,2,"dummy"
"4277",1,2,1,4,"dummy"
"4278",0,1,1,2,"dummy"
"4280",0,0,1,1,"dummy"
"4283",2,0,3,5,"dummy"
"4312",4,6,0,10,"dummy"
"4313",1,0,1,2,"dummy"
"4314",0,1,0,1,"dummy"
"4317",0,1,3,4,"dummy"
"4318",0,1,4,5,"dummy"
"4319",2,0,3,5,"dummy"
"4320",0,1,3,4,"dummy"
"4321",1,0,3,4,"dummy"
"4322",0,2,3,5,"dummy"
"4323",2,2,3,7,"dummy"
"4325",0,2,0,2,"dummy"
"4326",0,1,0,1,"dummy"
"4327",0,8,1,9,"dummy"
"4328",0,3,0,3,"dummy"
"4329",0,0,1,1,"dummy"
"4330",0,1,0,1,"dummy"
"4331",0,1,0,1,"dummy"
"4332",0,1,0,1,"dummy"
"4333",1,2,0,3,"dummy"
"4334",10,14,0,24,"dummy"
"4338",2,0,1,3,"dummy"
"4341",1,0,0,1,"dummy"
"4342",0,0,1,1,"dummy"
"4343",0,2,0,2,"dummy"
"4344",4,0,0,4,"dummy"
"4346",0,1,0,1,"dummy"
"4350",0,0,1,1,"dummy"
"4365",2,2,0,4,"dummy"
"4366",1,3,0,4,"dummy"
"4368",1,6,0,7,"dummy"
"4369",0,0,1,1,"dummy"
"4370",0,1,0,1,"dummy"
"4372",0,2,2,4,"dummy"
"4373",1,1,0,2,"dummy"
"4374",4,4,4,12,"dummy"
"4375",2,0,1,3,"dummy"
"4376",0,2,1,3,"dummy"
"4378",0,1,0,1,"dummy"
"4379",0,1,0,1,"dummy"
"4380",0,4,1,5,"dummy"
"4381",0,3,0,3,"dummy"
"4385",1,7,3,11,"dummy"
"4386",0,0,1,1,"dummy"
"4390",0,9,0,9,"dummy"
"4392",2,0,0,2,"dummy"
"4394",2,2,1,5,"dummy"
"4397",0,1,0,1,"dummy"
"4398",0,4,0,4,"dummy"
"4399",0,1,0,1,"dummy"
"4401",5,1,1,7,"dummy"
"4402",0,1,0,1,"dummy"
"4403",0,0,1,1,"dummy"
"4404",0,0,2,2,"dummy"
"4405",0,0,1,1,"dummy"
"4406",0,0,2,2,"dummy"
"4407",0,0,1,1,"dummy"
"4408",0,0,2,2,"dummy"
"4409",2,0,0,2,"dummy"
"4415",2,1,1,4,"dummy"
"4416",0,0,1,1,"dummy"
"4417",0,1,0,1,"dummy"
"4418",0,2,0,2,"dummy"
"4421",2,0,0,2,"dummy"
"4428",1,1,2,4,"dummy"
"4429",0,0,1,1,"dummy"
"4431",0,0,1,1,"dummy"
"4432",0,0,1,1,"dummy"
"4433",0,0,1,1,"dummy"
"4436",0,2,1,3,"dummy"
"4437",0,1,0,1,"dummy"
"4438",0,2,1,3,"dummy"
"4439",0,0,1,1,"dummy"
"4447",0,1,0,1,"dummy"
"4450",0,0,0,0,"dummy"
"4452",0,1,0,1,"dummy"
"4453",1,4,2,7,"dummy"
"4454",0,0,1,1,"dummy"
"4456",0,0,0,0,"dummy"
"4457",0,0,0,0,"dummy"
"4460",4,1,0,5,"dummy"
"4462",0,1,0,1,"dummy"
"4463",1,0,0,1,"dummy"
"4464",0,3,0,3,"dummy"
"4465",2,13,2,17,"dummy"
"4466",1,3,1,5,"dummy"
"4467",1,2,0,3,"dummy"
"4468",0,1,0,1,"dummy"
"4469",2,0,1,3,"dummy"
"4471",0,2,0,2,"dummy"
"4472",0,0,1,1,"dummy"
"4473",0,1,0,1,"dummy"
"4474",0,0,1,1,"dummy"
"4475",0,0,4,4,"dummy"
"4476",0,0,2,2,"dummy"
"4477",3,1,1,5,"dummy"
"4479",1,0,0,1,"dummy"
"4482",0,1,0,1,"dummy"
"4486",0,0,0,0,"dummy"
"4487",0,20,0,20,"dummy"
"4488",2,2,0,4,"dummy"
"4489",16,0,2,18,"dummy"
"4490",0,1,0,1,"dummy"
"4491",2,2,1,5,"dummy"
"4492",0,0,1,1,"dummy"
"4496",0,2,0,2,"dummy"
"4499",1,1,3,5,"dummy"
"4500",0,0,1,1,"dummy"
"4501",0,0,1,1,"dummy"
"4502",4,0,0,4,"dummy"
"4504",0,0,0,0,"dummy"
"4505",0,0,2,2,"dummy"
"4506",0,0,0,0,"dummy"
"4507",4,0,0,4,"dummy"
"4508",0,0,1,1,"dummy"
"4509",0,0,1,1,"dummy"
"4513",0,0,1,1,"dummy"
"4514",0,0,1,1,"dummy"
"4515",0,0,1,1,"dummy"
"4517",0,0,0,0,"dummy"
"4519",0,0,1,1,"dummy"
"4520",1,0,0,1,"dummy"
"4523",0,2,1,3,"dummy"
"4524",0,1,0,1,"dummy"
"4532",11,4,1,16,"dummy"
"4533",2,15,3,20,"dummy"
"4534",13,11,2,26,"dummy"
"4535",11,13,2,26,"dummy"
"4539",2,0,0,2,"dummy"
"4621",0,1,0,1,"dummy"
"4623",0,1,0,1,"dummy"
"4624",6,1,0,7,"dummy"
"4627",0,0,0,0,"dummy"
"4628",0,0,1,1,"dummy"
"4629",0,1,0,1,"dummy"
"4630",0,1,0,1,"dummy"
"4634",41,4,4,49,"dummy"
"4635",0,0,0,0,"dummy"
"4639",14,15,0,29,"dummy"
"4640",2,2,0,4,"dummy"
"4646",2,2,0,4,"dummy"
"4647",0,1,0,1,"dummy"
"4650",4,4,1,9,"dummy"
"4654",0,0,1,1,"dummy"
"4655",0,1,0,1,"dummy"
"4656",0,1,0,1,"dummy"
"4657",0,0,1,1,"dummy"
"4658",0,0,0,0,"dummy"
"4659",0,1,0,1,"dummy"
"4660",0,0,1,1,"dummy"
"4661",0,2,0,2,"dummy"
"4662",0,1,1,2,"dummy"
"4663",2,1,1,4,"dummy"
"4664",1,2,1,4,"dummy"
"4665",2,0,0,2,"dummy"
"4666",0,0,1,1,"dummy"
"4667",0,0,2,2,"dummy"
"4668",1,0,0,1,"dummy"
"4669",1,1,0,2,"dummy"
"4670",2,0,1,3,"dummy"
"4671",0,1,0,1,"dummy"
"4672",1,0,0,1,"dummy"
"4673",0,0,0,0,"dummy"
"4674",2,0,0,2,"dummy"
"4675",0,0,0,0,"dummy"
"4676",0,1,0,1,"dummy"
"4677",0,0,0,0,"dummy"
"4678",0,1,1,2,"dummy"
"4679",0,0,1,1,"dummy"
"4680",0,0,1,1,"dummy"
"4681",2,1,1,4,"dummy"
"4683",0,1,0,1,"dummy"
"4684",0,2,0,2,"dummy"
"4685",0,2,0,2,"dummy"
"4686",0,1,0,1,"dummy"
"4687",0,0,1,1,"dummy"
"4688",1,0,0,1,"dummy"
"4689",12,10,3,25,"dummy"
"4690",1,0,0,1,"dummy"
"4692",1,0,0,1,"dummy"
"4693",0,1,0,1,"dummy"
"4694",2,3,0,5,"dummy"
"4695",2,2,0,4,"dummy"
"4697",0,0,1,1,"dummy"
"4698",1,1,0,2,"dummy"
"4701",0,0,1,1,"dummy"
"4702",0,0,1,1,"dummy"
"4706",2,0,0,2,"dummy"
"4707",0,3,1,4,"dummy"
"4708",0,0,1,1,"dummy"
"4709",3,1,0,4,"dummy"
"4710",2,0,0,2,"dummy"
"4715",0,1,0,1,"dummy"
"4716",1,2,0,3,"dummy"
"4717",1,0,0,1,"dummy"
"4718",0,2,0,2,"dummy"
"4719",0,1,0,1,"dummy"
"4720",0,1,0,1,"dummy"
"4721",0,2,0,2,"dummy"
"4722",0,1,0,1,"dummy"
"4723",0,3,0,3,"dummy"
"4724",0,1,0,1,"dummy"
"4725",0,1,0,1,"dummy"
"4726",0,1,0,1,"dummy"
"4727",0,1,0,1,"dummy"
"4728",0,2,0,2,"dummy"
"4745",15,3,0,18,"dummy"
"4746",0,1,0,1,"dummy"
"4747",2,0,0,2,"dummy"
"4749",2,0,1,3,"dummy"
"4750",4,2,5,11,"dummy"
"4751",2,0,2,4,"dummy"
"4755",1,1,0,2,"dummy"
"4756",4,3,1,8,"dummy"
"4757",2,14,0,16,"dummy"
"4758",0,7,0,7,"dummy"
"4759",0,1,0,1,"dummy"
"4760",0,0,1,1,"dummy"
"4761",10,3,1,14,"dummy"
"4762",0,2,0,2,"dummy"
"4763",1,7,3,11,"dummy"
"4765",0,3,0,3,"dummy"
"4768",0,0,1,1,"dummy"
"4769",0,1,1,2,"dummy"
"4770",0,2,0,2,"dummy"
"4771",0,0,1,1,"dummy"
"4772",1,11,0,12,"dummy"
"4774",0,12,0,12,"dummy"
"4779",0,1,0,1,"dummy"
"4780",0,0,1,1,"dummy"
"4784",0,1,0,1,"dummy"
"4785",0,3,0,3,"dummy"
"4786",0,3,0,3,"dummy"
"4787",1,3,0,4,"dummy"
"4788",1,0,0,1,"dummy"
"4789",4,1,0,5,"dummy"
"4790",0,0,0,0,"dummy"
"4791",1,0,0,1,"dummy"
"4792",0,0,0,0,"dummy"
"4793",0,3,0,3,"dummy"
"4794",0,0,0,0,"dummy"
"4795",0,0,1,1,"dummy"
"4800",1,2,3,6,"dummy"
"4803",0,2,0,2,"dummy"
"4804",0,0,1,1,"dummy"
"4807",2,1,4,7,"dummy"
"4810",0,3,0,3,"dummy"
"4811",0,0,5,5,"dummy"
"4812",0,0,3,3,"dummy"
"4813",0,1,4,5,"dummy"
"4815",3,2,0,5,"dummy"
"4816",4,3,0,7,"dummy"
"4817",0,4,1,5,"dummy"
"4818",4,0,0,4,"dummy"
"4821",0,0,2,2,"dummy"
"4828",0,0,0,0,"dummy"
"4830",0,0,0,0,"dummy"
"4831",0,6,3,9,"dummy"
"4833",2,6,0,8,"dummy"
"4835",0,0,1,1,"dummy"
"4837",3,5,1,9,"dummy"
"4838",5,3,1,9,"dummy"
"4839",2,2,0,4,"dummy"
"4840",3,18,2,23,"dummy"
"4841",0,1,0,1,"dummy"
"4842",0,0,0,0,"dummy"
"4843",16,0,2,18,"dummy"
"4844",2,3,0,5,"dummy"
"4845",0,0,1,1,"dummy"
"4846",1,2,0,3,"dummy"
"4848",0,1,0,1,"dummy"
"4849",0,3,2,5,"dummy"
"4850",0,1,0,1,"dummy"
"4851",0,0,3,3,"dummy"
"4856",0,1,0,1,"dummy"
"4857",1,1,0,2,"dummy"
"4863",0,3,1,4,"dummy"
"4864",3,3,1,7,"dummy"
"4865",1,0,0,1,"dummy"
"4866",0,0,0,0,"dummy"
"4872",1,1,0,2,"dummy"
"4873",1,4,0,5,"dummy"
"4874",9,0,1,10,"dummy"
"4877",3,9,0,12,"dummy"
"4878",0,1,0,1,"dummy"
"4879",3,3,2,8,"dummy"
"4880",0,0,1,1,"dummy"
"4881",0,2,2,4,"dummy"
"4882",0,6,0,6,"dummy"
"4883",2,4,0,6,"dummy"
"4884",4,3,1,8,"dummy"
"4885",2,4,0,6,"dummy"
"4886",0,1,0,1,"dummy"
"4887",0,3,0,3,"dummy"
"4888",0,0,2,2,"dummy"
"4889",0,0,2,2,"dummy"
"4890",0,0,0,0,"dummy"
"4891",2,5,1,8,"dummy"
"4892",0,0,0,0,"dummy"
"4896",0,0,1,1,"dummy"
"4897",0,0,1,1,"dummy"
"4901",2,1,1,4,"dummy"
"4902",0,0,1,1,"dummy"
"4903",0,0,1,1,"dummy"
"4904",0,0,1,1,"dummy"
"4906",4,21,3,28,"dummy"
"4907",25,10,5,40,"dummy"
"4908",0,1,2,3,"dummy"
"4909",0,4,2,6,"dummy"
"4910",6,3,2,11,"dummy"
"4911",4,0,1,5,"dummy"
"4912",0,3,0,3,"dummy"
"4913",0,1,1,2,"dummy"
"4924",0,0,1,1,"dummy"
"4931",2,0,1,3,"dummy"
"4932",0,0,0,0,"dummy"
"4933",0,2,0,2,"dummy"
"4935",0,1,0,1,"dummy"
"4936",0,0,0,0,"dummy"
"4937",0,2,0,2,"dummy"
"4940",1,0,0,1,"dummy"
"4941",0,1,0,1,"dummy"
"4942",0,1,0,1,"dummy"
"4943",0,0,1,1,"dummy"
"4944",1,14,0,15,"dummy"
"4950",0,1,0,1,"dummy"
"4951",0,2,0,2,"dummy"
"4952",0,0,0,0,"dummy"
"4954",0,0,1,1,"dummy"
"4955",0,0,1,1,"dummy"
"4956",0,0,1,1,"dummy"
"4957",0,0,1,1,"dummy"
"4959",0,1,1,2,"dummy"
"4960",2,9,1,12,"dummy"
"4961",0,0,1,1,"dummy"
"4968",0,0,0,0,"dummy"
"4969",1,0,0,1,"dummy"
"4970",0,0,1,1,"dummy"
"4971",1,1,0,2,"dummy"
"4972",0,0,1,1,"dummy"
"4973",0,0,1,1,"dummy"
"4974",2,0,0,2,"dummy"
"4975",0,2,0,2,"dummy"
"4976",0,1,0,1,"dummy"
"4977",1,0,0,1,"dummy"
"4978",0,1,0,1,"dummy"
"4979",0,0,0,0,"dummy"
"4980",4,1,0,5,"dummy"
"4981",1,0,0,1,"dummy"
"4982",0,0,0,0,"dummy"
"4983",0,0,0,0,"dummy"
"4985",0,0,0,0,"dummy"
"4986",0,1,0,1,"dummy"
"4987",0,0,1,1,"dummy"
"4988",0,1,1,2,"dummy"
"4989",0,0,1,1,"dummy"
"4990",0,0,3,3,"dummy"
"4991",0,0,1,1,"dummy"
"4994",1,0,0,1,"dummy"
"4995",0,0,1,1,"dummy"
"5032",1,2,2,5,"dummy"
"5033",0,2,0,2,"dummy"
"5036",0,0,1,1,"dummy"
"5039",2,0,2,4,"dummy"
"5040",5,0,0,5,"dummy"
"5041",0,1,0,1,"dummy"
"5042",0,2,0,2,"dummy"
"5053",0,0,0,0,"dummy"
"5052",0,0,0,0,"dummy"
"5051",0,2,0,2,"dummy"
"5050",0,4,0,4,"dummy"
"5055",0,11,0,11,"dummy"
"5056",2,1,0,3,"dummy"
"5058",0,0,0,0,"dummy"
"5060",2,6,1,9,"dummy"
"5070",0,1,2,3,"dummy"
"5071",1,1,0,2,"dummy"
"5072",1,0,0,1,"dummy"
"5073",0,0,1,1,"dummy"
"5075",0,0,0,0,"dummy"
"5078",5,8,0,13,"dummy"
"5080",1,5,1,7,"dummy"
"5081",2,0,0,2,"dummy"
"5082",0,1,1,2,"dummy"
"5089",2,1,3,6,"dummy"
"5092",0,1,0,1,"dummy"
"5093",1,0,0,1,"dummy"
"5094",3,1,0,4,"dummy"
"5095",0,1,0,1,"dummy"
"5096",0,0,0,0,"dummy"
"5097",3,2,0,5,"dummy"
"5099",0,2,1,3,"dummy"
"5100",0,7,0,7,"dummy"
"5101",0,0,0,0,"dummy"
"5103",0,0,1,1,"dummy"
"5105",1,4,0,5,"dummy"
"5106",1,3,2,6,"dummy"
"5107",1,0,1,2,"dummy"
"5108",4,2,3,9,"dummy"
"5110",0,0,0,0,"dummy"
"5113",0,1,0,1,"dummy"
"5114",1,0,0,1,"dummy"
"5116",0,0,1,1,"dummy"
"5117",1,1,0,2,"dummy"
"5118",0,0,4,4,"dummy"
"5156",0,5,0,5,"dummy"
"5157",3,9,0,12,"dummy"
"5158",2,2,0,4,"dummy"
"5159",0,4,2,6,"dummy"
"5160",0,2,0,2,"dummy"
"5161",0,1,0,1,"dummy"
"5162",5,5,0,10,"dummy"
"5163",0,1,0,1,"dummy"
"5164",0,0,1,1,"dummy"
"5169",0,0,1,1,"dummy"
"5170",0,1,0,1,"dummy"
"5171",0,0,0,0,"dummy"
"5172",0,1,1,2,"dummy"
"5173",0,0,1,1,"dummy"
"5175",0,1,0,1,"dummy"
"5177",1,0,1,2,"dummy"
"5178",0,1,1,2,"dummy"
"5179",0,0,0,0,"dummy"
"5180",1,0,0,1,"dummy"
"5181",0,0,1,1,"dummy"
"5182",0,0,1,1,"dummy"
"5183",0,0,1,1,"dummy"
"5184",0,0,1,1,"dummy"
"5185",0,0,1,1,"dummy"
"5186",0,0,1,1,"dummy"
"5190",1,0,0,1,"dummy"
"5191",16,6,3,25,"dummy"
"5192",1,2,6,9,"dummy"
"5193",3,3,2,8,"dummy"
"5194",3,2,2,7,"dummy"
"5196",2,0,0,2,"dummy"
"5197",0,4,0,4,"dummy"
"5198",4,1,0,5,"dummy"
"5199",6,0,0,6,"dummy"
"5200",0,0,1,1,"dummy"
"5201",4,1,1,6,"dummy"
"5202",0,0,1,1,"dummy"
"5203",0,2,0,2,"dummy"
"5204",0,2,0,2,"dummy"
"5207",0,0,1,1,"dummy"
"5213",0,0,1,1,"dummy"
"5214",1,0,1,2,"dummy"
"5216",0,0,0,0,"dummy"
"5218",0,2,0,2,"dummy"
"5219",0,0,2,2,"dummy"
"5220",0,0,2,2,"dummy"
"5224",0,0,1,1,"dummy"
"5228",3,8,2,13,"dummy"
"5229",0,2,0,2,"dummy"
"5230",49,0,2,51,"dummy"
"5231",0,0,1,1,"dummy"
"5232",4,6,2,12,"dummy"
"5233",2,2,2,6,"dummy"
"5234",0,1,1,2,"dummy"
"5235",15,2,1,18,"dummy"
"5236",0,0,2,2,"dummy"
"5237",0,0,1,1,"dummy"
"5242",0,2,1,3,"dummy"
"5243",4,0,1,5,"dummy"
"5244",0,1,0,1,"dummy"
"5246",0,0,1,1,"dummy"
"5247",0,0,1,1,"dummy"
"5248",0,0,1,1,"dummy"
"5249",0,0,1,1,"dummy"
"5250",0,0,1,1,"dummy"
"5251",0,0,0,0,"dummy"
"5252",0,0,1,1,"dummy"
"5253",0,0,1,1,"dummy"
"5254",0,0,1,1,"dummy"
"5255",0,0,1,1,"dummy"
"5256",0,0,1,1,"dummy"
"5257",0,0,1,1,"dummy"
"5258",0,0,1,1,"dummy"
"5259",0,0,1,1,"dummy"
"5260",0,0,1,1,"dummy"
"5261",0,0,1,1,"dummy"
"5279",0,8,0,8,"dummy"
"5280",0,1,0,1,"dummy"
"5281",0,0,0,0,"dummy"
"5291",0,0,0,0,"dummy"
"5292",0,0,0,0,"dummy"
"5293",2,0,0,2,"dummy"
"5296",8,8,0,16,"dummy"
"5297",25,21,8,54,"dummy"
"5298",7,1,0,8,"dummy"
"5300",2,2,3,7,"dummy"
"5304",2,0,1,3,"dummy"
"5306",0,0,1,1,"dummy"
"5307",0,0,1,1,"dummy"
"5308",3,1,3,7,"dummy"
"5311",4,5,3,12,"dummy"
"5312",0,4,0,4,"dummy"
"5316",0,0,0,0,"dummy"
"5318",0,0,1,1,"dummy"
"5319",0,0,1,1,"dummy"
"5320",0,1,0,1,"dummy"
"5321",0,1,0,1,"dummy"
"5322",0,0,3,3,"dummy"
"5341",0,3,1,4,"dummy"
"5342",0,1,0,1,"dummy"
"5343",0,2,0,2,"dummy"
"5344",0,0,1,1,"dummy"
"5345",0,0,1,1,"dummy"
"5346",0,1,1,2,"dummy"
"5349",0,12,0,12,"dummy"
"5350",1,6,0,7,"dummy"
"5351",0,0,1,1,"dummy"
"5352",1,2,0,3,"dummy"
"5353",0,2,0,2,"dummy"
"5354",0,0,0,0,"dummy"
"5355",7,6,1,14,"dummy"
"5356",0,0,0,0,"dummy"
"5357",0,4,0,4,"dummy"
"5358",3,4,0,7,"dummy"
"5359",0,1,0,1,"dummy"
"5360",0,1,0,1,"dummy"
"5361",3,3,0,6,"dummy"
"5362",4,2,1,7,"dummy"
"5363",0,1,1,2,"dummy"
"5364",1,0,1,2,"dummy"
"5365",0,1,0,1,"dummy"
"5367",0,1,1,2,"dummy"
"5368",2,4,2,8,"dummy"
"5369",0,2,0,2,"dummy"
"5370",0,2,0,2,"dummy"
"5371",0,0,1,1,"dummy"
"5374",3,6,1,10,"dummy"
"5377",18,8,2,28,"dummy"
"5378",2,3,1,6,"dummy"
"5379",0,0,0,0,"dummy"
"5380",0,0,0,0,"dummy"
"5381",0,0,0,0,"dummy"
"5382",0,0,0,0,"dummy"
"5383",0,0,1,1,"dummy"
"5384",0,0,1,1,"dummy"
"5385",0,0,1,1,"dummy"
"5386",5,0,2,7,"dummy"
"5387",0,0,1,1,"dummy"
"5388",6,0,4,10,"dummy"
"5408",0,0,1,1,"dummy"
"5409",0,0,0,0,"dummy"
"5412",0,0,0,0,"dummy"
"5413",0,0,3,3,"dummy"
"5414",0,0,3,3,"dummy"
"5415",0,0,0,0,"dummy"
"5420",0,1,3,4,"dummy"
"5421",3,2,1,6,"dummy"
"5423",2,2,3,7,"dummy"
"5424",9,5,1,15,"dummy"
"5426",0,1,0,1,"dummy"
"5427",0,3,0,3,"dummy"
"5428",2,3,1,6,"dummy"
"5429",0,1,0,1,"dummy"
"5430",0,1,1,2,"dummy"
"5431",4,1,0,5,"dummy"
"5432",12,6,1,19,"dummy"
"5433",1,1,0,2,"dummy"
"5434",2,3,0,5,"dummy"
"5435",3,1,3,7,"dummy"
"5436",0,4,0,4,"dummy"
"5437",0,4,0,4,"dummy"
"5438",0,5,0,5,"dummy"
"5439",0,1,0,1,"dummy"
"5440",0,4,0,4,"dummy"
"5441",0,1,0,1,"dummy"
"5442",1,0,2,3,"dummy"
"5443",0,3,0,3,"dummy"
"5444",3,3,0,6,"dummy"
"5445",0,2,0,2,"dummy"
"5446",0,0,1,1,"dummy"
"5447",0,2,0,2,"dummy"
"5448",0,1,0,1,"dummy"
"5449",0,1,0,1,"dummy"
"5450",0,2,0,2,"dummy"
"5451",0,2,0,2,"dummy"
"5452",0,2,0,2,"dummy"
"5453",0,1,0,1,"dummy"
"5454",0,0,1,1,"dummy"
"5455",0,25,0,25,"dummy"
"5456",4,4,0,8,"dummy"
"5457",25,19,0,44,"dummy"
"5458",0,0,0,0,"dummy"
"5459",3,3,0,6,"dummy"
"5460",3,0,0,3,"dummy"
"5461",2,2,0,4,"dummy"
"5462",0,2,0,2,"dummy"
"5463",1,0,0,1,"dummy"
"5464",2,0,0,2,"dummy"
"5465",1,1,0,2,"dummy"
"5466",0,0,1,1,"dummy"
"5467",2,0,1,3,"dummy"
"5468",1,4,1,6,"dummy"
"5469",2,1,0,3,"dummy"
"5470",0,1,0,1,"dummy"
"5471",0,2,0,2,"dummy"
"5472",0,0,1,1,"dummy"
"5473",0,1,0,1,"dummy"
"5474",0,0,1,1,"dummy"
"5479",4,5,2,11,"dummy"
"5480",1,0,3,4,"dummy"
"5481",0,0,1,1,"dummy"
"5482",0,2,1,3,"dummy"
"5483",0,0,1,1,"dummy"
"5485",0,0,1,1,"dummy"
"5486",0,0,1,1,"dummy"
"5487",4,2,0,6,"dummy"
"5488",0,0,1,1,"dummy"
"5489",0,2,0,2,"dummy"
"5523",0,0,1,1,"dummy"
"5530",0,0,1,1,"dummy"
"5538",0,2,0,2,"dummy"
"5540",0,0,0,0,"dummy"
"5541",0,0,0,0,"dummy"
"5543",0,0,1,1,"dummy"
"5544",0,0,1,1,"dummy"
"5546",0,1,1,2,"dummy"
"5550",0,10,0,10,"dummy"
"5551",0,2,0,2,"dummy"
"5552",0,0,1,1,"dummy"
"5553",0,0,2,2,"dummy"
"5554",0,2,0,2,"dummy"
"5555",0,7,0,7,"dummy"
"5564",0,2,0,2,"dummy"
"5566",2,5,1,8,"dummy"
"5568",0,2,0,2,"dummy"
"5569",3,0,0,3,"dummy"
"5570",28,9,0,37,"dummy"
"5571",0,0,1,1,"dummy"
"5573",1,0,0,1,"dummy"
"5574",2,3,1,6,"dummy"
"5575",0,0,1,1,"dummy"
"5580",1,0,1,2,"dummy"
"5581",1,0,0,1,"dummy"
"5582",16,4,2,22,"dummy"
"5583",0,0,1,1,"dummy"
"5585",4,11,1,16,"dummy"
"5586",0,1,5,6,"dummy"
"5589",4,3,2,9,"dummy"
"5591",2,0,0,2,"dummy"
"5592",2,0,0,2,"dummy"
"5593",0,0,0,0,"dummy"
"5594",0,0,1,1,"dummy"
"5595",0,0,1,1,"dummy"
"5596",1,0,0,1,"dummy"
"5598",0,3,0,3,"dummy"
"5599",3,3,3,9,"dummy"
"5605",0,1,0,1,"dummy"
"5606",1,4,2,7,"dummy"
"5607",0,0,1,1,"dummy"
"5609",0,0,0,0,"dummy"
"5610",0,0,1,1,"dummy"
"5612",0,0,1,1,"dummy"
"5613",0,1,0,1,"dummy"
"5615",0,0,1,1,"dummy"
"5616",0,0,1,1,"dummy"
"5617",0,0,1,1,"dummy"
"5618",9,0,0,9,"dummy"
"5619",2,0,0,2,"dummy"
"5630",0,1,0,1,"dummy"
"5631",0,0,0,0,"dummy"
"5632",3,0,2,5,"dummy"
"5633",0,0,0,0,"dummy"
"5634",0,0,0,0,"dummy"
"5636",0,0,0,0,"dummy"
"5637",0,0,0,0,"dummy"
"5639",0,7,0,7,"dummy"
"5642",0,3,1,4,"dummy"
"5644",0,0,1,1,"dummy"
"5645",0,0,1,1,"dummy"
"5647",5,0,1,6,"dummy"
"5648",0,5,0,5,"dummy"
"5649",4,0,1,5,"dummy"
"5650",0,2,0,2,"dummy"
"5651",0,0,1,1,"dummy"
"5652",0,3,0,3,"dummy"
"5653",5,1,3,9,"dummy"
"5654",3,7,1,11,"dummy"
"5655",0,2,0,2,"dummy"
"5656",0,1,0,1,"dummy"
"5657",2,0,0,2,"dummy"
"5658",0,0,2,2,"dummy"
"5659",0,1,0,1,"dummy"
"5663",0,1,0,1,"dummy"
"5664",0,2,0,2,"dummy"
"5665",0,1,1,2,"dummy"
"5668",0,1,1,2,"dummy"
"5669",0,1,0,1,"dummy"
"5670",0,0,0,0,"dummy"
"5671",0,0,2,2,"dummy"
"5672",5,0,0,5,"dummy"
"5674",0,0,1,1,"dummy"
"5675",0,1,1,2,"dummy"
"5676",0,5,0,5,"dummy"
"5680",1,0,0,1,"dummy"
"5681",0,1,0,1,"dummy"
"5682",0,1,0,1,"dummy"
"5683",0,0,1,1,"dummy"
"5684",0,1,0,1,"dummy"
"5685",1,0,0,1,"dummy"
"5686",0,5,0,5,"dummy"
"5687",0,0,1,1,"dummy"
"5689",3,1,1,5,"dummy"
"5690",0,0,0,0,"dummy"
"5691",0,1,0,1,"dummy"
"5695",0,2,0,2,"dummy"
"5696",0,1,0,1,"dummy"
"5705",1,0,2,3,"dummy"
"5708",0,1,0,1,"dummy"
"5711",0,12,0,12,"dummy"
"5712",0,7,0,7,"dummy"
"5713",5,8,2,15,"dummy"
"5714",1,4,1,6,"dummy"
"5716",0,0,2,2,"dummy"
"5717",0,0,1,1,"dummy"
"5718",0,0,1,1,"dummy"
"5719",0,0,1,1,"dummy"
"5720",0,0,1,1,"dummy"
"5721",0,0,1,1,"dummy"
"5722",0,0,2,2,"dummy"
"5723",0,0,1,1,"dummy"
"5724",0,0,1,1,"dummy"
"5725",0,0,1,1,"dummy"
"5726",0,0,1,1,"dummy"
"5727",0,0,1,1,"dummy"
"5729",0,0,1,1,"dummy"
"5737",6,0,0,6,"dummy"
"5738",2,5,2,9,"dummy"
"5740",0,5,0,5,"dummy"
"5741",0,0,1,1,"dummy"
"5742",1,0,0,1,"dummy"
"5743",0,2,0,2,"dummy"
"5744",0,1,0,1,"dummy"
"5745",0,2,0,2,"dummy"
"5746",21,0,0,21,"dummy"
"5747",0,0,0,0,"dummy"
"5748",4,4,0,8,"dummy"
"5750",0,0,1,1,"dummy"
"5756",0,0,1,1,"dummy"
"5757",0,0,1,1,"dummy"
"5758",0,0,1,1,"dummy"
"5759",0,0,1,1,"dummy"
"5762",1,1,0,2,"dummy"
"5763",0,0,1,1,"dummy"
"5764",0,0,1,1,"dummy"
"5766",10,0,4,14,"dummy"
"5767",0,0,1,1,"dummy"
"5768",0,0,1,1,"dummy"
"5769",0,0,1,1,"dummy"
"5771",0,3,0,3,"dummy"
"5772",0,3,0,3,"dummy"
"5775",9,10,6,25,"dummy"
"5776",0,0,1,1,"dummy"
"5778",0,0,2,2,"dummy"
"5779",1,1,0,2,"dummy"
"5780",1,21,6,28,"dummy"
"5781",2,5,2,9,"dummy"
"5782",2,0,0,2,"dummy"
"5786",0,0,1,1,"dummy"
"5787",0,0,0,0,"dummy"
"5788",0,0,0,0,"dummy"
"5789",0,0,0,0,"dummy"
"5790",0,3,0,3,"dummy"
"5791",0,0,0,0,"dummy"
"5792",4,1,0,5,"dummy"
"5793",0,0,0,0,"dummy"
"5794",1,0,0,1,"dummy"
"5795",0,0,0,0,"dummy"
"5796",0,0,0,0,"dummy"
"5797",0,0,0,0,"dummy"
"5799",0,5,1,6,"dummy"
"5800",7,9,4,20,"dummy"
"5801",0,0,3,3,"dummy"
"5802",1,0,1,2,"dummy"
"5803",0,0,2,2,"dummy"
"5805",1,10,1,12,"dummy"
"5806",0,3,0,3,"dummy"
"5807",0,1,0,1,"dummy"
"5808",6,0,1,7,"dummy"
"5809",0,6,0,6,"dummy"
"5810",0,1,0,1,"dummy"
"5811",0,1,0,1,"dummy"
"5812",0,1,0,1,"dummy"
"5813",0,0,1,1,"dummy"
"5815",0,0,1,1,"dummy"
"5816",1,1,1,3,"dummy"
"5820",0,1,0,1,"dummy"
"5821",0,1,0,1,"dummy"
"5823",5,0,0,5,"dummy"
"5824",0,0,1,1,"dummy"
"5827",2,1,1,4,"dummy"
"5829",0,0,4,4,"dummy"
"5830",1,1,0,2,"dummy"
"5832",4,2,1,7,"dummy"
"5834",0,2,0,2,"dummy"
"5835",0,3,0,3,"dummy"
"5836",4,9,0,13,"dummy"
"5837",0,2,0,2,"dummy"
"5838",0,6,0,6,"dummy"
"5839",0,0,3,3,"dummy"
"5840",0,0,2,2,"dummy"
"5841",3,7,1,11,"dummy"
"5879",0,0,1,1,"dummy"
"5880",0,0,1,1,"dummy"
"5881",0,0,1,1,"dummy"
"5888",0,0,1,1,"dummy"
"5889",0,0,6,6,"dummy"
"5890",2,5,1,8,"dummy"
"5892",0,0,1,1,"dummy"
"5895",1,7,2,10,"dummy"
"5896",0,6,0,6,"dummy"
"5897",1,5,0,6,"dummy"
"5898",0,4,2,6,"dummy"
"5899",2,2,0,4,"dummy"
"5900",0,1,0,1,"dummy"
"5917",0,0,2,2,"dummy"
"5918",1,6,0,7,"dummy"
"5920",0,0,0,0,"dummy"
"5921",0,3,1,4,"dummy"
"5922",0,1,0,1,"dummy"
"5924",0,2,0,2,"dummy"
"5925",0,0,1,1,"dummy"
"5927",1,4,0,5,"dummy"
"5929",0,1,0,1,"dummy"
"5930",1,5,2,8,"dummy"
"5931",0,2,0,2,"dummy"
"5932",2,2,0,4,"dummy"
"5933",3,4,0,7,"dummy"
"5934",0,0,2,2,"dummy"
"5935",5,2,2,9,"dummy"
"5936",0,1,0,1,"dummy"
"5937",2,3,0,5,"dummy"
"5938",1,8,1,10,"dummy"
"5939",6,8,1,15,"dummy"
"5940",0,0,1,1,"dummy"
"5941",0,0,1,1,"dummy"
"5942",12,16,0,28,"dummy"
"5943",0,2,0,2,"dummy"
"5947",0,0,0,0,"dummy"
"5948",0,0,1,1,"dummy"
"5962",0,1,0,1,"dummy"
"5963",0,3,0,3,"dummy"
"5964",0,1,0,1,"dummy"
"5966",1,0,0,1,"dummy"
"5982",0,2,0,2,"dummy"
"5987",39,5,2,46,"dummy"
"5989",0,1,0,1,"dummy"
"5990",0,1,2,3,"dummy"
"5995",0,0,1,1,"dummy"
"5997",2,1,1,4,"dummy"
"5998",0,0,0,0,"dummy"
"5999",0,0,4,4,"dummy"
"6000",0,0,1,1,"dummy"
"6001",8,7,0,15,"dummy"
"6002",0,0,3,3,"dummy"
"6003",0,0,0,0,"dummy"
"6004",0,0,0,0,"dummy"
"6005",0,0,0,0,"dummy"
"6006",0,0,0,0,"dummy"
"6008",0,1,0,1,"dummy"
"6009",0,0,1,1,"dummy"
"6011",1,8,0,9,"dummy"
"6012",9,17,0,26,"dummy"
"6013",6,3,0,9,"dummy"
"6014",2,11,1,14,"dummy"
"6015",4,2,0,6,"dummy"
"6016",4,0,0,4,"dummy"
"6017",0,0,17,17,"dummy"
"6019",0,1,0,1,"dummy"
"6020",0,1,0,1,"dummy"
"6021",12,0,0,12,"dummy"
"6022",2,2,0,4,"dummy"
"6023",22,1,0,23,"dummy"
"6024",0,17,0,17,"dummy"
"6025",6,2,0,8,"dummy"
"6026",0,0,0,0,"dummy"
"6030",2,0,3,5,"dummy"
"6032",0,0,1,1,"dummy"
"6034",0,2,1,3,"dummy"
"6038",0,5,0,5,"dummy"
"6039",4,2,0,6,"dummy"
"6040",0,0,1,1,"dummy"
"6041",0,0,1,1,"dummy"
"6042",1,2,0,3,"dummy"
"6043",6,0,1,7,"dummy"
"6044",2,1,1,4,"dummy"
"6045",1,1,0,2,"dummy"
"6046",0,1,1,2,"dummy"
"6047",0,1,0,1,"dummy"
"6048",1,0,2,3,"dummy"
"6049",1,7,1,9,"dummy"
"6050",2,0,2,4,"dummy"
"6051",3,4,1,8,"dummy"
"6052",0,2,0,2,"dummy"
"6053",0,1,0,1,"dummy"
"6056",0,0,1,1,"dummy"
"6057",1,4,0,5,"dummy"
"6061",0,1,0,1,"dummy"
"6065",2,0,0,2,"dummy"
"6068",0,5,0,5,"dummy"
"6069",0,3,0,3,"dummy"
"6071",0,1,0,1,"dummy"
"6080",0,29,1,30,"dummy"
"6081",7,2,3,12,"dummy"
"6083",0,2,0,2,"dummy"
"6084",1,1,0,2,"dummy"
"6085",0,2,0,2,"dummy"
"6087",1,0,0,1,"dummy"
"6090",6,7,1,14,"dummy"
"6091",1,2,0,3,"dummy"
"6092",1,0,0,1,"dummy"
"6093",0,1,0,1,"dummy"
"6094",0,2,0,2,"dummy"
"6095",2,2,0,4,"dummy"
"6096",1,1,1,3,"dummy"
"6097",0,0,0,0,"dummy"
"6098",0,1,0,1,"dummy"
"6099",0,0,1,1,"dummy"
"6101",1,4,3,8,"dummy"
"6102",0,0,2,2,"dummy"
"6105",0,0,2,2,"dummy"
"6108",3,1,1,5,"dummy"
"6109",0,0,1,1,"dummy"
"6112",2,1,2,5,"dummy"
"6113",0,5,0,5,"dummy"
"6114",5,1,0,6,"dummy"
"6115",0,2,0,2,"dummy"
"6116",0,3,0,3,"dummy"
"6117",0,1,0,1,"dummy"
"6118",0,0,0,0,"dummy"
"6119",2,3,0,5,"dummy"
"6120",2,2,0,4,"dummy"
"6121",1,1,0,2,"dummy"
"6122",0,1,0,1,"dummy"
"6123",0,4,0,4,"dummy"
"6124",0,2,0,2,"dummy"
"6125",3,0,0,3,"dummy"
"6126",0,0,1,1,"dummy"
"6128",1,3,0,4,"dummy"
"6129",2,9,4,15,"dummy"
"6132",0,4,0,4,"dummy"
"6134",0,0,1,1,"dummy"
"6135",0,0,1,1,"dummy"
"6138",2,0,3,5,"dummy"
"6141",0,0,0,0,"dummy"
"6143",1,2,0,3,"dummy"
"6148",1,0,0,1,"dummy"
"6151",0,0,1,1,"dummy"
"6152",0,0,1,1,"dummy"
"6153",0,0,1,1,"dummy"
"6174",0,1,0,1,"dummy"
"6175",1,4,1,6,"dummy"
"6176",8,5,3,16,"dummy"
"6177",2,5,2,9,"dummy"
"6178",0,1,0,1,"dummy"
"6179",3,9,0,12,"dummy"
"6180",19,37,2,58,"dummy"
"6181",0,0,6,6,"dummy"
"6182",0,0,1,1,"dummy"
"6183",0,2,0,2,"dummy"
"6184",0,0,0,0,"dummy"
"6190",0,0,1,1,"dummy"
"6194",0,2,0,2,"dummy"
"6196",0,1,0,1,"dummy"
"6197",1,4,0,5,"dummy"
"6199",12,12,0,24,"dummy"
"6203",0,0,1,1,"dummy"
"6205",0,1,1,2,"dummy"
"6207",0,1,0,1,"dummy"
"6208",0,0,1,1,"dummy"
"6214",1,0,0,1,"dummy"
"6217",0,2,0,2,"dummy"
"6218",0,1,2,3,"dummy"
"6219",0,8,1,9,"dummy"
"6220",0,2,0,2,"dummy"
"6221",2,0,0,2,"dummy"
"6222",0,2,0,2,"dummy"
"6223",0,2,0,2,"dummy"
"6224",0,1,0,1,"dummy"
"6225",1,0,0,1,"dummy"
"6226",12,4,1,17,"dummy"
"6227",0,0,4,4,"dummy"
"6228",2,8,2,12,"dummy"
"6229",1,0,0,1,"dummy"
"6230",0,0,0,0,"dummy"
"6231",1,1,0,2,"dummy"
"6232",1,0,0,1,"dummy"
"6233",0,0,4,4,"dummy"
"6234",0,0,4,4,"dummy"
"6235",0,0,4,4,"dummy"
"6236",0,0,4,4,"dummy"
"6237",0,2,0,2,"dummy"
"6238",0,0,4,4,"dummy"
"6239",0,0,1,1,"dummy"
"6240",0,1,5,6,"dummy"
"6241",0,0,1,1,"dummy"
"6242",0,0,1,1,"dummy"
"6243",0,0,2,2,"dummy"
"6244",0,0,1,1,"dummy"
"6245",0,0,2,2,"dummy"
"6246",0,0,1,1,"dummy"
"6247",0,0,1,1,"dummy"
"6248",0,0,1,1,"dummy"
"6249",0,3,0,3,"dummy"
"6250",3,5,1,9,"dummy"
"6251",0,2,0,2,"dummy"
"6252",0,1,0,1,"dummy"
"6253",0,1,0,1,"dummy"
"6254",0,1,0,1,"dummy"
"6255",1,0,0,1,"dummy"
"6256",23,1,6,30,"dummy"
"6257",0,1,0,1,"dummy"
"6275",0,1,0,1,"dummy"
"6277",1,1,0,2,"dummy"
"6280",0,5,0,5,"dummy"
"6281",1,5,2,8,"dummy"
"6282",0,4,0,4,"dummy"
"6283",1,0,0,1,"dummy"
"6287",1,1,0,2,"dummy"
"6288",1,1,1,3,"dummy"
"6307",8,0,0,8,"dummy"
"6308",0,8,0,8,"dummy"
"6309",0,0,1,1,"dummy"
"6310",0,0,3,3,"dummy"
"6311",0,0,3,3,"dummy"
"6312",0,0,3,3,"dummy"
"6313",0,0,2,2,"dummy"
"6314",0,0,3,3,"dummy"
"6315",8,9,2,19,"dummy"
"6316",0,0,1,1,"dummy"
"6317",0,0,1,1,"dummy"
"6318",0,0,1,1,"dummy"
"6319",2,2,3,7,"dummy"
"6320",0,0,2,2,"dummy"
"6321",2,2,2,6,"dummy"
"6322",2,2,3,7,"dummy"
"6329",0,0,0,0,"dummy"
"6334",0,3,0,3,"dummy"
"6335",2,1,1,4,"dummy"
"6336",0,1,0,1,"dummy"
"6337",1,0,0,1,"dummy"
"6339",0,0,1,1,"dummy"
"6340",0,0,0,0,"dummy"
"6341",0,0,1,1,"dummy"
"6345",6,0,0,6,"dummy"
"6346",2,5,2,9,"dummy"
"6348",0,3,0,3,"dummy"
"6353",18,32,1,51,"dummy"
"6354",9,4,0,13,"dummy"
"6355",3,12,0,15,"dummy"
"6356",41,25,5,71,"dummy"
"6359",0,2,1,3,"dummy"
"6360",1,2,0,3,"dummy"
"6361",9,1,5,15,"dummy"
"6381",0,0,4,4,"dummy"
"6382",2,0,0,2,"dummy"
"6383",0,1,0,1,"dummy"
"6384",0,1,0,1,"dummy"
"6385",1,2,0,3,"dummy"
"6386",1,0,0,1,"dummy"
"6387",0,0,1,1,"dummy"
"6388",2,2,0,4,"dummy"
"6391",0,2,2,4,"dummy"
"6392",2,6,0,8,"dummy"
"6393",3,0,1,4,"dummy"
"6397",0,1,0,1,"dummy"
"6398",0,1,0,1,"dummy"
"6399",0,0,1,1,"dummy"
"6400",0,0,1,1,"dummy"
"6401",0,9,1,10,"dummy"
"6402",0,0,1,1,"dummy"
"6404",0,1,0,1,"dummy"
"6406",2,3,0,5,"dummy"
"6407",0,1,0,1,"dummy"
"6408",1,8,0,9,"dummy"
"6409",0,2,0,2,"dummy"
"6410",0,0,1,1,"dummy"
"6411",0,0,2,2,"dummy"
"6412",0,0,3,3,"dummy"
"6413",0,2,0,2,"dummy"
"6414",0,0,1,1,"dummy"
"6415",0,0,1,1,"dummy"
"6417",0,3,0,3,"dummy"
"6421",1,1,0,2,"dummy"
"6422",3,0,0,3,"dummy"
"6425",2,2,1,5,"dummy"
"6427",13,17,0,30,"dummy"
"6429",0,0,0,0,"dummy"
"6430",0,0,0,0,"dummy"
"6431",0,0,1,1,"dummy"
"6432",0,0,0,0,"dummy"
"6433",0,0,1,1,"dummy"
"6434",0,0,0,0,"dummy"
"6436",6,0,0,6,"dummy"
"6437",2,5,2,9,"dummy"
"6440",0,0,0,0,"dummy"
"6442",0,1,0,1,"dummy"
"6443",0,0,1,1,"dummy"
"6444",0,1,0,1,"dummy"
"6445",2,1,2,5,"dummy"
"6450",6,0,3,9,"dummy"
"6451",0,0,2,2,"dummy"
"6453",3,4,0,7,"dummy"
"6454",4,15,1,20,"dummy"
"6455",0,1,0,1,"dummy"
"6457",0,2,0,2,"dummy"
"6459",0,0,2,2,"dummy"
"6460",0,0,2,2,"dummy"
"6461",0,2,2,4,"dummy"
"6463",0,1,0,1,"dummy"
"6464",3,4,0,7,"dummy"
"6465",5,2,0,7,"dummy"
"6466",1,0,0,1,"dummy"
"6467",2,0,0,2,"dummy"
"6468",1,1,0,2,"dummy"
"6469",1,6,0,7,"dummy"
"6470",1,3,0,4,"dummy"
"6471",1,1,0,2,"dummy"
"6472",5,0,0,5,"dummy"
"6473",5,1,0,6,"dummy"
"6474",1,1,0,2,"dummy"
"6475",2,0,0,2,"dummy"
"6476",1,0,0,1,"dummy"
"6477",0,1,0,1,"dummy"
"6478",1,0,0,1,"dummy"
"6479",4,0,0,4,"dummy"
"6480",3,5,0,8,"dummy"
"6481",0,0,2,2,"dummy"
"6482",0,0,2,2,"dummy"
"6483",0,0,1,1,"dummy"
"6484",0,2,0,2,"dummy"
"6485",2,0,0,2,"dummy"
"6486",0,0,1,1,"dummy"
"6490",0,0,1,1,"dummy"
"6491",0,0,1,1,"dummy"
"6492",0,2,0,2,"dummy"
"6493",2,2,1,5,"dummy"
"6494",0,0,1,1,"dummy"
"6496",0,0,1,1,"dummy"
"6499",2,0,2,4,"dummy"
"6501",2,4,0,6,"dummy"
"6502",0,2,0,2,"dummy"
"6503",0,2,0,2,"dummy"
"6504",10,2,0,12,"dummy"
"6505",0,2,0,2,"dummy"
"6506",0,0,0,0,"dummy"
"6507",0,0,3,3,"dummy"
"6508",0,5,0,5,"dummy"
"6511",0,0,1,1,"dummy"
"6512",0,0,0,0,"dummy"
"6515",0,1,0,1,"dummy"
"6517",2,0,0,2,"dummy"
"6518",0,2,0,2,"dummy"
"6520",0,5,0,5,"dummy"
"6522",1,0,0,1,"dummy"
"6523",0,0,1,1,"dummy"
"6524",0,0,1,1,"dummy"
"6525",0,0,1,1,"dummy"
"6526",0,0,1,1,"dummy"
"6527",0,0,1,1,"dummy"
"6528",0,0,1,1,"dummy"
"6529",0,0,1,1,"dummy"
"6530",0,0,1,1,"dummy"
"6531",0,0,1,1,"dummy"
"6534",0,0,1,1,"dummy"
"6536",0,1,0,1,"dummy"
"6537",2,0,0,2,"dummy"
"6538",0,1,0,1,"dummy"
"6542",0,0,2,2,"dummy"
"6543",0,2,0,2,"dummy"
"6546",0,1,0,1,"dummy"
"6547",1,1,0,2,"dummy"
"6548",0,0,1,1,"dummy"
"6549",0,0,1,1,"dummy"
"6552",0,0,0,0,"dummy"
"6553",1,0,0,1,"dummy"
"6554",0,1,0,1,"dummy"
"6555",1,0,0,1,"dummy"
"6556",0,0,1,1,"dummy"
"6557",0,0,1,1,"dummy"
"6558",1,8,3,12,"dummy"
"6559",0,0,0,0,"dummy"
"6566",0,0,0,0,"dummy"
"6567",0,0,1,1,"dummy"
"6568",0,0,1,1,"dummy"
"6569",4,2,0,6,"dummy"
"6570",0,0,0,0,"dummy"
"6573",0,0,2,2,"dummy"
"6601",0,1,0,1,"dummy"
"6602",0,1,0,1,"dummy"
"6603",0,1,0,1,"dummy"
"6604",0,1,0,1,"dummy"
"6605",0,0,1,1,"dummy"
"6606",0,0,1,1,"dummy"
"6607",0,0,1,1,"dummy"
"6608",0,7,1,8,"dummy"
"6610",0,1,0,1,"dummy"
"6611",0,3,0,3,"dummy"
"6612",3,0,0,3,"dummy"
"6613",0,1,1,2,"dummy"
"6614",1,0,0,1,"dummy"
"6616",0,1,0,1,"dummy"
"6618",0,3,0,3,"dummy"
"6619",0,0,0,0,"dummy"
"6620",1,7,0,8,"dummy"
"6621",0,0,2,2,"dummy"
"6622",2,2,1,5,"dummy"
"6625",0,0,1,1,"dummy"
"6627",0,2,0,2,"dummy"
"6629",0,1,0,1,"dummy"
"6630",1,0,0,1,"dummy"
"6631",0,1,0,1,"dummy"
"6632",0,1,0,1,"dummy"
"6634",0,0,1,1,"dummy"
"6636",2,4,0,6,"dummy"
"6637",0,11,0,11,"dummy"
"6638",11,0,0,11,"dummy"
"6639",0,2,0,2,"dummy"
"6642",1,0,3,4,"dummy"
"6647",0,0,0,0,"dummy"
"6648",0,0,0,0,"dummy"
"6650",2,4,0,6,"dummy"
"6651",0,2,0,2,"dummy"
"6652",0,2,0,2,"dummy"
"6653",10,2,0,12,"dummy"
"6654",0,2,0,2,"dummy"
"6655",0,0,0,0,"dummy"
"6656",0,0,3,3,"dummy"
"6658",0,7,3,10,"dummy"
"6659",3,1,0,4,"dummy"
"6661",0,1,0,1,"dummy"
"6662",0,0,1,1,"dummy"
"6663",0,0,2,2,"dummy"
"6664",0,0,1,1,"dummy"
"6665",4,4,0,8,"dummy"
"6666",0,1,0,1,"dummy"
"6668",0,0,2,2,"dummy"
"6669",0,0,1,1,"dummy"
"6671",0,0,0,0,"dummy"
"6672",0,0,0,0,"dummy"
"6673",1,4,1,6,"dummy"
"6676",0,0,3,3,"dummy"
"6677",2,2,6,10,"dummy"
"6678",0,0,1,1,"dummy"
"6679",14,7,8,29,"dummy"
"6680",0,0,1,1,"dummy"
"6681",3,0,1,4,"dummy"
"6682",0,2,0,2,"dummy"
"6683",0,2,1,3,"dummy"
"6684",0,1,0,1,"dummy"
"6685",2,2,3,7,"dummy"
"6690",0,1,0,1,"dummy"
"6716",2,2,0,4,"dummy"
"6717",0,0,2,2,"dummy"
"6718",0,1,0,1,"dummy"
"6719",0,3,2,5,"dummy"
"6720",0,1,0,1,"dummy"
"6721",1,3,0,4,"dummy"
"6722",2,1,1,4,"dummy"
"6723",2,1,0,3,"dummy"
"6724",2,6,0,8,"dummy"
"6725",1,6,2,9,"dummy"
"6726",4,0,0,4,"dummy"
"6727",0,0,1,1,"dummy"
"6745",0,2,0,2,"dummy"
"6746",0,3,0,3,"dummy"
"6747",0,2,0,2,"dummy"
"6752",0,0,0,0,"dummy"
"6754",0,6,1,7,"dummy"
"6756",0,3,0,3,"dummy"
"6757",0,1,0,1,"dummy"
"6759",9,5,4,18,"dummy"
"6760",0,0,0,0,"dummy"
"6764",1,0,1,2,"dummy"
"6765",0,1,0,1,"dummy"
"6766",1,0,0,1,"dummy"
"6768",0,0,0,0,"dummy"
"6770",4,0,0,4,"dummy"
"6771",0,0,1,1,"dummy"
"6772",0,0,1,1,"dummy"
"6773",0,0,1,1,"dummy"
"6774",0,2,2,4,"dummy"
"6776",0,0,3,3,"dummy"
"6777",2,2,6,10,"dummy"
"6778",0,0,1,1,"dummy"
"6779",14,7,8,29,"dummy"
"6780",0,0,1,1,"dummy"
"6781",3,0,1,4,"dummy"
"6782",0,2,0,2,"dummy"
"6783",0,2,1,3,"dummy"
"6784",0,1,0,1,"dummy"
"6785",2,2,3,7,"dummy"
"6787",0,0,0,0,"dummy"
"6788",0,1,0,1,"dummy"
"6790",0,0,3,3,"dummy"
"6791",0,0,3,3,"dummy"
"6792",0,0,2,2,"dummy"
"6793",3,7,3,13,"dummy"
"6798",0,1,0,1,"dummy"
"6800",1,0,0,1,"dummy"
"6802",0,0,1,1,"dummy"
"6803",0,0,2,2,"dummy"
"6804",2,1,0,3,"dummy"
"6806",0,1,0,1,"dummy"
"6826",0,2,0,2,"dummy"
"6832",0,2,1,3,"dummy"
"6834",3,5,1,9,"dummy"
"6835",3,2,1,6,"dummy"
"6836",7,7,6,20,"dummy"
"6837",0,0,0,0,"dummy"
"6838",0,4,1,5,"dummy"
"6839",0,0,1,1,"dummy"
"6840",0,0,0,0,"dummy"
"6846",0,1,0,1,"dummy"
"6847",1,0,5,6,"dummy"
"6848",0,0,1,1,"dummy"
"6849",1,1,0,2,"dummy"
"6850",0,0,1,1,"dummy"
"6851",0,0,1,1,"dummy"
"6852",2,0,1,3,"dummy"
"6853",0,3,0,3,"dummy"
"6885",1,27,0,28,"dummy"
"6886",3,6,2,11,"dummy"
"6887",0,3,1,4,"dummy"
"6888",0,1,0,1,"dummy"
"6889",11,13,1,25,"dummy"
"6890",5,4,5,14,"dummy"
"6891",3,12,2,17,"dummy"
"6892",0,1,0,1,"dummy"
"6894",3,2,1,6,"dummy"
"6895",0,0,2,2,"dummy"
"6897",0,0,1,1,"dummy"
"6898",0,0,1,1,"dummy"
"6899",1,0,0,1,"dummy"
"6900",0,2,0,2,"dummy"
"6901",0,1,0,1,"dummy"
"6904",0,0,2,2,"dummy"
"6911",2,22,0,24,"dummy"
"6913",1,3,0,4,"dummy"
"6914",0,1,0,1,"dummy"
"6916",5,10,1,16,"dummy"
"6917",0,0,2,2,"dummy"
"6918",9,18,3,30,"dummy"
"6919",0,2,0,2,"dummy"
"6920",5,5,2,12,"dummy"
"6921",5,5,2,12,"dummy"
"6922",0,0,1,1,"dummy"
"6923",0,0,2,2,"dummy"
"6924",5,3,0,8,"dummy"
"6925",17,1,0,18,"dummy"
"6926",0,0,1,1,"dummy"
"6927",1,1,0,2,"dummy"
"6928",1,17,2,20,"dummy"
"6932",0,0,1,1,"dummy"
"6936",3,2,0,5,"dummy"
"6937",2,5,2,9,"dummy"
"6938",1,0,0,1,"dummy"
"6939",1,0,1,2,"dummy"
"6940",6,0,0,6,"dummy"
"6941",0,1,0,1,"dummy"
"6942",2,0,1,3,"dummy"
"6943",0,0,1,1,"dummy"
"6944",6,9,0,15,"dummy"
"6945",1,0,4,5,"dummy"
"6946",0,0,3,3,"dummy"
"6948",1,0,0,1,"dummy"
"6949",0,0,1,1,"dummy"
"6950",0,1,0,1,"dummy"
"6952",1,2,0,3,"dummy"
"6953",0,1,0,1,"dummy"
"6954",1,1,1,3,"dummy"
"6955",0,0,1,1,"dummy"
"6956",0,0,1,1,"dummy"
"6957",0,0,1,1,"dummy"
"6959",0,1,0,1,"dummy"
"6960",0,1,0,1,"dummy"
"6962",0,0,1,1,"dummy"
"6965",0,1,1,2,"dummy"
"6967",1,3,0,4,"dummy"
"6969",0,3,0,3,"dummy"
"6971",0,0,0,0,"dummy"
"6975",0,0,1,1,"dummy"
"6976",0,0,1,1,"dummy"
"6977",0,1,0,1,"dummy"
"6980",3,2,0,5,"dummy"
"6981",0,0,1,1,"dummy"
"6982",0,0,3,3,"dummy"
"6983",0,0,1,1,"dummy"
"6984",0,0,2,2,"dummy"
"6987",0,0,1,1,"dummy"
"6988",0,0,1,1,"dummy"
"6989",2,1,1,4,"dummy"
"6990",0,0,1,1,"dummy"
"6992",0,1,0,1,"dummy"
"6994",3,3,2,8,"dummy"
"6995",0,0,1,1,"dummy"
"6996",1,2,0,3,"dummy"
"6997",0,1,0,1,"dummy"
"6998",0,0,3,3,"dummy"
"6999",0,0,1,1,"dummy"
"7000",0,1,0,1,"dummy"
"7001",0,1,4,5,"dummy"
"7002",0,0,2,2,"dummy"
"7003",0,0,1,1,"dummy"
"7004",0,0,1,1,"dummy"
"7005",0,0,1,1,"dummy"
"7009",0,4,0,4,"dummy"
"7024",0,2,0,2,"dummy"
"7025",0,2,0,2,"dummy"
"7026",0,1,0,1,"dummy"
"7027",0,2,0,2,"dummy"
"7028",0,1,1,2,"dummy"
"7029",7,6,0,13,"dummy"
"7031",0,3,0,3,"dummy"
"7032",1,1,0,2,"dummy"
"7033",0,1,0,1,"dummy"
"7034",0,0,1,1,"dummy"
"7035",0,2,0,2,"dummy"
"7036",0,0,1,1,"dummy"
"7038",0,1,0,1,"dummy"
"7040",4,0,2,6,"dummy"
"7041",0,4,3,7,"dummy"
"7042",1,1,0,2,"dummy"
"7046",0,1,0,1,"dummy"
"7047",0,0,2,2,"dummy"
"7048",0,0,1,1,"dummy"
"7050",0,0,1,1,"dummy"
"7051",0,2,1,3,"dummy"
"7052",1,0,0,1,"dummy"
"7054",13,0,1,14,"dummy"
"7055",0,1,0,1,"dummy"
"7056",0,0,1,1,"dummy"
"7057",0,1,0,1,"dummy"
"7058",0,0,1,1,"dummy"
"7060",0,0,1,1,"dummy"
"7061",0,0,1,1,"dummy"
"7065",1,0,0,1,"dummy"
"7066",0,1,0,1,"dummy"
"7067",0,0,2,2,"dummy"
"7068",0,1,0,1,"dummy"
"7072",0,0,0,0,"dummy"
"7073",0,1,0,1,"dummy"
"7075",0,0,0,0,"dummy"
"7076",0,3,0,3,"dummy"
"7077",0,1,0,1,"dummy"
"7078",0,1,0,1,"dummy"
"7079",0,2,0,2,"dummy"
"7081",0,0,1,1,"dummy"
"7082",0,0,3,3,"dummy"
"7083",0,1,0,1,"dummy"
"7084",1,0,1,2,"dummy"
"7085",0,0,4,4,"dummy"
"7086",2,1,4,7,"dummy"
"7087",0,0,1,1,"dummy"
"7088",1,0,1,2,"dummy"
"7089",0,1,0,1,"dummy"
"7092",0,0,1,1,"dummy"
"7093",0,0,4,4,"dummy"
"7094",3,1,0,4,"dummy"
"7117",0,1,1,2,"dummy"
"7119",0,0,1,1,"dummy"
"7120",0,0,1,1,"dummy"
"7121",0,0,1,1,"dummy"
"7122",0,0,1,1,"dummy"
"7123",0,0,1,1,"dummy"
"7124",0,0,0,0,"dummy"
"7125",0,0,1,1,"dummy"
"7126",0,0,1,1,"dummy"
"7127",0,0,1,1,"dummy"
"7128",0,0,1,1,"dummy"
"7129",0,0,1,1,"dummy"
"7130",0,0,1,1,"dummy"
"7131",0,0,1,1,"dummy"
"7132",0,0,1,1,"dummy"
"7133",0,0,1,1,"dummy"
"7134",0,0,1,1,"dummy"
"7135",0,0,1,1,"dummy"
"7136",0,0,1,1,"dummy"
"7137",0,0,1,1,"dummy"
"7138",0,0,1,1,"dummy"
"7139",0,0,1,1,"dummy"
"7140",0,0,1,1,"dummy"
"7151",0,0,1,1,"dummy"
"7152",0,0,1,1,"dummy"
"7157",1,6,15,22,"dummy"
"7158",7,7,2,16,"dummy"
"7159",13,1,2,16,"dummy"
"7160",6,9,2,17,"dummy"
"7164",1,1,0,2,"dummy"
"7166",1,1,1,3,"dummy"
"7167",0,1,1,2,"dummy"
"7168",0,0,2,2,"dummy"
"7169",0,1,0,1,"dummy"
"7171",2,5,2,9,"dummy"
"7178",2,3,1,6,"dummy"
"7179",0,0,2,2,"dummy"
"7180",0,0,2,2,"dummy"
"7183",6,13,0,19,"dummy"
"7184",5,0,3,8,"dummy"
"7185",4,7,1,12,"dummy"
"7186",2,1,2,5,"dummy"
"7188",0,0,1,1,"dummy"
"7190",8,1,1,10,"dummy"
"7191",0,0,1,1,"dummy"
"7192",0,1,0,1,"dummy"
"7193",0,0,1,1,"dummy"
"7195",1,0,1,2,"dummy"
"7198",2,3,0,5,"dummy"
"7199",59,4,0,63,"dummy"
"7200",4,4,1,9,"dummy"
"7201",0,3,0,3,"dummy"
"7202",2,2,0,4,"dummy"
"7204",0,0,0,0,"dummy"
"7205",7,0,2,9,"dummy"
"7206",2,0,3,5,"dummy"
"7207",0,0,2,2,"dummy"
"7208",0,6,0,6,"dummy"
"7210",0,1,1,2,"dummy"
"7220",0,0,1,1,"dummy"
"7222",21,14,7,42,"dummy"
"7224",0,6,1,7,"dummy"
"7225",2,2,0,4,"dummy"
"7233",0,2,0,2,"dummy"
"7234",1,0,1,2,"dummy"
"7237",0,2,1,3,"dummy"
"7238",0,2,1,3,"dummy"
"7239",1,0,0,1,"dummy"
"7240",3,0,3,6,"dummy"
"7242",0,5,0,5,"dummy"
"7243",5,3,0,8,"dummy"
"7244",0,3,0,3,"dummy"
"7245",0,0,2,2,"dummy"
"7246",0,3,0,3,"dummy"
"7247",0,2,0,2,"dummy"
"7248",3,0,0,3,"dummy"
"7249",0,0,0,0,"dummy"
"7250",0,7,2,9,"dummy"
"7254",2,9,0,11,"dummy"
"7255",0,0,1,1,"dummy"
"7258",2,35,0,37,"dummy"
"7259",37,2,1,40,"dummy"
"7260",0,0,1,1,"dummy"
"7262",0,0,1,1,"dummy"
"7264",1,0,0,1,"dummy"
"7266",0,0,1,1,"dummy"
"7267",0,1,0,1,"dummy"
"7274",0,1,0,1,"dummy"
"7275",0,1,1,2,"dummy"
"7276",1,0,2,3,"dummy"
"7277",0,0,1,1,"dummy"
"7279",2,4,0,6,"dummy"
"7280",0,2,0,2,"dummy"
"7281",0,2,0,2,"dummy"
"7282",10,2,0,12,"dummy"
"7283",0,2,0,2,"dummy"
"7284",0,0,0,0,"dummy"
"7285",0,0,3,3,"dummy"
"7286",0,5,0,5,"dummy"
"7287",1,0,1,2,"dummy"
"7292",0,2,0,2,"dummy"
"7296",4,0,0,4,"dummy"
"7297",2,0,0,2,"dummy"
"7289",0,3,0,3,"dummy"
"7290",2,15,2,19,"dummy"
"7294",0,0,0,0,"dummy"
"7322",1,0,0,1,"dummy"
"7323",0,0,0,0,"dummy"
"7326",1,0,0,1,"dummy"
"7327",0,0,0,0,"dummy"
"7363",2,4,0,6,"dummy"
"7365",0,0,1,1,"dummy"
"7367",0,1,0,1,"dummy"
"7368",0,1,0,1,"dummy"
"7369",0,2,0,2,"dummy"
"7370",0,9,0,9,"dummy"
"7371",2,0,0,2,"dummy"
"7372",0,5,1,6,"dummy"
"7373",3,5,1,9,"dummy"
"7374",4,2,1,7,"dummy"
"7375",1,0,0,1,"dummy"
"7376",0,2,0,2,"dummy"
"7377",0,2,0,2,"dummy"
"7378",0,5,1,6,"dummy"
"7379",0,1,0,1,"dummy"
"7381",3,0,3,6,"dummy"
"7382",3,0,0,3,"dummy"
"7383",0,3,1,4,"dummy"
"7384",0,0,1,1,"dummy"
"7385",0,6,2,8,"dummy"
"7387",0,1,0,1,"dummy"
"7389",0,0,1,1,"dummy"
"7392",7,5,0,12,"dummy"
"7394",0,1,0,1,"dummy"
"7396",0,0,1,1,"dummy"
"7397",0,2,0,2,"dummy"
"7398",0,0,0,0,"dummy"
"7399",2,0,0,2,"dummy"
"7400",0,0,1,1,"dummy"
"7402",0,1,0,1,"dummy"
"7403",1,0,0,1,"dummy"
"7404",0,0,0,0,"dummy"
"7405",0,0,0,0,"dummy"
"7407",0,0,1,1,"dummy"
"7408",0,0,1,1,"dummy"
"7411",1,6,0,7,"dummy"
"7412",2,3,0,5,"dummy"
"7413",0,2,0,2,"dummy"
"7415",0,0,1,1,"dummy"
"7416",0,0,1,1,"dummy"
"7422",9,1,0,10,"dummy"
"7425",0,1,0,1,"dummy"
"7430",0,1,0,1,"dummy"
"7431",0,2,0,2,"dummy"
"7432",5,4,1,10,"dummy"
"7433",0,1,0,1,"dummy"
"7434",0,4,1,5,"dummy"
"7436",3,4,0,7,"dummy"
"7437",0,2,0,2,"dummy"
"7438",0,2,0,2,"dummy"
"7439",0,0,1,1,"dummy"
"7441",0,1,0,1,"dummy"
"7442",0,2,0,2,"dummy"
"7443",0,2,0,2,"dummy"
"7444",0,1,0,1,"dummy"
"7445",0,0,1,1,"dummy"
"7446",0,0,1,1,"dummy"
"7447",1,0,0,1,"dummy"
"7448",12,10,3,25,"dummy"
"7449",1,0,0,1,"dummy"
"7450",0,0,0,0,"dummy"
"7503",1,1,0,2,"dummy"
"7504",0,7,1,8,"dummy"
"7505",7,0,1,8,"dummy"
"7506",0,5,4,9,"dummy"
"7507",0,1,0,1,"dummy"
"7521",0,13,0,13,"dummy"
"7522",2,3,0,5,"dummy"
"7523",0,1,0,1,"dummy"
"7524",1,0,0,1,"dummy"
"7525",0,1,0,1,"dummy"
"7526",2,4,1,7,"dummy"
"7534",5,8,4,17,"dummy"
"7535",5,7,2,14,"dummy"
"7536",0,2,0,2,"dummy"
"7537",0,1,0,1,"dummy"
"7542",0,2,0,2,"dummy"
"7550",1,0,2,3,"dummy"
"7555",2,0,0,2,"dummy"
"7556",0,1,0,1,"dummy"
"7557",0,1,0,1,"dummy"
"7558",1,0,0,1,"dummy"
"7559",0,0,1,1,"dummy"
"7560",0,1,0,1,"dummy"
"7563",0,5,0,5,"dummy"
"7564",1,5,0,6,"dummy"
"7565",3,2,2,7,"dummy"
"7566",4,14,0,18,"dummy"
"7567",2,3,1,6,"dummy"
"7568",3,2,1,6,"dummy"
"7569",5,0,1,6,"dummy"
"7574",0,7,1,8,"dummy"
"7575",0,7,1,8,"dummy"
"7580",0,0,1,1,"dummy"
"7581",0,0,0,0,"dummy"
"7582",0,7,0,7,"dummy"
"7583",0,1,0,1,"dummy"
"7452",0,0,0,0,"dummy"
"7453",3,13,0,16,"dummy"
"7454",0,1,0,1,"dummy"
"7455",0,0,1,1,"dummy"
"7456",0,0,1,1,"dummy"
"7457",0,0,1,1,"dummy"
"7458",1,6,1,8,"dummy"
"7459",0,0,0,0,"dummy"
"7460",0,0,1,1,"dummy"
"7461",2,3,3,8,"dummy"
"7462",0,1,0,1,"dummy"
"7463",0,0,1,1,"dummy"
"7464",0,0,1,1,"dummy"
"7467",0,1,0,1,"dummy"
"7468",0,2,0,2,"dummy"
"7469",0,0,0,0,"dummy"
"7470",10,3,0,13,"dummy"
"7471",0,2,1,3,"dummy"
"7496",5,11,1,17,"dummy"
"7497",3,11,0,14,"dummy"
"7498",8,2,4,14,"dummy"
"7499",0,2,0,2,"dummy"
"7500",1,6,0,7,"dummy"
"7501",0,2,0,2,"dummy"
"7509",0,0,0,0,"dummy"
"7510",0,0,0,0,"dummy"
"7511",0,1,0,1,"dummy"
"7512",0,3,0,3,"dummy"
"7513",1,2,0,3,"dummy"
"7514",0,1,0,1,"dummy"
"7515",1,0,0,1,"dummy"
"7516",0,5,2,7,"dummy"
"7517",1,0,3,4,"dummy"
"7518",0,3,0,3,"dummy"
"7519",0,0,1,1,"dummy"
"7528",2,3,3,8,"dummy"
"7529",0,0,2,2,"dummy"
"7530",3,1,0,4,"dummy"
"7531",0,1,0,1,"dummy"
"7532",0,1,0,1,"dummy"
"7546",0,0,0,0,"dummy"
"7547",0,0,0,0,"dummy"
"7548",1,0,1,2,"dummy"
"7571",1,9,2,12,"dummy"
"7572",0,1,0,1,"dummy"
"7587",3,5,1,9,"dummy"
"7716",0,0,1,1,"dummy"
"7717",1,0,0,1,"dummy"
"7722",0,0,0,0,"dummy"
"7768",0,2,0,2,"dummy"
"7769",0,0,1,1,"dummy"
"7770",2,3,0,5,"dummy"
"7784",2,1,0,3,"dummy"
"7785",3,2,1,6,"dummy"
"7786",0,3,0,3,"dummy"
"7791",2,3,1,6,"dummy"
"7792",0,0,1,1,"dummy"
"7797",0,0,1,1,"dummy"
"7798",0,0,2,2,"dummy"
"7799",0,0,2,2,"dummy"
"7800",0,0,2,2,"dummy"
"7724",0,0,1,1,"dummy"
"7729",0,0,1,1,"dummy"
"7730",0,3,1,4,"dummy"
"7752",3,5,3,11,"dummy"
"7753",2,3,0,5,"dummy"
"7754",3,1,0,4,"dummy"
"7755",0,0,2,2,"dummy"
"7756",3,6,2,11,"dummy"
"7757",0,0,0,0,"dummy"
"7758",1,0,0,1,"dummy"
"7759",0,2,0,2,"dummy"
"7760",2,2,0,4,"dummy"
"7761",0,1,0,1,"dummy"
"7762",2,0,0,2,"dummy"
"7765",0,0,3,3,"dummy"
"7766",0,0,0,0,"dummy"
"7788",0,4,0,4,"dummy"
"7789",0,0,0,0,"dummy"
"7794",0,0,2,2,"dummy"
"7795",0,0,1,1,"dummy"
"7802",2,2,1,5,"dummy"
"7803",2,0,0,2,"dummy"
"7804",3,0,3,6,"dummy"
"7805",0,1,0,1,"dummy"
"7806",1,2,0,3,"dummy"
"7807",0,0,0,0,"dummy"
"7808",0,2,4,6,"dummy"
"7809",2,0,0,2,"dummy"
"7827",1,2,1,4,"dummy"
"7828",1,6,3,10,"dummy"
"7829",0,1,0,1,"dummy"
"7834",0,2,0,2,"dummy"
"7842",2,14,5,21,"dummy"
"7843",0,1,0,1,"dummy"
"7844",0,0,2,2,"dummy"
"7845",0,2,0,2,"dummy"
"7846",0,1,0,1,"dummy"
"7858",9,13,20,42,"dummy"
"7866",1,9,0,10,"dummy"
"7872",0,0,0,0,"dummy"
"7873",5,5,0,10,"dummy"
"7874",12,1,0,13,"dummy"
"7875",0,2,0,2,"dummy"
"7876",1,0,0,1,"dummy"
"7877",0,1,2,3,"dummy"
"7878",1,0,0,1,"dummy"
"7879",0,0,2,2,"dummy"
"7880",5,2,4,11,"dummy"
"7881",0,1,0,1,"dummy"
"7882",0,1,0,1,"dummy"
"7883",0,0,2,2,"dummy"
"7884",17,25,0,42,"dummy"
"7885",0,0,0,0,"dummy"
"7886",0,0,0,0,"dummy"
"7887",5,5,0,10,"dummy"
"7888",0,0,0,0,"dummy"
"7889",0,0,2,2,"dummy"
"7890",5,5,0,10,"dummy"
"7904",0,22,0,22,"dummy"
"7905",0,2,0,2,"dummy"
"7906",18,11,5,34,"dummy"
"7907",0,2,0,2,"dummy"
"7910",2,3,0,5,"dummy"
"7911",3,4,2,9,"dummy"
"7946",0,1,0,1,"dummy"
"7947",0,1,0,1,"dummy"
"7948",0,6,0,6,"dummy"
"7951",5,5,0,10,"dummy"
"7952",0,2,0,2,"dummy"
"7953",1,0,1,2,"dummy"
"7956",0,0,3,3,"dummy"
"7811",0,3,0,3,"dummy"
"7812",0,1,0,1,"dummy"
"7815",0,0,1,1,"dummy"
"7816",2,5,0,7,"dummy"
"7817",2,8,7,17,"dummy"
"7820",2,14,0,16,"dummy"
"7821",0,0,1,1,"dummy"
"7822",0,1,0,1,"dummy"
"7825",0,0,1,1,"dummy"
"7848",0,0,1,1,"dummy"
"7849",0,0,2,2,"dummy"
"7850",3,6,1,10,"dummy"
"7863",2,3,1,6,"dummy"
"7864",0,2,0,2,"dummy"
"7917",0,0,1,1,"dummy"
"7928",0,0,2,2,"dummy"
"7929",0,0,1,1,"dummy"
"7930",0,0,1,1,"dummy"
"7931",0,0,1,1,"dummy"
"7932",4,1,1,6,"dummy"
"7933",0,0,2,2,"dummy"
"7934",0,0,1,1,"dummy"
"7935",0,0,1,1,"dummy"
"7936",0,0,1,1,"dummy"
"7937",0,0,1,1,"dummy"
"7938",0,0,1,1,"dummy"
"7939",0,0,2,2,"dummy"
"7940",0,0,1,1,"dummy"
"7941",0,0,1,1,"dummy"
"7942",0,0,1,1,"dummy"
"7958",2,7,0,9,"dummy"
"7959",13,16,3,32,"dummy"
"7960",3,2,0,5,"dummy"
"7969",1,1,6,8,"dummy"
"7970",1,2,1,4,"dummy"
"7971",1,1,0,2,"dummy"
"7974",0,2,0,2,"dummy"
"7978",6,7,1,14,"dummy"
"7979",1,2,0,3,"dummy"
"7980",1,0,0,1,"dummy"
"7981",0,1,0,1,"dummy"
"7982",0,2,0,2,"dummy"
"7983",2,2,0,4,"dummy"
"7984",1,1,1,3,"dummy"
"7985",0,0,0,0,"dummy"
"7986",0,1,0,1,"dummy"
"7987",0,0,1,1,"dummy"
"7997",2,3,0,5,"dummy"
"7998",0,0,1,1,"dummy"
"7999",0,4,2,6,"dummy"
"8016",7,0,1,8,"dummy"
"8017",0,0,0,0,"dummy"
"8023",5,0,2,7,"dummy"
"8024",0,1,0,1,"dummy"
"8025",2,2,0,4,"dummy"
"8028",0,0,0,0,"dummy"
"8029",1,3,0,4,"dummy"
"8030",3,1,0,4,"dummy"
"8031",0,1,0,1,"dummy"
"8032",0,1,0,1,"dummy"
"8033",0,2,0,2,"dummy"
"8034",0,5,0,5,"dummy"
"8035",1,1,0,2,"dummy"
"8036",0,1,0,1,"dummy"
"8037",2,2,0,4,"dummy"
"8038",13,27,5,45,"dummy"
"8039",9,4,2,15,"dummy"
"8040",25,13,14,52,"dummy"
"7962",0,1,2,3,"dummy"
"7963",0,0,0,0,"dummy"
"7964",0,1,0,1,"dummy"
"7965",4,0,2,6,"dummy"
"7966",1,0,0,1,"dummy"
"7967",0,0,0,0,"dummy"
"7976",0,4,0,4,"dummy"
"7991",1,4,0,5,"dummy"
"7994",0,0,1,1,"dummy"
"7995",0,2,0,2,"dummy"
"8001",1,1,1,3,"dummy"
"8002",0,0,1,1,"dummy"
"8003",0,1,0,1,"dummy"
"8006",1,0,0,1,"dummy"
"8007",0,1,0,1,"dummy"
"8008",0,1,0,1,"dummy"
"8009",15,0,1,16,"dummy"
"8010",0,0,1,1,"dummy"
"8011",0,13,0,13,"dummy"
"8012",13,0,0,13,"dummy"
"8013",0,0,0,0,"dummy"
"8014",0,3,0,3,"dummy"
"8019",0,0,1,1,"dummy"
"8020",0,1,0,1,"dummy"
"8021",0,0,1,1,"dummy"
"8046",2,2,0,4,"dummy"
"8047",0,1,1,2,"dummy"
"8048",0,1,1,2,"dummy"
"8049",0,1,0,1,"dummy"
"8050",0,4,1,5,"dummy"
"8051",0,0,1,1,"dummy"
"8052",1,0,0,1,"dummy"
"8053",0,1,0,1,"dummy"
"8061",0,1,0,1,"dummy"
"8062",1,1,0,2,"dummy"
"8075",0,2,0,2,"dummy"
"8076",2,0,0,2,"dummy"
"8077",0,2,0,2,"dummy"
"8078",2,0,0,2,"dummy"
"8079",0,2,0,2,"dummy"
"8080",0,0,0,0,"dummy"
"8081",0,0,0,0,"dummy"
"8087",0,1,0,1,"dummy"
"8088",0,0,1,1,"dummy"
"8089",2,2,1,5,"dummy"
"8122",0,0,3,3,"dummy"
"8123",0,0,1,1,"dummy"
"8124",0,0,1,1,"dummy"
"8125",0,0,0,0,"dummy"
"8126",0,0,1,1,"dummy"
"8127",0,5,0,5,"dummy"
"8128",7,1,1,9,"dummy"
"8129",0,2,1,3,"dummy"
"8130",1,5,0,6,"dummy"
"8131",0,0,4,4,"dummy"
"8132",22,4,1,27,"dummy"
"8133",0,0,0,0,"dummy"
"8147",1,3,3,7,"dummy"
"8148",6,22,4,32,"dummy"
"8149",10,7,1,18,"dummy"
"8162",0,1,1,2,"dummy"
"8167",3,28,0,31,"dummy"
"8174",1,1,1,3,"dummy"
"8179",3,0,0,3,"dummy"
"8194",0,1,0,1,"dummy"
"8195",2,0,1,3,"dummy"
"8196",0,6,1,7,"dummy"
"8197",1,0,0,1,"dummy"
"8198",9,0,0,9,"dummy"
"8041",3,2,0,5,"dummy"
"8042",1,1,0,2,"dummy"
"8043",0,0,0,0,"dummy"
"8044",25,19,2,46,"dummy"
"8055",0,0,0,0,"dummy"
"8056",0,0,0,0,"dummy"
"8057",0,0,0,0,"dummy"
"8058",0,0,0,0,"dummy"
"8059",0,0,0,0,"dummy"
"8064",2,3,0,5,"dummy"
"8065",3,2,0,5,"dummy"
"8066",0,1,0,1,"dummy"
"8067",0,1,0,1,"dummy"
"8068",1,2,0,3,"dummy"
"8069",0,1,0,1,"dummy"
"8070",0,3,0,3,"dummy"
"8083",1,2,2,5,"dummy"
"8091",5,6,0,11,"dummy"
"8143",0,1,1,2,"dummy"
"8144",0,0,5,5,"dummy"
"8145",0,0,3,3,"dummy"
"8151",0,1,0,1,"dummy"
"8154",0,0,1,1,"dummy"
"8155",2,0,1,3,"dummy"
"8158",4,6,2,12,"dummy"
"8164",1,0,0,1,"dummy"
"8165",2,2,3,7,"dummy"
"8169",0,0,1,1,"dummy"
"8172",0,0,1,1,"dummy"
"8181",0,0,1,1,"dummy"
"8182",0,0,1,1,"dummy"
"8183",2,0,0,2,"dummy"
"8184",0,0,1,1,"dummy"
"8185",2,4,1,7,"dummy"
"8186",0,0,0,0,"dummy"
"8187",1,0,0,1,"dummy"
"8188",0,7,1,8,"dummy"
"8189",0,0,4,4,"dummy"
"8192",0,0,1,1,"dummy"
"8212",0,0,1,1,"dummy"
"8213",0,0,1,1,"dummy"
"8215",0,1,1,2,"dummy"
"8216",0,1,3,4,"dummy"
"8220",13,29,2,44,"dummy"
"8221",0,2,0,2,"dummy"
"8222",0,0,0,0,"dummy"
"8223",3,1,1,5,"dummy"
"8224",0,0,2,2,"dummy"
"8228",0,0,1,1,"dummy"
"8231",3,28,0,31,"dummy"
"8233",0,0,1,1,"dummy"
"8234",0,0,1,1,"dummy"
"8236",0,0,1,1,"dummy"
"8238",0,0,0,0,"dummy"
"8239",0,0,1,1,"dummy"
"8240",3,0,0,3,"dummy"
"8241",0,0,1,1,"dummy"
"8242",0,1,0,1,"dummy"
"8243",0,0,0,0,"dummy"
"8244",0,0,1,1,"dummy"
"8245",0,2,0,2,"dummy"
"8246",0,0,1,1,"dummy"
"8247",0,0,1,1,"dummy"
"8249",14,5,3,22,"dummy"
"8252",1,0,1,2,"dummy"
"8253",0,7,0,7,"dummy"
"8254",5,4,2,11,"dummy"
"8255",0,0,3,3,"dummy"
"8256",0,0,1,1,"dummy"
"8257",4,3,4,11,"dummy"
"8260",0,0,0,0,"dummy"
"8267",9,7,1,17,"dummy"
"8279",4,11,0,15,"dummy"
"8280",20,5,6,31,"dummy"
"8281",0,0,2,2,"dummy"
"8282",0,0,2,2,"dummy"
"8287",0,0,2,2,"dummy"
"8288",0,0,1,1,"dummy"
"8289",2,0,2,4,"dummy"
"8292",2,0,1,3,"dummy"
"8295",0,1,1,2,"dummy"
"8299",1,1,0,2,"dummy"
"8301",0,1,0,1,"dummy"
"8302",0,0,2,2,"dummy"
"8305",0,0,0,0,"dummy"
"8323",2,4,0,6,"dummy"
"8324",0,2,0,2,"dummy"
"8325",0,2,0,2,"dummy"
"8326",10,2,0,12,"dummy"
"8327",0,2,0,2,"dummy"
"8328",0,0,0,0,"dummy"
"8329",0,0,3,3,"dummy"
"8330",0,5,0,5,"dummy"
"8331",1,0,1,2,"dummy"
"8334",1,0,1,2,"dummy"
"8335",0,0,1,1,"dummy"
"8336",7,1,5,13,"dummy"
"8337",0,0,1,1,"dummy"
"8338",0,0,1,1,"dummy"
"8339",1,0,1,2,"dummy"
"8340",0,2,1,3,"dummy"
"8343",0,1,2,3,"dummy"
"8345",3,3,0,6,"dummy"
"8346",1,1,0,2,"dummy"
"8349",0,3,1,4,"dummy"
"8350",0,1,0,1,"dummy"
"8351",0,0,1,1,"dummy"
"8353",0,2,0,2,"dummy"
"8355",6,2,2,10,"dummy"
"8358",0,0,0,0,"dummy"
"8359",1,0,0,1,"dummy"
"8360",0,0,0,0,"dummy"
"8361",0,1,0,1,"dummy"
"8363",1,3,0,4,"dummy"
"8365",0,2,0,2,"dummy"
"8366",0,1,0,1,"dummy"
"8367",0,0,1,1,"dummy"
"8368",1,0,0,1,"dummy"
"8369",0,1,0,1,"dummy"
"8370",0,5,2,7,"dummy"
"8371",5,3,3,11,"dummy"
"8373",0,0,1,1,"dummy"
"8374",4,0,1,5,"dummy"
"8377",2,1,1,4,"dummy"
"8378",1,2,0,3,"dummy"
"8379",1,3,2,6,"dummy"
"8382",0,0,0,0,"dummy"
"8383",0,2,1,3,"dummy"
"8391",2,6,4,12,"dummy"
"8392",0,1,0,1,"dummy"
"8393",0,1,0,1,"dummy"
"8394",2,0,0,2,"dummy"
"8398",4,11,1,16,"dummy"
"8399",0,5,1,6,"dummy"
"8400",2,0,0,2,"dummy"
"8401",1,0,1,2,"dummy"
"8404",0,0,0,0,"dummy"
"8405",0,7,0,7,"dummy"
"8406",0,0,0,0,"dummy"
"8407",1,0,0,1,"dummy"
"8410",0,1,0,1,"dummy"
"8412",1,3,0,4,"dummy"
"8414",0,0,1,1,"dummy"
"8415",1,1,0,2,"dummy"
"8416",0,2,2,4,"dummy"
"8417",3,1,2,6,"dummy"
"8418",0,0,0,0,"dummy"
"8419",0,1,1,2,"dummy"
"8420",0,1,0,1,"dummy"
"8422",2,3,1,6,"dummy"
"8423",4,4,2,10,"dummy"
"8424",0,1,1,2,"dummy"
"8425",3,1,0,4,"dummy"
"8426",3,4,2,9,"dummy"
"8427",0,0,1,1,"dummy"
"8428",0,0,1,1,"dummy"
"8429",0,0,1,1,"dummy"
"8430",0,0,0,0,"dummy"
"8433",1,1,0,2,"dummy"
"8436",0,3,0,3,"dummy"
"8437",0,3,0,3,"dummy"
"8438",0,3,0,3,"dummy"
"8439",0,0,1,1,"dummy"
"8440",0,8,0,8,"dummy"
"8444",2,6,2,10,"dummy"
"8445",0,3,0,3,"dummy"
"8446",1,1,0,2,"dummy"
"8447",0,3,0,3,"dummy"
"8448",0,0,2,2,"dummy"
"8449",1,0,0,1,"dummy"
"8450",0,0,2,2,"dummy"
"8451",0,0,4,4,"dummy"
"8452",0,3,0,3,"dummy"
"8453",0,5,0,5,"dummy"
"8454",2,5,0,7,"dummy"
"8455",2,3,2,7,"dummy"
"8456",2,1,0,3,"dummy"
"8458",0,0,1,1,"dummy"
"8459",0,2,0,2,"dummy"
"8461",2,1,0,3,"dummy"
"8462",0,1,0,1,"dummy"
"8468",0,1,0,1,"dummy"
"8471",0,9,0,9,"dummy"
"8475",0,0,1,1,"dummy"
"8481",2,5,0,7,"dummy"
"8482",3,7,2,12,"dummy"
"8498",1,1,0,2,"dummy"
"8500",14,18,1,33,"dummy"
"8501",0,0,11,11,"dummy"
"8504",2,2,0,4,"dummy"
"8505",1,0,3,4,"dummy"
"8506",0,1,0,1,"dummy"
"8518",0,2,1,3,"dummy"
"8520",0,0,1,1,"dummy"
"8521",0,0,0,0,"dummy"
"8522",0,0,1,1,"dummy"
"8523",0,0,1,1,"dummy"
"8524",0,0,1,1,"dummy"
"8526",0,0,2,2,"dummy"
"8527",0,0,2,2,"dummy"
"8528",0,0,1,1,"dummy"
"8529",0,0,1,1,"dummy"
"8530",0,0,0,0,"dummy"
"8531",0,0,1,1,"dummy"
"8532",0,1,3,4,"dummy"
"8533",0,0,1,1,"dummy"
"8534",0,0,1,1,"dummy"
"8535",0,0,2,2,"dummy"
"8536",2,0,0,2,"dummy"
"8537",0,0,3,3,"dummy"
"8538",0,2,0,2,"dummy"
"8539",0,1,0,1,"dummy"
"8540",0,0,1,1,"dummy"
"8541",2,1,0,3,"dummy"
"8542",0,0,4,4,"dummy"
"8543",0,4,0,4,"dummy"
"8544",0,0,1,1,"dummy"
"8545",0,0,1,1,"dummy"
"8546",0,0,1,1,"dummy"
"8547",1,0,1,2,"dummy"
"8548",0,1,0,1,"dummy"
"8549",0,0,3,3,"dummy"
"8550",1,0,0,1,"dummy"
"8551",0,0,1,1,"dummy"
"8552",9,0,0,9,"dummy"
"8553",0,0,0,0,"dummy"
"8554",0,0,0,0,"dummy"
"8555",0,0,0,0,"dummy"
"8556",0,2,0,2,"dummy"
"8557",0,0,0,0,"dummy"
"8562",0,0,1,1,"dummy"
"8563",0,0,1,1,"dummy"
"8564",0,7,0,7,"dummy"
"8565",0,0,1,1,"dummy"
"8566",0,0,0,0,"dummy"
"8567",0,0,1,1,"dummy"
"8568",0,0,1,1,"dummy"
"8569",0,0,1,1,"dummy"
"8570",0,0,1,1,"dummy"
"8571",0,0,1,1,"dummy"
"8572",0,0,0,0,"dummy"
"8573",0,0,1,1,"dummy"
"8574",0,0,1,1,"dummy"
"8575",0,0,1,1,"dummy"
"8576",0,0,1,1,"dummy"
"8577",0,1,0,1,"dummy"
"8578",0,0,0,0,"dummy"
"8579",0,0,1,1,"dummy"
"8580",0,0,1,1,"dummy"
"8581",0,0,1,1,"dummy"
"8582",0,0,1,1,"dummy"
"8583",0,0,1,1,"dummy"
"8584",0,0,1,1,"dummy"
"8585",0,0,1,1,"dummy"
"8586",0,0,1,1,"dummy"
"8587",0,0,1,1,"dummy"
"8588",0,0,1,1,"dummy"
"8589",0,0,1,1,"dummy"
"8590",0,0,1,1,"dummy"
"8591",0,0,1,1,"dummy"
"8592",0,0,1,1,"dummy"
"8593",0,0,1,1,"dummy"
"8595",0,2,0,2,"dummy"
"8596",0,0,1,1,"dummy"
"8597",0,2,0,2,"dummy"
"8598",0,2,0,2,"dummy"
"8607",0,6,3,9,"dummy"
"8608",0,1,0,1,"dummy"
"8609",0,0,4,4,"dummy"
"8610",0,1,0,1,"dummy"
"8611",0,0,1,1,"dummy"
"8612",0,0,1,1,"dummy"
"8613",0,0,1,1,"dummy"
"8614",0,0,1,1,"dummy"
"8616",0,0,0,0,"dummy"
"8621",0,0,0,0,"dummy"
"8623",0,2,0,2,"dummy"
"8624",4,0,0,4,"dummy"
"8625",0,0,1,1,"dummy"
"8627",0,0,0,0,"dummy"
"8628",0,0,0,0,"dummy"
"8629",0,0,0,0,"dummy"
"8630",3,5,1,9,"dummy"
"8631",4,4,0,8,"dummy"
"8632",0,0,1,1,"dummy"
"8633",3,3,1,7,"dummy"
"8643",4,18,2,24,"dummy"
"8646",1,1,6,8,"dummy"
"8647",0,0,1,1,"dummy"
"8648",0,0,2,2,"dummy"
"8649",0,0,1,1,"dummy"
"8650",1,1,2,4,"dummy"
"8651",0,0,0,0,"dummy"
"8652",0,0,2,2,"dummy"
"8653",7,0,1,8,"dummy"
"8656",1,1,0,2,"dummy"
"8658",1,0,0,1,"dummy"
"8659",0,1,0,1,"dummy"
"8663",0,5,0,5,"dummy"
"8664",0,0,1,1,"dummy"
"8665",0,1,0,1,"dummy"
"8666",0,1,0,1,"dummy"
"8667",1,0,2,3,"dummy"
"8668",0,2,1,3,"dummy"
"8669",0,1,0,1,"dummy"
"8670",0,1,1,2,"dummy"
"8671",2,9,3,14,"dummy"
"8672",0,3,0,3,"dummy"
"8674",0,0,1,1,"dummy"
"8675",0,0,1,1,"dummy"
"8676",0,1,0,1,"dummy"
"8677",4,3,0,7,"dummy"
"8678",0,1,0,1,"dummy"
"8679",0,0,1,1,"dummy"
"8680",0,0,1,1,"dummy"
"8681",0,0,1,1,"dummy"
"8682",0,0,1,1,"dummy"
"8684",0,0,0,0,"dummy"
"8685",0,2,0,2,"dummy"
"8686",0,0,2,2,"dummy"
"8687",0,1,0,1,"dummy"
"8688",0,1,0,1,"dummy"
"8689",0,0,2,2,"dummy"
"8690",0,1,0,1,"dummy"
"8694",0,0,0,0,"dummy"
"8695",0,0,0,0,"dummy"
"8696",0,0,0,0,"dummy"
"8698",0,2,0,2,"dummy"
"8699",2,0,0,2,"dummy"
"8700",0,1,0,1,"dummy"
"8702",0,1,1,2,"dummy"
"8703",0,0,1,1,"dummy"
"8704",0,0,1,1,"dummy"
"8705",0,0,1,1,"dummy"
"8707",0,0,1,1,"dummy"
"8708",3,3,2,8,"dummy"
"8709",1,0,0,1,"dummy"
"8710",2,0,2,4,"dummy"
"8711",12,1,3,16,"dummy"
"8712",0,1,0,1,"dummy"
"8713",1,1,1,3,"dummy"
"8714",0,3,1,4,"dummy"
"8715",0,0,2,2,"dummy"
"8716",0,7,0,7,"dummy"
"8717",4,1,0,5,"dummy"
"8718",1,12,0,13,"dummy"
"8719",0,0,1,1,"dummy"
"8720",12,13,1,26,"dummy"
"8722",1,1,1,3,"dummy"
"8724",4,9,2,15,"dummy"
"8736",0,1,0,1,"dummy"
"8738",0,1,0,1,"dummy"
"8741",2,0,0,2,"dummy"
"8743",0,1,0,1,"dummy"
"8744",0,3,0,3,"dummy"
"8745",0,3,0,3,"dummy"
"8746",16,5,0,21,"dummy"
"8747",0,0,2,2,"dummy"
"8748",0,0,3,3,"dummy"
"8749",0,1,0,1,"dummy"
"8750",0,0,1,1,"dummy"
"8751",0,0,1,1,"dummy"
"8754",0,2,0,2,"dummy"
"8755",2,0,0,2,"dummy"
"8756",2,5,0,7,"dummy"
"8757",1,7,2,10,"dummy"
"8759",1,0,0,1,"dummy"
"8760",0,1,0,1,"dummy"
"8761",0,1,1,2,"dummy"
"8762",0,1,0,1,"dummy"
"8763",1,0,0,1,"dummy"
"8764",0,2,3,5,"dummy"
"8774",0,0,3,3,"dummy"
"8775",0,1,0,1,"dummy"
"8777",0,0,1,1,"dummy"
"8778",0,0,2,2,"dummy"
"8782",0,0,1,1,"dummy"
"8784",4,3,3,10,"dummy"
"8785",0,10,0,10,"dummy"
"8787",0,0,1,1,"dummy"
"8793",0,0,0,0,"dummy"
"8794",0,0,0,0,"dummy"
"8795",0,0,0,0,"dummy"
"8796",0,0,0,0,"dummy"
"8802",0,0,1,1,"dummy"
"8804",0,1,0,1,"dummy"
"8805",4,3,3,10,"dummy"
"8806",0,3,0,3,"dummy"
"8811",0,0,0,0,"dummy"
"8812",0,0,1,1,"dummy"
"8827",0,5,0,5,"dummy"
"8828",0,1,0,1,"dummy"
"8829",5,0,0,5,"dummy"
"8830",1,0,1,2,"dummy"
"8831",0,1,0,1,"dummy"
"8854",0,0,1,1,"dummy"
"8855",0,0,1,1,"dummy"
"8856",0,0,1,1,"dummy"
"8857",0,0,3,3,"dummy"
"8858",0,0,1,1,"dummy"
"8859",6,3,0,9,"dummy"
"8860",1,3,0,4,"dummy"
"8861",0,1,0,1,"dummy"
"8862",5,1,0,6,"dummy"
"8863",0,0,0,0,"dummy"
"8864",0,0,2,2,"dummy"
"8865",0,0,0,0,"dummy"
"8866",0,0,1,1,"dummy"
"8867",0,0,0,0,"dummy"
"8868",0,0,0,0,"dummy"
"8869",0,0,1,1,"dummy"
"8870",1,2,0,3,"dummy"
"8871",0,0,0,0,"dummy"
"8872",2,1,0,3,"dummy"
"8873",0,0,0,0,"dummy"
"8874",0,3,1,4,"dummy"
"8876",0,3,0,3,"dummy"
"8877",0,1,0,1,"dummy"
"8878",0,0,2,2,"dummy"
"8879",1,1,0,2,"dummy"
"8880",3,13,0,16,"dummy"
"8889",6,1,1,8,"dummy"
"8890",0,0,0,0,"dummy"
"8892",3,5,0,8,"dummy"
"8897",0,1,1,2,"dummy"
"8913",0,0,0,0,"dummy"
"8914",0,0,0,0,"dummy"
"8915",0,0,1,1,"dummy"
"8916",0,0,0,0,"dummy"
"8917",0,0,0,0,"dummy"
"8918",0,1,0,1,"dummy"
"8919",0,0,0,0,"dummy"
"8920",0,0,0,0,"dummy"
"8921",1,1,0,2,"dummy"
"8924",0,0,0,0,"dummy"
"8925",0,0,0,0,"dummy"
"8932",0,4,0,4,"dummy"
"8933",0,16,0,16,"dummy"
"8934",0,1,0,1,"dummy"
"8939",2,0,0,2,"dummy"
"8940",0,2,0,2,"dummy"
"8944",2,1,0,3,"dummy"
"8945",13,7,3,23,"dummy"
"8946",0,0,1,1,"dummy"
"8947",0,0,3,3,"dummy"
"8948",6,0,1,7,"dummy"
"8949",3,9,0,12,"dummy"
"8950",2,0,4,6,"dummy"
"8951",1,2,0,3,"dummy"
"8952",18,18,0,36,"dummy"
"8953",3,2,0,5,"dummy"
"8954",0,0,0,0,"dummy"
"8955",1,0,1,2,"dummy"
"8956",0,0,0,0,"dummy"
"8957",15,0,0,15,"dummy"
"8964",0,1,0,1,"dummy"
"8988",0,1,0,1,"dummy"
"9012",2,0,0,2,"dummy"
"9013",0,0,0,0,"dummy"
"9019",2,2,2,6,"dummy"
"9020",0,2,10,12,"dummy"
"9021",0,1,0,1,"dummy"
"9022",7,18,0,25,"dummy"
"9023",4,0,0,4,"dummy"
"9028",1,1,0,2,"dummy"
"9029",0,3,0,3,"dummy"
"9030",1,1,0,2,"dummy"
"9065",1,0,0,1,"dummy"
"9066",0,9,0,9,"dummy"
"9067",5,4,0,9,"dummy"
"9068",3,1,1,5,"dummy"
"9069",0,1,0,1,"dummy"
"9078",10,0,0,10,"dummy"
"9079",0,12,0,12,"dummy"
"9080",0,0,0,0,"dummy"
"9081",0,0,1,1,"dummy"
"9082",0,0,0,0,"dummy"
"9085",1,1,0,2,"dummy"
"9088",2,6,0,8,"dummy"
"9089",6,9,1,16,"dummy"
"9090",0,2,0,2,"dummy"
"9091",2,2,0,4,"dummy"
"9092",2,0,0,2,"dummy"
"9093",0,2,0,2,"dummy"
"9094",5,10,3,18,"dummy"
"9101",0,2,0,2,"dummy"
"9102",0,1,0,1,"dummy"
"9103",1,0,0,1,"dummy"
"9116",4,4,1,9,"dummy"
"8936",0,0,1,1,"dummy"
"8937",0,0,1,1,"dummy"
"8942",0,5,2,7,"dummy"
"8986",3,0,0,3,"dummy"
"8992",0,0,1,1,"dummy"
"8993",0,0,2,2,"dummy"
"8994",0,0,1,1,"dummy"
"8995",0,0,1,1,"dummy"
"8996",0,0,1,1,"dummy"
"8999",0,1,4,5,"dummy"
"9000",5,3,2,10,"dummy"
"9001",3,35,3,41,"dummy"
"9002",2,9,2,13,"dummy"
"9005",0,2,0,2,"dummy"
"9006",2,2,0,4,"dummy"
"9007",2,0,0,2,"dummy"
"9008",0,0,0,0,"dummy"
"9009",0,1,0,1,"dummy"
"9010",0,0,1,1,"dummy"
"9015",0,1,0,1,"dummy"
"9016",1,2,0,3,"dummy"
"9017",0,0,3,3,"dummy"
"9025",0,0,0,0,"dummy"
"9026",0,0,0,0,"dummy"
"9036",0,0,1,1,"dummy"
"9063",2,2,0,4,"dummy"
"9076",1,0,0,1,"dummy"
"9098",4,8,1,13,"dummy"
"9099",9,1,1,11,"dummy"
"9114",0,0,1,1,"dummy"
"9140",1,1,1,3,"dummy"
"9141",5,3,2,10,"dummy"
"9142",0,2,0,2,"dummy"
"9143",0,3,0,3,"dummy"
"9144",0,3,0,3,"dummy"
"9145",0,2,0,2,"dummy"
"9146",0,2,0,2,"dummy"
"9147",0,1,0,1,"dummy"
"9148",0,1,0,1,"dummy"
"9151",1,2,0,3,"dummy"
"9152",0,0,0,0,"dummy"
"9153",0,1,0,1,"dummy"
"9161",0,0,0,0,"dummy"
"9186",3,4,0,7,"dummy"
"9187",5,4,2,11,"dummy"
"9188",0,0,3,3,"dummy"
"9189",0,0,1,1,"dummy"
"9190",0,2,3,5,"dummy"
"9191",0,1,0,1,"dummy"
"9192",0,0,3,3,"dummy"
"9193",0,0,0,0,"dummy"
"9194",0,0,3,3,"dummy"
"9195",0,1,0,1,"dummy"
"9196",1,0,0,1,"dummy"
"9197",0,0,1,1,"dummy"
"9198",0,0,3,3,"dummy"
"9199",0,0,3,3,"dummy"
"9200",0,0,3,3,"dummy"
"9201",0,1,0,1,"dummy"
"9202",0,0,3,3,"dummy"
"9203",3,2,1,6,"dummy"
"9216",0,0,1,1,"dummy"
"9117",0,1,0,1,"dummy"
"9118",2,2,1,5,"dummy"
"9119",0,4,0,4,"dummy"
"9120",0,0,1,1,"dummy"
"9121",2,4,1,7,"dummy"
"9122",0,0,1,1,"dummy"
"9123",0,2,0,2,"dummy"
"9124",0,0,1,1,"dummy"
"9125",3,3,3,9,"dummy"
"9126",5,3,0,8,"dummy"
"9127",2,2,5,9,"dummy"
"9134",11,4,1,16,"dummy"
"9135",0,0,1,1,"dummy"
"9136",3,2,1,6,"dummy"
"9137",0,0,1,1,"dummy"
"9138",6,6,0,12,"dummy"
"9179",0,0,1,1,"dummy"
"9218",0,4,2,6,"dummy"
"9219",2,0,0,2,"dummy"
"9223",4,10,2,16,"dummy"
"9224",0,3,0,3,"dummy"
"9225",0,0,2,2,"dummy"
"9226",6,6,0,12,"dummy"
"9227",0,0,2,2,"dummy"
"9228",12,17,1,30,"dummy"
"9229",0,3,0,3,"dummy"
"9235",0,1,0,1,"dummy"
"9236",0,0,3,3,"dummy"
"9221",2,0,0,2,"dummy"
"9231",1,11,0,12,"dummy"
"9232",0,4,0,4,"dummy"
"9233",0,2,0,2,"dummy"
"9239",6,15,2,23,"dummy"
"9240",0,2,0,2,"dummy"
"9241",0,1,1,2,"dummy"
"9242",0,0,2,2,"dummy"
"9243",3,0,0,3,"dummy"
"9244",22,1,2,25,"dummy"
"9245",0,0,1,1,"dummy"
"9246",5,12,1,18,"dummy"
"9247",0,0,0,0,"dummy"
"9251",4,0,2,6,"dummy"
"9265",0,0,1,1,"dummy"
"9266",0,0,0,0,"dummy"
"9267",0,0,0,0,"dummy"
"9268",0,0,1,1,"dummy"
"9269",0,0,0,0,"dummy"
"9270",0,0,1,1,"dummy"
"9271",0,0,0,0,"dummy"
"9272",0,0,0,0,"dummy"
"9273",0,0,0,0,"dummy"
"9274",0,1,0,1,"dummy"
"9275",0,0,0,0,"dummy"
"9281",1,1,0,2,"dummy"
"9282",0,0,1,1,"dummy"
"9283",0,1,0,1,"dummy"
"9284",1,1,0,2,"dummy"
"9290",0,0,1,1,"dummy"
"9291",0,0,1,1,"dummy"
"9292",0,0,2,2,"dummy"
"9296",6,0,0,6,"dummy"
"9297",2,5,2,9,"dummy"
"9301",0,2,0,2,"dummy"
"9302",0,1,0,1,"dummy"
"9312",0,1,2,3,"dummy"
"9313",2,1,0,3,"dummy"
"9314",0,5,0,5,"dummy"
"9315",24,2,0,26,"dummy"
"9316",0,0,2,2,"dummy"
"9320",24,18,3,45,"dummy"
"9321",0,0,1,1,"dummy"
"9322",1,3,1,5,"dummy"
"9323",0,1,0,1,"dummy"
"9324",0,0,1,1,"dummy"
"9325",17,0,0,17,"dummy"
"9326",0,2,0,2,"dummy"
"9327",0,2,0,2,"dummy"
"9328",0,2,0,2,"dummy"
"9329",0,1,0,1,"dummy"
"9330",0,1,0,1,"dummy"
"9331",1,0,0,1,"dummy"
"9332",0,2,0,2,"dummy"
"9335",0,0,1,1,"dummy"
"9336",0,0,0,0,"dummy"
"9338",4,1,0,5,"dummy"
"9340",0,2,0,2,"dummy"
"9343",0,1,0,1,"dummy"
"9344",1,0,0,1,"dummy"
"9345",0,1,0,1,"dummy"
"9346",0,1,0,1,"dummy"
"9348",0,0,1,1,"dummy"
"9351",0,1,0,1,"dummy"
"9353",0,0,3,3,"dummy"
"9356",0,1,2,3,"dummy"
"9357",0,0,2,2,"dummy"
"9365",0,0,1,1,"dummy"
"9366",0,0,1,1,"dummy"
"9367",0,1,0,1,"dummy"
"9368",0,0,2,2,"dummy"
"9381",0,0,1,1,"dummy"
"9382",0,0,1,1,"dummy"
"9383",0,0,0,0,"dummy"
"9384",0,0,1,1,"dummy"
"9385",0,0,1,1,"dummy"
"9395",0,0,1,1,"dummy"
"9396",0,0,1,1,"dummy"
"9397",0,0,1,1,"dummy"
"9401",0,2,0,2,"dummy"
"9402",1,0,0,1,"dummy"
"9403",0,1,2,3,"dummy"
"9404",0,1,0,1,"dummy"
"9410",0,0,0,0,"dummy"
"9411",0,1,0,1,"dummy"
"9412",5,2,1,8,"dummy"
"9413",1,0,2,3,"dummy"
"9414",0,1,0,1,"dummy"
"9415",0,1,0,1,"dummy"
"9416",0,1,0,1,"dummy"
"9417",1,6,0,7,"dummy"
"9418",0,5,1,6,"dummy"
"9419",1,9,0,10,"dummy"
"9420",9,1,0,10,"dummy"
"9421",0,1,0,1,"dummy"
"9422",0,0,1,1,"dummy"
"9423",1,0,0,1,"dummy"
"9429",0,24,0,24,"dummy"
"9430",5,1,0,6,"dummy"
"9434",1,1,1,3,"dummy"
"9363",1,2,2,5,"dummy"
"9370",0,0,0,0,"dummy"
"9373",0,0,1,1,"dummy"
"9374",4,2,0,6,"dummy"
"9375",0,0,1,1,"dummy"
"9376",3,2,0,5,"dummy"
"9377",2,0,0,2,"dummy"
"9378",0,0,1,1,"dummy"
"9379",0,0,0,0,"dummy"
"9387",0,0,0,0,"dummy"
"9390",0,2,0,2,"dummy"
"9391",1,0,1,2,"dummy"
"9399",0,0,1,1,"dummy"
"9406",0,0,1,1,"dummy"
"9425",0,0,1,1,"dummy"
"9426",2,3,0,5,"dummy"
"9427",0,1,0,1,"dummy"
"9432",2,5,2,9,"dummy"
"9436",0,0,1,1,"dummy"
"9437",0,0,1,1,"dummy"
"9505",2,3,0,5,"dummy"
"9521",0,1,0,1,"dummy"
"9523",0,0,2,2,"dummy"
"9526",0,0,3,3,"dummy"
"9527",0,0,3,3,"dummy"
"9529",0,3,0,3,"dummy"
"9530",0,5,2,7,"dummy"
"9531",0,0,1,1,"dummy"
"9532",2,4,0,6,"dummy"
"9533",0,1,0,1,"dummy"
"9541",0,1,0,1,"dummy"
"9542",5,0,1,6,"dummy"
"9543",0,0,1,1,"dummy"
"9544",0,3,2,5,"dummy"
"9545",3,0,2,5,"dummy"
"9546",0,0,1,1,"dummy"
"9547",0,0,1,1,"dummy"
"9550",0,1,0,1,"dummy"
"9551",1,0,0,1,"dummy"
"9552",0,0,1,1,"dummy"
"9566",0,3,0,3,"dummy"
"9567",2,11,0,13,"dummy"
"9568",0,0,1,1,"dummy"
"9569",0,1,0,1,"dummy"
"9572",0,0,2,2,"dummy"
"9574",0,1,0,1,"dummy"
"9576",0,0,0,0,"dummy"
"9578",1,0,0,1,"dummy"
"9581",0,6,0,6,"dummy"
"9582",0,0,1,1,"dummy"
"9583",10,0,4,14,"dummy"
"9584",1,1,4,6,"dummy"
"9585",0,1,4,5,"dummy"
"9587",2,7,0,9,"dummy"
"9588",1,6,3,10,"dummy"
"9590",0,0,0,0,"dummy"
"9591",0,0,0,0,"dummy"
"9592",0,0,0,0,"dummy"
"9593",0,0,0,0,"dummy"
"9594",0,0,0,0,"dummy"
"9595",0,0,0,0,"dummy"
"9596",0,0,0,0,"dummy"
"9597",0,0,0,0,"dummy"
"9598",0,0,0,0,"dummy"
"9599",0,0,0,0,"dummy"
"9600",0,0,0,0,"dummy"
"9601",0,0,0,0,"dummy"
"9602",0,0,0,0,"dummy"
"9604",0,1,0,1,"dummy"
"9606",0,1,0,1,"dummy"
"9608",2,4,0,6,"dummy"
"9609",0,2,0,2,"dummy"
"9610",0,2,0,2,"dummy"
"9611",10,2,0,12,"dummy"
"9612",0,2,0,2,"dummy"
"9621",0,6,2,8,"dummy"
"9622",0,2,0,2,"dummy"
"9623",0,1,0,1,"dummy"
"9624",0,2,0,2,"dummy"
"9625",0,1,0,1,"dummy"
"9626",0,0,1,1,"dummy"
"9634",0,3,0,3,"dummy"
"9636",0,2,2,4,"dummy"
"9639",4,2,3,9,"dummy"
"9640",0,2,0,2,"dummy"
"9641",1,0,0,1,"dummy"
"9646",0,1,0,1,"dummy"
"9651",8,36,2,46,"dummy"
"9652",17,27,5,49,"dummy"
"9653",0,1,0,1,"dummy"
"9654",0,0,1,1,"dummy"
"9657",0,1,0,1,"dummy"
"9658",0,0,0,0,"dummy"
"9659",0,0,1,1,"dummy"
"9664",0,0,0,0,"dummy"
"9669",0,4,0,4,"dummy"
"9670",4,7,0,11,"dummy"
"9671",2,3,0,5,"dummy"
"9673",0,0,3,3,"dummy"
"9674",0,0,0,0,"dummy"
"9677",1,0,1,2,"dummy"
"9682",0,0,3,3,"dummy"
"9683",0,2,0,2,"dummy"
"9687",1,4,0,5,"dummy"
"9688",0,0,1,1,"dummy"
"9689",2,3,0,5,"dummy"
"9691",3,1,0,4,"dummy"
"9692",0,1,0,1,"dummy"
"9693",0,16,2,18,"dummy"
"9694",27,4,3,34,"dummy"
"9695",6,27,2,35,"dummy"
"9704",0,0,0,0,"dummy"
"9711",0,0,1,1,"dummy"
"9712",2,5,3,10,"dummy"
"9713",0,2,2,4,"dummy"
"9714",5,2,1,8,"dummy"
"9715",0,0,1,1,"dummy"
"9716",0,0,2,2,"dummy"
"9717",2,2,1,5,"dummy"
"9718",0,0,2,2,"dummy"
"9725",0,0,1,1,"dummy"
"9726",0,0,0,0,"dummy"
"9727",0,0,1,1,"dummy"
"9728",0,0,1,1,"dummy"
"9729",0,0,1,1,"dummy"
"9732",0,4,2,6,"dummy"
"9738",0,0,0,0,"dummy"
"9739",0,0,1,1,"dummy"
"9740",0,0,0,0,"dummy"
"9741",0,0,3,3,"dummy"
"9742",1,6,3,10,"dummy"
"9743",0,1,3,4,"dummy"
"9744",5,1,0,6,"dummy"
"9745",4,0,0,4,"dummy"
"9747",0,1,0,1,"dummy"
"9750",1,2,0,3,"dummy"
"9752",0,0,1,1,"dummy"
"9753",1,0,0,1,"dummy"
"9754",3,24,3,30,"dummy"
"9755",0,1,0,1,"dummy"
"9756",2,4,0,6,"dummy"
"9757",4,1,2,7,"dummy"
"9758",2,0,1,3,"dummy"
"9760",1,2,0,3,"dummy"
"9761",0,1,0,1,"dummy"
"9762",1,3,0,4,"dummy"
"9763",0,1,0,1,"dummy"
"9764",3,4,0,7,"dummy"
"9765",1,1,0,2,"dummy"
"9766",3,1,1,5,"dummy"
"9768",2,0,0,2,"dummy"
"9772",0,2,0,2,"dummy"
"9773",0,0,1,1,"dummy"
"9775",0,0,1,1,"dummy"
"9776",0,1,0,1,"dummy"
"9777",0,7,0,7,"dummy"
"9779",0,0,0,0,"dummy"
"9780",0,3,0,3,"dummy"
"9781",0,5,4,9,"dummy"
"9783",0,1,0,1,"dummy"
"9787",0,1,2,3,"dummy"
"9788",0,0,0,0,"dummy"
"9789",0,2,0,2,"dummy"
"9790",5,0,2,7,"dummy"
"9791",1,0,0,1,"dummy"
"9793",0,1,0,1,"dummy"
"9794",0,0,1,1,"dummy"
"9795",0,0,1,1,"dummy"
"9796",0,0,1,1,"dummy"
"9797",0,0,1,1,"dummy"
"9798",1,0,2,3,"dummy"
"9799",3,2,1,6,"dummy"
"9800",0,0,0,0,"dummy"
"9801",0,0,3,3,"dummy"
"9802",0,0,1,1,"dummy"
"9804",18,11,5,34,"dummy"
"9805",0,4,0,4,"dummy"
"9806",0,1,0,1,"dummy"
"9807",0,0,1,1,"dummy"
"9809",2,0,1,3,"dummy"
"9810",2,3,2,7,"dummy"
"9812",0,2,0,2,"dummy"
"9815",0,6,0,6,"dummy"
"9816",0,4,1,5,"dummy"
"9817",0,0,2,2,"dummy"
"9818",1,5,0,6,"dummy"
"9819",1,0,0,1,"dummy"
"9820",0,6,1,7,"dummy"
"9821",2,7,0,9,"dummy"
"9822",0,3,0,3,"dummy"
"9825",4,6,3,13,"dummy"
"9826",0,2,0,2,"dummy"
"9830",7,12,1,20,"dummy"
"9831",0,0,2,2,"dummy"
"9834",0,2,0,2,"dummy"
"9835",0,2,0,2,"dummy"
"9836",0,0,1,1,"dummy"
"9837",0,2,1,3,"dummy"
"9838",0,0,0,0,"dummy"
"9839",3,6,1,10,"dummy"
"9841",0,0,0,0,"dummy"
"9842",0,0,0,0,"dummy"
"9845",0,0,1,1,"dummy"
"9846",3,3,2,8,"dummy"
"9847",1,0,0,1,"dummy"
"9848",2,0,2,4,"dummy"
"9849",12,1,3,16,"dummy"
"9850",0,1,0,1,"dummy"
"9851",1,1,1,3,"dummy"
"9852",0,3,1,4,"dummy"
"9853",0,0,2,2,"dummy"
"9854",0,7,0,7,"dummy"
"9855",4,1,0,5,"dummy"
"9856",1,12,0,13,"dummy"
"9857",0,0,1,1,"dummy"
"9858",12,13,1,26,"dummy"
"9859",0,0,3,3,"dummy"
"9860",0,0,1,1,"dummy"
"9861",0,0,2,2,"dummy"
"9862",0,0,1,1,"dummy"
"9863",0,0,3,3,"dummy"
"9864",2,1,0,3,"dummy"
"9865",0,5,0,5,"dummy"
"9866",0,2,1,3,"dummy"
"9867",0,1,0,1,"dummy"
"9868",0,1,1,2,"dummy"
"9869",1,2,0,3,"dummy"
"9870",3,1,0,4,"dummy"
"9871",1,2,0,3,"dummy"
"9872",0,1,0,1,"dummy"
"9873",0,1,0,1,"dummy"
"9874",0,1,1,2,"dummy"
"9875",0,0,1,1,"dummy"
"9877",0,3,1,4,"dummy"
"9880",1,0,0,1,"dummy"
"9881",0,0,1,1,"dummy"
"9891",0,2,0,2,"dummy"
"9892",0,1,0,1,"dummy"
"9893",0,1,0,1,"dummy"
"9894",0,1,0,1,"dummy"
"9896",2,8,0,10,"dummy"
"9897",0,0,3,3,"dummy"
"9899",0,3,0,3,"dummy"
"9904",0,2,1,3,"dummy"
"9906",0,3,1,4,"dummy"
"9907",0,0,1,1,"dummy"
"9908",0,0,1,1,"dummy"
"9909",4,5,0,9,"dummy"
"9973",0,4,0,4,"dummy"
"9974",2,4,0,6,"dummy"
"9975",1,0,1,2,"dummy"
"9976",0,1,0,1,"dummy"
"10005",3,4,1,8,"dummy"
"10006",5,12,3,20,"dummy"
"10007",0,1,0,1,"dummy"
"10014",2,2,0,4,"dummy"
"10051",9,2,2,13,"dummy"
"10052",8,2,4,14,"dummy"
"10053",1,0,1,2,"dummy"
"10054",0,2,0,2,"dummy"
"10055",0,1,0,1,"dummy"
"10056",0,4,0,4,"dummy"
"10057",2,0,0,2,"dummy"
"10064",2,2,0,4,"dummy"
"10065",0,0,1,1,"dummy"
"10066",0,0,1,1,"dummy"
"10067",0,2,0,2,"dummy"
"10070",0,1,0,1,"dummy"
"10092",0,0,1,1,"dummy"
"10093",0,0,0,0,"dummy"
"10097",0,0,1,1,"dummy"
"10098",0,5,0,5,"dummy"
"10099",0,4,0,4,"dummy"
"10100",0,1,1,2,"dummy"
"10105",1,1,1,3,"dummy"
"10122",0,4,0,4,"dummy"
"10125",1,2,2,5,"dummy"
"10126",0,0,0,0,"dummy"
"10130",0,5,0,5,"dummy"
"10131",0,1,0,1,"dummy"
"10132",0,2,0,2,"dummy"
"10133",0,1,0,1,"dummy"
"10134",0,0,2,2,"dummy"
"10135",4,5,1,10,"dummy"
"10136",4,4,1,9,"dummy"
"10137",5,7,1,13,"dummy"
"10138",0,1,0,1,"dummy"
"10139",0,0,1,1,"dummy"
"10140",0,1,0,1,"dummy"
"10141",1,0,0,1,"dummy"
"10142",0,0,0,0,"dummy"
"10143",0,3,0,3,"dummy"
"10146",0,4,0,4,"dummy"
"10147",2,4,0,6,"dummy"
"10148",2,1,0,3,"dummy"
"10149",1,0,1,2,"dummy"
"10156",1,1,0,2,"dummy"
"10157",0,3,0,3,"dummy"
"10186",0,1,0,1,"dummy"
"10187",2,1,0,3,"dummy"
"10188",0,1,0,1,"dummy"
"10189",1,0,0,1,"dummy"
"9911",4,8,0,12,"dummy"
"9912",0,2,0,2,"dummy"
"9917",4,7,0,11,"dummy"
"9918",2,0,0,2,"dummy"
"9919",0,3,0,3,"dummy"
"9920",0,0,1,1,"dummy"
"9927",2,2,0,4,"dummy"
"9934",0,0,1,1,"dummy"
"9951",0,1,1,2,"dummy"
"9952",10,9,0,19,"dummy"
"9953",0,4,0,4,"dummy"
"9954",0,0,0,0,"dummy"
"9957",2,0,0,2,"dummy"
"9958",0,1,0,1,"dummy"
"9959",0,0,1,1,"dummy"
"9960",0,0,1,1,"dummy"
"9961",0,0,1,1,"dummy"
"9967",0,1,0,1,"dummy"
"9968",0,2,0,2,"dummy"
"9969",0,1,0,1,"dummy"
"9978",0,2,0,2,"dummy"
"9979",0,0,1,1,"dummy"
"9980",0,1,3,4,"dummy"
"9981",0,3,0,3,"dummy"
"9982",3,0,0,3,"dummy"
"9983",0,0,1,1,"dummy"
"9986",9,3,0,12,"dummy"
"9987",0,1,0,1,"dummy"
"9988",1,0,0,1,"dummy"
"9989",0,0,1,1,"dummy"
"9990",1,1,0,2,"dummy"
"9991",0,1,0,1,"dummy"
"9992",0,1,0,1,"dummy"
"9993",0,1,0,1,"dummy"
"9994",0,1,0,1,"dummy"
"9995",0,0,1,1,"dummy"
"9996",0,0,3,3,"dummy"
"9997",0,0,1,1,"dummy"
"9998",0,1,1,2,"dummy"
"10009",0,0,1,1,"dummy"
"10010",3,2,3,8,"dummy"
"10016",0,2,0,2,"dummy"
"10017",0,0,1,1,"dummy"
"10018",0,0,2,2,"dummy"
"10019",2,0,0,2,"dummy"
"10020",0,0,1,1,"dummy"
"10021",0,0,1,1,"dummy"
"10022",0,1,0,1,"dummy"
"10023",1,0,1,2,"dummy"
"10024",0,1,0,1,"dummy"
"10025",1,0,0,1,"dummy"
"10026",1,0,1,2,"dummy"
"10027",0,1,0,1,"dummy"
"10028",0,0,1,1,"dummy"
"10029",0,0,1,1,"dummy"
"10030",0,0,2,2,"dummy"
"10031",0,1,0,1,"dummy"
"10032",0,0,1,1,"dummy"
"10033",0,1,0,1,"dummy"
"10034",0,0,1,1,"dummy"
"10035",0,0,1,1,"dummy"
"10036",0,0,1,1,"dummy"
"10037",0,0,1,1,"dummy"
"10038",0,0,1,1,"dummy"
"10039",0,0,2,2,"dummy"
"10040",0,0,1,1,"dummy"
"10041",3,0,0,3,"dummy"
"10042",0,0,1,1,"dummy"
"10043",0,0,1,1,"dummy"
"10044",0,0,1,1,"dummy"
"10045",0,0,1,1,"dummy"
"10046",0,0,1,1,"dummy"
"10047",0,0,1,1,"dummy"
"10059",0,3,0,3,"dummy"
"10062",0,1,0,1,"dummy"
"10072",0,1,0,1,"dummy"
"10075",0,7,0,7,"dummy"
"10076",1,3,3,7,"dummy"
"10077",1,6,1,8,"dummy"
"10078",7,2,0,9,"dummy"
"10079",2,1,0,3,"dummy"
"10080",0,0,0,0,"dummy"
"10081",0,0,0,0,"dummy"
"10082",0,0,0,0,"dummy"
"10083",0,0,1,1,"dummy"
"10084",0,0,1,1,"dummy"
"10089",8,15,2,25,"dummy"
"10090",5,4,0,9,"dummy"
"10095",0,1,0,1,"dummy"
"10114",2,2,1,5,"dummy"
"10117",2,0,1,3,"dummy"
"10118",0,1,1,2,"dummy"
"10128",0,0,1,1,"dummy"
"10153",0,1,0,1,"dummy"
"10154",0,0,1,1,"dummy"
"10163",1,2,1,4,"dummy"
"10164",0,1,0,1,"dummy"
"10165",2,1,0,3,"dummy"
"10166",1,5,1,7,"dummy"
"10167",6,2,1,9,"dummy"
"10168",5,8,4,17,"dummy"
"10169",4,5,1,10,"dummy"
"10170",0,1,0,1,"dummy"
"10171",0,1,0,1,"dummy"
"10172",3,1,1,5,"dummy"
"10173",1,0,0,1,"dummy"
"10174",0,2,0,2,"dummy"
"10175",0,0,2,2,"dummy"
"10178",0,0,1,1,"dummy"
"10193",0,0,1,1,"dummy"
"10194",0,0,0,0,"dummy"
"10235",1,7,1,9,"dummy"
"10242",0,0,1,1,"dummy"
"10243",0,0,1,1,"dummy"
"10248",0,2,0,2,"dummy"
"10249",0,0,0,0,"dummy"
"10250",0,0,1,1,"dummy"
"10251",0,0,0,0,"dummy"
"10252",0,2,0,2,"dummy"
"10253",0,0,1,1,"dummy"
"10254",0,0,1,1,"dummy"
"10255",0,0,1,1,"dummy"
"10256",0,0,0,0,"dummy"
"10257",0,0,1,1,"dummy"
"10258",0,0,1,1,"dummy"
"10259",0,0,1,1,"dummy"
"10260",0,0,0,0,"dummy"
"10261",0,0,0,0,"dummy"
"10264",2,4,0,6,"dummy"
"10265",0,2,0,2,"dummy"
"10266",0,2,0,2,"dummy"
"10267",10,2,0,12,"dummy"
"10268",0,2,0,2,"dummy"
"10269",0,0,0,0,"dummy"
"10270",0,0,3,3,"dummy"
"10271",0,5,0,5,"dummy"
"10272",1,0,1,2,"dummy"
"10273",0,0,6,6,"dummy"
"10284",0,2,0,2,"dummy"
"10285",2,0,0,2,"dummy"
"10286",0,2,0,2,"dummy"
"10287",0,0,1,1,"dummy"
"10291",0,4,3,7,"dummy"
"10297",0,3,1,4,"dummy"
"10319",9,4,1,14,"dummy"
"10320",1,1,0,2,"dummy"
"10321",0,2,0,2,"dummy"
"10322",0,4,1,5,"dummy"
"10221",0,0,0,0,"dummy"
"10222",1,1,0,2,"dummy"
"10223",0,3,1,4,"dummy"
"10224",0,0,1,1,"dummy"
"10225",0,1,0,1,"dummy"
"10226",0,7,0,7,"dummy"
"10227",1,0,0,1,"dummy"
"10228",4,1,0,5,"dummy"
"10229",1,12,0,13,"dummy"
"10230",0,1,0,1,"dummy"
"10231",0,0,1,1,"dummy"
"10232",0,5,0,5,"dummy"
"10233",0,12,1,13,"dummy"
"10275",1,0,0,1,"dummy"
"10276",2,6,0,8,"dummy"
"10277",1,0,0,1,"dummy"
"10278",1,0,0,1,"dummy"
"10279",0,1,0,1,"dummy"
"10280",0,0,2,2,"dummy"
"10281",4,0,0,4,"dummy"
"10282",0,0,2,2,"dummy"
"10289",4,1,0,5,"dummy"
"10295",0,0,0,0,"dummy"
"10299",0,2,1,3,"dummy"
"10300",0,1,0,1,"dummy"
"10303",0,1,0,1,"dummy"
"10304",2,2,1,5,"dummy"
"10317",0,1,0,1,"dummy"
"10327",0,0,1,1,"dummy"
"10328",1,2,2,5,"dummy"
"10329",0,2,0,2,"dummy"
"10330",0,2,0,2,"dummy"
"10331",0,1,0,1,"dummy"
"10332",2,3,0,5,"dummy"
"10333",3,0,0,3,"dummy"
"10334",0,1,1,2,"dummy"
"10335",2,2,0,4,"dummy"
"10336",1,0,0,1,"dummy"
"10337",0,0,1,1,"dummy"
"10338",1,3,0,4,"dummy"
"10339",0,0,1,1,"dummy"
"10340",0,0,1,1,"dummy"
"10341",0,0,2,2,"dummy"
"10343",0,0,1,1,"dummy"
"10344",0,2,0,2,"dummy"
"10345",0,3,0,3,"dummy"
"10346",4,3,0,7,"dummy"
"10347",3,1,2,6,"dummy"
"10348",0,0,1,1,"dummy"
"10350",0,1,0,1,"dummy"
"10354",0,1,0,1,"dummy"
"10355",0,0,1,1,"dummy"
"10358",0,0,1,1,"dummy"
"10360",0,0,2,2,"dummy"
"10361",0,2,0,2,"dummy"
"10363",0,0,1,1,"dummy"
"10374",0,0,0,0,"dummy"
"10376",4,2,0,6,"dummy"
"10377",1,0,0,1,"dummy"
"10378",2,3,1,6,"dummy"
"10379",0,4,0,4,"dummy"
"10381",13,0,0,13,"dummy"
"10382",2,26,0,28,"dummy"
"10383",9,3,1,13,"dummy"
"10384",0,10,0,10,"dummy"
"10385",1,1,0,2,"dummy"
"10386",0,1,0,1,"dummy"
"10387",0,4,0,4,"dummy"
"10388",0,1,0,1,"dummy"
"10389",1,0,0,1,"dummy"
"10390",0,0,0,0,"dummy"
"10410",0,0,1,1,"dummy"
"10413",1,4,0,5,"dummy"
"10414",4,1,0,5,"dummy"
"10415",0,0,1,1,"dummy"
"10416",0,2,1,3,"dummy"
"10417",0,0,1,1,"dummy"
"10418",0,1,0,1,"dummy"
"10419",1,1,0,2,"dummy"
"10420",1,0,0,1,"dummy"
"10421",0,1,0,1,"dummy"
"10422",0,0,0,0,"dummy"
"10428",0,15,4,19,"dummy"
"10429",1,0,0,1,"dummy"
"10430",0,0,0,0,"dummy"
"10431",0,1,1,2,"dummy"
"10432",0,0,1,1,"dummy"
"10433",0,2,0,2,"dummy"
"10434",1,0,0,1,"dummy"
"10435",0,3,0,3,"dummy"
"10436",4,4,0,8,"dummy"
"10437",0,1,0,1,"dummy"
"10438",0,0,1,1,"dummy"
"10439",3,10,2,15,"dummy"
"10440",0,0,2,2,"dummy"
"10441",0,0,2,2,"dummy"
"10442",0,0,1,1,"dummy"
"10443",0,0,1,1,"dummy"
"10444",0,1,0,1,"dummy"
"10445",5,8,0,13,"dummy"
"10446",6,0,1,7,"dummy"
"10451",1,0,0,1,"dummy"
"10456",3,7,1,11,"dummy"
"10457",5,7,0,12,"dummy"
"10458",0,0,1,1,"dummy"
"10459",0,0,2,2,"dummy"
"10460",4,1,5,10,"dummy"
"10461",0,2,0,2,"dummy"
"10464",0,1,3,4,"dummy"
"10465",0,1,4,5,"dummy"
"10466",2,0,3,5,"dummy"
"10467",0,1,3,4,"dummy"
"10468",1,0,3,4,"dummy"
"10469",0,0,3,3,"dummy"
"10470",0,2,3,5,"dummy"
"10471",2,2,3,7,"dummy"
"10476",0,0,0,0,"dummy"
"10477",0,0,0,0,"dummy"
"10489",0,1,0,1,"dummy"
"10490",0,0,0,0,"dummy"
"10502",1,9,1,11,"dummy"
"10503",5,1,0,6,"dummy"
"10524",0,1,0,1,"dummy"
"10525",0,2,3,5,"dummy"
"10526",3,2,1,6,"dummy"
"10527",0,0,1,1,"dummy"
"10530",2,2,0,4,"dummy"
"10531",0,1,0,1,"dummy"
"10532",1,0,0,1,"dummy"
"10536",0,1,0,1,"dummy"
"10541",0,1,0,1,"dummy"
"10448",0,0,1,1,"dummy"
"10449",10,6,1,17,"dummy"
"10473",0,0,1,1,"dummy"
"10474",1,8,4,13,"dummy"
"10481",0,0,1,1,"dummy"
"10482",1,8,0,9,"dummy"
"10507",0,16,1,17,"dummy"
"10508",5,6,0,11,"dummy"
"10509",12,14,0,26,"dummy"
"10510",0,1,0,1,"dummy"
"10511",0,1,0,1,"dummy"
"10512",1,2,0,3,"dummy"
"10513",17,42,4,63,"dummy"
"10514",0,0,0,0,"dummy"
"10515",0,3,0,3,"dummy"
"10516",2,2,0,4,"dummy"
"10517",2,2,1,5,"dummy"
"10518",0,0,4,4,"dummy"
"10519",0,0,4,4,"dummy"
"10520",2,0,0,2,"dummy"
"10521",8,2,1,11,"dummy"
"10522",5,10,1,16,"dummy"
"10543",3,3,0,6,"dummy"
"10548",7,0,0,7,"dummy"
"10551",0,0,0,0,"dummy"
"10552",0,0,0,0,"dummy"
"10554",0,0,2,2,"dummy"
"10555",0,1,0,1,"dummy"
"10556",0,1,0,1,"dummy"
"10562",0,0,0,0,"dummy"
"10563",0,1,0,1,"dummy"
"10564",0,0,0,0,"dummy"
"10565",0,0,2,2,"dummy"
"10566",0,0,1,1,"dummy"
"10569",0,5,0,5,"dummy"
"10572",0,1,0,1,"dummy"
"10575",2,5,2,9,"dummy"
"10577",0,1,1,2,"dummy"
"10578",0,0,2,2,"dummy"
"10582",0,0,0,0,"dummy"
"10584",0,1,1,2,"dummy"
"10585",0,1,1,2,"dummy"
"10586",1,0,0,1,"dummy"
"10597",0,1,1,2,"dummy"
"10598",0,1,1,2,"dummy"
"10599",2,6,1,9,"dummy"
"10619",0,2,0,2,"dummy"
"10621",11,15,5,31,"dummy"
"10622",17,16,6,39,"dummy"
"10623",0,1,2,3,"dummy"
"10624",0,1,0,1,"dummy"
"10625",0,1,1,2,"dummy"
"10626",15,14,4,33,"dummy"
"10627",0,1,1,2,"dummy"
"10628",1,0,0,1,"dummy"
"10629",0,1,0,1,"dummy"
"10631",0,0,1,1,"dummy"
"10632",0,0,2,2,"dummy"
"10633",2,0,4,6,"dummy"
"10634",0,0,4,4,"dummy"
"10635",0,0,1,1,"dummy"
"10642",0,1,0,1,"dummy"
"10643",1,0,0,1,"dummy"
"10644",2,1,1,4,"dummy"
"10663",0,2,0,2,"dummy"
"10664",0,0,2,2,"dummy"
"10665",0,0,1,1,"dummy"
"10666",0,0,2,2,"dummy"
"10678",6,18,2,26,"dummy"
"10679",0,0,1,1,"dummy"
"10680",5,0,0,5,"dummy"
"10681",0,1,0,1,"dummy"
"10682",1,10,2,13,"dummy"
"10683",0,2,0,2,"dummy"
"10684",0,4,0,4,"dummy"
"10685",0,1,0,1,"dummy"
"10692",4,6,1,11,"dummy"
"10693",3,0,0,3,"dummy"
"10695",0,0,0,0,"dummy"
"10696",1,2,0,3,"dummy"
"10697",0,0,1,1,"dummy"
"10698",0,0,1,1,"dummy"
"10699",0,1,1,2,"dummy"
"10700",0,1,1,2,"dummy"
"10702",2,2,3,7,"dummy"
"10703",0,0,2,2,"dummy"
"10704",2,2,4,8,"dummy"
"10705",2,3,1,6,"dummy"
"10707",0,0,1,1,"dummy"
"10708",0,0,1,1,"dummy"
"10709",0,0,1,1,"dummy"
"10716",0,2,0,2,"dummy"
"10717",0,1,0,1,"dummy"
"10719",0,1,0,1,"dummy"
"10720",0,1,0,1,"dummy"
"10721",0,1,0,1,"dummy"
"10722",0,2,0,2,"dummy"
"10723",0,1,0,1,"dummy"
"10724",0,6,0,6,"dummy"
"10726",0,0,1,1,"dummy"
"10727",0,1,1,2,"dummy"
"10728",0,2,0,2,"dummy"
"10729",7,0,1,8,"dummy"
"10730",0,2,0,2,"dummy"
"10731",0,0,1,1,"dummy"
"10734",1,0,0,1,"dummy"
"10735",1,1,1,3,"dummy"
"10736",0,1,0,1,"dummy"
"10737",1,1,1,3,"dummy"
"10738",2,1,1,4,"dummy"
"10742",0,1,0,1,"dummy"
"10743",0,1,0,1,"dummy"
"10744",0,0,1,1,"dummy"
"10745",0,1,0,1,"dummy"
"10752",0,1,1,2,"dummy"
"10753",0,0,1,1,"dummy"
"10755",1,3,1,5,"dummy"
"10756",0,3,0,3,"dummy"
"10757",0,1,0,1,"dummy"
"10758",3,1,0,4,"dummy"
"10759",0,0,2,2,"dummy"
"10760",4,10,2,16,"dummy"
"10761",0,2,0,2,"dummy"
"10763",0,0,1,1,"dummy"
"10766",1,0,2,3,"dummy"
"10768",0,0,0,0,"dummy"
"10769",0,1,0,1,"dummy"
"10770",0,4,0,4,"dummy"
"10771",0,1,0,1,"dummy"
"10772",8,2,2,12,"dummy"
"10773",1,0,1,2,"dummy"
"10775",0,0,1,1,"dummy"
"10776",0,0,1,1,"dummy"
"10777",0,0,1,1,"dummy"
"10778",0,0,1,1,"dummy"
"10784",0,2,0,2,"dummy"
"10785",0,1,0,1,"dummy"
"10786",1,0,0,1,"dummy"
"10788",3,4,0,7,"dummy"
"10789",0,2,0,2,"dummy"
"10790",1,1,0,2,"dummy"
"10791",3,4,1,8,"dummy"
"10792",0,0,1,1,"dummy"
"10793",0,0,1,1,"dummy"
"10795",0,0,1,1,"dummy"
"10796",0,0,0,0,"dummy"
"10797",1,0,1,2,"dummy"
"10798",0,0,1,1,"dummy"
"10800",0,2,1,3,"dummy"
"10801",0,3,0,3,"dummy"
"10802",15,0,2,17,"dummy"
"10803",0,0,1,1,"dummy"
"10805",1,17,2,20,"dummy"
"10806",0,2,0,2,"dummy"
"10807",2,2,0,4,"dummy"
"10809",1,0,0,1,"dummy"
"10813",11,4,3,18,"dummy"
"10814",0,0,0,0,"dummy"
"10815",0,0,1,1,"dummy"
"10816",0,1,1,2,"dummy"
"10817",0,19,1,20,"dummy"
"10818",7,0,0,7,"dummy"
"10824",3,8,0,11,"dummy"
"10825",0,2,0,2,"dummy"
"10826",0,3,7,10,"dummy"
"10827",0,0,1,1,"dummy"
"10828",0,0,1,1,"dummy"
"10829",0,0,1,1,"dummy"
"10830",0,0,1,1,"dummy"
"10831",0,3,0,3,"dummy"
"10832",0,1,0,1,"dummy"
"10833",0,0,0,0,"dummy"
"10834",3,2,0,5,"dummy"
"10835",0,0,3,3,"dummy"
"10836",2,0,3,5,"dummy"
"10837",0,0,3,3,"dummy"
"10838",0,0,2,2,"dummy"
"10839",8,10,1,19,"dummy"
"10842",0,0,0,0,"dummy"
"10844",1,7,0,8,"dummy"
"10845",0,0,0,0,"dummy"
"10846",2,5,0,7,"dummy"
"10847",0,1,0,1,"dummy"
"10848",0,2,0,2,"dummy"
"10850",3,0,0,3,"dummy"
"10852",3,5,4,12,"dummy"
"10856",2,0,0,2,"dummy"
"10857",0,1,0,1,"dummy"
"10858",0,7,0,7,"dummy"
"10859",10,0,0,10,"dummy"
"10860",9,0,0,9,"dummy"
"10861",0,2,2,4,"dummy"
"10862",6,2,2,10,"dummy"
"10863",0,1,0,1,"dummy"
"10869",0,26,2,28,"dummy"
"10870",12,8,3,23,"dummy"
"10871",0,0,1,1,"dummy"
"10872",0,0,1,1,"dummy"
"10873",0,2,0,2,"dummy"
"10874",5,6,1,12,"dummy"
"10875",0,1,0,1,"dummy"
"10876",0,0,1,1,"dummy"
"10886",0,0,0,0,"dummy"
"10887",0,2,0,2,"dummy"
"10888",1,1,0,2,"dummy"
"10889",0,0,0,0,"dummy"
"10890",0,0,3,3,"dummy"
"10891",0,0,0,0,"dummy"
"10895",0,1,1,2,"dummy"
"10896",0,0,1,1,"dummy"
"10897",0,0,1,1,"dummy"
"10898",0,26,0,26,"dummy"
"10899",0,0,1,1,"dummy"
"10900",0,0,1,1,"dummy"
"10902",0,1,0,1,"dummy"
"10906",0,1,0,1,"dummy"
"10907",0,1,0,1,"dummy"
"10908",0,1,0,1,"dummy"
"10910",4,7,5,16,"dummy"
"10911",3,2,3,8,"dummy"
"10912",0,2,3,5,"dummy"
"10913",0,0,1,1,"dummy"
"10914",0,0,1,1,"dummy"
"10915",0,0,1,1,"dummy"
"10916",0,0,4,4,"dummy"
"10917",0,0,1,1,"dummy"
"10918",0,0,1,1,"dummy"
"10919",0,0,2,2,"dummy"
"10920",0,0,2,2,"dummy"
"10921",0,0,1,1,"dummy"
"10922",0,0,2,2,"dummy"
"10931",0,1,0,1,"dummy"
"10933",0,0,0,0,"dummy"
"10934",0,2,0,2,"dummy"
"10935",0,0,0,0,"dummy"
"10937",0,4,0,4,"dummy"
"10938",0,1,0,1,"dummy"
"10939",0,1,0,1,"dummy"
"10940",0,3,0,3,"dummy"
"10941",2,8,2,12,"dummy"
"10942",1,0,4,5,"dummy"
"10943",1,3,0,4,"dummy"
"10944",4,3,3,10,"dummy"
"10945",1,0,1,2,"dummy"
"10946",1,0,0,1,"dummy"
"10947",1,0,0,1,"dummy"
"10948",0,1,0,1,"dummy"
"10949",2,0,3,5,"dummy"
"10950",8,1,0,9,"dummy"
"10951",0,1,0,1,"dummy"
"10952",1,0,0,1,"dummy"
"10953",1,0,0,1,"dummy"
"10954",1,0,0,1,"dummy"
"10955",1,0,0,1,"dummy"
"10956",1,0,0,1,"dummy"
"10957",0,1,0,1,"dummy"
"10958",0,1,0,1,"dummy"
"10959",1,0,0,1,"dummy"
"10960",2,15,0,17,"dummy"
"10963",4,4,1,9,"dummy"
"10965",0,1,2,3,"dummy"
"10966",0,0,0,0,"dummy"
"10967",0,1,0,1,"dummy"
"10968",4,0,2,6,"dummy"
"10969",1,0,0,1,"dummy"
"10970",0,0,0,0,"dummy"
"10975",5,12,0,17,"dummy"
"10977",0,2,0,2,"dummy"
"10978",15,4,0,19,"dummy"
"10979",0,3,4,7,"dummy"
"10980",7,22,0,29,"dummy"
"10981",0,2,0,2,"dummy"
"10991",0,0,0,0,"dummy"
"10993",2,2,1,5,"dummy"
"10994",0,1,0,1,"dummy"
"10996",0,18,0,18,"dummy"
"10997",0,3,1,4,"dummy"
"10998",2,2,0,4,"dummy"
"10999",0,1,0,1,"dummy"
"11003",0,0,0,0,"dummy"
"11016",2,1,4,7,"dummy"
"11020",0,0,1,1,"dummy"
"11022",0,3,0,3,"dummy"
"11023",0,3,0,3,"dummy"
"11024",0,7,0,7,"dummy"
"11025",0,4,0,4,"dummy"
"11026",0,0,0,0,"dummy"
"11027",0,3,0,3,"dummy"
"11028",20,17,4,41,"dummy"
"11029",0,0,0,0,"dummy"
"11030",2,1,1,4,"dummy"
"11031",0,1,0,1,"dummy"
"11032",0,1,0,1,"dummy"
"11033",0,0,1,1,"dummy"
"11034",10,15,5,30,"dummy"
"11035",0,1,0,1,"dummy"
"11036",0,1,0,1,"dummy"
"11037",0,1,0,1,"dummy"
"11038",0,1,0,1,"dummy"
"11043",1,0,0,1,"dummy"
"11053",0,4,1,5,"dummy"
"11056",0,14,0,14,"dummy"
"11057",0,2,1,3,"dummy"
"11058",4,3,0,7,"dummy"
"11059",10,18,2,30,"dummy"
"11060",0,3,0,3,"dummy"
"11061",3,2,0,5,"dummy"
"11062",0,3,0,3,"dummy"
"11067",0,0,1,1,"dummy"
"11069",19,20,2,41,"dummy"
"11071",0,0,1,1,"dummy"
"11073",5,4,0,9,"dummy"
"11074",0,0,1,1,"dummy"
"11075",1,3,0,4,"dummy"
"11078",0,2,0,2,"dummy"
"11079",0,0,0,0,"dummy"
"11092",4,6,0,10,"dummy"
"11093",0,0,1,1,"dummy"
"11094",0,1,0,1,"dummy"
"11095",0,1,0,1,"dummy"
"11096",8,8,0,16,"dummy"
"11097",1,0,1,2,"dummy"
"11098",5,2,1,8,"dummy"
"11099",0,0,2,2,"dummy"
"11100",0,0,1,1,"dummy"
"11101",0,0,0,0,"dummy"
"11105",1,1,0,2,"dummy"
"11106",0,0,1,1,"dummy"
"11107",0,0,1,1,"dummy"
"11110",0,4,0,4,"dummy"
"11111",2,1,0,3,"dummy"
"11112",0,0,3,3,"dummy"
"11113",0,0,1,1,"dummy"
"11114",0,2,0,2,"dummy"
"11115",4,0,2,6,"dummy"
"11116",0,45,0,45,"dummy"
"11117",4,4,0,8,"dummy"
"11118",4,6,0,10,"dummy"
"11119",0,0,0,0,"dummy"
"11120",1,1,0,2,"dummy"
"11121",1,2,0,3,"dummy"
"11128",0,0,1,1,"dummy"
"11129",0,0,1,1,"dummy"
"11130",1,0,0,1,"dummy"
"11131",0,0,1,1,"dummy"
"11136",2,2,0,4,"dummy"
"11147",0,2,0,2,"dummy"
"11155",1,0,0,1,"dummy"
"11156",0,2,0,2,"dummy"
"11191",0,0,2,2,"dummy"
"11203",0,29,0,29,"dummy"
"11204",0,0,1,1,"dummy"
"11234",0,2,1,3,"dummy"
"11244",0,0,1,1,"dummy"
"11253",0,1,0,1,"dummy"
"11254",0,1,0,1,"dummy"
"11271",0,0,1,1,"dummy"
"11280",0,19,0,19,"dummy"
"11281",1,3,0,4,"dummy"
"11282",0,0,1,1,"dummy"
"11283",0,0,1,1,"dummy"
"11286",0,0,2,2,"dummy"
"11287",0,0,1,1,"dummy"
"11288",0,0,1,1,"dummy"
"11291",3,3,2,8,"dummy"
"11292",0,1,0,1,"dummy"
"11293",0,0,2,2,"dummy"
"11298",0,0,4,4,"dummy"
"11299",0,0,0,0,"dummy"
"11300",0,1,0,1,"dummy"
"11301",0,2,0,2,"dummy"
"11302",0,0,1,1,"dummy"
"11305",0,0,0,0,"dummy"
"11306",1,1,0,2,"dummy"
"11322",0,1,0,1,"dummy"
"11323",0,2,0,2,"dummy"
"11140",1,1,1,3,"dummy"
"11141",0,2,0,2,"dummy"
"11145",16,2,2,20,"dummy"
"11151",5,0,1,6,"dummy"
"11158",0,0,1,1,"dummy"
"11161",0,1,0,1,"dummy"
"11162",0,5,0,5,"dummy"
"11163",0,0,1,1,"dummy"
"11166",0,0,3,3,"dummy"
"11180",3,0,0,3,"dummy"
"11183",1,0,0,1,"dummy"
"11184",0,1,0,1,"dummy"
"11185",0,5,0,5,"dummy"
"11186",0,3,1,4,"dummy"
"11187",4,3,1,8,"dummy"
"11188",1,6,2,9,"dummy"
"11189",0,0,1,1,"dummy"
"11193",0,1,0,1,"dummy"
"11194",1,0,0,1,"dummy"
"11195",0,0,0,0,"dummy"
"11196",0,2,0,2,"dummy"
"11197",0,2,1,3,"dummy"
"11198",0,2,0,2,"dummy"
"11199",0,1,0,1,"dummy"
"11213",0,0,1,1,"dummy"
"11214",0,0,1,1,"dummy"
"11217",0,0,0,0,"dummy"
"11218",0,0,0,0,"dummy"
"11219",0,0,0,0,"dummy"
"11220",0,0,0,0,"dummy"
"11221",0,0,0,0,"dummy"
"11222",0,0,0,0,"dummy"
"11223",0,0,0,0,"dummy"
"11224",0,0,0,0,"dummy"
"11225",0,0,0,0,"dummy"
"11226",0,0,0,0,"dummy"
"11227",0,0,0,0,"dummy"
"11228",0,0,0,0,"dummy"
"11229",0,0,0,0,"dummy"
"11230",0,0,0,0,"dummy"
"11231",0,0,0,0,"dummy"
"11232",0,0,0,0,"dummy"
"11246",3,2,3,8,"dummy"
"11251",0,0,1,1,"dummy"
"11264",2,0,0,2,"dummy"
"11265",0,4,0,4,"dummy"
"11266",0,2,0,2,"dummy"
"11269",1,3,1,5,"dummy"
"11312",0,3,0,3,"dummy"
"11313",3,0,0,3,"dummy"
"11316",0,3,0,3,"dummy"
"11325",0,0,2,2,"dummy"
"11421",1,0,0,1,"dummy"
"11453",0,0,1,1,"dummy"
"11390",0,0,1,1,"dummy"
"11391",0,0,1,1,"dummy"
"11392",0,0,4,4,"dummy"
"11393",0,0,1,1,"dummy"
"11407",3,8,1,12,"dummy"
"11408",0,4,0,4,"dummy"
"11409",11,4,2,17,"dummy"
"11410",0,1,0,1,"dummy"
"11411",5,11,2,18,"dummy"
"11412",5,6,0,11,"dummy"
"11417",2,0,1,3,"dummy"
"11423",2,2,0,4,"dummy"
"11426",0,5,0,5,"dummy"
"11427",5,20,1,26,"dummy"
"11430",0,0,1,1,"dummy"
"11433",0,1,1,2,"dummy"
"11434",1,0,0,1,"dummy"
"11445",0,1,0,1,"dummy"
"11446",0,5,1,6,"dummy"
"11447",0,2,1,3,"dummy"
"11448",0,0,2,2,"dummy"
"11449",0,2,0,2,"dummy"
"11450",22,9,6,37,"dummy"
"11451",0,0,1,1,"dummy"
"11454",1,2,0,3,"dummy"
"11455",0,2,0,2,"dummy"
"11456",0,0,0,0,"dummy"
"11457",0,0,0,0,"dummy"
"11458",0,0,1,1,"dummy"
"11459",0,4,0,4,"dummy"
"11464",0,1,2,3,"dummy"
"11467",0,0,0,0,"dummy"
"11468",1,0,0,1,"dummy"
"11469",0,0,1,1,"dummy"
"11470",2,3,0,5,"dummy"
"11471",0,0,1,1,"dummy"
"11472",0,0,0,0,"dummy"
"11473",4,1,0,5,"dummy"
"11474",1,0,0,1,"dummy"
"11475",0,0,0,0,"dummy"
"11476",0,0,0,0,"dummy"
"11514",0,0,0,0,"dummy"
"11515",0,0,0,0,"dummy"
"11516",0,0,0,0,"dummy"
"11517",0,0,0,0,"dummy"
"11518",0,0,0,0,"dummy"
"11519",0,0,0,0,"dummy"
"11523",1,0,1,2,"dummy"
"11524",0,0,1,1,"dummy"
"11526",3,2,2,7,"dummy"
"11536",0,0,0,0,"dummy"
"11537",0,0,0,0,"dummy"
"11538",0,0,0,0,"dummy"
"11539",0,0,0,0,"dummy"
"11540",0,0,0,0,"dummy"
"11541",0,0,0,0,"dummy"
"11542",0,1,0,1,"dummy"
"11544",1,1,0,2,"dummy"
"11545",0,0,0,0,"dummy"
"11549",0,16,0,16,"dummy"
"11551",0,14,0,14,"dummy"
"11552",0,0,1,1,"dummy"
"11553",0,5,1,6,"dummy"
"11554",2,3,0,5,"dummy"
"11555",0,0,2,2,"dummy"
"11560",3,1,0,4,"dummy"
"11563",0,0,1,1,"dummy"
"11564",0,0,0,0,"dummy"
"11566",0,2,0,2,"dummy"
"11567",0,1,0,1,"dummy"
"11568",0,2,1,3,"dummy"
"11569",0,1,0,1,"dummy"
"11570",0,0,1,1,"dummy"
"11571",0,2,0,2,"dummy"
"11572",0,2,1,3,"dummy"
"11573",0,2,0,2,"dummy"
"11574",1,0,0,1,"dummy"
"11575",0,1,0,1,"dummy"
"11576",0,5,0,5,"dummy"
"11577",0,1,0,1,"dummy"
"11578",2,5,0,7,"dummy"
"11579",0,2,0,2,"dummy"
"11580",1,0,0,1,"dummy"
"11581",1,1,0,2,"dummy"
"11582",0,0,1,1,"dummy"
"11583",18,2,1,21,"dummy"
"11584",0,0,1,1,"dummy"
"11591",4,3,4,11,"dummy"
"11602",0,0,0,0,"dummy"
"11603",0,0,1,1,"dummy"
"11605",0,1,0,1,"dummy"
"11608",0,0,1,1,"dummy"
"11610",0,0,1,1,"dummy"
"11611",0,0,2,2,"dummy"
"11612",0,1,0,1,"dummy"
"11613",0,0,1,1,"dummy"
"11614",12,19,2,33,"dummy"
"11615",0,0,1,1,"dummy"
"11616",8,5,2,15,"dummy"
"11617",0,2,0,2,"dummy"
"11618",0,0,1,1,"dummy"
"11619",1,0,0,1,"dummy"
"11622",0,2,0,2,"dummy"
"11625",4,0,0,4,"dummy"
"11626",0,6,0,6,"dummy"
"11627",9,14,2,25,"dummy"
"11628",5,6,3,14,"dummy"
"11634",1,0,0,1,"dummy"
"11635",0,1,3,4,"dummy"
"11636",1,0,0,1,"dummy"
"11637",2,3,2,7,"dummy"
"11638",1,0,0,1,"dummy"
"11639",1,0,0,1,"dummy"
"11640",0,1,0,1,"dummy"
"11641",0,1,0,1,"dummy"
"11642",0,3,0,3,"dummy"
"11643",0,1,0,1,"dummy"
"11644",1,0,0,1,"dummy"
"11651",0,0,0,0,"dummy"
"11652",3,0,0,3,"dummy"
"11656",0,0,2,2,"dummy"
"11670",0,6,1,7,"dummy"
"11671",5,2,1,8,"dummy"
"11674",2,0,2,4,"dummy"
"11762",0,0,1,1,"dummy"
"11763",0,2,0,2,"dummy"
"11764",1,1,5,7,"dummy"
"11765",1,0,5,6,"dummy"
"11779",3,3,2,8,"dummy"
"11632",0,0,1,1,"dummy"
"11646",0,1,0,1,"dummy"
"11647",0,1,0,1,"dummy"
"11648",12,18,1,31,"dummy"
"11649",0,8,0,8,"dummy"
"11654",1,1,0,2,"dummy"
"11658",0,0,1,1,"dummy"
"11659",0,1,0,1,"dummy"
"11660",0,0,1,1,"dummy"
"11661",0,2,0,2,"dummy"
"11662",0,0,0,0,"dummy"
"11663",0,1,2,3,"dummy"
"11664",0,2,0,2,"dummy"
"11665",1,0,0,1,"dummy"
"11666",0,0,1,1,"dummy"
"11754",0,1,0,1,"dummy"
"11755",0,0,1,1,"dummy"
"11756",13,11,2,26,"dummy"
"11757",0,0,1,1,"dummy"
"11758",0,0,0,0,"dummy"
"11759",1,5,0,6,"dummy"
"11760",2,2,0,4,"dummy"
"11769",0,0,1,1,"dummy"
"11772",0,0,1,1,"dummy"
"11773",0,0,0,0,"dummy"
"11774",0,0,1,1,"dummy"
"11775",0,0,1,1,"dummy"
"11785",0,1,0,1,"dummy"
"11787",0,6,0,6,"dummy"
"11789",0,7,0,7,"dummy"
"11792",0,2,0,2,"dummy"
"11793",0,1,0,1,"dummy"
"11794",0,3,1,4,"dummy"
"11795",0,5,0,5,"dummy"
"11796",7,3,0,10,"dummy"
"11798",31,7,1,39,"dummy"
"11799",0,2,0,2,"dummy"
"11800",6,2,1,9,"dummy"
"11801",1,4,0,5,"dummy"
"11802",1,3,4,8,"dummy"
"11803",16,19,2,37,"dummy"
"11805",0,6,0,6,"dummy"
"11806",1,6,0,7,"dummy"
"11810",0,1,0,1,"dummy"
"11811",0,0,0,0,"dummy"
"11813",0,2,1,3,"dummy"
"11814",1,0,0,1,"dummy"
"11816",0,0,2,2,"dummy"
"11817",4,1,1,6,"dummy"
"11818",0,2,0,2,"dummy"
"11819",0,0,0,0,"dummy"
"11821",0,0,0,0,"dummy"
"11822",0,0,0,0,"dummy"
"11823",6,0,0,6,"dummy"
"11824",2,0,0,2,"dummy"
"11841",0,1,0,1,"dummy"
"11842",0,0,1,1,"dummy"
"11846",0,1,0,1,"dummy"
"11847",3,1,4,8,"dummy"
"11849",0,3,0,3,"dummy"
"11850",1,2,0,3,"dummy"
"11852",14,2,2,18,"dummy"
"11853",0,5,3,8,"dummy"
"11854",4,0,0,4,"dummy"
"11857",0,2,0,2,"dummy"
"11858",2,3,1,6,"dummy"
"11889",0,0,0,0,"dummy"
"11892",0,0,0,0,"dummy"
"11893",0,1,0,1,"dummy"
"11894",0,0,1,1,"dummy"
"11896",0,0,0,0,"dummy"
"11897",0,2,1,3,"dummy"
"11898",2,0,1,3,"dummy"
"11916",0,7,4,11,"dummy"
"11920",11,1,0,12,"dummy"
"11921",0,2,0,2,"dummy"
"11923",0,10,1,11,"dummy"
"11924",0,1,2,3,"dummy"
"11925",0,0,0,0,"dummy"
"11926",0,0,0,0,"dummy"
"11927",0,0,0,0,"dummy"
"11928",0,0,0,0,"dummy"
"11929",0,0,0,0,"dummy"
"11930",0,0,0,0,"dummy"
"11931",0,0,0,0,"dummy"
"11932",0,0,0,0,"dummy"
"11933",0,0,0,0,"dummy"
"11934",1,0,0,1,"dummy"
"11935",0,0,0,0,"dummy"
"11936",0,0,0,0,"dummy"
"11937",0,0,0,0,"dummy"
"11938",0,0,0,0,"dummy"
"11939",0,2,1,3,"dummy"
"11940",0,1,0,1,"dummy"
"11941",0,0,0,0,"dummy"
"11942",0,0,0,0,"dummy"
"11943",0,0,0,0,"dummy"
"11944",0,0,0,0,"dummy"
"11945",0,0,0,0,"dummy"
"11946",0,0,0,0,"dummy"
"11947",0,0,0,0,"dummy"
"11948",0,0,0,0,"dummy"
"11949",0,1,0,1,"dummy"
"11950",0,0,0,0,"dummy"
"11951",0,0,0,0,"dummy"
"11952",0,0,0,0,"dummy"
"11954",0,2,0,2,"dummy"
"11955",2,2,7,11,"dummy"
"11956",2,0,0,2,"dummy"
"11957",0,1,0,1,"dummy"
"11958",20,9,2,31,"dummy"
"11960",0,1,4,5,"dummy"
"11961",2,8,1,11,"dummy"
"11962",0,1,0,1,"dummy"
"11963",0,1,0,1,"dummy"
"11964",0,1,0,1,"dummy"
"11966",0,0,1,1,"dummy"
"11967",0,2,0,2,"dummy"
"11968",0,1,0,1,"dummy"
"11969",0,0,0,0,"dummy"
"11970",0,0,0,0,"dummy"
"11971",0,1,0,1,"dummy"
"11972",0,0,1,1,"dummy"
"11973",1,1,0,2,"dummy"
"11974",2,2,1,5,"dummy"
"11975",0,0,0,0,"dummy"
"11976",1,2,0,3,"dummy"
"11977",3,10,0,13,"dummy"
"11978",2,3,1,6,"dummy"
"11979",0,0,1,1,"dummy"
"11980",3,1,1,5,"dummy"
"11981",4,3,0,7,"dummy"
"11982",0,3,0,3,"dummy"
"11983",0,0,1,1,"dummy"
"11984",8,5,4,17,"dummy"
"11985",1,2,0,3,"dummy"
"11986",0,2,0,2,"dummy"
"11988",2,0,3,5,"dummy"
"11989",1,0,0,1,"dummy"
"11990",0,1,0,1,"dummy"
"11991",0,1,1,2,"dummy"
"11993",0,0,4,4,"dummy"
"11994",0,0,4,4,"dummy"
"11995",0,0,4,4,"dummy"
"11996",0,0,4,4,"dummy"
"11997",0,0,4,4,"dummy"
"11998",0,0,4,4,"dummy"
"11999",0,0,4,4,"dummy"
"12005",0,4,1,5,"dummy"
"12006",1,2,0,3,"dummy"
"12007",0,0,3,3,"dummy"
"12008",0,3,1,4,"dummy"
"12009",0,0,0,0,"dummy"
"12010",0,1,0,1,"dummy"
"12011",0,0,0,0,"dummy"
"12012",30,4,0,34,"dummy"
"12013",0,0,1,1,"dummy"
"12015",8,17,2,27,"dummy"
"12016",12,29,2,43,"dummy"
"12017",29,41,12,82,"dummy"
"12018",0,1,0,1,"dummy"
"12019",7,20,0,27,"dummy"
"12020",1,5,1,7,"dummy"
"12021",2,2,0,4,"dummy"
"12022",0,13,0,13,"dummy"
"12023",0,2,0,2,"dummy"
"12024",6,46,13,65,"dummy"
"12025",0,1,0,1,"dummy"
"12026",7,8,5,20,"dummy"
"12027",0,1,0,1,"dummy"
"12028",0,3,0,3,"dummy"
"12029",0,0,0,0,"dummy"
"12030",0,2,0,2,"dummy"
"12031",1,0,0,1,"dummy"
"12032",0,1,0,1,"dummy"
"12033",26,5,0,31,"dummy"
"12035",0,3,0,3,"dummy"
"12036",0,1,0,1,"dummy"
"12038",0,3,0,3,"dummy"
"12039",0,1,0,1,"dummy"
"12045",1,0,0,1,"dummy"
"12046",0,0,1,1,"dummy"
"12047",2,0,0,2,"dummy"
"12048",0,0,1,1,"dummy"
"12049",0,1,0,1,"dummy"
"12050",0,2,0,2,"dummy"
"12054",0,1,0,1,"dummy"
"12055",0,5,0,5,"dummy"
"12056",1,2,0,3,"dummy"
"12057",0,1,0,1,"dummy"
"12058",0,0,1,1,"dummy"
"12059",0,0,1,1,"dummy"
"12062",6,0,0,6,"dummy"
"12063",2,5,2,9,"dummy"
"12065",0,1,0,1,"dummy"
"12067",1,1,0,2,"dummy"
"12068",4,35,3,42,"dummy"
"12069",54,16,5,75,"dummy"
"12071",2,2,1,5,"dummy"
"12073",0,0,1,1,"dummy"
"12075",1,1,1,3,"dummy"
"12080",3,16,0,19,"dummy"
"12082",2,0,0,2,"dummy"
"12084",0,4,1,5,"dummy"
"12085",0,1,0,1,"dummy"
"12089",0,0,0,0,"dummy"
"12090",0,0,0,0,"dummy"
"12091",0,0,0,0,"dummy"
"12092",1,5,1,7,"dummy"
"12093",0,1,0,1,"dummy"
"12094",1,1,1,3,"dummy"
"12095",0,0,2,2,"dummy"
"12096",1,1,1,3,"dummy"
"12097",1,0,0,1,"dummy"
"12098",1,0,2,3,"dummy"
"12099",0,1,0,1,"dummy"
"12100",0,1,1,2,"dummy"
"12101",0,1,0,1,"dummy"
"12102",1,0,6,7,"dummy"
"12103",1,0,1,2,"dummy"
"12104",1,1,3,5,"dummy"
"12105",0,0,2,2,"dummy"
"12110",0,1,0,1,"dummy"
"12111",0,0,1,1,"dummy"
"12112",0,0,3,3,"dummy"
"12113",0,8,3,11,"dummy"
"12114",1,0,0,1,"dummy"
"12115",0,0,3,3,"dummy"
"12116",3,6,4,13,"dummy"
"12117",0,1,0,1,"dummy"
"12118",5,1,0,6,"dummy"
"12119",0,1,0,1,"dummy"
"12120",8,4,4,16,"dummy"
"12121",0,2,0,2,"dummy"
"12122",0,3,0,3,"dummy"
"12123",0,0,1,1,"dummy"
"12124",0,2,0,2,"dummy"
"12125",0,1,0,1,"dummy"
"12126",11,2,0,13,"dummy"
"12144",0,9,0,9,"dummy"
"12147",0,0,1,1,"dummy"
"12149",2,2,2,6,"dummy"
"12150",0,1,0,1,"dummy"
"12151",1,4,1,6,"dummy"
"12152",0,1,0,1,"dummy"
"12153",3,0,0,3,"dummy"
"12156",4,3,1,8,"dummy"
"12157",1,0,0,1,"dummy"
"12158",0,1,0,1,"dummy"
"12159",0,1,0,1,"dummy"
"12160",0,0,1,1,"dummy"
"12161",0,0,1,1,"dummy"
"12162",0,0,0,0,"dummy"
"12164",5,0,2,7,"dummy"
"12173",0,0,4,4,"dummy"
"12175",3,3,0,6,"dummy"
"12176",0,0,1,1,"dummy"
"12179",0,0,1,1,"dummy"
"12180",0,0,1,1,"dummy"
"12181",0,0,0,0,"dummy"
"12182",0,2,0,2,"dummy"
"12183",0,0,0,0,"dummy"
"12184",0,0,1,1,"dummy"
"12185",0,0,0,0,"dummy"
"12186",0,0,1,1,"dummy"
"12187",0,0,0,0,"dummy"
"12188",0,0,2,2,"dummy"
"12192",0,0,2,2,"dummy"
"12193",0,1,0,1,"dummy"
"12194",0,0,1,1,"dummy"
"12195",0,0,1,1,"dummy"
"12196",0,1,0,1,"dummy"
"12198",0,0,0,0,"dummy"
"12199",0,0,1,1,"dummy"
"12200",0,0,1,1,"dummy"
"12201",0,0,1,1,"dummy"
"12202",0,0,0,0,"dummy"
"12203",0,0,0,0,"dummy"
"12204",0,0,1,1,"dummy"
"12205",0,0,1,1,"dummy"
"12206",0,0,1,1,"dummy"
"12208",0,0,1,1,"dummy"
"12210",0,0,0,0,"dummy"
"12214",4,25,1,30,"dummy"
"12216",0,12,0,12,"dummy"
"12217",2,2,0,4,"dummy"
"12218",0,2,0,2,"dummy"
"12219",0,2,0,2,"dummy"
"12220",0,2,0,2,"dummy"
"12231",4,13,2,19,"dummy"
"12235",0,3,0,3,"dummy"
"12240",0,0,1,1,"dummy"
"12243",0,0,1,1,"dummy"
"12246",0,0,1,1,"dummy"
"12247",0,1,4,5,"dummy"
"12248",2,2,6,10,"dummy"
"12249",0,5,0,5,"dummy"
"12256",0,0,1,1,"dummy"
"12264",1,4,0,5,"dummy"
"12265",6,6,2,14,"dummy"
"12270",0,0,1,1,"dummy"
"12272",0,0,1,1,"dummy"
"12274",1,0,0,1,"dummy"
"12276",0,1,0,1,"dummy"
"12289",0,0,0,0,"dummy"
"12291",2,2,0,4,"dummy"
"12295",4,2,3,9,"dummy"
"12298",0,0,3,3,"dummy"
"12302",0,3,0,3,"dummy"
"12303",7,1,0,8,"dummy"
"12304",0,2,1,3,"dummy"
"12305",1,0,1,2,"dummy"
"12306",0,0,1,1,"dummy"
"12307",2,0,1,3,"dummy"
"12308",1,0,1,2,"dummy"
"12312",0,1,0,1,"dummy"
"12313",1,3,2,6,"dummy"
"12314",0,0,1,1,"dummy"
"12315",0,3,1,4,"dummy"
"12316",0,0,0,0,"dummy"
"12317",0,0,1,1,"dummy"
"12320",0,2,0,2,"dummy"
"12321",24,24,4,52,"dummy"
"12322",0,0,1,1,"dummy"
"12323",0,1,0,1,"dummy"
"12324",0,0,1,1,"dummy"
"12325",8,7,4,19,"dummy"
"12326",4,4,0,8,"dummy"
"12327",1,1,0,2,"dummy"
"12328",0,0,1,1,"dummy"
"12330",1,1,0,2,"dummy"
"12331",0,1,0,1,"dummy"
"12332",2,2,0,4,"dummy"
"12333",0,1,0,1,"dummy"
"12342",0,0,0,0,"dummy"
"12343",0,0,0,0,"dummy"
"12344",0,0,1,1,"dummy"
"12345",0,0,1,1,"dummy"
"12346",1,1,0,2,"dummy"
"12347",0,0,2,2,"dummy"
"12348",0,0,1,1,"dummy"
"12349",2,0,0,2,"dummy"
"12352",0,0,2,2,"dummy"
"12353",0,0,1,1,"dummy"
"12354",0,0,1,1,"dummy"
"12355",0,0,1,1,"dummy"
"12357",0,0,1,1,"dummy"
"12358",0,0,1,1,"dummy"
"12359",0,3,0,3,"dummy"
"12360",0,0,2,2,"dummy"
"12361",0,0,1,1,"dummy"
"12362",0,0,1,1,"dummy"
"12363",0,0,1,1,"dummy"
"12364",0,0,1,1,"dummy"
"12365",0,0,1,1,"dummy"
"12366",0,0,1,1,"dummy"
"12367",0,0,1,1,"dummy"
"12368",0,0,1,1,"dummy"
"12369",0,0,1,1,"dummy"
"12370",0,0,1,1,"dummy"
"12371",0,0,1,1,"dummy"
"12372",0,0,1,1,"dummy"
"12373",0,0,1,1,"dummy"
"12374",0,0,1,1,"dummy"
"12375",0,0,2,2,"dummy"
"12376",0,0,1,1,"dummy"
"12377",0,0,1,1,"dummy"
"12378",1,1,1,3,"dummy"
"12379",2,2,0,4,"dummy"
"12380",1,1,1,3,"dummy"
"12381",0,4,0,4,"dummy"
"12382",2,6,0,8,"dummy"
"12383",10,7,1,18,"dummy"
"12384",6,15,0,21,"dummy"
"12385",0,0,1,1,"dummy"
"12386",0,0,1,1,"dummy"
"12387",0,0,2,2,"dummy"
"12389",0,0,0,0,"dummy"
"12391",0,1,0,1,"dummy"
"12392",0,2,0,2,"dummy"
"12395",0,11,0,11,"dummy"
"12396",0,1,0,1,"dummy"
"12402",0,0,0,0,"dummy"
"12403",0,0,1,1,"dummy"
"12405",1,22,1,24,"dummy"
"12406",0,3,0,3,"dummy"
"12407",0,1,0,1,"dummy"
"12410",5,12,2,19,"dummy"
"12411",0,0,3,3,"dummy"
"12412",10,2,0,12,"dummy"
"12413",0,0,1,1,"dummy"
"12421",2,1,0,3,"dummy"
"12422",0,3,0,3,"dummy"
"12423",1,0,0,1,"dummy"
"12424",1,3,0,4,"dummy"
"12425",0,1,0,1,"dummy"
"12426",2,0,0,2,"dummy"
"12427",1,2,1,4,"dummy"
"12430",0,0,0,0,"dummy"
"12431",0,0,1,1,"dummy"
"12432",0,1,0,1,"dummy"
"12434",1,0,0,1,"dummy"
"12436",0,0,0,0,"dummy"
"12437",2,9,10,21,"dummy"
"12438",0,0,1,1,"dummy"
"12439",1,0,5,6,"dummy"
"12440",6,3,4,13,"dummy"
"12441",0,0,3,3,"dummy"
"12442",0,0,1,1,"dummy"
"12444",2,4,1,7,"dummy"
"12445",1,2,0,3,"dummy"
"12446",1,0,2,3,"dummy"
"12451",1,1,0,2,"dummy"
"12453",1,4,1,6,"dummy"
"12454",0,1,0,1,"dummy"
"12455",0,2,0,2,"dummy"
"12457",1,9,0,10,"dummy"
"12460",0,2,0,2,"dummy"
"12461",0,0,1,1,"dummy"
"12462",0,0,1,1,"dummy"
"12464",2,2,1,5,"dummy"
"12465",3,8,0,11,"dummy"
"12466",2,4,0,6,"dummy"
"12467",0,2,0,2,"dummy"
"12468",8,3,1,12,"dummy"
"12469",0,2,0,2,"dummy"
"12470",2,3,2,7,"dummy"
"12471",10,14,1,25,"dummy"
"12472",2,2,0,4,"dummy"
"12473",36,13,3,52,"dummy"
"12474",0,2,0,2,"dummy"
"12475",5,11,1,17,"dummy"
"12476",0,2,0,2,"dummy"
"12477",1,3,1,5,"dummy"
"12478",8,3,1,12,"dummy"
"12480",0,9,0,9,"dummy"
"12481",8,11,2,21,"dummy"
"12482",4,5,0,9,"dummy"
"12483",1,3,0,4,"dummy"
"12484",0,1,0,1,"dummy"
"12485",0,1,0,1,"dummy"
"12486",0,0,1,1,"dummy"
"12487",0,1,0,1,"dummy"
"12490",4,7,5,16,"dummy"
"12491",3,2,3,8,"dummy"
"12492",0,2,3,5,"dummy"
"12493",0,0,1,1,"dummy"
"12494",0,0,1,1,"dummy"
"12495",0,0,1,1,"dummy"
"12496",0,0,4,4,"dummy"
"12497",0,0,1,1,"dummy"
"12498",0,0,1,1,"dummy"
"12499",0,0,2,2,"dummy"
"12500",0,0,2,2,"dummy"
"12501",0,0,1,1,"dummy"
"12502",0,0,2,2,"dummy"
"12517",0,0,1,1,"dummy"
"12518",0,0,1,1,"dummy"
"12521",0,3,0,3,"dummy"
"12522",1,6,2,9,"dummy"
"12523",5,9,3,17,"dummy"
"12526",4,5,3,12,"dummy"
"12527",2,0,3,5,"dummy"
"12528",3,0,1,4,"dummy"
"12532",0,2,0,2,"dummy"
"12535",0,6,0,6,"dummy"
"12536",0,2,0,2,"dummy"
"12537",5,2,2,9,"dummy"
"12539",3,4,0,7,"dummy"
"12541",0,0,1,1,"dummy"
"12543",0,0,1,1,"dummy"
"12546",2,2,0,4,"dummy"
"12548",1,0,0,1,"dummy"
"12550",0,1,0,1,"dummy"
"12551",0,0,1,1,"dummy"
"12552",0,14,0,14,"dummy"
"12553",0,4,0,4,"dummy"
"12554",0,0,0,0,"dummy"
"12555",2,0,1,3,"dummy"
"12556",0,3,0,3,"dummy"
"12557",3,0,0,3,"dummy"
"12558",0,4,0,4,"dummy"
"12560",3,1,0,4,"dummy"
"12561",0,1,0,1,"dummy"
"12562",0,16,2,18,"dummy"
"12563",27,4,3,34,"dummy"
"12564",6,27,2,35,"dummy"
"12578",0,0,0,0,"dummy"
"12579",0,5,0,5,"dummy"
"12580",2,0,0,2,"dummy"
"12581",0,2,0,2,"dummy"
"12609",0,0,1,1,"dummy"
"12610",0,0,1,1,"dummy"
"12611",0,0,2,2,"dummy"
"12636",0,0,1,1,"dummy"
"12637",2,1,1,4,"dummy"
"12638",0,0,2,2,"dummy"
"12639",0,0,1,1,"dummy"
"12640",0,0,1,1,"dummy"
"12641",0,0,1,1,"dummy"
"12642",0,0,1,1,"dummy"
"12643",0,0,1,1,"dummy"
"12644",0,1,2,3,"dummy"
"12645",0,0,1,1,"dummy"
"12646",0,0,1,1,"dummy"
"12647",0,2,1,3,"dummy"
"12648",0,1,0,1,"dummy"
"12654",7,16,2,25,"dummy"
"12658",0,1,0,1,"dummy"
"12659",1,1,0,2,"dummy"
"12662",3,0,0,3,"dummy"
"12667",1,0,0,1,"dummy"
"12668",0,0,1,1,"dummy"
"12669",2,0,0,2,"dummy"
"12670",0,0,1,1,"dummy"
"12671",0,1,0,1,"dummy"
"12672",0,2,0,2,"dummy"
"12678",0,1,1,2,"dummy"
"12690",0,1,0,1,"dummy"
"12691",0,0,1,1,"dummy"
"12707",0,0,1,1,"dummy"
"12708",0,0,2,2,"dummy"
"12709",0,1,0,1,"dummy"
"12710",0,0,1,1,"dummy"
"12711",1,1,0,2,"dummy"
"12712",1,1,0,2,"dummy"
"12713",1,1,0,2,"dummy"
"12714",1,1,0,2,"dummy"
"12715",1,0,0,1,"dummy"
"12716",0,0,1,1,"dummy"
"12717",0,0,1,1,"dummy"
"12718",0,2,0,2,"dummy"
"12734",0,0,3,3,"dummy"
"12735",8,1,0,9,"dummy"
"12736",0,0,0,0,"dummy"
"12737",0,13,0,13,"dummy"
"12738",0,2,0,2,"dummy"
"12739",0,1,0,1,"dummy"
"12740",24,11,2,37,"dummy"
"12741",0,0,0,0,"dummy"
"12742",0,1,0,1,"dummy"
"12743",0,5,0,5,"dummy"
"12744",14,3,4,21,"dummy"
"12745",0,0,1,1,"dummy"
"12748",0,0,1,1,"dummy"
"12749",2,21,2,25,"dummy"
"12750",0,1,0,1,"dummy"
"12751",3,5,0,8,"dummy"
"12752",1,1,0,2,"dummy"
"12753",0,1,0,1,"dummy"
"12758",0,3,0,3,"dummy"
"12759",2,1,0,3,"dummy"
"12763",5,0,0,5,"dummy"
"12566",3,0,1,4,"dummy"
"12567",0,3,1,4,"dummy"
"12568",1,0,0,1,"dummy"
"12569",0,1,0,1,"dummy"
"12570",1,0,0,1,"dummy"
"12583",0,11,0,11,"dummy"
"12584",14,11,2,27,"dummy"
"12585",16,23,1,40,"dummy"
"12586",0,2,0,2,"dummy"
"12587",3,9,0,12,"dummy"
"12588",0,1,0,1,"dummy"
"12589",19,0,1,20,"dummy"
"12590",0,4,0,4,"dummy"
"12591",0,1,0,1,"dummy"
"12592",0,0,2,2,"dummy"
"12593",0,0,4,4,"dummy"
"12594",0,0,4,4,"dummy"
"12595",0,1,0,1,"dummy"
"12596",0,0,2,2,"dummy"
"12597",0,0,1,1,"dummy"
"12598",0,0,2,2,"dummy"
"12599",0,0,2,2,"dummy"
"12600",0,0,2,2,"dummy"
"12601",0,2,0,2,"dummy"
"12602",6,14,5,25,"dummy"
"12603",14,2,0,16,"dummy"
"12604",1,0,0,1,"dummy"
"12605",0,1,0,1,"dummy"
"12606",0,0,1,1,"dummy"
"12607",0,0,1,1,"dummy"
"12613",0,0,1,1,"dummy"
"12616",0,3,4,7,"dummy"
"12617",0,1,0,1,"dummy"
"12618",0,1,0,1,"dummy"
"12619",0,1,0,1,"dummy"
"12620",1,8,4,13,"dummy"
"12621",0,2,0,2,"dummy"
"12622",2,2,0,4,"dummy"
"12623",0,1,0,1,"dummy"
"12624",0,1,0,1,"dummy"
"12625",0,2,0,2,"dummy"
"12626",2,2,0,4,"dummy"
"12627",0,1,0,1,"dummy"
"12628",0,1,0,1,"dummy"
"12629",0,1,0,1,"dummy"
"12630",11,1,4,16,"dummy"
"12631",1,12,3,16,"dummy"
"12632",3,0,1,4,"dummy"
"12633",0,1,0,1,"dummy"
"12634",1,1,0,2,"dummy"
"12650",0,0,1,1,"dummy"
"12651",0,0,1,1,"dummy"
"12652",0,1,2,3,"dummy"
"12656",0,0,1,1,"dummy"
"12684",1,2,1,4,"dummy"
"12685",0,0,1,1,"dummy"
"12686",2,1,1,4,"dummy"
"12687",1,8,0,9,"dummy"
"12688",1,1,5,7,"dummy"
"12693",0,0,1,1,"dummy"
"12698",0,1,0,1,"dummy"
"12699",3,0,0,3,"dummy"
"12700",0,1,0,1,"dummy"
"12701",0,0,0,0,"dummy"
"12755",0,0,3,3,"dummy"
"12756",0,0,2,2,"dummy"
"12761",0,0,1,1,"dummy"
"12766",0,4,0,4,"dummy"
"12767",0,7,0,7,"dummy"
"12768",1,1,0,2,"dummy"
"12769",12,10,0,22,"dummy"
"12770",6,6,0,12,"dummy"
"12771",4,13,0,17,"dummy"
"12772",22,17,0,39,"dummy"
"12773",11,12,0,23,"dummy"
"12774",8,8,5,21,"dummy"
"12779",1,8,2,11,"dummy"
"12780",0,2,1,3,"dummy"
"12781",0,2,3,5,"dummy"
"12795",0,1,1,2,"dummy"
"12796",0,1,1,2,"dummy"
"12797",0,1,0,1,"dummy"
"12798",0,4,1,5,"dummy"
"12799",0,0,1,1,"dummy"
"12800",1,0,0,1,"dummy"
"12801",0,1,0,1,"dummy"
"12844",0,0,3,3,"dummy"
"12845",1,0,0,1,"dummy"
"12846",0,3,0,3,"dummy"
"12847",3,0,0,3,"dummy"
"12850",0,0,1,1,"dummy"
"12851",0,1,1,2,"dummy"
"12862",0,6,1,7,"dummy"
"12868",0,2,0,2,"dummy"
"12919",1,7,1,9,"dummy"
"12920",1,0,0,1,"dummy"
"12921",0,1,0,1,"dummy"
"12928",0,1,0,1,"dummy"
"12935",3,0,1,4,"dummy"
"12950",0,3,0,3,"dummy"
"12951",2,0,0,2,"dummy"
"12972",0,0,1,1,"dummy"
"12973",2,2,0,4,"dummy"
"12974",0,1,0,1,"dummy"
"12975",0,0,2,2,"dummy"
"12976",0,0,2,2,"dummy"
"12985",1,2,0,3,"dummy"
"12988",0,1,1,2,"dummy"
"12989",1,0,0,1,"dummy"
"12990",0,0,0,0,"dummy"
"13049",6,0,0,6,"dummy"
"13050",2,5,2,9,"dummy"
"12786",0,0,1,1,"dummy"
"12787",0,0,1,1,"dummy"
"12788",0,0,2,2,"dummy"
"12789",0,1,0,1,"dummy"
"12790",0,0,1,1,"dummy"
"12791",0,0,1,1,"dummy"
"12792",0,1,0,1,"dummy"
"12793",0,0,1,1,"dummy"
"12803",0,1,0,1,"dummy"
"12804",3,5,0,8,"dummy"
"12805",0,1,0,1,"dummy"
"12806",0,5,0,5,"dummy"
"12807",0,3,0,3,"dummy"
"12839",5,21,1,27,"dummy"
"12842",1,1,2,4,"dummy"
"12864",6,6,2,14,"dummy"
"12865",0,0,1,1,"dummy"
"12866",0,0,1,1,"dummy"
"12873",8,8,0,16,"dummy"
"12874",0,0,1,1,"dummy"
"12875",8,8,0,16,"dummy"
"12880",0,0,1,1,"dummy"
"12881",0,0,1,1,"dummy"
"12882",0,0,1,1,"dummy"
"12883",0,0,1,1,"dummy"
"12884",0,0,1,1,"dummy"
"12885",0,0,1,1,"dummy"
"12886",0,0,1,1,"dummy"
"12887",0,0,1,1,"dummy"
"12888",0,0,1,1,"dummy"
"12889",0,0,1,1,"dummy"
"12890",0,0,1,1,"dummy"
"12891",0,0,1,1,"dummy"
"12892",0,0,1,1,"dummy"
"12893",0,0,1,1,"dummy"
"12894",0,0,1,1,"dummy"
"12895",0,0,1,1,"dummy"
"12896",0,0,1,1,"dummy"
"12897",0,0,1,1,"dummy"
"12898",0,0,1,1,"dummy"
"12899",0,0,1,1,"dummy"
"12900",0,0,1,1,"dummy"
"12901",0,0,1,1,"dummy"
"12902",0,0,1,1,"dummy"
"12903",0,0,1,1,"dummy"
"12904",0,0,1,1,"dummy"
"12905",0,0,1,1,"dummy"
"12906",0,0,1,1,"dummy"
"12907",0,0,1,1,"dummy"
"12910",1,0,0,1,"dummy"
"12915",1,2,1,4,"dummy"
"12916",2,21,1,24,"dummy"
"12917",0,1,0,1,"dummy"
"12930",0,15,1,16,"dummy"
"12931",1,1,1,3,"dummy"
"12932",0,0,2,2,"dummy"
"12933",0,1,0,1,"dummy"
"12939",0,0,1,1,"dummy"
"12940",0,0,1,1,"dummy"
"12941",0,1,0,1,"dummy"
"12944",2,4,1,7,"dummy"
"12945",0,0,1,1,"dummy"
"12946",0,0,2,2,"dummy"
"12947",0,0,1,1,"dummy"
"12948",4,6,4,14,"dummy"
"12957",0,0,3,3,"dummy"
"12958",0,1,0,1,"dummy"
"12959",1,3,0,4,"dummy"
"12960",0,0,1,1,"dummy"
"12961",1,0,0,1,"dummy"
"12962",2,0,0,2,"dummy"
"12966",0,0,1,1,"dummy"
"12967",0,1,1,2,"dummy"
"12968",6,0,2,8,"dummy"
"12978",0,0,1,1,"dummy"
"12979",0,0,1,1,"dummy"
"12980",2,3,0,5,"dummy"
"12981",0,0,1,1,"dummy"
"13052",0,0,1,1,"dummy"
"13053",6,3,1,10,"dummy"
"13056",0,1,0,1,"dummy"
"13057",0,0,1,1,"dummy"
"13058",0,0,3,3,"dummy"
"13059",0,0,3,3,"dummy"
"13060",0,2,1,3,"dummy"
"13063",0,1,1,2,"dummy"
"13064",2,1,0,3,"dummy"
"13065",0,1,0,1,"dummy"
"13066",0,0,0,0,"dummy"
"13067",0,0,4,4,"dummy"
"13068",1,0,0,1,"dummy"
"13069",0,1,0,1,"dummy"
"13073",1,0,3,4,"dummy"
"13075",0,0,1,1,"dummy"
"13076",0,1,0,1,"dummy"
"13083",0,0,1,1,"dummy"
"13084",0,1,0,1,"dummy"
"13086",0,1,0,1,"dummy"
"13094",0,5,0,5,"dummy"
"13095",3,0,0,3,"dummy"
"13096",0,1,0,1,"dummy"
"13097",0,1,0,1,"dummy"
"13098",0,4,0,4,"dummy"
"13099",0,3,0,3,"dummy"
"13100",0,3,0,3,"dummy"
"13101",1,3,2,6,"dummy"
"13102",0,1,0,1,"dummy"
"13103",1,4,0,5,"dummy"
"13104",0,1,0,1,"dummy"
"13105",0,0,2,2,"dummy"
"13124",1,0,3,4,"dummy"
"13125",3,4,1,8,"dummy"
"13126",0,1,0,1,"dummy"
"13127",0,0,0,0,"dummy"
"13128",0,6,1,7,"dummy"
"13129",0,1,0,1,"dummy"
"13132",0,1,0,1,"dummy"
"13133",0,0,1,1,"dummy"
"13134",0,0,1,1,"dummy"
"13135",0,1,2,3,"dummy"
"13136",0,0,4,4,"dummy"
"13138",0,1,0,1,"dummy"
"13139",0,0,0,0,"dummy"
"13142",1,1,0,2,"dummy"
"13143",0,0,1,1,"dummy"
"13144",1,0,0,1,"dummy"
"13145",1,3,1,5,"dummy"
"13147",0,0,1,1,"dummy"
"13148",0,2,0,2,"dummy"
"13149",0,2,0,2,"dummy"
"13157",1,1,0,2,"dummy"
"13165",11,4,3,18,"dummy"
"13167",24,3,1,28,"dummy"
"13168",0,0,1,1,"dummy"
"13170",0,0,1,1,"dummy"
"13171",0,0,1,1,"dummy"
"13172",0,0,1,1,"dummy"
"13173",0,0,1,1,"dummy"
"13174",0,0,1,1,"dummy"
"13175",0,0,1,1,"dummy"
"13176",0,0,1,1,"dummy"
"13178",1,0,2,3,"dummy"
"13184",0,0,1,1,"dummy"
"13185",0,1,0,1,"dummy"
"13186",3,8,1,12,"dummy"
"13187",2,1,0,3,"dummy"
"13190",4,1,0,5,"dummy"
"13191",0,2,0,2,"dummy"
"13192",1,2,0,3,"dummy"
"13194",0,0,0,0,"dummy"
"13195",0,0,0,0,"dummy"
"13196",0,0,0,0,"dummy"
"13197",0,0,0,0,"dummy"
"13198",0,0,0,0,"dummy"
"13199",0,0,0,0,"dummy"
"13200",0,0,0,0,"dummy"
"13201",0,0,0,0,"dummy"
"13202",0,0,0,0,"dummy"
"13203",0,0,0,0,"dummy"
"13204",0,0,0,0,"dummy"
"13205",0,0,0,0,"dummy"
"13206",0,0,0,0,"dummy"
"13207",0,5,0,5,"dummy"
"13208",3,6,1,10,"dummy"
"13209",5,3,2,10,"dummy"
"13210",1,0,1,2,"dummy"
"13211",1,1,0,2,"dummy"
"13213",0,4,1,5,"dummy"
"13214",2,0,2,4,"dummy"
"13215",1,0,2,3,"dummy"
"13217",0,0,0,0,"dummy"
"13218",0,0,0,0,"dummy"
"13219",1,5,0,6,"dummy"
"13220",1,3,0,4,"dummy"
"13221",1,1,0,2,"dummy"
"13222",1,0,0,1,"dummy"
"13224",0,0,1,1,"dummy"
"13225",2,14,2,18,"dummy"
"13226",0,0,1,1,"dummy"
"13227",0,1,2,3,"dummy"
"13228",3,0,0,3,"dummy"
"13229",3,0,0,3,"dummy"
"13230",8,2,2,12,"dummy"
"13231",2,16,2,20,"dummy"
"13232",0,0,1,1,"dummy"
"13233",6,4,2,12,"dummy"
"13234",2,2,0,4,"dummy"
"13235",2,3,0,5,"dummy"
"13236",1,0,0,1,"dummy"
"13238",0,0,0,0,"dummy"
"13240",0,1,0,1,"dummy"
"13241",1,0,1,2,"dummy"
"13242",0,0,1,1,"dummy"
"13244",0,0,1,1,"dummy"
"13245",1,3,0,4,"dummy"
"13246",0,5,0,5,"dummy"
"13266",1,0,0,1,"dummy"
"13267",0,0,0,0,"dummy"
"13268",0,2,0,2,"dummy"
"13269",0,2,0,2,"dummy"
"13270",2,2,0,4,"dummy"
"13271",8,0,0,8,"dummy"
"13272",0,1,0,1,"dummy"
"13273",0,3,0,3,"dummy"
"13274",1,0,0,1,"dummy"
"13275",0,0,1,1,"dummy"
"13276",1,0,0,1,"dummy"
"13277",2,0,0,2,"dummy"
"13278",2,0,0,2,"dummy"
"13279",0,0,0,0,"dummy"
"13280",0,3,0,3,"dummy"
"13281",1,0,0,1,"dummy"
"13283",0,1,3,4,"dummy"
"13286",0,4,0,4,"dummy"
"13290",5,8,0,13,"dummy"
"13291",3,1,0,4,"dummy"
"13292",0,0,2,2,"dummy"
"13297",0,1,0,1,"dummy"
"13298",5,4,1,10,"dummy"
"13299",0,1,1,2,"dummy"
"13300",1,2,1,4,"dummy"
"13301",0,2,1,3,"dummy"
"13302",0,0,1,1,"dummy"
"13303",9,3,0,12,"dummy"
"13304",0,0,0,0,"dummy"
"13305",0,1,0,1,"dummy"
"13306",5,11,2,18,"dummy"
"13307",0,2,1,3,"dummy"
"13308",0,5,0,5,"dummy"
"13309",0,0,0,0,"dummy"
"13310",0,2,0,2,"dummy"
"13311",12,1,3,16,"dummy"
"13312",0,0,0,0,"dummy"
"13313",0,2,1,3,"dummy"
"13314",7,5,2,14,"dummy"
"13315",0,0,1,1,"dummy"
"13317",2,0,0,2,"dummy"
"13318",2,0,0,2,"dummy"
"13319",0,3,0,3,"dummy"
"13320",1,0,0,1,"dummy"
"13323",6,10,3,19,"dummy"
"13324",1,1,0,2,"dummy"
"13326",1,0,1,2,"dummy"
"13327",0,27,2,29,"dummy"
"13328",0,1,0,1,"dummy"
"13329",0,1,0,1,"dummy"
"13330",0,2,0,2,"dummy"
"13331",0,1,0,1,"dummy"
"13333",0,0,2,2,"dummy"
"13340",0,0,1,1,"dummy"
"13341",0,0,1,1,"dummy"
"13342",1,0,0,1,"dummy"
"13343",0,1,0,1,"dummy"
"13347",29,21,5,55,"dummy"
"13348",0,1,0,1,"dummy"
"13349",0,0,2,2,"dummy"
"13350",0,0,1,1,"dummy"
"13354",0,3,1,4,"dummy"
"13357",1,3,0,4,"dummy"
"13362",2,0,2,4,"dummy"
"13366",66,8,4,78,"dummy"
"13388",3,2,2,7,"dummy"
"13390",2,0,2,4,"dummy"
"13394",0,1,0,1,"dummy"
"13395",1,3,0,4,"dummy"
"13396",0,0,1,1,"dummy"
"13398",0,1,0,1,"dummy"
"13399",0,1,0,1,"dummy"
"13400",0,3,0,3,"dummy"
"13404",1,1,0,2,"dummy"
"13405",0,1,0,1,"dummy"
"13406",0,0,1,1,"dummy"
"13407",0,3,0,3,"dummy"
"13408",0,0,3,3,"dummy"
"13409",0,0,1,1,"dummy"
"13410",0,0,1,1,"dummy"
"13411",0,4,0,4,"dummy"
"13412",0,1,0,1,"dummy"
"13413",0,0,1,1,"dummy"
"13414",0,2,0,2,"dummy"
"13435",0,1,0,1,"dummy"
"13437",0,0,1,1,"dummy"
"13438",0,0,1,1,"dummy"
"13439",0,0,2,2,"dummy"
"13440",0,0,1,1,"dummy"
"13441",1,1,0,2,"dummy"
"13442",1,0,0,1,"dummy"
"13444",0,0,0,0,"dummy"
"13445",2,2,0,4,"dummy"
"13446",0,0,1,1,"dummy"
"13447",0,0,1,1,"dummy"
"13448",0,0,0,0,"dummy"
"13449",0,0,0,0,"dummy"
"13451",2,9,2,13,"dummy"
"13452",0,0,2,2,"dummy"
"13453",10,11,0,21,"dummy"
"13454",0,0,0,0,"dummy"
"13476",1,0,0,1,"dummy"
"13477",5,1,1,7,"dummy"
"13478",0,0,1,1,"dummy"
"13479",1,0,1,2,"dummy"
"13480",0,14,2,16,"dummy"
"13495",0,0,1,1,"dummy"
"13496",0,0,0,0,"dummy"
"13500",0,1,4,5,"dummy"
"13501",0,3,0,3,"dummy"
"13502",0,0,0,0,"dummy"
"13503",8,8,9,25,"dummy"
"13504",0,4,0,4,"dummy"
"13505",0,1,0,1,"dummy"
"13506",0,0,0,0,"dummy"
"13507",0,1,0,1,"dummy"
"13508",1,0,0,1,"dummy"
"13509",8,8,9,25,"dummy"
"13510",0,1,0,1,"dummy"
"13511",1,1,2,4,"dummy"
"13512",1,4,2,7,"dummy"
"13513",3,2,0,5,"dummy"
"13514",0,0,1,1,"dummy"
"13515",0,1,0,1,"dummy"
"13516",1,0,0,1,"dummy"
"13525",3,0,0,3,"dummy"
"13526",0,0,1,1,"dummy"
"13539",0,0,0,0,"dummy"
"13552",0,0,1,1,"dummy"
"13553",2,0,0,2,"dummy"
"13554",1,2,0,3,"dummy"
"13555",1,0,2,3,"dummy"
"13556",0,1,0,1,"dummy"
"13557",1,1,2,4,"dummy"
"13558",1,0,0,1,"dummy"
"13559",1,0,0,1,"dummy"
"13560",0,0,1,1,"dummy"
"13561",0,0,1,1,"dummy"
"13562",0,1,0,1,"dummy"
"13563",3,2,1,6,"dummy"
"13564",1,0,0,1,"dummy"
"13565",2,0,2,4,"dummy"
"13566",0,0,2,2,"dummy"
"13567",0,2,0,2,"dummy"
"13568",0,2,0,2,"dummy"
"13569",2,1,0,3,"dummy"
"13570",0,0,1,1,"dummy"
"13571",0,0,2,2,"dummy"
"13572",0,1,0,1,"dummy"
"13578",0,0,1,1,"dummy"
"13579",0,1,1,2,"dummy"
"13580",0,0,1,1,"dummy"
"13581",0,2,0,2,"dummy"
"13582",0,0,0,0,"dummy"
"13583",0,1,0,1,"dummy"
"13584",6,4,1,11,"dummy"
"13585",3,0,0,3,"dummy"
"13586",0,5,0,5,"dummy"
"13587",0,1,3,4,"dummy"
"13588",1,0,0,1,"dummy"
"13591",0,1,0,1,"dummy"
"13601",0,0,1,1,"dummy"
"13605",2,0,0,2,"dummy"
"13608",0,0,0,0,"dummy"
"13609",0,0,0,0,"dummy"
"13613",0,0,1,1,"dummy"
"13614",0,0,1,1,"dummy"
"13615",0,0,1,1,"dummy"
"13616",0,0,1,1,"dummy"
"13617",0,0,1,1,"dummy"
"13639",5,7,9,21,"dummy"
"13640",6,6,1,13,"dummy"
"13641",6,7,0,13,"dummy"
"13652",0,0,1,1,"dummy"
"13456",1,3,0,4,"dummy"
"13462",1,9,0,10,"dummy"
"13463",1,0,0,1,"dummy"
"13464",0,0,2,2,"dummy"
"13465",0,0,0,0,"dummy"
"13466",0,0,1,1,"dummy"
"13471",0,0,2,2,"dummy"
"13472",0,1,0,1,"dummy"
"13482",3,0,0,3,"dummy"
"13483",1,0,2,3,"dummy"
"13484",0,0,0,0,"dummy"
"13487",0,1,4,5,"dummy"
"13488",0,1,2,3,"dummy"
"13491",0,5,0,5,"dummy"
"13492",7,5,0,12,"dummy"
"13493",1,1,0,2,"dummy"
"13498",0,0,1,1,"dummy"
"13541",0,0,1,1,"dummy"
"13542",1,0,0,1,"dummy"
"13543",0,0,0,0,"dummy"
"13544",8,9,0,17,"dummy"
"13545",0,2,0,2,"dummy"
"13546",0,1,0,1,"dummy"
"13547",2,2,0,4,"dummy"
"13548",0,1,0,1,"dummy"
"13549",1,1,0,2,"dummy"
"13550",0,1,0,1,"dummy"
"13574",12,24,3,39,"dummy"
"13593",0,0,0,0,"dummy"
"13596",0,1,0,1,"dummy"
"13597",22,1,1,24,"dummy"
"13598",1,1,1,3,"dummy"
"13599",1,0,1,2,"dummy"
"13603",0,1,0,1,"dummy"
"13611",0,0,1,1,"dummy"
"13619",0,0,1,1,"dummy"
"13620",0,0,1,1,"dummy"
"13621",0,0,1,1,"dummy"
"13622",0,0,1,1,"dummy"
"13623",0,0,1,1,"dummy"
"13624",0,0,1,1,"dummy"
"13625",0,0,1,1,"dummy"
"13626",0,0,1,1,"dummy"
"13627",0,0,1,1,"dummy"
"13628",0,0,2,2,"dummy"
"13629",0,0,1,1,"dummy"
"13630",0,0,1,1,"dummy"
"13631",0,0,1,1,"dummy"
"13632",0,0,1,1,"dummy"
"13633",0,0,2,2,"dummy"
"13634",0,0,0,0,"dummy"
"13635",0,0,1,1,"dummy"
"13636",0,0,1,1,"dummy"
"13637",0,0,1,1,"dummy"
"13643",0,1,0,1,"dummy"
"13644",0,2,0,2,"dummy"
"13647",0,3,1,4,"dummy"
"13648",0,1,0,1,"dummy"
"13649",0,0,1,1,"dummy"
"13650",1,2,2,5,"dummy"
"13656",0,0,0,0,"dummy"
"13659",0,3,1,4,"dummy"
"13660",2,1,0,3,"dummy"
"13661",7,2,0,9,"dummy"
"13662",0,1,1,2,"dummy"
"13663",0,0,1,1,"dummy"
"13664",1,3,2,6,"dummy"
"13665",2,1,0,3,"dummy"
"13666",0,0,1,1,"dummy"
"13667",0,2,0,2,"dummy"
"13668",6,0,0,6,"dummy"
"13669",1,13,0,14,"dummy"
"13670",0,0,1,1,"dummy"
"13671",0,0,0,0,"dummy"
"13672",0,1,0,1,"dummy"
"13673",0,4,1,5,"dummy"
"13674",0,1,0,1,"dummy"
"13675",0,12,0,12,"dummy"
"13676",5,5,0,10,"dummy"
"13677",12,1,0,13,"dummy"
"13678",0,2,0,2,"dummy"
"13679",1,0,0,1,"dummy"
"13680",0,1,2,3,"dummy"
"13681",1,0,0,1,"dummy"
"13682",0,0,2,2,"dummy"
"13683",5,2,4,11,"dummy"
"13684",0,1,0,1,"dummy"
"13685",0,1,0,1,"dummy"
"13686",0,0,2,2,"dummy"
"13687",17,25,0,42,"dummy"
"13688",0,0,0,0,"dummy"
"13689",0,0,0,0,"dummy"
"13690",5,5,0,10,"dummy"
"13691",0,0,2,2,"dummy"
"13692",5,5,0,10,"dummy"
"13727",0,2,4,6,"dummy"
"13733",2,0,0,2,"dummy"
"13734",0,2,0,2,"dummy"
"13739",1,0,0,1,"dummy"
"13740",0,0,1,1,"dummy"
"13748",2,2,0,4,"dummy"
"13753",0,5,0,5,"dummy"
"13754",0,1,2,3,"dummy"
"13757",0,4,0,4,"dummy"
"13760",0,1,0,1,"dummy"
"13761",1,2,0,3,"dummy"
"13784",0,1,0,1,"dummy"
"13785",1,0,0,1,"dummy"
"13786",0,3,1,4,"dummy"
"13787",4,0,0,4,"dummy"
"13788",0,4,0,4,"dummy"
"13789",0,1,0,1,"dummy"
"13790",0,1,0,1,"dummy"
"13807",1,1,0,2,"dummy"
"13810",0,1,1,2,"dummy"
"13811",3,5,0,8,"dummy"
"13812",1,0,1,2,"dummy"
"13815",2,3,0,5,"dummy"
"13816",3,2,1,6,"dummy"
"13817",0,1,0,1,"dummy"
"13818",1,1,0,2,"dummy"
"13819",0,0,1,1,"dummy"
"13820",0,0,3,3,"dummy"
"13821",0,1,4,5,"dummy"
"13822",0,0,1,1,"dummy"
"13823",0,0,3,3,"dummy"
"13824",0,0,1,1,"dummy"
"13825",2,1,5,8,"dummy"
"13832",0,1,0,1,"dummy"
"13833",0,2,0,2,"dummy"
"13834",0,1,1,2,"dummy"
"13835",0,4,0,4,"dummy"
"13836",14,3,5,22,"dummy"
"13837",1,1,2,4,"dummy"
"13838",0,0,0,0,"dummy"
"13839",0,0,1,1,"dummy"
"13840",0,2,0,2,"dummy"
"13841",1,1,2,4,"dummy"
"13842",0,2,0,2,"dummy"
"13843",0,0,1,1,"dummy"
"13844",1,2,0,3,"dummy"
"13845",0,0,3,3,"dummy"
"13846",1,1,8,10,"dummy"
"13847",0,0,2,2,"dummy"
"13848",0,1,3,4,"dummy"
"13856",0,0,3,3,"dummy"
"13857",4,9,4,17,"dummy"
"13858",0,1,0,1,"dummy"
"13859",1,0,3,4,"dummy"
"13865",1,0,0,1,"dummy"
"13866",0,2,0,2,"dummy"
"13867",0,0,1,1,"dummy"
"13868",1,3,0,4,"dummy"
"13893",0,1,0,1,"dummy"
"13898",0,0,0,0,"dummy"
"13903",0,4,0,4,"dummy"
"13904",1,17,1,19,"dummy"
"13723",0,0,0,0,"dummy"
"13736",4,4,1,9,"dummy"
"13737",0,0,1,1,"dummy"
"13744",0,1,0,1,"dummy"
"13745",0,1,0,1,"dummy"
"13746",0,3,1,4,"dummy"
"13750",0,0,1,1,"dummy"
"13751",0,0,1,1,"dummy"
"13763",0,1,0,1,"dummy"
"13773",0,1,0,1,"dummy"
"13792",0,1,0,1,"dummy"
"13801",0,2,0,2,"dummy"
"13802",0,1,0,1,"dummy"
"13803",0,1,0,1,"dummy"
"13804",0,1,0,1,"dummy"
"13805",0,0,1,1,"dummy"
"13827",0,1,0,1,"dummy"
"13828",0,0,1,1,"dummy"
"13829",0,1,0,1,"dummy"
"13830",0,0,1,1,"dummy"
"13861",0,11,2,13,"dummy"
"13870",0,0,0,0,"dummy"
"13871",0,1,0,1,"dummy"
"13872",0,1,0,1,"dummy"
"13873",0,12,1,13,"dummy"
"13874",1,1,0,2,"dummy"
"13875",0,10,1,11,"dummy"
"13876",3,1,0,4,"dummy"
"13877",18,7,2,27,"dummy"
"13878",7,12,2,21,"dummy"
"13879",0,9,2,11,"dummy"
"13880",1,0,0,1,"dummy"
"13881",9,1,1,11,"dummy"
"13882",0,0,0,0,"dummy"
"13883",0,0,0,0,"dummy"
"13884",11,7,2,20,"dummy"
"13885",3,2,0,5,"dummy"
"13886",1,0,0,1,"dummy"
"13887",0,1,0,1,"dummy"
"13888",0,1,0,1,"dummy"
"13889",0,1,0,1,"dummy"
"13890",0,0,1,1,"dummy"
"13891",0,1,0,1,"dummy"
"13895",3,1,1,5,"dummy"
"13896",6,1,3,10,"dummy"
"13900",0,0,1,1,"dummy"
"13901",0,1,0,1,"dummy"
"13906",1,0,0,1,"dummy"
"13907",0,1,0,1,"dummy"
"13908",0,0,1,1,"dummy"
"13909",1,0,1,2,"dummy"
"13910",0,1,0,1,"dummy"
"13911",1,0,0,1,"dummy"
"13920",3,14,1,18,"dummy"
"13923",0,0,0,0,"dummy"
"13924",0,0,0,0,"dummy"
"13926",0,2,0,2,"dummy"
"13927",0,5,0,5,"dummy"
"13928",0,2,0,2,"dummy"
"13929",0,1,0,1,"dummy"
"13930",0,1,0,1,"dummy"
"13931",2,1,0,3,"dummy"
"13932",1,0,0,1,"dummy"
"13946",0,1,0,1,"dummy"
"13947",0,0,1,1,"dummy"
"13950",0,1,0,1,"dummy"
"13951",0,2,0,2,"dummy"
"13952",1,6,0,7,"dummy"
"13953",0,3,0,3,"dummy"
"13954",9,0,1,10,"dummy"
"13955",8,0,0,8,"dummy"
"13956",0,3,0,3,"dummy"
"13961",0,2,0,2,"dummy"
"13966",0,0,0,0,"dummy"
"13967",0,0,1,1,"dummy"
"13974",0,2,2,4,"dummy"
"13975",1,0,0,1,"dummy"
"13985",0,0,2,2,"dummy"
"13991",2,3,2,7,"dummy"
"13992",0,1,0,1,"dummy"
"13993",0,0,1,1,"dummy"
"13994",0,0,1,1,"dummy"
"14005",0,0,1,1,"dummy"
"14006",0,0,1,1,"dummy"
"14011",0,0,1,1,"dummy"
"14012",0,0,1,1,"dummy"
"14065",3,1,4,8,"dummy"
"14066",0,1,0,1,"dummy"
"14067",0,0,0,0,"dummy"
"14068",0,0,1,1,"dummy"
"14069",5,3,2,10,"dummy"
"14070",0,1,0,1,"dummy"
"14071",0,1,1,2,"dummy"
"14072",1,0,0,1,"dummy"
"14073",1,0,0,1,"dummy"
"14074",0,0,0,0,"dummy"
"14075",1,0,0,1,"dummy"
"14076",0,1,0,1,"dummy"
"14077",1,0,0,1,"dummy"
"14099",14,0,0,14,"dummy"
"14100",0,0,1,1,"dummy"
"14101",0,1,0,1,"dummy"
"14102",0,1,0,1,"dummy"
"14103",2,3,1,6,"dummy"
"14134",0,1,1,2,"dummy"
"14135",0,0,1,1,"dummy"
"14136",0,0,2,2,"dummy"
"14137",1,9,0,10,"dummy"
"14138",0,1,0,1,"dummy"
"14139",0,0,1,1,"dummy"
"14140",2,0,0,2,"dummy"
"14141",0,1,0,1,"dummy"
"14142",0,1,0,1,"dummy"
"14143",0,1,0,1,"dummy"
"13941",0,0,1,1,"dummy"
"13942",0,0,3,3,"dummy"
"13943",0,0,1,1,"dummy"
"13944",1,0,0,1,"dummy"
"13969",0,1,0,1,"dummy"
"13970",1,0,1,2,"dummy"
"13977",0,5,0,5,"dummy"
"13978",0,2,0,2,"dummy"
"13979",0,5,0,5,"dummy"
"13980",0,1,0,1,"dummy"
"13981",0,5,0,5,"dummy"
"13987",2,0,3,5,"dummy"
"13996",0,1,0,1,"dummy"
"13999",0,0,1,1,"dummy"
"14000",0,3,2,5,"dummy"
"14001",0,0,1,1,"dummy"
"14002",2,2,0,4,"dummy"
"14003",0,0,2,2,"dummy"
"14057",0,1,0,1,"dummy"
"14058",0,0,1,1,"dummy"
"14059",2,10,0,12,"dummy"
"14060",2,6,1,9,"dummy"
"14061",3,2,4,9,"dummy"
"14079",0,0,1,1,"dummy"
"14082",4,6,2,12,"dummy"
"14083",5,0,0,5,"dummy"
"14090",0,1,1,2,"dummy"
"14091",0,2,0,2,"dummy"
"14092",0,1,1,2,"dummy"
"14093",0,0,1,1,"dummy"
"14094",0,2,0,2,"dummy"
"14095",0,1,0,1,"dummy"
"14096",3,2,1,6,"dummy"
"14097",1,1,0,2,"dummy"
"14113",0,0,1,1,"dummy"
"14114",0,0,1,1,"dummy"
"14115",0,0,1,1,"dummy"
"14116",0,0,1,1,"dummy"
"14123",0,1,0,1,"dummy"
"14124",0,8,0,8,"dummy"
"14125",0,2,0,2,"dummy"
"14126",0,2,0,2,"dummy"
"14127",8,12,1,21,"dummy"
"14130",0,0,0,0,"dummy"
"14156",6,8,2,16,"dummy"
"14157",8,8,2,18,"dummy"
"14158",0,1,0,1,"dummy"
"14159",0,1,0,1,"dummy"
"14162",0,0,2,2,"dummy"
"14144",0,1,0,1,"dummy"
"14145",6,0,0,6,"dummy"
"14146",0,1,1,2,"dummy"
"14147",0,0,1,1,"dummy"
"14148",0,0,1,1,"dummy"
"14149",0,0,1,1,"dummy"
"14150",0,0,1,1,"dummy"
"14151",0,2,1,3,"dummy"
"14152",1,1,2,4,"dummy"
"14153",0,2,1,3,"dummy"
"14154",0,0,1,1,"dummy"
"14164",0,1,0,1,"dummy"
"14165",0,13,0,13,"dummy"
"14166",0,3,0,3,"dummy"
"14167",1,3,0,4,"dummy"
"14173",0,0,0,0,"dummy"
"14174",0,0,0,0,"dummy"
"14185",0,0,2,2,"dummy"
"14187",2,2,0,4,"dummy"
"14188",0,0,1,1,"dummy"
"14189",11,2,5,18,"dummy"
"14190",0,0,1,1,"dummy"
"14191",1,0,0,1,"dummy"
"14192",1,0,4,5,"dummy"
"14193",0,2,1,3,"dummy"
"14194",0,0,1,1,"dummy"
"14204",5,2,0,7,"dummy"
"14205",4,3,0,7,"dummy"
"14206",0,0,0,0,"dummy"
"14207",0,1,0,1,"dummy"
"14208",0,1,0,1,"dummy"
"14209",1,3,3,7,"dummy"
"14210",6,6,0,12,"dummy"
"14211",0,1,0,1,"dummy"
"14213",4,1,1,6,"dummy"
"14215",0,0,2,2,"dummy"
"14216",0,0,1,1,"dummy"
"14218",0,0,0,0,"dummy"
"14219",0,16,3,19,"dummy"
"14220",2,0,2,4,"dummy"
"14234",0,0,2,2,"dummy"
"14235",0,0,1,1,"dummy"
"14236",0,0,1,1,"dummy"
"14237",0,3,0,3,"dummy"
"14238",1,1,1,3,"dummy"
"14239",0,0,1,1,"dummy"
"14240",0,0,1,1,"dummy"
"14244",0,0,0,0,"dummy"
"14247",0,0,0,0,"dummy"
"14248",0,0,0,0,"dummy"
"14251",0,0,1,1,"dummy"
"14252",0,2,0,2,"dummy"
"14253",0,2,0,2,"dummy"
"14254",0,0,1,1,"dummy"
"14255",0,0,2,2,"dummy"
"14258",0,0,1,1,"dummy"
"14260",0,1,0,1,"dummy"
"14261",11,1,2,14,"dummy"
"14262",0,1,0,1,"dummy"
"14263",3,7,0,10,"dummy"
"14264",0,1,0,1,"dummy"
"14265",0,1,0,1,"dummy"
"14266",7,4,0,11,"dummy"
"14267",1,0,2,3,"dummy"
"14268",1,3,1,5,"dummy"
"14269",0,1,0,1,"dummy"
"14270",0,1,0,1,"dummy"
"14271",15,0,2,17,"dummy"
"14272",0,2,0,2,"dummy"
"14273",0,1,0,1,"dummy"
"14274",0,1,0,1,"dummy"
"14275",0,3,0,3,"dummy"
"14276",0,0,1,1,"dummy"
"14277",1,4,0,5,"dummy"
"14278",5,1,0,6,"dummy"
"14279",0,1,0,1,"dummy"
"14280",0,1,0,1,"dummy"
"14281",0,1,0,1,"dummy"
"14282",1,0,0,1,"dummy"
"14283",4,3,1,8,"dummy"
"14284",2,5,1,8,"dummy"
"14285",1,0,0,1,"dummy"
"14286",1,0,0,1,"dummy"
"14287",1,0,0,1,"dummy"
"14288",0,2,0,2,"dummy"
"14289",0,1,0,1,"dummy"
"14290",2,0,0,2,"dummy"
"14291",0,1,0,1,"dummy"
"14292",1,0,0,1,"dummy"
"14293",0,0,1,1,"dummy"
"14294",0,3,0,3,"dummy"
"14295",0,2,0,2,"dummy"
"14296",0,0,1,1,"dummy"
"14297",0,3,0,3,"dummy"
"14298",0,0,1,1,"dummy"
"14299",2,0,0,2,"dummy"
"14300",0,1,0,1,"dummy"
"14301",0,2,0,2,"dummy"
"14302",3,2,2,7,"dummy"
"14303",1,0,0,1,"dummy"
"14304",0,0,2,2,"dummy"
"14305",0,1,0,1,"dummy"
"14315",5,17,2,24,"dummy"
"14320",0,0,1,1,"dummy"
"14309",0,1,0,1,"dummy"
"14310",5,4,2,11,"dummy"
"14311",0,1,0,1,"dummy"
"14312",2,4,1,7,"dummy"
"14313",0,5,0,5,"dummy"
"14338",3,0,0,3,"dummy"
"14345",1,2,0,3,"dummy"
"14346",0,5,1,6,"dummy"
"14347",0,3,0,3,"dummy"
"14348",0,0,1,1,"dummy"
"14356",11,4,2,17,"dummy"
"14359",0,1,0,1,"dummy"
"14362",0,5,3,8,"dummy"
"14363",0,0,2,2,"dummy"
"14364",1,3,1,5,"dummy"
"14365",6,0,4,10,"dummy"
"14367",0,0,0,0,"dummy"
"14369",3,12,0,15,"dummy"
"14370",5,3,3,11,"dummy"
"14371",0,1,0,1,"dummy"
"14372",2,3,0,5,"dummy"
"14373",4,12,1,17,"dummy"
"14374",0,0,2,2,"dummy"
"14375",0,3,0,3,"dummy"
"14376",0,3,16,19,"dummy"
"14377",0,2,0,2,"dummy"
"14385",0,2,3,5,"dummy"
"14411",0,1,0,1,"dummy"
"14412",2,0,0,2,"dummy"
"14413",0,0,1,1,"dummy"
"14414",0,0,1,1,"dummy"
"14415",0,0,1,1,"dummy"
"14416",0,1,1,2,"dummy"
"14417",1,1,0,2,"dummy"
"14418",0,0,2,2,"dummy"
"14419",0,0,1,1,"dummy"
"14420",0,0,2,2,"dummy"
"14421",0,0,1,1,"dummy"
"14422",0,0,2,2,"dummy"
"14423",0,0,1,1,"dummy"
"14424",0,0,1,1,"dummy"
"14425",0,0,1,1,"dummy"
"14426",0,0,1,1,"dummy"
"14427",0,0,1,1,"dummy"
"14428",0,0,0,0,"dummy"
"14429",0,0,1,1,"dummy"
"14431",4,8,1,13,"dummy"
"14435",2,0,0,2,"dummy"
"14436",0,0,1,1,"dummy"
"14437",0,0,1,1,"dummy"
"14439",5,4,5,14,"dummy"
"14440",3,0,0,3,"dummy"
"14441",0,0,2,2,"dummy"
"14442",0,0,0,0,"dummy"
"14444",0,0,0,0,"dummy"
"14446",0,0,0,0,"dummy"
"14447",1,1,0,2,"dummy"
"14448",0,0,1,1,"dummy"
"14449",7,8,3,18,"dummy"
"14450",0,0,0,0,"dummy"
"14451",0,0,0,0,"dummy"
"14452",4,7,3,14,"dummy"
"14454",0,0,1,1,"dummy"
"14455",0,2,0,2,"dummy"
"14456",6,1,0,7,"dummy"
"14457",1,12,1,14,"dummy"
"14458",0,0,1,1,"dummy"
"14459",1,0,0,1,"dummy"
"14460",0,2,0,2,"dummy"
"14461",12,12,0,24,"dummy"
"14462",0,0,1,1,"dummy"
"14463",0,0,0,0,"dummy"
"14464",0,0,0,0,"dummy"
"14465",0,0,1,1,"dummy"
"14466",0,2,0,2,"dummy"
"14467",2,3,2,7,"dummy"
"14468",1,2,0,3,"dummy"
"14469",0,0,0,0,"dummy"
"14470",0,0,0,0,"dummy"
"14471",0,0,0,0,"dummy"
"14472",0,0,0,0,"dummy"
"14473",3,0,0,3,"dummy"
"14474",0,0,0,0,"dummy"
"14476",0,3,0,3,"dummy"
"14477",0,1,0,1,"dummy"
"14478",1,3,1,5,"dummy"
"14489",0,1,2,3,"dummy"
"14490",0,0,0,0,"dummy"
"14493",0,2,0,2,"dummy"
"14494",0,0,0,0,"dummy"
"14499",0,0,1,1,"dummy"
"14522",5,7,9,21,"dummy"
"14523",6,6,1,13,"dummy"
"14524",6,7,0,13,"dummy"
"14527",0,1,0,1,"dummy"
"14528",0,5,0,5,"dummy"
"14529",0,3,1,4,"dummy"
"14530",4,3,1,8,"dummy"
"14531",1,3,2,6,"dummy"
"14532",1,3,1,5,"dummy"
"14534",0,0,1,1,"dummy"
"14535",0,0,1,1,"dummy"
"14536",0,2,1,3,"dummy"
"14537",3,1,2,6,"dummy"
"14538",1,3,2,6,"dummy"
"14539",0,0,1,1,"dummy"
"14540",3,1,2,6,"dummy"
"14547",0,3,0,3,"dummy"
"14548",1,1,1,3,"dummy"
"14549",0,1,0,1,"dummy"
"14552",5,4,1,10,"dummy"
"14553",2,2,5,9,"dummy"
"14554",0,3,0,3,"dummy"
"14555",5,7,1,13,"dummy"
"14556",0,1,0,1,"dummy"
"14557",0,0,0,0,"dummy"
"14558",0,0,2,2,"dummy"
"14559",0,0,1,1,"dummy"
"14560",0,0,0,0,"dummy"
"14561",0,0,1,1,"dummy"
"14564",10,1,0,11,"dummy"
"14573",1,2,0,3,"dummy"
"14577",0,5,0,5,"dummy"
"14578",0,2,0,2,"dummy"
"14579",1,6,0,7,"dummy"
"14580",0,3,0,3,"dummy"
"14581",2,1,1,4,"dummy"
"14582",0,5,0,5,"dummy"
"14583",0,1,0,1,"dummy"
"14584",0,2,0,2,"dummy"
"14585",0,1,0,1,"dummy"
"14586",0,1,0,1,"dummy"
"14587",0,3,0,3,"dummy"
"14588",1,0,0,1,"dummy"
"14589",0,1,2,3,"dummy"
"14590",0,1,0,1,"dummy"
"14591",0,22,0,22,"dummy"
"14594",0,11,0,11,"dummy"
"14595",8,8,2,18,"dummy"
"14596",0,2,0,2,"dummy"
"14597",0,4,0,4,"dummy"
"14598",2,1,2,5,"dummy"
"14599",0,3,0,3,"dummy"
"14600",4,3,0,7,"dummy"
"14603",0,1,0,1,"dummy"
"14604",0,1,0,1,"dummy"
"14605",0,0,1,1,"dummy"
"14607",0,1,0,1,"dummy"
"14608",0,0,1,1,"dummy"
"14609",0,3,0,3,"dummy"
"14610",0,1,0,1,"dummy"
"14612",0,0,3,3,"dummy"
"14613",0,0,1,1,"dummy"
"14615",0,1,0,1,"dummy"
"14616",1,0,2,3,"dummy"
"14617",0,0,1,1,"dummy"
"14618",0,0,1,1,"dummy"
"14619",0,1,1,2,"dummy"
"14620",0,0,1,1,"dummy"
"14621",0,0,2,2,"dummy"
"14622",4,19,7,30,"dummy"
"14631",0,5,1,6,"dummy"
"14634",0,1,0,1,"dummy"
"14635",0,0,1,1,"dummy"
"14636",0,0,1,1,"dummy"
"14640",0,0,0,0,"dummy"
"14641",0,0,0,0,"dummy"
"14642",0,0,0,0,"dummy"
"14644",0,0,4,4,"dummy"
"14645",33,0,5,38,"dummy"
"14646",0,0,1,1,"dummy"
"14647",0,0,1,1,"dummy"
"14648",0,0,1,1,"dummy"
"14649",0,0,1,1,"dummy"
"14650",0,0,1,1,"dummy"
"14651",0,0,1,1,"dummy"
"14652",0,0,1,1,"dummy"
"14653",0,0,1,1,"dummy"
"14655",0,0,0,0,"dummy"
"14656",0,0,0,0,"dummy"
"14657",0,0,0,0,"dummy"
"14658",0,0,0,0,"dummy"
"14661",0,3,0,3,"dummy"
"14663",1,0,0,1,"dummy"
"14664",0,2,0,2,"dummy"
"14665",0,1,0,1,"dummy"
"14666",4,0,0,4,"dummy"
"14667",25,1,0,26,"dummy"
"14668",1,0,0,1,"dummy"
"14669",0,9,0,9,"dummy"
"14670",0,0,7,7,"dummy"
"14671",0,0,1,1,"dummy"
"14672",1,0,0,1,"dummy"
"14673",0,7,7,14,"dummy"
"14674",0,0,14,14,"dummy"
"14675",0,0,14,14,"dummy"
"14676",0,0,14,14,"dummy"
"14677",0,1,0,1,"dummy"
"14678",0,1,0,1,"dummy"
"14679",0,1,0,1,"dummy"
"14680",6,13,0,19,"dummy"
"14681",0,0,2,2,"dummy"
"14682",22,0,0,22,"dummy"
"14683",0,3,0,3,"dummy"
"14688",1,0,0,1,"dummy"
"14689",2,0,1,3,"dummy"
"14690",0,0,0,0,"dummy"
"14691",0,1,0,1,"dummy"
"14692",8,1,0,9,"dummy"
"14693",0,0,0,0,"dummy"
"14694",0,0,0,0,"dummy"
"14695",1,10,0,11,"dummy"
"14696",7,1,0,8,"dummy"
"14697",2,0,3,5,"dummy"
"14699",0,0,1,1,"dummy"
"14700",0,0,2,2,"dummy"
"14701",1,1,1,3,"dummy"
"14702",0,0,1,1,"dummy"
"14703",0,0,1,1,"dummy"
"14706",1,0,0,1,"dummy"
"14707",14,1,1,16,"dummy"
"14708",4,4,0,8,"dummy"
"14709",4,4,0,8,"dummy"
"14710",0,1,0,1,"dummy"
"14711",0,3,0,3,"dummy"
"14713",0,5,0,5,"dummy"
"14714",0,3,2,5,"dummy"
"14715",7,2,0,9,"dummy"
"14716",0,0,1,1,"dummy"
"14717",0,1,0,1,"dummy"
"14718",1,2,1,4,"dummy"
"14719",0,0,1,1,"dummy"
"14720",2,12,5,19,"dummy"
"14721",0,0,0,0,"dummy"
"14722",22,0,2,24,"dummy"
"14723",0,8,3,11,"dummy"
"14724",1,0,0,1,"dummy"
"14725",7,0,5,12,"dummy"
"14726",2,0,0,2,"dummy"
"14727",0,0,1,1,"dummy"
"14729",0,2,0,2,"dummy"
"14730",0,1,1,2,"dummy"
"14731",0,2,0,2,"dummy"
"14732",2,0,0,2,"dummy"
"14733",0,0,1,1,"dummy"
"14734",0,0,1,1,"dummy"
"14748",0,0,1,1,"dummy"
"14749",0,0,3,3,"dummy"
"14751",0,0,1,1,"dummy"
"14753",3,3,2,8,"dummy"
"14754",3,3,2,8,"dummy"
"14757",0,1,0,1,"dummy"
"14800",0,1,1,2,"dummy"
"14801",0,4,0,4,"dummy"
"14802",5,4,2,11,"dummy"
"14804",0,3,0,3,"dummy"
"14805",0,3,0,3,"dummy"
"14806",6,0,1,7,"dummy"
"14807",0,1,0,1,"dummy"
"14808",14,37,6,57,"dummy"
"14809",0,0,0,0,"dummy"
"14810",0,0,0,0,"dummy"
"14811",0,2,0,2,"dummy"
"14815",0,0,1,1,"dummy"
"14818",0,1,0,1,"dummy"
"14819",1,0,1,2,"dummy"
"14820",0,1,0,1,"dummy"
"14821",0,0,2,2,"dummy"
"14823",0,10,0,10,"dummy"
"14825",0,2,0,2,"dummy"
"14826",0,2,0,2,"dummy"
"14827",3,1,1,5,"dummy"
"14828",0,2,0,2,"dummy"
"14832",0,0,2,2,"dummy"
"14833",0,0,0,0,"dummy"
"14834",0,0,1,1,"dummy"
"14835",0,0,0,0,"dummy"
"14836",0,0,1,1,"dummy"
"14837",1,1,3,5,"dummy"
"14838",1,1,3,5,"dummy"
"14840",1,6,1,8,"dummy"
"14845",1,0,0,1,"dummy"
"14850",0,4,0,4,"dummy"
"14851",3,0,0,3,"dummy"
"14852",0,0,0,0,"dummy"
"14853",0,1,0,1,"dummy"
"14854",4,3,0,7,"dummy"
"14855",0,0,1,1,"dummy"
"14856",0,1,0,1,"dummy"
"14857",0,1,0,1,"dummy"
"14859",0,0,1,1,"dummy"
"14861",2,2,3,7,"dummy"
"14862",0,0,1,1,"dummy"
"14863",0,1,0,1,"dummy"
"14864",1,0,1,2,"dummy"
"14865",0,1,0,1,"dummy"
"14866",0,17,0,17,"dummy"
"14868",1,0,0,1,"dummy"
"14869",0,0,1,1,"dummy"
"14870",2,0,0,2,"dummy"
"14871",0,0,1,1,"dummy"
"14872",0,1,0,1,"dummy"
"14873",0,2,0,2,"dummy"
"14875",1,0,0,1,"dummy"
"14876",3,0,2,5,"dummy"
"14877",0,0,2,2,"dummy"
"14878",0,0,1,1,"dummy"
"14881",0,0,1,1,"dummy"
"14882",0,0,1,1,"dummy"
"14883",0,0,1,1,"dummy"
"14889",0,0,4,4,"dummy"
"14891",0,1,0,1,"dummy"
"14892",0,1,0,1,"dummy"
"14893",0,6,0,6,"dummy"
"14894",0,1,0,1,"dummy"
"14895",2,0,0,2,"dummy"
"14897",1,0,0,1,"dummy"
"14898",0,0,0,0,"dummy"
"14904",0,2,0,2,"dummy"
"14907",1,0,0,1,"dummy"
"14909",1,5,1,7,"dummy"
"14910",0,5,0,5,"dummy"
"14912",0,2,0,2,"dummy"
"14913",0,1,0,1,"dummy"
"14914",3,1,1,5,"dummy"
"14915",0,1,0,1,"dummy"
"14916",1,0,0,1,"dummy"
"14917",0,5,1,6,"dummy"
"14918",0,1,0,1,"dummy"
"14919",7,2,2,11,"dummy"
"14920",1,1,0,2,"dummy"
"14922",17,2,2,21,"dummy"
"14923",0,0,0,0,"dummy"
"14924",0,5,0,5,"dummy"
"14925",0,2,0,2,"dummy"
"14926",2,35,2,39,"dummy"
"14927",0,0,1,1,"dummy"
"14928",3,16,2,21,"dummy"
"14929",6,11,3,20,"dummy"
"14930",1,5,1,7,"dummy"
"14931",22,0,3,25,"dummy"
"14932",1,6,0,7,"dummy"
"14933",0,4,3,7,"dummy"
"14934",0,1,0,1,"dummy"
"14935",0,1,0,1,"dummy"
"14936",0,0,1,1,"dummy"
"14937",0,0,2,2,"dummy"
"14938",2,2,0,4,"dummy"
"14939",0,0,1,1,"dummy"
"14940",0,17,0,17,"dummy"
"14941",0,1,1,2,"dummy"
"14942",0,0,1,1,"dummy"
"14943",0,0,1,1,"dummy"
"14945",5,0,3,8,"dummy"
"14946",3,0,0,3,"dummy"
"14947",0,1,0,1,"dummy"
"14948",0,1,0,1,"dummy"
"14949",0,1,0,1,"dummy"
"14950",2,4,0,6,"dummy"
"14951",0,2,0,2,"dummy"
"14953",0,1,0,1,"dummy"
"14954",0,1,0,1,"dummy"
"14959",0,0,0,0,"dummy"
"14960",2,8,4,14,"dummy"
"14961",0,2,0,2,"dummy"
"14963",0,0,1,1,"dummy"
"14964",0,2,0,2,"dummy"
"14965",1,0,0,1,"dummy"
"14966",0,2,0,2,"dummy"
"14970",1,0,1,2,"dummy"
"14973",0,0,2,2,"dummy"
"14974",11,4,5,20,"dummy"
"14975",2,12,5,19,"dummy"
"14976",3,1,0,4,"dummy"
"14977",0,0,1,1,"dummy"
"14978",0,2,0,2,"dummy"
"14979",6,7,0,13,"dummy"
"14980",0,0,0,0,"dummy"
"14981",7,5,0,12,"dummy"
"14982",1,0,0,1,"dummy"
"14983",4,9,0,13,"dummy"
"14984",7,4,0,11,"dummy"
"14986",0,1,0,1,"dummy"
"14988",2,2,0,4,"dummy"
"14989",2,6,2,10,"dummy"
"14994",0,1,0,1,"dummy"
"14995",5,3,4,12,"dummy"
"14999",0,5,0,5,"dummy"
"15000",0,1,0,1,"dummy"
"15001",0,1,0,1,"dummy"
"15002",2,2,0,4,"dummy"
"15003",2,0,1,3,"dummy"
"15004",0,0,0,0,"dummy"
"15005",0,2,0,2,"dummy"
"15006",2,3,0,5,"dummy"
"15008",0,4,0,4,"dummy"
"15009",0,0,1,1,"dummy"
"15015",0,0,1,1,"dummy"
"15017",0,1,0,1,"dummy"
"15018",1,0,0,1,"dummy"
"15019",1,2,3,6,"dummy"
"15022",1,2,0,3,"dummy"
"15024",0,0,1,1,"dummy"
"15025",14,0,1,15,"dummy"
"15026",0,3,0,3,"dummy"
"15027",3,0,1,4,"dummy"
"15028",0,38,2,40,"dummy"
"15030",0,0,1,1,"dummy"
"15031",0,1,0,1,"dummy"
"15032",3,3,3,9,"dummy"
"15033",1,1,0,2,"dummy"
"15048",0,1,0,1,"dummy"
"15049",1,0,0,1,"dummy"
"15050",0,1,0,1,"dummy"
"15060",0,0,0,0,"dummy"
"15062",0,0,1,1,"dummy"
"15063",0,0,0,0,"dummy"
"15077",0,2,2,4,"dummy"
"15081",0,5,3,8,"dummy"
"15082",5,0,3,8,"dummy"
"15086",10,1,0,11,"dummy"
"15087",0,0,1,1,"dummy"
"15088",0,1,0,1,"dummy"
"15089",0,10,0,10,"dummy"
"15092",0,0,0,0,"dummy"
"15093",0,1,0,1,"dummy"
"15098",0,9,0,9,"dummy"
"15101",0,1,2,3,"dummy"
"15102",13,8,2,23,"dummy"
"15103",0,1,0,1,"dummy"
"15104",0,0,1,1,"dummy"
"15105",0,0,0,0,"dummy"
"15106",0,0,1,1,"dummy"
"15116",0,0,1,1,"dummy"
"15122",0,1,0,1,"dummy"
"15123",0,2,0,2,"dummy"
"15124",0,2,0,2,"dummy"
"15125",0,1,0,1,"dummy"
"15126",1,0,0,1,"dummy"
"15127",3,1,0,4,"dummy"
"15128",1,8,0,9,"dummy"
"15129",1,2,0,3,"dummy"
"15130",2,10,0,12,"dummy"
"15131",2,2,0,4,"dummy"
"15132",2,2,0,4,"dummy"
"15133",8,0,1,9,"dummy"
"15134",2,4,0,6,"dummy"
"15135",0,1,0,1,"dummy"
"15136",0,7,0,7,"dummy"
"15137",0,1,0,1,"dummy"
"15138",1,1,0,2,"dummy"
"15139",0,3,0,3,"dummy"
"15140",0,0,0,0,"dummy"
"15141",7,2,1,10,"dummy"
"15142",4,2,2,8,"dummy"
"15143",19,20,2,41,"dummy"
"15144",0,1,0,1,"dummy"
"15145",0,1,0,1,"dummy"
"15146",0,0,1,1,"dummy"
"15147",0,1,0,1,"dummy"
"15148",0,0,1,1,"dummy"
"15149",4,4,2,10,"dummy"
"15150",1,0,1,2,"dummy"
"15151",0,1,0,1,"dummy"
"15152",1,1,1,3,"dummy"
"15153",1,4,1,6,"dummy"
"15154",0,0,0,0,"dummy"
"15155",0,0,1,1,"dummy"
"15156",0,1,0,1,"dummy"
"15157",1,0,0,1,"dummy"
"15158",2,2,1,5,"dummy"
"15159",0,0,0,0,"dummy"
"15160",0,0,1,1,"dummy"
"15161",0,0,1,1,"dummy"
"15162",0,0,1,1,"dummy"
"15163",0,0,1,1,"dummy"
"15164",9,2,0,11,"dummy"
"15165",0,0,0,0,"dummy"
"15170",4,2,0,6,"dummy"
"15171",0,0,0,0,"dummy"
"15172",0,0,1,1,"dummy"
"15186",0,1,2,3,"dummy"
"15187",0,0,0,0,"dummy"
"15188",0,1,0,1,"dummy"
"15189",4,0,2,6,"dummy"
"15190",1,0,0,1,"dummy"
"15191",0,0,0,0,"dummy"
"15230",0,1,1,2,"dummy"
"15239",2,2,0,4,"dummy"
"15240",0,0,1,1,"dummy"
"15241",0,1,0,1,"dummy"
"15242",1,0,0,1,"dummy"
"15243",0,0,0,0,"dummy"
"15246",0,3,0,3,"dummy"
"15247",0,0,0,0,"dummy"
"15248",0,0,1,1,"dummy"
"15249",0,0,1,1,"dummy"
"15250",0,0,1,1,"dummy"
"15251",0,0,1,1,"dummy"
"15252",0,0,1,1,"dummy"
"15253",0,0,1,1,"dummy"
"15254",0,0,1,1,"dummy"
"15255",0,0,1,1,"dummy"
"15256",0,0,2,2,"dummy"
"15257",1,1,1,3,"dummy"
"15258",5,9,0,14,"dummy"
"15079",0,2,1,3,"dummy"
"15084",0,1,0,1,"dummy"
"15108",0,1,0,1,"dummy"
"15109",0,0,1,1,"dummy"
"15110",2,1,0,3,"dummy"
"15111",4,6,1,11,"dummy"
"15112",0,2,0,2,"dummy"
"15113",1,0,1,2,"dummy"
"15114",0,0,1,1,"dummy"
"15118",2,3,0,5,"dummy"
"15119",1,5,0,6,"dummy"
"15120",0,2,0,2,"dummy"
"15174",2,0,0,2,"dummy"
"15179",0,18,2,20,"dummy"
"15180",0,7,0,7,"dummy"
"15181",0,4,0,4,"dummy"
"15182",0,11,0,11,"dummy"
"15193",0,5,0,5,"dummy"
"15194",3,3,0,6,"dummy"
"15195",5,4,0,9,"dummy"
"15196",0,0,1,1,"dummy"
"15197",5,1,1,7,"dummy"
"15198",0,0,1,1,"dummy"
"15199",0,0,0,0,"dummy"
"15200",0,0,4,4,"dummy"
"15201",4,1,2,7,"dummy"
"15202",3,3,1,7,"dummy"
"15203",1,1,0,2,"dummy"
"15204",1,3,6,10,"dummy"
"15205",0,2,0,2,"dummy"
"15206",0,2,0,2,"dummy"
"15207",10,4,5,19,"dummy"
"15208",0,2,1,3,"dummy"
"15209",1,1,2,4,"dummy"
"15210",0,0,0,0,"dummy"
"15211",0,0,0,0,"dummy"
"15212",3,2,0,5,"dummy"
"15213",0,0,0,0,"dummy"
"15214",2,7,0,9,"dummy"
"15215",0,0,0,0,"dummy"
"15216",0,0,0,0,"dummy"
"15217",0,0,1,1,"dummy"
"15218",0,0,0,0,"dummy"
"15219",0,0,0,0,"dummy"
"15220",0,0,0,0,"dummy"
"15221",0,0,0,0,"dummy"
"15222",0,0,1,1,"dummy"
"15223",0,0,0,0,"dummy"
"15224",0,0,0,0,"dummy"
"15227",0,1,1,2,"dummy"
"15228",0,0,0,0,"dummy"
"15232",0,1,0,1,"dummy"
"15236",6,0,0,6,"dummy"
"15237",2,5,2,9,"dummy"
"15273",0,0,0,0,"dummy"
"15274",0,0,0,0,"dummy"
"15289",3,0,0,3,"dummy"
"15290",2,5,0,7,"dummy"
"15291",0,1,0,1,"dummy"
"15292",0,1,0,1,"dummy"
"15297",0,0,1,1,"dummy"
"15298",9,3,0,12,"dummy"
"15299",2,3,0,5,"dummy"
"15300",0,1,0,1,"dummy"
"15301",0,1,0,1,"dummy"
"15305",0,0,1,1,"dummy"
"15313",0,1,0,1,"dummy"
"15316",0,1,0,1,"dummy"
"15351",0,1,0,1,"dummy"
"15352",0,0,1,1,"dummy"
"15353",2,2,0,4,"dummy"
"15354",2,1,0,3,"dummy"
"15363",0,0,0,0,"dummy"
"15259",4,3,1,8,"dummy"
"15260",0,1,0,1,"dummy"
"15261",0,1,0,1,"dummy"
"15262",0,0,2,2,"dummy"
"15263",0,0,1,1,"dummy"
"15264",0,0,1,1,"dummy"
"15265",0,1,0,1,"dummy"
"15280",0,1,0,1,"dummy"
"15281",0,1,0,1,"dummy"
"15282",0,4,2,6,"dummy"
"15283",0,0,1,1,"dummy"
"15284",0,0,1,1,"dummy"
"15285",0,3,0,3,"dummy"
"15294",0,0,0,0,"dummy"
"15295",0,1,0,1,"dummy"
"15303",0,0,0,0,"dummy"
"15318",4,4,4,12,"dummy"
"15319",1,0,0,1,"dummy"
"15320",0,1,0,1,"dummy"
"15321",2,3,3,8,"dummy"
"15322",0,0,0,0,"dummy"
"15323",0,0,0,0,"dummy"
"15324",0,1,2,3,"dummy"
"15325",0,0,0,0,"dummy"
"15326",1,0,0,1,"dummy"
"15327",0,0,1,1,"dummy"
"15328",0,0,0,0,"dummy"
"15329",0,0,0,0,"dummy"
"15330",0,0,0,0,"dummy"
"15331",0,0,0,0,"dummy"
"15332",0,5,0,5,"dummy"
"15333",7,0,0,7,"dummy"
"15334",0,1,0,1,"dummy"
"15335",0,0,1,1,"dummy"
"15336",0,14,1,15,"dummy"
"15337",0,2,0,2,"dummy"
"15338",0,0,0,0,"dummy"
"15339",0,0,0,0,"dummy"
"15340",0,1,1,2,"dummy"
"15341",0,0,0,0,"dummy"
"15348",4,3,2,9,"dummy"
"15349",0,0,2,2,"dummy"
"15356",1,0,0,1,"dummy"
"15357",0,2,0,2,"dummy"
"15358",0,0,1,1,"dummy"
"15359",6,0,0,6,"dummy"
"15360",0,1,0,1,"dummy"
"15361",6,2,1,9,"dummy"
"15376",0,5,3,8,"dummy"
"15377",2,0,1,3,"dummy"
"15380",0,0,1,1,"dummy"
"15381",0,1,0,1,"dummy"
"15382",0,0,0,0,"dummy"
"15383",0,0,0,0,"dummy"
"15384",1,0,0,1,"dummy"
"15385",0,1,0,1,"dummy"
"15386",0,2,0,2,"dummy"
"15387",0,0,0,0,"dummy"
"15426",1,1,0,2,"dummy"
"15430",2,7,4,13,"dummy"
"15431",0,0,3,3,"dummy"
"15432",0,1,0,1,"dummy"
"15463",0,1,0,1,"dummy"
"15464",0,5,3,8,"dummy"
"15465",0,0,3,3,"dummy"
"15466",1,5,0,6,"dummy"
"15467",10,11,0,21,"dummy"
"15402",0,11,0,11,"dummy"
"15403",0,10,0,10,"dummy"
"15404",10,10,0,20,"dummy"
"15405",1,0,0,1,"dummy"
"15406",0,1,0,1,"dummy"
"15407",1,3,0,4,"dummy"
"15408",0,2,0,2,"dummy"
"15409",0,1,0,1,"dummy"
"15410",2,2,0,4,"dummy"
"15411",0,1,0,1,"dummy"
"15412",0,1,1,2,"dummy"
"15413",1,0,0,1,"dummy"
"15414",0,1,0,1,"dummy"
"15415",0,0,1,1,"dummy"
"15416",0,1,0,1,"dummy"
"15417",3,3,0,6,"dummy"
"15418",0,0,0,0,"dummy"
"15419",0,0,0,0,"dummy"
"15420",0,0,0,0,"dummy"
"15421",4,2,0,6,"dummy"
"15422",0,0,1,1,"dummy"
"15423",0,1,1,2,"dummy"
"15424",1,0,0,1,"dummy"
"15428",0,5,1,6,"dummy"
"15434",0,0,0,0,"dummy"
"15435",0,0,0,0,"dummy"
"15436",0,0,1,1,"dummy"
"15437",0,0,1,1,"dummy"
"15438",0,0,1,1,"dummy"
"15439",0,0,0,0,"dummy"
"15440",0,0,0,0,"dummy"
"15441",0,0,0,0,"dummy"
"15442",0,0,0,0,"dummy"
"15443",0,0,0,0,"dummy"
"15444",0,0,0,0,"dummy"
"15445",0,0,0,0,"dummy"
"15446",0,0,0,0,"dummy"
"15447",0,0,0,0,"dummy"
"15448",0,0,1,1,"dummy"
"15449",0,0,0,0,"dummy"
"15450",0,1,0,1,"dummy"
"15451",0,0,0,0,"dummy"
"15452",0,0,0,0,"dummy"
"15453",0,0,0,0,"dummy"
"15454",0,0,0,0,"dummy"
"15455",0,0,0,0,"dummy"
"15456",0,0,0,0,"dummy"
"15457",0,0,0,0,"dummy"
"15458",0,0,0,0,"dummy"
"15461",1,1,0,2,"dummy"
"15485",0,0,0,0,"dummy"
"15500",0,2,0,2,"dummy"
"15501",0,2,0,2,"dummy"
"15502",0,0,2,2,"dummy"
"15503",0,2,0,2,"dummy"
"15504",0,1,0,1,"dummy"
"15505",0,1,0,1,"dummy"
"15506",0,4,0,4,"dummy"
"15507",0,0,1,1,"dummy"
"15530",0,3,1,4,"dummy"
"15531",0,0,2,2,"dummy"
"15532",4,2,1,7,"dummy"
"15533",0,0,1,1,"dummy"
"15534",0,0,1,1,"dummy"
"15535",0,0,1,1,"dummy"
"15536",0,0,2,2,"dummy"
"15537",0,0,2,2,"dummy"
"15538",0,0,2,2,"dummy"
"15539",0,0,1,1,"dummy"
"15540",0,0,1,1,"dummy"
"15541",0,0,1,1,"dummy"
"15542",0,0,1,1,"dummy"
"15543",0,0,1,1,"dummy"
"15544",0,0,1,1,"dummy"
"15545",0,0,1,1,"dummy"
"15550",0,6,1,7,"dummy"
"15551",2,1,0,3,"dummy"
"15552",5,5,0,10,"dummy"
"15553",5,5,0,10,"dummy"
"15554",0,0,1,1,"dummy"
"15557",1,1,0,2,"dummy"
"15558",0,0,1,1,"dummy"
"15559",0,3,0,3,"dummy"
"15560",0,0,1,1,"dummy"
"15561",0,0,1,1,"dummy"
"15562",10,18,5,33,"dummy"
"15563",2,5,0,7,"dummy"
"15564",1,0,0,1,"dummy"
"15565",0,1,0,1,"dummy"
"15566",2,2,0,4,"dummy"
"15567",0,1,0,1,"dummy"
"15568",6,5,0,11,"dummy"
"15487",0,2,0,2,"dummy"
"15488",0,0,1,1,"dummy"
"15489",0,0,1,1,"dummy"
"15490",0,1,0,1,"dummy"
"15491",0,0,1,1,"dummy"
"15492",0,0,0,0,"dummy"
"15493",0,0,1,1,"dummy"
"15494",0,0,0,0,"dummy"
"15495",0,5,0,5,"dummy"
"15496",0,0,0,0,"dummy"
"15509",0,1,0,1,"dummy"
"15547",0,5,0,5,"dummy"
"15548",0,6,0,6,"dummy"
"15575",4,4,0,8,"dummy"
"15578",0,1,0,1,"dummy"
"15579",1,2,1,4,"dummy"
"15580",0,1,0,1,"dummy"
"15581",1,3,0,4,"dummy"
"15582",3,3,0,6,"dummy"
"15585",1,2,0,3,"dummy"
"15586",0,5,1,6,"dummy"
"15587",1,0,0,1,"dummy"
"15588",21,2,2,25,"dummy"
"15589",0,3,0,3,"dummy"
"15600",2,2,0,4,"dummy"
"15605",2,4,0,6,"dummy"
"15606",0,2,0,2,"dummy"
"15607",0,2,0,2,"dummy"
"15608",10,2,0,12,"dummy"
"15609",0,2,0,2,"dummy"
"15610",0,0,0,0,"dummy"
"15611",0,0,3,3,"dummy"
"15612",0,5,0,5,"dummy"
"15613",1,0,1,2,"dummy"
"15569",3,3,1,7,"dummy"
"15591",0,0,0,0,"dummy"
"15592",0,0,0,0,"dummy"
"15593",0,0,1,1,"dummy"
"15594",0,0,0,0,"dummy"
"15595",0,0,1,1,"dummy"
"15596",0,0,0,0,"dummy"
"15603",0,0,1,1,"dummy"
"15620",1,0,0,1,"dummy"
"15621",0,1,0,1,"dummy"
"15622",2,4,4,10,"dummy"
"15623",0,2,0,2,"dummy"
"15624",12,4,5,21,"dummy"
"15625",0,0,3,3,"dummy"
"15626",0,1,0,1,"dummy"
"15628",0,13,2,15,"dummy"
"15630",0,4,0,4,"dummy"
"15631",0,1,0,1,"dummy"
"15632",0,2,1,3,"dummy"
"15633",5,2,1,8,"dummy"
"15634",0,2,0,2,"dummy"
"15635",0,0,1,1,"dummy"
"15636",5,8,0,13,"dummy"
"15637",0,4,0,4,"dummy"
"15638",0,3,0,3,"dummy"
"15639",0,0,1,1,"dummy"
"15654",1,1,0,2,"dummy"
"15656",0,0,2,2,"dummy"
"15657",0,8,2,10,"dummy"
"15658",5,0,0,5,"dummy"
"15659",0,0,0,0,"dummy"
"15661",0,7,0,7,"dummy"
"15662",4,0,0,4,"dummy"
"15663",0,1,1,2,"dummy"
"15664",0,1,0,1,"dummy"
"15666",1,1,0,2,"dummy"
"15667",12,1,1,14,"dummy"
"15668",0,7,2,9,"dummy"
"15670",0,8,0,8,"dummy"
"15671",3,3,0,6,"dummy"
"15672",0,2,0,2,"dummy"
"15673",2,0,0,2,"dummy"
"15674",0,2,0,2,"dummy"
"15675",1,0,0,1,"dummy"
"15677",1,0,0,1,"dummy"
"15680",4,4,5,13,"dummy"
"15681",4,3,1,8,"dummy"
"15682",3,0,1,4,"dummy"
"15683",2,0,1,3,"dummy"
"15684",0,1,0,1,"dummy"
"15685",0,0,1,1,"dummy"
"15695",1,0,0,1,"dummy"
"15701",0,4,0,4,"dummy"
"15702",0,0,4,4,"dummy"
"15712",0,0,0,0,"dummy"
"15719",1,6,0,7,"dummy"
"15720",0,1,0,1,"dummy"
"15724",0,1,0,1,"dummy"
"15725",0,0,1,1,"dummy"
"15726",0,3,0,3,"dummy"
"15733",0,0,1,1,"dummy"
"15734",0,0,1,1,"dummy"
"15735",0,0,1,1,"dummy"
"15737",2,0,0,2,"dummy"
"15738",0,2,0,2,"dummy"
"15747",4,0,0,4,"dummy"
"15748",0,9,0,9,"dummy"
"15749",0,2,0,2,"dummy"
"15750",0,0,3,3,"dummy"
"15752",1,2,0,3,"dummy"
"15753",1,2,0,3,"dummy"
"15754",2,2,0,4,"dummy"
"15757",2,0,0,2,"dummy"
"15758",0,0,0,0,"dummy"
"15760",0,0,2,2,"dummy"
"15761",0,1,0,1,"dummy"
"15763",0,0,1,1,"dummy"
"15764",0,3,2,5,"dummy"
"15765",0,2,1,3,"dummy"
"15767",1,9,1,11,"dummy"
"15768",0,1,0,1,"dummy"
"15769",0,2,0,2,"dummy"
"15770",0,0,1,1,"dummy"
"15771",0,0,3,3,"dummy"
"15772",2,0,0,2,"dummy"
"15773",0,1,0,1,"dummy"
"15774",0,1,0,1,"dummy"
"15775",1,2,0,3,"dummy"
"15776",1,0,0,1,"dummy"
"15777",0,0,1,1,"dummy"
"15778",2,2,0,4,"dummy"
"15782",0,1,0,1,"dummy"
"15784",0,6,0,6,"dummy"
"15785",0,1,0,1,"dummy"
"15787",2,0,0,2,"dummy"
"15788",0,1,0,1,"dummy"
"15791",0,0,1,1,"dummy"
"15792",11,7,2,20,"dummy"
"15799",5,4,4,13,"dummy"
"15800",0,0,1,1,"dummy"
"15801",0,0,1,1,"dummy"
"15802",2,0,0,2,"dummy"
"15803",0,0,1,1,"dummy"
"15804",0,0,1,1,"dummy"
"15805",0,0,1,1,"dummy"
"15806",0,0,1,1,"dummy"
"15807",0,0,1,1,"dummy"
"15808",0,0,1,1,"dummy"
"15811",0,0,0,0,"dummy"
"15816",0,6,1,7,"dummy"
"15817",0,0,1,1,"dummy"
"15821",0,1,0,1,"dummy"
"15822",0,1,0,1,"dummy"
"15823",0,1,0,1,"dummy"
"15824",0,1,0,1,"dummy"
"15825",0,1,0,1,"dummy"
"15826",0,1,0,1,"dummy"
"15827",0,1,0,1,"dummy"
"15828",0,2,0,2,"dummy"
"15829",0,1,0,1,"dummy"
"15834",2,3,0,5,"dummy"
"15856",0,4,3,7,"dummy"
"15857",2,1,0,3,"dummy"
"15868",0,4,0,4,"dummy"
"15869",10,10,0,20,"dummy"
"15871",0,0,1,1,"dummy"
"15872",0,1,0,1,"dummy"
"15874",0,17,1,18,"dummy"
"15875",13,16,0,29,"dummy"
"15876",1,0,0,1,"dummy"
"15877",0,1,0,1,"dummy"
"15878",0,6,0,6,"dummy"
"15879",0,2,0,2,"dummy"
"15880",6,3,2,11,"dummy"
"15881",0,3,0,3,"dummy"
"15882",1,1,1,3,"dummy"
"15883",0,3,0,3,"dummy"
"15884",0,1,0,1,"dummy"
"15886",3,21,0,24,"dummy"
"15887",4,6,0,10,"dummy"
"15888",5,9,0,14,"dummy"
"15889",3,2,0,5,"dummy"
"15890",0,22,4,26,"dummy"
"15891",22,0,4,26,"dummy"
"15892",0,5,0,5,"dummy"
"15893",0,1,0,1,"dummy"
"15894",2,0,0,2,"dummy"
"15895",0,1,0,1,"dummy"
"15896",1,2,0,3,"dummy"
"15897",0,0,1,1,"dummy"
"15898",1,2,1,4,"dummy"
"15900",0,4,0,4,"dummy"
"15901",2,0,2,4,"dummy"
"15902",0,0,0,0,"dummy"
"15904",2,5,2,9,"dummy"
"15906",0,0,0,0,"dummy"
"15907",4,12,3,19,"dummy"
"15908",4,3,0,7,"dummy"
"15909",0,0,0,0,"dummy"
"15910",5,5,0,10,"dummy"
"15911",0,0,1,1,"dummy"
"15912",0,2,2,4,"dummy"
"15913",0,2,0,2,"dummy"
"15914",0,0,1,1,"dummy"
"15915",0,0,1,1,"dummy"
"15916",0,1,0,1,"dummy"
"15918",0,0,1,1,"dummy"
"15920",0,0,1,1,"dummy"
"15921",0,0,0,0,"dummy"
"15928",2,14,0,16,"dummy"
"15929",0,0,1,1,"dummy"
"15930",0,3,0,3,"dummy"
"15931",13,18,1,32,"dummy"
"15933",1,2,0,3,"dummy"
"15934",0,0,1,1,"dummy"
"15935",0,0,2,2,"dummy"
"15936",0,0,1,1,"dummy"
"15937",1,1,1,3,"dummy"
"15938",0,4,1,5,"dummy"
"15939",0,0,0,0,"dummy"
"15940",0,1,0,1,"dummy"
"15941",0,3,0,3,"dummy"
"15942",0,0,0,0,"dummy"
"15943",0,0,0,0,"dummy"
"15944",0,2,0,2,"dummy"
"15945",15,9,1,25,"dummy"
"15951",2,3,0,5,"dummy"
"15957",0,0,1,1,"dummy"
"15958",0,0,1,1,"dummy"
"15960",0,0,0,0,"dummy"
"15961",0,0,0,0,"dummy"
"15968",0,0,1,1,"dummy"
"15970",7,0,1,8,"dummy"
"15971",0,0,0,0,"dummy"
"15976",0,1,0,1,"dummy"
"15978",0,7,0,7,"dummy"
"15979",0,1,0,1,"dummy"
"15980",0,1,0,1,"dummy"
"15981",0,31,0,31,"dummy"
"15983",0,1,0,1,"dummy"
"15985",0,0,4,4,"dummy"
"15986",5,0,3,8,"dummy"
"15988",2,11,0,13,"dummy"
"15989",1,1,0,2,"dummy"
"15990",7,3,0,10,"dummy"
"15991",5,3,5,13,"dummy"
"15992",0,0,1,1,"dummy"
"15993",0,0,1,1,"dummy"
"15994",4,4,0,8,"dummy"
"15995",8,32,1,41,"dummy"
"15998",0,2,0,2,"dummy"
"16000",15,0,3,18,"dummy"
"16001",0,0,1,1,"dummy"
"16002",0,1,0,1,"dummy"
"16003",0,0,1,1,"dummy"
"16004",0,1,0,1,"dummy"
"16005",0,0,1,1,"dummy"
"16006",0,0,1,1,"dummy"
"16007",0,0,1,1,"dummy"
"16008",0,0,1,1,"dummy"
"16009",0,0,1,1,"dummy"
"16010",0,0,1,1,"dummy"
"16011",0,0,1,1,"dummy"
"16012",0,0,1,1,"dummy"
"16013",0,0,1,1,"dummy"
"16014",0,0,1,1,"dummy"
"16015",0,0,1,1,"dummy"
"16016",0,0,1,1,"dummy"
"16017",0,0,1,1,"dummy"
"16018",0,0,1,1,"dummy"
"16019",0,0,1,1,"dummy"
"16020",0,0,1,1,"dummy"
"16021",0,0,1,1,"dummy"
"16023",1,0,0,1,"dummy"
"16025",0,0,1,1,"dummy"
"16026",0,0,1,1,"dummy"
"16027",0,1,1,2,"dummy"
"16059",0,4,1,5,"dummy"
"16061",6,0,0,6,"dummy"
"16062",0,2,0,2,"dummy"
"16063",1,0,0,1,"dummy"
"16064",0,2,0,2,"dummy"
"16068",0,1,0,1,"dummy"
"16069",0,0,0,0,"dummy"
"16071",2,2,3,7,"dummy"
"16072",5,14,2,21,"dummy"
"16094",2,4,0,6,"dummy"
"16096",0,0,0,0,"dummy"
"16099",4,0,1,5,"dummy"
"16100",1,4,1,6,"dummy"
"16102",0,0,1,1,"dummy"
"16112",0,5,0,5,"dummy"
"16114",2,2,0,4,"dummy"
"16115",14,2,1,17,"dummy"
"16116",6,0,0,6,"dummy"
"16117",0,0,1,1,"dummy"
"16118",0,0,1,1,"dummy"
"16119",1,1,3,5,"dummy"
"16120",4,2,2,8,"dummy"
"16121",0,0,1,1,"dummy"
"16122",0,1,0,1,"dummy"
"16123",0,0,1,1,"dummy"
"16126",0,2,1,3,"dummy"
"16128",0,4,0,4,"dummy"
"16150",0,3,3,6,"dummy"
"16151",0,2,0,2,"dummy"
"16152",0,1,0,1,"dummy"
"16153",1,2,0,3,"dummy"
"16154",2,2,0,4,"dummy"
"16155",0,1,0,1,"dummy"
"16156",2,1,1,4,"dummy"
"16161",1,0,2,3,"dummy"
"16162",0,1,2,3,"dummy"
"16163",0,1,0,1,"dummy"
"16164",0,0,0,0,"dummy"
"16165",0,0,1,1,"dummy"
"16166",0,0,3,3,"dummy"
"16167",0,0,3,3,"dummy"
"16168",0,0,4,4,"dummy"
"16169",2,3,1,6,"dummy"
"16171",0,2,0,2,"dummy"
"16172",3,5,1,9,"dummy"
"16173",0,5,0,5,"dummy"
"16174",0,0,0,0,"dummy"
"16175",0,0,1,1,"dummy"
"16176",0,0,1,1,"dummy"
"16178",3,5,2,10,"dummy"
"16180",0,4,1,5,"dummy"
"16182",2,1,0,3,"dummy"
"16183",5,13,1,19,"dummy"
"16185",0,3,2,5,"dummy"
"16186",0,4,0,4,"dummy"
"16187",3,0,1,4,"dummy"
"16188",0,1,0,1,"dummy"
"16192",17,6,4,27,"dummy"
"16194",0,0,1,1,"dummy"
"16196",0,0,1,1,"dummy"
"16199",0,1,1,2,"dummy"
"16206",1,0,0,1,"dummy"
"16207",0,0,0,0,"dummy"
"16265",0,0,1,1,"dummy"
"16266",0,0,1,1,"dummy"
"16267",0,1,0,1,"dummy"
"16269",0,0,1,1,"dummy"
"16270",0,0,1,1,"dummy"
"16272",2,0,0,2,"dummy"
"16273",0,0,1,1,"dummy"
"16274",0,0,0,0,"dummy"
"16275",0,0,1,1,"dummy"
"16276",1,0,0,1,"dummy"
"16278",0,0,0,0,"dummy"
"16279",0,0,0,0,"dummy"
"16282",0,0,0,0,"dummy"
"16283",1,1,0,2,"dummy"
"16284",0,0,3,3,"dummy"
"16285",8,5,0,13,"dummy"
"16286",0,0,0,0,"dummy"
"16287",0,0,0,0,"dummy"
"16288",0,0,0,0,"dummy"
"16289",0,6,0,6,"dummy"
"16290",4,8,2,14,"dummy"
"16293",4,1,0,5,"dummy"
"16295",0,0,0,0,"dummy"
"16297",3,1,1,5,"dummy"
"16299",1,0,0,1,"dummy"
"16300",0,0,1,1,"dummy"
"16302",2,0,0,2,"dummy"
"16305",1,1,1,3,"dummy"
"16306",0,0,3,3,"dummy"
"16307",0,1,0,1,"dummy"
"16308",1,0,4,5,"dummy"
"16309",0,2,0,2,"dummy"
"16312",0,0,0,0,"dummy"
"16316",0,0,1,1,"dummy"
"16318",0,1,0,1,"dummy"
"16321",0,6,2,8,"dummy"
"16322",2,5,0,7,"dummy"
"16324",16,21,3,40,"dummy"
"16325",1,0,5,6,"dummy"
"16345",0,0,1,1,"dummy"
"16346",1,3,0,4,"dummy"
"16347",1,0,0,1,"dummy"
"16348",0,1,0,1,"dummy"
"16349",0,0,1,1,"dummy"
"16350",0,3,0,3,"dummy"
"16351",0,1,0,1,"dummy"
"16352",0,1,0,1,"dummy"
"16353",4,3,0,7,"dummy"
"16354",0,1,0,1,"dummy"
"16355",0,0,1,1,"dummy"
"16356",0,2,0,2,"dummy"
"16357",0,5,0,5,"dummy"
"16358",0,0,0,0,"dummy"
"16359",0,1,0,1,"dummy"
"16360",0,1,0,1,"dummy"
"16361",0,1,0,1,"dummy"
"16363",0,0,0,0,"dummy"
"16364",1,0,0,1,"dummy"
"16365",0,1,0,1,"dummy"
"16366",0,0,1,1,"dummy"
"16369",2,8,2,12,"dummy"
"16370",0,1,2,3,"dummy"
"16371",0,3,1,4,"dummy"
"16372",0,0,1,1,"dummy"
"16375",4,1,2,7,"dummy"
"16376",0,0,1,1,"dummy"
"16377",0,0,0,0,"dummy"
"16380",0,2,1,3,"dummy"
"16383",0,0,1,1,"dummy"
"16384",13,18,5,36,"dummy"
"16385",3,2,1,6,"dummy"
"16387",2,4,5,11,"dummy"
"16388",0,3,2,5,"dummy"
"16389",1,0,0,1,"dummy"
"16390",2,8,3,13,"dummy"
"16392",1,8,2,11,"dummy"
"16393",1,1,0,2,"dummy"
"16394",0,0,1,1,"dummy"
"16395",0,1,0,1,"dummy"
"16396",0,1,0,1,"dummy"
"16397",0,5,0,5,"dummy"
"16398",0,0,1,1,"dummy"
"16399",7,9,0,16,"dummy"
"16400",4,0,0,4,"dummy"
"16401",5,1,0,6,"dummy"
"16402",5,17,1,23,"dummy"
"16403",6,11,1,18,"dummy"
"16404",0,2,0,2,"dummy"
"16405",1,0,0,1,"dummy"
"16406",0,1,0,1,"dummy"
"16407",1,1,1,3,"dummy"
"16408",1,3,0,4,"dummy"
"16409",1,0,0,1,"dummy"
"16410",10,0,0,10,"dummy"
"16411",1,0,0,1,"dummy"
"16412",8,3,4,15,"dummy"
"16413",0,1,0,1,"dummy"
"16418",0,0,0,0,"dummy"
"16419",5,0,2,7,"dummy"
"16420",0,0,0,0,"dummy"
"16422",0,1,0,1,"dummy"
"16423",0,3,0,3,"dummy"
"16424",4,0,0,4,"dummy"
"16425",0,1,0,1,"dummy"
"16426",0,4,0,4,"dummy"
"16427",0,2,0,2,"dummy"
"16428",0,0,1,1,"dummy"
"16429",0,4,0,4,"dummy"
"16430",1,4,2,7,"dummy"
"16436",0,0,2,2,"dummy"
"16442",0,0,0,0,"dummy"
"16443",0,1,0,1,"dummy"
"16444",0,1,0,1,"dummy"
"16452",0,0,1,1,"dummy"
"16453",0,0,1,1,"dummy"
"16454",0,2,0,2,"dummy"
"16456",6,3,1,10,"dummy"
"16457",3,6,1,10,"dummy"
"16459",0,0,1,1,"dummy"
"16460",0,0,1,1,"dummy"
"16464",0,0,0,0,"dummy"
"16465",1,1,0,2,"dummy"
"16466",0,1,1,2,"dummy"
"16467",0,1,0,1,"dummy"
"16468",0,0,0,0,"dummy"
"16469",0,0,1,1,"dummy"
"16470",0,5,0,5,"dummy"
"16471",0,0,0,0,"dummy"
"16472",1,4,1,6,"dummy"
"16473",4,8,1,13,"dummy"
"16474",0,2,0,2,"dummy"
"16475",0,2,0,2,"dummy"
"16476",0,0,2,2,"dummy"
"16477",0,0,2,2,"dummy"
"16478",0,0,3,3,"dummy"
"16479",6,0,0,6,"dummy"
"16480",0,0,3,3,"dummy"
"16481",0,0,4,4,"dummy"
"16482",0,1,0,1,"dummy"
"16483",0,0,5,5,"dummy"
"16484",0,0,0,0,"dummy"
"16485",0,1,0,1,"dummy"
"16486",0,1,0,1,"dummy"
"16487",0,0,1,1,"dummy"
"16488",0,0,1,1,"dummy"
"16489",0,0,1,1,"dummy"
"16490",0,0,1,1,"dummy"
"16493",1,1,0,2,"dummy"
"16494",0,2,0,2,"dummy"
"16495",2,4,3,9,"dummy"
"16497",0,1,0,1,"dummy"
"16498",0,1,0,1,"dummy"
"16500",0,0,2,2,"dummy"
"16501",0,0,0,0,"dummy"
"16502",0,6,0,6,"dummy"
"16503",0,2,3,5,"dummy"
"16533",0,0,1,1,"dummy"
"16534",0,1,0,1,"dummy"
"16539",4,0,5,9,"dummy"
"16540",1,3,0,4,"dummy"
"16541",7,1,1,9,"dummy"
"16546",0,3,0,3,"dummy"
"16547",0,2,0,2,"dummy"
"16550",0,4,0,4,"dummy"
"16551",3,3,0,6,"dummy"
"16552",0,0,1,1,"dummy"
"16553",0,0,1,1,"dummy"
"16554",1,0,0,1,"dummy"
"16555",0,1,4,5,"dummy"
"16556",1,0,0,1,"dummy"
"16558",1,5,3,9,"dummy"
"16559",4,7,0,11,"dummy"
"16560",0,1,0,1,"dummy"
"16561",6,2,2,10,"dummy"
"16562",2,8,0,10,"dummy"
"16563",41,15,9,65,"dummy"
"16564",0,3,2,5,"dummy"
"16565",3,0,2,5,"dummy"
"16568",0,2,0,2,"dummy"
"16570",0,10,0,10,"dummy"
"16574",3,4,1,8,"dummy"
"16575",0,0,1,1,"dummy"
"16576",1,0,0,1,"dummy"
"16577",0,1,0,1,"dummy"
"16578",1,0,1,2,"dummy"
"16579",0,1,0,1,"dummy"
"16580",0,1,0,1,"dummy"
"16581",0,1,0,1,"dummy"
"16582",2,0,0,2,"dummy"
"16583",2,0,1,3,"dummy"
"16584",0,1,1,2,"dummy"
"16585",0,0,1,1,"dummy"
"16586",0,1,0,1,"dummy"
"16590",0,0,3,3,"dummy"
"16591",0,5,0,5,"dummy"
"16592",39,2,5,46,"dummy"
"16593",17,16,3,36,"dummy"
"16594",7,0,0,7,"dummy"
"16595",0,2,0,2,"dummy"
"16596",4,4,4,12,"dummy"
"16597",0,3,0,3,"dummy"
"16598",0,2,1,3,"dummy"
"16604",1,0,0,1,"dummy"
"16605",0,0,0,0,"dummy"
"16606",0,0,0,0,"dummy"
"16607",0,0,1,1,"dummy"
"16608",0,0,1,1,"dummy"
"16611",0,0,0,0,"dummy"
"16612",8,10,1,19,"dummy"
"16614",0,0,1,1,"dummy"
"16615",4,5,0,9,"dummy"
"16616",0,0,1,1,"dummy"
"16617",1,2,0,3,"dummy"
"16618",0,1,1,2,"dummy"
"16620",1,1,1,3,"dummy"
"16621",0,0,1,1,"dummy"
"16623",0,0,1,1,"dummy"
"16624",0,1,0,1,"dummy"
"16625",0,0,1,1,"dummy"
"16629",0,0,1,1,"dummy"
"16630",0,0,1,1,"dummy"
"16631",0,0,1,1,"dummy"
"16632",1,0,2,3,"dummy"
"16633",0,0,0,0,"dummy"
"16638",0,2,0,2,"dummy"
"16641",1,2,0,3,"dummy"
"16642",5,8,1,14,"dummy"
"16643",1,0,1,2,"dummy"
"16644",1,0,0,1,"dummy"
"16647",0,1,0,1,"dummy"
"16648",1,0,0,1,"dummy"
"16650",0,0,0,0,"dummy"
"16652",0,0,1,1,"dummy"
"16653",13,7,4,24,"dummy"
"16654",0,1,0,1,"dummy"
"16655",0,0,1,1,"dummy"
"16657",0,0,0,0,"dummy"
"16660",0,0,0,0,"dummy"
"16661",0,0,0,0,"dummy"
"16662",0,0,0,0,"dummy"
"16663",3,0,0,3,"dummy"
"16664",0,0,0,0,"dummy"
"16665",0,0,0,0,"dummy"
"16666",0,0,0,0,"dummy"
"16667",0,0,0,0,"dummy"
"16668",0,0,0,0,"dummy"
"16669",0,1,0,1,"dummy"
"16670",0,1,0,1,"dummy"
"16671",0,0,1,1,"dummy"
"16672",0,0,1,1,"dummy"
"16673",0,0,1,1,"dummy"
"16674",0,0,1,1,"dummy"
"16675",0,0,1,1,"dummy"
"16676",0,0,1,1,"dummy"
"16678",1,1,0,2,"dummy"
"16679",0,0,0,0,"dummy"
"16680",4,3,2,9,"dummy"
"16685",0,0,1,1,"dummy"
"16687",0,1,0,1,"dummy"
"16688",8,5,0,13,"dummy"
"16689",1,0,0,1,"dummy"
"16691",0,0,1,1,"dummy"
"16692",0,4,0,4,"dummy"
"16694",1,0,1,2,"dummy"
"16695",0,1,0,1,"dummy"
"16697",0,0,0,0,"dummy"
"16699",0,2,0,2,"dummy"
"16701",8,1,0,9,"dummy"
"16702",1,1,0,2,"dummy"
"16709",0,0,1,1,"dummy"
"16712",24,49,3,76,"dummy"
"16713",0,0,0,0,"dummy"
"16715",1,0,0,1,"dummy"
"16717",0,0,1,1,"dummy"
"16718",7,28,5,40,"dummy"
"16719",0,0,1,1,"dummy"
"16720",0,1,0,1,"dummy"
"16723",0,1,0,1,"dummy"
"16724",0,3,0,3,"dummy"
"16726",0,0,2,2,"dummy"
"16727",0,0,2,2,"dummy"
"16728",0,0,6,6,"dummy"
"16729",2,0,0,2,"dummy"
"16730",0,0,2,2,"dummy"
"16732",1,2,0,3,"dummy"
"16733",0,1,0,1,"dummy"
"16737",12,21,1,34,"dummy"
"16738",15,1,2,18,"dummy"
"16739",2,2,0,4,"dummy"
"16741",3,9,0,12,"dummy"
"16742",1,0,0,1,"dummy"
"16743",0,1,0,1,"dummy"
"16746",6,14,2,22,"dummy"
"16747",0,10,0,10,"dummy"
"16748",9,9,0,18,"dummy"
"16749",20,15,3,38,"dummy"
"16750",1,0,0,1,"dummy"
"16751",2,2,0,4,"dummy"
"16752",0,1,0,1,"dummy"
"16753",0,0,0,0,"dummy"
"16754",1,0,0,1,"dummy"
"16755",0,1,0,1,"dummy"
"16756",0,10,0,10,"dummy"
"16757",4,0,0,4,"dummy"
"16758",0,1,1,2,"dummy"
"16759",1,3,1,5,"dummy"
"16760",8,7,0,15,"dummy"
"16761",0,1,0,1,"dummy"
"16762",3,1,0,4,"dummy"
"16764",0,1,0,1,"dummy"
"16765",0,5,1,6,"dummy"
"16766",0,2,0,2,"dummy"
"16768",1,0,0,1,"dummy"
"16769",2,4,1,7,"dummy"
"16770",0,0,1,1,"dummy"
"16771",0,0,1,1,"dummy"
"16774",0,1,0,1,"dummy"
"16777",0,1,1,2,"dummy"
"16781",0,1,1,2,"dummy"
"16791",1,3,1,5,"dummy"
"16792",0,0,1,1,"dummy"
"16793",3,2,1,6,"dummy"
"16799",0,1,0,1,"dummy"
"16800",1,0,1,2,"dummy"
"16801",0,1,0,1,"dummy"
"16802",3,2,1,6,"dummy"
"16803",1,0,3,4,"dummy"
"16804",0,1,4,5,"dummy"
"16805",0,0,4,4,"dummy"
"16806",0,0,6,6,"dummy"
"16809",7,2,1,10,"dummy"
"16810",0,0,0,0,"dummy"
"16825",0,0,2,2,"dummy"
"16830",0,0,0,0,"dummy"
"16831",13,1,0,14,"dummy"
"16832",0,0,0,0,"dummy"
"16833",1,0,4,5,"dummy"
"16835",0,1,0,1,"dummy"
"16836",8,5,3,16,"dummy"
"16837",0,0,1,1,"dummy"
"16838",0,0,0,0,"dummy"
"16839",0,0,0,0,"dummy"
"16840",0,0,1,1,"dummy"
"16841",0,1,0,1,"dummy"
"16842",0,0,3,3,"dummy"
"16843",0,0,3,3,"dummy"
"16844",0,0,1,1,"dummy"
"16847",0,0,1,1,"dummy"
"16856",3,1,0,4,"dummy"
"16857",0,5,0,5,"dummy"
"16862",0,1,0,1,"dummy"
"16896",0,1,0,1,"dummy"
"16898",9,2,3,14,"dummy"
"16902",0,0,0,0,"dummy"
"16903",0,0,0,0,"dummy"
"16910",2,0,0,2,"dummy"
"16912",0,0,1,1,"dummy"
"16913",0,0,1,1,"dummy"
"16922",0,3,0,3,"dummy"
"16929",2,4,0,6,"dummy"
"16930",0,2,0,2,"dummy"
"16931",0,2,0,2,"dummy"
"16932",10,2,0,12,"dummy"
"16933",0,2,0,2,"dummy"
"16934",0,0,0,0,"dummy"
"16935",0,0,3,3,"dummy"
"16936",0,5,0,5,"dummy"
"16938",0,0,1,1,"dummy"
"16939",0,0,1,1,"dummy"
"16940",0,0,1,1,"dummy"
"16942",7,10,0,17,"dummy"
"16945",0,0,0,0,"dummy"
"16946",0,0,0,0,"dummy"
"16949",1,0,0,1,"dummy"
"16950",1,9,2,12,"dummy"
"16951",0,0,1,1,"dummy"
"16953",1,0,0,1,"dummy"
"16954",3,5,0,8,"dummy"
"16955",0,1,0,1,"dummy"
"16957",0,3,0,3,"dummy"
"16958",0,1,0,1,"dummy"
"16959",0,2,0,2,"dummy"
"16960",4,0,0,4,"dummy"
"16961",7,5,0,12,"dummy"
"16969",4,7,2,13,"dummy"
"16970",1,1,1,3,"dummy"
"16980",0,0,1,1,"dummy"
"16981",0,1,0,1,"dummy"
"16984",0,0,1,1,"dummy"
"16986",0,0,1,1,"dummy"
"16987",0,0,7,7,"dummy"
"16988",0,0,4,4,"dummy"
"16990",9,0,0,9,"dummy"
"16991",2,2,1,5,"dummy"
"16993",11,5,2,18,"dummy"
"16994",11,15,3,29,"dummy"
"16996",0,1,1,2,"dummy"
"16997",0,0,1,1,"dummy"
"16998",0,4,1,5,"dummy"
"17000",0,2,0,2,"dummy"
"17001",12,1,3,16,"dummy"
"17002",0,0,0,0,"dummy"
"17003",0,0,1,1,"dummy"
"17005",0,1,0,1,"dummy"
"17006",0,4,0,4,"dummy"
"17009",0,0,1,1,"dummy"
"17010",0,3,2,5,"dummy"
"17012",1,0,0,1,"dummy"
"17016",1,4,0,5,"dummy"
"17017",4,2,0,6,"dummy"
"17020",0,0,1,1,"dummy"
"17022",1,1,0,2,"dummy"
"17025",0,1,4,5,"dummy"
"17027",0,0,2,2,"dummy"
"17028",0,0,1,1,"dummy"
"17029",0,8,2,10,"dummy"
"17030",0,0,2,2,"dummy"
"17031",0,0,1,1,"dummy"
"17032",2,2,2,6,"dummy"
"17033",0,0,2,2,"dummy"
"17034",0,0,1,1,"dummy"
"17035",0,0,2,2,"dummy"
"17036",0,0,1,1,"dummy"
"17037",0,0,1,1,"dummy"
"17038",0,1,2,3,"dummy"
"17039",0,0,2,2,"dummy"
"17040",0,0,2,2,"dummy"
"17041",0,0,1,1,"dummy"
"17043",5,2,3,10,"dummy"
"17044",0,3,1,4,"dummy"
"17045",0,2,0,2,"dummy"
"17046",0,2,0,2,"dummy"
"17047",0,1,0,1,"dummy"
"17048",0,1,0,1,"dummy"
"17049",0,1,0,1,"dummy"
"17050",1,2,0,3,"dummy"
"17051",0,2,0,2,"dummy"
"17052",0,0,1,1,"dummy"
"17053",0,2,0,2,"dummy"
"17054",0,0,1,1,"dummy"
"17055",0,2,0,2,"dummy"
"17056",1,0,0,1,"dummy"
"17057",6,3,0,9,"dummy"
"17058",1,7,0,8,"dummy"
"17059",0,1,0,1,"dummy"
"17060",0,1,0,1,"dummy"
"17061",0,0,3,3,"dummy"
"17062",0,2,2,4,"dummy"
"17063",0,1,0,1,"dummy"
"17064",1,0,0,1,"dummy"
"17065",0,0,2,2,"dummy"
"17066",3,0,0,3,"dummy"
"17067",4,15,1,20,"dummy"
"17068",0,7,0,7,"dummy"
"17069",10,1,0,11,"dummy"
"17070",1,1,0,2,"dummy"
"17072",7,1,0,8,"dummy"
"17073",0,0,0,0,"dummy"
"17075",1,1,0,2,"dummy"
"17076",3,3,0,6,"dummy"
"17077",0,1,0,1,"dummy"
"17079",0,0,1,1,"dummy"
"17080",1,1,2,4,"dummy"
"17090",0,1,0,1,"dummy"
"17099",3,13,1,17,"dummy"
"17101",0,1,2,3,"dummy"
"17102",1,3,0,4,"dummy"
"17103",3,1,0,4,"dummy"
"17104",0,0,1,1,"dummy"
"17105",0,0,1,1,"dummy"
"17106",0,0,1,1,"dummy"
"17107",0,1,0,1,"dummy"
"17108",0,0,1,1,"dummy"
"17109",1,0,0,1,"dummy"
"17110",0,0,1,1,"dummy"
"17131",0,0,0,0,"dummy"
"17136",0,0,1,1,"dummy"
"17137",0,0,1,1,"dummy"
"17138",0,0,2,2,"dummy"
"17139",0,0,1,1,"dummy"
"17140",0,0,2,2,"dummy"
"17141",1,3,1,5,"dummy"
"17142",2,1,0,3,"dummy"
"17145",0,1,0,1,"dummy"
"17146",10,0,1,11,"dummy"
"17147",5,1,1,7,"dummy"
"17148",0,2,0,2,"dummy"
"17149",2,0,0,2,"dummy"
"17151",6,0,0,6,"dummy"
"17152",2,5,2,9,"dummy"
"17154",0,0,0,0,"dummy"
"17155",1,0,0,1,"dummy"
"17158",1,3,0,4,"dummy"
"17159",0,0,0,0,"dummy"
"17161",0,1,0,1,"dummy"
"17164",0,0,1,1,"dummy"
"17165",0,1,3,4,"dummy"
"17166",5,3,0,8,"dummy"
"17168",2,0,0,2,"dummy"
"17171",0,6,1,7,"dummy"
"17172",4,4,0,8,"dummy"
"17173",4,5,0,9,"dummy"
"17174",0,0,1,1,"dummy"
"17175",1,0,0,1,"dummy"
"17177",0,6,0,6,"dummy"
"17178",0,1,0,1,"dummy"
"17179",1,2,0,3,"dummy"
"17180",0,0,0,0,"dummy"
"17181",0,1,0,1,"dummy"
"17182",6,5,2,13,"dummy"
"17183",0,0,1,1,"dummy"
"17184",1,10,1,12,"dummy"
"17185",0,2,0,2,"dummy"
"17186",0,0,1,1,"dummy"
"17187",0,15,1,16,"dummy"
"17188",0,0,1,1,"dummy"
"17189",12,9,0,21,"dummy"
"17190",0,1,0,1,"dummy"
"17191",0,2,0,2,"dummy"
"17192",0,0,1,1,"dummy"
"17195",0,0,1,1,"dummy"
"17197",2,0,0,2,"dummy"
"17198",2,0,0,2,"dummy"
"17200",0,0,0,0,"dummy"
"17202",0,3,1,4,"dummy"
"17204",0,1,0,1,"dummy"
"17205",0,2,0,2,"dummy"
"17210",0,2,4,6,"dummy"
"17211",0,0,1,1,"dummy"
"17212",0,0,2,2,"dummy"
"17213",0,2,0,2,"dummy"
"17214",6,4,3,13,"dummy"
"17215",2,2,2,6,"dummy"
"17218",0,23,0,23,"dummy"
"17219",0,2,1,3,"dummy"
"17220",0,0,1,1,"dummy"
"17221",4,4,4,12,"dummy"
"17222",0,0,0,0,"dummy"
"17223",0,1,0,1,"dummy"
"17224",4,3,2,9,"dummy"
"17227",0,0,0,0,"dummy"
"17229",2,0,0,2,"dummy"
"17231",1,3,1,5,"dummy"
"17234",1,0,0,1,"dummy"
"17235",0,1,0,1,"dummy"
"17236",19,1,0,20,"dummy"
"17237",0,4,0,4,"dummy"
"17238",19,16,1,36,"dummy"
"17239",16,16,3,35,"dummy"
"17240",1,3,0,4,"dummy"
"17242",0,0,2,2,"dummy"
"17243",0,0,1,1,"dummy"
"17244",0,0,1,1,"dummy"
"17245",0,0,1,1,"dummy"
"17246",0,0,1,1,"dummy"
"17247",1,0,1,2,"dummy"
"17248",0,0,1,1,"dummy"
"17249",0,0,2,2,"dummy"
"17250",0,0,1,1,"dummy"
"17251",0,1,3,4,"dummy"
"17252",0,0,1,1,"dummy"
"17253",0,0,1,1,"dummy"
"17254",0,0,1,1,"dummy"
"17255",0,0,1,1,"dummy"
"17256",0,0,1,1,"dummy"
"17257",0,0,1,1,"dummy"
"17258",0,0,1,1,"dummy"
"17259",0,0,1,1,"dummy"
"17260",0,0,1,1,"dummy"
"17261",0,0,1,1,"dummy"
"17262",0,0,1,1,"dummy"
"17263",0,0,1,1,"dummy"
"17264",0,0,1,1,"dummy"
"17265",0,0,1,1,"dummy"
"17266",0,0,1,1,"dummy"
"17267",0,0,1,1,"dummy"
"17268",0,0,1,1,"dummy"
"17269",0,0,1,1,"dummy"
"17270",0,0,1,1,"dummy"
"17271",0,0,1,1,"dummy"
"17272",0,0,1,1,"dummy"
"17273",0,0,1,1,"dummy"
"17274",0,0,1,1,"dummy"
"17275",0,0,1,1,"dummy"
"17276",0,0,1,1,"dummy"
"17277",0,0,1,1,"dummy"
"17278",0,0,1,1,"dummy"
"17279",0,0,1,1,"dummy"
"17280",0,0,1,1,"dummy"
"17281",0,0,1,1,"dummy"
"17282",0,0,1,1,"dummy"
"17283",0,0,1,1,"dummy"
"17284",0,0,1,1,"dummy"
"17285",0,0,1,1,"dummy"
"17286",0,0,1,1,"dummy"
"17287",0,0,1,1,"dummy"
"17288",0,0,1,1,"dummy"
"17289",0,0,1,1,"dummy"
"17290",0,0,1,1,"dummy"
"17291",0,0,1,1,"dummy"
"17292",0,0,1,1,"dummy"
"17294",1,0,0,1,"dummy"
"17295",2,1,1,4,"dummy"
"17296",0,1,2,3,"dummy"
"17297",0,0,1,1,"dummy"
"17298",0,0,1,1,"dummy"
"17299",0,0,1,1,"dummy"
"17300",0,1,0,1,"dummy"
"17301",0,0,1,1,"dummy"
"17308",0,0,1,1,"dummy"
"17310",0,1,0,1,"dummy"
"17311",0,0,1,1,"dummy"
"17312",0,0,0,0,"dummy"
"17313",0,0,1,1,"dummy"
"17314",1,0,0,1,"dummy"
"17315",0,0,1,1,"dummy"
"17318",2,1,0,3,"dummy"
"17319",11,6,1,18,"dummy"
"17320",0,1,1,2,"dummy"
"17324",0,0,1,1,"dummy"
"17325",2,0,0,2,"dummy"
"17326",3,9,5,17,"dummy"
"17327",7,0,1,8,"dummy"
"17328",1,3,0,4,"dummy"
"17329",2,3,0,5,"dummy"
"17330",0,0,1,1,"dummy"
"17331",0,3,1,4,"dummy"
"17332",3,0,2,5,"dummy"
"17333",1,2,0,3,"dummy"
"17334",0,4,1,5,"dummy"
"17335",0,0,1,1,"dummy"
"17336",9,1,2,12,"dummy"
"17337",0,2,0,2,"dummy"
"17338",0,2,0,2,"dummy"
"17339",0,2,0,2,"dummy"
"17340",0,4,0,4,"dummy"
"17341",2,0,0,2,"dummy"
"17342",0,0,2,2,"dummy"
"17343",0,2,0,2,"dummy"
"17344",0,0,1,1,"dummy"
"17345",0,11,0,11,"dummy"
"17346",0,1,0,1,"dummy"
"17347",11,0,0,11,"dummy"
"17348",0,10,0,10,"dummy"
"17349",0,1,0,1,"dummy"
"17350",1,0,0,1,"dummy"
"17351",0,0,1,1,"dummy"
"17352",0,0,1,1,"dummy"
"17353",0,0,1,1,"dummy"
"17354",0,5,0,5,"dummy"
"17355",0,1,0,1,"dummy"
"17356",6,13,1,20,"dummy"
"17357",0,2,0,2,"dummy"
"17358",4,8,0,12,"dummy"
"17359",23,8,2,33,"dummy"
"17360",0,1,0,1,"dummy"
"17361",1,4,0,5,"dummy"
"17362",4,1,0,5,"dummy"
"17363",1,4,0,5,"dummy"
"17364",0,0,1,1,"dummy"
"17365",0,1,0,1,"dummy"
"17366",0,1,0,1,"dummy"
"17367",0,0,0,0,"dummy"
"17368",0,1,1,2,"dummy"
"17369",0,0,1,1,"dummy"
"17370",0,0,1,1,"dummy"
"17371",0,0,1,1,"dummy"
"17372",0,0,1,1,"dummy"
"17373",0,0,1,1,"dummy"
"17374",1,0,1,2,"dummy"
"17375",0,4,0,4,"dummy"
"17376",0,0,0,0,"dummy"
"17377",0,0,2,2,"dummy"
"17378",0,1,0,1,"dummy"
"17379",0,0,0,0,"dummy"
"17380",0,2,0,2,"dummy"
"17383",5,24,1,30,"dummy"
"17384",0,0,2,2,"dummy"
"17385",0,3,0,3,"dummy"
"17386",12,6,1,19,"dummy"
"17408",0,1,0,1,"dummy"
"17409",0,0,1,1,"dummy"
"17416",0,1,0,1,"dummy"
"17419",0,0,1,1,"dummy"
"17423",2,4,0,6,"dummy"
"17424",0,2,0,2,"dummy"
"17425",0,2,0,2,"dummy"
"17426",10,2,0,12,"dummy"
"17427",0,2,0,2,"dummy"
"17428",0,0,0,0,"dummy"
"17395",2,2,0,4,"dummy"
"17396",0,0,1,1,"dummy"
"17399",1,0,1,2,"dummy"
"17400",5,6,0,11,"dummy"
"17401",0,0,1,1,"dummy"
"17406",0,1,0,1,"dummy"
"17411",0,1,1,2,"dummy"
"17412",0,0,1,1,"dummy"
"17413",0,0,2,2,"dummy"
"17414",0,0,1,1,"dummy"
"17421",2,2,0,4,"dummy"
"17432",0,0,2,2,"dummy"
"17435",0,2,0,2,"dummy"
"17436",1,2,1,4,"dummy"
"17437",0,2,0,2,"dummy"
"17438",0,2,0,2,"dummy"
"17439",1,7,0,8,"dummy"
"17440",0,1,0,1,"dummy"
"17441",2,1,0,3,"dummy"
"17442",0,4,0,4,"dummy"
"17443",3,1,0,4,"dummy"
"17444",1,1,0,2,"dummy"
"17445",7,2,3,12,"dummy"
"17447",0,1,0,1,"dummy"
"17448",1,1,0,2,"dummy"
"17449",0,0,2,2,"dummy"
"17453",0,3,0,3,"dummy"
"17459",0,0,3,3,"dummy"
"17462",0,0,1,1,"dummy"
"17469",0,5,0,5,"dummy"
"17470",0,0,0,0,"dummy"
"17471",1,7,1,9,"dummy"
"17479",2,0,3,5,"dummy"
"17480",1,0,0,1,"dummy"
"17481",0,1,0,1,"dummy"
"17482",0,1,1,2,"dummy"
"17485",0,2,0,2,"dummy"
"17486",13,1,3,17,"dummy"
"17487",0,0,0,0,"dummy"
"17488",0,0,1,1,"dummy"
"17489",0,1,1,2,"dummy"
"17491",0,1,0,1,"dummy"
"17492",0,2,0,2,"dummy"
"17493",0,0,0,0,"dummy"
"17494",0,0,0,0,"dummy"
"17495",1,1,0,2,"dummy"
"17496",0,1,0,1,"dummy"
"17497",2,2,0,4,"dummy"
"17499",0,0,0,0,"dummy"
"17500",0,1,0,1,"dummy"
"17501",0,0,0,0,"dummy"
"17504",0,0,0,0,"dummy"
"17507",4,2,0,6,"dummy"
"17508",0,0,0,0,"dummy"
"17509",0,4,0,4,"dummy"
"17510",8,0,0,8,"dummy"
"17511",0,0,0,0,"dummy"
"17512",0,0,0,0,"dummy"
"17515",0,2,0,2,"dummy"
"17516",2,0,0,2,"dummy"
"17517",4,2,0,6,"dummy"
"17518",0,0,1,1,"dummy"
"17519",0,0,1,1,"dummy"
"17520",0,0,1,1,"dummy"
"17521",4,1,1,6,"dummy"
"17522",0,0,1,1,"dummy"
"17523",0,0,1,1,"dummy"
"17524",0,0,1,1,"dummy"
"17525",0,0,1,1,"dummy"
"17526",0,0,1,1,"dummy"
"17527",0,0,1,1,"dummy"
"17530",2,4,0,6,"dummy"
"17531",0,1,0,1,"dummy"
"17532",0,0,1,1,"dummy"
"17533",0,4,1,5,"dummy"
"17534",1,1,1,3,"dummy"
"17535",0,0,1,1,"dummy"
"17536",4,4,2,10,"dummy"
"17537",0,3,0,3,"dummy"
"17538",0,1,0,1,"dummy"
"17543",0,4,0,4,"dummy"
"17544",0,0,1,1,"dummy"
"17545",0,0,1,1,"dummy"
"17553",9,0,1,10,"dummy"
"17556",1,0,1,2,"dummy"
"17557",0,3,1,4,"dummy"
"17558",3,1,1,5,"dummy"
"17559",0,2,0,2,"dummy"
"17560",0,1,1,2,"dummy"
"17561",0,2,0,2,"dummy"
"17562",0,13,0,13,"dummy"
"17563",0,0,3,3,"dummy"
"17564",2,1,2,5,"dummy"
"17565",1,0,1,2,"dummy"
"17566",0,1,1,2,"dummy"
"17567",0,18,0,18,"dummy"
"17568",0,0,1,1,"dummy"
"17569",0,1,0,1,"dummy"
"17570",0,0,1,1,"dummy"
"17571",1,0,1,2,"dummy"
"17572",0,1,1,2,"dummy"
"17573",1,0,1,2,"dummy"
"17574",0,1,1,2,"dummy"
"17580",0,0,1,1,"dummy"
"17581",0,2,0,2,"dummy"
"17582",0,0,1,1,"dummy"
"17583",0,1,0,1,"dummy"
"17584",0,0,0,0,"dummy"
"17585",0,0,1,1,"dummy"
"17586",0,0,0,0,"dummy"
"17608",2,0,3,5,"dummy"
"17613",2,2,1,5,"dummy"
"17614",3,8,0,11,"dummy"
"17615",2,4,0,6,"dummy"
"17616",0,2,0,2,"dummy"
"17617",8,3,1,12,"dummy"
"17618",0,2,0,2,"dummy"
"17619",2,3,2,7,"dummy"
"17620",10,14,1,25,"dummy"
"17621",2,2,0,4,"dummy"
"17622",36,13,3,52,"dummy"
"17623",0,2,0,2,"dummy"
"17624",5,11,1,17,"dummy"
"17625",0,2,0,2,"dummy"
"17626",1,3,1,5,"dummy"
"17627",8,3,1,12,"dummy"
"17630",0,1,0,1,"dummy"
"17631",1,0,0,1,"dummy"
"17638",0,1,0,1,"dummy"
"17643",1,0,1,2,"dummy"
"17644",4,1,2,7,"dummy"
"17651",5,4,0,9,"dummy"
"17652",7,1,1,9,"dummy"
"17653",0,1,0,1,"dummy"
"17654",0,6,1,7,"dummy"
"17655",0,4,1,5,"dummy"
"17656",7,5,2,14,"dummy"
"17659",0,2,0,2,"dummy"
"17660",0,0,1,1,"dummy"
"17661",0,0,1,1,"dummy"
"17662",0,0,1,1,"dummy"
"17663",4,0,0,4,"dummy"
"17664",4,3,0,7,"dummy"
"17665",0,2,0,2,"dummy"
"17666",1,1,0,2,"dummy"
"17667",0,0,0,0,"dummy"
"17668",0,0,1,1,"dummy"
"17669",0,0,0,0,"dummy"
"17670",0,0,1,1,"dummy"
"17671",0,0,0,0,"dummy"
"17672",0,0,1,1,"dummy"
"17673",0,0,0,0,"dummy"
"17674",1,2,0,3,"dummy"
"17540",6,0,0,6,"dummy"
"17541",2,5,2,9,"dummy"
"17547",0,0,0,0,"dummy"
"17588",4,2,1,7,"dummy"
"17601",0,0,1,1,"dummy"
"17602",1,7,0,8,"dummy"
"17605",0,1,0,1,"dummy"
"17606",0,0,1,1,"dummy"
"17633",0,0,2,2,"dummy"
"17634",0,5,0,5,"dummy"
"17635",3,2,0,5,"dummy"
"17636",3,0,0,3,"dummy"
"17640",0,1,0,1,"dummy"
"17641",0,0,1,1,"dummy"
"17648",0,1,0,1,"dummy"
"17649",0,3,0,3,"dummy"
"17709",0,1,0,1,"dummy"
"17736",1,0,0,1,"dummy"
"17737",0,2,0,2,"dummy"
"17738",0,0,3,3,"dummy"
"17739",4,8,0,12,"dummy"
"17740",12,8,4,24,"dummy"
"17741",35,18,5,58,"dummy"
"17742",1,6,0,7,"dummy"
"17743",2,6,0,8,"dummy"
"17744",17,20,0,37,"dummy"
"17745",12,7,0,19,"dummy"
"17746",0,1,0,1,"dummy"
"17747",0,3,1,4,"dummy"
"17748",0,1,0,1,"dummy"
"17749",3,0,0,3,"dummy"
"17750",0,0,3,3,"dummy"
"17751",1,9,0,10,"dummy"
"17752",0,7,0,7,"dummy"
"17753",2,0,0,2,"dummy"
"17754",7,1,0,8,"dummy"
"17755",1,1,0,2,"dummy"
"17756",0,2,0,2,"dummy"
"17757",0,3,0,3,"dummy"
"17758",0,3,0,3,"dummy"
"17759",0,4,0,4,"dummy"
"17760",0,1,0,1,"dummy"
"17761",0,1,0,1,"dummy"
"17762",5,5,0,10,"dummy"
"17763",4,0,1,5,"dummy"
"17764",0,0,0,0,"dummy"
"17765",0,6,0,6,"dummy"
"17766",1,0,0,1,"dummy"
"17767",1,0,1,2,"dummy"
"17768",1,2,0,3,"dummy"
"17769",0,0,0,0,"dummy"
"17770",0,0,1,1,"dummy"
"17771",0,0,1,1,"dummy"
"17772",0,0,1,1,"dummy"
"17773",0,0,0,0,"dummy"
"17774",0,2,0,2,"dummy"
"17775",0,0,1,1,"dummy"
"17776",0,4,0,4,"dummy"
"17777",1,0,1,2,"dummy"
"17780",0,0,2,2,"dummy"
"17781",0,1,3,4,"dummy"
"17782",0,0,1,1,"dummy"
"17783",0,0,1,1,"dummy"
"17784",7,6,3,16,"dummy"
"17785",7,7,4,18,"dummy"
"17786",2,2,1,5,"dummy"
"17787",4,3,0,7,"dummy"
"17788",0,0,1,1,"dummy"
"17789",13,12,2,27,"dummy"
"17790",0,0,0,0,"dummy"
"17791",4,3,3,10,"dummy"
"17792",0,0,1,1,"dummy"
"17793",0,0,1,1,"dummy"
"17794",0,0,0,0,"dummy"
"17798",0,3,0,3,"dummy"
"17799",1,1,0,2,"dummy"
"17807",0,0,1,1,"dummy"
"17675",0,0,1,1,"dummy"
"17676",0,0,1,1,"dummy"
"17677",0,0,1,1,"dummy"
"17678",0,0,0,0,"dummy"
"17679",0,0,1,1,"dummy"
"17680",0,0,1,1,"dummy"
"17681",0,0,1,1,"dummy"
"17682",0,0,1,1,"dummy"
"17683",0,0,0,0,"dummy"
"17684",0,0,0,0,"dummy"
"17685",1,10,0,11,"dummy"
"17686",0,0,1,1,"dummy"
"17687",9,1,0,10,"dummy"
"17688",0,0,1,1,"dummy"
"17689",0,0,1,1,"dummy"
"17690",0,0,1,1,"dummy"
"17691",0,0,0,0,"dummy"
"17692",0,0,0,0,"dummy"
"17693",0,0,1,1,"dummy"
"17694",0,0,1,1,"dummy"
"17695",0,0,0,0,"dummy"
"17696",0,0,0,0,"dummy"
"17697",0,0,0,0,"dummy"
"17698",0,0,0,0,"dummy"
"17699",0,0,0,0,"dummy"
"17700",0,0,0,0,"dummy"
"17701",1,0,0,1,"dummy"
"17702",0,1,0,1,"dummy"
"17703",0,0,0,0,"dummy"
"17704",8,11,1,20,"dummy"
"17705",0,0,1,1,"dummy"
"17706",0,0,1,1,"dummy"
"17707",0,0,1,1,"dummy"
"17711",0,2,0,2,"dummy"
"17712",5,5,0,10,"dummy"
"17713",4,1,2,7,"dummy"
"17718",0,1,0,1,"dummy"
"17719",1,0,1,2,"dummy"
"17720",2,1,6,9,"dummy"
"17721",13,5,2,20,"dummy"
"17722",5,13,2,20,"dummy"
"17727",0,2,0,2,"dummy"
"17728",0,5,1,6,"dummy"
"17729",0,0,2,2,"dummy"
"17734",0,0,0,0,"dummy"
"17796",0,0,1,1,"dummy"
"17801",8,0,0,8,"dummy"
"17802",1,0,0,1,"dummy"
"17803",0,1,0,1,"dummy"
"17804",0,0,0,0,"dummy"
"17805",1,2,0,3,"dummy"
"17818",0,2,2,4,"dummy"
"17819",0,1,0,1,"dummy"
"17820",0,0,3,3,"dummy"
"17821",6,4,1,11,"dummy"
"17822",1,0,2,3,"dummy"
"17830",2,2,4,8,"dummy"
"17831",7,5,5,17,"dummy"
"17847",0,6,0,6,"dummy"
"17848",0,5,0,5,"dummy"
"17849",0,3,0,3,"dummy"
"17850",0,1,0,1,"dummy"
"17851",0,1,0,1,"dummy"
"17852",3,4,1,8,"dummy"
"17853",0,5,0,5,"dummy"
"17854",0,0,2,2,"dummy"
"17855",0,1,0,1,"dummy"
"17866",0,0,1,1,"dummy"
"17867",0,0,1,1,"dummy"
"17928",0,0,0,0,"dummy"
"17929",1,2,1,4,"dummy"
"17937",0,1,0,1,"dummy"
"17938",0,2,0,2,"dummy"
"17939",0,1,1,2,"dummy"
"17940",0,4,0,4,"dummy"
"17941",14,3,5,22,"dummy"
"17942",1,1,2,4,"dummy"
"17943",0,0,0,0,"dummy"
"17944",0,0,1,1,"dummy"
"17945",0,2,0,2,"dummy"
"17946",1,1,2,4,"dummy"
"17824",0,2,0,2,"dummy"
"17825",0,2,0,2,"dummy"
"17826",3,1,2,6,"dummy"
"17839",0,0,0,0,"dummy"
"17840",1,4,1,6,"dummy"
"17841",8,5,3,16,"dummy"
"17842",2,5,2,9,"dummy"
"17843",0,1,0,1,"dummy"
"17844",3,9,0,12,"dummy"
"17845",1,0,0,1,"dummy"
"17857",0,0,1,1,"dummy"
"17858",0,0,1,1,"dummy"
"17859",1,0,0,1,"dummy"
"17862",0,1,0,1,"dummy"
"17931",4,0,2,6,"dummy"
"17972",0,0,4,4,"dummy"
"17973",0,0,0,0,"dummy"
"17974",0,0,2,2,"dummy"
"17975",4,12,5,21,"dummy"
"17976",6,0,0,6,"dummy"
"17977",0,0,1,1,"dummy"
"17990",0,4,3,7,"dummy"
"17993",0,2,4,6,"dummy"
"17994",0,0,1,1,"dummy"
"17995",0,0,2,2,"dummy"
"17996",0,2,0,2,"dummy"
"17997",1,4,1,6,"dummy"
"17998",0,5,0,5,"dummy"
"17999",5,2,0,7,"dummy"
"18003",0,0,0,0,"dummy"
"18004",0,0,2,2,"dummy"
"18005",33,19,2,54,"dummy"
"18006",5,0,0,5,"dummy"
"18007",0,2,0,2,"dummy"
"18018",4,4,0,8,"dummy"
"18019",0,1,0,1,"dummy"
"18020",2,2,2,6,"dummy"
"18021",0,0,2,2,"dummy"
"18022",0,0,2,2,"dummy"
"18033",27,4,3,34,"dummy"
"18041",2,0,2,4,"dummy"
"17947",0,2,0,2,"dummy"
"17948",0,0,1,1,"dummy"
"17949",1,2,0,3,"dummy"
"17950",0,0,3,3,"dummy"
"17951",1,1,8,10,"dummy"
"17952",0,0,2,2,"dummy"
"17953",0,1,3,4,"dummy"
"17958",0,1,1,2,"dummy"
"17959",0,0,1,1,"dummy"
"17960",0,0,1,1,"dummy"
"17961",0,4,0,4,"dummy"
"17962",2,2,0,4,"dummy"
"17963",0,1,0,1,"dummy"
"17964",1,2,2,5,"dummy"
"17965",0,17,3,20,"dummy"
"17966",0,0,0,0,"dummy"
"17967",0,2,0,2,"dummy"
"17968",5,3,0,8,"dummy"
"17969",1,1,0,2,"dummy"
"17970",5,5,0,10,"dummy"
"17979",0,0,1,1,"dummy"
"17982",3,33,0,36,"dummy"
"17983",1,0,0,1,"dummy"
"17984",0,1,0,1,"dummy"
"17985",26,4,2,32,"dummy"
"17986",0,0,1,1,"dummy"
"17987",1,1,0,2,"dummy"
"17988",0,1,0,1,"dummy"
"18001",0,0,1,1,"dummy"
"18009",1,9,0,10,"dummy"
"18012",0,1,2,3,"dummy"
"18013",2,0,0,2,"dummy"
"18016",0,1,0,1,"dummy"
"18024",9,3,0,12,"dummy"
"18025",0,2,0,2,"dummy"
"18026",0,1,0,1,"dummy"
"18027",0,7,2,9,"dummy"
"18028",2,0,0,2,"dummy"
"18029",0,1,0,1,"dummy"
"18037",1,0,0,1,"dummy"
"18043",1,19,5,25,"dummy"
"18050",4,13,0,17,"dummy"
"18051",3,0,0,3,"dummy"
"18052",2,1,1,4,"dummy"
"18053",0,1,1,2,"dummy"
"18054",0,0,0,0,"dummy"
"18055",0,2,3,5,"dummy"
"18056",0,0,0,0,"dummy"
"18057",0,1,0,1,"dummy"
"18070",8,5,4,17,"dummy"
"18075",2,2,2,6,"dummy"
"18076",0,0,3,3,"dummy"
"18077",1,0,0,1,"dummy"
"18078",3,1,0,4,"dummy"
"18079",0,2,1,3,"dummy"
"18080",0,2,1,3,"dummy"
"18081",1,0,0,1,"dummy"
"18082",0,0,1,1,"dummy"
"18083",0,0,1,1,"dummy"
"18084",0,0,0,0,"dummy"
"18091",2,0,0,2,"dummy"
"18092",0,0,1,1,"dummy"
"18093",0,1,0,1,"dummy"
"18111",0,1,0,1,"dummy"
"18117",1,2,1,4,"dummy"
"18133",5,18,3,26,"dummy"
"18138",0,0,1,1,"dummy"
"18139",0,0,0,0,"dummy"
"18144",0,0,3,3,"dummy"
"18145",0,2,0,2,"dummy"
"18146",6,1,4,11,"dummy"
"18147",0,0,1,1,"dummy"
"18158",8,0,3,11,"dummy"
"18059",0,1,0,1,"dummy"
"18062",1,1,0,2,"dummy"
"18072",1,9,2,12,"dummy"
"18073",0,3,0,3,"dummy"
"18095",0,0,1,1,"dummy"
"18096",9,2,1,12,"dummy"
"18097",0,1,1,2,"dummy"
"18098",1,5,2,8,"dummy"
"18099",5,4,0,9,"dummy"
"18100",0,0,1,1,"dummy"
"18101",3,1,0,4,"dummy"
"18102",0,0,0,0,"dummy"
"18103",0,1,0,1,"dummy"
"18104",0,1,0,1,"dummy"
"18105",0,0,1,1,"dummy"
"18106",0,0,0,0,"dummy"
"18107",5,11,0,16,"dummy"
"18113",2,3,0,5,"dummy"
"18114",0,0,1,1,"dummy"
"18115",6,1,0,7,"dummy"
"18128",41,13,3,57,"dummy"
"18129",0,1,0,1,"dummy"
"18130",0,2,0,2,"dummy"
"18131",0,1,0,1,"dummy"
"18141",0,1,0,1,"dummy"
"18142",0,0,7,7,"dummy"
"18151",0,1,0,1,"dummy"
"18154",1,1,5,7,"dummy"
"18155",2,1,1,4,"dummy"
"18156",0,0,1,1,"dummy"
"18160",6,0,0,6,"dummy"
"18161",2,5,2,9,"dummy"
"18170",0,0,1,1,"dummy"
"18175",14,34,4,52,"dummy"
"18226",0,3,0,3,"dummy"
"18227",1,0,1,2,"dummy"
"18228",2,6,0,8,"dummy"
"18229",0,1,0,1,"dummy"
"18230",14,19,0,33,"dummy"
"18231",2,1,1,4,"dummy"
"18232",11,20,3,34,"dummy"
"18233",0,0,0,0,"dummy"
"18234",0,0,1,1,"dummy"
"18235",0,1,1,2,"dummy"
"18236",0,0,1,1,"dummy"
"18237",5,2,0,7,"dummy"
"18238",2,4,0,6,"dummy"
"18239",0,1,0,1,"dummy"
"18240",0,0,1,1,"dummy"
"18241",0,0,1,1,"dummy"
"18242",0,0,1,1,"dummy"
"18243",0,0,0,0,"dummy"
"18244",0,1,0,1,"dummy"
"18245",0,8,0,8,"dummy"
"18246",1,2,0,3,"dummy"
"18247",1,0,0,1,"dummy"
"18248",3,0,0,3,"dummy"
"18249",2,0,0,2,"dummy"
"18250",0,1,0,1,"dummy"
"18251",0,1,0,1,"dummy"
"18252",0,0,1,1,"dummy"
"18165",0,0,1,1,"dummy"
"18166",0,1,0,1,"dummy"
"18254",0,0,0,0,"dummy"
"18255",0,0,0,0,"dummy"
"18257",0,0,1,1,"dummy"
"18258",0,0,1,1,"dummy"
"18264",9,2,3,14,"dummy"
"18266",0,3,0,3,"dummy"
"18268",0,0,1,1,"dummy"
"18269",0,0,1,1,"dummy"
"18270",0,0,1,1,"dummy"
"18272",7,10,0,17,"dummy"
"18284",2,0,0,2,"dummy"
"18288",4,7,2,13,"dummy"
"18289",1,1,1,3,"dummy"
"18299",2,4,0,6,"dummy"
"18300",0,2,0,2,"dummy"
"18301",0,2,0,2,"dummy"
"18302",10,2,0,12,"dummy"
"18303",0,2,0,2,"dummy"
"18304",0,0,0,0,"dummy"
"18305",0,0,3,3,"dummy"
"18306",0,5,0,5,"dummy"
"18312",0,2,0,2,"dummy"
"18313",12,1,3,16,"dummy"
"18314",0,0,0,0,"dummy"
"18315",0,0,1,1,"dummy"
"18317",0,1,0,1,"dummy"
"18318",0,4,0,4,"dummy"
"18322",0,0,0,0,"dummy"
"18323",0,0,0,0,"dummy"
"18326",1,0,0,1,"dummy"
"18327",3,5,0,8,"dummy"
"18328",0,1,0,1,"dummy"
"18333",1,0,0,1,"dummy"
"18334",1,9,2,12,"dummy"
"18335",0,0,1,1,"dummy"
"18338",0,3,0,3,"dummy"
"18339",0,1,0,1,"dummy"
"18340",0,2,0,2,"dummy"
"18341",4,0,0,4,"dummy"
"18342",7,5,0,12,"dummy"
"18344",1,4,0,5,"dummy"
"18345",4,2,0,6,"dummy"
"18347",1,1,0,2,"dummy"
"18350",1,0,0,1,"dummy"
"18352",0,0,1,1,"dummy"
"18353",0,3,2,5,"dummy"
"18355",0,0,1,1,"dummy"
"18356",0,1,0,1,"dummy"
"18359",0,0,1,1,"dummy"
"18361",0,0,1,1,"dummy"
"18362",0,0,7,7,"dummy"
"18363",0,0,4,4,"dummy"
"18365",9,0,0,9,"dummy"
"18366",2,2,1,5,"dummy"
"18368",11,5,2,18,"dummy"
"18369",11,15,3,29,"dummy"
"18371",0,1,1,2,"dummy"
"18372",0,0,1,1,"dummy"
"18373",0,4,1,5,"dummy"
"18377",7,1,0,8,"dummy"
"18378",0,0,0,0,"dummy"
"18380",0,1,4,5,"dummy"
"18383",1,1,0,2,"dummy"
"18384",3,3,0,6,"dummy"
"18385",0,1,0,1,"dummy"
"18387",0,0,2,2,"dummy"
"18388",0,0,1,1,"dummy"
"18389",0,8,2,10,"dummy"
"18390",0,0,2,2,"dummy"
"18391",0,0,1,1,"dummy"
"18392",2,2,2,6,"dummy"
"18393",0,0,2,2,"dummy"
"18394",0,0,1,1,"dummy"
"18395",0,0,2,2,"dummy"
"18396",0,0,1,1,"dummy"
"18397",0,0,1,1,"dummy"
"18398",0,1,2,3,"dummy"
"18399",0,0,2,2,"dummy"
"18400",0,0,2,2,"dummy"
"18401",0,0,1,1,"dummy"
"18403",0,0,1,1,"dummy"
"18408",0,1,0,1,"dummy"
"18421",0,0,1,1,"dummy"
"18422",1,1,2,4,"dummy"
"18424",5,2,3,10,"dummy"
"18425",0,3,1,4,"dummy"
"18426",0,2,0,2,"dummy"
"18427",0,2,0,2,"dummy"
"18428",0,1,0,1,"dummy"
"18429",0,1,0,1,"dummy"
"18430",0,1,0,1,"dummy"
"18431",1,2,0,3,"dummy"
"18432",0,2,0,2,"dummy"
"18433",0,0,1,1,"dummy"
"18434",0,2,0,2,"dummy"
"18435",0,0,1,1,"dummy"
"18436",0,2,0,2,"dummy"
"18437",1,0,0,1,"dummy"
"18438",6,3,0,9,"dummy"
"18439",1,7,0,8,"dummy"
"18440",0,1,0,1,"dummy"
"18441",0,1,0,1,"dummy"
"18442",0,0,3,3,"dummy"
"18443",0,2,2,4,"dummy"
"18444",0,1,0,1,"dummy"
"18445",1,0,0,1,"dummy"
"18446",0,0,2,2,"dummy"
"18447",3,0,0,3,"dummy"
"18448",4,15,1,20,"dummy"
"18449",0,7,0,7,"dummy"
"18450",10,1,0,11,"dummy"
"18451",1,1,0,2,"dummy"
"18456",0,0,0,0,"dummy"
"18458",0,0,1,1,"dummy"
"18459",0,1,3,4,"dummy"
"18460",5,3,0,8,"dummy"
"18463",2,0,0,2,"dummy"
"18466",0,6,1,7,"dummy"
"18467",4,4,0,8,"dummy"
"18468",4,5,0,9,"dummy"
"18469",0,0,1,1,"dummy"
"18470",1,0,0,1,"dummy"
"18472",0,6,0,6,"dummy"
"18473",0,1,0,1,"dummy"
"18474",1,2,0,3,"dummy"
"18475",0,0,0,0,"dummy"
"18476",0,1,0,1,"dummy"
"18477",6,5,2,13,"dummy"
"18478",0,0,1,1,"dummy"
"18479",1,10,1,12,"dummy"
"18480",0,2,0,2,"dummy"
"18481",0,0,1,1,"dummy"
"18482",0,15,1,16,"dummy"
"18483",0,0,1,1,"dummy"
"18484",12,9,0,21,"dummy"
"18485",0,1,0,1,"dummy"
"18486",0,2,0,2,"dummy"
"18487",0,0,1,1,"dummy"
"18489",0,0,1,1,"dummy"
"18492",2,0,0,2,"dummy"
"18493",2,0,0,2,"dummy"
"18495",0,0,0,0,"dummy"
"18499",3,13,1,17,"dummy"
"18501",0,1,2,3,"dummy"
"18502",1,3,0,4,"dummy"
"18503",3,1,0,4,"dummy"
"18504",0,0,1,1,"dummy"
"18505",0,0,1,1,"dummy"
"18506",0,0,1,1,"dummy"
"18507",0,1,0,1,"dummy"
"18508",0,0,1,1,"dummy"
"18509",1,0,0,1,"dummy"
"18510",0,0,1,1,"dummy"
"18527",0,0,0,0,"dummy"
"18529",0,23,0,23,"dummy"
"18530",0,2,1,3,"dummy"
"18531",0,0,1,1,"dummy"
"18532",4,4,4,12,"dummy"
"18533",0,0,0,0,"dummy"
"18534",0,1,0,1,"dummy"
"18535",4,3,2,9,"dummy"
"18538",0,2,4,6,"dummy"
"18539",0,0,1,1,"dummy"
"18540",0,0,2,2,"dummy"
"18541",0,2,0,2,"dummy"
"18542",6,4,3,13,"dummy"
"18543",2,2,2,6,"dummy"
"18545",0,3,1,4,"dummy"
"18548",0,1,0,1,"dummy"
"18549",0,2,0,2,"dummy"
"18555",0,0,1,1,"dummy"
"18556",0,0,1,1,"dummy"
"18557",0,0,2,2,"dummy"
"18558",0,0,1,1,"dummy"
"18559",0,0,2,2,"dummy"
"18560",1,3,1,5,"dummy"
"18561",2,1,0,3,"dummy"
"18565",0,1,0,1,"dummy"
"18566",10,0,1,11,"dummy"
"18567",5,1,1,7,"dummy"
"18568",0,2,0,2,"dummy"
"18569",2,0,0,2,"dummy"
"18571",6,0,0,6,"dummy"
"18572",2,5,2,9,"dummy"
"18574",0,0,0,0,"dummy"
"18575",1,0,0,1,"dummy"
"18578",0,1,0,1,"dummy"
"18580",1,3,0,4,"dummy"
"18581",0,0,0,0,"dummy"
"18583",0,0,1,1,"dummy"
"18584",2,0,0,2,"dummy"
"18585",3,9,5,17,"dummy"
"18586",7,0,1,8,"dummy"
"18587",1,3,0,4,"dummy"
"18588",2,3,0,5,"dummy"
"18589",0,0,1,1,"dummy"
"18590",0,3,1,4,"dummy"
"18591",3,0,2,5,"dummy"
"18592",1,2,0,3,"dummy"
"18593",0,4,1,5,"dummy"
"18594",0,0,1,1,"dummy"
"18595",9,1,2,12,"dummy"
"18596",0,2,0,2,"dummy"
"18597",0,2,0,2,"dummy"
"18598",0,2,0,2,"dummy"
"18599",0,4,0,4,"dummy"
"18600",2,0,0,2,"dummy"
"18601",0,0,2,2,"dummy"
"18602",0,2,0,2,"dummy"
"18603",0,0,1,1,"dummy"
"18604",0,11,0,11,"dummy"
"18605",0,1,0,1,"dummy"
"18606",11,0,0,11,"dummy"
"18607",0,10,0,10,"dummy"
"18608",0,1,0,1,"dummy"
"18609",1,0,0,1,"dummy"
"18610",0,0,1,1,"dummy"
"18611",0,0,1,1,"dummy"
"18612",0,0,1,1,"dummy"
"18613",0,5,0,5,"dummy"
"18614",0,1,0,1,"dummy"
"18615",6,13,1,20,"dummy"
"18616",0,2,0,2,"dummy"
"18617",4,8,0,12,"dummy"
"18618",23,8,2,33,"dummy"
"18619",0,1,0,1,"dummy"
"18620",1,4,0,5,"dummy"
"18621",4,1,0,5,"dummy"
"18622",1,4,0,5,"dummy"
"18623",0,0,1,1,"dummy"
"18624",0,1,0,1,"dummy"
"18625",0,1,0,1,"dummy"
"18626",0,0,0,0,"dummy"
"18627",0,1,1,2,"dummy"
"18628",0,0,1,1,"dummy"
"18629",0,0,1,1,"dummy"
"18630",0,0,1,1,"dummy"
"18631",0,0,1,1,"dummy"
"18632",0,0,1,1,"dummy"
"18633",1,0,1,2,"dummy"
"18634",0,4,0,4,"dummy"
"18635",0,0,0,0,"dummy"
"18636",0,0,2,2,"dummy"
"18637",0,1,0,1,"dummy"
"18638",0,0,0,0,"dummy"
"18639",0,2,0,2,"dummy"
"18642",2,2,0,4,"dummy"
"18643",0,0,1,1,"dummy"
"18645",1,3,1,5,"dummy"
"18647",2,0,0,2,"dummy"
"18650",0,1,0,1,"dummy"
"18651",0,0,1,1,"dummy"
"18652",0,0,0,0,"dummy"
"18653",0,0,1,1,"dummy"
"18654",1,0,0,1,"dummy"
"18655",0,0,1,1,"dummy"
"18658",2,1,0,3,"dummy"
"18659",11,6,1,18,"dummy"
"18660",0,1,1,2,"dummy"
"18664",5,24,1,30,"dummy"
"18665",0,0,2,2,"dummy"
"18666",0,3,0,3,"dummy"
"18667",12,6,1,19,"dummy"
"18678",0,0,1,1,"dummy"
"18680",0,0,2,2,"dummy"
"18681",0,0,1,1,"dummy"
"18682",0,0,1,1,"dummy"
"18683",0,0,1,1,"dummy"
"18684",0,0,1,1,"dummy"
"18685",1,0,1,2,"dummy"
"18686",0,0,1,1,"dummy"
"18687",0,0,2,2,"dummy"
"18688",0,0,1,1,"dummy"
"18689",0,1,3,4,"dummy"
"18690",0,0,1,1,"dummy"
"18691",0,0,1,1,"dummy"
"18692",0,0,1,1,"dummy"
"18693",0,0,1,1,"dummy"
"18694",0,0,1,1,"dummy"
"18695",0,0,1,1,"dummy"
"18696",0,0,1,1,"dummy"
"18697",0,0,1,1,"dummy"
"18698",0,0,1,1,"dummy"
"18699",0,0,1,1,"dummy"
"18700",0,0,1,1,"dummy"
"18701",0,0,1,1,"dummy"
"18702",0,0,1,1,"dummy"
"18703",0,0,1,1,"dummy"
"18704",0,0,1,1,"dummy"
"18705",0,0,1,1,"dummy"
"18706",0,0,1,1,"dummy"
"18707",0,0,1,1,"dummy"
"18708",0,0,1,1,"dummy"
"18709",0,0,1,1,"dummy"
"18710",0,0,1,1,"dummy"
"18711",0,0,1,1,"dummy"
"18712",0,0,1,1,"dummy"
"18713",0,0,1,1,"dummy"
"18714",0,0,1,1,"dummy"
"18715",0,0,1,1,"dummy"
"18716",0,0,1,1,"dummy"
"18717",0,0,1,1,"dummy"
"18718",0,0,1,1,"dummy"
"18719",0,0,1,1,"dummy"
"18720",0,0,1,1,"dummy"
"18721",0,0,1,1,"dummy"
"18722",0,0,1,1,"dummy"
"18723",0,0,1,1,"dummy"
"18724",0,0,1,1,"dummy"
"18725",0,0,1,1,"dummy"
"18726",0,0,1,1,"dummy"
"18727",0,0,1,1,"dummy"
"18728",0,0,1,1,"dummy"
"18729",0,0,1,1,"dummy"
"18730",0,0,1,1,"dummy"
"18732",0,1,0,1,"dummy"
"18734",0,1,1,2,"dummy"
"18735",0,0,1,1,"dummy"
"18736",0,0,2,2,"dummy"
"18737",0,0,1,1,"dummy"
"18739",1,0,0,1,"dummy"
"18740",2,1,1,4,"dummy"
"18741",0,1,2,3,"dummy"
"18742",0,0,1,1,"dummy"
"18743",0,0,1,1,"dummy"
"18744",0,0,1,1,"dummy"
"18745",0,1,0,1,"dummy"
"18746",0,0,1,1,"dummy"
"18749",0,1,0,1,"dummy"
"18753",0,3,0,3,"dummy"
"18755",0,0,1,1,"dummy"
"18757",0,2,0,2,"dummy"
"18758",1,2,1,4,"dummy"
"18759",0,2,0,2,"dummy"
"18760",0,2,0,2,"dummy"
"18761",1,7,0,8,"dummy"
"18762",0,1,0,1,"dummy"
"18763",2,1,0,3,"dummy"
"18764",0,4,0,4,"dummy"
"18765",3,1,0,4,"dummy"
"18766",1,1,0,2,"dummy"
"18767",7,2,3,12,"dummy"
"18772",0,0,3,3,"dummy"
"18774",2,4,0,6,"dummy"
"18775",0,2,0,2,"dummy"
"18776",0,2,0,2,"dummy"
"18777",10,2,0,12,"dummy"
"18778",0,2,0,2,"dummy"
"18779",0,0,0,0,"dummy"
"18781",2,1,1,4,"dummy"
"18782",2,3,0,5,"dummy"
"18783",0,0,3,3,"dummy"
"18784",5,0,0,5,"dummy"
"18785",0,0,3,3,"dummy"
"18787",0,6,0,6,"dummy"
"18788",2,4,0,6,"dummy"
"18790",2,2,0,4,"dummy"
"18792",1,0,1,2,"dummy"
"18793",5,6,0,11,"dummy"
"18794",0,0,1,1,"dummy"
"18799",1,0,0,1,"dummy"
"18800",0,1,0,1,"dummy"
"18801",19,1,0,20,"dummy"
"18802",0,4,0,4,"dummy"
"18803",19,16,1,36,"dummy"
"18804",16,16,3,35,"dummy"
"18805",1,3,0,4,"dummy"
"18807",0,1,0,1,"dummy"
"18808",0,0,1,1,"dummy"
"18812",0,0,2,2,"dummy"
"18814",0,1,0,1,"dummy"
"18815",0,2,0,2,"dummy"
"18816",0,0,0,0,"dummy"
"18817",0,0,0,0,"dummy"
"18818",1,1,0,2,"dummy"
"18819",0,1,0,1,"dummy"
"18820",2,2,0,4,"dummy"
"18823",0,1,0,1,"dummy"
"18824",1,1,0,2,"dummy"
"18825",0,0,2,2,"dummy"
"18827",4,2,0,6,"dummy"
"18828",0,0,0,0,"dummy"
"18829",0,4,0,4,"dummy"
"18830",8,0,0,8,"dummy"
"18831",0,0,0,0,"dummy"
"18832",0,0,0,0,"dummy"
"18839",0,0,0,0,"dummy"
"18841",1,0,1,2,"dummy"
"18842",0,3,1,4,"dummy"
"18843",3,1,1,5,"dummy"
"18844",0,2,0,2,"dummy"
"18845",0,1,1,2,"dummy"
"18846",0,2,0,2,"dummy"
"18847",0,13,0,13,"dummy"
"18848",0,0,3,3,"dummy"
"18849",2,1,2,5,"dummy"
"18850",1,0,1,2,"dummy"
"18851",0,1,1,2,"dummy"
"18852",0,18,0,18,"dummy"
"18853",0,0,1,1,"dummy"
"18854",0,1,0,1,"dummy"
"18855",0,0,1,1,"dummy"
"18856",1,0,1,2,"dummy"
"18857",0,1,1,2,"dummy"
"18858",1,0,1,2,"dummy"
"18859",0,1,1,2,"dummy"
"18861",0,0,0,0,"dummy"
"18862",0,0,0,0,"dummy"
"18865",1,2,3,6,"dummy"
"18866",0,0,1,1,"dummy"
"18867",0,2,0,2,"dummy"
"18868",8,5,1,14,"dummy"
"18870",9,0,1,10,"dummy"
"18875",0,0,0,0,"dummy"
"18876",1,0,1,2,"dummy"
"18881",0,0,1,1,"dummy"
"18886",0,5,0,5,"dummy"
"18887",0,0,0,0,"dummy"
"18888",1,7,1,9,"dummy"
"18891",2,0,3,5,"dummy"
"18892",1,0,0,1,"dummy"
"18893",0,1,0,1,"dummy"
"18894",0,1,1,2,"dummy"
"18896",0,0,0,0,"dummy"
"18897",0,1,0,1,"dummy"
"18898",0,0,0,0,"dummy"
"18900",0,1,0,1,"dummy"
"18901",0,0,1,1,"dummy"
"18903",0,0,2,2,"dummy"
"18904",0,5,0,5,"dummy"
"18905",3,2,0,5,"dummy"
"18906",3,0,0,3,"dummy"
"18908",1,0,1,2,"dummy"
"18909",4,1,2,7,"dummy"
"18911",0,2,0,2,"dummy"
"18912",2,0,0,2,"dummy"
"18913",4,2,0,6,"dummy"
"18914",0,0,1,1,"dummy"
"18915",0,0,1,1,"dummy"
"18916",0,0,1,1,"dummy"
"18917",4,1,1,6,"dummy"
"18918",0,0,1,1,"dummy"
"18919",0,0,1,1,"dummy"
"18920",0,0,1,1,"dummy"
"18921",0,0,1,1,"dummy"
"18922",0,0,1,1,"dummy"
"18923",0,0,1,1,"dummy"
"18947",0,1,1,2,"dummy"
"18950",6,0,0,6,"dummy"
"18951",2,5,2,9,"dummy"
"18954",2,2,1,5,"dummy"
"18955",3,8,0,11,"dummy"
"18956",2,4,0,6,"dummy"
"18957",0,2,0,2,"dummy"
"18958",8,3,1,12,"dummy"
"18959",0,2,0,2,"dummy"
"18960",2,3,2,7,"dummy"
"18961",10,14,1,25,"dummy"
"18962",2,2,0,4,"dummy"
"18963",36,13,3,52,"dummy"
"18964",0,2,0,2,"dummy"
"18965",5,11,1,17,"dummy"
"18966",0,2,0,2,"dummy"
"18967",1,3,1,5,"dummy"
"18968",8,3,1,12,"dummy"
"18970",0,4,0,4,"dummy"
"18971",0,0,1,1,"dummy"
"18972",0,0,1,1,"dummy"
"18976",0,1,0,1,"dummy"
"18977",1,0,0,1,"dummy"
"18979",0,1,0,1,"dummy"
"18981",2,4,0,6,"dummy"
"18982",0,1,0,1,"dummy"
"18983",0,0,1,1,"dummy"
"18984",0,4,1,5,"dummy"
"18985",1,1,1,3,"dummy"
"18986",0,0,1,1,"dummy"
"18987",4,4,2,10,"dummy"
"18988",0,3,0,3,"dummy"
"18989",0,1,0,1,"dummy"
"18993",0,1,0,1,"dummy"
"18994",0,0,1,1,"dummy"
"18999",0,0,1,1,"dummy"
"19000",1,7,0,8,"dummy"
"19003",0,1,0,1,"dummy"
"19016",4,2,1,7,"dummy"
"19020",0,2,0,2,"dummy"
"19021",0,0,1,1,"dummy"
"19022",0,0,1,1,"dummy"
"19023",0,0,1,1,"dummy"
"19024",4,0,0,4,"dummy"
"19025",4,3,0,7,"dummy"
"19026",0,2,0,2,"dummy"
"19027",1,1,0,2,"dummy"
"19028",0,0,0,0,"dummy"
"19029",0,0,1,1,"dummy"
"19030",0,0,0,0,"dummy"
"19031",0,0,1,1,"dummy"
"19032",0,0,0,0,"dummy"
"19033",0,0,1,1,"dummy"
"19034",0,0,0,0,"dummy"
"19035",1,2,0,3,"dummy"
"19036",0,0,1,1,"dummy"
"19037",0,0,1,1,"dummy"
"19038",0,0,1,1,"dummy"
"19039",0,0,0,0,"dummy"
"19040",0,0,1,1,"dummy"
"19041",0,0,1,1,"dummy"
"19042",0,0,1,1,"dummy"
"19043",0,0,1,1,"dummy"
"19044",0,0,0,0,"dummy"
"19045",0,0,0,0,"dummy"
"19046",1,10,0,11,"dummy"
"19047",0,0,1,1,"dummy"
"19048",9,1,0,10,"dummy"
"19049",0,0,1,1,"dummy"
"19050",0,0,1,1,"dummy"
"19051",0,0,1,1,"dummy"
"19052",0,0,0,0,"dummy"
"19053",0,0,0,0,"dummy"
"19054",0,0,1,1,"dummy"
"19055",0,0,1,1,"dummy"
"19056",0,0,0,0,"dummy"
"19057",0,0,0,0,"dummy"
"19058",0,0,0,0,"dummy"
"19059",0,0,0,0,"dummy"
"19060",0,0,0,0,"dummy"
"19061",0,0,0,0,"dummy"
"19062",1,0,0,1,"dummy"
"19063",0,1,0,1,"dummy"
"19064",0,0,0,0,"dummy"
"19065",8,11,1,20,"dummy"
"19066",0,0,1,1,"dummy"
"19067",0,0,1,1,"dummy"
"19068",0,0,1,1,"dummy"
"19071",0,1,0,1,"dummy"
"19072",1,0,1,2,"dummy"
"19073",2,1,6,9,"dummy"
"19074",13,5,2,20,"dummy"
"19075",5,13,2,20,"dummy"
"19078",5,4,0,9,"dummy"
"19079",7,1,1,9,"dummy"
"19080",0,1,0,1,"dummy"
"19081",0,6,1,7,"dummy"
"19082",0,4,1,5,"dummy"
"19083",7,5,2,14,"dummy"
"19087",0,2,0,2,"dummy"
"19088",0,5,1,6,"dummy"
"19089",0,0,2,2,"dummy"
"19093",0,0,0,0,"dummy"
"19096",0,0,1,1,"dummy"
"19097",0,0,1,1,"dummy"
"19099",0,1,0,1,"dummy"
"19100",0,3,0,3,"dummy"
"19110",2,2,4,8,"dummy"
"19111",7,5,5,17,"dummy"
"19113",0,2,2,4,"dummy"
"19114",0,1,0,1,"dummy"
"19115",0,0,3,3,"dummy"
"19116",6,4,1,11,"dummy"
"19117",1,0,2,3,"dummy"
"19120",0,2,0,2,"dummy"
"19121",0,2,0,2,"dummy"
"19122",3,1,2,6,"dummy"
"19130",0,0,1,1,"dummy"
"19131",0,0,1,1,"dummy"
"19132",1,0,0,1,"dummy"
"19134",0,6,0,6,"dummy"
"19135",0,5,0,5,"dummy"
"19136",0,3,0,3,"dummy"
"19137",0,1,0,1,"dummy"
"19138",0,1,0,1,"dummy"
"19139",3,4,1,8,"dummy"
"19140",0,5,0,5,"dummy"
"19141",0,0,2,2,"dummy"
"19142",0,1,0,1,"dummy"
"19146",0,1,0,1,"dummy"
"19151",0,0,1,1,"dummy"
"19152",0,0,1,1,"dummy"
"19154",0,2,0,2,"dummy"
"19155",5,5,0,10,"dummy"
"19156",4,1,2,7,"dummy"
"19160",1,0,0,1,"dummy"
"19161",0,2,0,2,"dummy"
"19162",0,0,3,3,"dummy"
"19163",4,8,0,12,"dummy"
"19164",12,8,4,24,"dummy"
"19165",35,18,5,58,"dummy"
"19166",1,6,0,7,"dummy"
"19167",2,6,0,8,"dummy"
"19168",17,20,0,37,"dummy"
"19169",12,7,0,19,"dummy"
"19170",0,1,0,1,"dummy"
"19171",0,3,1,4,"dummy"
"19172",0,1,0,1,"dummy"
"19173",3,0,0,3,"dummy"
"19174",0,0,3,3,"dummy"
"19175",1,9,0,10,"dummy"
"19176",0,7,0,7,"dummy"
"19177",2,0,0,2,"dummy"
"19178",7,1,0,8,"dummy"
"19179",1,1,0,2,"dummy"
"19180",0,2,0,2,"dummy"
"19181",0,3,0,3,"dummy"
"19182",0,3,0,3,"dummy"
"19183",0,4,0,4,"dummy"
"19184",0,1,0,1,"dummy"
"19185",0,1,0,1,"dummy"
"19186",5,5,0,10,"dummy"
"19187",4,0,1,5,"dummy"
"19188",0,0,0,0,"dummy"
"19189",0,6,0,6,"dummy"
"19190",1,0,0,1,"dummy"
"19191",1,0,1,2,"dummy"
"19192",1,2,0,3,"dummy"
"19193",0,0,0,0,"dummy"
"19194",0,0,1,1,"dummy"
"19195",0,0,1,1,"dummy"
"19196",0,0,1,1,"dummy"
"19197",0,0,0,0,"dummy"
"19198",0,2,0,2,"dummy"
"19199",0,0,1,1,"dummy"
"19200",0,4,0,4,"dummy"
"19201",1,0,1,2,"dummy"
"19204",0,0,1,1,"dummy"
"19205",0,2,0,2,"dummy"
"19206",0,0,1,1,"dummy"
"19207",0,1,0,1,"dummy"
"19208",0,0,0,0,"dummy"
"19209",0,0,1,1,"dummy"
"19210",0,0,0,0,"dummy"
"19213",4,0,2,6,"dummy"
"19216",0,0,0,0,"dummy"
"19217",1,2,1,4,"dummy"
"19295",0,0,0,0,"dummy"
"19296",0,0,1,1,"dummy"
"19311",0,1,1,2,"dummy"
"19312",0,0,1,1,"dummy"
"19313",0,0,1,1,"dummy"
"19314",0,4,0,4,"dummy"
"19315",2,2,0,4,"dummy"
"19316",0,1,0,1,"dummy"
"19317",1,2,2,5,"dummy"
"19318",0,17,3,20,"dummy"
"19319",0,0,0,0,"dummy"
"19320",0,2,0,2,"dummy"
"19321",5,3,0,8,"dummy"
"19322",1,1,0,2,"dummy"
"19323",5,5,0,10,"dummy"
"19333",0,0,2,2,"dummy"
"19334",0,1,3,4,"dummy"
"19335",0,0,1,1,"dummy"
"19336",0,0,1,1,"dummy"
"19337",7,6,3,16,"dummy"
"19338",7,7,4,18,"dummy"
"19339",2,2,1,5,"dummy"
"19340",4,3,0,7,"dummy"
"19341",0,0,1,1,"dummy"
"19342",13,12,2,27,"dummy"
"19343",0,0,0,0,"dummy"
"19344",4,3,3,10,"dummy"
"19345",0,0,1,1,"dummy"
"19346",0,0,1,1,"dummy"
"19347",0,0,0,0,"dummy"
"19357",0,0,0,0,"dummy"
"19358",0,0,2,2,"dummy"
"19359",33,19,2,54,"dummy"
"19360",5,0,0,5,"dummy"
"19361",0,2,0,2,"dummy"
"19365",0,1,2,3,"dummy"
"19366",2,0,0,2,"dummy"
"19372",0,3,0,3,"dummy"
"19373",1,1,0,2,"dummy"
"19377",8,0,0,8,"dummy"
"19378",1,0,0,1,"dummy"
"19379",0,1,0,1,"dummy"
"19380",0,0,0,0,"dummy"
"19381",1,2,0,3,"dummy"
"19384",0,0,1,1,"dummy"
"19395",9,3,0,12,"dummy"
"19396",0,2,0,2,"dummy"
"19397",0,1,0,1,"dummy"
"19398",0,7,2,9,"dummy"
"19399",2,0,0,2,"dummy"
"19400",0,1,0,1,"dummy"
"19403",2,0,2,4,"dummy"
"19273",0,1,0,1,"dummy"
"19274",0,2,0,2,"dummy"
"19275",0,1,1,2,"dummy"
"19276",0,4,0,4,"dummy"
"19277",14,3,5,22,"dummy"
"19278",1,1,2,4,"dummy"
"19279",0,0,0,0,"dummy"
"19280",0,0,1,1,"dummy"
"19281",0,2,0,2,"dummy"
"19282",1,1,2,4,"dummy"
"19283",0,2,0,2,"dummy"
"19284",0,0,1,1,"dummy"
"19285",1,2,0,3,"dummy"
"19286",0,0,3,3,"dummy"
"19287",1,1,8,10,"dummy"
"19288",0,0,2,2,"dummy"
"19289",0,1,3,4,"dummy"
"19298",0,4,3,7,"dummy"
"19303",3,33,0,36,"dummy"
"19304",1,0,0,1,"dummy"
"19305",0,1,0,1,"dummy"
"19306",26,4,2,32,"dummy"
"19307",0,0,1,1,"dummy"
"19308",1,1,0,2,"dummy"
"19309",0,1,0,1,"dummy"
"19325",0,4,0,4,"dummy"
"19326",2,2,0,4,"dummy"
"19327",4,5,0,9,"dummy"
"19328",10,7,0,17,"dummy"
"19329",27,3,2,32,"dummy"
"19330",0,0,0,0,"dummy"
"19331",0,0,0,0,"dummy"
"19349",0,2,4,6,"dummy"
"19350",0,0,1,1,"dummy"
"19351",0,0,2,2,"dummy"
"19352",0,2,0,2,"dummy"
"19353",1,4,1,6,"dummy"
"19354",0,5,0,5,"dummy"
"19355",5,2,0,7,"dummy"
"19363",1,9,0,10,"dummy"
"19368",7,0,0,7,"dummy"
"19369",2,0,0,2,"dummy"
"19370",0,4,0,4,"dummy"
"19375",0,0,1,1,"dummy"
"19386",0,1,0,1,"dummy"
"19387",0,0,0,0,"dummy"
"19388",2,0,0,2,"dummy"
"19389",3,0,0,3,"dummy"
"19390",0,0,0,0,"dummy"
"19391",0,0,1,1,"dummy"
"19392",0,0,1,1,"dummy"
"19393",1,0,0,1,"dummy"
"19405",4,13,0,17,"dummy"
"19406",3,0,0,3,"dummy"
"19407",2,1,1,4,"dummy"
"19408",0,1,1,2,"dummy"
"19409",0,0,0,0,"dummy"
"19410",0,2,3,5,"dummy"
"19411",0,0,0,0,"dummy"
"19412",0,1,0,1,"dummy"
"19421",1,19,5,25,"dummy"
"19428",1,1,0,2,"dummy"
"19439",2,0,0,2,"dummy"
"19440",0,0,1,1,"dummy"
"19441",0,1,0,1,"dummy"
"19464",0,1,0,1,"dummy"
"19480",5,18,3,26,"dummy"
"19497",8,5,4,17,"dummy"
"19532",0,0,1,1,"dummy"
"19535",0,0,1,1,"dummy"
"19536",0,1,0,1,"dummy"
"19539",1,9,2,12,"dummy"
"19540",0,3,0,3,"dummy"
"19550",0,1,0,1,"dummy"
"19553",6,0,0,6,"dummy"
"19554",2,5,2,9,"dummy"
"19574",8,0,3,11,"dummy"
"19581",0,0,1,1,"dummy"
"19582",0,0,0,0,"dummy"
"19637",0,3,0,3,"dummy"
"19638",1,0,1,2,"dummy"
"19639",2,6,0,8,"dummy"
"19640",0,1,0,1,"dummy"
"19641",14,19,0,33,"dummy"
"19642",2,1,1,4,"dummy"
"19643",11,20,3,34,"dummy"
"19644",0,0,0,0,"dummy"
"19645",0,0,1,1,"dummy"
"19646",0,1,1,2,"dummy"
"19647",0,0,1,1,"dummy"
"19648",5,2,0,7,"dummy"
"19649",2,4,0,6,"dummy"
"19650",0,1,0,1,"dummy"
"19651",0,0,1,1,"dummy"
"19652",0,0,1,1,"dummy"
"19653",0,0,1,1,"dummy"
"19654",0,0,0,0,"dummy"
"19655",0,1,0,1,"dummy"
"19656",0,8,0,8,"dummy"
"19657",1,2,0,3,"dummy"
"19658",1,0,0,1,"dummy"
"19659",3,0,0,3,"dummy"
"19660",2,0,0,2,"dummy"
"19661",0,1,0,1,"dummy"
"19662",0,1,0,1,"dummy"
"19663",0,0,1,1,"dummy"
"19432",0,4,0,4,"dummy"
"19433",1,5,0,6,"dummy"
"19434",2,2,0,4,"dummy"
"19435",0,1,0,1,"dummy"
"19443",0,0,1,1,"dummy"
"19444",9,2,1,12,"dummy"
"19445",0,1,1,2,"dummy"
"19446",1,5,2,8,"dummy"
"19447",5,4,0,9,"dummy"
"19448",0,0,1,1,"dummy"
"19449",3,1,0,4,"dummy"
"19450",0,0,0,0,"dummy"
"19451",0,1,0,1,"dummy"
"19452",0,1,0,1,"dummy"
"19453",0,0,1,1,"dummy"
"19454",0,0,0,0,"dummy"
"19455",5,11,0,16,"dummy"
"19460",2,3,0,5,"dummy"
"19461",0,0,1,1,"dummy"
"19462",6,1,0,7,"dummy"
"19468",1,2,1,4,"dummy"
"19473",41,13,3,57,"dummy"
"19474",0,1,0,1,"dummy"
"19475",0,2,0,2,"dummy"
"19476",0,1,0,1,"dummy"
"19482",4,4,0,8,"dummy"
"19483",0,1,0,1,"dummy"
"19484",2,2,2,6,"dummy"
"19485",0,0,2,2,"dummy"
"19486",0,0,2,2,"dummy"
"19489",0,1,0,1,"dummy"
"19494",4,4,4,12,"dummy"
"19495",0,1,0,1,"dummy"
"19504",2,2,2,6,"dummy"
"19505",0,0,3,3,"dummy"
"19506",1,0,0,1,"dummy"
"19507",3,1,0,4,"dummy"
"19508",0,2,1,3,"dummy"
"19509",0,2,1,3,"dummy"
"19510",1,0,0,1,"dummy"
"19511",0,0,1,1,"dummy"
"19512",0,0,1,1,"dummy"
"19513",0,0,0,0,"dummy"
"19518",14,34,4,52,"dummy"
"19521",2,2,4,8,"dummy"
"19522",3,3,0,6,"dummy"
"19523",0,0,1,1,"dummy"
"19546",1,1,5,7,"dummy"
"19547",2,1,1,4,"dummy"
"19548",0,0,1,1,"dummy"
"19558",0,1,0,1,"dummy"
"19559",0,0,7,7,"dummy"
"19562",0,0,1,1,"dummy"
"19563",1,3,1,5,"dummy"
"19564",39,5,0,44,"dummy"
"19565",0,0,2,2,"dummy"
"19566",0,0,1,1,"dummy"
"19567",0,0,2,2,"dummy"
"19568",1,2,0,3,"dummy"
"19569",7,8,5,20,"dummy"
"19570",4,7,1,12,"dummy"
"19571",2,3,2,7,"dummy"
"19572",0,0,1,1,"dummy"
"19576",0,0,3,3,"dummy"
"19577",0,2,0,2,"dummy"
"19578",6,1,4,11,"dummy"
"19579",0,0,1,1,"dummy"
"19668",2,2,1,5,"dummy"
"19669",2,2,1,5,"dummy"
"19670",0,0,1,1,"dummy"
"19671",2,2,1,5,"dummy"
"19672",2,2,1,5,"dummy"
"19673",2,2,1,5,"dummy"
"19674",2,2,1,5,"dummy"
"19680",0,0,0,0,"dummy"
"19682",0,0,1,1,"dummy"
"19683",0,0,0,0,"dummy"
"19687",0,0,1,1,"dummy"
"19688",0,0,0,0,"dummy"
"19689",0,0,0,0,"dummy"
"19693",0,0,0,0,"dummy"
"19694",0,3,1,4,"dummy"
"19695",0,1,0,1,"dummy"
"19719",0,0,1,1,"dummy"
"19720",0,0,0,0,"dummy"
"19721",0,0,2,2,"dummy"
"19726",0,1,0,1,"dummy"
"19727",0,0,0,0,"dummy"
"19728",0,0,0,0,"dummy"
"19729",0,0,0,0,"dummy"
"19730",0,0,1,1,"dummy"
"19737",0,0,1,1,"dummy"
"19738",0,0,1,1,"dummy"
"19740",0,0,1,1,"dummy"
"19741",1,1,2,4,"dummy"
"19743",18,1,0,19,"dummy"
"19744",0,0,1,1,"dummy"
"19747",1,3,4,8,"dummy"
"19748",0,1,1,2,"dummy"
"19749",0,2,1,3,"dummy"
"19750",0,0,1,1,"dummy"
"19751",0,1,0,1,"dummy"
"19754",0,0,3,3,"dummy"
"19755",11,12,1,24,"dummy"
"19757",0,1,1,2,"dummy"
"19766",0,0,0,0,"dummy"
"19767",2,1,2,5,"dummy"
"19768",0,0,1,1,"dummy"
"19769",0,1,0,1,"dummy"
"19770",21,6,3,30,"dummy"
"19771",0,7,3,10,"dummy"
"19772",0,5,0,5,"dummy"
"19773",0,1,0,1,"dummy"
"19774",1,1,0,2,"dummy"
"19775",0,1,0,1,"dummy"
"19776",0,0,1,1,"dummy"
"19777",0,2,0,2,"dummy"
"19778",4,4,2,10,"dummy"
"19779",0,2,0,2,"dummy"
"19780",0,1,0,1,"dummy"
"19781",0,3,1,4,"dummy"
"19782",0,0,1,1,"dummy"
"19783",24,14,1,39,"dummy"
"19784",0,0,0,0,"dummy"
"19786",0,0,1,1,"dummy"
"19787",2,2,2,6,"dummy"
"19789",1,0,0,1,"dummy"
"19792",0,1,0,1,"dummy"
"19794",0,0,1,1,"dummy"
"19796",0,1,0,1,"dummy"
"19799",1,3,1,5,"dummy"
"19800",1,2,3,6,"dummy"
"19801",0,0,1,1,"dummy"
"19803",3,1,2,6,"dummy"
"19806",1,2,1,4,"dummy"
"19807",4,24,2,30,"dummy"
"19808",0,1,0,1,"dummy"
"19809",1,2,0,3,"dummy"
"19810",5,5,3,13,"dummy"
"19811",4,6,1,11,"dummy"
"19815",0,0,1,1,"dummy"
"19816",1,0,5,6,"dummy"
"19818",0,0,0,0,"dummy"
"19819",0,2,0,2,"dummy"
"19820",2,0,0,2,"dummy"
"19822",0,1,0,1,"dummy"
"19827",0,0,1,1,"dummy"
"19828",2,12,2,16,"dummy"
"19832",0,2,0,2,"dummy"
"19835",2,0,0,2,"dummy"
"19836",1,0,1,2,"dummy"
"19837",2,0,0,2,"dummy"
"19838",3,0,0,3,"dummy"
"19839",0,0,0,0,"dummy"
"19840",0,0,0,0,"dummy"
"19841",1,2,0,3,"dummy"
"19845",0,9,2,11,"dummy"
"19847",1,2,0,3,"dummy"
"19848",2,3,0,5,"dummy"
"19851",0,3,0,3,"dummy"
"19852",4,1,0,5,"dummy"
"19853",0,0,1,1,"dummy"
"19864",0,0,2,2,"dummy"
"19865",0,0,0,0,"dummy"
"19869",0,1,2,3,"dummy"
"19870",0,0,0,0,"dummy"
"19871",0,1,0,1,"dummy"
"19872",4,0,2,6,"dummy"
"19873",1,0,0,1,"dummy"
"19874",0,0,0,0,"dummy"
"19875",0,0,0,0,"dummy"
"19877",0,3,2,5,"dummy"
"19879",0,0,1,1,"dummy"
"19880",1,1,2,4,"dummy"
"19881",2,0,0,2,"dummy"
"19882",2,6,1,9,"dummy"
"19883",0,1,0,1,"dummy"
"19884",0,1,1,2,"dummy"
"19949",0,0,1,1,"dummy"
"19952",0,0,1,1,"dummy"
"19953",0,0,2,2,"dummy"
"19954",0,0,1,1,"dummy"
"19955",2,1,0,3,"dummy"
"19957",6,3,5,14,"dummy"
"19958",0,0,2,2,"dummy"
"19961",2,0,0,2,"dummy"
"19962",0,2,0,2,"dummy"
"19963",1,3,0,4,"dummy"
"19964",3,1,0,4,"dummy"
"19965",0,0,1,1,"dummy"
"19966",1,1,0,2,"dummy"
"19967",1,1,0,2,"dummy"
"19968",2,1,0,3,"dummy"
"19969",1,6,0,7,"dummy"
"19970",5,1,0,6,"dummy"
"19971",0,0,0,0,"dummy"
"19972",1,5,1,7,"dummy"
"19973",5,1,1,7,"dummy"
"19974",1,5,1,7,"dummy"
"19975",0,0,2,2,"dummy"
"19981",0,2,0,2,"dummy"
"19983",0,1,0,1,"dummy"
"19984",0,2,0,2,"dummy"
"19985",0,0,0,0,"dummy"
"19986",0,0,1,1,"dummy"
"19987",0,3,0,3,"dummy"
"19988",0,1,0,1,"dummy"
"19989",1,1,2,4,"dummy"
"19990",0,2,0,2,"dummy"
"19991",0,1,0,1,"dummy"
"19992",0,2,0,2,"dummy"
"19994",0,0,1,1,"dummy"
"19996",0,24,2,26,"dummy"
"19997",0,2,1,3,"dummy"
"19998",0,0,1,1,"dummy"
"19999",17,55,10,82,"dummy"
"20000",1,0,8,9,"dummy"
"20001",5,3,6,14,"dummy"
"20002",0,1,1,2,"dummy"
"20003",1,1,1,3,"dummy"
"20005",1,0,0,1,"dummy"
"20006",0,0,1,1,"dummy"
"20008",0,2,1,3,"dummy"
"20009",0,5,0,5,"dummy"
"20010",2,1,0,3,"dummy"
"20011",0,4,0,4,"dummy"
"20012",0,0,2,2,"dummy"
"20013",0,0,2,2,"dummy"
"20014",4,0,1,5,"dummy"
"20015",0,1,2,3,"dummy"
"20016",9,6,0,15,"dummy"
"20017",0,0,1,1,"dummy"
"20018",0,0,1,1,"dummy"
"20019",0,0,1,1,"dummy"
"20020",0,2,0,2,"dummy"
"20021",2,1,0,3,"dummy"
"20022",2,2,0,4,"dummy"
"20023",1,0,0,1,"dummy"
"20024",1,0,0,1,"dummy"
"20025",0,1,0,1,"dummy"
"20026",7,10,1,18,"dummy"
"20027",3,4,1,8,"dummy"
"20028",0,0,1,1,"dummy"
"20029",2,1,0,3,"dummy"
"20030",8,1,6,15,"dummy"
"20032",0,1,0,1,"dummy"
"20033",1,3,0,4,"dummy"
"20034",1,1,0,2,"dummy"
"20035",0,0,3,3,"dummy"
"20038",0,0,1,1,"dummy"
"20045",0,0,2,2,"dummy"
"20047",0,1,0,1,"dummy"
"20048",0,1,0,1,"dummy"
"20049",0,1,0,1,"dummy"
"20050",0,6,1,7,"dummy"
"20053",0,0,0,0,"dummy"
"20054",0,0,0,0,"dummy"
"20057",2,2,1,5,"dummy"
"20058",0,0,1,1,"dummy"
"20059",0,0,2,2,"dummy"
"20060",1,5,4,10,"dummy"
"20062",1,0,1,2,"dummy"
"20063",0,1,0,1,"dummy"
"20064",0,0,1,1,"dummy"
"20065",6,1,1,8,"dummy"
"20068",1,0,0,1,"dummy"
"20069",0,1,0,1,"dummy"
"20073",0,0,1,1,"dummy"
"20074",2,3,3,8,"dummy"
"20075",0,0,1,1,"dummy"
"20076",0,0,1,1,"dummy"
"20077",0,0,1,1,"dummy"
"20078",0,0,1,1,"dummy"
"20079",0,0,1,1,"dummy"
"20080",0,0,1,1,"dummy"
"20081",0,0,1,1,"dummy"
"20082",0,0,1,1,"dummy"
"20083",0,0,1,1,"dummy"
"20086",0,0,1,1,"dummy"
"20089",3,1,0,4,"dummy"
"20090",1,4,1,6,"dummy"
"20091",0,4,0,4,"dummy"
"20099",0,3,0,3,"dummy"
"20100",0,1,0,1,"dummy"
"20101",1,0,0,1,"dummy"
"20103",12,4,4,20,"dummy"
"20104",2,2,1,5,"dummy"
"20105",5,0,2,7,"dummy"
"20106",0,0,1,1,"dummy"
"20107",0,0,2,2,"dummy"
"20114",0,1,0,1,"dummy"
"20115",1,0,0,1,"dummy"
"20133",0,0,1,1,"dummy"
"20135",2,3,1,6,"dummy"
"20136",0,3,0,3,"dummy"
"20137",0,1,0,1,"dummy"
"20138",5,7,1,13,"dummy"
"20142",0,0,1,1,"dummy"
"20143",0,0,1,1,"dummy"
"20144",0,0,1,1,"dummy"
"20145",3,7,4,14,"dummy"
"20146",0,2,0,2,"dummy"
"20147",1,1,0,2,"dummy"
"20148",2,2,0,4,"dummy"
"20149",0,0,1,1,"dummy"
"20151",0,1,0,1,"dummy"
"20152",0,0,0,0,"dummy"
"20153",1,16,0,17,"dummy"
"20154",0,1,0,1,"dummy"
"20155",1,1,0,2,"dummy"
"20156",0,2,0,2,"dummy"
"20157",0,10,0,10,"dummy"
"20158",1,3,0,4,"dummy"
"20159",0,1,0,1,"dummy"
"20160",0,0,1,1,"dummy"
"20163",1,4,0,5,"dummy"
"20164",0,0,0,0,"dummy"
"20165",1,2,1,4,"dummy"
"20166",0,0,1,1,"dummy"
"20168",0,2,5,7,"dummy"
"20170",0,7,0,7,"dummy"
"20171",1,0,1,2,"dummy"
"20173",0,0,2,2,"dummy"
"20174",4,3,1,8,"dummy"
"20175",0,0,1,1,"dummy"
"20178",1,4,0,5,"dummy"
"20179",0,2,0,2,"dummy"
"20180",0,1,0,1,"dummy"
"20181",1,0,0,1,"dummy"
"20185",10,3,1,14,"dummy"
"20186",3,4,0,7,"dummy"
"20187",1,0,0,1,"dummy"
"20188",4,4,0,8,"dummy"
"20189",3,6,2,11,"dummy"
"20190",0,1,0,1,"dummy"
"20191",0,5,0,5,"dummy"
"20192",1,2,0,3,"dummy"
"20193",0,0,1,1,"dummy"
"20194",7,11,0,18,"dummy"
"20195",1,1,0,2,"dummy"
"20196",0,0,1,1,"dummy"
"20197",0,1,0,1,"dummy"
"20198",0,0,0,0,"dummy"
"20199",1,0,1,2,"dummy"
"20200",0,3,1,4,"dummy"
"20201",8,14,9,31,"dummy"
"20202",0,0,0,0,"dummy"
"20203",1,0,0,1,"dummy"
"20204",0,3,0,3,"dummy"
"20205",1,1,0,2,"dummy"
"20206",1,1,0,2,"dummy"
"20207",3,2,0,5,"dummy"
"20208",4,2,1,7,"dummy"
"20209",0,7,1,8,"dummy"
"20210",5,0,1,6,"dummy"
"20211",0,0,1,1,"dummy"
"20212",0,2,1,3,"dummy"
"20213",0,0,1,1,"dummy"
"20214",0,1,0,1,"dummy"
"20215",0,1,0,1,"dummy"
"20216",0,0,1,1,"dummy"
"20217",0,0,0,0,"dummy"
"20218",0,0,1,1,"dummy"
"20219",0,0,0,0,"dummy"
"20220",3,8,7,18,"dummy"
"20221",15,0,5,20,"dummy"
"20222",1,1,0,2,"dummy"
"20223",3,3,0,6,"dummy"
"20224",0,1,0,1,"dummy"
"20225",1,1,1,3,"dummy"
"20227",12,5,2,19,"dummy"
"20228",1,3,0,4,"dummy"
"20229",0,0,1,1,"dummy"
"20230",2,1,0,3,"dummy"
"20233",0,1,0,1,"dummy"
"20234",0,0,0,0,"dummy"
"20235",1,0,0,1,"dummy"
"20240",0,1,1,2,"dummy"
"20241",0,2,0,2,"dummy"
"20244",0,2,0,2,"dummy"
"20245",0,2,0,2,"dummy"
"20246",2,4,1,7,"dummy"
"20248",0,10,3,13,"dummy"
"20249",3,1,0,4,"dummy"
"20250",0,0,1,1,"dummy"
"20251",0,0,2,2,"dummy"
"20252",0,0,2,2,"dummy"
"20253",0,0,1,1,"dummy"
"20254",3,3,0,6,"dummy"
"20275",0,1,0,1,"dummy"
"20278",1,0,1,2,"dummy"
"20279",0,1,0,1,"dummy"
"20282",2,16,0,18,"dummy"
"20283",0,1,0,1,"dummy"
"20285",0,1,1,2,"dummy"
"20286",1,0,1,2,"dummy"
"20287",9,7,0,16,"dummy"
"20288",0,0,1,1,"dummy"
"20289",2,3,0,5,"dummy"
"20290",2,2,0,4,"dummy"
"20291",0,0,0,0,"dummy"
"20292",0,0,1,1,"dummy"
"20293",1,2,0,3,"dummy"
"20294",0,2,0,2,"dummy"
"20295",2,0,0,2,"dummy"
"20297",0,0,1,1,"dummy"
"20298",0,3,4,7,"dummy"
"20300",0,1,0,1,"dummy"
"20302",0,0,6,6,"dummy"
"20303",15,0,0,15,"dummy"
"20304",0,3,0,3,"dummy"
"20313",1,2,0,3,"dummy"
"20314",9,8,3,20,"dummy"
"20315",2,2,1,5,"dummy"
"20316",1,3,5,9,"dummy"
"20319",0,0,2,2,"dummy"
"20322",1,1,0,2,"dummy"
"20324",0,10,0,10,"dummy"
"20325",0,7,0,7,"dummy"
"20326",3,1,0,4,"dummy"
"20328",5,7,7,19,"dummy"
"20330",0,1,0,1,"dummy"
"20343",0,0,1,1,"dummy"
"20344",0,0,1,1,"dummy"
"20348",0,0,3,3,"dummy"
"20350",0,0,1,1,"dummy"
"20351",0,0,1,1,"dummy"
"20375",0,0,3,3,"dummy"
"20376",0,4,0,4,"dummy"
"20377",16,3,5,24,"dummy"
"20378",0,0,0,0,"dummy"
"20380",0,0,0,0,"dummy"
"20381",0,0,0,0,"dummy"
"20382",0,0,0,0,"dummy"
"20389",0,2,0,2,"dummy"
"20390",0,2,0,2,"dummy"
"20391",0,2,0,2,"dummy"
"20410",0,1,0,1,"dummy"
"20411",0,0,2,2,"dummy"
"20412",0,0,2,2,"dummy"
"20413",1,1,1,3,"dummy"
"20414",0,0,1,1,"dummy"
"20417",0,6,0,6,"dummy"
"20419",0,1,0,1,"dummy"
"20421",0,0,0,0,"dummy"
"20422",0,19,0,19,"dummy"
"20423",0,0,1,1,"dummy"
"20424",2,0,1,3,"dummy"
"20425",1,0,1,2,"dummy"
"20426",1,1,1,3,"dummy"
"20427",5,4,1,10,"dummy"
"20428",0,1,0,1,"dummy"
"20429",0,1,1,2,"dummy"
"20430",0,1,1,2,"dummy"
"20431",14,14,0,28,"dummy"
"20432",0,1,0,1,"dummy"
"20433",4,5,0,9,"dummy"
"20434",0,1,0,1,"dummy"
"20435",0,0,1,1,"dummy"
"20436",0,0,1,1,"dummy"
"20437",1,0,1,2,"dummy"
"20441",0,0,0,0,"dummy"
"20442",0,0,0,0,"dummy"
"20443",0,0,1,1,"dummy"
"20449",4,0,1,5,"dummy"
"20451",0,2,0,2,"dummy"
"20452",1,1,1,3,"dummy"
"20453",0,2,0,2,"dummy"
"20454",0,2,0,2,"dummy"
"20455",0,1,1,2,"dummy"
"20456",0,1,0,1,"dummy"
"20457",0,0,1,1,"dummy"
"20458",2,1,4,7,"dummy"
"20460",0,2,0,2,"dummy"
"20461",3,0,0,3,"dummy"
"20462",0,1,0,1,"dummy"
"20465",0,1,0,1,"dummy"
"20469",0,0,1,1,"dummy"
"20472",0,4,1,5,"dummy"
"20473",0,0,1,1,"dummy"
"20474",1,3,2,6,"dummy"
"20475",26,26,8,60,"dummy"
"20476",11,13,12,36,"dummy"
"20477",0,0,1,1,"dummy"
"20478",0,0,1,1,"dummy"
"20479",0,0,1,1,"dummy"
"20481",0,2,0,2,"dummy"
"20482",0,0,1,1,"dummy"
"20486",1,2,1,4,"dummy"
"20488",1,0,0,1,"dummy"
"20489",0,1,0,1,"dummy"
"20503",0,0,1,1,"dummy"
"20504",0,1,0,1,"dummy"
"20505",0,1,0,1,"dummy"
"20506",0,1,0,1,"dummy"
"20507",0,1,0,1,"dummy"
"20508",0,2,1,3,"dummy"
"20510",0,0,1,1,"dummy"
"20511",0,0,0,0,"dummy"
"20512",0,0,0,0,"dummy"
"20513",0,0,0,0,"dummy"
"20514",0,0,0,0,"dummy"
"20515",0,0,0,0,"dummy"
"20516",0,0,0,0,"dummy"
"20517",0,0,0,0,"dummy"
"20518",0,0,0,0,"dummy"
"20519",0,0,0,0,"dummy"
"20520",0,0,0,0,"dummy"
"20521",0,3,3,6,"dummy"
"20522",0,0,1,1,"dummy"
"20523",0,0,0,0,"dummy"
"20524",0,0,0,0,"dummy"
"20525",0,0,0,0,"dummy"
"20526",3,1,0,4,"dummy"
"20527",0,0,1,1,"dummy"
"20528",2,2,2,6,"dummy"
"20529",0,0,1,1,"dummy"
"20530",0,0,1,1,"dummy"
"20531",0,0,1,1,"dummy"
"20532",0,0,1,1,"dummy"
"20533",0,0,1,1,"dummy"
"20534",0,0,1,1,"dummy"
"20535",0,0,1,1,"dummy"
"20536",0,0,1,1,"dummy"
"20537",0,0,1,1,"dummy"
"20538",1,2,1,4,"dummy"
"20539",0,0,1,1,"dummy"
"20540",0,0,1,1,"dummy"
"20541",0,0,0,0,"dummy"
"20542",0,0,1,1,"dummy"
"20543",0,0,1,1,"dummy"
"20544",0,0,0,0,"dummy"
"20545",1,3,1,5,"dummy"
"20546",0,0,0,0,"dummy"
"20547",0,0,0,0,"dummy"
"20548",0,0,1,1,"dummy"
"20549",0,0,1,1,"dummy"
"20550",0,0,1,1,"dummy"
"20551",0,0,1,1,"dummy"
"20552",0,0,0,0,"dummy"
"20553",0,0,1,1,"dummy"
"20554",0,0,1,1,"dummy"
"20555",0,0,1,1,"dummy"
"20556",0,0,0,0,"dummy"
"20557",0,0,1,1,"dummy"
"20558",0,0,0,0,"dummy"
"20559",0,0,0,0,"dummy"
"20560",0,0,0,0,"dummy"
"20561",0,0,1,1,"dummy"
"20562",0,0,1,1,"dummy"
"20570",0,0,1,1,"dummy"
"20572",2,2,0,4,"dummy"
"20573",0,2,0,2,"dummy"
"20574",2,2,0,4,"dummy"
"20578",1,1,0,2,"dummy"
"20584",0,0,1,1,"dummy"
"20585",1,2,3,6,"dummy"
"20588",0,2,0,2,"dummy"
"20589",0,6,0,6,"dummy"
"20590",0,0,3,3,"dummy"
"20591",5,2,2,9,"dummy"
"20592",5,0,1,6,"dummy"
"20593",0,0,6,6,"dummy"
"20595",0,9,0,9,"dummy"
"20596",0,0,1,1,"dummy"
"20597",0,1,0,1,"dummy"
"20598",0,1,0,1,"dummy"
"20599",12,3,1,16,"dummy"
"20600",0,1,0,1,"dummy"
"20601",0,1,0,1,"dummy"
"20602",0,1,0,1,"dummy"
"20603",0,4,1,5,"dummy"
"20604",4,0,2,6,"dummy"
"20605",0,1,0,1,"dummy"
"20609",0,0,0,0,"dummy"
"20610",0,0,0,0,"dummy"
"20614",0,0,1,1,"dummy"
"20615",0,0,1,1,"dummy"
"20616",0,0,1,1,"dummy"
"20618",0,0,1,1,"dummy"
"20619",0,1,3,4,"dummy"
"20623",0,1,0,1,"dummy"
"20624",0,1,0,1,"dummy"
"20625",0,0,1,1,"dummy"
"20626",0,2,0,2,"dummy"
"20627",10,7,1,18,"dummy"
"20628",2,4,0,6,"dummy"
"20629",0,1,0,1,"dummy"
"20630",1,1,0,2,"dummy"
"20631",0,1,0,1,"dummy"
"20632",0,2,0,2,"dummy"
"20633",2,1,0,3,"dummy"
"20634",0,0,1,1,"dummy"
"20635",0,0,0,0,"dummy"
"20636",0,0,1,1,"dummy"
"20637",2,0,1,3,"dummy"
"20638",0,1,0,1,"dummy"
"20639",3,5,0,8,"dummy"
"20640",2,3,0,5,"dummy"
"20641",0,0,1,1,"dummy"
"20642",2,12,1,15,"dummy"
"20643",0,3,2,5,"dummy"
"20644",3,3,0,6,"dummy"
"20645",0,1,0,1,"dummy"
"20646",0,0,1,1,"dummy"
"20647",3,3,0,6,"dummy"
"20648",0,1,0,1,"dummy"
"20649",2,1,2,5,"dummy"
"20650",5,5,0,10,"dummy"
"20651",0,0,0,0,"dummy"
"20652",13,17,1,31,"dummy"
"20653",2,0,1,3,"dummy"
"20654",0,0,0,0,"dummy"
"20655",0,2,0,2,"dummy"
"20656",0,0,1,1,"dummy"
"20657",0,1,1,2,"dummy"
"20658",2,10,1,13,"dummy"
"20659",2,2,0,4,"dummy"
"20660",3,2,1,6,"dummy"
"20661",0,0,2,2,"dummy"
"20662",1,1,0,2,"dummy"
"20663",0,0,0,0,"dummy"
"20664",0,1,0,1,"dummy"
"20665",10,2,1,13,"dummy"
"20666",0,0,1,1,"dummy"
"20667",0,0,1,1,"dummy"
"20668",1,2,0,3,"dummy"
"20669",0,0,0,0,"dummy"
"20671",0,0,1,1,"dummy"
"20672",3,16,2,21,"dummy"
"20673",0,0,1,1,"dummy"
"20674",16,3,1,20,"dummy"
"20676",0,1,1,2,"dummy"
"20679",0,0,0,0,"dummy"
"20680",1,2,0,3,"dummy"
"20681",18,5,4,27,"dummy"
"20682",0,1,0,1,"dummy"
"20684",4,14,0,18,"dummy"
"20685",1,1,1,3,"dummy"
"20690",0,0,3,3,"dummy"
"20691",0,0,0,0,"dummy"
"20692",0,2,1,3,"dummy"
"20695",0,0,1,1,"dummy"
"20696",0,0,1,1,"dummy"
"20697",0,0,1,1,"dummy"
"20698",0,0,1,1,"dummy"
"20714",0,0,1,1,"dummy"
"20715",0,0,0,0,"dummy"
"20716",0,0,0,0,"dummy"
"20717",0,0,0,0,"dummy"
"20718",0,0,0,0,"dummy"
"20719",0,0,0,0,"dummy"
"20720",0,1,0,1,"dummy"
"20721",0,0,0,0,"dummy"
"20722",15,16,3,34,"dummy"
"20723",12,0,0,12,"dummy"
"20724",1,0,0,1,"dummy"
"20743",5,0,1,6,"dummy"
"20749",1,3,1,5,"dummy"
"20752",0,2,0,2,"dummy"
"20753",0,1,0,1,"dummy"
"20754",0,1,0,1,"dummy"
"20755",0,1,1,2,"dummy"
"20756",0,0,0,0,"dummy"
"20758",1,0,0,1,"dummy"
"20759",0,0,1,1,"dummy"
"20761",0,0,0,0,"dummy"
"20763",0,0,1,1,"dummy"
"20764",0,2,2,4,"dummy"
"20765",0,4,0,4,"dummy"
"20770",0,6,0,6,"dummy"
"20773",0,0,1,1,"dummy"
"20774",0,8,0,8,"dummy"
"20775",0,0,1,1,"dummy"
"20776",0,0,1,1,"dummy"
"20779",0,0,1,1,"dummy"
"20782",0,0,1,1,"dummy"
"20783",2,2,0,4,"dummy"
"20786",0,0,1,1,"dummy"
"20789",0,0,2,2,"dummy"
"20790",0,0,0,0,"dummy"
"20791",0,1,1,2,"dummy"
"20792",3,4,0,7,"dummy"
"20793",4,0,0,4,"dummy"
"20794",1,1,0,2,"dummy"
"20795",1,1,0,2,"dummy"
"20797",11,3,1,15,"dummy"
"20801",0,0,1,1,"dummy"
"20802",0,0,1,1,"dummy"
"20824",0,0,4,4,"dummy"
"20827",0,0,0,0,"dummy"
"20829",0,2,1,3,"dummy"
"20830",2,3,2,7,"dummy"
"20841",10,4,1,15,"dummy"
"20844",2,8,2,12,"dummy"
"20845",2,2,1,5,"dummy"
"20846",0,0,1,1,"dummy"
"20848",0,1,2,3,"dummy"
"20849",0,0,0,0,"dummy"
"20850",0,2,0,2,"dummy"
"20851",5,0,2,7,"dummy"
"20852",1,0,0,1,"dummy"
"20853",0,0,0,0,"dummy"
"20855",0,0,1,1,"dummy"
"20856",0,0,1,1,"dummy"
"20857",0,0,1,1,"dummy"
"20858",0,3,0,3,"dummy"
"20859",0,2,0,2,"dummy"
"20860",0,0,1,1,"dummy"
"20861",3,5,4,12,"dummy"
"20862",0,0,2,2,"dummy"
"20863",10,3,4,17,"dummy"
"20864",0,0,1,1,"dummy"
"20865",0,0,1,1,"dummy"
"20866",0,0,1,1,"dummy"
"20867",0,0,1,1,"dummy"
"20868",0,0,1,1,"dummy"
"20869",0,0,1,1,"dummy"
"20870",0,0,1,1,"dummy"
"20871",0,0,1,1,"dummy"
"20872",0,0,1,1,"dummy"
"20873",0,0,1,1,"dummy"
"20874",0,0,1,1,"dummy"
"20875",0,0,1,1,"dummy"
"20876",0,1,2,3,"dummy"
"20877",0,0,1,1,"dummy"
"20878",0,0,1,1,"dummy"
"20879",0,0,1,1,"dummy"
"20880",0,0,1,1,"dummy"
"20882",1,1,0,2,"dummy"
"20883",0,0,2,2,"dummy"
"20884",1,4,1,6,"dummy"
"20885",1,2,4,7,"dummy"
"20886",0,0,1,1,"dummy"
"20887",1,3,0,4,"dummy"
"20888",0,5,1,6,"dummy"
"20889",0,0,0,0,"dummy"
"20890",1,3,2,6,"dummy"
"20891",0,0,2,2,"dummy"
"20892",0,0,3,3,"dummy"
"20893",0,0,3,3,"dummy"
"20894",0,0,2,2,"dummy"
"20895",0,0,2,2,"dummy"
"20896",0,0,3,3,"dummy"
"20897",0,0,3,3,"dummy"
"20898",0,0,3,3,"dummy"
"20899",1,0,3,4,"dummy"
"20900",0,0,3,3,"dummy"
"20901",0,0,3,3,"dummy"
"20902",0,0,4,4,"dummy"
"20903",0,3,0,3,"dummy"
"20904",1,2,0,3,"dummy"
"20905",2,1,0,3,"dummy"
"20906",1,2,0,3,"dummy"
"20907",1,0,0,1,"dummy"
"20908",5,7,1,13,"dummy"
"20909",0,0,1,1,"dummy"
"20910",0,0,1,1,"dummy"
"20911",9,3,0,12,"dummy"
"20912",0,0,2,2,"dummy"
"20913",0,0,0,0,"dummy"
"20915",0,2,0,2,"dummy"
"20916",0,2,0,2,"dummy"
"20917",0,2,0,2,"dummy"
"20918",3,4,1,8,"dummy"
"20919",0,0,2,2,"dummy"
"20920",0,0,4,4,"dummy"
"20921",1,1,0,2,"dummy"
"20922",0,1,0,1,"dummy"
"20923",0,0,1,1,"dummy"
"20924",0,0,2,2,"dummy"
"20925",0,0,1,1,"dummy"
"20926",1,0,1,2,"dummy"
"20927",0,0,1,1,"dummy"
"20930",0,1,0,1,"dummy"
"20931",0,0,1,1,"dummy"
"20937",5,0,2,7,"dummy"
"20940",0,3,0,3,"dummy"
"20942",2,2,0,4,"dummy"
"20944",2,7,0,9,"dummy"
"20945",6,2,3,11,"dummy"
"20947",0,0,0,0,"dummy"
"20954",1,1,0,2,"dummy"
"20955",2,0,2,4,"dummy"
"20956",1,0,0,1,"dummy"
"20957",2,12,1,15,"dummy"
"20958",1,1,0,2,"dummy"
"20959",2,1,1,4,"dummy"
"20960",1,0,0,1,"dummy"
"20961",1,0,0,1,"dummy"
"20963",1,0,1,2,"dummy"
"20964",0,1,0,1,"dummy"
"20967",2,1,1,4,"dummy"
"20968",1,1,2,4,"dummy"
"20969",0,0,0,0,"dummy"
"20970",1,0,1,2,"dummy"
"20974",0,0,0,0,"dummy"
"20976",2,0,0,2,"dummy"
"20981",1,0,4,5,"dummy"
"20982",0,1,2,3,"dummy"
"20983",5,20,1,26,"dummy"
"20989",0,1,0,1,"dummy"
"20990",0,1,0,1,"dummy"
"21013",0,4,1,5,"dummy"
"21016",1,0,0,1,"dummy"
"21017",5,5,1,11,"dummy"
"21021",0,0,2,2,"dummy"
"21022",1,3,2,6,"dummy"
"21028",0,0,2,2,"dummy"
"21030",0,1,0,1,"dummy"
"21031",0,1,1,2,"dummy"
"21032",15,36,6,57,"dummy"
"21033",0,1,0,1,"dummy"
"21034",11,0,1,12,"dummy"
"21035",0,12,0,12,"dummy"
"21036",0,1,2,3,"dummy"
"21037",0,1,0,1,"dummy"
"21038",20,3,0,23,"dummy"
"21039",0,1,0,1,"dummy"
"21040",0,1,0,1,"dummy"
"21041",0,0,8,8,"dummy"
"21042",0,1,0,1,"dummy"
"21043",2,3,0,5,"dummy"
"21044",1,0,0,1,"dummy"
"21045",0,1,0,1,"dummy"
"21046",0,1,0,1,"dummy"
"21047",0,3,0,3,"dummy"
"21048",0,1,0,1,"dummy"
"21049",4,4,10,18,"dummy"
"21050",0,1,0,1,"dummy"
"21051",2,2,1,5,"dummy"
"21052",0,0,1,1,"dummy"
"21054",0,1,0,1,"dummy"
"21058",0,0,1,1,"dummy"
"21059",3,11,0,14,"dummy"
"21060",0,1,0,1,"dummy"
"21065",0,0,1,1,"dummy"
"21067",3,2,2,7,"dummy"
"21068",0,8,2,10,"dummy"
"21069",8,2,0,10,"dummy"
"21070",0,0,0,0,"dummy"
"21071",0,0,0,0,"dummy"
"21072",1,2,0,3,"dummy"
"21073",4,7,3,14,"dummy"
"21080",0,8,0,8,"dummy"
"21082",0,0,2,2,"dummy"
"21083",4,3,3,10,"dummy"
"21084",1,3,0,4,"dummy"
"21088",0,0,1,1,"dummy"
"21093",0,0,1,1,"dummy"
"21095",0,0,2,2,"dummy"
"21096",1,2,0,3,"dummy"
"21097",4,4,0,8,"dummy"
"21099",0,0,1,1,"dummy"
"21100",0,0,1,1,"dummy"
"21101",0,1,0,1,"dummy"
"21102",8,1,1,10,"dummy"
"21103",1,0,1,2,"dummy"
"21104",1,1,0,2,"dummy"
"21109",0,0,1,1,"dummy"
"21110",0,2,0,2,"dummy"
"21122",0,0,3,3,"dummy"
"21123",0,0,2,2,"dummy"
"21125",0,0,1,1,"dummy"
"21128",0,0,0,0,"dummy"
"21129",0,5,0,5,"dummy"
"21130",0,4,0,4,"dummy"
"21131",0,0,1,1,"dummy"
"21132",2,2,0,4,"dummy"
"21133",1,0,0,1,"dummy"
"21134",0,2,0,2,"dummy"
"21140",0,1,0,1,"dummy"
"21142",0,3,0,3,"dummy"
"21143",0,0,0,0,"dummy"
"21144",0,0,0,0,"dummy"
"21145",6,1,0,7,"dummy"
"21146",0,1,0,1,"dummy"
"21148",24,1,1,26,"dummy"
"21149",5,1,0,6,"dummy"
"21150",0,1,0,1,"dummy"
"21151",0,1,0,1,"dummy"
"21153",3,12,3,18,"dummy"
"21154",0,1,0,1,"dummy"
"21157",4,20,1,25,"dummy"
"21159",3,2,4,9,"dummy"
"21160",10,0,0,10,"dummy"
"21161",0,2,0,2,"dummy"
"21162",0,0,4,4,"dummy"
"21165",1,0,0,1,"dummy"
"21167",2,2,0,4,"dummy"
"21196",1,0,0,1,"dummy"
"21197",0,1,0,1,"dummy"
"21198",0,2,0,2,"dummy"
"21199",0,0,0,0,"dummy"
"21200",0,1,0,1,"dummy"
"21211",0,1,0,1,"dummy"
"21212",0,1,0,1,"dummy"
"21213",0,1,0,1,"dummy"
"21229",0,2,0,2,"dummy"
"21230",1,2,1,4,"dummy"
"21269",0,0,1,1,"dummy"
"21270",0,0,0,0,"dummy"
"21375",0,0,0,0,"dummy"
"21392",0,1,0,1,"dummy"
"21395",0,1,0,1,"dummy"
"21396",0,0,7,7,"dummy"
"21418",0,0,0,0,"dummy"
"21421",1,9,1,11,"dummy"
"21422",3,7,0,10,"dummy"
"21423",0,3,1,4,"dummy"
"21424",4,2,1,7,"dummy"
"21461",0,0,1,1,"dummy"
"21462",1,1,1,3,"dummy"
"21503",5,19,0,24,"dummy"
"21504",5,4,0,9,"dummy"
"21527",0,0,1,1,"dummy"
"21530",0,7,0,7,"dummy"
"21533",4,0,2,6,"dummy"
"21534",0,1,0,1,"dummy"
"21535",6,0,0,6,"dummy"
"21536",1,0,0,1,"dummy"
"21537",0,0,0,0,"dummy"
"21538",0,1,0,1,"dummy"
"21539",0,0,1,1,"dummy"
"21542",0,0,1,1,"dummy"
"21545",0,7,0,7,"dummy"
"21546",3,0,1,4,"dummy"
"21547",0,0,1,1,"dummy"
"21548",0,0,1,1,"dummy"
"21549",0,2,0,2,"dummy"
"21550",3,0,1,4,"dummy"
"21553",0,0,1,1,"dummy"
"21554",0,3,0,3,"dummy"
"21567",0,0,1,1,"dummy"
"21568",0,0,1,1,"dummy"
"21569",0,0,1,1,"dummy"
"21572",0,0,0,0,"dummy"
"21575",0,1,0,1,"dummy"
"21580",0,4,0,4,"dummy"
"21601",6,3,3,12,"dummy"
"21602",0,5,1,6,"dummy"
"21603",0,0,2,2,"dummy"
"21232",0,0,2,2,"dummy"
"21261",18,2,1,21,"dummy"
"21262",0,0,1,1,"dummy"
"21263",1,1,0,2,"dummy"
"21371",0,1,0,1,"dummy"
"21372",1,6,0,7,"dummy"
"21373",1,1,0,2,"dummy"
"21379",11,8,1,20,"dummy"
"21380",0,4,0,4,"dummy"
"21381",0,1,0,1,"dummy"
"21382",1,0,0,1,"dummy"
"21383",1,0,0,1,"dummy"
"21384",12,11,4,27,"dummy"
"21385",0,2,0,2,"dummy"
"21386",0,1,0,1,"dummy"
"21387",5,0,1,6,"dummy"
"21388",5,5,1,11,"dummy"
"21402",3,11,1,15,"dummy"
"21403",62,6,1,69,"dummy"
"21404",4,3,2,9,"dummy"
"21405",0,0,1,1,"dummy"
"21406",0,0,1,1,"dummy"
"21407",0,0,1,1,"dummy"
"21408",1,0,1,2,"dummy"
"21409",0,1,0,1,"dummy"
"21410",0,0,1,1,"dummy"
"21411",0,0,2,2,"dummy"
"21412",2,3,0,5,"dummy"
"21413",3,4,1,8,"dummy"
"21414",0,0,1,1,"dummy"
"21451",0,16,0,16,"dummy"
"21452",0,0,0,0,"dummy"
"21453",3,0,0,3,"dummy"
"21454",0,0,1,1,"dummy"
"21491",3,3,2,8,"dummy"
"21492",0,1,0,1,"dummy"
"21495",0,0,1,1,"dummy"
"21496",0,3,0,3,"dummy"
"21499",0,0,1,1,"dummy"
"21500",1,19,0,20,"dummy"
"21501",0,0,1,1,"dummy"
"21506",4,3,3,10,"dummy"
"21507",0,0,1,1,"dummy"
"21508",0,2,0,2,"dummy"
"21509",0,0,1,1,"dummy"
"21512",0,10,1,11,"dummy"
"21513",1,0,0,1,"dummy"
"21514",0,0,1,1,"dummy"
"21519",0,1,1,2,"dummy"
"21520",5,2,0,7,"dummy"
"21521",2,1,0,3,"dummy"
"21522",0,0,1,1,"dummy"
"21523",0,1,0,1,"dummy"
"21556",0,0,1,1,"dummy"
"21557",0,0,2,2,"dummy"
"21558",0,0,1,1,"dummy"
"21559",1,1,0,2,"dummy"
"21560",1,1,0,2,"dummy"
"21561",1,1,0,2,"dummy"
"21562",1,1,0,2,"dummy"
"21563",0,0,1,1,"dummy"
"21564",0,0,1,1,"dummy"
"21565",0,2,0,2,"dummy"
"21582",0,1,1,2,"dummy"
"21587",0,1,0,1,"dummy"
"21588",0,1,0,1,"dummy"
"21589",0,4,0,4,"dummy"
"21590",0,2,0,2,"dummy"
"21591",5,5,0,10,"dummy"
"21606",0,1,0,1,"dummy"
"21617",3,8,3,14,"dummy"
"21618",0,2,1,3,"dummy"
"21619",2,0,2,4,"dummy"
"21620",1,2,2,5,"dummy"
"21621",0,1,0,1,"dummy"
"21622",0,0,1,1,"dummy"
"21704",0,0,1,1,"dummy"
"21705",0,1,0,1,"dummy"
"21706",1,0,0,1,"dummy"
"21718",0,0,1,1,"dummy"
"21729",0,2,0,2,"dummy"
"21773",0,0,0,0,"dummy"
"21774",0,0,1,1,"dummy"
"21775",0,10,0,10,"dummy"
"21776",2,0,3,5,"dummy"
"21604",0,0,1,1,"dummy"
"21615",2,5,2,9,"dummy"
"21624",0,4,0,4,"dummy"
"21629",0,0,0,0,"dummy"
"21632",1,13,2,16,"dummy"
"21633",9,4,2,15,"dummy"
"21634",2,0,0,2,"dummy"
"21635",0,1,0,1,"dummy"
"21636",1,0,0,1,"dummy"
"21650",1,0,0,1,"dummy"
"21651",0,1,0,1,"dummy"
"21656",0,0,1,1,"dummy"
"21657",0,0,1,1,"dummy"
"21658",0,0,1,1,"dummy"
"21700",1,0,1,2,"dummy"
"21701",0,0,1,1,"dummy"
"21702",0,0,1,1,"dummy"
"21724",9,5,0,14,"dummy"
"21725",1,1,1,3,"dummy"
"21726",0,2,0,2,"dummy"
"21727",0,1,0,1,"dummy"
"21853",0,0,1,1,"dummy"
"21856",0,0,1,1,"dummy"
"21857",0,0,0,0,"dummy"
"21858",0,0,2,2,"dummy"
"21865",0,0,3,3,"dummy"
"21868",0,0,1,1,"dummy"
"21869",0,0,1,1,"dummy"
"21870",3,1,0,4,"dummy"
"21871",0,0,1,1,"dummy"
"21876",3,2,1,6,"dummy"
"21879",0,0,1,1,"dummy"
"21884",0,1,1,2,"dummy"
"21885",0,0,1,1,"dummy"
"21886",0,0,1,1,"dummy"
"21887",0,0,1,1,"dummy"
"21905",0,0,1,1,"dummy"
"21906",0,0,3,3,"dummy"
"21907",0,6,0,6,"dummy"
"21908",6,2,3,11,"dummy"
"21909",0,0,1,1,"dummy"
"21910",1,1,1,3,"dummy"
"21911",0,0,1,1,"dummy"
"21912",0,1,1,2,"dummy"
"21918",0,0,1,1,"dummy"
"21919",0,0,1,1,"dummy"
"21920",5,6,1,12,"dummy"
"21921",0,0,1,1,"dummy"
"21922",0,12,0,12,"dummy"
"21923",0,3,0,3,"dummy"
"21924",2,2,2,6,"dummy"
"21925",1,1,0,2,"dummy"
"21926",0,3,0,3,"dummy"
"21927",0,0,6,6,"dummy"
"21928",0,0,1,1,"dummy"
"21934",0,2,0,2,"dummy"
"21935",0,1,0,1,"dummy"
"21936",0,2,0,2,"dummy"
"21937",0,2,1,3,"dummy"
"21938",0,1,0,1,"dummy"
"21939",0,1,0,1,"dummy"
"21940",1,4,0,5,"dummy"
"21941",0,1,0,1,"dummy"
"21942",0,1,0,1,"dummy"
"21777",3,4,0,7,"dummy"
"21778",12,8,6,26,"dummy"
"21779",6,1,5,12,"dummy"
"21780",1,2,1,4,"dummy"
"21783",10,7,4,21,"dummy"
"21784",0,2,0,2,"dummy"
"21808",0,0,1,1,"dummy"
"21809",0,0,1,1,"dummy"
"21810",0,0,2,2,"dummy"
"21811",0,0,1,1,"dummy"
"21812",0,0,0,0,"dummy"
"21813",0,1,0,1,"dummy"
"21814",1,0,0,1,"dummy"
"21815",2,0,0,2,"dummy"
"21816",0,0,1,1,"dummy"
"21817",0,1,0,1,"dummy"
"21818",0,2,0,2,"dummy"
"21819",0,0,1,1,"dummy"
"21820",0,0,1,1,"dummy"
"21821",0,0,1,1,"dummy"
"21822",0,2,0,2,"dummy"
"21823",0,1,0,1,"dummy"
"21824",3,4,0,7,"dummy"
"21825",0,3,0,3,"dummy"
"21826",2,0,0,2,"dummy"
"21827",0,2,0,2,"dummy"
"21828",0,1,0,1,"dummy"
"21829",2,7,0,9,"dummy"
"21830",2,0,0,2,"dummy"
"21831",2,2,0,4,"dummy"
"21832",0,2,0,2,"dummy"
"21833",0,2,0,2,"dummy"
"21834",0,2,0,2,"dummy"
"21835",0,0,0,0,"dummy"
"21836",0,0,1,1,"dummy"
"21837",0,2,0,2,"dummy"
"21838",0,0,1,1,"dummy"
"21839",0,4,0,4,"dummy"
"21840",0,0,2,2,"dummy"
"21841",0,1,0,1,"dummy"
"21842",0,1,0,1,"dummy"
"21843",8,0,0,8,"dummy"
"21844",0,1,0,1,"dummy"
"21845",0,0,0,0,"dummy"
"21846",1,0,0,1,"dummy"
"21847",0,0,0,0,"dummy"
"21848",0,0,0,0,"dummy"
"21849",10,2,0,12,"dummy"
"21850",0,0,0,0,"dummy"
"21851",1,0,0,1,"dummy"
"21889",0,1,0,1,"dummy"
"21890",0,0,4,4,"dummy"
"21891",1,3,1,5,"dummy"
"21892",0,2,1,3,"dummy"
"21893",3,1,1,5,"dummy"
"21894",0,0,0,0,"dummy"
"21895",0,0,2,2,"dummy"
"21896",1,0,0,1,"dummy"
"21897",2,0,0,2,"dummy"
"21898",0,0,0,0,"dummy"
"21899",0,0,0,0,"dummy"
"21900",0,2,0,2,"dummy"
"21901",3,2,0,5,"dummy"
"21914",0,0,1,1,"dummy"
"21915",0,0,0,0,"dummy"
"21916",0,0,0,0,"dummy"
"21960",0,4,0,4,"dummy"
"21961",0,0,2,2,"dummy"
"21962",0,0,1,1,"dummy"
"21967",0,0,1,1,"dummy"
"21970",2,3,0,5,"dummy"
"21973",0,1,0,1,"dummy"
"21978",0,0,1,1,"dummy"
"21943",0,2,0,2,"dummy"
"21946",0,0,1,1,"dummy"
"21947",0,0,1,1,"dummy"
"21950",0,7,0,7,"dummy"
"21951",5,0,0,5,"dummy"
"21952",1,0,0,1,"dummy"
"21955",3,16,0,19,"dummy"
"21956",1,2,0,3,"dummy"
"21957",2,5,0,7,"dummy"
"21958",1,2,0,3,"dummy"
"21980",0,1,1,2,"dummy"
"21990",1,0,0,1,"dummy"
"21991",0,0,0,0,"dummy"
"22002",0,1,0,1,"dummy"
"22003",0,0,1,1,"dummy"
"22004",0,0,1,1,"dummy"
"22005",2,0,0,2,"dummy"
"22006",0,0,0,0,"dummy"
"22007",0,0,0,0,"dummy"
"22008",0,0,0,0,"dummy"
"22009",2,0,0,2,"dummy"
"22010",0,3,0,3,"dummy"
"22011",1,5,0,6,"dummy"
"22012",1,0,0,1,"dummy"
"22013",0,0,1,1,"dummy"
"22014",0,0,2,2,"dummy"
"22015",0,0,1,1,"dummy"
"22016",0,4,0,4,"dummy"
"22017",0,0,0,0,"dummy"
"22020",0,1,0,1,"dummy"
"22021",0,1,0,1,"dummy"
"22032",1,10,0,11,"dummy"
"22033",0,1,0,1,"dummy"
"22038",0,1,0,1,"dummy"
"22039",2,2,0,4,"dummy"
"22040",2,0,3,5,"dummy"
"22043",5,3,2,10,"dummy"
"22086",2,3,1,6,"dummy"
"22087",0,0,1,1,"dummy"
"22088",0,2,1,3,"dummy"
"22089",0,3,0,3,"dummy"
"22090",0,1,1,2,"dummy"
"22091",1,7,0,8,"dummy"
"22092",0,2,1,3,"dummy"
"22110",0,1,0,1,"dummy"
"21995",0,1,0,1,"dummy"
"21996",0,0,2,2,"dummy"
"21997",0,0,2,2,"dummy"
"21998",2,1,0,3,"dummy"
"21999",0,0,2,2,"dummy"
"22000",0,0,2,2,"dummy"
"22030",0,0,1,1,"dummy"
"22035",0,0,1,1,"dummy"
"22036",0,0,0,0,"dummy"
"22045",1,1,2,4,"dummy"
"22046",1,8,6,15,"dummy"
"22047",0,5,1,6,"dummy"
"22048",1,0,0,1,"dummy"
"22049",1,0,0,1,"dummy"
"22050",3,5,0,8,"dummy"
"22051",1,1,0,2,"dummy"
"22052",3,0,0,3,"dummy"
"22053",1,1,0,2,"dummy"
"22054",0,2,1,3,"dummy"
"22055",7,4,3,14,"dummy"
"22056",0,0,1,1,"dummy"
"22057",2,4,1,7,"dummy"
"22058",3,3,0,6,"dummy"
"22061",0,0,4,4,"dummy"
"22062",0,1,1,2,"dummy"
"22063",0,5,1,6,"dummy"
"22064",1,2,0,3,"dummy"
"22065",0,2,3,5,"dummy"
"22066",0,5,1,6,"dummy"
"22067",9,6,3,18,"dummy"
"22068",3,2,3,8,"dummy"
"22069",0,2,0,2,"dummy"
"22070",1,1,0,2,"dummy"
"22071",0,1,0,1,"dummy"
"22072",0,1,0,1,"dummy"
"22073",0,1,0,1,"dummy"
"22074",0,1,1,2,"dummy"
"22075",0,10,0,10,"dummy"
"22076",4,6,7,17,"dummy"
"22096",1,10,0,11,"dummy"
"22097",0,1,0,1,"dummy"
"22098",0,0,2,2,"dummy"
"22101",0,0,1,1,"dummy"
"22102",0,0,1,1,"dummy"
"22103",3,0,0,3,"dummy"
"22106",0,2,0,2,"dummy"
"22107",0,0,0,0,"dummy"
"22108",0,1,0,1,"dummy"
"22126",0,0,1,1,"dummy"
"22127",0,2,0,2,"dummy"
"22128",13,3,0,16,"dummy"
"22131",1,0,0,1,"dummy"
"22132",0,1,0,1,"dummy"
"22133",1,7,1,9,"dummy"
"22134",0,0,1,1,"dummy"
"22137",0,0,1,1,"dummy"
"22142",1,10,0,11,"dummy"
"22143",0,1,0,1,"dummy"
"22144",0,0,2,2,"dummy"
"22146",0,1,0,1,"dummy"
"22147",1,1,0,2,"dummy"
"22148",0,1,0,1,"dummy"
"22149",6,0,0,6,"dummy"
"22150",0,1,0,1,"dummy"
"22153",0,0,1,1,"dummy"
"22154",3,0,0,3,"dummy"
"22155",0,2,0,2,"dummy"
"22156",0,2,0,2,"dummy"
"22157",2,0,0,2,"dummy"
"22161",0,0,0,0,"dummy"
"22162",0,0,0,0,"dummy"
"22163",0,0,0,0,"dummy"
"22164",4,0,2,6,"dummy"
"22165",0,0,1,1,"dummy"
"22166",0,0,1,1,"dummy"
"22167",1,0,0,1,"dummy"
"22169",0,1,0,1,"dummy"
"22172",0,0,0,0,"dummy"
"22175",2,0,4,6,"dummy"
"22176",0,0,2,2,"dummy"
"22177",5,4,0,9,"dummy"
"22178",0,1,2,3,"dummy"
"22181",0,2,0,2,"dummy"
"22182",5,5,0,10,"dummy"
"22183",0,0,0,0,"dummy"
"22184",0,1,1,2,"dummy"
"22185",0,0,0,0,"dummy"
"22186",0,0,1,1,"dummy"
"22187",2,0,0,2,"dummy"
"22195",2,4,0,6,"dummy"
"22196",0,2,0,2,"dummy"
"22197",0,2,0,2,"dummy"
"22198",10,2,0,12,"dummy"
"22199",0,2,0,2,"dummy"
"22200",0,0,0,0,"dummy"
"22201",0,0,3,3,"dummy"
"22202",0,5,0,5,"dummy"
"22203",1,0,1,2,"dummy"
"22207",1,1,2,4,"dummy"
"22216",0,0,0,0,"dummy"
"22217",0,0,1,1,"dummy"
"22219",8,3,3,14,"dummy"
"22221",0,0,1,1,"dummy"
"22222",0,0,1,1,"dummy"
"22223",0,1,1,2,"dummy"
"22224",0,0,1,1,"dummy"
"22225",0,0,1,1,"dummy"
"22226",0,4,1,5,"dummy"
"22227",0,2,1,3,"dummy"
"22228",0,0,1,1,"dummy"
"22230",2,4,1,7,"dummy"
"22236",0,5,0,5,"dummy"
"22237",0,0,1,1,"dummy"
"22238",0,4,0,4,"dummy"
"22239",4,2,1,7,"dummy"
"22241",7,0,0,7,"dummy"
"22242",8,4,0,12,"dummy"
"22243",0,6,0,6,"dummy"
"22244",0,3,0,3,"dummy"
"22245",11,7,1,19,"dummy"
"22251",6,1,4,11,"dummy"
"22252",0,1,1,2,"dummy"
"22253",6,0,0,6,"dummy"
"22255",1,2,1,4,"dummy"
"22256",0,1,0,1,"dummy"
"22257",0,0,1,1,"dummy"
"22258",0,0,0,0,"dummy"
"22263",0,0,1,1,"dummy"
"22264",6,8,3,17,"dummy"
"22265",0,2,0,2,"dummy"
"22266",2,0,0,2,"dummy"
"22267",1,0,0,1,"dummy"
"22270",0,2,1,3,"dummy"
"22274",1,2,1,4,"dummy"
"22275",1,1,0,2,"dummy"
"22276",0,1,0,1,"dummy"
"22277",0,1,0,1,"dummy"
"22278",0,1,1,2,"dummy"
"22279",0,1,0,1,"dummy"
"22280",14,4,0,18,"dummy"
"22281",0,0,1,1,"dummy"
"22287",2,0,3,5,"dummy"
"22288",1,0,0,1,"dummy"
"22289",0,1,0,1,"dummy"
"22290",0,1,1,2,"dummy"
"22293",0,0,1,1,"dummy"
"22294",1,0,0,1,"dummy"
"22295",3,0,0,3,"dummy"
"22296",0,0,1,1,"dummy"
"22297",2,0,3,5,"dummy"
"22310",0,0,1,1,"dummy"
"22311",8,2,0,10,"dummy"
"22344",0,1,0,1,"dummy"
"22371",2,0,2,4,"dummy"
"22374",0,3,1,4,"dummy"
"22375",2,1,0,3,"dummy"
"22376",6,2,0,8,"dummy"
"22377",0,1,1,2,"dummy"
"22378",0,0,1,1,"dummy"
"22379",1,3,2,6,"dummy"
"22380",2,1,0,3,"dummy"
"22381",0,0,1,1,"dummy"
"22382",0,2,0,2,"dummy"
"22383",6,0,0,6,"dummy"
"22384",1,13,0,14,"dummy"
"22385",0,0,1,1,"dummy"
"22386",0,0,0,0,"dummy"
"22387",0,1,0,1,"dummy"
"22388",12,12,0,24,"dummy"
"22389",0,0,1,1,"dummy"
"22390",0,2,0,2,"dummy"
"22391",0,0,2,2,"dummy"
"22392",5,2,4,11,"dummy"
"22393",0,1,0,1,"dummy"
"22394",0,1,0,1,"dummy"
"22395",0,0,0,0,"dummy"
"22396",0,0,0,0,"dummy"
"22397",0,0,0,0,"dummy"
"22415",0,1,0,1,"dummy"
"22418",1,2,0,3,"dummy"
"22419",1,0,0,1,"dummy"
"22422",1,0,0,1,"dummy"
"22427",0,0,0,0,"dummy"
"22428",0,0,0,0,"dummy"
"22440",1,1,1,3,"dummy"
"22450",0,1,4,5,"dummy"
"22463",1,3,6,10,"dummy"
"22464",0,0,0,0,"dummy"
"22465",2,2,0,4,"dummy"
"22466",0,3,0,3,"dummy"
"22467",1,2,0,3,"dummy"
"22468",1,3,0,4,"dummy"
"22474",0,3,0,3,"dummy"
"22482",0,0,1,1,"dummy"
"22491",0,1,2,3,"dummy"
"22492",2,5,1,8,"dummy"
"22531",0,0,1,1,"dummy"
"22532",0,0,1,1,"dummy"
"22542",0,0,1,1,"dummy"
"22548",3,4,2,9,"dummy"
"22549",0,1,0,1,"dummy"
"22550",0,2,0,2,"dummy"
"22551",0,1,0,1,"dummy"
"22560",0,0,1,1,"dummy"
"22561",0,0,2,2,"dummy"
"22564",0,1,0,1,"dummy"
"22301",8,6,0,14,"dummy"
"22302",1,0,0,1,"dummy"
"22303",2,0,0,2,"dummy"
"22304",0,1,1,2,"dummy"
"22305",3,1,0,4,"dummy"
"22308",12,1,6,19,"dummy"
"22318",0,5,0,5,"dummy"
"22319",0,0,1,1,"dummy"
"22320",0,1,0,1,"dummy"
"22321",0,1,0,1,"dummy"
"22322",1,0,2,3,"dummy"
"22323",0,2,1,3,"dummy"
"22324",0,1,0,1,"dummy"
"22325",0,5,1,6,"dummy"
"22326",0,1,1,2,"dummy"
"22327",0,4,0,4,"dummy"
"22328",0,5,0,5,"dummy"
"22329",3,0,0,3,"dummy"
"22330",0,8,0,8,"dummy"
"22331",3,3,0,6,"dummy"
"22332",5,4,0,9,"dummy"
"22333",4,4,0,8,"dummy"
"22334",5,6,0,11,"dummy"
"22335",2,2,0,4,"dummy"
"22336",3,3,0,6,"dummy"
"22337",5,5,0,10,"dummy"
"22338",0,1,0,1,"dummy"
"22339",4,4,0,8,"dummy"
"22340",8,5,0,13,"dummy"
"22341",2,0,0,2,"dummy"
"22342",0,0,1,1,"dummy"
"22346",0,2,0,2,"dummy"
"22347",0,1,0,1,"dummy"
"22348",1,2,0,3,"dummy"
"22349",0,2,0,2,"dummy"
"22354",0,0,0,0,"dummy"
"22355",0,1,0,1,"dummy"
"22356",0,2,0,2,"dummy"
"22357",0,0,1,1,"dummy"
"22369",3,1,0,4,"dummy"
"22424",0,7,0,7,"dummy"
"22425",1,0,0,1,"dummy"
"22430",0,1,0,1,"dummy"
"22431",6,9,0,15,"dummy"
"22432",1,1,0,2,"dummy"
"22433",3,6,2,11,"dummy"
"22436",0,1,0,1,"dummy"
"22437",0,0,0,0,"dummy"
"22438",0,0,1,1,"dummy"
"22446",0,0,0,0,"dummy"
"22452",0,2,0,2,"dummy"
"22455",0,2,0,2,"dummy"
"22456",0,0,2,2,"dummy"
"22457",0,0,1,1,"dummy"
"22458",0,0,1,1,"dummy"
"22459",0,0,1,1,"dummy"
"22460",0,0,1,1,"dummy"
"22461",2,0,0,2,"dummy"
"22470",8,0,0,8,"dummy"
"22471",0,0,0,0,"dummy"
"22472",0,1,0,1,"dummy"
"22476",2,12,1,15,"dummy"
"22477",3,1,1,5,"dummy"
"22478",3,1,0,4,"dummy"
"22479",0,3,0,3,"dummy"
"22480",11,2,5,18,"dummy"
"22484",0,1,0,1,"dummy"
"22487",0,1,0,1,"dummy"
"22488",0,3,4,7,"dummy"
"22489",2,0,0,2,"dummy"
"22494",2,1,0,3,"dummy"
"22495",0,0,1,1,"dummy"
"22518",0,0,2,2,"dummy"
"22521",0,0,0,0,"dummy"
"22522",0,0,2,2,"dummy"
"22523",0,0,0,0,"dummy"
"22524",4,9,0,13,"dummy"
"22525",0,0,1,1,"dummy"
"22526",0,2,1,3,"dummy"
"22527",2,0,2,4,"dummy"
"22528",0,1,2,3,"dummy"
"22529",0,0,1,1,"dummy"
"22536",0,0,0,0,"dummy"
"22537",0,0,3,3,"dummy"
"22538",1,6,1,8,"dummy"
"22539",14,5,5,24,"dummy"
"22540",1,4,0,5,"dummy"
"22553",0,0,0,0,"dummy"
"22554",0,0,0,0,"dummy"
"22555",0,0,0,0,"dummy"
"22558",0,0,3,3,"dummy"
"22570",0,0,1,1,"dummy"
"22595",0,1,0,1,"dummy"
"22596",0,0,1,1,"dummy"
"22602",0,0,2,2,"dummy"
"22603",0,7,0,7,"dummy"
"22615",0,0,2,2,"dummy"
"22616",0,7,0,7,"dummy"
"22630",0,0,2,2,"dummy"
"22631",11,22,2,35,"dummy"
"22634",6,5,0,11,"dummy"
"22635",0,0,1,1,"dummy"
"22638",0,0,1,1,"dummy"
"22647",0,1,2,3,"dummy"
"22648",0,0,0,0,"dummy"
"22649",0,1,0,1,"dummy"
"22650",4,0,2,6,"dummy"
"22651",1,0,0,1,"dummy"
"22652",0,0,0,0,"dummy"
"22661",1,0,0,1,"dummy"
"22664",0,0,1,1,"dummy"
"22665",0,0,1,1,"dummy"
"22748",1,8,2,11,"dummy"
"22813",0,0,2,2,"dummy"
"22814",0,0,1,1,"dummy"
"22832",1,4,2,7,"dummy"
"22833",0,0,1,1,"dummy"
"22834",2,0,2,4,"dummy"
"22835",3,17,1,21,"dummy"
"22836",2,3,3,8,"dummy"
"22837",48,0,0,48,"dummy"
"22838",0,0,0,0,"dummy"
"22839",0,0,0,0,"dummy"
"22840",0,0,0,0,"dummy"
"22841",0,29,0,29,"dummy"
"22842",0,1,0,1,"dummy"
"22843",13,20,1,34,"dummy"
"22844",2,8,0,10,"dummy"
"22845",16,19,0,35,"dummy"
"22846",13,7,0,20,"dummy"
"22847",0,0,1,1,"dummy"
"22848",0,0,1,1,"dummy"
"22849",6,0,0,6,"dummy"
"22850",0,6,1,7,"dummy"
"22851",12,9,2,23,"dummy"
"22852",0,0,1,1,"dummy"
"22866",1,0,0,1,"dummy"
"22867",0,2,1,3,"dummy"
"22868",0,0,0,0,"dummy"
"22869",2,0,0,2,"dummy"
"22574",4,4,1,9,"dummy"
"22575",0,0,1,1,"dummy"
"22578",0,0,1,1,"dummy"
"22579",0,0,1,1,"dummy"
"22580",0,0,1,1,"dummy"
"22581",0,0,1,1,"dummy"
"22582",0,0,1,1,"dummy"
"22583",0,0,1,1,"dummy"
"22584",0,0,1,1,"dummy"
"22585",0,0,1,1,"dummy"
"22586",0,0,1,1,"dummy"
"22587",0,0,1,1,"dummy"
"22588",0,0,1,1,"dummy"
"22589",6,6,2,14,"dummy"
"22590",0,0,1,1,"dummy"
"22591",0,0,1,1,"dummy"
"22598",2,2,1,5,"dummy"
"22599",7,3,0,10,"dummy"
"22600",0,0,0,0,"dummy"
"22605",2,4,0,6,"dummy"
"22606",0,2,0,2,"dummy"
"22607",0,2,0,2,"dummy"
"22608",10,2,0,12,"dummy"
"22609",0,2,0,2,"dummy"
"22610",0,0,0,0,"dummy"
"22611",0,0,3,3,"dummy"
"22612",0,5,0,5,"dummy"
"22613",1,0,1,2,"dummy"
"22618",1,0,0,1,"dummy"
"22619",2,0,1,3,"dummy"
"22620",0,0,0,0,"dummy"
"22621",0,1,0,1,"dummy"
"22622",8,1,0,9,"dummy"
"22623",0,0,0,0,"dummy"
"22624",0,0,0,0,"dummy"
"22625",1,10,0,11,"dummy"
"22626",7,1,0,8,"dummy"
"22627",0,0,1,1,"dummy"
"22628",2,0,3,5,"dummy"
"22642",0,3,0,3,"dummy"
"22643",0,2,0,2,"dummy"
"22644",0,1,0,1,"dummy"
"22645",0,0,1,1,"dummy"
"22654",0,2,0,2,"dummy"
"22655",4,10,1,15,"dummy"
"22656",1,1,0,2,"dummy"
"22659",0,0,2,2,"dummy"
"22667",0,0,1,1,"dummy"
"22672",0,0,0,0,"dummy"
"22673",0,0,3,3,"dummy"
"22676",0,2,0,2,"dummy"
"22677",13,15,0,28,"dummy"
"22680",0,0,1,1,"dummy"
"22681",0,0,1,1,"dummy"
"22682",2,4,4,10,"dummy"
"22683",2,2,1,5,"dummy"
"22684",2,2,1,5,"dummy"
"22685",8,0,0,8,"dummy"
"22686",0,6,0,6,"dummy"
"22687",1,3,0,4,"dummy"
"22688",0,0,1,1,"dummy"
"22689",6,0,0,6,"dummy"
"22690",1,0,0,1,"dummy"
"22691",0,9,1,10,"dummy"
"22692",1,0,0,1,"dummy"
"22693",0,0,0,0,"dummy"
"22694",7,2,0,9,"dummy"
"22695",0,3,0,3,"dummy"
"22696",1,0,0,1,"dummy"
"22697",1,4,1,6,"dummy"
"22698",5,0,0,5,"dummy"
"22699",0,1,0,1,"dummy"
"22700",0,2,0,2,"dummy"
"22701",0,2,1,3,"dummy"
"22702",2,0,0,2,"dummy"
"22703",0,0,1,1,"dummy"
"22704",0,1,0,1,"dummy"
"22705",1,0,0,1,"dummy"
"22706",2,0,0,2,"dummy"
"22707",0,1,0,1,"dummy"
"22708",0,1,0,1,"dummy"
"22709",1,0,0,1,"dummy"
"22710",1,1,0,2,"dummy"
"22711",0,1,0,1,"dummy"
"22712",4,2,0,6,"dummy"
"22713",4,13,0,17,"dummy"
"22714",9,3,2,14,"dummy"
"22715",0,1,0,1,"dummy"
"22716",1,0,0,1,"dummy"
"22717",4,4,0,8,"dummy"
"22718",1,1,2,4,"dummy"
"22719",0,1,2,3,"dummy"
"22720",1,1,0,2,"dummy"
"22721",1,1,0,2,"dummy"
"22722",0,0,0,0,"dummy"
"22723",2,12,3,17,"dummy"
"22724",1,1,0,2,"dummy"
"22725",2,4,1,7,"dummy"
"22726",2,0,0,2,"dummy"
"22727",0,2,0,2,"dummy"
"22728",9,0,0,9,"dummy"
"22729",0,1,0,1,"dummy"
"22730",0,0,0,0,"dummy"
"22731",1,1,0,2,"dummy"
"22732",2,2,1,5,"dummy"
"22733",1,1,0,2,"dummy"
"22734",1,1,0,2,"dummy"
"22735",4,0,0,4,"dummy"
"22743",0,1,0,1,"dummy"
"22744",0,1,0,1,"dummy"
"22808",0,3,0,3,"dummy"
"22809",0,2,0,2,"dummy"
"22810",0,1,1,2,"dummy"
"22811",1,0,1,2,"dummy"
"22816",0,0,0,0,"dummy"
"22817",0,0,0,0,"dummy"
"22818",0,0,1,1,"dummy"
"22819",0,0,2,2,"dummy"
"22820",0,0,1,1,"dummy"
"22821",3,0,0,3,"dummy"
"22822",0,0,0,0,"dummy"
"22823",0,0,0,0,"dummy"
"22830",0,0,1,1,"dummy"
"22854",0,1,0,1,"dummy"
"22855",0,1,1,2,"dummy"
"22856",6,0,1,7,"dummy"
"22857",5,7,1,13,"dummy"
"22858",0,4,1,5,"dummy"
"22859",0,5,0,5,"dummy"
"22860",0,2,2,4,"dummy"
"22861",1,0,0,1,"dummy"
"22862",2,1,1,4,"dummy"
"22863",0,0,1,1,"dummy"
"22864",3,3,0,6,"dummy"
"22871",12,1,0,13,"dummy"
"22872",1,0,0,1,"dummy"
"22875",0,2,0,2,"dummy"
"22876",0,1,0,1,"dummy"
"22877",0,0,1,1,"dummy"
"22878",0,0,1,1,"dummy"
"22879",0,2,0,2,"dummy"
"22880",0,0,2,2,"dummy"
"22896",0,0,1,1,"dummy"
"22897",0,0,0,0,"dummy"
"22902",0,2,0,2,"dummy"
"22903",0,1,0,1,"dummy"
"22904",0,0,1,1,"dummy"
"22905",0,1,2,3,"dummy"
"22906",0,0,1,1,"dummy"
"22914",0,0,2,2,"dummy"
"22915",0,0,1,1,"dummy"
"22950",2,0,3,5,"dummy"
"22958",0,0,0,0,"dummy"
"22959",0,0,1,1,"dummy"
"22960",0,1,0,1,"dummy"
"22961",0,0,2,2,"dummy"
"22964",4,0,0,4,"dummy"
"22968",0,2,0,2,"dummy"
"22969",0,0,1,1,"dummy"
"22970",0,1,1,2,"dummy"
"22973",9,2,3,14,"dummy"
"22974",2,2,0,4,"dummy"
"22975",5,41,1,47,"dummy"
"22976",0,4,1,5,"dummy"
"22982",3,0,3,6,"dummy"
"22983",0,0,1,1,"dummy"
"22984",0,0,1,1,"dummy"
"22985",0,0,1,1,"dummy"
"22986",2,2,0,4,"dummy"
"22987",0,1,0,1,"dummy"
"22988",0,0,1,1,"dummy"
"22989",1,0,1,2,"dummy"
"22990",0,1,0,1,"dummy"
"22891",0,0,1,1,"dummy"
"22892",0,0,2,2,"dummy"
"22893",0,0,1,1,"dummy"
"22894",2,1,0,3,"dummy"
"22899",0,0,1,1,"dummy"
"22900",0,0,1,1,"dummy"
"22908",1,1,0,2,"dummy"
"22911",1,2,0,3,"dummy"
"22912",0,0,0,0,"dummy"
"22931",1,4,0,5,"dummy"
"22932",2,0,0,2,"dummy"
"22947",0,6,0,6,"dummy"
"22948",0,1,0,1,"dummy"
"22952",1,7,0,8,"dummy"
"22966",0,1,0,1,"dummy"
"22978",0,0,0,0,"dummy"
"22979",0,0,0,0,"dummy"
"22980",0,0,0,0,"dummy"
"22996",0,2,0,2,"dummy"
"22997",3,0,0,3,"dummy"
"22998",1,3,0,4,"dummy"
"22999",0,1,0,1,"dummy"
"23003",0,1,0,1,"dummy"
"23004",0,0,1,1,"dummy"
"23005",1,0,1,2,"dummy"
"23006",0,5,0,5,"dummy"
"23022",0,1,1,2,"dummy"
"23025",0,0,4,4,"dummy"
"23026",0,1,4,5,"dummy"
"23027",0,6,0,6,"dummy"
"23028",0,4,0,4,"dummy"
"23029",0,1,0,1,"dummy"
"23030",0,0,1,1,"dummy"
"23060",0,0,1,1,"dummy"
"23061",0,0,1,1,"dummy"
"23067",0,0,0,0,"dummy"
"23068",4,1,0,5,"dummy"
"23069",0,0,0,0,"dummy"
"23070",1,0,0,1,"dummy"
"23071",0,0,0,0,"dummy"
"23072",0,0,0,0,"dummy"
"23075",6,11,0,17,"dummy"
"23076",3,0,0,3,"dummy"
"23080",0,0,1,1,"dummy"
"23081",0,0,0,0,"dummy"
"23089",0,11,0,11,"dummy"
"23090",14,0,1,15,"dummy"
"23091",0,3,0,3,"dummy"
"23092",0,1,0,1,"dummy"
"23093",0,1,0,1,"dummy"
"23096",1,1,0,2,"dummy"
"23097",0,1,0,1,"dummy"
"23098",0,1,0,1,"dummy"
"23099",0,3,0,3,"dummy"
"23100",20,14,3,37,"dummy"
"23101",0,3,0,3,"dummy"
"23102",0,2,0,2,"dummy"
"23103",0,0,1,1,"dummy"
"23104",1,0,0,1,"dummy"
"23117",0,1,0,1,"dummy"
"23118",0,0,1,1,"dummy"
"23140",0,0,0,0,"dummy"
"23141",0,0,0,0,"dummy"
"23150",0,0,1,1,"dummy"
"23151",0,0,1,1,"dummy"
"23156",0,0,1,1,"dummy"
"23001",0,0,0,0,"dummy"
"23012",0,15,3,18,"dummy"
"23015",0,1,0,1,"dummy"
"23016",0,2,0,2,"dummy"
"23017",0,1,0,1,"dummy"
"23018",0,0,2,2,"dummy"
"23032",0,1,0,1,"dummy"
"23033",1,3,2,6,"dummy"
"23034",0,0,1,1,"dummy"
"23035",0,3,1,4,"dummy"
"23036",0,0,0,0,"dummy"
"23037",0,0,1,1,"dummy"
"23040",0,0,0,0,"dummy"
"23041",2,1,0,3,"dummy"
"23042",0,0,0,0,"dummy"
"23043",0,1,0,1,"dummy"
"23044",2,0,0,2,"dummy"
"23045",2,1,0,3,"dummy"
"23046",0,2,0,2,"dummy"
"23047",3,0,0,3,"dummy"
"23048",2,6,2,10,"dummy"
"23049",0,0,0,0,"dummy"
"23050",0,1,0,1,"dummy"
"23051",2,0,0,2,"dummy"
"23052",0,0,1,1,"dummy"
"23053",0,0,1,1,"dummy"
"23054",1,0,0,1,"dummy"
"23055",4,0,0,4,"dummy"
"23058",1,1,2,4,"dummy"
"23063",2,1,0,3,"dummy"
"23078",2,2,0,4,"dummy"
"23087",0,0,2,2,"dummy"
"23106",0,1,0,1,"dummy"
"23107",1,0,0,1,"dummy"
"23108",0,1,0,1,"dummy"
"23109",0,0,1,1,"dummy"
"23110",0,1,0,1,"dummy"
"23111",1,1,1,3,"dummy"
"23112",1,0,0,1,"dummy"
"23115",0,1,0,1,"dummy"
"23120",0,1,0,1,"dummy"
"23121",0,1,0,1,"dummy"
"23122",0,2,0,2,"dummy"
"23123",1,0,1,2,"dummy"
"23124",0,0,1,1,"dummy"
"23125",0,0,0,0,"dummy"
"23126",0,0,1,1,"dummy"
"23127",0,0,1,1,"dummy"
"23128",0,0,1,1,"dummy"
"23129",0,0,1,1,"dummy"
"23130",0,0,1,1,"dummy"
"23131",0,0,1,1,"dummy"
"23132",0,0,0,0,"dummy"
"23133",0,0,1,1,"dummy"
"23134",0,0,1,1,"dummy"
"23135",0,0,1,1,"dummy"
"23136",0,0,1,1,"dummy"
"23137",0,0,1,1,"dummy"
"23138",0,0,1,1,"dummy"
"23160",0,1,1,2,"dummy"
"23171",0,0,0,0,"dummy"
"23172",0,0,0,0,"dummy"
"23175",0,0,1,1,"dummy"
"23220",4,6,2,12,"dummy"
"23228",0,0,1,1,"dummy"
"23229",0,0,1,1,"dummy"
"23230",0,1,0,1,"dummy"
"23234",0,0,1,1,"dummy"
"23235",0,0,1,1,"dummy"
"23236",0,1,0,1,"dummy"
"23243",1,1,5,7,"dummy"
"23244",0,10,0,10,"dummy"
"23162",4,5,3,12,"dummy"
"23163",4,5,4,13,"dummy"
"23164",0,0,1,1,"dummy"
"23165",9,7,3,19,"dummy"
"23166",0,2,2,4,"dummy"
"23167",0,0,1,1,"dummy"
"23177",0,5,1,6,"dummy"
"23178",0,1,0,1,"dummy"
"23179",0,0,2,2,"dummy"
"23180",0,1,0,1,"dummy"
"23181",0,1,0,1,"dummy"
"23182",1,2,1,4,"dummy"
"23183",0,2,0,2,"dummy"
"23184",0,0,2,2,"dummy"
"23185",0,0,1,1,"dummy"
"23186",0,2,0,2,"dummy"
"23187",2,4,5,11,"dummy"
"23188",25,28,4,57,"dummy"
"23189",1,2,0,3,"dummy"
"23190",11,9,3,23,"dummy"
"23191",0,1,0,1,"dummy"
"23192",1,1,0,2,"dummy"
"23193",6,2,0,8,"dummy"
"23194",2,7,0,9,"dummy"
"23195",6,2,0,8,"dummy"
"23196",0,0,1,1,"dummy"
"23197",5,6,1,12,"dummy"
"23198",2,6,0,8,"dummy"
"23199",1,2,0,3,"dummy"
"23200",0,1,0,1,"dummy"
"23201",4,6,0,10,"dummy"
"23202",0,0,1,1,"dummy"
"23203",1,0,0,1,"dummy"
"23204",2,1,1,4,"dummy"
"23205",0,0,0,0,"dummy"
"23206",0,1,0,1,"dummy"
"23207",0,0,0,0,"dummy"
"23208",0,2,0,2,"dummy"
"23209",0,1,0,1,"dummy"
"23210",1,1,0,2,"dummy"
"23211",0,1,0,1,"dummy"
"23212",0,2,0,2,"dummy"
"23213",0,3,0,3,"dummy"
"23214",0,0,0,0,"dummy"
"23215",1,0,0,1,"dummy"
"23218",6,7,0,13,"dummy"
"23222",0,2,0,2,"dummy"
"23223",4,6,0,10,"dummy"
"23224",4,4,0,8,"dummy"
"23225",0,0,1,1,"dummy"
"23226",0,0,1,1,"dummy"
"23232",0,0,1,1,"dummy"
"23238",0,0,2,2,"dummy"
"23239",0,0,1,1,"dummy"
"23275",0,0,1,1,"dummy"
"23276",0,1,0,1,"dummy"
"23277",1,1,0,2,"dummy"
"23282",1,0,0,1,"dummy"
"23283",0,0,1,1,"dummy"
"23289",0,0,0,0,"dummy"
"23290",0,0,0,0,"dummy"
"23291",0,0,0,0,"dummy"
"23292",0,0,0,0,"dummy"
"23293",0,0,0,0,"dummy"
"23294",0,0,0,0,"dummy"
"23295",0,0,0,0,"dummy"
"23296",0,0,0,0,"dummy"
"23297",0,0,0,0,"dummy"
"23298",0,0,0,0,"dummy"
"23299",0,0,0,0,"dummy"
"23300",0,0,0,0,"dummy"
"23301",0,0,0,0,"dummy"
"23302",0,0,0,0,"dummy"
"23303",0,0,0,0,"dummy"
"23304",0,1,0,1,"dummy"
"23305",0,0,0,0,"dummy"
"23306",0,0,0,0,"dummy"
"23307",0,0,0,0,"dummy"
"23308",0,0,0,0,"dummy"
"23309",0,6,0,6,"dummy"
"23310",0,0,0,0,"dummy"
"23311",0,0,0,0,"dummy"
"23322",0,1,3,4,"dummy"
"23339",7,8,14,29,"dummy"
"23342",0,1,0,1,"dummy"
"23350",0,0,0,0,"dummy"
"23351",0,0,0,0,"dummy"
"23352",1,0,0,1,"dummy"
"23353",0,9,0,9,"dummy"
"23245",0,7,0,7,"dummy"
"23246",1,4,3,8,"dummy"
"23247",1,1,4,6,"dummy"
"23248",4,4,3,11,"dummy"
"23249",1,1,4,6,"dummy"
"23250",3,0,0,3,"dummy"
"23251",4,4,3,11,"dummy"
"23252",1,1,4,6,"dummy"
"23253",1,1,4,6,"dummy"
"23254",1,1,4,6,"dummy"
"23255",0,0,0,0,"dummy"
"23256",3,5,0,8,"dummy"
"23257",0,0,1,1,"dummy"
"23258",0,0,1,1,"dummy"
"23259",0,2,0,2,"dummy"
"23260",3,3,1,7,"dummy"
"23261",0,0,1,1,"dummy"
"23262",0,0,2,2,"dummy"
"23263",0,2,0,2,"dummy"
"23264",3,3,0,6,"dummy"
"23265",4,4,2,10,"dummy"
"23266",3,3,0,6,"dummy"
"23285",0,0,1,1,"dummy"
"23286",29,2,1,32,"dummy"
"23287",1,0,0,1,"dummy"
"23313",0,0,1,1,"dummy"
"23314",0,0,1,1,"dummy"
"23315",0,0,1,1,"dummy"
"23316",8,8,1,17,"dummy"
"23317",0,0,1,1,"dummy"
"23318",0,0,1,1,"dummy"
"23319",0,0,1,1,"dummy"
"23320",0,0,1,1,"dummy"
"23346",0,0,1,1,"dummy"
"23347",2,4,1,7,"dummy"
"23348",0,1,0,1,"dummy"
"23370",2,0,0,2,"dummy"
"23383",0,1,1,2,"dummy"
"23405",1,0,1,2,"dummy"
"23406",0,3,0,3,"dummy"
"23407",3,1,0,4,"dummy"
"23414",0,3,1,4,"dummy"
"23415",0,3,1,4,"dummy"
"23416",2,2,0,4,"dummy"
"23417",0,0,0,0,"dummy"
"23422",1,4,3,8,"dummy"
"23423",0,1,0,1,"dummy"
"23424",0,4,0,4,"dummy"
"23425",0,0,1,1,"dummy"
"23426",0,1,0,1,"dummy"
"23427",0,1,0,1,"dummy"
"23428",0,1,0,1,"dummy"
"23354",7,3,3,13,"dummy"
"23355",0,2,0,2,"dummy"
"23356",0,1,0,1,"dummy"
"23357",0,0,0,0,"dummy"
"23358",0,1,0,1,"dummy"
"23359",1,0,3,4,"dummy"
"23360",0,0,2,2,"dummy"
"23361",4,1,1,6,"dummy"
"23362",0,1,0,1,"dummy"
"23363",0,0,1,1,"dummy"
"23364",0,0,1,1,"dummy"
"23365",3,9,0,12,"dummy"
"23366",1,0,1,2,"dummy"
"23367",0,0,1,1,"dummy"
"23368",0,0,1,1,"dummy"
"23409",1,1,0,2,"dummy"
"23410",0,1,0,1,"dummy"
"23411",3,0,0,3,"dummy"
"23412",0,1,0,1,"dummy"
"23430",0,0,1,1,"dummy"
"23431",2,6,0,8,"dummy"
"23432",0,2,2,4,"dummy"
"23433",0,0,1,1,"dummy"
"23434",0,0,2,2,"dummy"
"23435",0,1,4,5,"dummy"
"23436",0,0,1,1,"dummy"
"23437",0,0,2,2,"dummy"
"23438",0,0,1,1,"dummy"
"23439",0,0,2,2,"dummy"
"23440",0,0,1,1,"dummy"
"23441",0,0,2,2,"dummy"
"23442",0,0,2,2,"dummy"
"23443",0,0,2,2,"dummy"
"23444",0,0,2,2,"dummy"
"23445",0,0,2,2,"dummy"
"23446",0,0,1,1,"dummy"
"23447",0,0,2,2,"dummy"
"23448",0,0,2,2,"dummy"
"23449",0,0,2,2,"dummy"
"23450",0,0,2,2,"dummy"
"23451",0,0,2,2,"dummy"
"23452",0,5,2,7,"dummy"
"23453",0,0,2,2,"dummy"
"23454",0,0,6,6,"dummy"
"23455",0,0,4,4,"dummy"
"23456",0,0,4,4,"dummy"
"23457",0,0,4,4,"dummy"
"23458",0,0,4,4,"dummy"
"23459",0,0,6,6,"dummy"
"23460",0,0,2,2,"dummy"
"23505",0,1,0,1,"dummy"
"23508",0,1,0,1,"dummy"
"23509",1,2,0,3,"dummy"
"23510",0,2,0,2,"dummy"
"23511",0,4,0,4,"dummy"
"23512",1,2,1,4,"dummy"
"23513",5,8,0,13,"dummy"
"23514",2,0,2,4,"dummy"
"23515",0,1,0,1,"dummy"
"23516",0,1,0,1,"dummy"
"23517",0,2,0,2,"dummy"
"23518",0,2,0,2,"dummy"
"23519",0,1,0,1,"dummy"
"23520",0,1,0,1,"dummy"
"23521",0,2,0,2,"dummy"
"23522",0,1,2,3,"dummy"
"23523",9,6,3,18,"dummy"
"23524",2,1,0,3,"dummy"
"23525",2,10,4,16,"dummy"
"23526",1,0,0,1,"dummy"
"23527",0,1,0,1,"dummy"
"23528",0,0,2,2,"dummy"
"23529",0,3,1,4,"dummy"
"23531",0,0,0,0,"dummy"
"23532",0,0,0,0,"dummy"
"23534",0,0,0,0,"dummy"
"23535",1,1,0,2,"dummy"
"23536",0,1,0,1,"dummy"
"23537",0,2,0,2,"dummy"
"23545",1,1,0,2,"dummy"
"23547",3,3,0,6,"dummy"
"23548",4,0,0,4,"dummy"
"23549",1,3,2,6,"dummy"
"23550",3,1,2,6,"dummy"
"23552",0,4,0,4,"dummy"
"23553",1,1,0,2,"dummy"
"23555",0,1,1,2,"dummy"
"23556",1,1,1,3,"dummy"
"23557",0,0,1,1,"dummy"
"23560",2,3,0,5,"dummy"
"23561",0,0,0,0,"dummy"
"23563",2,0,0,2,"dummy"
"23565",0,0,1,1,"dummy"
"23567",0,0,0,0,"dummy"
"23568",4,0,0,4,"dummy"
"23569",1,0,0,1,"dummy"
"23570",0,0,0,0,"dummy"
"23571",6,0,0,6,"dummy"
"23572",3,0,0,3,"dummy"
"23574",0,0,0,0,"dummy"
"23576",18,1,0,19,"dummy"
"23579",1,4,3,8,"dummy"
"23580",24,20,2,46,"dummy"
"23584",0,1,0,1,"dummy"
"23598",0,1,0,1,"dummy"
"23599",1,0,1,2,"dummy"
"23600",0,2,4,6,"dummy"
"23601",8,0,0,8,"dummy"
"23602",10,4,4,18,"dummy"
"23603",0,0,0,0,"dummy"
"23604",2,0,0,2,"dummy"
"23606",0,0,1,1,"dummy"
"23609",0,1,0,1,"dummy"
"23610",1,6,0,7,"dummy"
"23611",0,1,0,1,"dummy"
"23612",0,1,1,2,"dummy"
"23613",6,1,1,8,"dummy"
"23614",0,0,1,1,"dummy"
"23615",0,0,1,1,"dummy"
"23620",0,0,1,1,"dummy"
"23621",0,0,1,1,"dummy"
"23623",0,2,0,2,"dummy"
"23624",0,4,0,4,"dummy"
"23625",0,4,0,4,"dummy"
"23626",0,4,0,4,"dummy"
"23627",0,4,0,4,"dummy"
"23628",0,0,1,1,"dummy"
"23683",1,0,0,1,"dummy"
"23684",0,3,0,3,"dummy"
"23685",2,0,0,2,"dummy"
"23688",0,1,2,3,"dummy"
"23689",0,0,0,0,"dummy"
"23690",0,1,0,1,"dummy"
"23691",4,0,2,6,"dummy"
"23692",1,0,0,1,"dummy"
"23693",0,0,0,0,"dummy"
"23694",0,0,0,0,"dummy"
"23705",0,4,1,5,"dummy"
"23706",0,4,0,4,"dummy"
"23707",0,4,0,4,"dummy"
"23708",1,4,4,9,"dummy"
"23712",0,0,1,1,"dummy"
"23713",0,1,0,1,"dummy"
"23714",4,4,3,11,"dummy"
"23716",1,3,1,5,"dummy"
"23717",3,1,1,5,"dummy"
"23718",0,0,1,1,"dummy"
"23719",0,2,1,3,"dummy"
"23720",0,0,1,1,"dummy"
"23721",0,0,2,2,"dummy"
"23724",0,1,0,1,"dummy"
"23726",0,1,1,2,"dummy"
"23727",0,2,0,2,"dummy"
"23739",0,1,0,1,"dummy"
"23740",0,1,0,1,"dummy"
"23741",0,2,0,2,"dummy"
"23742",0,1,0,1,"dummy"
"23744",0,0,2,2,"dummy"
"23748",0,5,0,5,"dummy"
"23750",2,4,0,6,"dummy"
"23752",2,4,0,6,"dummy"
"23753",0,2,0,2,"dummy"
"23754",0,2,0,2,"dummy"
"23755",10,2,0,12,"dummy"
"23756",0,2,0,2,"dummy"
"23757",0,0,0,0,"dummy"
"23758",0,0,3,3,"dummy"
"23759",0,5,0,5,"dummy"
"23777",6,4,4,14,"dummy"
"23781",10,2,2,14,"dummy"
"23782",0,0,1,1,"dummy"
"23784",4,2,0,6,"dummy"
"23785",1,1,0,2,"dummy"
"23786",0,1,0,1,"dummy"
"23787",0,1,0,1,"dummy"
"23788",7,0,1,8,"dummy"
"23789",0,1,0,1,"dummy"
"23790",0,4,0,4,"dummy"
"23791",0,0,1,1,"dummy"
"23792",2,5,0,7,"dummy"
"23793",5,5,0,10,"dummy"
"23794",0,0,0,0,"dummy"
"23795",3,5,0,8,"dummy"
"23796",0,1,0,1,"dummy"
"23797",0,3,0,3,"dummy"
"23798",5,0,0,5,"dummy"
"23799",7,0,3,10,"dummy"
"23827",3,8,1,12,"dummy"
"23834",0,3,0,3,"dummy"
"23835",6,0,0,6,"dummy"
"23836",0,1,1,2,"dummy"
"23837",4,2,2,8,"dummy"
"23840",1,2,1,4,"dummy"
"23841",0,0,1,1,"dummy"
"23849",0,1,0,1,"dummy"
"23853",2,0,0,2,"dummy"
"23855",6,9,0,15,"dummy"
"23856",15,2,2,19,"dummy"
"23857",6,5,0,11,"dummy"
"23858",0,1,0,1,"dummy"
"23859",2,0,0,2,"dummy"
"23861",0,0,1,1,"dummy"
"23864",0,6,0,6,"dummy"
"23866",0,0,0,0,"dummy"
"23867",18,2,0,20,"dummy"
"23868",0,0,0,0,"dummy"
"23870",18,1,1,20,"dummy"
"23871",0,0,1,1,"dummy"
"23872",0,0,1,1,"dummy"
"23873",0,1,0,1,"dummy"
"23874",2,1,0,3,"dummy"
"23875",0,1,1,2,"dummy"
"23877",2,4,0,6,"dummy"
"23878",0,2,0,2,"dummy"
"23879",0,2,0,2,"dummy"
"23880",10,2,0,12,"dummy"
"23881",0,2,0,2,"dummy"
"23882",0,0,0,0,"dummy"
"23897",1,0,0,1,"dummy"
"23898",0,1,0,1,"dummy"
"23899",0,0,6,6,"dummy"
"23900",0,1,0,1,"dummy"
"23901",0,0,2,2,"dummy"
"23902",0,0,1,1,"dummy"
"23903",0,2,0,2,"dummy"
"23904",3,4,1,8,"dummy"
"23905",0,1,0,1,"dummy"
"23906",5,0,4,9,"dummy"
"23907",0,1,0,1,"dummy"
"23910",0,0,1,1,"dummy"
"23911",0,4,3,7,"dummy"
"23914",0,1,0,1,"dummy"
"23915",0,0,1,1,"dummy"
"23918",0,2,0,2,"dummy"
"23938",0,0,0,0,"dummy"
"23940",0,0,0,0,"dummy"
"23942",0,1,0,1,"dummy"
"23944",0,2,0,2,"dummy"
"23945",3,1,0,4,"dummy"
"23960",1,2,0,3,"dummy"
"23973",2,20,2,24,"dummy"
"23974",0,3,0,3,"dummy"
"23975",5,6,0,11,"dummy"
"23976",6,21,1,28,"dummy"
"23977",0,1,0,1,"dummy"
"23979",0,0,0,0,"dummy"
"23980",0,0,1,1,"dummy"
"23981",0,2,0,2,"dummy"
"23982",0,0,1,1,"dummy"
"23983",0,1,0,1,"dummy"
"23984",0,0,1,1,"dummy"
"23985",0,1,1,2,"dummy"
"23986",0,0,1,1,"dummy"
"23987",0,0,3,3,"dummy"
"23988",0,0,1,1,"dummy"
"23990",3,3,0,6,"dummy"
"23991",0,0,3,3,"dummy"
"23992",17,23,9,49,"dummy"
"23993",3,3,0,6,"dummy"
"23994",0,0,1,1,"dummy"
"23995",0,0,1,1,"dummy"
"23996",0,0,1,1,"dummy"
"23997",0,0,1,1,"dummy"
"23998",0,1,0,1,"dummy"
"23999",0,1,0,1,"dummy"
"24000",0,0,1,1,"dummy"
"24001",0,0,1,1,"dummy"
"24002",0,0,1,1,"dummy"
"24003",0,0,1,1,"dummy"
"24005",0,2,1,3,"dummy"
"24006",0,1,0,1,"dummy"
"24007",0,5,0,5,"dummy"
"24008",0,1,0,1,"dummy"
"24009",0,2,2,4,"dummy"
"24010",0,1,1,2,"dummy"
"24011",0,9,0,9,"dummy"
"24020",2,4,0,6,"dummy"
"24021",0,2,0,2,"dummy"
"24022",0,2,0,2,"dummy"
"24023",10,2,0,12,"dummy"
"24024",0,2,0,2,"dummy"
"24025",0,0,0,0,"dummy"
"24026",0,0,3,3,"dummy"
"24027",0,5,0,5,"dummy"
"24032",0,2,0,2,"dummy"
"24033",2,1,2,5,"dummy"
"24034",1,3,2,6,"dummy"
"24035",0,1,0,1,"dummy"
"24036",0,0,1,1,"dummy"
"24037",0,2,0,2,"dummy"
"24038",0,2,0,2,"dummy"
"24039",2,1,0,3,"dummy"
"24040",0,1,2,3,"dummy"
"24041",0,0,1,1,"dummy"
"24042",0,1,1,2,"dummy"
"24043",0,1,1,2,"dummy"
"24045",0,0,1,1,"dummy"
"24046",0,1,0,1,"dummy"
"24047",0,0,1,1,"dummy"
"24048",0,0,1,1,"dummy"
"24049",0,0,1,1,"dummy"
"24050",0,1,0,1,"dummy"
"24051",0,0,1,1,"dummy"
"24054",2,4,6,12,"dummy"
"24055",28,20,3,51,"dummy"
"24056",2,0,0,2,"dummy"
"24062",0,0,1,1,"dummy"
"24064",0,0,1,1,"dummy"
"24066",0,1,0,1,"dummy"
"24067",32,13,0,45,"dummy"
"24068",0,5,0,5,"dummy"
"24069",2,0,0,2,"dummy"
"24070",3,0,0,3,"dummy"
"24072",0,1,0,1,"dummy"
"24073",0,0,1,1,"dummy"
"24074",1,0,0,1,"dummy"
"24075",0,6,2,8,"dummy"
"24077",3,1,0,4,"dummy"
"24081",1,10,2,13,"dummy"
"24086",1,0,1,2,"dummy"
"24087",0,1,0,1,"dummy"
"24088",0,1,1,2,"dummy"
"24097",0,0,2,2,"dummy"
"24104",0,6,0,6,"dummy"
"24105",0,0,1,1,"dummy"
"24114",0,0,0,0,"dummy"
"24115",0,0,1,1,"dummy"
"24116",0,0,3,3,"dummy"
"24118",0,8,0,8,"dummy"
"24119",2,2,1,5,"dummy"
"24120",0,1,0,1,"dummy"
"24122",0,1,0,1,"dummy"
"24124",0,0,1,1,"dummy"
"24125",0,1,0,1,"dummy"
"24127",1,0,1,2,"dummy"
"24128",14,8,4,26,"dummy"
"24129",0,0,1,1,"dummy"
"24130",0,0,1,1,"dummy"
"24131",0,0,1,1,"dummy"
"24132",0,0,2,2,"dummy"
"24133",0,0,1,1,"dummy"
"24134",0,0,1,1,"dummy"
"24135",2,4,0,6,"dummy"
"24136",0,0,1,1,"dummy"
"24137",0,0,1,1,"dummy"
"24138",0,0,1,1,"dummy"
"24139",0,0,1,1,"dummy"
"24140",0,0,1,1,"dummy"
"24141",0,0,1,1,"dummy"
"24142",0,0,1,1,"dummy"
"24143",0,0,1,1,"dummy"
"24144",0,0,1,1,"dummy"
"24145",0,0,1,1,"dummy"
"24146",0,0,1,1,"dummy"
"24147",0,0,1,1,"dummy"
"24148",0,0,1,1,"dummy"
"24149",0,0,1,1,"dummy"
"24150",0,0,1,1,"dummy"
"24151",0,0,1,1,"dummy"
"24152",3,4,2,9,"dummy"
"24153",0,0,1,1,"dummy"
"24154",0,0,1,1,"dummy"
"24155",0,0,1,1,"dummy"
"24156",0,0,1,1,"dummy"
"24157",0,4,2,6,"dummy"
"24158",0,0,1,1,"dummy"
"24159",0,0,1,1,"dummy"
"24160",0,0,1,1,"dummy"
"24161",0,0,1,1,"dummy"
"24162",0,0,1,1,"dummy"
"24163",0,0,1,1,"dummy"
"24164",0,0,1,1,"dummy"
"24165",0,0,1,1,"dummy"
"24166",4,0,2,6,"dummy"
"24167",0,0,1,1,"dummy"
"24168",0,0,1,1,"dummy"
"24169",1,0,0,1,"dummy"
"24170",0,0,1,1,"dummy"
"24175",1,0,0,1,"dummy"
"24176",1,2,2,5,"dummy"
"24177",0,3,0,3,"dummy"
"24178",0,5,0,5,"dummy"
"24179",2,2,3,7,"dummy"
"24180",2,4,0,6,"dummy"
"24181",1,0,1,2,"dummy"
"24182",0,1,0,1,"dummy"
"24183",4,5,3,12,"dummy"
"24185",0,0,2,2,"dummy"
"24187",1,2,0,3,"dummy"
"24189",0,3,0,3,"dummy"
"24193",0,0,0,0,"dummy"
"24196",1,3,1,5,"dummy"
"24197",0,1,0,1,"dummy"
"24199",0,4,0,4,"dummy"
"24200",0,8,0,8,"dummy"
"24201",2,1,0,3,"dummy"
"24202",4,0,0,4,"dummy"
"24203",0,2,1,3,"dummy"
"24278",1,2,0,3,"dummy"
"24283",0,13,1,14,"dummy"
"24284",5,2,0,7,"dummy"
"24285",1,2,2,5,"dummy"
"24286",5,2,0,7,"dummy"
"24287",0,2,0,2,"dummy"
"24288",0,0,1,1,"dummy"
"24289",0,1,0,1,"dummy"
"24290",0,0,1,1,"dummy"
"24291",0,0,0,0,"dummy"
"24292",0,1,0,1,"dummy"
"24293",0,0,2,2,"dummy"
"24294",0,0,0,0,"dummy"
"24297",6,6,0,12,"dummy"
"24299",1,2,1,4,"dummy"
"24300",0,0,0,0,"dummy"
"24301",6,9,1,16,"dummy"
"24302",0,2,0,2,"dummy"
"24303",4,5,0,9,"dummy"
"24304",8,19,6,33,"dummy"
"24305",1,3,0,4,"dummy"
"24306",10,1,1,12,"dummy"
"24308",0,1,0,1,"dummy"
"24309",0,0,1,1,"dummy"
"24310",0,1,1,2,"dummy"
"24311",0,3,0,3,"dummy"
"24312",0,0,1,1,"dummy"
"24313",0,3,2,5,"dummy"
"24315",0,5,0,5,"dummy"
"24316",0,6,0,6,"dummy"
"24317",4,5,1,10,"dummy"
"24318",10,1,0,11,"dummy"
"24319",0,0,0,0,"dummy"
"24321",5,3,0,8,"dummy"
"24322",1,0,0,1,"dummy"
"24324",0,0,4,4,"dummy"
"24325",2,3,0,5,"dummy"
"24326",7,25,1,33,"dummy"
"24327",0,4,0,4,"dummy"
"24328",1,1,0,2,"dummy"
"24329",4,4,0,8,"dummy"
"24330",4,1,3,8,"dummy"
"24331",2,0,0,2,"dummy"
"24369",0,0,1,1,"dummy"
"24370",2,0,2,4,"dummy"
"24371",2,0,2,4,"dummy"
"24379",0,3,0,3,"dummy"
"24380",0,1,0,1,"dummy"
"24381",0,0,1,1,"dummy"
"24382",1,0,0,1,"dummy"
"24383",1,0,0,1,"dummy"
"24384",1,0,0,1,"dummy"
"24385",0,1,0,1,"dummy"
"24386",2,1,0,3,"dummy"
"24389",0,1,0,1,"dummy"
"24390",1,0,0,1,"dummy"
"24391",0,0,1,1,"dummy"
"24402",0,1,0,1,"dummy"
"24410",3,0,1,4,"dummy"
"24415",0,5,0,5,"dummy"
"24416",0,1,0,1,"dummy"
"24417",5,0,0,5,"dummy"
"24438",0,0,1,1,"dummy"
"24439",0,0,1,1,"dummy"
"24449",0,1,0,1,"dummy"
"24450",0,1,0,1,"dummy"
"24451",0,0,1,1,"dummy"
"24459",0,2,0,2,"dummy"
"24460",0,0,0,0,"dummy"
"24467",3,2,5,10,"dummy"
"24479",10,3,3,16,"dummy"
"24483",0,0,0,0,"dummy"
"24484",0,0,1,1,"dummy"
"24485",0,1,0,1,"dummy"
"24486",1,0,0,1,"dummy"
"24496",0,0,1,1,"dummy"
"24504",0,2,0,2,"dummy"
"24545",3,1,0,4,"dummy"
"24552",6,1,1,8,"dummy"
"24553",0,0,0,0,"dummy"
"24333",0,0,1,1,"dummy"
"24334",0,0,1,1,"dummy"
"24346",0,1,0,1,"dummy"
"24347",1,0,4,5,"dummy"
"24348",1,3,1,5,"dummy"
"24349",0,1,1,2,"dummy"
"24350",0,0,1,1,"dummy"
"24351",0,0,0,0,"dummy"
"24352",7,3,0,10,"dummy"
"24353",0,1,0,1,"dummy"
"24354",0,1,0,1,"dummy"
"24355",1,16,0,17,"dummy"
"24356",5,5,2,12,"dummy"
"24357",1,3,0,4,"dummy"
"24358",0,1,0,1,"dummy"
"24359",7,7,4,18,"dummy"
"24360",0,0,1,1,"dummy"
"24361",0,0,1,1,"dummy"
"24362",3,7,1,11,"dummy"
"24363",0,0,0,0,"dummy"
"24364",0,1,0,1,"dummy"
"24365",2,0,0,2,"dummy"
"24373",0,0,1,1,"dummy"
"24374",1,3,0,4,"dummy"
"24375",1,2,0,3,"dummy"
"24376",2,0,1,3,"dummy"
"24377",0,2,1,3,"dummy"
"24393",0,1,0,1,"dummy"
"24394",14,14,0,28,"dummy"
"24395",0,0,1,1,"dummy"
"24396",0,1,0,1,"dummy"
"24397",1,3,0,4,"dummy"
"24398",1,2,1,4,"dummy"
"24399",22,13,2,37,"dummy"
"24400",0,6,0,6,"dummy"
"24404",2,7,2,11,"dummy"
"24405",0,0,0,0,"dummy"
"24408",0,0,1,1,"dummy"
"24419",2,0,0,2,"dummy"
"24424",2,0,2,4,"dummy"
"24425",0,0,1,1,"dummy"
"24426",4,5,0,9,"dummy"
"24427",0,1,0,1,"dummy"
"24428",0,2,0,2,"dummy"
"24429",2,1,1,4,"dummy"
"24432",0,8,0,8,"dummy"
"24435",0,20,0,20,"dummy"
"24436",0,1,0,1,"dummy"
"24444",0,0,2,2,"dummy"
"24445",1,0,0,1,"dummy"
"24446",0,0,1,1,"dummy"
"24447",0,0,2,2,"dummy"
"24464",0,1,0,1,"dummy"
"24465",0,2,0,2,"dummy"
"24469",7,3,1,11,"dummy"
"24481",1,0,0,1,"dummy"
"24488",9,0,2,11,"dummy"
"24489",0,0,1,1,"dummy"
"24490",0,2,0,2,"dummy"
"24491",0,0,0,0,"dummy"
"24492",0,0,1,1,"dummy"
"24493",0,0,2,2,"dummy"
"24494",0,3,0,3,"dummy"
"24498",0,0,0,0,"dummy"
"24499",2,2,0,4,"dummy"
"24500",2,1,0,3,"dummy"
"24501",0,0,1,1,"dummy"
"24502",0,2,0,2,"dummy"
"24506",0,0,1,1,"dummy"
"24549",0,1,0,1,"dummy"
"24550",0,1,0,1,"dummy"
"24555",2,4,0,6,"dummy"
"24560",0,0,0,0,"dummy"
"24561",17,2,0,19,"dummy"
"24562",1,4,0,5,"dummy"
"24563",1,1,4,6,"dummy"
"24564",0,0,3,3,"dummy"
"24565",1,1,3,5,"dummy"
"24566",0,1,3,4,"dummy"
"24567",0,1,1,2,"dummy"
"24568",3,1,0,4,"dummy"
"24569",3,3,1,7,"dummy"
"24570",0,0,0,0,"dummy"
"24571",3,3,1,7,"dummy"
"24576",0,0,0,0,"dummy"
"24577",10,17,3,30,"dummy"
"24578",17,7,5,29,"dummy"
"24579",3,1,1,5,"dummy"
"24580",0,2,0,2,"dummy"
"24581",0,12,4,16,"dummy"
"24582",0,1,0,1,"dummy"
"24583",5,0,0,5,"dummy"
"24586",3,4,3,10,"dummy"
"24587",9,5,0,14,"dummy"
"24588",0,0,1,1,"dummy"
"24589",2,0,0,2,"dummy"
"24590",0,0,1,1,"dummy"
"24591",2,2,0,4,"dummy"
"24592",2,0,0,2,"dummy"
"24593",2,0,0,2,"dummy"
"24594",0,2,0,2,"dummy"
"24595",1,0,0,1,"dummy"
"24596",0,0,1,1,"dummy"
"24601",1,1,0,2,"dummy"
"24602",2,0,0,2,"dummy"
"24609",0,4,0,4,"dummy"
"24610",3,1,0,4,"dummy"
"24622",0,0,1,1,"dummy"
"24634",0,0,2,2,"dummy"
"24635",0,9,0,9,"dummy"
"24636",0,10,2,12,"dummy"
"24704",3,11,0,14,"dummy"
"24705",14,19,2,35,"dummy"
"24706",3,11,0,14,"dummy"
"24707",0,4,0,4,"dummy"
"24708",2,4,1,7,"dummy"
"24727",17,13,0,30,"dummy"
"24728",2,2,0,4,"dummy"
"24745",0,20,3,23,"dummy"
"24769",0,1,0,1,"dummy"
"24770",3,1,0,4,"dummy"
"24771",1,4,3,8,"dummy"
"24772",0,1,2,3,"dummy"
"24773",1,0,0,1,"dummy"
"24774",0,1,0,1,"dummy"
"24775",0,0,1,1,"dummy"
"24776",0,0,1,1,"dummy"
"24777",0,0,1,1,"dummy"
"24778",0,0,1,1,"dummy"
"24779",0,0,1,1,"dummy"
"24780",1,0,0,1,"dummy"
"24781",0,0,0,0,"dummy"
"24782",0,1,0,1,"dummy"
"24783",0,0,1,1,"dummy"
"24784",1,0,0,1,"dummy"
"24785",0,1,0,1,"dummy"
"24786",0,0,0,0,"dummy"
"24787",0,0,0,0,"dummy"
"24788",0,0,1,1,"dummy"
"24789",0,0,1,1,"dummy"
"24790",0,0,1,1,"dummy"
"24791",0,1,0,1,"dummy"
"24792",0,2,0,2,"dummy"
"24798",1,0,0,1,"dummy"
"24827",0,0,4,4,"dummy"
"24828",0,1,4,5,"dummy"
"24598",0,1,0,1,"dummy"
"24599",0,0,1,1,"dummy"
"24604",0,1,0,1,"dummy"
"24607",0,0,2,2,"dummy"
"24612",0,2,3,5,"dummy"
"24613",0,0,3,3,"dummy"
"24614",0,0,1,1,"dummy"
"24615",0,1,0,1,"dummy"
"24616",0,0,0,0,"dummy"
"24640",0,0,1,1,"dummy"
"24641",0,0,1,1,"dummy"
"24642",0,1,1,2,"dummy"
"24643",0,0,1,1,"dummy"
"24644",0,1,0,1,"dummy"
"24645",3,2,0,5,"dummy"
"24646",0,1,1,2,"dummy"
"24647",0,0,1,1,"dummy"
"24648",0,0,1,1,"dummy"
"24649",0,0,1,1,"dummy"
"24650",0,0,1,1,"dummy"
"24651",0,0,1,1,"dummy"
"24652",0,0,1,1,"dummy"
"24653",0,0,1,1,"dummy"
"24654",0,4,3,7,"dummy"
"24655",0,0,1,1,"dummy"
"24656",0,0,1,1,"dummy"
"24657",0,0,1,1,"dummy"
"24658",3,3,5,11,"dummy"
"24659",1,0,1,2,"dummy"
"24660",0,1,0,1,"dummy"
"24661",4,4,2,10,"dummy"
"24662",0,2,0,2,"dummy"
"24663",0,0,1,1,"dummy"
"24664",0,0,1,1,"dummy"
"24665",0,0,1,1,"dummy"
"24666",0,0,2,2,"dummy"
"24667",0,0,1,1,"dummy"
"24668",0,0,1,1,"dummy"
"24669",0,0,1,1,"dummy"
"24670",0,0,1,1,"dummy"
"24671",0,0,1,1,"dummy"
"24672",0,0,1,1,"dummy"
"24673",0,1,3,4,"dummy"
"24674",0,0,1,1,"dummy"
"24675",0,0,1,1,"dummy"
"24676",4,0,0,4,"dummy"
"24677",0,0,1,1,"dummy"
"24678",0,1,0,1,"dummy"
"24679",0,0,1,1,"dummy"
"24680",0,1,0,1,"dummy"
"24681",0,3,0,3,"dummy"
"24682",0,0,1,1,"dummy"
"24683",0,0,1,1,"dummy"
"24684",0,0,1,1,"dummy"
"24685",0,0,1,1,"dummy"
"24686",3,0,1,4,"dummy"
"24687",0,0,1,1,"dummy"
"24688",0,0,1,1,"dummy"
"24689",0,0,1,1,"dummy"
"24690",0,0,1,1,"dummy"
"24691",0,0,1,1,"dummy"
"24692",0,0,1,1,"dummy"
"24693",0,0,1,1,"dummy"
"24694",0,0,1,1,"dummy"
"24695",0,0,1,1,"dummy"
"24696",0,0,1,1,"dummy"
"24697",0,0,1,1,"dummy"
"24698",0,0,1,1,"dummy"
"24699",0,0,1,1,"dummy"
"24700",0,0,1,1,"dummy"
"24743",0,0,1,1,"dummy"
"24756",0,1,0,1,"dummy"
"24757",0,1,0,1,"dummy"
"24758",0,0,0,0,"dummy"
"24759",0,0,1,1,"dummy"
"24762",11,17,2,30,"dummy"
"24763",0,0,1,1,"dummy"
"24764",16,11,1,28,"dummy"
"24765",2,2,0,4,"dummy"
"24766",3,3,0,6,"dummy"
"24767",2,2,0,4,"dummy"
"24800",12,17,6,35,"dummy"
"24805",3,0,0,3,"dummy"
"24806",0,2,1,3,"dummy"
"24807",0,0,1,1,"dummy"
"24808",1,3,1,5,"dummy"
"24809",0,0,1,1,"dummy"
"24810",1,0,1,2,"dummy"
"24811",1,0,2,3,"dummy"
"24812",0,0,1,1,"dummy"
"24813",3,0,1,4,"dummy"
"24814",0,0,1,1,"dummy"
"24815",0,0,1,1,"dummy"
"24816",0,2,1,3,"dummy"
"24817",0,2,0,2,"dummy"
"24818",0,2,0,2,"dummy"
"24819",0,0,2,2,"dummy"
"24820",5,0,0,5,"dummy"
"24821",2,6,2,10,"dummy"
"24822",0,1,0,1,"dummy"
"24823",0,0,1,1,"dummy"
"24850",0,0,1,1,"dummy"
"24851",0,0,1,1,"dummy"
"24852",1,2,2,5,"dummy"
"24853",0,0,3,3,"dummy"
"24854",2,2,0,4,"dummy"
"24855",0,1,0,1,"dummy"
"24865",2,2,0,4,"dummy"
"24879",1,0,0,1,"dummy"
"24880",0,1,0,1,"dummy"
"24881",1,0,0,1,"dummy"
"24882",0,1,0,1,"dummy"
"24883",0,0,1,1,"dummy"
"24884",0,0,1,1,"dummy"
"24885",0,0,1,1,"dummy"
"24886",1,0,0,1,"dummy"
"24887",0,0,1,1,"dummy"
"24888",0,1,0,1,"dummy"
"24829",1,1,2,4,"dummy"
"24832",0,0,0,0,"dummy"
"24833",0,0,1,1,"dummy"
"24834",0,0,0,0,"dummy"
"24835",0,0,1,1,"dummy"
"24836",0,2,0,2,"dummy"
"24837",0,0,1,1,"dummy"
"24838",0,0,1,1,"dummy"
"24839",2,2,0,4,"dummy"
"24840",3,9,1,13,"dummy"
"24841",0,0,1,1,"dummy"
"24842",0,3,0,3,"dummy"
"24843",1,0,0,1,"dummy"
"24844",0,1,0,1,"dummy"
"24845",0,0,1,1,"dummy"
"24846",2,0,0,2,"dummy"
"24857",0,1,0,1,"dummy"
"24858",0,2,0,2,"dummy"
"24859",6,0,2,8,"dummy"
"24860",0,0,1,1,"dummy"
"24861",4,0,2,6,"dummy"
"24867",0,16,0,16,"dummy"
"24868",0,0,2,2,"dummy"
"24874",0,0,2,2,"dummy"
"24875",0,0,2,2,"dummy"
"24892",8,24,6,38,"dummy"
"24894",4,5,2,11,"dummy"
"24899",0,0,5,5,"dummy"
"24907",2,1,1,4,"dummy"
"24908",0,1,0,1,"dummy"
"24910",1,2,1,4,"dummy"
"24911",0,0,0,0,"dummy"
"24912",0,5,0,5,"dummy"
"24913",0,0,3,3,"dummy"
"24914",0,1,0,1,"dummy"
"24915",0,1,0,1,"dummy"
"24918",3,0,0,3,"dummy"
"24919",0,0,1,1,"dummy"
"24932",0,1,0,1,"dummy"
"24933",0,1,0,1,"dummy"
"24934",0,0,1,1,"dummy"
"24935",0,1,0,1,"dummy"
"24936",0,0,1,1,"dummy"
"24937",0,0,1,1,"dummy"
"24938",0,0,1,1,"dummy"
"24941",3,19,0,22,"dummy"
"24942",0,0,0,0,"dummy"
"24960",6,4,1,11,"dummy"
"24961",1,0,0,1,"dummy"
"24962",0,1,0,1,"dummy"
"24963",0,0,1,1,"dummy"
"24964",0,0,1,1,"dummy"
"24965",2,2,0,4,"dummy"
"24966",1,4,0,5,"dummy"
"24967",0,2,0,2,"dummy"
"24968",0,1,0,1,"dummy"
"24969",6,0,0,6,"dummy"
"24970",0,7,0,7,"dummy"
"24971",1,0,0,1,"dummy"
"24972",0,0,0,0,"dummy"
"24975",1,14,2,17,"dummy"
"24976",19,0,3,22,"dummy"
"24978",2,9,3,14,"dummy"
"24979",9,2,1,12,"dummy"
"24981",6,17,4,27,"dummy"
"24982",12,0,5,17,"dummy"
"24983",1,3,1,5,"dummy"
"24993",2,0,0,2,"dummy"
"24994",0,0,0,0,"dummy"
"24995",1,0,0,1,"dummy"
"24997",3,3,0,6,"dummy"
"24999",0,0,1,1,"dummy"
"25005",0,3,0,3,"dummy"
"25006",6,3,0,9,"dummy"
"25007",0,5,0,5,"dummy"
"25008",5,0,0,5,"dummy"
"25009",3,7,0,10,"dummy"
"25010",0,2,1,3,"dummy"
"25011",1,0,1,2,"dummy"
"25012",0,3,1,4,"dummy"
"25013",2,1,0,3,"dummy"
"25014",8,2,0,10,"dummy"
"25015",0,5,0,5,"dummy"
"25016",0,1,1,2,"dummy"
"25017",0,0,1,1,"dummy"
"25018",0,1,0,1,"dummy"
"25019",0,1,0,1,"dummy"
"25020",0,1,0,1,"dummy"
"25021",0,2,0,2,"dummy"
"25022",1,0,0,1,"dummy"
"25023",0,1,0,1,"dummy"
"25024",0,1,0,1,"dummy"
"25025",0,2,0,2,"dummy"
"25026",0,1,0,1,"dummy"
"25029",0,0,1,1,"dummy"
"25038",0,5,0,5,"dummy"
"25039",0,3,2,5,"dummy"
"25040",7,2,0,9,"dummy"
"25041",0,0,1,1,"dummy"
"25042",0,1,0,1,"dummy"
"25043",1,2,1,4,"dummy"
"25044",0,0,1,1,"dummy"
"25045",2,12,5,19,"dummy"
"25046",0,0,0,0,"dummy"
"25047",26,19,2,47,"dummy"
"25048",6,12,2,20,"dummy"
"25049",3,5,1,9,"dummy"
"25050",13,3,0,16,"dummy"
"25051",1,2,2,5,"dummy"
"25052",2,1,0,3,"dummy"
"25053",0,0,1,1,"dummy"
"25054",2,17,1,20,"dummy"
"25055",2,5,0,7,"dummy"
"25056",4,0,2,6,"dummy"
"25057",5,3,3,11,"dummy"
"25058",0,0,1,1,"dummy"
"25060",59,59,1,119,"dummy"
"25065",0,0,1,1,"dummy"
"25066",2,2,3,7,"dummy"
"25091",0,0,0,0,"dummy"
"25092",0,0,1,1,"dummy"
"25093",7,1,2,10,"dummy"
"25095",2,2,1,5,"dummy"
"25098",2,5,2,9,"dummy"
"25100",0,0,1,1,"dummy"
"25101",0,0,1,1,"dummy"
"25102",0,0,1,1,"dummy"
"25103",0,0,0,0,"dummy"
"25104",0,0,1,1,"dummy"
"25106",0,0,1,1,"dummy"
"25107",1,4,1,6,"dummy"
"25108",3,5,3,11,"dummy"
"25109",0,4,0,4,"dummy"
"25110",0,1,0,1,"dummy"
"25111",0,10,0,10,"dummy"
"25112",10,10,0,20,"dummy"
"25113",2,5,1,8,"dummy"
"25115",1,7,0,8,"dummy"
"25116",1,1,2,4,"dummy"
"25117",0,0,1,1,"dummy"
"25119",0,1,0,1,"dummy"
"25120",0,13,0,13,"dummy"
"25121",0,3,0,3,"dummy"
"25122",0,1,0,1,"dummy"
"25123",0,0,0,0,"dummy"
"25124",1,0,0,1,"dummy"
"25125",0,1,0,1,"dummy"
"25126",0,1,0,1,"dummy"
"25127",0,1,0,1,"dummy"
"25128",0,1,0,1,"dummy"
"25129",0,1,0,1,"dummy"
"25132",2,0,0,2,"dummy"
"25134",0,0,1,1,"dummy"
"25135",0,0,2,2,"dummy"
"25136",0,0,1,1,"dummy"
"25137",0,0,1,1,"dummy"
"25138",0,0,1,1,"dummy"
"25140",0,2,0,2,"dummy"
"25142",0,34,0,34,"dummy"
"25143",4,25,0,29,"dummy"
"25144",0,0,1,1,"dummy"
"25145",2,25,0,27,"dummy"
"25146",3,13,1,17,"dummy"
"25147",0,0,0,0,"dummy"
"25148",0,10,12,22,"dummy"
"25149",0,5,0,5,"dummy"
"25150",0,4,0,4,"dummy"
"25152",0,4,2,6,"dummy"
"25155",0,0,3,3,"dummy"
"25157",0,0,0,0,"dummy"
"25158",0,0,0,0,"dummy"
"25162",0,0,1,1,"dummy"
"25163",0,0,3,3,"dummy"
"25164",1,0,0,1,"dummy"
"25165",0,0,1,1,"dummy"
"25166",1,0,1,2,"dummy"
"25167",0,0,0,0,"dummy"
"25168",0,0,0,0,"dummy"
"25169",0,0,0,0,"dummy"
"25170",0,0,0,0,"dummy"
"25171",1,0,0,1,"dummy"
"25173",0,1,0,1,"dummy"
"25174",0,0,1,1,"dummy"
"25175",0,0,1,1,"dummy"
"25176",0,0,1,1,"dummy"
"25177",0,0,1,1,"dummy"
"25178",0,0,1,1,"dummy"
"25179",0,0,2,2,"dummy"
"25182",0,0,1,1,"dummy"
"25183",0,6,1,7,"dummy"
"25184",0,0,0,0,"dummy"
"25185",0,2,0,2,"dummy"
"25187",0,0,1,1,"dummy"
"25189",0,0,1,1,"dummy"
"25190",0,0,0,0,"dummy"
"25191",0,2,0,2,"dummy"
"25192",0,0,1,1,"dummy"
"25193",0,0,0,0,"dummy"
"25194",0,0,0,0,"dummy"
"25195",2,0,0,2,"dummy"
"25196",0,0,0,0,"dummy"
"25197",0,1,0,1,"dummy"
"25198",0,0,0,0,"dummy"
"25199",0,0,0,0,"dummy"
"25200",0,1,1,2,"dummy"
"25201",1,0,1,2,"dummy"
"25202",0,0,0,0,"dummy"
"25206",0,2,0,2,"dummy"
"25207",0,0,1,1,"dummy"
"25208",0,0,0,0,"dummy"
"25225",0,1,0,1,"dummy"
"25228",1,1,1,3,"dummy"
"25229",0,2,0,2,"dummy"
"25230",0,3,0,3,"dummy"
"25231",0,16,1,17,"dummy"
"25247",0,1,0,1,"dummy"
"25248",2,1,0,3,"dummy"
"25249",0,1,0,1,"dummy"
"25250",0,0,1,1,"dummy"
"25251",0,2,0,2,"dummy"
"25252",0,2,0,2,"dummy"
"25253",0,1,0,1,"dummy"
"25254",0,2,0,2,"dummy"
"25255",0,1,0,1,"dummy"
"25256",3,3,1,7,"dummy"
"25257",1,3,2,6,"dummy"
"25258",0,0,1,1,"dummy"
"25259",0,0,1,1,"dummy"
"25263",0,0,0,0,"dummy"
"25264",0,0,0,0,"dummy"
"25265",0,0,0,0,"dummy"
"25266",0,1,0,1,"dummy"
"25267",0,0,0,0,"dummy"
"25268",0,0,0,0,"dummy"
"25269",0,0,0,0,"dummy"
"25270",0,0,0,0,"dummy"
"25271",0,0,0,0,"dummy"
"25272",0,0,0,0,"dummy"
"25273",0,0,0,0,"dummy"
"25274",0,1,0,1,"dummy"
"25276",0,5,1,6,"dummy"
"25277",4,8,0,12,"dummy"
"25278",0,3,0,3,"dummy"
"25280",2,0,0,2,"dummy"
"25283",0,1,0,1,"dummy"
"25284",0,0,1,1,"dummy"
"25285",1,0,0,1,"dummy"
"25287",0,2,0,2,"dummy"
"25289",1,0,0,1,"dummy"
"25296",2,3,0,5,"dummy"
"25297",0,0,2,2,"dummy"
"25299",0,0,1,1,"dummy"
"25300",19,14,4,37,"dummy"
"25302",0,0,0,0,"dummy"
"25303",0,2,0,2,"dummy"
"25304",0,0,0,0,"dummy"
"25305",0,0,1,1,"dummy"
"25306",0,0,2,2,"dummy"
"25307",0,0,2,2,"dummy"
"25308",0,0,1,1,"dummy"
"25309",0,0,0,0,"dummy"
"25312",2,2,1,5,"dummy"
"25313",0,2,0,2,"dummy"
"25316",0,3,0,3,"dummy"
"25317",0,0,1,1,"dummy"
"25318",5,0,2,7,"dummy"
"25320",0,1,0,1,"dummy"
"25322",1,0,1,2,"dummy"
"25323",0,1,0,1,"dummy"
"25324",0,1,1,2,"dummy"
"25326",0,0,1,1,"dummy"
"25327",0,1,0,1,"dummy"
"25330",0,0,1,1,"dummy"
"25331",0,0,1,1,"dummy"
"25332",3,1,0,4,"dummy"
"25333",4,30,5,39,"dummy"
"25334",2,0,0,2,"dummy"
"25335",0,0,1,1,"dummy"
"25336",0,0,1,1,"dummy"
"25337",1,1,3,5,"dummy"
"25338",20,22,7,49,"dummy"
"25339",2,0,0,2,"dummy"
"25340",0,1,1,2,"dummy"
"25341",0,1,0,1,"dummy"
"25342",0,0,1,1,"dummy"
"25343",0,0,0,0,"dummy"
"25344",0,0,0,0,"dummy"
"25345",0,0,1,1,"dummy"
"25348",0,1,1,2,"dummy"
"25351",0,1,0,1,"dummy"
"25361",0,0,2,2,"dummy"
"25362",4,0,0,4,"dummy"
"25364",0,3,0,3,"dummy"
"25366",0,0,1,1,"dummy"
"25367",0,0,1,1,"dummy"
"25368",0,0,0,0,"dummy"
"25369",0,0,1,1,"dummy"
"25372",0,0,1,1,"dummy"
"25390",0,0,0,0,"dummy"
"25391",1,0,0,1,"dummy"
"25392",4,0,0,4,"dummy"
"25394",1,0,1,2,"dummy"
"25396",2,0,0,2,"dummy"
"25405",3,0,0,3,"dummy"
"25406",0,0,1,1,"dummy"
"25444",0,6,1,7,"dummy"
"25446",0,0,0,0,"dummy"
"25447",0,0,0,0,"dummy"
"25448",0,0,0,0,"dummy"
"25449",0,0,0,0,"dummy"
"25451",1,3,0,4,"dummy"
"25452",1,1,0,2,"dummy"
"25453",0,4,1,5,"dummy"
"25454",0,0,1,1,"dummy"
"25455",4,0,1,5,"dummy"
"25456",1,4,0,5,"dummy"
"25459",1,5,1,7,"dummy"
"25460",5,1,1,7,"dummy"
"25461",0,2,0,2,"dummy"
"25463",2,4,0,6,"dummy"
"25464",0,2,0,2,"dummy"
"25465",0,2,0,2,"dummy"
"25466",10,2,0,12,"dummy"
"25467",0,2,0,2,"dummy"
"25472",1,3,2,6,"dummy"
"25473",0,0,1,1,"dummy"
"25474",29,4,2,35,"dummy"
"25475",0,5,2,7,"dummy"
"25476",1,0,0,1,"dummy"
"25477",0,1,0,1,"dummy"
"25478",1,0,3,4,"dummy"
"25480",0,1,0,1,"dummy"
"25481",0,0,0,0,"dummy"
"25482",0,1,0,1,"dummy"
"25483",0,18,0,18,"dummy"
"25484",2,0,0,2,"dummy"
"25485",0,0,0,0,"dummy"
"25486",0,2,0,2,"dummy"
"25487",0,0,0,0,"dummy"
"25488",0,0,0,0,"dummy"
"25489",1,0,0,1,"dummy"
"25490",0,0,0,0,"dummy"
"25494",2,5,2,9,"dummy"
"25496",0,0,3,3,"dummy"
"25497",0,1,0,1,"dummy"
"25498",1,3,1,5,"dummy"
"25500",0,3,0,3,"dummy"
"25501",2,0,1,3,"dummy"
"25502",3,3,0,6,"dummy"
"25503",0,2,0,2,"dummy"
"25504",0,0,1,1,"dummy"
"25507",0,1,0,1,"dummy"
"25508",1,0,1,2,"dummy"
"25509",0,1,0,1,"dummy"
"25511",0,0,2,2,"dummy"
"25512",0,0,2,2,"dummy"
"25513",0,2,0,2,"dummy"
"25515",0,2,2,4,"dummy"
"25518",1,4,0,5,"dummy"
"25519",0,0,1,1,"dummy"
"25520",0,0,3,3,"dummy"
"25525",0,1,0,1,"dummy"
"25526",0,1,0,1,"dummy"
"25527",0,1,0,1,"dummy"
"25531",0,0,1,1,"dummy"
"25532",0,2,1,3,"dummy"
"25533",0,1,2,3,"dummy"
"25534",0,0,1,1,"dummy"
"25538",10,6,3,19,"dummy"
"25551",0,0,1,1,"dummy"
"25553",2,0,0,2,"dummy"
"25554",0,0,0,0,"dummy"
"25556",0,0,1,1,"dummy"
"25570",0,3,0,3,"dummy"
"25571",0,1,0,1,"dummy"
"25573",0,0,1,1,"dummy"
"25576",0,0,1,1,"dummy"
"25577",0,0,1,1,"dummy"
"25583",0,1,0,1,"dummy"
"25584",0,1,0,1,"dummy"
"25585",0,0,2,2,"dummy"
"25586",3,3,2,8,"dummy"
"25587",3,3,2,8,"dummy"
"25589",0,0,1,1,"dummy"
"25590",0,0,1,1,"dummy"
"25591",0,1,0,1,"dummy"
"25592",0,0,1,1,"dummy"
"25593",0,0,1,1,"dummy"
"25594",1,3,0,4,"dummy"
"25595",0,2,1,3,"dummy"
"25596",0,0,1,1,"dummy"
"25597",0,0,1,1,"dummy"
"25604",0,0,1,1,"dummy"
"25605",3,2,0,5,"dummy"
"25606",2,2,0,4,"dummy"
"25610",0,2,0,2,"dummy"
"25611",0,0,3,3,"dummy"
"25615",0,0,1,1,"dummy"
"25616",0,0,1,1,"dummy"
"25621",0,1,0,1,"dummy"
"25622",0,0,1,1,"dummy"
"25623",0,0,1,1,"dummy"
"25624",0,1,2,3,"dummy"
"25625",0,0,1,1,"dummy"
"25626",0,0,1,1,"dummy"
"25629",0,0,1,1,"dummy"
"25631",0,1,0,1,"dummy"
"25632",1,0,1,2,"dummy"
"25633",0,1,1,2,"dummy"
"25634",0,1,0,1,"dummy"
"25635",0,0,1,1,"dummy"
"25639",0,0,1,1,"dummy"
"25641",0,11,0,11,"dummy"
"25642",1,1,0,2,"dummy"
"25643",0,0,1,1,"dummy"
"25644",1,0,0,1,"dummy"
"25645",6,0,1,7,"dummy"
"25646",0,2,0,2,"dummy"
"25647",1,0,0,1,"dummy"
"25648",2,2,1,5,"dummy"
"25649",1,0,0,1,"dummy"
"25650",0,0,0,0,"dummy"
"25651",0,0,1,1,"dummy"
"25654",0,0,2,2,"dummy"
"25659",1,1,0,2,"dummy"
"25660",5,4,2,11,"dummy"
"25663",0,1,2,3,"dummy"
"25664",1,1,1,3,"dummy"
"25665",0,2,1,3,"dummy"
"25666",0,2,1,3,"dummy"
"25667",0,1,0,1,"dummy"
"25668",0,0,0,0,"dummy"
"25669",6,4,1,11,"dummy"
"25670",3,0,0,3,"dummy"
"25671",0,0,1,1,"dummy"
"25672",0,0,1,1,"dummy"
"25673",0,1,5,6,"dummy"
"25675",0,0,2,2,"dummy"
"25676",0,0,1,1,"dummy"
"25677",0,0,1,1,"dummy"
"25678",0,0,2,2,"dummy"
"25679",0,0,1,1,"dummy"
"25680",0,0,0,0,"dummy"
"25681",0,0,0,0,"dummy"
"25683",0,2,0,2,"dummy"
"25684",0,2,0,2,"dummy"
"25685",0,2,0,2,"dummy"
"25686",2,0,0,2,"dummy"
"25689",0,0,1,1,"dummy"
"25690",0,1,0,1,"dummy"
"25702",0,3,4,7,"dummy"
"25703",0,0,3,3,"dummy"
"25704",0,0,1,1,"dummy"
"25707",1,0,0,1,"dummy"
"25708",3,17,2,22,"dummy"
"25709",0,1,0,1,"dummy"
"25710",0,1,0,1,"dummy"
"25711",0,2,0,2,"dummy"
"25712",2,4,2,8,"dummy"
"25713",0,1,0,1,"dummy"
"25714",0,1,0,1,"dummy"
"25715",29,12,4,45,"dummy"
"25719",0,0,3,3,"dummy"
"25720",0,0,1,1,"dummy"
"25721",0,0,1,1,"dummy"
"25722",0,0,1,1,"dummy"
"25723",0,0,1,1,"dummy"
"25724",0,0,1,1,"dummy"
"25727",1,0,0,1,"dummy"
"25731",0,1,0,1,"dummy"
"25734",0,0,1,1,"dummy"
"25735",0,1,1,2,"dummy"
"25736",0,0,1,1,"dummy"
"25737",0,0,1,1,"dummy"
"25738",0,0,1,1,"dummy"
"25741",0,2,2,4,"dummy"
"25745",2,6,0,8,"dummy"
"25764",0,0,1,1,"dummy"
"25765",29,2,1,32,"dummy"
"25766",1,0,0,1,"dummy"
"25770",0,6,0,6,"dummy"
"25773",0,1,0,1,"dummy"
"25774",2,3,0,5,"dummy"
"25775",0,0,0,0,"dummy"
"25776",0,2,1,3,"dummy"
"25779",6,0,0,6,"dummy"
"25780",2,5,2,9,"dummy"
"25783",0,1,1,2,"dummy"
"25784",0,0,0,0,"dummy"
"25785",0,1,0,1,"dummy"
"25786",0,3,0,3,"dummy"
"25787",13,12,1,26,"dummy"
"25789",5,0,1,6,"dummy"
"25791",0,0,1,1,"dummy"
"25794",0,0,1,1,"dummy"
"25795",0,0,1,1,"dummy"
"25797",26,6,0,32,"dummy"
"25798",5,3,1,9,"dummy"
"25799",0,1,0,1,"dummy"
"25800",0,0,1,1,"dummy"
"25801",0,0,1,1,"dummy"
"25802",0,3,0,3,"dummy"
"25803",2,5,0,7,"dummy"
"25804",2,4,0,6,"dummy"
"25805",16,0,1,17,"dummy"
"25806",0,16,1,17,"dummy"
"25807",9,25,0,34,"dummy"
"25808",2,2,0,4,"dummy"
"25809",32,9,0,41,"dummy"
"25810",0,4,0,4,"dummy"
"25811",14,20,0,34,"dummy"
"25812",0,1,0,1,"dummy"
"25814",6,1,1,8,"dummy"
"25817",0,0,1,1,"dummy"
"25819",0,0,0,0,"dummy"
"25820",0,1,0,1,"dummy"
"25821",0,0,1,1,"dummy"
"25822",0,8,1,9,"dummy"
"25823",1,1,0,2,"dummy"
"25824",1,3,0,4,"dummy"
"25825",0,1,0,1,"dummy"
"25826",0,0,1,1,"dummy"
"25829",0,9,0,9,"dummy"
"25830",2,2,0,4,"dummy"
"25831",1,0,1,2,"dummy"
"25833",0,1,0,1,"dummy"
"25834",0,0,1,1,"dummy"
"25836",2,4,0,6,"dummy"
"25837",0,2,0,2,"dummy"
"25838",0,2,0,2,"dummy"
"25839",10,2,0,12,"dummy"
"25840",0,2,0,2,"dummy"
"25841",0,0,0,0,"dummy"
"25842",0,0,3,3,"dummy"
"25843",0,5,0,5,"dummy"
"25847",0,5,5,10,"dummy"
"25848",5,0,5,10,"dummy"
"25849",0,5,5,10,"dummy"
"25850",6,4,0,10,"dummy"
"25854",0,0,1,1,"dummy"
"25856",0,1,1,2,"dummy"
"25857",0,1,0,1,"dummy"
"25858",0,0,1,1,"dummy"
"25859",0,2,0,2,"dummy"
"25860",2,0,1,3,"dummy"
"25861",3,3,1,7,"dummy"
"25862",0,1,0,1,"dummy"
"25863",3,1,1,5,"dummy"
"25864",0,1,0,1,"dummy"
"25866",0,2,0,2,"dummy"
"25867",0,1,0,1,"dummy"
"25870",0,0,1,1,"dummy"
"25871",0,0,1,1,"dummy"
"25872",0,0,1,1,"dummy"
"25873",0,0,2,2,"dummy"
"25874",0,0,1,1,"dummy"
"25876",0,5,1,6,"dummy"
"25883",0,1,3,4,"dummy"
"25884",0,0,1,1,"dummy"
"25885",0,0,1,1,"dummy"
"25890",0,1,0,1,"dummy"
"25891",0,0,1,1,"dummy"
"25893",0,0,0,0,"dummy"
"25894",1,0,0,1,"dummy"
"25895",0,0,1,1,"dummy"
"25896",1,1,0,2,"dummy"
"25897",0,0,1,1,"dummy"
"25898",0,1,0,1,"dummy"
"25899",0,2,0,2,"dummy"
"25900",0,0,2,2,"dummy"
"25905",5,4,3,12,"dummy"
"25907",0,1,0,1,"dummy"
"25910",9,12,1,22,"dummy"
"25911",2,0,0,2,"dummy"
"25912",19,16,0,35,"dummy"
"25913",3,2,0,5,"dummy"
"25914",2,3,0,5,"dummy"
"25915",4,4,0,8,"dummy"
"25918",3,3,0,6,"dummy"
"25919",0,2,0,2,"dummy"
"25920",0,1,0,1,"dummy"
"25921",0,1,0,1,"dummy"
"25922",0,1,0,1,"dummy"
"25923",0,1,0,1,"dummy"
"25924",1,0,0,1,"dummy"
"25925",0,1,0,1,"dummy"
"25926",1,1,0,2,"dummy"
"25927",0,1,0,1,"dummy"
"25930",0,1,0,1,"dummy"
"25931",0,2,0,2,"dummy"
"25932",0,1,0,1,"dummy"
"25938",0,1,0,1,"dummy"
"25939",0,0,1,1,"dummy"
"25940",2,0,0,2,"dummy"
"25941",0,2,2,4,"dummy"
"25942",0,0,1,1,"dummy"
"25943",0,1,1,2,"dummy"
"25944",0,0,1,1,"dummy"
"25945",8,8,2,18,"dummy"
"25949",0,0,1,1,"dummy"
"25950",2,0,2,4,"dummy"
"25951",2,0,0,2,"dummy"
"25952",0,2,1,3,"dummy"
"25953",0,0,1,1,"dummy"
"25957",0,1,0,1,"dummy"
"25958",0,4,1,5,"dummy"
"25959",1,0,0,1,"dummy"
"25961",1,0,0,1,"dummy"
"25962",6,2,0,8,"dummy"
"25964",2,3,2,7,"dummy"
"25966",0,1,0,1,"dummy"
"25967",0,3,0,3,"dummy"
"25968",2,0,2,4,"dummy"
"25970",0,0,1,1,"dummy"
"25971",2,9,3,14,"dummy"
"25974",0,0,1,1,"dummy"
"25977",1,0,0,1,"dummy"
"25978",1,0,1,2,"dummy"
"25979",0,0,0,0,"dummy"
"25980",1,3,0,4,"dummy"
"25981",0,0,1,1,"dummy"
"25982",0,0,0,0,"dummy"
"25983",6,3,3,12,"dummy"
"25984",3,2,0,5,"dummy"
"25985",0,0,1,1,"dummy"
"25987",0,0,1,1,"dummy"
"25990",4,0,0,4,"dummy"
"25991",0,0,0,0,"dummy"
"25992",2,1,0,3,"dummy"
"25993",0,0,0,0,"dummy"
"25994",0,0,1,1,"dummy"
"25996",1,2,0,3,"dummy"
"25997",0,1,0,1,"dummy"
"25998",0,0,1,1,"dummy"
"25999",0,1,0,1,"dummy"
"26000",0,0,0,0,"dummy"
"26001",0,1,0,1,"dummy"
"26014",0,2,0,2,"dummy"
"26015",0,1,0,1,"dummy"
"26016",0,1,0,1,"dummy"
"26019",0,2,4,6,"dummy"
"26020",0,1,5,6,"dummy"
"26021",0,0,0,0,"dummy"
"26022",0,0,3,3,"dummy"
"26023",0,1,3,4,"dummy"
"26024",0,1,0,1,"dummy"
"26026",0,0,3,3,"dummy"
"26027",2,3,0,5,"dummy"
"26029",0,1,0,1,"dummy"
"26030",0,1,0,1,"dummy"
"26031",2,1,1,4,"dummy"
"26035",0,3,0,3,"dummy"
"26037",1,1,1,3,"dummy"
"26038",0,0,1,1,"dummy"
"26039",5,1,3,9,"dummy"
"26040",0,2,0,2,"dummy"
"26041",0,0,1,1,"dummy"
"26042",0,0,1,1,"dummy"
"26043",0,1,1,2,"dummy"
"26045",2,2,3,7,"dummy"
"26046",0,0,0,0,"dummy"
"26058",2,5,2,9,"dummy"
"26061",0,1,1,2,"dummy"
"26062",1,0,0,1,"dummy"
"26063",3,0,0,3,"dummy"
"26064",0,4,1,5,"dummy"
"26065",6,21,1,28,"dummy"
"26066",0,0,1,1,"dummy"
"26067",1,0,0,1,"dummy"
"26068",0,3,0,3,"dummy"
"26069",0,1,0,1,"dummy"
"26070",1,5,0,6,"dummy"
"26071",0,0,1,1,"dummy"
"26072",0,3,0,3,"dummy"
"26073",0,2,0,2,"dummy"
"26074",7,0,1,8,"dummy"
"26075",9,6,1,16,"dummy"
"26076",1,0,1,2,"dummy"
"26077",0,0,0,0,"dummy"
"26078",0,0,0,0,"dummy"
"26079",0,0,1,1,"dummy"
"26080",0,2,0,2,"dummy"
"26082",0,2,0,2,"dummy"
"26083",0,2,0,2,"dummy"
"26084",0,1,0,1,"dummy"
"26085",0,0,2,2,"dummy"
"26087",1,1,6,8,"dummy"
"26119",1,3,1,5,"dummy"
"26120",3,5,0,8,"dummy"
"26121",1,2,3,6,"dummy"
"26122",0,0,2,2,"dummy"
"26123",0,0,2,2,"dummy"
"26125",1,0,0,1,"dummy"
"26126",0,2,2,4,"dummy"
"26127",1,0,0,1,"dummy"
"26129",0,2,1,3,"dummy"
"26130",1,2,0,3,"dummy"
"26131",0,0,1,1,"dummy"
"26132",0,11,0,11,"dummy"
"26133",0,8,2,10,"dummy"
"26134",0,2,1,3,"dummy"
"26135",0,1,0,1,"dummy"
"26140",11,1,2,14,"dummy"
"26141",0,0,0,0,"dummy"
"26177",1,1,0,2,"dummy"
"26178",0,1,2,3,"dummy"
"26179",1,0,0,1,"dummy"
"26184",2,0,1,3,"dummy"
"26185",0,0,1,1,"dummy"
"26186",0,0,1,1,"dummy"
"26211",0,0,1,1,"dummy"
"26212",0,0,0,0,"dummy"
"26213",0,0,0,0,"dummy"
"26214",0,0,0,0,"dummy"
"26215",0,0,1,1,"dummy"
"26145",0,0,0,0,"dummy"
"26167",0,1,0,1,"dummy"
"26168",0,1,0,1,"dummy"
"26169",0,1,0,1,"dummy"
"26170",0,3,0,3,"dummy"
"26171",0,1,0,1,"dummy"
"26188",3,0,0,3,"dummy"
"26189",0,1,0,1,"dummy"
"26190",3,11,4,18,"dummy"
"26191",4,22,5,31,"dummy"
"26192",0,23,1,24,"dummy"
"26193",5,4,0,9,"dummy"
"26194",41,4,8,53,"dummy"
"26195",0,0,3,3,"dummy"
"26196",0,0,0,0,"dummy"
"26197",0,0,1,1,"dummy"
"26198",0,0,0,0,"dummy"
"26199",1,4,1,6,"dummy"
"26200",0,0,1,1,"dummy"
"26203",0,2,0,2,"dummy"
"26204",0,0,0,0,"dummy"
"26205",0,0,0,0,"dummy"
"26206",4,1,0,5,"dummy"
"26207",1,0,0,1,"dummy"
"26208",0,0,0,0,"dummy"
"26209",0,0,0,0,"dummy"
"26217",0,0,0,0,"dummy"
"26218",0,0,0,0,"dummy"
"26228",9,0,0,9,"dummy"
"26229",0,1,0,1,"dummy"
"26230",0,1,0,1,"dummy"
"26235",2,0,1,3,"dummy"
"26236",0,0,1,1,"dummy"
"26237",0,0,1,1,"dummy"
"26239",0,0,1,1,"dummy"
"26241",2,0,2,4,"dummy"
"26242",1,3,0,4,"dummy"
"26243",3,1,0,4,"dummy"
"26246",1,0,0,1,"dummy"
"26247",0,0,1,1,"dummy"
"26248",0,1,0,1,"dummy"
"26249",0,1,0,1,"dummy"
"26251",0,0,1,1,"dummy"
"26252",3,0,0,3,"dummy"
"26253",0,1,0,1,"dummy"
"26254",17,2,0,19,"dummy"
"26255",0,0,2,2,"dummy"
"26256",0,1,1,2,"dummy"
"26258",0,0,0,0,"dummy"
"26259",0,0,1,1,"dummy"
"26262",0,0,1,1,"dummy"
"26263",0,20,1,21,"dummy"
"26265",0,1,2,3,"dummy"
"26266",2,2,0,4,"dummy"
"26268",0,7,0,7,"dummy"
"26271",0,0,1,1,"dummy"
"26272",0,0,1,1,"dummy"
"26273",0,0,1,1,"dummy"
"26274",0,0,1,1,"dummy"
"26275",0,0,1,1,"dummy"
"26286",0,0,1,1,"dummy"
"26289",1,5,3,9,"dummy"
"26290",1,0,0,1,"dummy"
"26292",0,1,0,1,"dummy"
"26293",0,1,0,1,"dummy"
"26294",0,0,1,1,"dummy"
"26295",0,0,3,3,"dummy"
"26296",0,0,1,1,"dummy"
"26297",0,1,1,2,"dummy"
"26298",0,0,2,2,"dummy"
"26299",0,0,1,1,"dummy"
"26300",0,0,1,1,"dummy"
"26301",0,0,1,1,"dummy"
"26302",3,9,3,15,"dummy"
"26303",0,0,1,1,"dummy"
"26304",0,0,1,1,"dummy"
"26305",0,0,1,1,"dummy"
"26306",0,0,1,1,"dummy"
"26307",0,0,1,1,"dummy"
"26308",0,0,2,2,"dummy"
"26309",0,0,1,1,"dummy"
"26311",0,4,0,4,"dummy"
"26312",0,2,0,2,"dummy"
"26331",2,3,1,6,"dummy"
"26332",4,5,2,11,"dummy"
"26334",0,0,2,2,"dummy"
"26335",0,0,0,0,"dummy"
"26339",0,4,0,4,"dummy"
"26341",0,0,4,4,"dummy"
"26342",8,0,0,8,"dummy"
"26344",0,0,1,1,"dummy"
"26345",1,4,4,9,"dummy"
"26346",6,1,0,7,"dummy"
"26348",1,4,0,5,"dummy"
"26349",8,4,2,14,"dummy"
"26350",0,0,0,0,"dummy"
"26351",0,0,4,4,"dummy"
"26352",0,0,1,1,"dummy"
"26358",0,1,0,1,"dummy"
"26359",0,1,1,2,"dummy"
"26361",1,10,0,11,"dummy"
"26362",22,14,3,39,"dummy"
"26363",0,0,1,1,"dummy"
"26364",0,0,1,1,"dummy"
"26365",11,8,1,20,"dummy"
"26366",0,0,1,1,"dummy"
"26367",0,0,1,1,"dummy"
"26368",0,1,1,2,"dummy"
"26373",7,0,1,8,"dummy"
"26374",0,2,1,3,"dummy"
"26375",1,3,1,5,"dummy"
"26378",0,0,6,6,"dummy"
"26379",0,0,6,6,"dummy"
"26380",0,0,6,6,"dummy"
"26383",2,0,1,3,"dummy"
"26384",0,0,1,1,"dummy"
"26385",0,5,0,5,"dummy"
"26386",5,0,0,5,"dummy"
"26387",0,2,0,2,"dummy"
"26388",0,3,2,5,"dummy"
"26389",2,0,0,2,"dummy"
"26390",0,0,2,2,"dummy"
"26391",0,1,0,1,"dummy"
"26392",0,0,1,1,"dummy"
"26393",0,1,0,1,"dummy"
"26394",0,10,0,10,"dummy"
"26395",34,2,0,36,"dummy"
"26396",0,0,1,1,"dummy"
"26397",0,0,1,1,"dummy"
"26398",0,0,1,1,"dummy"
"26399",0,0,0,0,"dummy"
"26400",0,0,1,1,"dummy"
"26401",0,1,0,1,"dummy"
"26402",0,0,1,1,"dummy"
"26403",0,0,1,1,"dummy"
"26406",0,0,1,1,"dummy"
"26408",0,0,1,1,"dummy"
"26409",0,0,1,1,"dummy"
"26411",0,0,0,0,"dummy"
"26412",0,1,0,1,"dummy"
"26413",0,1,0,1,"dummy"
"26414",0,1,0,1,"dummy"
"26415",0,0,0,0,"dummy"
"26416",0,1,0,1,"dummy"
"26417",2,2,0,4,"dummy"
"26418",0,5,1,6,"dummy"
"26419",0,0,0,0,"dummy"
"26420",15,15,0,30,"dummy"
"26421",0,0,0,0,"dummy"
"26422",0,1,0,1,"dummy"
"26423",0,0,1,1,"dummy"
"26424",0,0,2,2,"dummy"
"26426",1,5,0,6,"dummy"
"26427",6,2,1,9,"dummy"
"26428",0,1,0,1,"dummy"
"26433",0,1,4,5,"dummy"
"26434",0,0,1,1,"dummy"
"26436",1,2,0,3,"dummy"
"26438",3,5,0,8,"dummy"
"26439",1,4,0,5,"dummy"
"26440",0,0,1,1,"dummy"
"26441",0,3,0,3,"dummy"
"26442",0,0,1,1,"dummy"
"26443",1,3,0,4,"dummy"
"26444",0,0,1,1,"dummy"
"26445",0,0,1,1,"dummy"
"26446",0,0,0,0,"dummy"
"26447",0,4,2,6,"dummy"
"26448",2,2,0,4,"dummy"
"26449",3,5,1,9,"dummy"
"26450",0,2,0,2,"dummy"
"26451",0,2,1,3,"dummy"
"26452",2,2,0,4,"dummy"
"26453",2,1,3,6,"dummy"
"26454",3,0,0,3,"dummy"
"26456",0,0,2,2,"dummy"
"26457",0,1,0,1,"dummy"
"26458",0,2,0,2,"dummy"
"26459",0,1,0,1,"dummy"
"26460",0,1,0,1,"dummy"
"26461",0,1,0,1,"dummy"
"26462",0,0,1,1,"dummy"
"26463",0,0,1,1,"dummy"
"26466",1,1,1,3,"dummy"
"26470",0,7,0,7,"dummy"
"26471",2,4,1,7,"dummy"
"26472",0,0,2,2,"dummy"
"26473",0,5,0,5,"dummy"
"26476",0,2,0,2,"dummy"
"26477",0,0,1,1,"dummy"
"26478",4,4,0,8,"dummy"
"26480",0,0,3,3,"dummy"
"26481",1,1,0,2,"dummy"
"26482",1,1,0,2,"dummy"
"26484",0,1,0,1,"dummy"
"26485",1,0,0,1,"dummy"
"26486",0,9,2,11,"dummy"
"26487",9,0,2,11,"dummy"
"26488",0,3,2,5,"dummy"
"26489",0,1,0,1,"dummy"
"26490",0,5,0,5,"dummy"
"26491",1,0,0,1,"dummy"
"26493",2,2,1,5,"dummy"
"26511",0,1,0,1,"dummy"
"26512",1,0,0,1,"dummy"
"26513",0,0,1,1,"dummy"
"26517",4,4,0,8,"dummy"
"26518",0,2,0,2,"dummy"
"26519",0,0,1,1,"dummy"
"26520",0,3,0,3,"dummy"
"26521",2,2,0,4,"dummy"
"26522",0,0,0,0,"dummy"
"26534",0,0,1,1,"dummy"
"26546",1,1,0,2,"dummy"
"26548",1,1,1,3,"dummy"
"26549",0,0,1,1,"dummy"
"26551",0,0,1,1,"dummy"
"26552",0,0,1,1,"dummy"
"26553",0,0,1,1,"dummy"
"26557",0,14,0,14,"dummy"
"26558",3,1,2,6,"dummy"
"26559",0,0,1,1,"dummy"
"26560",0,2,3,5,"dummy"
"26562",11,4,3,18,"dummy"
"26563",4,2,0,6,"dummy"
"26564",0,4,0,4,"dummy"
"26565",2,0,0,2,"dummy"
"26566",2,4,0,6,"dummy"
"26568",0,0,0,0,"dummy"
"26569",1,4,1,6,"dummy"
"26570",8,5,3,16,"dummy"
"26571",2,5,2,9,"dummy"
"26572",0,1,0,1,"dummy"
"26573",3,9,3,15,"dummy"
"26574",1,0,0,1,"dummy"
"26576",0,1,1,2,"dummy"
"26577",0,2,0,2,"dummy"
"26578",0,0,1,1,"dummy"
"26579",6,14,5,25,"dummy"
"26580",0,0,1,1,"dummy"
"26581",10,16,6,32,"dummy"
"26582",10,1,0,11,"dummy"
"26583",3,9,4,16,"dummy"
"26584",0,0,2,2,"dummy"
"26585",4,4,1,9,"dummy"
"26586",0,2,2,4,"dummy"
"26587",0,0,1,1,"dummy"
"26588",0,0,0,0,"dummy"
"26589",8,6,3,17,"dummy"
"26590",0,0,0,0,"dummy"
"26591",0,2,0,2,"dummy"
"26592",0,2,0,2,"dummy"
"26593",0,1,0,1,"dummy"
"26594",2,1,0,3,"dummy"
"26595",2,2,0,4,"dummy"
"26596",0,0,1,1,"dummy"
"26601",0,2,0,2,"dummy"
"26602",0,6,0,6,"dummy"
"26605",0,3,0,3,"dummy"
"26606",3,3,0,6,"dummy"
"26607",0,1,0,1,"dummy"
"26608",0,1,0,1,"dummy"
"26609",2,0,0,2,"dummy"
"26610",0,0,1,1,"dummy"
"26611",0,0,1,1,"dummy"
"26612",2,9,2,13,"dummy"
"26613",0,4,0,4,"dummy"
"26614",0,0,1,1,"dummy"
"26623",0,0,1,1,"dummy"
"26624",0,0,1,1,"dummy"
"26625",0,0,1,1,"dummy"
"26626",0,0,0,0,"dummy"
"26627",0,1,0,1,"dummy"
"26628",0,0,1,1,"dummy"
"26629",0,1,1,2,"dummy"
"26630",0,0,1,1,"dummy"
"26631",0,0,1,1,"dummy"
"26632",0,0,1,1,"dummy"
"26637",1,2,0,3,"dummy"
"26638",1,0,0,1,"dummy"
"26639",0,1,2,3,"dummy"
"26640",0,0,0,0,"dummy"
"26641",1,0,2,3,"dummy"
"26642",0,0,1,1,"dummy"
"26643",12,0,2,14,"dummy"
"26647",2,1,0,3,"dummy"
"26648",0,0,1,1,"dummy"
"26649",0,3,0,3,"dummy"
"26650",1,2,0,3,"dummy"
"26651",0,1,0,1,"dummy"
"26655",0,1,0,1,"dummy"
"26656",0,2,0,2,"dummy"
"26659",0,2,0,2,"dummy"
"26660",1,3,0,4,"dummy"
"26661",0,1,1,2,"dummy"
"26662",2,2,1,5,"dummy"
"26663",2,7,0,9,"dummy"
"26665",7,7,1,15,"dummy"
"26667",7,0,1,8,"dummy"
"26671",0,1,0,1,"dummy"
"26672",0,0,2,2,"dummy"
"26673",0,0,1,1,"dummy"
"26674",3,4,2,9,"dummy"
"26676",0,0,0,0,"dummy"
"26679",0,6,0,6,"dummy"
"26680",0,0,2,2,"dummy"
"26681",3,4,1,8,"dummy"
"26683",5,0,0,5,"dummy"
"26684",2,5,1,8,"dummy"
"26686",2,2,0,4,"dummy"
"26687",0,3,0,3,"dummy"
"26688",0,1,0,1,"dummy"
"26689",0,6,0,6,"dummy"
"26696",2,0,0,2,"dummy"
"26698",0,1,1,2,"dummy"
"26699",0,0,1,1,"dummy"
"26700",15,5,5,25,"dummy"
"26703",0,2,0,2,"dummy"
"26704",0,1,0,1,"dummy"
"26706",2,4,0,6,"dummy"
"26707",0,2,0,2,"dummy"
"26708",0,2,0,2,"dummy"
"26709",10,2,0,12,"dummy"
"26710",0,2,0,2,"dummy"
"26711",0,0,0,0,"dummy"
"26713",1,3,0,4,"dummy"
"26714",0,1,0,1,"dummy"
"26715",0,2,0,2,"dummy"
"26716",0,0,1,1,"dummy"
"26717",0,0,1,1,"dummy"
"26718",0,0,1,1,"dummy"
"26719",0,5,0,5,"dummy"
"26721",0,2,0,2,"dummy"
"26723",0,0,1,1,"dummy"
"26724",0,0,2,2,"dummy"
"26725",0,0,1,1,"dummy"
"26726",3,3,0,6,"dummy"
"26727",0,1,0,1,"dummy"
"26728",0,0,1,1,"dummy"
"26731",0,1,0,1,"dummy"
"26734",0,0,1,1,"dummy"
"26735",0,0,1,1,"dummy"
"26737",0,8,0,8,"dummy"
"26738",1,1,0,2,"dummy"
"26740",1,2,0,3,"dummy"
"26741",0,0,1,1,"dummy"
"26744",0,0,0,0,"dummy"
"26745",0,3,0,3,"dummy"
"26747",0,0,1,1,"dummy"
"26748",1,2,0,3,"dummy"
"26749",0,2,0,2,"dummy"
"26750",0,4,0,4,"dummy"
"26751",0,5,1,6,"dummy"
"26754",4,1,2,7,"dummy"
"26755",0,1,0,1,"dummy"
"26756",1,2,0,3,"dummy"
"26758",0,0,3,3,"dummy"
"26760",0,4,0,4,"dummy"
"26761",3,6,2,11,"dummy"
"26764",6,0,0,6,"dummy"
"26765",2,5,2,9,"dummy"
"26776",0,5,3,8,"dummy"
"26777",0,8,0,8,"dummy"
"26778",2,2,0,4,"dummy"
"26779",0,0,1,1,"dummy"
"26787",6,16,0,22,"dummy"
"26788",13,1,0,14,"dummy"
"26790",0,1,0,1,"dummy"
"26791",0,0,1,1,"dummy"
"26793",5,3,1,9,"dummy"
"26796",0,0,0,0,"dummy"
"26799",0,0,1,1,"dummy"
"26800",0,0,1,1,"dummy"
"26801",0,0,1,1,"dummy"
"26802",0,0,1,1,"dummy"
"26803",0,0,1,1,"dummy"
"26804",0,0,1,1,"dummy"
"26805",0,0,0,0,"dummy"
"26806",0,0,0,0,"dummy"
"26809",0,0,1,1,"dummy"
"26810",6,4,4,14,"dummy"
"26811",0,1,0,1,"dummy"
"26812",0,0,1,1,"dummy"
"26813",0,1,0,1,"dummy"
"26814",4,0,0,4,"dummy"
"26815",4,6,4,14,"dummy"
"26816",3,1,0,4,"dummy"
"26817",0,0,3,3,"dummy"
"26819",7,1,0,8,"dummy"
"26820",0,0,1,1,"dummy"
"26821",0,0,0,0,"dummy"
"26822",3,0,2,5,"dummy"
"26823",4,5,3,12,"dummy"
"26825",2,0,3,5,"dummy"
"26826",1,0,0,1,"dummy"
"26827",0,1,0,1,"dummy"
"26828",0,1,1,2,"dummy"
"26834",0,0,1,1,"dummy"
"26836",0,3,0,3,"dummy"
"26837",0,0,0,0,"dummy"
"26840",0,0,1,1,"dummy"
"26846",0,2,0,2,"dummy"
"26847",2,0,1,3,"dummy"
"26849",0,1,1,2,"dummy"
"26850",0,0,1,1,"dummy"
"26851",1,2,1,4,"dummy"
"26852",32,5,0,37,"dummy"
"26855",0,0,1,1,"dummy"
"26873",0,0,1,1,"dummy"
"26874",0,0,2,2,"dummy"
"26875",0,1,1,2,"dummy"
"26877",0,3,0,3,"dummy"
"26878",1,1,0,2,"dummy"
"26879",0,2,0,2,"dummy"
"26880",2,3,2,7,"dummy"
"26881",0,1,0,1,"dummy"
"26883",0,0,1,1,"dummy"
"26884",0,0,1,1,"dummy"
"26885",0,0,2,2,"dummy"
"26886",26,3,7,36,"dummy"
"26889",2,0,3,5,"dummy"
"26892",11,17,1,29,"dummy"
"26893",14,5,0,19,"dummy"
"26894",0,1,3,4,"dummy"
"26895",1,0,3,4,"dummy"
"26896",0,0,3,3,"dummy"
"26897",0,0,3,3,"dummy"
"26898",0,36,0,36,"dummy"
"26899",36,0,0,36,"dummy"
"26900",0,2,0,2,"dummy"
"26901",0,0,1,1,"dummy"
"26902",2,0,0,2,"dummy"
"26903",1,0,1,2,"dummy"
"26904",2,2,3,7,"dummy"
"26905",0,1,1,2,"dummy"
"26906",0,0,3,3,"dummy"
"26907",2,2,3,7,"dummy"
"26908",0,1,0,1,"dummy"
"26909",0,0,0,0,"dummy"
"26910",1,0,2,3,"dummy"
"26911",0,0,2,2,"dummy"
"26912",0,1,3,4,"dummy"
"26913",0,1,0,1,"dummy"
"26915",1,0,0,1,"dummy"
"26916",0,0,1,1,"dummy"
"26917",1,1,0,2,"dummy"
"26918",0,1,0,1,"dummy"
"26919",0,0,0,0,"dummy"
"26920",0,0,1,1,"dummy"
"26921",0,0,2,2,"dummy"
"26922",0,0,0,0,"dummy"
"26923",0,0,0,0,"dummy"
"26924",0,0,0,0,"dummy"
"26926",2,0,3,5,"dummy"
"26927",1,0,0,1,"dummy"
"26928",0,1,0,1,"dummy"
"26929",0,1,1,2,"dummy"
"26931",0,0,1,1,"dummy"
"26932",0,7,1,8,"dummy"
"26933",6,7,9,22,"dummy"
"26934",2,7,7,16,"dummy"
"26935",0,0,1,1,"dummy"
"26936",0,0,2,2,"dummy"
"26937",0,0,1,1,"dummy"
"26938",4,0,0,4,"dummy"
"26941",0,0,1,1,"dummy"
"26942",1,1,0,2,"dummy"
"26943",2,3,0,5,"dummy"
"26944",0,1,0,1,"dummy"
"26945",5,3,2,10,"dummy"
"26946",1,1,1,3,"dummy"
"26947",1,1,0,2,"dummy"
"26948",0,1,0,1,"dummy"
"26951",0,0,1,1,"dummy"
"26960",1,0,0,1,"dummy"
"26961",3,0,0,3,"dummy"
"26962",0,1,0,1,"dummy"
"26964",0,0,1,1,"dummy"
"26967",1,0,1,2,"dummy"
"26968",0,1,0,1,"dummy"
"26970",2,3,4,9,"dummy"
"26974",0,1,0,1,"dummy"
"26978",0,3,0,3,"dummy"
"26979",0,0,1,1,"dummy"
"26980",0,2,0,2,"dummy"
"26981",0,1,2,3,"dummy"
"26982",0,0,1,1,"dummy"
"26987",1,7,0,8,"dummy"
"26988",0,1,0,1,"dummy"
"26989",5,2,1,8,"dummy"
"26990",0,1,1,2,"dummy"
"27000",2,3,1,6,"dummy"
"27001",3,0,3,6,"dummy"
"27005",1,0,1,2,"dummy"
"27006",0,0,0,0,"dummy"
"27007",1,0,0,1,"dummy"
"27009",0,69,0,69,"dummy"
"27010",0,1,0,1,"dummy"
"27011",5,5,0,10,"dummy"
"27012",1,1,0,2,"dummy"
"27013",63,10,4,77,"dummy"
"27014",0,0,1,1,"dummy"
"27015",0,0,1,1,"dummy"
"27016",0,0,2,2,"dummy"
"27017",0,0,2,2,"dummy"
"27018",1,2,0,3,"dummy"
"27019",0,2,0,2,"dummy"
"27020",2,1,2,5,"dummy"
"27021",7,0,2,9,"dummy"
"27022",0,4,0,4,"dummy"
"27023",0,0,0,0,"dummy"
"27024",0,1,0,1,"dummy"
"27025",3,3,1,7,"dummy"
"27026",0,0,0,0,"dummy"
"27027",0,4,1,5,"dummy"
"27028",0,9,0,9,"dummy"
"27031",0,0,1,1,"dummy"
"27034",0,0,0,0,"dummy"
"27035",0,0,0,0,"dummy"
"27036",0,0,0,0,"dummy"
"27037",0,0,0,0,"dummy"
"27038",0,0,0,0,"dummy"
"27039",0,0,0,0,"dummy"
"27046",0,2,0,2,"dummy"
"27047",0,0,1,1,"dummy"
"27048",0,1,0,1,"dummy"
"27051",0,3,0,3,"dummy"
"27052",10,0,3,13,"dummy"
"27053",0,0,2,2,"dummy"
"27055",7,1,3,11,"dummy"
"27056",1,0,0,1,"dummy"
"27057",0,1,0,1,"dummy"
"27058",4,3,0,7,"dummy"
"27060",0,0,0,0,"dummy"
"27061",7,0,2,9,"dummy"
"27062",2,0,3,5,"dummy"
"27063",0,0,2,2,"dummy"
"27064",0,6,0,6,"dummy"
"27068",2,0,0,2,"dummy"
"27069",0,2,0,2,"dummy"
"27070",0,4,1,5,"dummy"
"27071",0,0,2,2,"dummy"
"27072",0,1,1,2,"dummy"
"27074",36,5,6,47,"dummy"
"27075",0,0,2,2,"dummy"
"27076",0,0,1,1,"dummy"
"27077",0,0,1,1,"dummy"
"27079",12,19,3,34,"dummy"
"27080",7,1,0,8,"dummy"
"27081",0,0,0,0,"dummy"
"27082",2,0,4,6,"dummy"
"27084",0,0,0,0,"dummy"
"27085",0,0,1,1,"dummy"
"27089",0,0,1,1,"dummy"
"27094",0,0,0,0,"dummy"
"27095",0,0,1,1,"dummy"
"27096",1,24,4,29,"dummy"
"27097",5,3,1,9,"dummy"
"27098",3,5,0,8,"dummy"
"27099",0,0,1,1,"dummy"
"27101",3,0,0,3,"dummy"
"27103",0,1,0,1,"dummy"
"27104",0,2,0,2,"dummy"
"27105",0,0,0,0,"dummy"
"27107",9,11,0,20,"dummy"
"27108",0,1,0,1,"dummy"
"27109",0,0,3,3,"dummy"
"27111",0,4,1,5,"dummy"
"27113",0,0,2,2,"dummy"
"27115",0,4,5,9,"dummy"
"27116",0,2,1,3,"dummy"
"27117",0,3,0,3,"dummy"
"27119",2,0,0,2,"dummy"
"27124",1,2,0,3,"dummy"
"27125",5,2,1,8,"dummy"
"27126",2,9,0,11,"dummy"
"27127",0,3,0,3,"dummy"
"27128",0,1,1,2,"dummy"
"27129",0,3,0,3,"dummy"
"27130",0,1,0,1,"dummy"
"27131",0,0,1,1,"dummy"
"27132",3,0,0,3,"dummy"
"27133",3,2,0,5,"dummy"
"27134",0,0,1,1,"dummy"
"27135",0,1,0,1,"dummy"
"27136",0,2,0,2,"dummy"
"27137",1,6,0,7,"dummy"
"27138",0,0,1,1,"dummy"
"27139",1,0,0,1,"dummy"
"27140",3,3,2,8,"dummy"
"27141",1,2,1,4,"dummy"
"27142",15,0,3,18,"dummy"
"27143",0,0,0,0,"dummy"
"27144",0,0,0,0,"dummy"
"27145",0,0,0,0,"dummy"
"27146",0,0,1,1,"dummy"
"27147",2,3,0,5,"dummy"
"27148",0,1,0,1,"dummy"
"27149",0,1,0,1,"dummy"
"27150",0,1,0,1,"dummy"
"27151",0,0,0,0,"dummy"
"27152",1,0,0,1,"dummy"
"27153",1,0,1,2,"dummy"
"27154",0,0,0,0,"dummy"
"27155",0,1,0,1,"dummy"
"27156",3,0,0,3,"dummy"
"27157",0,0,2,2,"dummy"
"27158",0,0,1,1,"dummy"
"27159",0,0,1,1,"dummy"
"27160",0,0,0,0,"dummy"
"27161",0,1,0,1,"dummy"
"27162",0,0,1,1,"dummy"
"27163",2,0,0,2,"dummy"
"27164",0,0,1,1,"dummy"
"27165",0,0,1,1,"dummy"
"27166",0,1,0,1,"dummy"
"27167",1,0,0,1,"dummy"
"27168",0,2,0,2,"dummy"
"27169",0,0,2,2,"dummy"
"27170",0,2,0,2,"dummy"
"27171",0,2,0,2,"dummy"
"27172",1,0,0,1,"dummy"
"27173",0,2,0,2,"dummy"
"27174",0,2,2,4,"dummy"
"27175",0,0,0,0,"dummy"
"27176",9,9,0,18,"dummy"
"27177",2,0,0,2,"dummy"
"27178",0,0,1,1,"dummy"
"27179",4,2,1,7,"dummy"
"27180",0,2,0,2,"dummy"
"27181",0,0,1,1,"dummy"
"27182",0,0,1,1,"dummy"
"27183",0,0,1,1,"dummy"
"27184",0,0,1,1,"dummy"
"27185",0,0,2,2,"dummy"
"27186",0,0,2,2,"dummy"
"27187",0,0,2,2,"dummy"
"27188",0,0,2,2,"dummy"
"27189",0,0,2,2,"dummy"
"27193",0,2,1,3,"dummy"
"27194",0,2,0,2,"dummy"
"27195",0,2,0,2,"dummy"
"27196",0,0,1,1,"dummy"
"27197",1,0,0,1,"dummy"
"27199",0,1,0,1,"dummy"
"27203",1,2,0,3,"dummy"
"27204",0,1,0,1,"dummy"
"27205",1,6,0,7,"dummy"
"27206",2,6,1,9,"dummy"
"27207",0,2,0,2,"dummy"
"27208",0,0,1,1,"dummy"
"27209",0,0,2,2,"dummy"
"27210",7,3,10,20,"dummy"
"27212",0,6,0,6,"dummy"
"27214",0,1,0,1,"dummy"
"27217",0,3,4,7,"dummy"
"27218",24,0,0,24,"dummy"
"27219",0,1,0,1,"dummy"
"27224",0,1,0,1,"dummy"
"27225",1,6,6,13,"dummy"
"27226",0,3,0,3,"dummy"
"27233",0,3,0,3,"dummy"
"27234",0,1,0,1,"dummy"
"27235",2,3,0,5,"dummy"
"27236",0,4,0,4,"dummy"
"27237",0,1,0,1,"dummy"
"27238",0,0,1,1,"dummy"
"27239",0,0,0,0,"dummy"
"27240",1,0,0,1,"dummy"
"27241",0,0,1,1,"dummy"
"27243",0,0,1,1,"dummy"
"27244",0,1,0,1,"dummy"
"27245",0,1,0,1,"dummy"
"27246",0,0,0,0,"dummy"
"27247",1,0,0,1,"dummy"
"27248",7,3,2,12,"dummy"
"27250",3,0,0,3,"dummy"
"27252",13,9,1,23,"dummy"
"27253",0,3,0,3,"dummy"
"27254",0,1,1,2,"dummy"
"27255",0,1,0,1,"dummy"
"27257",0,1,0,1,"dummy"
"27258",0,2,0,2,"dummy"
"27259",0,0,0,0,"dummy"
"27260",2,0,0,2,"dummy"
"27263",0,1,0,1,"dummy"
"27264",0,3,1,4,"dummy"
"27267",0,0,1,1,"dummy"
"27310",0,0,0,0,"dummy"
"27311",0,0,0,0,"dummy"
"27312",0,0,0,0,"dummy"
"27313",0,0,0,0,"dummy"
"27314",0,1,0,1,"dummy"
"27323",0,0,1,1,"dummy"
"27324",0,1,2,3,"dummy"
"27357",2,2,4,8,"dummy"
"27358",0,0,0,0,"dummy"
"27359",0,0,3,3,"dummy"
"27360",0,0,2,2,"dummy"
"27361",0,0,5,5,"dummy"
"27362",0,0,0,0,"dummy"
"27363",0,0,0,0,"dummy"
"27364",0,0,0,0,"dummy"
"27365",0,0,0,0,"dummy"
"27366",0,0,0,0,"dummy"
"27367",0,0,0,0,"dummy"
"27368",0,0,0,0,"dummy"
"27369",1,2,0,3,"dummy"
"27413",2,0,2,4,"dummy"
"27416",1,2,1,4,"dummy"
"27426",0,1,0,1,"dummy"
"27427",0,3,0,3,"dummy"
"27428",0,0,1,1,"dummy"
"27458",0,0,1,1,"dummy"
"27469",0,1,0,1,"dummy"
"27470",0,1,0,1,"dummy"
"27471",0,0,1,1,"dummy"
"27499",4,0,2,6,"dummy"
"27500",2,3,0,5,"dummy"
"27501",0,0,0,0,"dummy"
"27537",0,1,0,1,"dummy"
"27542",0,1,0,1,"dummy"
"27543",4,2,4,10,"dummy"
"27550",0,0,0,0,"dummy"
"27272",0,3,0,3,"dummy"
"27273",0,0,0,0,"dummy"
"27274",0,0,1,1,"dummy"
"27275",0,8,0,8,"dummy"
"27276",0,0,1,1,"dummy"
"27277",0,1,0,1,"dummy"
"27278",0,1,1,2,"dummy"
"27279",0,1,1,2,"dummy"
"27280",0,1,1,2,"dummy"
"27281",1,1,1,3,"dummy"
"27282",4,2,0,6,"dummy"
"27283",0,1,0,1,"dummy"
"27284",0,1,0,1,"dummy"
"27285",0,0,1,1,"dummy"
"27286",2,2,1,5,"dummy"
"27287",0,0,1,1,"dummy"
"27288",0,1,0,1,"dummy"
"27289",0,0,0,0,"dummy"
"27290",11,7,4,22,"dummy"
"27291",0,1,1,2,"dummy"
"27292",0,0,2,2,"dummy"
"27293",1,0,1,2,"dummy"
"27294",0,1,0,1,"dummy"
"27297",0,0,1,1,"dummy"
"27298",0,0,0,0,"dummy"
"27299",0,0,0,0,"dummy"
"27304",1,3,1,5,"dummy"
"27316",0,0,0,0,"dummy"
"27332",8,4,0,12,"dummy"
"27333",0,0,0,0,"dummy"
"27334",4,1,0,5,"dummy"
"27335",1,0,0,1,"dummy"
"27336",0,0,0,0,"dummy"
"27337",0,2,0,2,"dummy"
"27338",2,0,0,2,"dummy"
"27339",0,0,0,0,"dummy"
"27355",0,3,0,3,"dummy"
"27405",0,0,0,0,"dummy"
"27406",0,0,3,3,"dummy"
"27407",0,0,0,0,"dummy"
"27410",0,1,2,3,"dummy"
"27411",0,0,1,1,"dummy"
"27420",0,1,0,1,"dummy"
"27421",0,0,1,1,"dummy"
"27422",1,0,0,1,"dummy"
"27423",1,1,0,2,"dummy"
"27424",0,1,0,1,"dummy"
"27430",0,0,1,1,"dummy"
"27522",0,11,0,11,"dummy"
"27525",0,0,0,0,"dummy"
"27554",61,20,1,82,"dummy"
"27555",2,0,0,2,"dummy"
"27556",0,4,0,4,"dummy"
"27567",0,1,0,1,"dummy"
"27572",2,0,1,3,"dummy"
"27573",0,0,1,1,"dummy"
"27574",0,0,1,1,"dummy"
"27576",0,0,1,1,"dummy"
"27578",2,0,2,4,"dummy"
"27579",1,3,0,4,"dummy"
"27580",3,1,0,4,"dummy"
"27582",1,0,0,1,"dummy"
"27583",0,0,1,1,"dummy"
"27584",0,1,0,1,"dummy"
"27585",0,1,0,1,"dummy"
"27590",0,0,1,1,"dummy"
"27591",0,0,1,1,"dummy"
"27592",0,0,1,1,"dummy"
"27593",0,0,1,1,"dummy"
"27594",0,0,1,1,"dummy"
"27602",0,1,2,3,"dummy"
"27603",2,2,0,4,"dummy"
"27605",0,0,1,1,"dummy"
"27606",3,0,0,3,"dummy"
"27607",0,1,0,1,"dummy"
"27608",17,2,0,19,"dummy"
"27609",0,0,2,2,"dummy"
"27610",0,1,1,2,"dummy"
"27612",0,0,0,0,"dummy"
"27613",0,0,1,1,"dummy"
"27615",0,0,1,1,"dummy"
"27616",0,20,1,21,"dummy"
"27618",0,7,0,7,"dummy"
"27621",0,0,1,1,"dummy"
"27624",1,5,3,9,"dummy"
"27625",1,0,0,1,"dummy"
"27627",0,1,0,1,"dummy"
"27628",0,1,0,1,"dummy"
"27629",0,0,1,1,"dummy"
"27630",0,0,3,3,"dummy"
"27631",0,0,1,1,"dummy"
"27632",0,1,1,2,"dummy"
"27633",0,0,2,2,"dummy"
"27634",0,0,1,1,"dummy"
"27635",0,0,1,1,"dummy"
"27636",0,0,1,1,"dummy"
"27637",3,9,3,15,"dummy"
"27638",0,0,1,1,"dummy"
"27639",0,0,1,1,"dummy"
"27640",0,0,1,1,"dummy"
"27641",0,0,1,1,"dummy"
"27642",0,0,1,1,"dummy"
"27643",0,0,2,2,"dummy"
"27644",0,0,1,1,"dummy"
"27661",0,4,0,4,"dummy"
"27662",0,2,0,2,"dummy"
"27666",2,3,1,6,"dummy"
"27667",4,5,2,11,"dummy"
"27669",0,4,0,4,"dummy"
"27672",0,0,2,2,"dummy"
"27673",0,0,0,0,"dummy"
"27676",0,0,1,1,"dummy"
"27677",1,4,4,9,"dummy"
"27678",6,1,0,7,"dummy"
"27680",0,0,4,4,"dummy"
"27681",8,0,0,8,"dummy"
"27684",1,4,0,5,"dummy"
"27685",8,4,2,14,"dummy"
"27686",0,0,0,0,"dummy"
"27687",0,0,4,4,"dummy"
"27688",0,0,1,1,"dummy"
"27694",0,1,0,1,"dummy"
"27695",0,1,1,2,"dummy"
"27697",1,10,0,11,"dummy"
"27698",22,14,3,39,"dummy"
"27699",0,0,1,1,"dummy"
"27700",0,0,1,1,"dummy"
"27701",11,8,1,20,"dummy"
"27702",0,0,1,1,"dummy"
"27703",0,0,1,1,"dummy"
"27704",0,1,1,2,"dummy"
"27708",7,0,1,8,"dummy"
"27709",0,2,1,3,"dummy"
"27710",1,3,1,5,"dummy"
"27714",0,0,6,6,"dummy"
"27715",0,0,6,6,"dummy"
"27716",0,0,6,6,"dummy"
"27718",0,0,1,1,"dummy"
"27719",0,0,1,1,"dummy"
"27721",0,0,0,0,"dummy"
"27722",0,1,0,1,"dummy"
"27723",0,1,0,1,"dummy"
"27724",0,1,0,1,"dummy"
"27725",0,0,0,0,"dummy"
"27726",0,1,0,1,"dummy"
"27727",2,2,0,4,"dummy"
"27728",0,5,1,6,"dummy"
"27729",0,0,0,0,"dummy"
"27730",15,15,0,30,"dummy"
"27731",0,0,0,0,"dummy"
"27732",0,1,0,1,"dummy"
"27733",0,0,1,1,"dummy"
"27734",0,0,2,2,"dummy"
"27737",1,5,0,6,"dummy"
"27738",6,2,1,9,"dummy"
"27739",0,1,0,1,"dummy"
"27742",0,0,1,1,"dummy"
"27767",0,0,1,1,"dummy"
"27769",1,0,0,1,"dummy"
"27770",0,0,1,1,"dummy"
"27771",0,1,0,1,"dummy"
"27772",0,1,0,1,"dummy"
"27774",2,0,2,4,"dummy"
"27775",1,3,0,4,"dummy"
"27776",3,1,0,4,"dummy"
"27778",2,0,1,3,"dummy"
"27779",0,0,1,1,"dummy"
"27780",0,0,1,1,"dummy"
"27785",0,0,1,1,"dummy"
"27786",3,0,0,3,"dummy"
"27787",0,1,0,1,"dummy"
"27788",17,2,0,19,"dummy"
"27789",0,0,2,2,"dummy"
"27790",0,1,1,2,"dummy"
"27800",0,0,1,1,"dummy"
"27801",0,0,1,1,"dummy"
"27802",0,0,1,1,"dummy"
"27803",0,0,1,1,"dummy"
"27804",0,0,1,1,"dummy"
"27806",0,1,2,3,"dummy"
"27807",2,2,0,4,"dummy"
"27810",0,0,1,1,"dummy"
"27811",0,20,1,21,"dummy"
"27813",0,7,0,7,"dummy"
"27816",0,0,0,0,"dummy"
"27817",0,0,1,1,"dummy"
"27820",0,0,1,1,"dummy"
"27823",1,5,3,9,"dummy"
"27824",1,0,0,1,"dummy"
"27841",0,1,0,1,"dummy"
"27842",0,1,0,1,"dummy"
"27843",0,0,1,1,"dummy"
"27844",0,0,3,3,"dummy"
"27845",0,0,1,1,"dummy"
"27846",0,1,1,2,"dummy"
"27847",0,0,2,2,"dummy"
"27848",0,0,1,1,"dummy"
"27849",0,0,1,1,"dummy"
"27850",0,0,1,1,"dummy"
"27851",3,9,3,15,"dummy"
"27852",0,0,1,1,"dummy"
"27853",0,0,1,1,"dummy"
"27854",0,0,1,1,"dummy"
"27855",0,0,1,1,"dummy"
"27856",0,0,1,1,"dummy"
"27857",0,0,2,2,"dummy"
"27858",0,0,1,1,"dummy"
"27860",0,4,0,4,"dummy"
"27861",0,2,0,2,"dummy"
"27865",2,3,1,6,"dummy"
"27866",4,5,2,11,"dummy"
"27869",0,0,2,2,"dummy"
"27870",0,0,0,0,"dummy"
"27872",0,4,0,4,"dummy"
"27875",0,0,1,1,"dummy"
"27876",1,4,4,9,"dummy"
"27877",6,1,0,7,"dummy"
"27879",0,0,4,4,"dummy"
"27880",8,0,0,8,"dummy"
"27883",1,4,0,5,"dummy"
"27884",8,4,2,14,"dummy"
"27885",0,0,0,0,"dummy"
"27886",0,0,4,4,"dummy"
"27887",0,0,1,1,"dummy"
"27892",0,1,0,1,"dummy"
"27893",0,1,1,2,"dummy"
"27896",1,10,0,11,"dummy"
"27897",22,14,3,39,"dummy"
"27898",0,0,1,1,"dummy"
"27899",0,0,1,1,"dummy"
"27900",11,8,1,20,"dummy"
"27901",0,0,1,1,"dummy"
"27902",0,0,1,1,"dummy"
"27903",0,1,1,2,"dummy"
"27907",7,0,1,8,"dummy"
"27908",0,2,1,3,"dummy"
"27909",1,3,1,5,"dummy"
"27913",0,0,6,6,"dummy"
"27914",0,0,6,6,"dummy"
"27915",0,0,6,6,"dummy"
"27917",2,0,1,3,"dummy"
"27918",0,0,1,1,"dummy"
"27919",0,5,0,5,"dummy"
"27920",5,0,0,5,"dummy"
"27921",0,2,0,2,"dummy"
"27922",0,3,2,5,"dummy"
"27923",2,0,0,2,"dummy"
"27924",0,0,2,2,"dummy"
"27925",0,1,0,1,"dummy"
"27926",0,0,1,1,"dummy"
"27927",0,1,0,1,"dummy"
"27928",0,10,0,10,"dummy"
"27929",34,2,0,36,"dummy"
"27930",0,0,1,1,"dummy"
"27931",0,0,1,1,"dummy"
"27932",0,0,1,1,"dummy"
"27933",0,0,0,0,"dummy"
"27934",0,0,1,1,"dummy"
"27935",0,1,0,1,"dummy"
"27936",0,0,1,1,"dummy"
"27937",0,0,1,1,"dummy"
"27940",0,0,0,0,"dummy"
"27941",0,1,0,1,"dummy"
"27942",0,1,0,1,"dummy"
"27943",0,1,0,1,"dummy"
"27944",0,0,0,0,"dummy"
"27945",0,1,0,1,"dummy"
"27946",2,2,0,4,"dummy"
"27947",0,5,1,6,"dummy"
"27948",0,0,0,0,"dummy"
"27949",15,15,0,30,"dummy"
"27950",0,0,0,0,"dummy"
"27951",0,1,0,1,"dummy"
"27952",0,0,1,1,"dummy"
"27953",0,0,2,2,"dummy"
"27955",1,5,0,6,"dummy"
"27956",6,2,1,9,"dummy"
"27957",0,1,0,1,"dummy"
"27961",0,0,1,1,"dummy"
"27963",0,0,1,1,"dummy"
"27964",0,0,1,1,"dummy"
"27967",0,1,4,5,"dummy"
"27968",0,0,1,1,"dummy"
"27970",1,2,0,3,"dummy"
"27972",0,2,0,2,"dummy"
"27973",0,6,0,6,"dummy"
"27975",0,6,0,6,"dummy"
"27976",0,1,0,1,"dummy"
"27978",0,0,2,2,"dummy"
"27979",0,1,0,1,"dummy"
"27980",0,2,0,2,"dummy"
"27981",0,1,0,1,"dummy"
"27982",0,1,0,1,"dummy"
"27983",0,1,0,1,"dummy"
"27984",0,0,1,1,"dummy"
"27985",0,0,1,1,"dummy"
"27987",3,5,0,8,"dummy"
"27988",1,4,0,5,"dummy"
"27989",0,0,1,1,"dummy"
"27990",0,3,0,3,"dummy"
"27991",0,0,1,1,"dummy"
"27992",1,3,0,4,"dummy"
"27993",0,0,1,1,"dummy"
"27994",0,0,1,1,"dummy"
"27995",0,0,0,0,"dummy"
"27996",0,4,2,6,"dummy"
"27997",2,2,0,4,"dummy"
"27998",3,5,1,9,"dummy"
"27999",0,2,0,2,"dummy"
"28000",0,2,1,3,"dummy"
"28001",2,2,0,4,"dummy"
"28002",2,1,3,6,"dummy"
"28003",3,0,0,3,"dummy"
"28006",1,1,1,3,"dummy"
"28010",0,7,0,7,"dummy"
"28011",2,4,1,7,"dummy"
"28012",0,0,2,2,"dummy"
"28013",0,5,0,5,"dummy"
"28016",0,0,3,3,"dummy"
"28017",1,1,0,2,"dummy"
"28018",1,1,0,2,"dummy"
"28020",0,2,0,2,"dummy"
"28021",0,0,1,1,"dummy"
"28022",4,4,0,8,"dummy"
"28024",0,1,0,1,"dummy"
"28025",1,0,0,1,"dummy"
"28026",0,9,2,11,"dummy"
"28027",9,0,2,11,"dummy"
"28028",0,3,2,5,"dummy"
"28029",0,1,0,1,"dummy"
"28030",0,5,0,5,"dummy"
"28031",1,0,0,1,"dummy"
"28033",2,2,1,5,"dummy"
"28051",0,1,0,1,"dummy"
"28052",1,0,0,1,"dummy"
"28053",0,0,1,1,"dummy"
"28056",4,4,0,8,"dummy"
"28057",0,2,0,2,"dummy"
"28058",0,0,1,1,"dummy"
"28059",0,3,0,3,"dummy"
"28060",2,2,0,4,"dummy"
"28061",0,0,0,0,"dummy"
"28067",0,0,1,1,"dummy"
"28069",0,0,2,2,"dummy"
"28070",0,0,1,1,"dummy"
"28071",0,3,0,3,"dummy"
"28072",1,1,1,3,"dummy"
"28073",0,0,1,1,"dummy"
"28074",0,0,1,1,"dummy"
"28088",1,1,1,3,"dummy"
"28089",0,0,1,1,"dummy"
"28093",0,0,1,1,"dummy"
"28094",0,0,1,1,"dummy"
"28095",0,0,1,1,"dummy"
"28102",0,0,0,0,"dummy"
"28103",1,4,1,6,"dummy"
"28104",8,5,3,16,"dummy"
"28105",2,5,2,9,"dummy"
"28106",0,1,0,1,"dummy"
"28107",3,9,3,15,"dummy"
"28108",1,0,0,1,"dummy"
"28116",0,1,1,2,"dummy"
"28117",0,2,0,2,"dummy"
"28118",0,0,1,1,"dummy"
"28119",6,14,5,25,"dummy"
"28120",0,0,1,1,"dummy"
"28121",10,16,6,32,"dummy"
"28122",10,1,0,11,"dummy"
"28123",3,9,4,16,"dummy"
"28124",0,0,2,2,"dummy"
"28125",4,4,1,9,"dummy"
"28126",0,2,2,4,"dummy"
"28127",0,0,1,1,"dummy"
"28128",0,0,0,0,"dummy"
"28129",8,6,3,17,"dummy"
"28130",0,0,0,0,"dummy"
"28131",0,2,0,2,"dummy"
"28132",0,2,0,2,"dummy"
"28133",0,1,0,1,"dummy"
"28134",2,1,0,3,"dummy"
"28135",2,2,0,4,"dummy"
"28136",0,0,1,1,"dummy"
"28145",0,0,3,3,"dummy"
"28146",0,1,0,1,"dummy"
"28147",1,1,0,2,"dummy"
"28148",0,1,0,1,"dummy"
"28149",0,6,0,6,"dummy"
"28150",0,0,1,1,"dummy"
"28172",2,1,0,3,"dummy"
"28173",0,0,1,1,"dummy"
"28174",0,3,0,3,"dummy"
"28175",1,2,0,3,"dummy"
"28176",0,1,0,1,"dummy"
"28183",7,7,1,15,"dummy"
"28186",0,2,0,2,"dummy"
"28187",1,3,0,4,"dummy"
"28188",0,1,1,2,"dummy"
"28189",2,2,1,5,"dummy"
"28190",2,7,0,9,"dummy"
"28194",0,1,0,1,"dummy"
"28195",0,0,2,2,"dummy"
"28196",0,0,1,1,"dummy"
"28197",3,4,2,9,"dummy"
"28206",5,0,0,5,"dummy"
"28207",2,5,1,8,"dummy"
"28216",0,0,0,0,"dummy"
"28217",0,0,0,0,"dummy"
"28218",4,1,0,5,"dummy"
"28219",0,3,0,3,"dummy"
"28220",1,0,0,1,"dummy"
"28221",0,0,0,0,"dummy"
"28222",0,0,0,0,"dummy"
"28225",0,2,0,2,"dummy"
"28226",2,7,0,9,"dummy"
"28232",0,1,0,1,"dummy"
"28255",2,4,0,6,"dummy"
"28256",0,2,0,2,"dummy"
"28257",0,2,0,2,"dummy"
"28258",10,2,0,12,"dummy"
"28259",0,2,0,2,"dummy"
"28260",0,0,0,0,"dummy"
"28269",0,1,1,2,"dummy"
"28270",0,0,0,0,"dummy"
"28275",0,0,1,1,"dummy"
"28276",0,0,1,1,"dummy"
"28281",0,0,1,1,"dummy"
"28282",1,2,0,3,"dummy"
"28283",0,2,0,2,"dummy"
"28284",0,4,0,4,"dummy"
"28285",0,5,1,6,"dummy"
"28091",0,0,0,0,"dummy"
"28097",0,14,0,14,"dummy"
"28098",3,1,2,6,"dummy"
"28099",0,0,1,1,"dummy"
"28100",0,2,3,5,"dummy"
"28110",11,4,3,18,"dummy"
"28111",4,2,0,6,"dummy"
"28112",0,4,0,4,"dummy"
"28113",2,0,0,2,"dummy"
"28114",2,4,0,6,"dummy"
"28152",0,3,0,3,"dummy"
"28153",3,3,0,6,"dummy"
"28154",0,1,0,1,"dummy"
"28155",0,1,0,1,"dummy"
"28156",2,0,0,2,"dummy"
"28157",0,0,1,1,"dummy"
"28158",0,0,1,1,"dummy"
"28159",2,9,2,13,"dummy"
"28160",0,4,0,4,"dummy"
"28161",0,0,1,1,"dummy"
"28180",0,1,0,1,"dummy"
"28181",0,2,0,2,"dummy"
"28192",7,0,1,8,"dummy"
"28199",0,0,0,0,"dummy"
"28202",0,6,0,6,"dummy"
"28203",0,0,2,2,"dummy"
"28204",3,4,1,8,"dummy"
"28211",2,2,0,4,"dummy"
"28212",0,3,0,3,"dummy"
"28213",0,1,0,1,"dummy"
"28214",0,6,0,6,"dummy"
"28230",2,0,0,2,"dummy"
"28236",0,8,3,11,"dummy"
"28237",0,2,0,2,"dummy"
"28238",0,1,0,1,"dummy"
"28239",8,14,2,24,"dummy"
"28240",0,2,0,2,"dummy"
"28241",2,1,0,3,"dummy"
"28242",2,3,0,5,"dummy"
"28243",1,0,0,1,"dummy"
"28244",0,0,1,1,"dummy"
"28245",0,1,0,1,"dummy"
"28246",7,1,0,8,"dummy"
"28247",1,4,1,6,"dummy"
"28248",1,0,0,1,"dummy"
"28249",4,3,0,7,"dummy"
"28250",0,2,0,2,"dummy"
"28253",0,1,0,1,"dummy"
"28262",0,0,1,1,"dummy"
"28263",0,0,2,2,"dummy"
"28264",0,0,1,1,"dummy"
"28265",3,3,0,6,"dummy"
"28266",0,1,0,1,"dummy"
"28267",0,0,1,1,"dummy"
"28272",0,8,0,8,"dummy"
"28273",1,1,0,2,"dummy"
"28278",1,2,0,3,"dummy"
"28279",0,0,1,1,"dummy"
"28292",0,0,0,0,"dummy"
"28293",0,3,0,3,"dummy"
"28303",0,2,0,2,"dummy"
"28304",0,1,0,1,"dummy"
"28309",6,0,0,6,"dummy"
"28310",2,5,2,9,"dummy"
"28313",0,1,1,2,"dummy"
"28314",1,0,2,3,"dummy"
"28315",0,0,1,1,"dummy"
"28316",0,9,1,10,"dummy"
"28317",0,0,0,0,"dummy"
"28318",1,1,0,2,"dummy"
"28319",0,1,1,2,"dummy"
"28320",0,0,4,4,"dummy"
"28325",0,0,3,3,"dummy"
"28288",4,1,2,7,"dummy"
"28289",0,1,0,1,"dummy"
"28290",1,2,0,3,"dummy"
"28295",1,3,0,4,"dummy"
"28296",0,1,0,1,"dummy"
"28297",0,2,0,2,"dummy"
"28298",0,0,1,1,"dummy"
"28299",0,0,1,1,"dummy"
"28300",0,0,1,1,"dummy"
"28301",0,5,0,5,"dummy"
"28322",0,4,0,4,"dummy"
"28323",3,6,2,11,"dummy"
"28335",0,5,3,8,"dummy"
"28336",0,8,0,8,"dummy"
"28337",2,2,0,4,"dummy"
"28338",0,0,1,1,"dummy"
"28346",6,16,0,22,"dummy"
"28347",13,1,0,14,"dummy"
"28369",7,1,0,8,"dummy"
"28370",0,0,1,1,"dummy"
"28371",0,0,0,0,"dummy"
"28372",3,0,2,5,"dummy"
"28373",4,5,3,12,"dummy"
"28392",0,0,1,1,"dummy"
"28393",0,0,1,1,"dummy"
"28394",0,0,1,1,"dummy"
"28395",0,0,1,1,"dummy"
"28396",0,0,1,1,"dummy"
"28397",0,0,1,1,"dummy"
"28398",0,0,0,0,"dummy"
"28399",0,0,0,0,"dummy"
"28414",0,0,1,1,"dummy"
"28437",0,0,1,1,"dummy"
"28438",0,0,2,2,"dummy"
"28439",0,1,1,2,"dummy"
"28442",0,0,1,1,"dummy"
"28443",0,0,1,1,"dummy"
"28444",0,0,2,2,"dummy"
"28445",26,3,7,36,"dummy"
"28481",0,0,1,1,"dummy"
"28482",1,1,0,2,"dummy"
"28483",2,3,0,5,"dummy"
"28484",0,1,0,1,"dummy"
"28485",5,3,2,10,"dummy"
"28486",1,1,1,3,"dummy"
"28487",1,1,0,2,"dummy"
"28488",0,1,0,1,"dummy"
"28499",0,0,1,1,"dummy"
"28506",1,0,0,1,"dummy"
"28507",0,0,1,1,"dummy"
"28508",1,1,0,2,"dummy"
"28509",0,1,0,1,"dummy"
"28510",0,0,0,0,"dummy"
"28511",0,0,1,1,"dummy"
"28512",0,0,2,2,"dummy"
"28513",0,0,0,0,"dummy"
"28514",0,0,0,0,"dummy"
"28515",0,0,0,0,"dummy"
"28523",0,0,1,1,"dummy"
"28526",2,3,4,9,"dummy"
"28563",1,0,1,2,"dummy"
"28564",0,0,0,0,"dummy"
"28565",1,0,0,1,"dummy"
"28588",0,0,1,1,"dummy"
"28349",0,1,0,1,"dummy"
"28350",0,0,1,1,"dummy"
"28353",5,3,1,9,"dummy"
"28356",0,0,0,0,"dummy"
"28359",0,0,1,1,"dummy"
"28360",6,4,4,14,"dummy"
"28361",0,1,0,1,"dummy"
"28362",0,0,1,1,"dummy"
"28363",0,1,0,1,"dummy"
"28364",4,0,0,4,"dummy"
"28365",4,6,4,14,"dummy"
"28366",3,1,0,4,"dummy"
"28367",0,0,3,3,"dummy"
"28375",2,0,3,5,"dummy"
"28376",1,0,0,1,"dummy"
"28377",0,1,0,1,"dummy"
"28378",0,1,1,2,"dummy"
"28381",0,3,0,3,"dummy"
"28382",0,0,0,0,"dummy"
"28387",0,0,1,1,"dummy"
"28390",0,0,1,1,"dummy"
"28403",0,1,1,2,"dummy"
"28404",0,0,1,1,"dummy"
"28405",1,2,1,4,"dummy"
"28406",32,5,0,37,"dummy"
"28409",0,2,0,2,"dummy"
"28410",2,0,1,3,"dummy"
"28431",0,3,0,3,"dummy"
"28432",1,1,0,2,"dummy"
"28433",0,2,0,2,"dummy"
"28434",2,3,2,7,"dummy"
"28435",0,1,0,1,"dummy"
"28447",2,0,3,5,"dummy"
"28450",11,17,1,29,"dummy"
"28451",14,5,0,19,"dummy"
"28452",0,1,3,4,"dummy"
"28453",1,0,3,4,"dummy"
"28454",0,0,3,3,"dummy"
"28455",0,0,3,3,"dummy"
"28456",0,36,0,36,"dummy"
"28457",36,0,0,36,"dummy"
"28458",0,2,0,2,"dummy"
"28459",0,0,1,1,"dummy"
"28460",2,0,0,2,"dummy"
"28461",1,0,1,2,"dummy"
"28462",2,2,3,7,"dummy"
"28463",0,1,1,2,"dummy"
"28464",0,0,3,3,"dummy"
"28465",2,2,3,7,"dummy"
"28466",0,1,0,1,"dummy"
"28467",0,0,0,0,"dummy"
"28468",1,0,2,3,"dummy"
"28469",0,0,2,2,"dummy"
"28470",0,1,3,4,"dummy"
"28471",0,1,0,1,"dummy"
"28474",2,0,3,5,"dummy"
"28475",1,0,0,1,"dummy"
"28476",0,1,0,1,"dummy"
"28477",0,1,1,2,"dummy"
"28490",0,0,1,1,"dummy"
"28491",0,7,1,8,"dummy"
"28492",6,7,9,22,"dummy"
"28493",2,7,7,16,"dummy"
"28494",0,0,1,1,"dummy"
"28495",0,0,2,2,"dummy"
"28496",0,0,1,1,"dummy"
"28497",4,0,0,4,"dummy"
"28517",1,0,0,1,"dummy"
"28518",3,0,0,3,"dummy"
"28519",0,1,0,1,"dummy"
"28530",0,1,0,1,"dummy"
"28533",1,0,1,2,"dummy"
"28534",0,1,0,1,"dummy"
"28537",0,3,0,3,"dummy"
"28538",0,0,1,1,"dummy"
"28539",0,2,0,2,"dummy"
"28540",0,1,2,3,"dummy"
"28541",0,0,1,1,"dummy"
"28554",1,7,0,8,"dummy"
"28555",0,1,0,1,"dummy"
"28556",5,2,1,8,"dummy"
"28557",0,1,1,2,"dummy"
"28560",2,3,1,6,"dummy"
"28561",3,0,3,6,"dummy"
"28567",0,69,0,69,"dummy"
"28568",0,1,0,1,"dummy"
"28569",5,5,0,10,"dummy"
"28570",1,1,0,2,"dummy"
"28571",63,10,4,77,"dummy"
"28572",0,0,1,1,"dummy"
"28573",0,0,1,1,"dummy"
"28574",0,0,2,2,"dummy"
"28575",0,0,2,2,"dummy"
"28576",1,2,0,3,"dummy"
"28577",0,2,0,2,"dummy"
"28578",2,1,2,5,"dummy"
"28579",7,0,2,9,"dummy"
"28580",0,4,0,4,"dummy"
"28581",0,0,0,0,"dummy"
"28582",0,1,0,1,"dummy"
"28583",3,3,1,7,"dummy"
"28584",0,0,0,0,"dummy"
"28585",0,4,1,5,"dummy"
"28586",0,9,0,9,"dummy"
"28592",0,0,0,0,"dummy"
"28593",0,0,0,0,"dummy"
"28594",0,0,0,0,"dummy"
"28595",0,0,0,0,"dummy"
"28596",0,0,0,0,"dummy"
"28597",0,0,0,0,"dummy"
"28604",0,2,0,2,"dummy"
"28605",0,0,1,1,"dummy"
"28606",0,1,0,1,"dummy"
"28613",0,3,0,3,"dummy"
"28614",10,0,3,13,"dummy"
"28615",0,0,2,2,"dummy"
"28625",2,0,0,2,"dummy"
"28626",0,2,0,2,"dummy"
"28627",0,4,1,5,"dummy"
"28628",0,0,2,2,"dummy"
"28629",0,1,1,2,"dummy"
"28632",36,5,6,47,"dummy"
"28633",0,0,2,2,"dummy"
"28634",0,0,1,1,"dummy"
"28635",0,0,1,1,"dummy"
"28638",12,19,3,34,"dummy"
"28639",7,1,0,8,"dummy"
"28640",0,0,0,0,"dummy"
"28641",2,0,4,6,"dummy"
"28654",0,0,0,0,"dummy"
"28655",0,0,1,1,"dummy"
"28656",1,24,4,29,"dummy"
"28657",5,3,1,9,"dummy"
"28658",3,5,0,8,"dummy"
"28659",0,0,1,1,"dummy"
"28665",9,11,0,20,"dummy"
"28666",0,1,0,1,"dummy"
"28667",0,0,3,3,"dummy"
"28673",2,0,0,2,"dummy"
"28679",0,4,5,9,"dummy"
"28680",0,2,1,3,"dummy"
"28681",0,3,0,3,"dummy"
"28687",0,1,0,1,"dummy"
"28698",0,6,0,6,"dummy"
"28701",0,1,0,1,"dummy"
"28608",7,1,3,11,"dummy"
"28609",1,0,0,1,"dummy"
"28610",0,1,0,1,"dummy"
"28611",4,3,0,7,"dummy"
"28619",0,0,0,0,"dummy"
"28620",7,0,2,9,"dummy"
"28621",2,0,3,5,"dummy"
"28622",0,0,2,2,"dummy"
"28623",0,6,0,6,"dummy"
"28643",0,0,0,0,"dummy"
"28644",0,0,1,1,"dummy"
"28647",0,0,1,1,"dummy"
"28652",3,0,0,3,"dummy"
"28661",0,1,0,1,"dummy"
"28662",0,2,0,2,"dummy"
"28663",0,0,0,0,"dummy"
"28669",0,4,1,5,"dummy"
"28675",0,0,2,2,"dummy"
"28683",0,3,4,7,"dummy"
"28684",24,0,0,24,"dummy"
"28685",0,1,0,1,"dummy"
"28689",1,2,0,3,"dummy"
"28690",0,1,0,1,"dummy"
"28691",1,6,0,7,"dummy"
"28692",2,6,1,9,"dummy"
"28693",0,2,0,2,"dummy"
"28694",0,0,1,1,"dummy"
"28695",0,0,2,2,"dummy"
"28696",7,3,10,20,"dummy"
"28703",0,2,1,3,"dummy"
"28704",0,2,0,2,"dummy"
"28705",0,2,0,2,"dummy"
"28706",0,0,1,1,"dummy"
"28707",1,0,0,1,"dummy"
"28710",1,2,0,3,"dummy"
"28711",5,2,1,8,"dummy"
"28712",2,9,0,11,"dummy"
"28713",0,3,0,3,"dummy"
"28714",0,1,1,2,"dummy"
"28715",0,3,0,3,"dummy"
"28716",0,1,0,1,"dummy"
"28717",0,0,1,1,"dummy"
"28718",3,0,0,3,"dummy"
"28719",3,2,0,5,"dummy"
"28720",0,0,1,1,"dummy"
"28721",0,1,0,1,"dummy"
"28722",0,2,0,2,"dummy"
"28723",1,6,0,7,"dummy"
"28724",0,0,1,1,"dummy"
"28725",1,0,0,1,"dummy"
"28726",3,3,2,8,"dummy"
"28727",1,2,1,4,"dummy"
"28728",15,0,3,18,"dummy"
"28729",0,0,0,0,"dummy"
"28730",0,0,0,0,"dummy"
"28731",0,0,0,0,"dummy"
"28732",0,0,1,1,"dummy"
"28733",2,3,0,5,"dummy"
"28734",0,1,0,1,"dummy"
"28735",0,1,0,1,"dummy"
"28736",0,1,0,1,"dummy"
"28737",0,0,0,0,"dummy"
"28738",1,0,0,1,"dummy"
"28739",1,0,1,2,"dummy"
"28740",0,0,0,0,"dummy"
"28741",0,1,0,1,"dummy"
"28742",3,0,0,3,"dummy"
"28743",0,0,2,2,"dummy"
"28744",0,0,1,1,"dummy"
"28745",0,0,1,1,"dummy"
"28746",0,0,0,0,"dummy"
"28747",0,1,0,1,"dummy"
"28748",0,0,1,1,"dummy"
"28749",2,0,0,2,"dummy"
"28750",0,0,1,1,"dummy"
"28751",0,0,1,1,"dummy"
"28752",0,1,0,1,"dummy"
"28753",1,0,0,1,"dummy"
"28754",0,2,0,2,"dummy"
"28755",0,0,2,2,"dummy"
"28756",0,2,0,2,"dummy"
"28757",0,2,0,2,"dummy"
"28758",1,0,0,1,"dummy"
"28759",0,2,0,2,"dummy"
"28760",0,2,2,4,"dummy"
"28761",0,0,0,0,"dummy"
"28762",9,9,0,18,"dummy"
"28763",2,0,0,2,"dummy"
"28764",0,0,1,1,"dummy"
"28765",4,2,1,7,"dummy"
"28766",0,2,0,2,"dummy"
"28767",0,0,1,1,"dummy"
"28768",0,0,1,1,"dummy"
"28769",0,0,1,1,"dummy"
"28770",0,0,1,1,"dummy"
"28771",0,0,2,2,"dummy"
"28772",0,0,2,2,"dummy"
"28773",0,0,2,2,"dummy"
"28774",0,0,2,2,"dummy"
"28775",0,0,2,2,"dummy"
"28783",0,1,0,1,"dummy"
"28784",1,6,6,13,"dummy"
"28785",0,3,0,3,"dummy"
"28790",0,0,1,1,"dummy"
"28791",0,1,0,1,"dummy"
"28792",0,1,0,1,"dummy"
"28793",0,0,0,0,"dummy"
"28794",1,0,0,1,"dummy"
"28795",7,3,2,12,"dummy"
"28798",0,3,0,3,"dummy"
"28799",0,1,0,1,"dummy"
"28800",2,3,0,5,"dummy"
"28801",0,4,0,4,"dummy"
"28802",0,1,0,1,"dummy"
"28803",0,0,1,1,"dummy"
"28804",0,0,0,0,"dummy"
"28805",1,0,0,1,"dummy"
"28806",0,0,1,1,"dummy"
"28808",3,0,0,3,"dummy"
"28810",13,9,1,23,"dummy"
"28811",0,3,0,3,"dummy"
"28812",0,1,1,2,"dummy"
"28813",0,1,0,1,"dummy"
"28815",0,1,0,1,"dummy"
"28816",0,2,0,2,"dummy"
"28817",0,0,0,0,"dummy"
"28818",2,0,0,2,"dummy"
"28823",0,1,0,1,"dummy"
"28824",0,3,1,4,"dummy"
"28826",0,0,1,1,"dummy"
"28830",0,3,0,3,"dummy"
"28831",0,0,0,0,"dummy"
"28832",0,0,1,1,"dummy"
"28833",0,8,0,8,"dummy"
"28834",0,0,1,1,"dummy"
"28835",0,1,0,1,"dummy"
"28836",0,1,1,2,"dummy"
"28837",0,1,1,2,"dummy"
"28838",0,1,1,2,"dummy"
"28839",1,1,1,3,"dummy"
"28840",4,2,0,6,"dummy"
"28841",0,1,0,1,"dummy"
"28842",0,1,0,1,"dummy"
"28843",0,0,1,1,"dummy"
"28844",2,2,1,5,"dummy"
"28845",0,0,1,1,"dummy"
"28846",0,1,0,1,"dummy"
"28847",0,0,0,0,"dummy"
"28848",11,7,4,22,"dummy"
"28849",0,1,1,2,"dummy"
"28850",0,0,2,2,"dummy"
"28851",1,0,1,2,"dummy"
"28852",0,1,0,1,"dummy"
"28885",0,0,1,1,"dummy"
"28886",0,0,0,0,"dummy"
"28887",0,0,0,0,"dummy"
"28890",1,3,1,5,"dummy"
"28902",0,0,0,0,"dummy"
"28992",4,0,2,6,"dummy"
"28993",2,3,0,5,"dummy"
"28994",0,0,0,0,"dummy"
"29030",0,1,2,3,"dummy"
"29031",0,0,1,1,"dummy"
"29035",8,4,0,12,"dummy"
"29036",0,0,0,0,"dummy"
"29037",4,1,0,5,"dummy"
"29038",1,0,0,1,"dummy"
"29039",0,0,0,0,"dummy"
"29040",0,2,0,2,"dummy"
"29041",2,0,0,2,"dummy"
"29042",0,0,0,0,"dummy"
"29046",0,1,0,1,"dummy"
"29047",0,0,1,1,"dummy"
"29048",1,0,0,1,"dummy"
"29049",1,1,0,2,"dummy"
"29050",0,1,0,1,"dummy"
"29071",0,0,1,1,"dummy"
"29074",0,0,0,0,"dummy"
"29099",0,1,0,1,"dummy"
"29100",4,2,4,10,"dummy"
"29107",0,0,0,0,"dummy"
"29119",61,20,1,82,"dummy"
"29120",2,0,0,2,"dummy"
"29121",0,4,0,4,"dummy"
"28892",0,0,0,0,"dummy"
"28893",0,0,0,0,"dummy"
"28894",0,0,0,0,"dummy"
"28895",0,0,0,0,"dummy"
"28896",0,1,0,1,"dummy"
"28906",0,0,1,1,"dummy"
"28907",0,1,2,3,"dummy"
"28957",0,13,0,13,"dummy"
"28958",0,1,0,1,"dummy"
"28959",0,0,1,1,"dummy"
"28960",10,3,0,13,"dummy"
"28961",0,0,0,0,"dummy"
"28962",3,9,0,12,"dummy"
"28973",0,1,0,1,"dummy"
"28974",0,1,0,1,"dummy"
"28975",0,0,1,1,"dummy"
"28978",2,2,4,8,"dummy"
"28979",0,0,0,0,"dummy"
"28980",0,0,3,3,"dummy"
"28981",0,0,2,2,"dummy"
"28982",0,0,5,5,"dummy"
"28983",0,0,0,0,"dummy"
"28984",0,0,0,0,"dummy"
"28985",0,0,0,0,"dummy"
"28986",0,0,0,0,"dummy"
"28987",0,0,0,0,"dummy"
"28988",0,0,0,0,"dummy"
"28989",0,0,0,0,"dummy"
"28990",1,2,0,3,"dummy"
"29011",0,0,2,2,"dummy"
"29012",0,0,1,1,"dummy"
"29021",0,3,0,3,"dummy"
"29024",0,0,0,0,"dummy"
"29025",0,0,3,3,"dummy"
"29026",0,0,0,0,"dummy"
"29033",2,0,2,4,"dummy"
"29044",1,2,1,4,"dummy"
"29054",0,1,0,1,"dummy"
"29055",0,3,0,3,"dummy"
"29056",0,0,1,1,"dummy"
"29063",0,0,1,1,"dummy"
"29097",0,11,0,11,"dummy"
"29111",0,1,0,1,"dummy"
"29131",0,0,0,0,"dummy"
"29132",0,0,0,0,"dummy"
"29133",0,0,0,0,"dummy"
"29135",0,0,0,0,"dummy"
"29136",0,0,3,3,"dummy"
"29138",17,3,1,21,"dummy"
"29139",0,4,0,4,"dummy"
"29145",0,0,1,1,"dummy"
"29149",0,1,0,1,"dummy"
"29151",0,0,0,0,"dummy"
"29152",0,2,0,2,"dummy"
"29153",0,1,0,1,"dummy"
"29156",3,2,0,5,"dummy"
"29160",9,0,0,9,"dummy"
"29161",13,1,5,19,"dummy"
"29163",0,12,1,13,"dummy"
"29164",0,0,1,1,"dummy"
"29166",0,1,0,1,"dummy"
"29167",0,0,1,1,"dummy"
"29168",1,2,0,3,"dummy"
"29169",0,0,1,1,"dummy"
"29177",3,0,0,3,"dummy"
"29179",0,1,0,1,"dummy"
"29180",0,1,0,1,"dummy"
"29181",0,0,1,1,"dummy"
"29182",0,0,1,1,"dummy"
"29183",0,1,0,1,"dummy"
"29184",0,1,0,1,"dummy"
"29185",0,0,1,1,"dummy"
"29188",0,0,1,1,"dummy"
"29189",0,0,2,2,"dummy"
"29194",2,0,2,4,"dummy"
"29196",1,7,1,9,"dummy"
"29198",0,1,0,1,"dummy"
"29199",0,3,0,3,"dummy"
"29200",0,3,1,4,"dummy"
"29201",6,0,0,6,"dummy"
"29202",2,0,0,2,"dummy"
"29203",2,7,3,12,"dummy"
"29205",0,1,0,1,"dummy"
"29223",0,0,1,1,"dummy"
"29225",6,20,1,27,"dummy"
"29226",9,11,2,22,"dummy"
"29227",8,13,0,21,"dummy"
"29228",3,3,0,6,"dummy"
"29229",2,12,3,17,"dummy"
"29232",1,2,0,3,"dummy"
"29234",0,1,0,1,"dummy"
"29237",0,0,1,1,"dummy"
"29240",7,7,2,16,"dummy"
"29241",0,0,2,2,"dummy"
"29242",0,1,0,1,"dummy"
"29243",0,0,1,1,"dummy"
"29244",24,16,3,43,"dummy"
"29245",2,2,0,4,"dummy"
"29246",0,0,3,3,"dummy"
"29247",1,5,1,7,"dummy"
"29248",0,2,1,3,"dummy"
"29249",3,0,0,3,"dummy"
"29250",0,1,0,1,"dummy"
"29252",2,0,0,2,"dummy"
"29273",0,0,1,1,"dummy"
"29274",0,1,0,1,"dummy"
"29275",1,0,0,1,"dummy"
"29276",0,2,0,2,"dummy"
"29277",2,2,0,4,"dummy"
"29279",3,4,1,8,"dummy"
"29280",0,0,0,0,"dummy"
"29281",0,0,1,1,"dummy"
"29283",2,4,0,6,"dummy"
"29284",0,2,0,2,"dummy"
"29285",0,2,0,2,"dummy"
"29286",10,2,0,12,"dummy"
"29287",0,2,0,2,"dummy"
"29288",0,0,0,0,"dummy"
"29289",0,0,3,3,"dummy"
"29290",0,5,0,5,"dummy"
"29291",1,0,1,2,"dummy"
"29296",0,1,0,1,"dummy"
"29297",5,1,5,11,"dummy"
"29298",1,20,6,27,"dummy"
"29300",0,0,1,1,"dummy"
"29301",0,0,1,1,"dummy"
"29302",0,0,1,1,"dummy"
"29303",0,0,1,1,"dummy"
"29304",0,0,1,1,"dummy"
"29305",0,0,1,1,"dummy"
"29306",0,0,1,1,"dummy"
"29307",0,0,1,1,"dummy"
"29308",0,0,1,1,"dummy"
"29309",0,0,1,1,"dummy"
"29310",0,0,1,1,"dummy"
"29311",0,0,1,1,"dummy"
"29312",0,0,1,1,"dummy"
"29313",0,0,1,1,"dummy"
"29314",0,0,1,1,"dummy"
"29320",4,2,0,6,"dummy"
"29328",2,4,2,8,"dummy"
"29330",0,0,0,0,"dummy"
"29331",3,1,0,4,"dummy"
"29342",0,3,0,3,"dummy"
"29343",0,1,0,1,"dummy"
"29344",0,3,0,3,"dummy"
"29345",1,1,0,2,"dummy"
"29346",0,0,3,3,"dummy"
"29348",2,0,3,5,"dummy"
"29352",0,2,1,3,"dummy"
"29354",0,2,0,2,"dummy"
"29355",0,1,0,1,"dummy"
"29357",0,2,1,3,"dummy"
"29404",30,26,3,59,"dummy"
"29405",0,0,0,0,"dummy"
"29407",1,2,0,3,"dummy"
"29408",0,2,0,2,"dummy"
"29409",0,1,0,1,"dummy"
"29412",0,0,1,1,"dummy"
"29413",0,0,1,1,"dummy"
"29415",0,0,1,1,"dummy"
"29416",1,13,1,15,"dummy"
"29417",0,0,2,2,"dummy"
"29428",0,0,1,1,"dummy"
"29429",0,1,0,1,"dummy"
"29432",0,5,0,5,"dummy"
"29440",1,1,1,3,"dummy"
"29446",0,0,0,0,"dummy"
"29447",1,3,0,4,"dummy"
"29448",0,2,0,2,"dummy"
"29449",0,1,0,1,"dummy"
"29450",0,1,0,1,"dummy"
"29451",21,4,2,27,"dummy"
"29509",0,2,0,2,"dummy"
"29512",0,3,0,3,"dummy"
"29513",1,3,0,4,"dummy"
"29514",1,1,0,2,"dummy"
"29515",0,1,0,1,"dummy"
"29516",1,4,0,5,"dummy"
"29522",3,0,4,7,"dummy"
"29523",4,2,2,8,"dummy"
"29524",1,0,0,1,"dummy"
"29525",19,38,3,60,"dummy"
"29526",1,4,0,5,"dummy"
"29527",3,0,0,3,"dummy"
"29528",8,1,1,10,"dummy"
"29529",0,2,0,2,"dummy"
"29530",0,0,0,0,"dummy"
"29531",2,0,0,2,"dummy"
"29532",0,1,0,1,"dummy"
"29533",0,2,0,2,"dummy"
"29534",0,5,0,5,"dummy"
"29535",0,0,1,1,"dummy"
"29536",2,1,0,3,"dummy"
"29537",1,0,2,3,"dummy"
"29538",0,1,0,1,"dummy"
"29539",0,0,3,3,"dummy"
"29542",0,0,1,1,"dummy"
"29543",0,0,1,1,"dummy"
"29550",1,2,0,3,"dummy"
"29551",0,1,0,1,"dummy"
"29552",0,0,0,0,"dummy"
"29553",0,0,0,0,"dummy"
"29554",2,2,0,4,"dummy"
"29555",2,0,0,2,"dummy"
"29556",1,1,0,2,"dummy"
"29557",1,1,0,2,"dummy"
"29558",0,2,0,2,"dummy"
"29561",1,0,2,3,"dummy"
"29562",0,0,1,1,"dummy"
"29563",0,1,0,1,"dummy"
"29564",0,0,0,0,"dummy"
"29565",0,0,0,0,"dummy"
"29566",4,3,0,7,"dummy"
"29567",0,0,0,0,"dummy"
"29568",0,0,1,1,"dummy"
"29569",0,0,1,1,"dummy"
"29570",2,3,0,5,"dummy"
"29571",2,2,0,4,"dummy"
"29572",0,1,0,1,"dummy"
"29573",0,0,0,0,"dummy"
"29574",1,1,0,2,"dummy"
"29575",1,2,2,5,"dummy"
"29576",3,1,0,4,"dummy"
"29577",1,4,0,5,"dummy"
"29578",0,0,1,1,"dummy"
"29579",0,1,0,1,"dummy"
"29580",0,1,0,1,"dummy"
"29581",0,1,0,1,"dummy"
"29582",0,1,0,1,"dummy"
"29583",0,1,0,1,"dummy"
"29584",0,1,0,1,"dummy"
"29585",5,5,1,11,"dummy"
"29586",1,1,1,3,"dummy"
"29596",0,0,0,0,"dummy"
"29597",4,9,1,14,"dummy"
"29598",0,0,1,1,"dummy"
"29599",2,2,2,6,"dummy"
"29600",4,2,4,10,"dummy"
"29601",2,2,0,4,"dummy"
"29604",0,0,2,2,"dummy"
"29605",0,3,0,3,"dummy"
"29606",0,0,1,1,"dummy"
"29609",0,0,1,1,"dummy"
"29610",0,0,1,1,"dummy"
"29611",0,0,1,1,"dummy"
"29612",0,0,1,1,"dummy"
"29613",0,0,1,1,"dummy"
"29614",0,0,1,1,"dummy"
"29615",0,0,1,1,"dummy"
"29616",0,0,1,1,"dummy"
"29617",0,0,1,1,"dummy"
"29618",0,0,1,1,"dummy"
"29619",0,0,1,1,"dummy"
"29620",0,0,1,1,"dummy"
"29621",0,0,1,1,"dummy"
"29622",0,0,1,1,"dummy"
"29623",0,0,1,1,"dummy"
"29624",0,0,1,1,"dummy"
"29625",0,0,1,1,"dummy"
"29626",0,0,1,1,"dummy"
"29627",0,0,1,1,"dummy"
"29628",0,0,1,1,"dummy"
"29629",0,0,1,1,"dummy"
"29635",0,10,0,10,"dummy"
"29636",0,1,0,1,"dummy"
"29637",7,5,1,13,"dummy"
"29638",0,1,0,1,"dummy"
"29640",2,3,1,6,"dummy"
"29641",6,2,1,9,"dummy"
"29642",0,1,0,1,"dummy"
"29643",0,0,1,1,"dummy"
"29646",0,10,3,13,"dummy"
"29678",0,0,0,0,"dummy"
"29679",0,0,0,0,"dummy"
"29680",0,0,0,0,"dummy"
"29681",0,0,0,0,"dummy"
"29684",0,1,0,1,"dummy"
"29692",0,1,0,1,"dummy"
"29695",0,2,0,2,"dummy"
"29697",11,0,3,14,"dummy"
"29698",0,1,0,1,"dummy"
"29699",0,2,0,2,"dummy"
"29702",3,0,0,3,"dummy"
"29703",0,2,2,4,"dummy"
"29728",0,12,2,14,"dummy"
"29729",1,7,0,8,"dummy"
"29731",0,1,0,1,"dummy"
"29732",0,0,3,3,"dummy"
"29733",0,0,1,1,"dummy"
"29736",0,0,0,0,"dummy"
"29743",0,2,0,2,"dummy"
"29744",1,2,1,4,"dummy"
"29745",0,1,1,2,"dummy"
"29747",0,1,0,1,"dummy"
"29748",2,9,3,14,"dummy"
"29749",5,10,2,17,"dummy"
"29750",0,1,0,1,"dummy"
"29752",0,0,1,1,"dummy"
"29753",0,0,1,1,"dummy"
"29754",0,0,1,1,"dummy"
"29755",0,0,1,1,"dummy"
"29756",0,0,1,1,"dummy"
"29757",0,0,1,1,"dummy"
"29758",0,0,1,1,"dummy"
"29759",0,0,1,1,"dummy"
"29760",0,0,1,1,"dummy"
"29761",0,0,1,1,"dummy"
"29762",0,0,1,1,"dummy"
"29763",2,6,0,8,"dummy"
"29764",0,0,1,1,"dummy"
"29765",0,0,1,1,"dummy"
"29766",0,0,1,1,"dummy"
"29767",0,0,1,1,"dummy"
"29768",0,0,2,2,"dummy"
"29769",1,1,2,4,"dummy"
"29770",0,0,1,1,"dummy"
"29771",0,0,1,1,"dummy"
"29772",0,0,1,1,"dummy"
"29773",0,0,1,1,"dummy"
"29774",0,0,1,1,"dummy"
"29775",0,0,1,1,"dummy"
"29776",0,0,1,1,"dummy"
"29777",0,0,1,1,"dummy"
"29778",0,0,1,1,"dummy"
"29779",0,0,1,1,"dummy"
"29780",0,0,1,1,"dummy"
"29781",0,0,1,1,"dummy"
"29796",0,3,1,4,"dummy"
"29797",0,0,3,3,"dummy"
"29807",1,4,0,5,"dummy"
"29808",1,2,2,5,"dummy"
"29809",0,0,3,3,"dummy"
"29813",0,1,1,2,"dummy"
"29814",1,0,1,2,"dummy"
"29815",0,3,1,4,"dummy"
"29821",6,4,1,11,"dummy"
"29834",0,1,0,1,"dummy"
"29835",0,0,1,1,"dummy"
"29836",0,0,1,1,"dummy"
"29839",0,0,0,0,"dummy"
"29840",0,3,0,3,"dummy"
"29841",0,2,0,2,"dummy"
"29842",0,1,0,1,"dummy"
"29843",1,4,2,7,"dummy"
"29844",2,4,0,6,"dummy"
"29845",0,1,0,1,"dummy"
"29849",0,0,0,0,"dummy"
"29860",0,10,0,10,"dummy"
"29861",0,2,1,3,"dummy"
"29862",0,2,0,2,"dummy"
"29863",0,2,0,2,"dummy"
"29864",2,0,0,2,"dummy"
"29865",0,0,0,0,"dummy"
"29866",8,2,0,10,"dummy"
"29867",0,0,0,0,"dummy"
"29868",0,0,0,0,"dummy"
"29871",1,1,0,2,"dummy"
"29874",0,0,1,1,"dummy"
"29876",0,0,1,1,"dummy"
"29877",0,0,3,3,"dummy"
"29878",0,0,3,3,"dummy"
"29879",0,0,4,4,"dummy"
"29880",2,3,1,6,"dummy"
"29882",0,1,0,1,"dummy"
"29883",0,1,0,1,"dummy"
"29884",1,1,0,2,"dummy"
"29885",1,4,0,5,"dummy"
"29886",3,1,0,4,"dummy"
"29887",0,1,0,1,"dummy"
"29888",2,1,1,4,"dummy"
"29889",0,0,1,1,"dummy"
"29890",0,0,1,1,"dummy"
"29891",0,0,1,1,"dummy"
"29892",0,0,1,1,"dummy"
"29895",0,1,0,1,"dummy"
"29899",0,0,0,0,"dummy"
"29900",0,0,1,1,"dummy"
"29901",0,0,0,0,"dummy"
"29902",0,0,0,0,"dummy"
"29903",0,0,1,1,"dummy"
"29904",0,0,0,0,"dummy"
"29906",0,0,2,2,"dummy"
"29907",0,0,1,1,"dummy"
"29908",5,5,0,10,"dummy"
"29909",6,7,0,13,"dummy"
"29910",0,3,1,4,"dummy"
"29911",1,0,0,1,"dummy"
"29913",1,2,0,3,"dummy"
"29914",0,0,1,1,"dummy"
"29915",1,0,1,2,"dummy"
"29916",0,1,0,1,"dummy"
"29917",3,2,0,5,"dummy"
"29918",0,1,0,1,"dummy"
"29919",3,0,1,4,"dummy"
"29926",3,2,1,6,"dummy"
"29927",0,4,0,4,"dummy"
"29948",0,0,0,0,"dummy"
"29949",0,2,0,2,"dummy"
"29950",0,1,0,1,"dummy"
"29951",1,0,1,2,"dummy"
"29952",0,0,1,1,"dummy"
"29953",0,0,1,1,"dummy"
"29954",0,0,1,1,"dummy"
"29955",0,0,1,1,"dummy"
"29956",0,0,1,1,"dummy"
"29957",0,0,1,1,"dummy"
"29959",0,0,0,0,"dummy"
"29962",1,0,2,3,"dummy"
"29965",0,0,1,1,"dummy"
"29966",0,1,1,2,"dummy"
"29967",1,0,1,2,"dummy"
"29971",2,0,2,4,"dummy"
"29974",8,3,3,14,"dummy"
"29975",1,0,0,1,"dummy"
"29976",3,3,4,10,"dummy"
"29991",0,0,1,1,"dummy"
"29992",0,0,1,1,"dummy"
"29993",0,1,0,1,"dummy"
"29996",1,5,0,6,"dummy"
"29997",0,2,0,2,"dummy"
"29998",0,3,0,3,"dummy"
"29999",2,4,0,6,"dummy"
"30000",0,1,0,1,"dummy"
"30002",0,4,0,4,"dummy"
"30003",0,0,1,1,"dummy"
"30004",0,0,1,1,"dummy"
"30005",0,1,0,1,"dummy"
"30006",0,0,1,1,"dummy"
"30007",0,3,0,3,"dummy"
"30011",0,0,0,0,"dummy"
"30012",0,0,0,0,"dummy"
"30013",0,0,0,0,"dummy"
"30014",0,0,0,0,"dummy"
"30015",0,0,0,0,"dummy"
"30016",0,0,0,0,"dummy"
"30017",0,0,0,0,"dummy"
"30018",0,0,0,0,"dummy"
"30019",0,0,0,0,"dummy"
"30020",0,0,0,0,"dummy"
"30021",0,0,0,0,"dummy"
"30022",0,0,0,0,"dummy"
"30023",0,0,0,0,"dummy"
"30024",0,0,0,0,"dummy"
"30025",0,0,0,0,"dummy"
"30026",0,1,0,1,"dummy"
"30027",0,0,0,0,"dummy"
"30028",0,0,0,0,"dummy"
"30029",0,0,0,0,"dummy"
"30030",0,0,0,0,"dummy"
"30031",0,6,0,6,"dummy"
"30032",0,0,0,0,"dummy"
"30033",0,0,0,0,"dummy"
"30034",0,0,1,1,"dummy"
"30035",0,0,0,0,"dummy"
"30036",0,0,1,1,"dummy"
"30037",0,0,1,1,"dummy"
"30038",0,2,0,2,"dummy"
"30039",0,0,0,0,"dummy"
"30040",0,2,0,2,"dummy"
"30041",2,0,0,2,"dummy"
"30042",0,2,0,2,"dummy"
"30043",2,0,0,2,"dummy"
"30044",0,2,0,2,"dummy"
"30045",3,0,0,3,"dummy"
"30046",0,2,0,2,"dummy"
"30047",0,0,0,0,"dummy"
"30048",0,0,0,0,"dummy"
"30049",0,38,2,40,"dummy"
"30050",0,2,0,2,"dummy"
"30051",1,0,0,1,"dummy"
"30052",0,4,0,4,"dummy"
"30053",2,4,0,6,"dummy"
"30054",0,3,0,3,"dummy"
"30055",16,4,9,29,"dummy"
"30056",0,2,0,2,"dummy"
"30057",0,0,1,1,"dummy"
"30058",3,14,2,19,"dummy"
"30059",0,2,0,2,"dummy"
"30060",1,1,1,3,"dummy"
"30061",0,2,0,2,"dummy"
"30062",0,0,1,1,"dummy"
"30063",0,0,2,2,"dummy"
"30064",0,0,1,1,"dummy"
"30065",0,1,0,1,"dummy"
"30066",0,0,0,0,"dummy"
"30067",0,0,0,0,"dummy"
"30068",0,0,0,0,"dummy"
"30069",0,0,1,1,"dummy"
"30070",0,2,0,2,"dummy"
"30071",0,1,0,1,"dummy"
"30072",0,1,0,1,"dummy"
"30073",1,0,0,1,"dummy"
"30074",0,0,1,1,"dummy"
"30075",0,2,0,2,"dummy"
"30076",9,1,0,10,"dummy"
"30077",0,2,0,2,"dummy"
"30078",0,2,0,2,"dummy"
"30079",2,2,0,4,"dummy"
"30084",0,0,2,2,"dummy"
"30085",0,2,0,2,"dummy"
"30086",0,0,0,0,"dummy"
"30087",2,1,0,3,"dummy"
"30088",1,0,0,1,"dummy"
"30089",0,0,0,0,"dummy"
"30092",2,4,0,6,"dummy"
"30094",0,0,2,2,"dummy"
"30095",0,1,0,1,"dummy"
"30097",4,5,3,12,"dummy"
"30102",0,0,1,1,"dummy"
"30103",0,0,1,1,"dummy"
"30104",0,3,0,3,"dummy"
"30105",0,1,3,4,"dummy"
"30106",8,8,0,16,"dummy"
"30107",5,0,1,6,"dummy"
"30108",1,0,0,1,"dummy"
"30109",0,0,1,1,"dummy"
"30110",0,0,1,1,"dummy"
"30111",2,2,0,4,"dummy"
"30112",0,1,0,1,"dummy"
"30114",0,2,0,2,"dummy"
"30115",0,3,0,3,"dummy"
"30116",0,2,0,2,"dummy"
"30117",0,0,0,0,"dummy"
"30118",0,0,1,1,"dummy"
"30119",0,0,1,1,"dummy"
"30120",0,0,0,0,"dummy"
"30121",11,7,0,18,"dummy"
"30122",0,0,1,1,"dummy"
"30123",3,3,0,6,"dummy"
"30124",1,1,1,3,"dummy"
"30125",0,0,2,2,"dummy"
"30138",0,0,1,1,"dummy"
"30139",0,0,1,1,"dummy"
"30140",6,5,8,19,"dummy"
"30141",1,0,0,1,"dummy"
"30142",0,0,1,1,"dummy"
"30145",0,2,2,4,"dummy"
"30146",2,0,2,4,"dummy"
"30147",0,1,0,1,"dummy"
"30156",0,0,1,1,"dummy"
"30158",0,2,4,6,"dummy"
"30159",17,10,1,28,"dummy"
"30160",0,0,1,1,"dummy"
"30161",0,1,0,1,"dummy"
"30181",0,0,1,1,"dummy"
"30182",0,0,1,1,"dummy"
"30186",1,0,0,1,"dummy"
"30187",0,0,1,1,"dummy"
"30189",0,1,0,1,"dummy"
"30190",0,0,1,1,"dummy"
"30191",0,0,1,1,"dummy"
"30192",0,0,1,1,"dummy"
"30193",0,0,1,1,"dummy"
"30195",6,1,2,9,"dummy"
"30196",0,2,0,2,"dummy"
"30197",2,0,0,2,"dummy"
"30198",7,8,3,18,"dummy"
"30199",1,0,0,1,"dummy"
"30200",0,0,1,1,"dummy"
"30202",0,5,0,5,"dummy"
"30203",7,0,1,8,"dummy"
"30206",2,4,1,7,"dummy"
"30208",1,9,3,13,"dummy"
"30209",1,1,0,2,"dummy"
"30210",0,4,0,4,"dummy"
"30212",0,5,1,6,"dummy"
"30218",0,2,0,2,"dummy"
"30219",0,1,0,1,"dummy"
"30221",1,1,0,2,"dummy"
"30222",10,3,0,13,"dummy"
"30223",1,10,1,12,"dummy"
"30226",10,8,2,20,"dummy"
"30229",0,0,1,1,"dummy"
"30231",2,2,1,5,"dummy"
"30232",0,2,0,2,"dummy"
"30234",0,4,0,4,"dummy"
"30235",1,7,0,8,"dummy"
"30237",0,0,1,1,"dummy"
"30238",0,0,1,1,"dummy"
"30267",0,1,0,1,"dummy"
"30268",0,6,1,7,"dummy"
"30269",0,0,0,0,"dummy"
"30270",0,1,0,1,"dummy"
"30271",0,1,0,1,"dummy"
"30272",3,0,0,3,"dummy"
"30273",0,1,0,1,"dummy"
"30274",0,1,0,1,"dummy"
"30275",5,5,0,10,"dummy"
"30276",0,0,1,1,"dummy"
"30277",0,0,1,1,"dummy"
"30278",0,0,1,1,"dummy"
"30279",0,0,1,1,"dummy"
"30291",0,2,0,2,"dummy"
"30292",0,0,0,0,"dummy"
"30293",0,0,0,0,"dummy"
"30294",0,11,0,11,"dummy"
"30295",0,0,2,2,"dummy"
"30296",0,0,2,2,"dummy"
"30297",0,0,1,1,"dummy"
"30300",1,1,0,2,"dummy"
"30301",0,1,0,1,"dummy"
"30302",2,1,5,8,"dummy"
"30303",0,0,1,1,"dummy"
"30304",0,1,0,1,"dummy"
"30305",0,0,1,1,"dummy"
"30306",0,0,1,1,"dummy"
"30307",0,0,1,1,"dummy"
"30309",0,0,3,3,"dummy"
"30310",2,3,0,5,"dummy"
"30311",2,9,0,11,"dummy"
"30313",0,2,0,2,"dummy"
"30314",5,2,1,8,"dummy"
"30316",5,1,0,6,"dummy"
"30317",0,0,1,1,"dummy"
"30319",7,0,2,9,"dummy"
"30322",0,0,4,4,"dummy"
"30323",0,0,2,2,"dummy"
"30327",7,4,1,12,"dummy"
"30328",2,0,0,2,"dummy"
"30329",0,1,0,1,"dummy"
"30330",1,0,0,1,"dummy"
"30331",0,0,0,0,"dummy"
"30332",1,0,0,1,"dummy"
"30336",0,0,0,0,"dummy"
"30337",0,0,1,1,"dummy"
"30339",0,10,0,10,"dummy"
"30340",0,2,0,2,"dummy"
"30341",1,0,0,1,"dummy"
"30342",4,5,2,11,"dummy"
"30344",6,9,5,20,"dummy"
"30345",1,1,1,3,"dummy"
"30347",2,0,0,2,"dummy"
"30348",0,0,0,0,"dummy"
"30349",2,0,0,2,"dummy"
"30352",2,0,3,5,"dummy"
"30353",0,0,2,2,"dummy"
"30354",0,7,0,7,"dummy"
"30356",6,10,4,20,"dummy"
"30357",2,0,3,5,"dummy"
"30358",0,1,0,1,"dummy"
"30359",2,3,3,8,"dummy"
"30360",0,1,0,1,"dummy"
"30362",0,1,0,1,"dummy"
"30364",1,1,2,4,"dummy"
"30365",0,0,1,1,"dummy"
"30366",0,1,0,1,"dummy"
"30368",1,0,0,1,"dummy"
"30369",0,0,1,1,"dummy"
"30370",0,0,1,1,"dummy"
"30373",9,2,0,11,"dummy"
"30374",0,3,0,3,"dummy"
"30375",3,2,0,5,"dummy"
"30376",0,4,0,4,"dummy"
"30377",2,3,0,5,"dummy"
"30378",0,4,2,6,"dummy"
"30381",5,0,0,5,"dummy"
"30389",0,0,1,1,"dummy"
"30390",0,0,0,0,"dummy"
"30391",0,0,0,0,"dummy"
"30392",0,0,1,1,"dummy"
"30393",0,0,1,1,"dummy"
"30394",0,0,1,1,"dummy"
"30395",0,0,1,1,"dummy"
"30396",0,0,1,1,"dummy"
"30397",0,0,1,1,"dummy"
"30398",0,0,1,1,"dummy"
"30399",0,3,0,3,"dummy"
"30400",0,0,1,1,"dummy"
"30401",0,0,0,0,"dummy"
"30402",0,0,0,0,"dummy"
"30404",11,1,0,12,"dummy"
"30405",0,2,0,2,"dummy"
"30408",0,2,0,2,"dummy"
"30410",0,0,1,1,"dummy"
"30411",1,0,0,1,"dummy"
"30412",1,14,0,15,"dummy"
"30413",0,0,1,1,"dummy"
"30419",0,1,0,1,"dummy"
"30420",0,0,2,2,"dummy"
"30421",0,0,0,0,"dummy"
"30422",3,2,0,5,"dummy"
"30423",7,1,1,9,"dummy"
"30424",0,19,0,19,"dummy"
"30425",0,0,0,0,"dummy"
"30426",0,0,0,0,"dummy"
"30427",0,0,3,3,"dummy"
"30428",0,0,0,0,"dummy"
"30429",0,0,2,2,"dummy"
"30430",0,0,4,4,"dummy"
"30431",0,0,3,3,"dummy"
"30436",0,1,0,1,"dummy"
"30437",1,0,0,1,"dummy"
"30438",2,0,0,2,"dummy"
"30442",0,0,0,0,"dummy"
"30443",0,0,0,0,"dummy"
"30445",0,4,0,4,"dummy"
"30446",2,0,0,2,"dummy"
"30449",0,9,0,9,"dummy"
"30450",3,1,0,4,"dummy"
"30451",0,3,0,3,"dummy"
"30452",0,1,0,1,"dummy"
"30454",0,0,2,2,"dummy"
"30456",0,0,1,1,"dummy"
"30458",2,0,0,2,"dummy"
"30459",0,0,0,0,"dummy"
"30463",0,3,0,3,"dummy"
"30464",3,1,0,4,"dummy"
"30465",3,1,0,4,"dummy"
"30466",0,1,0,1,"dummy"
"30467",0,3,0,3,"dummy"
"30469",0,0,1,1,"dummy"
"30470",7,3,0,10,"dummy"
"30471",0,1,0,1,"dummy"
"30476",0,4,4,8,"dummy"
"30478",0,0,1,1,"dummy"
"30479",0,2,0,2,"dummy"
"30480",0,0,1,1,"dummy"
"30484",0,0,1,1,"dummy"
"30489",0,2,0,2,"dummy"
"30490",0,2,0,2,"dummy"
"30491",0,1,0,1,"dummy"
"30492",0,0,1,1,"dummy"
"30494",2,35,0,37,"dummy"
"30497",1,0,0,1,"dummy"
"30499",0,0,1,1,"dummy"
"30500",0,0,1,1,"dummy"
"30501",0,0,1,1,"dummy"
"30503",0,0,1,1,"dummy"
"30504",0,0,1,1,"dummy"
"30507",0,0,1,1,"dummy"
"30508",0,1,0,1,"dummy"
"30509",0,2,0,2,"dummy"
"30510",0,3,0,3,"dummy"
"30511",0,1,0,1,"dummy"
"30512",0,0,0,0,"dummy"
"30514",7,12,3,22,"dummy"
"30524",0,17,2,19,"dummy"
"30525",0,2,1,3,"dummy"
"30526",1,2,0,3,"dummy"
"30527",0,1,0,1,"dummy"
"30528",2,0,0,2,"dummy"
"30529",0,2,0,2,"dummy"
"30531",0,0,2,2,"dummy"
"30532",0,0,2,2,"dummy"
"30533",0,0,1,1,"dummy"
"30534",0,0,1,1,"dummy"
"30536",0,0,1,1,"dummy"
"30538",0,4,1,5,"dummy"
"30539",12,0,2,14,"dummy"
"30540",0,1,0,1,"dummy"
"30541",10,11,5,26,"dummy"
"30542",12,2,1,15,"dummy"
"30578",0,1,0,1,"dummy"
"30579",0,4,0,4,"dummy"
"30580",3,16,1,20,"dummy"
"30581",0,0,1,1,"dummy"
"30582",1,0,1,2,"dummy"
"30583",0,1,0,1,"dummy"
"30584",0,0,1,1,"dummy"
"30585",0,0,0,0,"dummy"
"30586",0,0,2,2,"dummy"
"30587",0,1,2,3,"dummy"
"30588",0,0,0,0,"dummy"
"30589",3,11,2,16,"dummy"
"30590",0,0,3,3,"dummy"
"30591",1,3,0,4,"dummy"
"30592",1,3,0,4,"dummy"
"30597",0,2,0,2,"dummy"
"30598",2,0,0,2,"dummy"
"30599",0,1,0,1,"dummy"
"30600",1,0,0,1,"dummy"
"30601",0,4,0,4,"dummy"
"30603",2,4,0,6,"dummy"
"30604",0,2,0,2,"dummy"
"30605",0,2,0,2,"dummy"
"30606",10,2,0,12,"dummy"
"30607",0,2,0,2,"dummy"
"30608",0,0,0,0,"dummy"
"30611",2,3,0,5,"dummy"
"30612",0,3,0,3,"dummy"
"30613",0,0,1,1,"dummy"
"30614",2,2,0,4,"dummy"
"30615",1,1,2,4,"dummy"
"30616",3,4,0,7,"dummy"
"30617",0,0,1,1,"dummy"
"30618",0,0,1,1,"dummy"
"30621",2,0,1,3,"dummy"
"30622",0,0,0,0,"dummy"
"30623",1,3,0,4,"dummy"
"30625",0,2,1,3,"dummy"
"30626",0,0,1,1,"dummy"
"30627",0,1,0,1,"dummy"
"30628",2,2,1,5,"dummy"
"30629",1,0,1,2,"dummy"
"30630",5,3,3,11,"dummy"
"30631",2,2,1,5,"dummy"
"30632",0,0,1,1,"dummy"
"30633",4,0,1,5,"dummy"
"30634",2,1,2,5,"dummy"
"30635",2,1,1,4,"dummy"
"30636",0,0,3,3,"dummy"
"30637",0,0,1,1,"dummy"
"30638",0,3,2,5,"dummy"
"30639",2,2,8,12,"dummy"
"30640",4,2,3,9,"dummy"
"30641",0,0,1,1,"dummy"
"30642",0,0,1,1,"dummy"
"30643",0,0,1,1,"dummy"
"30644",0,0,2,2,"dummy"
"30646",2,5,3,10,"dummy"
"30647",1,0,1,2,"dummy"
"30648",1,0,3,4,"dummy"
"30649",0,2,0,2,"dummy"
"30650",2,0,0,2,"dummy"
"30651",0,4,0,4,"dummy"
"30652",14,8,5,27,"dummy"
"30653",6,12,6,24,"dummy"
"30654",1,0,1,2,"dummy"
"30655",4,0,0,4,"dummy"
"30656",1,1,2,4,"dummy"
"30657",1,2,0,3,"dummy"
"30658",7,5,4,16,"dummy"
"30659",0,0,0,0,"dummy"
"30682",10,7,2,19,"dummy"
"30683",0,0,0,0,"dummy"
"30684",0,0,1,1,"dummy"
"30685",0,2,0,2,"dummy"
"30686",0,0,1,1,"dummy"
"30687",0,0,0,0,"dummy"
"30688",1,7,0,8,"dummy"
"30689",7,1,0,8,"dummy"
"30690",4,5,0,9,"dummy"
"30691",0,0,1,1,"dummy"
"30692",6,6,0,12,"dummy"
"30693",6,7,1,14,"dummy"
"30694",1,4,0,5,"dummy"
"30695",0,1,0,1,"dummy"
"30696",0,0,0,0,"dummy"
"30697",0,0,1,1,"dummy"
"30698",9,3,2,14,"dummy"
"30699",1,5,3,9,"dummy"
"30701",15,10,1,26,"dummy"
"30714",6,2,1,9,"dummy"
"30727",1,3,0,4,"dummy"
"30728",3,1,0,4,"dummy"
"30729",6,0,5,11,"dummy"
"30731",2,0,0,2,"dummy"
"30732",1,0,0,1,"dummy"
"30733",1,2,0,3,"dummy"
"30734",2,1,0,3,"dummy"
"30735",0,0,1,1,"dummy"
"30736",1,3,0,4,"dummy"
"30737",2,1,1,4,"dummy"
"30738",0,1,0,1,"dummy"
"30739",0,1,1,2,"dummy"
"30740",0,2,0,2,"dummy"
"30741",3,0,0,3,"dummy"
"30742",2,2,1,5,"dummy"
"30743",0,0,0,0,"dummy"
"30744",3,1,1,5,"dummy"
"30745",0,0,0,0,"dummy"
"30746",0,0,0,0,"dummy"
"30747",0,1,0,1,"dummy"
"30748",0,1,0,1,"dummy"
"30749",1,2,1,4,"dummy"
"30750",0,1,0,1,"dummy"
"30751",0,0,3,3,"dummy"
"30752",1,6,3,10,"dummy"
"30753",0,2,0,2,"dummy"
"30754",0,1,0,1,"dummy"
"30755",0,4,1,5,"dummy"
"30756",0,1,0,1,"dummy"
"30757",0,0,1,1,"dummy"
"30758",0,6,0,6,"dummy"
"30759",0,1,0,1,"dummy"
"30760",0,6,0,6,"dummy"
"30761",0,1,0,1,"dummy"
"30762",0,0,0,0,"dummy"
"30763",0,0,2,2,"dummy"
"30764",0,8,0,8,"dummy"
"30765",0,2,0,2,"dummy"
"30766",0,2,0,2,"dummy"
"30767",0,0,1,1,"dummy"
"30768",0,0,0,0,"dummy"
"30769",0,0,1,1,"dummy"
"30770",0,1,0,1,"dummy"
"30771",0,3,0,3,"dummy"
"30772",6,0,0,6,"dummy"
"30773",0,0,1,1,"dummy"
"30774",0,0,1,1,"dummy"
"30775",0,0,0,0,"dummy"
"30776",0,1,0,1,"dummy"
"30777",0,1,0,1,"dummy"
"30778",0,0,1,1,"dummy"
"30779",52,8,4,64,"dummy"
"30780",1,15,0,16,"dummy"
"30781",1,1,0,2,"dummy"
"30782",0,0,14,14,"dummy"
"30784",0,13,0,13,"dummy"
"30787",0,0,1,1,"dummy"
"30788",0,6,3,9,"dummy"
"30789",2,2,1,5,"dummy"
"30790",0,1,5,6,"dummy"
"30791",2,2,2,6,"dummy"
"30792",0,2,0,2,"dummy"
"30793",0,0,2,2,"dummy"
"30794",2,3,2,7,"dummy"
"30795",1,10,2,13,"dummy"
"30796",0,1,0,1,"dummy"
"30797",0,2,0,2,"dummy"
"30798",4,0,0,4,"dummy"
"30799",0,2,0,2,"dummy"
"30800",0,1,0,1,"dummy"
"30801",1,5,1,7,"dummy"
"30802",2,5,0,7,"dummy"
"30803",6,6,2,14,"dummy"
"30804",7,1,0,8,"dummy"
"30805",7,13,11,31,"dummy"
"30806",0,2,0,2,"dummy"
"30807",0,2,0,2,"dummy"
"30808",2,2,0,4,"dummy"
"30809",2,2,7,11,"dummy"
"30810",0,0,1,1,"dummy"
"30811",0,0,2,2,"dummy"
"30812",0,2,0,2,"dummy"
"30813",0,0,1,1,"dummy"
"30814",0,1,0,1,"dummy"
"30815",2,2,1,5,"dummy"
"30816",0,5,0,5,"dummy"
"30817",0,0,1,1,"dummy"
"30818",2,0,0,2,"dummy"
"30819",2,2,4,8,"dummy"
"30820",2,3,6,11,"dummy"
"30821",0,1,1,2,"dummy"
"30822",1,0,1,2,"dummy"
"30823",0,0,1,1,"dummy"
"30824",0,0,1,1,"dummy"
"30825",0,0,1,1,"dummy"
"30826",2,2,0,4,"dummy"
"30827",0,2,1,3,"dummy"
"30828",15,5,3,23,"dummy"
"30829",2,2,0,4,"dummy"
"30830",2,2,0,4,"dummy"
"30831",0,0,1,1,"dummy"
"30832",0,0,2,2,"dummy"
"30833",0,1,0,1,"dummy"
"30834",1,0,2,3,"dummy"
"30835",2,2,0,4,"dummy"
"30836",2,2,0,4,"dummy"
"30837",2,2,0,4,"dummy"
"30838",1,0,2,3,"dummy"
"30839",17,6,6,29,"dummy"
"30840",0,0,4,4,"dummy"
"30841",2,2,0,4,"dummy"
"30842",0,0,1,1,"dummy"
"30843",0,0,1,1,"dummy"
"30844",2,0,0,2,"dummy"
"30845",0,0,1,1,"dummy"
"30846",0,0,1,1,"dummy"
"30847",0,0,1,1,"dummy"
"30848",0,0,1,1,"dummy"
"30849",0,0,1,1,"dummy"
"30850",7,5,2,14,"dummy"
"30851",0,0,1,1,"dummy"
"30852",0,2,0,2,"dummy"
"30853",4,2,1,7,"dummy"
"30854",0,0,1,1,"dummy"
"30855",0,0,1,1,"dummy"
"30856",0,0,1,1,"dummy"
"30857",0,0,1,1,"dummy"
"30859",4,1,0,5,"dummy"
"30862",3,13,1,17,"dummy"
"30863",6,0,0,6,"dummy"
"30864",9,3,2,14,"dummy"
"30865",0,0,1,1,"dummy"
"30866",0,1,0,1,"dummy"
"30867",1,1,1,3,"dummy"
"30868",0,0,0,0,"dummy"
"30869",0,1,1,2,"dummy"
"30870",0,0,1,1,"dummy"
"30871",0,0,0,0,"dummy"
"30872",0,0,0,0,"dummy"
"30873",0,0,1,1,"dummy"
"30874",1,2,0,3,"dummy"
"30875",9,2,2,13,"dummy"
"30876",0,0,2,2,"dummy"
"30879",0,1,1,2,"dummy"
"30880",0,0,1,1,"dummy"
"30881",0,0,1,1,"dummy"
"30883",0,33,2,35,"dummy"
"30884",1,1,2,4,"dummy"
"30885",0,0,1,1,"dummy"
"30886",1,0,0,1,"dummy"
"30887",13,3,0,16,"dummy"
"30888",0,1,0,1,"dummy"
"30889",0,3,0,3,"dummy"
"30890",0,11,0,11,"dummy"
"30891",0,5,1,6,"dummy"
"30892",11,20,3,34,"dummy"
"30893",0,0,1,1,"dummy"
"30894",0,0,1,1,"dummy"
"30895",1,10,0,11,"dummy"
"30896",0,1,0,1,"dummy"
"30897",0,0,1,1,"dummy"
"30898",0,1,0,1,"dummy"
"30899",0,0,1,1,"dummy"
"30900",0,1,0,1,"dummy"
"30901",5,16,1,22,"dummy"
"30902",2,1,0,3,"dummy"
"30903",0,4,0,4,"dummy"
"30904",6,0,0,6,"dummy"
"30906",0,9,0,9,"dummy"
"30907",1,7,0,8,"dummy"
"30908",0,0,1,1,"dummy"
"30909",0,0,1,1,"dummy"
"30910",1,9,0,10,"dummy"
"30911",1,2,0,3,"dummy"
"30912",0,0,2,2,"dummy"
"30913",0,0,2,2,"dummy"
"30914",0,0,2,2,"dummy"
"30915",0,0,2,2,"dummy"
"30916",7,3,1,11,"dummy"
"30917",0,0,2,2,"dummy"
"30918",1,2,0,3,"dummy"
"30919",6,2,0,8,"dummy"
"30920",0,1,0,1,"dummy"
"30921",0,3,0,3,"dummy"
"30922",0,0,1,1,"dummy"
"30923",0,3,0,3,"dummy"
"30924",0,0,1,1,"dummy"
"30925",1,2,0,3,"dummy"
"30929",5,12,0,17,"dummy"
"30930",26,13,3,42,"dummy"
"30933",0,0,0,0,"dummy"
"30934",1,1,0,2,"dummy"
"30935",0,1,1,2,"dummy"
"30936",0,0,2,2,"dummy"
"30937",1,1,0,2,"dummy"
"30938",0,12,0,12,"dummy"
"30941",3,0,3,6,"dummy"
"30942",0,4,1,5,"dummy"
"30945",19,7,4,30,"dummy"
"30950",0,3,0,3,"dummy"
"30952",1,12,0,13,"dummy"
"30953",2,2,0,4,"dummy"
"30954",0,2,0,2,"dummy"
"30955",0,1,0,1,"dummy"
"30956",0,1,0,1,"dummy"
"30957",0,1,0,1,"dummy"
"30959",0,0,1,1,"dummy"
"30961",1,0,1,2,"dummy"
"30962",0,0,3,3,"dummy"
"30963",4,0,0,4,"dummy"
"30964",0,0,2,2,"dummy"
"30965",9,2,2,13,"dummy"
"30966",0,3,0,3,"dummy"
"30967",1,0,0,1,"dummy"
"31012",0,1,0,1,"dummy"
"31014",4,0,3,7,"dummy"
"31015",0,0,0,0,"dummy"
"31017",0,0,1,1,"dummy"
"31018",0,0,1,1,"dummy"
"31019",0,0,1,1,"dummy"
"31020",0,0,1,1,"dummy"
"31021",0,0,1,1,"dummy"
"31022",0,0,1,1,"dummy"
"31023",0,0,1,1,"dummy"
"31024",0,0,1,1,"dummy"
"31025",0,0,1,1,"dummy"
"31026",0,0,1,1,"dummy"
"31027",0,0,1,1,"dummy"
"31028",0,0,1,1,"dummy"
"31029",0,0,1,1,"dummy"
"31030",0,0,1,1,"dummy"
"31031",0,0,1,1,"dummy"
"31032",0,0,1,1,"dummy"
"31033",0,0,1,1,"dummy"
"31034",0,0,1,1,"dummy"
"31035",0,0,1,1,"dummy"
"31036",0,0,1,1,"dummy"
"31037",0,0,1,1,"dummy"
"31039",0,3,0,3,"dummy"
"31045",0,0,1,1,"dummy"
"31047",2,3,3,8,"dummy"
"31049",0,1,0,1,"dummy"
"31056",0,0,1,1,"dummy"
"31057",1,1,0,2,"dummy"
"31058",0,0,4,4,"dummy"
"31059",0,0,2,2,"dummy"
"31060",0,0,0,0,"dummy"
"31063",1,2,0,3,"dummy"
"31064",3,1,1,5,"dummy"
"31065",0,0,2,2,"dummy"
"31066",0,0,0,0,"dummy"
"31068",0,0,3,3,"dummy"
"31069",0,0,1,1,"dummy"
"31070",2,3,3,8,"dummy"
"31076",0,1,0,1,"dummy"
"31079",0,1,0,1,"dummy"
"31083",0,1,0,1,"dummy"
"31085",0,1,0,1,"dummy"
"31086",0,1,0,1,"dummy"
"31088",0,0,1,1,"dummy"
"31089",0,0,1,1,"dummy"
"31091",22,0,2,24,"dummy"
"31094",0,0,2,2,"dummy"
"31096",2,2,0,4,"dummy"
"31099",0,0,2,2,"dummy"
"31100",1,0,0,1,"dummy"
"31102",0,3,0,3,"dummy"
"31103",0,1,0,1,"dummy"
"31104",1,3,1,5,"dummy"
"31105",0,6,1,7,"dummy"
"31106",6,0,1,7,"dummy"
"31107",3,1,1,5,"dummy"
"31108",1,1,0,2,"dummy"
"31109",1,2,1,4,"dummy"
"31110",5,3,1,9,"dummy"
"31111",2,4,0,6,"dummy"
"31112",0,0,2,2,"dummy"
"31113",2,3,0,5,"dummy"
"31115",0,0,0,0,"dummy"
"31116",0,0,0,0,"dummy"
"31118",10,4,4,18,"dummy"
"31120",0,1,0,1,"dummy"
"31121",0,1,1,2,"dummy"
"31123",2,0,0,2,"dummy"
"31124",0,0,1,1,"dummy"
"31125",0,0,1,1,"dummy"
"31126",0,5,0,5,"dummy"
"31127",0,5,0,5,"dummy"
"31128",0,11,0,11,"dummy"
"31129",0,2,1,3,"dummy"
"31130",11,1,0,12,"dummy"
"31131",0,1,0,1,"dummy"
"31132",0,0,2,2,"dummy"
"31133",2,9,0,11,"dummy"
"31134",1,0,0,1,"dummy"
"31135",0,1,0,1,"dummy"
"31136",0,0,2,2,"dummy"
"31138",6,10,1,17,"dummy"
"31139",2,4,2,8,"dummy"
"31140",3,6,0,9,"dummy"
"31141",0,0,0,0,"dummy"
"31142",1,1,0,2,"dummy"
"31143",0,0,1,1,"dummy"
"31144",2,5,0,7,"dummy"
"31145",0,1,0,1,"dummy"
"31146",0,4,0,4,"dummy"
"31147",0,0,1,1,"dummy"
"31150",0,0,1,1,"dummy"
"31151",1,6,1,8,"dummy"
"31152",0,0,0,0,"dummy"
"31156",0,1,0,1,"dummy"
"31157",0,1,0,1,"dummy"
"31158",1,0,0,1,"dummy"
"31159",0,0,1,1,"dummy"
"31160",0,0,1,1,"dummy"
"31162",0,0,3,3,"dummy"
"31166",1,0,1,2,"dummy"
"31167",0,0,2,2,"dummy"
"31168",1,0,0,1,"dummy"
"31169",0,3,4,7,"dummy"
"31170",0,2,0,2,"dummy"
"31173",0,1,0,1,"dummy"
"31174",0,0,0,0,"dummy"
"31175",0,0,1,1,"dummy"
"31208",2,3,1,6,"dummy"
"31209",0,0,1,1,"dummy"
"31210",1,4,4,9,"dummy"
"31211",0,3,0,3,"dummy"
"31212",0,6,0,6,"dummy"
"31213",0,0,1,1,"dummy"
"31214",0,0,1,1,"dummy"
"31216",0,1,0,1,"dummy"
"31217",0,1,0,1,"dummy"
"31218",0,7,0,7,"dummy"
"31232",0,1,0,1,"dummy"
"31233",0,0,1,1,"dummy"
"31235",1,2,1,4,"dummy"
"31236",3,5,1,9,"dummy"
"31237",0,0,1,1,"dummy"
"31239",0,0,0,0,"dummy"
"31240",3,2,0,5,"dummy"
"31246",0,2,0,2,"dummy"
"31248",0,0,1,1,"dummy"
"31257",0,1,0,1,"dummy"
"31258",8,9,0,17,"dummy"
"31259",0,2,0,2,"dummy"
"31260",0,3,3,6,"dummy"
"31261",0,0,2,2,"dummy"
"31262",0,1,0,1,"dummy"
"31263",1,0,0,1,"dummy"
"31264",0,0,0,0,"dummy"
"31265",0,1,0,1,"dummy"
"31266",1,1,1,3,"dummy"
"31267",1,0,1,2,"dummy"
"31268",0,0,0,0,"dummy"
"31269",0,0,0,0,"dummy"
"31270",0,1,0,1,"dummy"
"31271",0,0,0,0,"dummy"
"31272",1,0,0,1,"dummy"
"31273",1,0,1,2,"dummy"
"31274",0,4,1,5,"dummy"
"31275",0,0,0,0,"dummy"
"31276",0,0,0,0,"dummy"
"31277",0,1,0,1,"dummy"
"31281",0,0,1,1,"dummy"
"31290",0,1,0,1,"dummy"
"31291",0,5,1,6,"dummy"
"31292",8,23,4,35,"dummy"
"31296",1,3,0,4,"dummy"
"31297",0,1,0,1,"dummy"
"31308",0,1,0,1,"dummy"
"31310",2,1,0,3,"dummy"
"31311",0,2,0,2,"dummy"
"31312",1,0,0,1,"dummy"
"31313",0,0,0,0,"dummy"
"31314",0,0,0,0,"dummy"
"31322",0,0,2,2,"dummy"
"31323",0,0,1,1,"dummy"
"31326",0,0,1,1,"dummy"
"31336",0,2,0,2,"dummy"
"31337",0,2,0,2,"dummy"
"31342",0,12,1,13,"dummy"
"31349",0,5,1,6,"dummy"
"31357",0,0,1,1,"dummy"
"31359",0,0,2,2,"dummy"
"31360",7,3,0,10,"dummy"
"31363",0,0,1,1,"dummy"
"31364",4,2,1,7,"dummy"
"31365",0,0,1,1,"dummy"
"31366",0,1,0,1,"dummy"
"31367",0,23,0,23,"dummy"
"31370",0,1,0,1,"dummy"
"31376",0,0,1,1,"dummy"
"31380",0,1,0,1,"dummy"
"31381",1,0,0,1,"dummy"
"31382",1,0,0,1,"dummy"
"31386",0,2,0,2,"dummy"
"31387",0,0,1,1,"dummy"
"31388",0,0,1,1,"dummy"
"31392",1,0,2,3,"dummy"
"31393",0,1,2,3,"dummy"
"31394",1,0,1,2,"dummy"
"31395",0,0,1,1,"dummy"
"31396",0,0,1,1,"dummy"
"31397",0,0,1,1,"dummy"
"31401",0,0,1,1,"dummy"
"31402",0,0,1,1,"dummy"
"31403",0,1,0,1,"dummy"
"31405",0,0,1,1,"dummy"
"31415",0,0,0,0,"dummy"
"31416",0,4,2,6,"dummy"
"31419",0,6,0,6,"dummy"
"31420",1,3,0,4,"dummy"
"31421",6,5,2,13,"dummy"
"31423",2,0,0,2,"dummy"
"31424",0,2,0,2,"dummy"
"31425",0,4,1,5,"dummy"
"31426",0,0,2,2,"dummy"
"31427",0,1,1,2,"dummy"
"31429",2,6,0,8,"dummy"
"31430",1,0,0,1,"dummy"
"31431",0,0,0,0,"dummy"
"31432",0,0,1,1,"dummy"
"31433",2,2,1,5,"dummy"
"31434",1,1,0,2,"dummy"
"31435",0,2,1,3,"dummy"
"31436",1,1,0,2,"dummy"
"31437",1,1,1,3,"dummy"
"31438",0,1,0,1,"dummy"
"31439",0,0,1,1,"dummy"
"31440",0,0,1,1,"dummy"
"31441",0,0,1,1,"dummy"
"31442",1,2,0,3,"dummy"
"31443",0,0,1,1,"dummy"
"31444",0,0,1,1,"dummy"
"31445",0,0,1,1,"dummy"
"31455",7,0,0,7,"dummy"
"31456",0,0,1,1,"dummy"
"31458",5,4,2,11,"dummy"
"31459",0,1,0,1,"dummy"
"31460",1,1,0,2,"dummy"
"31461",4,6,2,12,"dummy"
"31465",0,0,3,3,"dummy"
"31466",0,0,2,2,"dummy"
"31467",0,1,1,2,"dummy"
"31468",7,4,5,16,"dummy"
"31470",0,38,0,38,"dummy"
"31471",2,1,0,3,"dummy"
"31472",0,2,1,3,"dummy"
"31473",1,3,1,5,"dummy"
"31474",0,5,0,5,"dummy"
"31475",10,0,0,10,"dummy"
"31476",0,0,1,1,"dummy"
"31477",0,1,0,1,"dummy"
"31478",2,0,0,2,"dummy"
"31479",1,0,0,1,"dummy"
"31480",26,0,0,26,"dummy"
"31481",7,2,2,11,"dummy"
"31482",8,2,0,10,"dummy"
"31483",0,10,3,13,"dummy"
"31484",0,2,0,2,"dummy"
"31485",0,0,1,1,"dummy"
"31486",0,1,0,1,"dummy"
"31487",1,0,0,1,"dummy"
"31488",0,2,0,2,"dummy"
"31489",0,0,1,1,"dummy"
"31490",2,0,0,2,"dummy"
"31491",0,1,0,1,"dummy"
"31492",0,0,2,2,"dummy"
"31493",3,3,0,6,"dummy"
"31494",0,2,0,2,"dummy"
"31495",0,0,1,1,"dummy"
"31496",1,3,3,7,"dummy"
"31497",14,11,0,25,"dummy"
"31498",0,5,0,5,"dummy"
"31499",0,1,0,1,"dummy"
"31502",0,3,0,3,"dummy"
"31503",0,0,1,1,"dummy"
"31505",0,1,0,1,"dummy"
"31506",0,1,0,1,"dummy"
"31507",3,2,1,6,"dummy"
"31509",0,5,1,6,"dummy"
"31511",0,1,0,1,"dummy"
"31512",2,3,2,7,"dummy"
"31513",0,2,0,2,"dummy"
"31514",0,1,2,3,"dummy"
"31515",2,10,1,13,"dummy"
"31516",0,1,0,1,"dummy"
"31517",3,0,1,4,"dummy"
"31518",2,0,0,2,"dummy"
"31521",0,0,1,1,"dummy"
"31522",1,3,1,5,"dummy"
"31531",0,1,2,3,"dummy"
"31533",1,1,3,5,"dummy"
"31534",0,1,2,3,"dummy"
"31535",9,14,10,33,"dummy"
"31536",0,0,0,0,"dummy"
"31537",29,3,0,32,"dummy"
"31538",1,2,0,3,"dummy"
"31539",1,3,0,4,"dummy"
"31541",3,0,1,4,"dummy"
"31543",0,1,0,1,"dummy"
"31544",0,0,1,1,"dummy"
"31545",2,7,1,10,"dummy"
"31562",2,1,1,4,"dummy"
"31565",0,1,0,1,"dummy"
"31566",3,3,0,6,"dummy"
"31567",0,0,0,0,"dummy"
"31568",12,19,4,35,"dummy"
"31569",3,0,0,3,"dummy"
"31570",0,1,0,1,"dummy"
"31571",0,0,1,1,"dummy"
"31572",0,0,0,0,"dummy"
"31573",4,3,4,11,"dummy"
"31577",0,0,1,1,"dummy"
"31607",0,0,1,1,"dummy"
"31608",0,0,2,2,"dummy"
"31621",1,1,0,2,"dummy"
"31640",1,1,0,2,"dummy"
"31641",0,0,1,1,"dummy"
"31642",0,0,1,1,"dummy"
"31643",0,1,3,4,"dummy"
"31649",1,2,0,3,"dummy"
"31650",3,7,0,10,"dummy"
"31651",7,19,3,29,"dummy"
"31652",1,1,0,2,"dummy"
"31653",0,1,0,1,"dummy"
"31654",0,2,1,3,"dummy"
"31655",0,1,0,1,"dummy"
"31656",0,1,0,1,"dummy"
"31657",1,0,0,1,"dummy"
"31668",0,0,1,1,"dummy"
"31687",0,0,0,0,"dummy"
"31688",0,0,0,0,"dummy"
"31575",0,2,0,2,"dummy"
"31579",0,0,0,0,"dummy"
"31580",0,0,5,5,"dummy"
"31581",0,1,0,1,"dummy"
"31582",0,0,0,0,"dummy"
"31583",0,1,0,1,"dummy"
"31584",0,2,1,3,"dummy"
"31585",0,1,0,1,"dummy"
"31586",0,2,0,2,"dummy"
"31587",0,2,0,2,"dummy"
"31588",0,2,0,2,"dummy"
"31589",0,0,1,1,"dummy"
"31590",0,2,0,2,"dummy"
"31591",0,1,0,1,"dummy"
"31592",0,1,0,1,"dummy"
"31593",1,2,0,3,"dummy"
"31594",0,1,0,1,"dummy"
"31600",0,1,0,1,"dummy"
"31601",0,0,1,1,"dummy"
"31612",4,0,0,4,"dummy"
"31615",1,4,0,5,"dummy"
"31623",0,0,3,3,"dummy"
"31624",0,0,2,2,"dummy"
"31625",0,0,1,1,"dummy"
"31626",0,0,1,1,"dummy"
"31627",0,0,0,0,"dummy"
"31628",0,0,1,1,"dummy"
"31629",0,0,1,1,"dummy"
"31630",0,0,1,1,"dummy"
"31631",0,0,2,2,"dummy"
"31632",0,0,1,1,"dummy"
"31645",0,2,1,3,"dummy"
"31646",0,5,2,7,"dummy"
"31647",0,0,1,1,"dummy"
"31659",0,1,0,1,"dummy"
"31660",0,0,1,1,"dummy"
"31661",0,2,0,2,"dummy"
"31662",8,5,3,16,"dummy"
"31672",0,1,0,1,"dummy"
"31673",0,0,1,1,"dummy"
"31674",0,0,1,1,"dummy"
"31675",1,5,2,8,"dummy"
"31676",0,0,1,1,"dummy"
"31677",0,0,2,2,"dummy"
"31678",0,1,0,1,"dummy"
"31679",0,1,0,1,"dummy"
"31680",0,0,2,2,"dummy"
"31681",1,0,4,5,"dummy"
"31682",0,0,2,2,"dummy"
"31683",0,0,2,2,"dummy"
"31684",0,1,0,1,"dummy"
"31685",0,0,2,2,"dummy"
"31692",0,0,1,1,"dummy"
"31693",1,5,2,8,"dummy"
"31694",0,1,0,1,"dummy"
"31695",0,6,0,6,"dummy"
"31696",14,12,2,28,"dummy"
"31697",0,2,0,2,"dummy"
"31698",0,1,0,1,"dummy"
"31699",0,3,0,3,"dummy"
"31700",13,9,4,26,"dummy"
"31701",0,1,0,1,"dummy"
"31702",0,1,0,1,"dummy"
"31703",1,1,0,2,"dummy"
"31704",0,0,0,0,"dummy"
"31705",0,2,1,3,"dummy"
"31706",0,1,0,1,"dummy"
"31721",1,0,0,1,"dummy"
"31722",5,22,4,31,"dummy"
"31723",9,12,1,22,"dummy"
"31724",4,1,0,5,"dummy"
"31727",0,0,1,1,"dummy"
"31729",0,31,0,31,"dummy"
"31732",0,2,0,2,"dummy"
"31734",0,0,1,1,"dummy"
"31740",5,1,2,8,"dummy"
"31743",1,1,0,2,"dummy"
"31744",0,0,1,1,"dummy"
"31750",0,1,2,3,"dummy"
"31751",0,0,0,0,"dummy"
"31752",0,1,0,1,"dummy"
"31753",4,0,2,6,"dummy"
"31754",1,0,0,1,"dummy"
"31755",0,0,0,0,"dummy"
"31757",0,0,1,1,"dummy"
"31758",0,1,0,1,"dummy"
"31759",0,2,0,2,"dummy"
"31760",2,0,0,2,"dummy"
"31761",0,3,0,3,"dummy"
"31762",0,4,0,4,"dummy"
"31763",0,3,0,3,"dummy"
"31766",0,0,1,1,"dummy"
"31769",7,6,0,13,"dummy"
"31770",0,0,1,1,"dummy"
"31771",3,2,0,5,"dummy"
"31772",2,0,0,2,"dummy"
"31775",0,15,0,15,"dummy"
"31779",0,1,0,1,"dummy"
"31780",0,0,1,1,"dummy"
"31782",0,1,0,1,"dummy"
"31783",0,1,2,3,"dummy"
"31784",0,0,1,1,"dummy"
"31785",0,0,3,3,"dummy"
"31786",0,2,0,2,"dummy"
"31787",0,2,0,2,"dummy"
"31788",0,1,0,1,"dummy"
"31789",4,10,4,18,"dummy"
"31791",0,3,0,3,"dummy"
"31792",4,12,0,16,"dummy"
"31793",1,26,3,30,"dummy"
"31795",0,0,1,1,"dummy"
"31796",0,1,0,1,"dummy"
"31799",2,0,2,4,"dummy"
"31800",2,1,0,3,"dummy"
"31803",0,0,1,1,"dummy"
"31805",0,0,1,1,"dummy"
"31806",0,1,0,1,"dummy"
"31808",0,1,0,1,"dummy"
"31810",0,0,1,1,"dummy"
"31811",0,0,1,1,"dummy"
"31812",0,0,2,2,"dummy"
"31813",0,2,0,2,"dummy"
"31814",0,0,1,1,"dummy"
"31815",0,1,0,1,"dummy"
"31816",0,0,1,1,"dummy"
"31819",0,0,3,3,"dummy"
"31837",0,1,0,1,"dummy"
"31838",0,1,0,1,"dummy"
"31839",0,2,0,2,"dummy"
"31840",8,2,1,11,"dummy"
"31841",0,3,0,3,"dummy"
"31842",0,2,0,2,"dummy"
"31843",0,2,0,2,"dummy"
"31844",0,0,1,1,"dummy"
"31845",0,1,0,1,"dummy"
"31846",1,2,1,4,"dummy"
"31847",13,2,3,18,"dummy"
"31848",0,2,0,2,"dummy"
"31849",0,1,0,1,"dummy"
"31850",8,3,1,12,"dummy"
"31851",0,0,2,2,"dummy"
"31852",0,0,2,2,"dummy"
"31853",0,0,2,2,"dummy"
"31856",0,0,1,1,"dummy"
"31858",12,12,2,26,"dummy"
"31859",5,1,1,7,"dummy"
"31861",0,0,1,1,"dummy"
"31864",0,2,0,2,"dummy"
"31867",0,0,3,3,"dummy"
"31868",0,11,0,11,"dummy"
"31869",0,0,0,0,"dummy"
"31872",1,3,1,5,"dummy"
"31873",1,1,0,2,"dummy"
"31874",5,4,0,9,"dummy"
"31875",4,5,7,16,"dummy"
"31876",0,0,7,7,"dummy"
"31877",0,3,0,3,"dummy"
"31878",0,1,0,1,"dummy"
"31879",0,0,2,2,"dummy"
"31880",3,0,4,7,"dummy"
"31881",1,0,0,1,"dummy"
"31882",1,0,2,3,"dummy"
"31883",0,12,0,12,"dummy"
"31884",4,4,0,8,"dummy"
"31885",0,1,1,2,"dummy"
"31886",8,8,3,19,"dummy"
"31888",0,1,0,1,"dummy"
"31889",1,0,0,1,"dummy"
"31890",0,3,1,4,"dummy"
"31891",4,0,0,4,"dummy"
"31892",0,4,0,4,"dummy"
"31893",0,1,0,1,"dummy"
"31894",0,1,0,1,"dummy"
"31896",0,3,1,4,"dummy"
"31900",0,0,1,1,"dummy"
"31902",5,0,1,6,"dummy"
"31903",10,2,0,12,"dummy"
"31904",2,1,1,4,"dummy"
"31905",3,5,1,9,"dummy"
"31906",4,3,1,8,"dummy"
"31907",1,3,0,4,"dummy"
"31908",4,6,0,10,"dummy"
"31909",1,1,1,3,"dummy"
"31910",0,1,0,1,"dummy"
"31911",0,1,1,2,"dummy"
"31912",0,2,0,2,"dummy"
"31913",0,0,1,1,"dummy"
"31917",0,0,1,1,"dummy"
"31918",1,3,1,5,"dummy"
"31919",39,5,0,44,"dummy"
"31923",0,1,0,1,"dummy"
"31924",0,3,1,4,"dummy"
"31925",0,1,0,1,"dummy"
"31926",0,0,0,0,"dummy"
"31927",0,6,2,8,"dummy"
"31928",0,1,0,1,"dummy"
"31929",5,4,0,9,"dummy"
"31930",1,0,0,1,"dummy"
"31933",0,0,3,3,"dummy"
"31934",1,1,1,3,"dummy"
"31935",0,0,1,1,"dummy"
"31938",1,0,2,3,"dummy"
"31939",0,0,0,0,"dummy"
"31941",3,4,1,8,"dummy"
"31942",1,3,0,4,"dummy"
"31943",1,0,0,1,"dummy"
"31944",0,0,1,1,"dummy"
"31948",6,7,1,14,"dummy"
"31949",0,1,0,1,"dummy"
"31951",1,1,0,2,"dummy"
"31963",8,0,1,9,"dummy"
"31964",0,0,0,0,"dummy"
"31971",0,0,1,1,"dummy"
"31972",0,0,1,1,"dummy"
"31973",0,0,2,2,"dummy"
"31974",26,3,7,36,"dummy"
"31987",0,1,0,1,"dummy"
"31988",0,2,2,4,"dummy"
"31989",3,0,0,3,"dummy"
"32020",0,0,2,2,"dummy"
"32061",1,10,2,13,"dummy"
"32087",0,1,0,1,"dummy"
"32088",1,1,0,2,"dummy"
"32089",5,5,0,10,"dummy"
"32090",0,0,0,0,"dummy"
"32091",0,1,0,1,"dummy"
"32092",0,0,1,1,"dummy"
"32093",0,0,1,1,"dummy"
"32105",0,0,0,0,"dummy"
"32106",0,0,1,1,"dummy"
"32107",0,0,0,0,"dummy"
"32108",0,0,1,1,"dummy"
"32119",1,0,0,1,"dummy"
"32120",0,0,2,2,"dummy"
"32121",0,0,0,0,"dummy"
"32122",0,0,0,0,"dummy"
"32125",2,6,0,8,"dummy"
"32126",0,1,0,1,"dummy"
"32127",0,0,1,1,"dummy"
"32138",1,1,0,2,"dummy"
"32139",4,0,0,4,"dummy"
"32153",7,10,2,19,"dummy"
"32154",4,4,0,8,"dummy"
"32155",0,0,0,0,"dummy"
"32156",0,2,0,2,"dummy"
"32157",3,3,0,6,"dummy"
"32158",11,3,0,14,"dummy"
"32169",0,1,0,1,"dummy"
"32172",4,3,1,8,"dummy"
"32190",0,10,0,10,"dummy"
"32221",0,0,1,1,"dummy"
"32222",0,3,4,7,"dummy"
"32223",0,0,1,1,"dummy"
"32224",5,2,1,8,"dummy"
"32225",0,1,0,1,"dummy"
"32226",2,2,0,4,"dummy"
"32227",0,1,0,1,"dummy"
"32228",0,1,7,8,"dummy"
"32229",0,3,0,3,"dummy"
"32230",0,0,0,0,"dummy"
"32231",0,0,1,1,"dummy"
"32232",0,0,1,1,"dummy"
"32233",0,1,1,2,"dummy"
"32234",2,0,0,2,"dummy"
"32235",6,3,1,10,"dummy"
"32236",0,1,0,1,"dummy"
"32237",2,5,4,11,"dummy"
"32238",0,0,1,1,"dummy"
"32239",0,1,0,1,"dummy"
"32240",0,0,3,3,"dummy"
"32241",0,0,1,1,"dummy"
"32242",1,1,0,2,"dummy"
"32243",3,3,0,6,"dummy"
"32244",0,1,0,1,"dummy"
"32253",0,1,0,1,"dummy"
"32259",8,0,0,8,"dummy"
"32260",0,0,1,1,"dummy"
"31980",0,1,2,3,"dummy"
"31981",0,2,0,2,"dummy"
"31993",0,0,1,1,"dummy"
"31994",0,0,0,0,"dummy"
"31995",0,1,0,1,"dummy"
"31996",1,2,0,3,"dummy"
"31997",0,1,0,1,"dummy"
"31998",1,10,1,12,"dummy"
"31999",1,1,0,2,"dummy"
"32000",0,1,0,1,"dummy"
"32001",7,2,0,9,"dummy"
"32002",0,1,0,1,"dummy"
"32003",0,0,1,1,"dummy"
"32004",0,0,2,2,"dummy"
"32007",2,2,1,5,"dummy"
"32008",0,2,0,2,"dummy"
"32013",0,0,2,2,"dummy"
"32022",1,4,1,6,"dummy"
"32023",0,0,1,1,"dummy"
"32024",0,0,1,1,"dummy"
"32025",0,2,1,3,"dummy"
"32026",1,5,4,10,"dummy"
"32027",0,0,1,1,"dummy"
"32028",1,0,4,5,"dummy"
"32029",0,3,1,4,"dummy"
"32030",0,0,1,1,"dummy"
"32031",0,0,1,1,"dummy"
"32032",0,0,1,1,"dummy"
"32042",3,0,0,3,"dummy"
"32043",0,3,0,3,"dummy"
"32044",5,0,0,5,"dummy"
"32047",0,0,1,1,"dummy"
"32048",0,0,1,1,"dummy"
"32049",0,0,1,1,"dummy"
"32050",0,0,1,1,"dummy"
"32051",0,0,1,1,"dummy"
"32052",0,0,1,1,"dummy"
"32053",0,0,1,1,"dummy"
"32054",0,0,1,1,"dummy"
"32055",0,0,1,1,"dummy"
"32056",0,0,1,1,"dummy"
"32057",0,0,1,1,"dummy"
"32095",0,1,2,3,"dummy"
"32096",6,4,1,11,"dummy"
"32101",0,1,0,1,"dummy"
"32102",0,2,0,2,"dummy"
"32103",1,3,0,4,"dummy"
"32110",0,0,0,0,"dummy"
"32111",3,6,2,11,"dummy"
"32112",0,2,0,2,"dummy"
"32113",0,0,1,1,"dummy"
"32114",0,0,1,1,"dummy"
"32115",0,5,1,6,"dummy"
"32131",0,0,0,0,"dummy"
"32132",0,2,0,2,"dummy"
"32133",0,0,1,1,"dummy"
"32136",0,0,0,0,"dummy"
"32160",0,0,2,2,"dummy"
"32161",1,0,3,4,"dummy"
"32164",0,0,1,1,"dummy"
"32167",0,0,1,1,"dummy"
"32182",0,1,1,2,"dummy"
"32183",0,21,0,21,"dummy"
"32188",0,0,1,1,"dummy"
"32192",0,0,0,0,"dummy"
"32198",0,0,1,1,"dummy"
"32199",0,0,1,1,"dummy"
"32200",0,1,0,1,"dummy"
"32201",1,0,0,1,"dummy"
"32202",0,1,0,1,"dummy"
"32203",1,0,0,1,"dummy"
"32204",0,0,2,2,"dummy"
"32205",0,2,0,2,"dummy"
"32206",2,0,0,2,"dummy"
"32207",0,2,0,2,"dummy"
"32208",0,0,1,1,"dummy"
"32209",0,1,0,1,"dummy"
"32210",0,0,1,1,"dummy"
"32211",0,1,0,1,"dummy"
"32212",0,1,0,1,"dummy"
"32213",0,2,0,2,"dummy"
"32214",4,0,0,4,"dummy"
"32215",0,1,1,2,"dummy"
"32216",0,1,0,1,"dummy"
"32217",0,0,1,1,"dummy"
"32218",0,0,1,1,"dummy"
"32219",0,0,1,1,"dummy"
"32246",3,17,3,23,"dummy"
"32249",4,0,1,5,"dummy"
"32255",0,0,1,1,"dummy"
"32256",0,0,1,1,"dummy"
"32257",0,1,0,1,"dummy"
"32276",0,0,1,1,"dummy"
"32279",0,2,1,3,"dummy"
"32280",0,1,0,1,"dummy"
"32281",1,2,2,5,"dummy"
"32282",0,0,1,1,"dummy"
"32283",0,1,0,1,"dummy"
"32288",1,0,0,1,"dummy"
"32289",0,0,1,1,"dummy"
"32296",1,0,0,1,"dummy"
"32299",0,3,0,3,"dummy"
"32300",0,1,0,1,"dummy"
"32301",0,1,0,1,"dummy"
"32302",0,1,0,1,"dummy"
"32303",0,0,1,1,"dummy"
"32304",0,0,1,1,"dummy"
"32327",0,10,0,10,"dummy"
"32328",0,2,0,2,"dummy"
"32329",0,1,0,1,"dummy"
"32330",4,3,2,9,"dummy"
"32351",0,0,1,1,"dummy"
"32352",1,0,0,1,"dummy"
"32353",0,0,0,0,"dummy"
"32354",0,0,1,1,"dummy"
"32355",0,0,1,1,"dummy"
"32375",2,5,1,8,"dummy"
"32376",3,4,0,7,"dummy"
"32377",4,3,0,7,"dummy"
"32378",0,0,1,1,"dummy"
"32379",0,0,1,1,"dummy"
"32380",0,0,0,0,"dummy"
"32381",0,0,2,2,"dummy"
"32382",0,0,1,1,"dummy"
"32383",0,1,0,1,"dummy"
"32394",0,2,1,3,"dummy"
"32395",15,8,2,25,"dummy"
"32396",19,10,0,29,"dummy"
"32397",0,0,0,0,"dummy"
"32398",0,0,1,1,"dummy"
"32399",0,0,0,0,"dummy"
"32410",3,0,3,6,"dummy"
"32440",0,0,0,0,"dummy"
"32445",2,0,2,4,"dummy"
"32446",1,0,0,1,"dummy"
"32449",2,2,0,4,"dummy"
"32453",1,0,0,1,"dummy"
"32454",0,1,0,1,"dummy"
"32455",1,0,0,1,"dummy"
"32456",1,9,0,10,"dummy"
"32457",0,0,1,1,"dummy"
"32458",1,0,0,1,"dummy"
"32459",0,1,0,1,"dummy"
"32460",0,1,0,1,"dummy"
"32461",1,5,0,6,"dummy"
"32261",0,0,2,2,"dummy"
"32272",1,0,0,1,"dummy"
"32273",0,0,1,1,"dummy"
"32274",5,0,1,6,"dummy"
"32308",0,0,1,1,"dummy"
"32309",0,0,1,1,"dummy"
"32310",0,0,2,2,"dummy"
"32311",0,0,1,1,"dummy"
"32312",0,0,0,0,"dummy"
"32313",0,0,1,1,"dummy"
"32314",0,2,0,2,"dummy"
"32315",2,2,0,4,"dummy"
"32316",0,0,1,1,"dummy"
"32317",0,3,0,3,"dummy"
"32318",0,1,0,1,"dummy"
"32319",0,0,1,1,"dummy"
"32320",1,4,0,5,"dummy"
"32321",0,1,0,1,"dummy"
"32322",0,2,0,2,"dummy"
"32323",9,2,0,11,"dummy"
"32324",2,2,0,4,"dummy"
"32325",0,2,0,2,"dummy"
"32357",12,1,0,13,"dummy"
"32358",0,0,1,1,"dummy"
"32359",2,0,0,2,"dummy"
"32370",0,1,0,1,"dummy"
"32371",1,1,0,2,"dummy"
"32372",0,3,0,3,"dummy"
"32373",0,1,0,1,"dummy"
"32387",0,0,0,0,"dummy"
"32388",0,2,0,2,"dummy"
"32401",0,0,1,1,"dummy"
"32406",0,0,2,2,"dummy"
"32442",0,0,1,1,"dummy"
"32443",0,4,5,9,"dummy"
"32451",0,2,0,2,"dummy"
"32463",3,1,0,4,"dummy"
"32464",0,0,1,1,"dummy"
"32465",2,2,0,4,"dummy"
"32466",0,0,0,0,"dummy"
"32467",0,2,0,2,"dummy"
"32470",0,1,0,1,"dummy"
"32471",0,1,0,1,"dummy"
"32487",0,1,0,1,"dummy"
"32502",2,4,0,6,"dummy"
"32503",0,2,0,2,"dummy"
"32504",0,2,0,2,"dummy"
"32505",10,2,0,12,"dummy"
"32506",0,2,0,2,"dummy"
"32510",2,5,1,8,"dummy"
"32511",0,1,0,1,"dummy"
"32521",4,0,2,6,"dummy"
"32522",3,3,0,6,"dummy"
"32523",0,0,4,4,"dummy"
"32524",0,3,0,3,"dummy"
"32525",0,3,0,3,"dummy"
"32526",0,2,0,2,"dummy"
"32529",2,0,0,2,"dummy"
"32530",1,0,0,1,"dummy"
"32533",0,0,0,0,"dummy"
"32534",0,0,0,0,"dummy"
"32535",1,0,0,1,"dummy"
"32536",0,0,0,0,"dummy"
"32497",2,0,3,5,"dummy"
"32498",1,0,0,1,"dummy"
"32499",0,1,0,1,"dummy"
"32500",0,1,1,2,"dummy"
"32508",0,1,0,1,"dummy"
"32515",2,4,1,7,"dummy"
"32516",4,56,2,62,"dummy"
"32517",0,5,2,7,"dummy"
"32518",3,2,0,5,"dummy"
"32519",29,16,2,47,"dummy"
"32559",0,1,0,1,"dummy"
"32560",0,0,0,0,"dummy"
"32561",0,0,0,0,"dummy"
"32562",0,0,0,0,"dummy"
"32563",0,0,0,0,"dummy"
"32564",0,0,0,0,"dummy"
"32565",0,1,0,1,"dummy"
"32566",0,0,0,0,"dummy"
"32567",0,0,0,0,"dummy"
"32568",0,2,0,2,"dummy"
"32569",0,0,0,0,"dummy"
"32570",1,5,0,6,"dummy"
"32571",0,0,0,0,"dummy"
"32572",0,1,4,5,"dummy"
"32573",0,0,0,0,"dummy"
"32574",1,0,4,5,"dummy"
"32575",0,0,0,0,"dummy"
"32576",0,1,0,1,"dummy"
"32577",0,2,0,2,"dummy"
"32578",0,0,0,0,"dummy"
"32579",0,0,0,0,"dummy"
"32580",0,0,0,0,"dummy"
"32581",0,0,0,0,"dummy"
"32582",0,0,0,0,"dummy"
"32590",0,0,2,2,"dummy"
"32591",0,1,0,1,"dummy"
"32604",0,0,1,1,"dummy"
"32605",0,0,0,0,"dummy"
"32608",0,1,0,1,"dummy"
"32609",1,0,0,1,"dummy"
"32610",0,1,0,1,"dummy"
"32614",0,0,2,2,"dummy"
"32623",0,0,1,1,"dummy"
"32624",0,0,2,2,"dummy"
"32625",2,0,0,2,"dummy"
"32668",0,2,0,2,"dummy"
"32669",0,0,1,1,"dummy"
"32670",0,1,0,1,"dummy"
"32671",5,2,1,8,"dummy"
"32674",0,15,1,16,"dummy"
"32675",1,1,1,3,"dummy"
"32676",0,0,2,2,"dummy"
"32677",0,1,0,1,"dummy"
"32682",0,0,0,0,"dummy"
"32683",0,0,1,1,"dummy"
"32691",2,0,1,3,"dummy"
"32692",0,0,0,0,"dummy"
"32693",0,0,2,2,"dummy"
"32694",0,0,2,2,"dummy"
"32695",1,2,2,5,"dummy"
"32696",0,0,1,1,"dummy"
"32697",1,2,1,4,"dummy"
"32698",0,1,1,2,"dummy"
"32699",0,1,0,1,"dummy"
"32700",0,0,0,0,"dummy"
"32701",0,0,0,0,"dummy"
"32702",0,1,0,1,"dummy"
"32703",0,0,3,3,"dummy"
"32704",0,1,0,1,"dummy"
"32705",0,0,1,1,"dummy"
"32537",0,0,0,0,"dummy"
"32538",0,13,0,13,"dummy"
"32539",4,4,0,8,"dummy"
"32540",0,0,4,4,"dummy"
"32541",0,1,4,5,"dummy"
"32542",0,0,1,1,"dummy"
"32543",0,0,0,0,"dummy"
"32544",4,4,1,9,"dummy"
"32545",7,4,0,11,"dummy"
"32546",8,11,0,19,"dummy"
"32547",0,4,1,5,"dummy"
"32548",0,0,0,0,"dummy"
"32549",11,4,1,16,"dummy"
"32550",4,7,1,12,"dummy"
"32551",0,0,2,2,"dummy"
"32552",0,0,1,1,"dummy"
"32553",1,0,0,1,"dummy"
"32554",1,0,0,1,"dummy"
"32555",0,0,1,1,"dummy"
"32588",0,1,0,1,"dummy"
"32612",0,2,0,2,"dummy"
"32616",0,0,1,1,"dummy"
"32621",0,0,1,1,"dummy"
"32653",0,0,0,0,"dummy"
"32658",0,1,0,1,"dummy"
"32659",0,0,1,1,"dummy"
"32660",0,1,1,2,"dummy"
"32661",0,0,1,1,"dummy"
"32662",0,0,1,1,"dummy"
"32663",0,0,1,1,"dummy"
"32666",6,2,0,8,"dummy"
"32687",0,0,0,0,"dummy"
"32710",0,15,0,15,"dummy"
"32713",2,1,1,4,"dummy"
"32731",0,10,0,10,"dummy"
"32732",0,0,0,0,"dummy"
"32733",0,1,0,1,"dummy"
"32734",0,0,5,5,"dummy"
"32735",0,0,5,5,"dummy"
"32738",0,0,1,1,"dummy"
"32739",3,2,0,5,"dummy"
"32740",0,4,0,4,"dummy"
"32743",0,0,0,0,"dummy"
"32751",1,3,0,4,"dummy"
"32769",0,0,1,1,"dummy"
"32770",0,0,1,1,"dummy"
"32771",0,0,0,0,"dummy"
"32772",0,0,0,0,"dummy"
"32773",0,0,0,0,"dummy"
"32774",0,1,0,1,"dummy"
"32787",1,1,2,4,"dummy"
"32788",0,0,1,1,"dummy"
"32789",1,2,0,3,"dummy"
"32793",9,2,1,12,"dummy"
"32794",0,0,1,1,"dummy"
"32795",0,0,1,1,"dummy"
"32796",0,0,1,1,"dummy"
"32797",5,4,1,10,"dummy"
"32798",0,0,1,1,"dummy"
"32892",0,0,0,0,"dummy"
"32893",0,0,0,0,"dummy"
"32894",0,0,0,0,"dummy"
"32895",0,0,0,0,"dummy"
"32896",0,0,0,0,"dummy"
"32897",0,0,0,0,"dummy"
"32898",0,0,0,0,"dummy"
"32899",0,0,0,0,"dummy"
"32900",0,0,0,0,"dummy"
"32706",1,0,0,1,"dummy"
"32715",0,0,3,3,"dummy"
"32716",0,1,0,1,"dummy"
"32717",1,2,0,3,"dummy"
"32718",0,0,0,0,"dummy"
"32719",2,1,3,6,"dummy"
"32720",0,0,0,0,"dummy"
"32721",0,6,0,6,"dummy"
"32726",0,2,0,2,"dummy"
"32727",0,1,0,1,"dummy"
"32728",7,11,1,19,"dummy"
"32729",0,1,3,4,"dummy"
"32745",0,0,1,1,"dummy"
"32746",1,0,0,1,"dummy"
"32747",0,1,0,1,"dummy"
"32748",0,0,0,0,"dummy"
"32749",1,1,0,2,"dummy"
"32766",8,9,0,17,"dummy"
"32767",0,2,0,2,"dummy"
"32776",4,0,1,5,"dummy"
"32777",0,0,0,0,"dummy"
"32778",3,2,2,7,"dummy"
"32781",2,2,0,4,"dummy"
"32782",0,2,10,12,"dummy"
"32783",0,1,0,1,"dummy"
"32784",7,18,0,25,"dummy"
"32785",4,0,0,4,"dummy"
"32920",0,19,0,19,"dummy"
"32921",3,10,0,13,"dummy"
"32922",3,1,0,4,"dummy"
"32923",1,0,0,1,"dummy"
"32924",0,1,0,1,"dummy"
"32925",2,1,2,5,"dummy"
"32926",0,1,1,2,"dummy"
"32927",0,1,0,1,"dummy"
"32928",0,1,1,2,"dummy"
"32929",0,0,1,1,"dummy"
"32930",0,0,0,0,"dummy"
"32931",0,0,1,1,"dummy"
"32932",0,4,0,4,"dummy"
"32933",1,0,1,2,"dummy"
"32934",0,5,0,5,"dummy"
"32978",2,4,0,6,"dummy"
"32979",0,2,0,2,"dummy"
"32980",0,2,0,2,"dummy"
"32981",10,2,0,12,"dummy"
"32982",0,2,0,2,"dummy"
"32983",0,0,0,0,"dummy"
"32984",0,0,3,3,"dummy"
"32985",0,5,0,5,"dummy"
"32999",2,0,1,3,"dummy"
"33000",0,1,1,2,"dummy"
"33001",0,0,1,1,"dummy"
"33002",0,0,0,0,"dummy"
"32901",0,0,0,0,"dummy"
"32902",0,0,0,0,"dummy"
"32903",0,0,0,0,"dummy"
"32904",0,0,0,0,"dummy"
"32905",0,0,0,0,"dummy"
"32906",0,0,0,0,"dummy"
"32907",0,0,0,0,"dummy"
"32908",0,0,0,0,"dummy"
"32909",0,0,0,0,"dummy"
"32910",0,0,0,0,"dummy"
"32911",0,0,0,0,"dummy"
"32912",0,0,0,0,"dummy"
"32913",0,0,0,0,"dummy"
"32914",0,0,0,0,"dummy"
"32915",0,0,0,0,"dummy"
"32916",0,0,0,0,"dummy"
"32917",0,0,0,0,"dummy"
"32918",0,0,0,0,"dummy"
"32964",0,7,0,7,"dummy"
"32965",1,0,1,2,"dummy"
"32966",0,0,1,1,"dummy"
"32967",0,0,1,1,"dummy"
"32968",0,0,1,1,"dummy"
"32969",0,0,1,1,"dummy"
"32970",0,0,1,1,"dummy"
"32971",0,0,1,1,"dummy"
"32972",0,0,1,1,"dummy"
"32973",0,0,1,1,"dummy"
"32974",0,0,1,1,"dummy"
"32975",0,0,1,1,"dummy"
"32976",0,0,1,1,"dummy"
"32987",3,3,0,6,"dummy"
"32988",4,9,0,13,"dummy"
"32989",0,1,0,1,"dummy"
"32990",9,3,0,12,"dummy"
"32991",0,0,5,5,"dummy"
"32992",0,0,1,1,"dummy"
"32993",0,0,1,1,"dummy"
"32994",1,2,0,3,"dummy"
"32995",1,5,0,6,"dummy"
"32996",0,0,1,1,"dummy"
"32997",0,0,1,1,"dummy"
"33006",0,0,1,1,"dummy"
"33015",0,2,0,2,"dummy"
"33032",0,0,0,0,"dummy"
"33033",0,2,0,2,"dummy"
"33034",0,0,1,1,"dummy"
"33035",0,1,0,1,"dummy"
"33036",1,0,0,1,"dummy"
"33037",0,1,0,1,"dummy"
"33003",0,0,0,0,"dummy"
"33004",0,0,0,0,"dummy"
"33008",0,0,2,2,"dummy"
"33009",5,8,1,14,"dummy"
"33010",0,5,0,5,"dummy"
"33011",0,3,0,3,"dummy"
"33012",6,0,0,6,"dummy"
"33013",0,0,2,2,"dummy"
"33017",0,1,0,1,"dummy"
"33018",0,3,0,3,"dummy"
"33019",0,2,0,2,"dummy"
"33020",3,0,0,3,"dummy"
"33021",0,0,0,0,"dummy"
"33022",4,1,0,5,"dummy"
"33023",1,0,0,1,"dummy"
"33024",0,0,0,0,"dummy"
"33025",0,0,0,0,"dummy"
"33026",0,3,1,4,"dummy"
"33027",0,0,0,0,"dummy"
"33028",4,0,0,4,"dummy"
"33053",0,0,0,0,"dummy"
"33054",0,0,1,1,"dummy"
"33055",0,0,0,0,"dummy"
"33134",0,0,1,1,"dummy"
"33065",7,5,0,12,"dummy"
"33067",0,0,1,1,"dummy"
"33069",0,1,0,1,"dummy"
"33070",13,2,1,16,"dummy"
"33071",0,6,0,6,"dummy"
"33079",0,1,0,1,"dummy"
"33080",0,1,0,1,"dummy"
"33081",0,0,1,1,"dummy"
"33082",0,2,0,2,"dummy"
"33084",4,2,2,8,"dummy"
"33085",0,1,0,1,"dummy"
"33086",1,0,1,2,"dummy"
"33087",3,5,2,10,"dummy"
"33088",0,1,0,1,"dummy"
"33089",0,0,0,0,"dummy"
"33090",6,5,2,13,"dummy"
"33091",0,0,2,2,"dummy"
"33092",3,2,0,5,"dummy"
"33094",2,3,1,6,"dummy"
"33095",0,1,0,1,"dummy"
"33096",7,3,0,10,"dummy"
"33097",0,2,1,3,"dummy"
"33098",0,1,0,1,"dummy"
"33099",0,0,1,1,"dummy"
"33102",4,6,0,10,"dummy"
"33104",0,1,0,1,"dummy"
"33105",0,3,0,3,"dummy"
"33106",0,2,0,2,"dummy"
"33107",1,0,0,1,"dummy"
"33108",0,5,0,5,"dummy"
"33111",0,3,0,3,"dummy"
"33113",0,0,2,2,"dummy"
"33119",29,2,1,32,"dummy"
"33120",1,0,0,1,"dummy"
"33124",0,11,0,11,"dummy"
"33125",4,1,1,6,"dummy"
"33126",0,0,0,0,"dummy"
"33130",0,0,2,2,"dummy"
"33131",0,0,1,1,"dummy"
"33132",0,0,1,1,"dummy"
"33133",0,0,1,1,"dummy"
"33135",0,0,1,1,"dummy"
"33136",0,0,1,1,"dummy"
"33137",0,0,1,1,"dummy"
"33138",0,0,1,1,"dummy"
"33139",0,0,1,1,"dummy"
"33140",2,2,2,6,"dummy"
"33141",0,0,1,1,"dummy"
"33142",0,0,1,1,"dummy"
"33145",0,0,0,0,"dummy"
"33146",0,0,0,0,"dummy"
"33147",0,1,0,1,"dummy"
"33149",1,6,0,7,"dummy"
"33150",6,1,0,7,"dummy"
"33152",0,0,1,1,"dummy"
"33153",0,0,1,1,"dummy"
"33154",0,0,1,1,"dummy"
"33155",0,0,1,1,"dummy"
"33156",0,0,1,1,"dummy"
"33157",0,0,1,1,"dummy"
"33158",0,0,1,1,"dummy"
"33159",0,0,1,1,"dummy"
"33160",0,0,1,1,"dummy"
"33161",0,0,1,1,"dummy"
"33162",0,0,1,1,"dummy"
"33163",0,0,1,1,"dummy"
"33164",0,0,1,1,"dummy"
"33165",0,0,1,1,"dummy"
"33166",0,0,1,1,"dummy"
"33167",0,0,1,1,"dummy"
"33168",0,0,1,1,"dummy"
"33169",0,0,1,1,"dummy"
"33170",0,0,1,1,"dummy"
"33171",0,0,1,1,"dummy"
"33172",0,0,1,1,"dummy"
"33173",0,0,1,1,"dummy"
"33174",0,0,1,1,"dummy"
"33175",0,0,1,1,"dummy"
"33176",0,0,1,1,"dummy"
"33177",0,0,1,1,"dummy"
"33178",0,0,1,1,"dummy"
"33179",0,0,1,1,"dummy"
"33180",0,0,1,1,"dummy"
"33183",0,1,1,2,"dummy"
"33184",0,2,0,2,"dummy"
"33185",9,8,2,19,"dummy"
"33186",0,1,0,1,"dummy"
"33187",0,0,1,1,"dummy"
"33191",0,3,0,3,"dummy"
"33192",3,1,0,4,"dummy"
"33195",0,3,1,4,"dummy"
"33196",3,1,1,5,"dummy"
"33197",5,5,0,10,"dummy"
"33198",2,2,1,5,"dummy"
"33199",2,3,2,7,"dummy"
"33200",2,2,1,5,"dummy"
"33204",0,1,2,3,"dummy"
"33205",5,7,1,13,"dummy"
"33206",1,1,0,2,"dummy"
"33210",0,1,0,1,"dummy"
"33213",0,0,2,2,"dummy"
"33214",0,0,2,2,"dummy"
"33215",3,9,0,12,"dummy"
"33218",0,0,1,1,"dummy"
"33219",0,2,0,2,"dummy"
"33220",0,1,0,1,"dummy"
"33221",5,8,5,18,"dummy"
"33224",1,0,1,2,"dummy"
"33225",0,2,0,2,"dummy"
"33227",0,2,0,2,"dummy"
"33228",0,1,0,1,"dummy"
"33229",2,3,5,10,"dummy"
"33230",1,2,0,3,"dummy"
"33231",1,1,0,2,"dummy"
"33232",0,0,1,1,"dummy"
"33234",3,0,3,6,"dummy"
"33235",0,4,3,7,"dummy"
"33236",0,1,0,1,"dummy"
"33238",0,0,1,1,"dummy"
"33239",5,2,1,8,"dummy"
"33240",2,4,1,7,"dummy"
"33241",1,0,0,1,"dummy"
"33242",5,19,1,25,"dummy"
"33243",0,0,4,4,"dummy"
"33244",0,0,2,2,"dummy"
"33245",0,0,0,0,"dummy"
"33246",0,0,0,0,"dummy"
"33247",0,0,0,0,"dummy"
"33249",0,0,0,0,"dummy"
"33250",0,0,1,1,"dummy"
"33251",4,8,0,12,"dummy"
"33252",1,1,0,2,"dummy"
"33253",8,3,0,11,"dummy"
"33254",0,0,1,1,"dummy"
"33255",0,1,0,1,"dummy"
"33256",0,2,0,2,"dummy"
"33257",0,0,0,0,"dummy"
"33258",0,0,0,0,"dummy"
"33259",4,0,0,4,"dummy"
"33260",0,0,0,0,"dummy"
"33261",0,0,0,0,"dummy"
"33262",0,0,2,2,"dummy"
"33263",0,0,0,0,"dummy"
"33265",2,2,2,6,"dummy"
"33267",9,2,3,14,"dummy"
"33268",0,0,0,0,"dummy"
"33269",0,4,0,4,"dummy"
"33273",0,3,0,3,"dummy"
"33275",0,2,0,2,"dummy"
"33284",11,1,3,15,"dummy"
"33286",0,3,0,3,"dummy"
"33288",1,2,0,3,"dummy"
"33289",0,2,0,2,"dummy"
"33290",2,2,0,4,"dummy"
"33293",2,1,0,3,"dummy"
"33294",1,0,0,1,"dummy"
"33305",0,1,0,1,"dummy"
"33306",0,2,0,2,"dummy"
"33307",1,0,0,1,"dummy"
"33308",0,0,0,0,"dummy"
"33309",6,0,0,6,"dummy"
"33310",5,1,0,6,"dummy"
"33311",0,1,0,1,"dummy"
"33312",1,0,0,1,"dummy"
"33314",1,0,1,2,"dummy"
"33315",0,0,2,2,"dummy"
"33316",1,0,0,1,"dummy"
"33317",0,3,4,7,"dummy"
"33318",0,2,0,2,"dummy"
"33325",0,6,0,6,"dummy"
"33326",0,2,0,2,"dummy"
"33349",0,14,0,14,"dummy"
"33350",3,1,2,6,"dummy"
"33351",0,0,1,1,"dummy"
"33352",0,2,3,5,"dummy"
"33354",0,1,0,1,"dummy"
"33355",1,0,0,1,"dummy"
"33356",0,2,0,2,"dummy"
"33357",0,0,1,1,"dummy"
"33358",0,1,3,4,"dummy"
"33360",0,2,0,2,"dummy"
"33362",0,0,1,1,"dummy"
"33363",0,0,3,3,"dummy"
"33364",0,0,3,3,"dummy"
"33365",0,0,4,4,"dummy"
"33366",2,3,1,6,"dummy"
"33371",0,1,0,1,"dummy"
"33372",0,2,0,2,"dummy"
"33373",2,0,2,4,"dummy"
"33374",0,1,0,1,"dummy"
"33375",0,1,0,1,"dummy"
"33376",5,40,5,50,"dummy"
"33381",0,0,1,1,"dummy"
"33385",0,2,0,2,"dummy"
"33386",0,0,1,1,"dummy"
"33387",0,0,0,0,"dummy"
"33388",0,2,0,2,"dummy"
"33389",1,0,0,1,"dummy"
"33390",4,19,3,26,"dummy"
"33394",0,0,1,1,"dummy"
"33395",0,0,1,1,"dummy"
"33396",0,4,0,4,"dummy"
"33397",0,2,0,2,"dummy"
"33398",0,2,0,2,"dummy"
"33401",0,3,0,3,"dummy"
"33402",1,0,0,1,"dummy"
"33403",0,1,0,1,"dummy"
"33405",3,0,0,3,"dummy"
"33406",0,1,0,1,"dummy"
"33407",0,0,1,1,"dummy"
"33408",0,1,0,1,"dummy"
"33409",0,0,1,1,"dummy"
"33410",0,0,1,1,"dummy"
"33413",0,0,0,0,"dummy"
"33437",0,0,1,1,"dummy"
"33440",0,0,1,1,"dummy"
"33441",0,14,0,14,"dummy"
"33442",0,0,1,1,"dummy"
"33443",0,0,1,1,"dummy"
"33449",0,1,0,1,"dummy"
"33450",0,1,0,1,"dummy"
"33451",0,1,0,1,"dummy"
"33452",0,2,0,2,"dummy"
"33453",0,1,0,1,"dummy"
"33454",0,2,1,3,"dummy"
"33455",3,1,0,4,"dummy"
"33456",0,2,0,2,"dummy"
"33457",0,1,0,1,"dummy"
"33459",14,8,4,26,"dummy"
"33461",0,0,2,2,"dummy"
"33463",0,1,0,1,"dummy"
"33464",0,0,2,2,"dummy"
"33465",0,0,2,2,"dummy"
"33467",1,2,0,3,"dummy"
"33470",4,3,2,9,"dummy"
"33472",0,0,1,1,"dummy"
"33473",0,1,0,1,"dummy"
"33475",0,2,0,2,"dummy"
"33482",8,9,2,19,"dummy"
"33483",8,8,0,16,"dummy"
"33484",0,6,0,6,"dummy"
"33486",1,4,0,5,"dummy"
"33487",1,1,0,2,"dummy"
"33488",2,0,0,2,"dummy"
"33489",0,2,0,2,"dummy"
"33490",3,1,0,4,"dummy"
"33491",2,8,1,11,"dummy"
"33492",1,5,0,6,"dummy"
"33493",0,0,1,1,"dummy"
"33509",0,0,0,0,"dummy"
"33523",8,8,1,17,"dummy"
"33524",3,17,3,23,"dummy"
"33525",6,2,1,9,"dummy"
"33526",0,3,0,3,"dummy"
"33527",2,0,0,2,"dummy"
"33528",3,1,0,4,"dummy"
"33529",0,0,1,1,"dummy"
"33530",1,0,0,1,"dummy"
"33531",1,1,0,2,"dummy"
"33532",1,0,0,1,"dummy"
"33533",0,1,0,1,"dummy"
"33535",0,1,0,1,"dummy"
"33536",0,3,0,3,"dummy"
"33537",0,1,0,1,"dummy"
"33538",0,1,0,1,"dummy"
"33539",0,2,0,2,"dummy"
"33540",2,2,0,4,"dummy"
"33541",0,5,0,5,"dummy"
"33542",0,0,0,0,"dummy"
"33543",0,5,0,5,"dummy"
"33545",1,0,0,1,"dummy"
"33548",12,1,0,13,"dummy"
"33549",0,0,1,1,"dummy"
"33550",0,1,0,1,"dummy"
"33551",1,0,0,1,"dummy"
"33552",0,1,0,1,"dummy"
"33553",0,1,0,1,"dummy"
"33554",0,2,0,2,"dummy"
"33555",2,0,0,2,"dummy"
"33563",1,6,1,8,"dummy"
"33564",0,0,1,1,"dummy"
"33565",0,1,0,1,"dummy"
"33566",0,1,0,1,"dummy"
"33567",2,2,1,5,"dummy"
"33568",0,20,0,20,"dummy"
"33569",0,2,0,2,"dummy"
"33571",4,1,2,7,"dummy"
"33573",0,4,0,4,"dummy"
"33574",6,15,7,28,"dummy"
"33575",10,44,5,59,"dummy"
"33576",0,0,0,0,"dummy"
"33577",2,4,5,11,"dummy"
"33578",0,0,1,1,"dummy"
"33579",7,10,0,17,"dummy"
"33581",0,1,0,1,"dummy"
"33582",14,25,4,43,"dummy"
"33586",3,2,1,6,"dummy"
"33587",0,5,1,6,"dummy"
"33588",0,2,0,2,"dummy"
"33589",4,0,1,5,"dummy"
"33590",0,0,1,1,"dummy"
"33591",0,0,1,1,"dummy"
"33592",0,0,1,1,"dummy"
"33593",0,0,1,1,"dummy"
"33595",0,2,2,4,"dummy"
"33597",0,1,1,2,"dummy"
"33598",0,3,2,5,"dummy"
"33599",3,1,2,6,"dummy"
"33600",0,0,1,1,"dummy"
"33601",1,0,0,1,"dummy"
"33616",0,4,0,4,"dummy"
"33617",0,1,3,4,"dummy"
"33618",0,2,1,3,"dummy"
"33619",6,2,1,9,"dummy"
"33621",0,0,1,1,"dummy"
"33623",0,1,0,1,"dummy"
"33624",0,3,0,3,"dummy"
"33628",0,0,1,1,"dummy"
"33629",0,1,3,4,"dummy"
"33630",1,0,0,1,"dummy"
"33631",0,1,0,1,"dummy"
"33632",0,0,1,1,"dummy"
"33633",0,0,1,1,"dummy"
"33634",0,0,1,1,"dummy"
"33635",0,0,1,1,"dummy"
"33636",0,0,4,4,"dummy"
"33638",0,0,1,1,"dummy"
"33640",0,0,0,0,"dummy"
"33641",0,0,0,0,"dummy"
"33642",0,0,0,0,"dummy"
"33643",0,0,0,0,"dummy"
"33644",0,0,0,0,"dummy"
"33645",0,0,0,0,"dummy"
"33646",0,0,0,0,"dummy"
"33647",0,0,0,0,"dummy"
"33648",0,0,1,1,"dummy"
"33650",7,2,1,10,"dummy"
"33651",1,2,0,3,"dummy"
"33652",0,0,0,0,"dummy"
"33653",0,0,1,1,"dummy"
"33656",0,0,0,0,"dummy"
"33657",0,5,0,5,"dummy"
"33663",42,51,0,93,"dummy"
"33696",0,2,0,2,"dummy"
"33697",3,10,1,14,"dummy"
"33698",0,0,3,3,"dummy"
"33699",7,7,8,22,"dummy"
"33700",0,0,1,1,"dummy"
"33703",3,2,0,5,"dummy"
"33704",0,2,0,2,"dummy"
"33705",0,1,0,1,"dummy"
"33706",1,0,0,1,"dummy"
"33707",1,5,1,7,"dummy"
"33708",1,0,0,1,"dummy"
"33709",0,1,0,1,"dummy"
"33710",0,3,0,3,"dummy"
"33711",0,0,0,0,"dummy"
"33712",0,4,0,4,"dummy"
"33713",0,1,0,1,"dummy"
"33714",25,1,3,29,"dummy"
"33715",0,1,0,1,"dummy"
"33716",1,0,0,1,"dummy"
"33718",0,1,1,2,"dummy"
"33719",0,0,1,1,"dummy"
"33721",1,0,0,1,"dummy"
"33722",0,1,0,1,"dummy"
"33723",1,10,0,11,"dummy"
"33724",0,1,0,1,"dummy"
"33725",0,0,0,0,"dummy"
"33726",0,1,0,1,"dummy"
"33727",0,0,0,0,"dummy"
"33728",0,0,0,0,"dummy"
"33729",0,0,1,1,"dummy"
"33730",0,0,1,1,"dummy"
"33731",0,0,3,3,"dummy"
"33732",0,1,0,1,"dummy"
"33733",15,4,1,20,"dummy"
"33734",0,1,0,1,"dummy"
"33735",0,1,0,1,"dummy"
"33736",0,3,0,3,"dummy"
"33737",11,2,0,13,"dummy"
"33738",0,0,0,0,"dummy"
"33739",0,0,1,1,"dummy"
"33742",3,0,0,3,"dummy"
"33743",0,3,0,3,"dummy"
"33744",3,0,0,3,"dummy"
"33746",0,1,1,2,"dummy"
"33747",0,3,0,3,"dummy"
"33748",0,7,0,7,"dummy"
"33749",0,1,0,1,"dummy"
"33757",0,3,1,4,"dummy"
"33758",0,0,0,0,"dummy"
"33760",2,0,1,3,"dummy"
"33761",0,1,0,1,"dummy"
"33762",0,3,1,4,"dummy"
"33763",3,2,0,5,"dummy"
"33764",0,0,0,0,"dummy"
"33765",1,1,0,2,"dummy"
"33766",0,0,2,2,"dummy"
"33767",2,0,0,2,"dummy"
"33768",2,0,0,2,"dummy"
"33769",0,0,1,1,"dummy"
"33772",0,2,0,2,"dummy"
"33773",0,5,5,10,"dummy"
"33774",1,1,5,7,"dummy"
"33775",0,1,0,1,"dummy"
"33776",1,4,10,15,"dummy"
"33777",0,1,2,3,"dummy"
"33778",0,6,0,6,"dummy"
"33779",0,2,0,2,"dummy"
"33780",0,8,0,8,"dummy"
"33781",0,1,0,1,"dummy"
"33782",1,1,1,3,"dummy"
"33783",0,0,1,1,"dummy"
"33784",0,3,0,3,"dummy"
"33785",5,2,0,7,"dummy"
"33786",0,9,0,9,"dummy"
"33787",0,2,0,2,"dummy"
"33788",0,0,1,1,"dummy"
"33789",0,0,1,1,"dummy"
"33790",16,1,0,17,"dummy"
"33791",52,45,5,102,"dummy"
"33792",5,14,0,19,"dummy"
"33793",4,4,0,8,"dummy"
"33794",0,0,1,1,"dummy"
"33795",0,2,0,2,"dummy"
"33796",0,2,0,2,"dummy"
"33797",0,2,1,3,"dummy"
"33798",0,0,1,1,"dummy"
"33799",0,3,0,3,"dummy"
"33800",9,0,0,9,"dummy"
"33801",12,8,1,21,"dummy"
"33802",0,0,1,1,"dummy"
"33803",0,10,0,10,"dummy"
"33821",0,1,0,1,"dummy"
"33822",0,3,0,3,"dummy"
"33823",1,0,1,2,"dummy"
"33826",0,3,0,3,"dummy"
"33827",1,0,0,1,"dummy"
"33828",1,21,4,26,"dummy"
"33829",2,0,1,3,"dummy"
"33834",0,1,0,1,"dummy"
"33835",0,2,0,2,"dummy"
"33836",0,1,0,1,"dummy"
"33841",0,0,1,1,"dummy"
"33842",0,0,1,1,"dummy"
"33843",0,0,1,1,"dummy"
"33851",4,10,0,14,"dummy"
"33852",0,3,1,4,"dummy"
"33853",3,1,2,6,"dummy"
"33854",0,5,0,5,"dummy"
"33855",0,0,0,0,"dummy"
"33856",0,0,0,0,"dummy"
"33860",4,6,6,16,"dummy"
"33861",0,0,0,0,"dummy"
"33862",0,2,0,2,"dummy"
"33863",2,0,1,3,"dummy"
"33864",0,2,0,2,"dummy"
"33883",0,0,2,2,"dummy"
"33884",0,1,0,1,"dummy"
"33885",0,2,1,3,"dummy"
"33886",0,0,1,1,"dummy"
"33887",0,1,1,2,"dummy"
"33888",2,0,0,2,"dummy"
"33889",2,1,0,3,"dummy"
"33890",0,2,0,2,"dummy"
"33891",0,1,0,1,"dummy"
"33897",1,0,0,1,"dummy"
"33898",0,1,0,1,"dummy"
"33899",1,0,0,1,"dummy"
"33907",1,1,0,2,"dummy"
"33908",0,1,5,6,"dummy"
"33913",2,1,1,4,"dummy"
"33916",3,21,0,24,"dummy"
"33917",1,1,0,2,"dummy"
"33918",22,17,0,39,"dummy"
"33919",0,2,0,2,"dummy"
"33920",0,0,1,1,"dummy"
"33921",1,0,0,1,"dummy"
"33922",5,5,0,10,"dummy"
"33923",0,1,0,1,"dummy"
"33805",2,4,0,6,"dummy"
"33806",0,2,0,2,"dummy"
"33807",0,2,0,2,"dummy"
"33808",10,2,0,12,"dummy"
"33809",0,2,0,2,"dummy"
"33810",0,0,0,0,"dummy"
"33811",0,0,3,3,"dummy"
"33812",0,5,0,5,"dummy"
"33815",2,2,0,4,"dummy"
"33818",0,0,1,1,"dummy"
"33819",0,1,0,1,"dummy"
"33845",1,2,0,3,"dummy"
"33846",6,17,1,24,"dummy"
"33847",7,2,0,9,"dummy"
"33848",2,0,0,2,"dummy"
"33849",10,8,2,20,"dummy"
"33893",0,3,0,3,"dummy"
"33894",0,0,1,1,"dummy"
"33895",0,0,0,0,"dummy"
"33910",0,0,1,1,"dummy"
"33911",0,0,1,1,"dummy"
"33927",0,0,1,1,"dummy"
"33928",0,0,1,1,"dummy"
"33929",0,0,1,1,"dummy"
"33930",1,1,0,2,"dummy"
"33931",0,4,1,5,"dummy"
"33932",4,9,2,15,"dummy"
"33933",1,0,0,1,"dummy"
"33934",1,2,3,6,"dummy"
"33935",0,0,3,3,"dummy"
"33936",0,0,1,1,"dummy"
"33937",0,0,1,1,"dummy"
"33938",0,0,1,1,"dummy"
"33939",0,2,0,2,"dummy"
"33940",0,0,0,0,"dummy"
"33941",0,2,0,2,"dummy"
"33942",4,4,2,10,"dummy"
"33943",12,8,1,21,"dummy"
"33944",1,1,0,2,"dummy"
"33945",0,7,4,11,"dummy"
"33946",0,0,1,1,"dummy"
"33947",2,4,1,7,"dummy"
"33948",14,21,1,36,"dummy"
"33949",0,0,1,1,"dummy"
"33950",0,0,1,1,"dummy"
"33951",0,9,0,9,"dummy"
"33952",8,8,1,17,"dummy"
"33953",0,0,1,1,"dummy"
"33954",0,3,0,3,"dummy"
"33955",0,1,0,1,"dummy"
"33958",0,2,0,2,"dummy"
"33959",14,0,2,16,"dummy"
"33960",0,0,1,1,"dummy"
"33961",0,1,1,2,"dummy"
"33962",0,3,0,3,"dummy"
"34016",0,2,0,2,"dummy"
"34017",0,0,1,1,"dummy"
"34018",0,0,2,2,"dummy"
"34024",0,0,0,0,"dummy"
"34043",0,0,1,1,"dummy"
"34044",0,1,0,1,"dummy"
"34088",0,0,1,1,"dummy"
"34089",0,2,0,2,"dummy"
"33966",0,0,0,0,"dummy"
"33967",0,0,0,0,"dummy"
"33968",0,1,0,1,"dummy"
"33969",0,0,1,1,"dummy"
"33970",0,16,1,17,"dummy"
"33971",0,0,1,1,"dummy"
"33972",0,0,0,0,"dummy"
"33973",1,3,0,4,"dummy"
"33974",0,0,1,1,"dummy"
"33975",0,2,0,2,"dummy"
"33976",0,1,0,1,"dummy"
"33977",1,1,0,2,"dummy"
"33978",1,0,0,1,"dummy"
"33979",1,3,0,4,"dummy"
"33980",0,0,1,1,"dummy"
"33981",0,0,1,1,"dummy"
"33982",0,0,1,1,"dummy"
"33983",0,0,1,1,"dummy"
"33984",1,0,0,1,"dummy"
"33985",1,1,0,2,"dummy"
"33986",1,3,0,4,"dummy"
"33987",0,1,0,1,"dummy"
"33988",8,5,0,13,"dummy"
"33989",6,11,0,17,"dummy"
"33990",0,0,0,0,"dummy"
"33991",0,0,0,0,"dummy"
"33992",1,1,0,2,"dummy"
"33993",0,0,1,1,"dummy"
"33994",0,1,0,1,"dummy"
"33995",1,1,0,2,"dummy"
"33996",0,1,0,1,"dummy"
"33997",0,0,1,1,"dummy"
"33998",4,5,0,9,"dummy"
"33999",0,1,0,1,"dummy"
"34000",1,2,0,3,"dummy"
"34001",2,1,0,3,"dummy"
"34002",0,0,0,0,"dummy"
"34003",0,1,0,1,"dummy"
"34004",3,1,0,4,"dummy"
"34005",0,1,0,1,"dummy"
"34006",1,2,0,3,"dummy"
"34007",2,1,0,3,"dummy"
"34011",3,0,0,3,"dummy"
"34014",2,0,2,4,"dummy"
"34020",0,0,3,3,"dummy"
"34041",0,0,0,0,"dummy"
"34046",0,0,1,1,"dummy"
"34047",0,1,0,1,"dummy"
"34048",6,3,1,10,"dummy"
"34055",0,0,2,2,"dummy"
"34091",0,0,1,1,"dummy"
"34092",0,0,0,0,"dummy"
"34093",0,1,0,1,"dummy"
"34094",1,2,0,3,"dummy"
"34095",0,1,0,1,"dummy"
"34096",1,10,1,12,"dummy"
"34097",1,1,0,2,"dummy"
"34098",0,1,0,1,"dummy"
"34099",7,2,0,9,"dummy"
"34100",0,1,0,1,"dummy"
"34101",0,0,1,1,"dummy"
"34102",0,0,2,2,"dummy"
"34123",0,0,1,1,"dummy"
"34126",3,2,4,9,"dummy"
"34127",0,0,0,0,"dummy"
"34128",3,0,1,4,"dummy"
"34131",2,0,1,3,"dummy"
"34132",0,3,0,3,"dummy"
"34133",46,8,2,56,"dummy"
"34134",0,5,0,5,"dummy"
"34139",0,2,0,2,"dummy"
"34140",2,0,1,3,"dummy"
"34141",0,2,0,2,"dummy"
"34164",0,2,0,2,"dummy"
"34165",3,1,1,5,"dummy"
"34166",0,1,0,1,"dummy"
"34167",0,0,2,2,"dummy"
"34168",2,0,2,4,"dummy"
"34169",0,2,0,2,"dummy"
"34170",2,0,0,2,"dummy"
"34171",0,1,0,1,"dummy"
"34172",0,2,0,2,"dummy"
"34173",0,1,0,1,"dummy"
"34174",0,2,0,2,"dummy"
"34175",3,0,0,3,"dummy"
"34176",0,0,1,1,"dummy"
"34177",3,0,0,3,"dummy"
"34178",0,5,0,5,"dummy"
"34104",0,0,1,1,"dummy"
"34105",2,0,4,6,"dummy"
"34106",0,2,0,2,"dummy"
"34107",0,1,1,2,"dummy"
"34108",1,0,1,2,"dummy"
"34109",0,0,4,4,"dummy"
"34110",0,0,1,1,"dummy"
"34111",0,0,1,1,"dummy"
"34112",0,0,1,1,"dummy"
"34113",1,5,0,6,"dummy"
"34114",0,0,1,1,"dummy"
"34115",0,0,1,1,"dummy"
"34116",0,0,1,1,"dummy"
"34117",3,4,1,8,"dummy"
"34118",0,0,1,1,"dummy"
"34119",0,0,1,1,"dummy"
"34120",0,1,0,1,"dummy"
"34121",0,0,1,1,"dummy"
"34136",4,0,3,7,"dummy"
"34137",0,0,1,1,"dummy"
"34147",1,3,1,5,"dummy"
"34148",0,3,0,3,"dummy"
"34149",1,0,0,1,"dummy"
"34150",1,9,0,10,"dummy"
"34151",3,4,0,7,"dummy"
"34152",0,0,1,1,"dummy"
"34153",4,4,1,9,"dummy"
"34154",0,1,0,1,"dummy"
"34155",0,0,1,1,"dummy"
"34156",0,0,1,1,"dummy"
"34157",2,0,2,4,"dummy"
"34158",0,0,1,1,"dummy"
"34159",0,0,1,1,"dummy"
"34160",1,0,0,1,"dummy"
"34161",0,4,0,4,"dummy"
"34162",0,1,0,1,"dummy"
"34201",0,0,1,1,"dummy"
"34202",0,2,0,2,"dummy"
"34203",0,2,0,2,"dummy"
"34218",3,3,1,7,"dummy"
"34219",1,0,0,1,"dummy"
"34232",1,1,1,3,"dummy"
"34238",8,5,3,16,"dummy"
"34241",14,12,1,27,"dummy"
"34242",0,0,1,1,"dummy"
"34243",0,0,2,2,"dummy"
"34244",6,7,0,13,"dummy"
"34245",4,0,1,5,"dummy"
"34246",0,0,0,0,"dummy"
"34247",0,2,0,2,"dummy"
"34257",0,2,0,2,"dummy"
"34258",0,0,1,1,"dummy"
"34268",0,1,0,1,"dummy"
"34269",4,0,0,4,"dummy"
"34284",0,0,2,2,"dummy"
"34285",0,0,0,0,"dummy"
"34286",0,0,0,0,"dummy"
"34287",17,1,1,19,"dummy"
"34288",11,14,1,26,"dummy"
"34289",11,10,0,21,"dummy"
"34290",3,0,1,4,"dummy"
"34291",0,9,1,10,"dummy"
"34292",0,0,1,1,"dummy"
"34293",1,0,0,1,"dummy"
"34294",1,1,3,5,"dummy"
"34295",0,1,0,1,"dummy"
"34296",0,0,0,0,"dummy"
"34297",0,1,1,2,"dummy"
"34298",12,19,4,35,"dummy"
"34303",1,1,0,2,"dummy"
"34309",0,3,0,3,"dummy"
"34310",6,2,0,8,"dummy"
"34311",1,1,0,2,"dummy"
"34334",0,1,0,1,"dummy"
"34382",0,0,0,0,"dummy"
"34383",2,10,2,14,"dummy"
"34384",0,1,0,1,"dummy"
"34385",0,2,0,2,"dummy"
"34179",0,0,0,0,"dummy"
"34180",0,1,0,1,"dummy"
"34181",1,0,0,1,"dummy"
"34182",1,4,0,5,"dummy"
"34183",5,1,0,6,"dummy"
"34184",0,0,1,1,"dummy"
"34185",0,1,0,1,"dummy"
"34186",0,4,0,4,"dummy"
"34187",0,0,1,1,"dummy"
"34188",2,0,0,2,"dummy"
"34189",8,2,0,10,"dummy"
"34190",0,2,0,2,"dummy"
"34191",2,0,2,4,"dummy"
"34192",2,2,0,4,"dummy"
"34193",0,1,0,1,"dummy"
"34194",0,1,0,1,"dummy"
"34195",0,1,0,1,"dummy"
"34196",0,1,0,1,"dummy"
"34197",0,1,0,1,"dummy"
"34221",0,0,1,1,"dummy"
"34222",1,0,0,1,"dummy"
"34223",1,0,0,1,"dummy"
"34224",0,1,0,1,"dummy"
"34225",4,0,0,4,"dummy"
"34228",3,3,2,8,"dummy"
"34229",3,1,0,4,"dummy"
"34230",0,2,3,5,"dummy"
"34236",0,0,1,1,"dummy"
"34249",0,5,0,5,"dummy"
"34250",0,12,1,13,"dummy"
"34251",1,0,0,1,"dummy"
"34254",0,3,0,3,"dummy"
"34255",1,4,1,6,"dummy"
"34260",1,10,2,13,"dummy"
"34261",0,0,2,2,"dummy"
"34262",0,3,1,4,"dummy"
"34263",0,0,0,0,"dummy"
"34264",6,3,0,9,"dummy"
"34265",0,1,1,2,"dummy"
"34266",0,0,1,1,"dummy"
"34279",5,5,3,13,"dummy"
"34282",0,2,0,2,"dummy"
"34305",2,2,0,4,"dummy"
"34306",3,1,0,4,"dummy"
"34307",0,1,0,1,"dummy"
"34332",0,0,1,1,"dummy"
"34340",0,2,0,2,"dummy"
"34341",2,1,0,3,"dummy"
"34342",0,1,2,3,"dummy"
"34343",2,9,0,11,"dummy"
"34344",5,0,1,6,"dummy"
"34345",0,3,0,3,"dummy"
"34346",0,0,0,0,"dummy"
"34347",0,0,0,0,"dummy"
"34348",0,0,0,0,"dummy"
"34349",4,3,0,7,"dummy"
"34352",0,2,0,2,"dummy"
"34353",0,0,0,0,"dummy"
"34354",1,12,0,13,"dummy"
"34355",0,0,1,1,"dummy"
"34356",7,1,0,8,"dummy"
"34387",0,0,0,0,"dummy"
"34388",0,1,0,1,"dummy"
"34389",0,0,1,1,"dummy"
"34390",0,0,1,1,"dummy"
"34391",0,0,1,1,"dummy"
"34392",0,0,1,1,"dummy"
"34393",0,0,0,0,"dummy"
"34394",0,0,1,1,"dummy"
"34395",0,0,1,1,"dummy"
"34396",0,0,0,0,"dummy"
"34397",0,0,0,0,"dummy"
"34398",0,0,0,0,"dummy"
"34399",0,0,0,0,"dummy"
"34400",0,0,0,0,"dummy"
"34401",0,0,0,0,"dummy"
"34402",0,0,0,0,"dummy"
"34403",0,0,0,0,"dummy"
"34404",0,0,0,0,"dummy"
"34405",0,0,0,0,"dummy"
"34406",0,0,0,0,"dummy"
"34407",0,0,0,0,"dummy"
"34408",0,0,0,0,"dummy"
"34409",0,0,0,0,"dummy"
"34410",0,0,0,0,"dummy"
"34411",0,4,0,4,"dummy"
"34412",6,5,1,12,"dummy"
"34413",2,2,1,5,"dummy"
"34414",0,0,0,0,"dummy"
"34415",0,2,0,2,"dummy"
"34416",0,0,0,0,"dummy"
"34421",0,5,0,5,"dummy"
"34422",4,1,0,5,"dummy"
"34423",0,0,1,1,"dummy"
"34424",0,0,4,4,"dummy"
"34425",0,0,4,4,"dummy"
"34426",7,20,2,29,"dummy"
"34427",0,0,1,1,"dummy"
"34436",0,5,0,5,"dummy"
"34437",0,21,1,22,"dummy"
"34438",0,1,0,1,"dummy"
"34443",7,8,14,29,"dummy"
"34458",5,1,0,6,"dummy"
"34459",0,6,0,6,"dummy"
"34460",0,3,1,4,"dummy"
"34461",3,6,0,9,"dummy"
"34462",0,1,0,1,"dummy"
"34463",2,2,1,5,"dummy"
"34464",0,7,1,8,"dummy"
"34465",0,0,1,1,"dummy"
"34466",5,9,2,16,"dummy"
"34467",0,0,0,0,"dummy"
"34468",0,0,1,1,"dummy"
"34469",2,3,3,8,"dummy"
"34470",0,1,6,7,"dummy"
"34471",0,3,2,5,"dummy"
"34472",0,0,4,4,"dummy"
"34473",0,0,2,2,"dummy"
"34474",0,0,2,2,"dummy"
"34475",0,0,1,1,"dummy"
"34476",0,0,2,2,"dummy"
"34481",0,2,0,2,"dummy"
"34482",0,1,0,1,"dummy"
"34483",0,1,0,1,"dummy"
"34418",0,1,0,1,"dummy"
"34419",0,1,0,1,"dummy"
"34429",0,0,1,1,"dummy"
"34430",1,1,0,2,"dummy"
"34431",8,5,0,13,"dummy"
"34432",0,2,0,2,"dummy"
"34433",13,16,1,30,"dummy"
"34434",0,3,0,3,"dummy"
"34478",0,1,0,1,"dummy"
"34479",0,2,0,2,"dummy"
"34485",0,4,1,5,"dummy"
"34486",1,0,0,1,"dummy"
"34487",0,1,1,2,"dummy"
"34488",0,0,1,1,"dummy"
"34489",0,0,1,1,"dummy"
"34490",0,0,1,1,"dummy"
"34493",0,1,0,1,"dummy"
"34494",0,1,0,1,"dummy"
"34495",0,1,0,1,"dummy"
"34498",1,0,0,1,"dummy"
"34499",0,1,0,1,"dummy"
"34514",0,3,0,3,"dummy"
"34515",0,0,1,1,"dummy"
"34516",5,0,2,7,"dummy"
"34519",0,0,0,0,"dummy"
"34524",0,0,1,1,"dummy"
"34525",0,1,0,1,"dummy"
"34526",0,2,0,2,"dummy"
"34528",0,0,1,1,"dummy"
"34529",0,0,1,1,"dummy"
"34530",0,0,2,2,"dummy"
"34531",26,3,7,36,"dummy"
"34538",4,1,2,7,"dummy"
"34539",6,8,0,14,"dummy"
"34540",0,0,1,1,"dummy"
"34541",0,0,2,2,"dummy"
"34544",1,0,0,1,"dummy"
"34546",0,0,0,0,"dummy"
"34547",0,0,0,0,"dummy"
"34548",0,1,0,1,"dummy"
"34549",0,0,0,0,"dummy"
"34550",0,0,0,0,"dummy"
"34551",1,0,0,1,"dummy"
"34552",1,3,1,5,"dummy"
"34554",0,2,0,2,"dummy"
"34556",0,0,1,1,"dummy"
"34557",0,0,1,1,"dummy"
"34558",0,0,1,1,"dummy"
"34559",0,0,1,1,"dummy"
"34560",0,0,1,1,"dummy"
"34561",0,0,1,1,"dummy"
"34562",0,0,1,1,"dummy"
"34563",0,0,1,1,"dummy"
"34564",0,0,1,1,"dummy"
"34565",0,0,1,1,"dummy"
"34566",0,0,1,1,"dummy"
"34567",0,0,1,1,"dummy"
"34568",0,0,1,1,"dummy"
"34569",0,0,1,1,"dummy"
"34570",0,0,1,1,"dummy"
"34571",0,0,1,1,"dummy"
"34572",0,0,1,1,"dummy"
"34573",0,0,1,1,"dummy"
"34574",0,0,1,1,"dummy"
"34578",25,16,3,44,"dummy"
"34579",6,12,0,18,"dummy"
"34580",0,1,0,1,"dummy"
"34581",0,3,1,4,"dummy"
"34582",12,8,1,21,"dummy"
"34583",0,2,0,2,"dummy"
"34584",1,2,0,3,"dummy"
"34585",0,1,0,1,"dummy"
"34586",1,4,1,6,"dummy"
"34587",0,2,0,2,"dummy"
"34588",0,6,6,12,"dummy"
"34589",0,0,1,1,"dummy"
"34590",4,5,1,10,"dummy"
"34591",3,1,3,7,"dummy"
"34592",0,0,4,4,"dummy"
"34596",2,5,0,7,"dummy"
"34597",0,3,0,3,"dummy"
"34598",0,2,0,2,"dummy"
"34599",6,10,0,16,"dummy"
"34600",0,4,0,4,"dummy"
"34601",2,0,0,2,"dummy"
"34602",0,2,0,2,"dummy"
"34603",0,0,1,1,"dummy"
"34604",3,4,1,8,"dummy"
"34605",0,0,1,1,"dummy"
"34606",2,14,0,16,"dummy"
"34607",0,4,0,4,"dummy"
"34608",0,1,1,2,"dummy"
"34611",1,1,2,4,"dummy"
"34612",0,0,0,0,"dummy"
"34613",2,1,0,3,"dummy"
"34614",0,0,4,4,"dummy"
"34615",5,1,0,6,"dummy"
"34617",1,7,1,9,"dummy"
"34618",0,0,3,3,"dummy"
"34619",1,2,0,3,"dummy"
"34625",0,31,0,31,"dummy"
"34626",31,0,0,31,"dummy"
"34627",0,31,0,31,"dummy"
"34628",0,0,0,0,"dummy"
"34630",0,0,1,1,"dummy"
"34632",0,1,0,1,"dummy"
"34633",4,0,0,4,"dummy"
"34635",2,0,0,2,"dummy"
"34636",0,1,4,5,"dummy"
"34638",0,2,1,3,"dummy"
"34639",1,0,0,1,"dummy"
"34640",0,1,0,1,"dummy"
"34641",0,1,0,1,"dummy"
"34642",0,1,0,1,"dummy"
"34643",0,0,2,2,"dummy"
"34644",0,0,1,1,"dummy"
"34645",0,0,0,0,"dummy"
"34646",0,0,0,0,"dummy"
"34647",0,1,0,1,"dummy"
"34648",0,0,0,0,"dummy"
"34649",1,0,1,2,"dummy"
"34650",1,0,3,4,"dummy"
"34651",0,0,1,1,"dummy"
"34652",1,4,1,6,"dummy"
"34653",1,0,0,1,"dummy"
"34654",1,0,0,1,"dummy"
"34655",0,1,0,1,"dummy"
"34663",0,0,2,2,"dummy"
"34664",5,4,0,9,"dummy"
"34665",0,1,0,1,"dummy"
"34670",0,0,5,5,"dummy"
"34671",0,0,0,0,"dummy"
"34672",0,1,0,1,"dummy"
"34673",0,1,0,1,"dummy"
"34674",0,0,0,0,"dummy"
"34677",8,9,2,19,"dummy"
"34678",0,1,0,1,"dummy"
"34679",0,1,0,1,"dummy"
"34682",0,1,0,1,"dummy"
"34683",1,0,0,1,"dummy"
"34684",0,0,2,2,"dummy"
"34686",2,0,3,5,"dummy"
"34687",1,0,0,1,"dummy"
"34688",0,1,0,1,"dummy"
"34689",0,1,1,2,"dummy"
"34695",1,0,0,1,"dummy"
"34696",1,0,0,1,"dummy"
"34697",1,1,0,2,"dummy"
"34698",0,1,0,1,"dummy"
"34699",0,0,1,1,"dummy"
"34700",0,1,0,1,"dummy"
"34703",50,8,1,59,"dummy"
"34704",1,0,3,4,"dummy"
"34705",0,1,3,4,"dummy"
"34724",8,17,2,27,"dummy"
"34725",12,29,2,43,"dummy"
"34726",29,41,12,82,"dummy"
"34727",0,1,0,1,"dummy"
"34728",7,20,0,27,"dummy"
"34729",1,5,1,7,"dummy"
"34730",2,2,0,4,"dummy"
"34731",0,13,0,13,"dummy"
"34732",0,2,0,2,"dummy"
"34733",6,46,13,65,"dummy"
"34734",0,1,0,1,"dummy"
"34735",7,8,5,20,"dummy"
"34736",0,1,0,1,"dummy"
"34737",0,3,0,3,"dummy"
"34738",0,0,0,0,"dummy"
"34739",0,2,0,2,"dummy"
"34740",1,0,0,1,"dummy"
"34741",0,1,0,1,"dummy"
"34742",26,5,0,31,"dummy"
"34744",0,0,2,2,"dummy"
"34762",0,2,0,2,"dummy"
"34763",1,0,0,1,"dummy"
"34765",0,0,2,2,"dummy"
"34766",0,0,1,1,"dummy"
"34767",0,3,1,4,"dummy"
"34768",0,1,1,2,"dummy"
"34769",0,0,1,1,"dummy"
"34770",1,0,0,1,"dummy"
"34773",0,3,0,3,"dummy"
"34774",0,1,1,2,"dummy"
"34775",3,0,0,3,"dummy"
"34776",0,3,0,3,"dummy"
"34779",0,2,0,2,"dummy"
"34780",0,0,2,2,"dummy"
"34782",5,0,4,9,"dummy"
"34791",0,0,3,3,"dummy"
"34795",0,1,0,1,"dummy"
"34799",0,1,0,1,"dummy"
"34800",0,5,2,7,"dummy"
"34801",2,5,0,7,"dummy"
"34803",0,1,0,1,"dummy"
"34805",8,16,0,24,"dummy"
"34812",3,2,1,6,"dummy"
"34813",2,1,0,3,"dummy"
"34814",0,1,0,1,"dummy"
"34815",4,4,2,10,"dummy"
"34816",1,0,0,1,"dummy"
"34817",0,1,0,1,"dummy"
"34818",2,2,1,5,"dummy"
"34819",0,0,1,1,"dummy"
"34820",0,1,0,1,"dummy"
"34821",0,0,0,0,"dummy"
"34822",1,0,1,2,"dummy"
"34823",5,6,4,15,"dummy"
"34824",0,0,0,0,"dummy"
"34825",0,0,1,1,"dummy"
"34826",6,6,4,16,"dummy"
"34828",6,1,1,8,"dummy"
"34829",0,0,0,0,"dummy"
"34831",0,0,1,1,"dummy"
"34832",0,0,0,0,"dummy"
"34834",0,1,0,1,"dummy"
"34835",3,14,2,19,"dummy"
"34837",0,2,0,2,"dummy"
"34838",0,0,0,0,"dummy"
"34839",4,1,0,5,"dummy"
"34841",0,0,3,3,"dummy"
"34842",0,5,0,5,"dummy"
"34843",3,3,0,6,"dummy"
"34844",3,4,0,7,"dummy"
"34845",0,0,1,1,"dummy"
"34849",2,0,0,2,"dummy"
"34869",1,1,1,3,"dummy"
"34871",1,5,1,7,"dummy"
"34873",0,1,0,1,"dummy"
"34874",14,0,0,14,"dummy"
"34877",2,0,3,5,"dummy"
"34878",1,0,0,1,"dummy"
"34879",0,1,0,1,"dummy"
"34880",0,1,1,2,"dummy"
"34882",0,0,1,1,"dummy"
"34883",0,1,0,1,"dummy"
"34884",2,0,2,4,"dummy"
"34885",0,1,0,1,"dummy"
"34915",8,4,4,16,"dummy"
"34916",0,4,0,4,"dummy"
"34923",0,0,0,0,"dummy"
"34924",0,0,0,0,"dummy"
"34930",0,0,1,1,"dummy"
"34931",1,1,3,5,"dummy"
"34932",1,1,0,2,"dummy"
"34933",0,0,1,1,"dummy"
"34934",0,0,1,1,"dummy"
"34935",0,0,1,1,"dummy"
"34936",0,0,3,3,"dummy"
"34938",2,0,0,2,"dummy"
"34939",0,1,0,1,"dummy"
"34940",0,0,0,0,"dummy"
"34941",0,0,1,1,"dummy"
"34947",0,1,0,1,"dummy"
"34948",4,0,1,5,"dummy"
"34949",0,0,1,1,"dummy"
"34950",0,1,0,1,"dummy"
"34951",2,0,1,3,"dummy"
"34952",0,0,1,1,"dummy"
"34954",0,1,0,1,"dummy"
"34955",0,1,0,1,"dummy"
"34956",0,0,2,2,"dummy"
"34957",2,1,1,4,"dummy"
"34958",0,0,4,4,"dummy"
"34959",0,0,1,1,"dummy"
"34960",0,1,0,1,"dummy"
"34961",0,0,0,0,"dummy"
"34963",0,5,1,6,"dummy"
"34964",4,3,0,7,"dummy"
"34985",0,1,0,1,"dummy"
"34986",0,1,0,1,"dummy"
"34995",0,0,0,0,"dummy"
"34996",2,0,0,2,"dummy"
"34997",0,1,0,1,"dummy"
"34998",0,3,0,3,"dummy"
"34999",0,0,0,0,"dummy"
"35000",2,2,0,4,"dummy"
"35002",0,0,1,1,"dummy"
"35003",0,0,0,0,"dummy"
"35006",0,1,0,1,"dummy"
"35008",6,6,1,13,"dummy"
"35009",0,0,0,0,"dummy"
"35010",1,0,0,1,"dummy"
"35014",0,0,1,1,"dummy"
"35016",0,5,0,5,"dummy"
"35017",4,1,0,5,"dummy"
"35018",0,1,0,1,"dummy"
"35020",0,1,0,1,"dummy"
"35021",0,0,1,1,"dummy"
"35022",0,0,1,1,"dummy"
"35026",0,1,0,1,"dummy"
"35028",0,1,0,1,"dummy"
"35029",1,0,0,1,"dummy"
"35030",1,0,1,2,"dummy"
"35031",0,0,0,0,"dummy"
"35032",0,0,3,3,"dummy"
"35033",0,0,3,3,"dummy"
"35034",0,0,2,2,"dummy"
"35037",0,0,1,1,"dummy"
"35038",0,2,0,2,"dummy"
"35039",4,14,2,20,"dummy"
"35040",0,0,1,1,"dummy"
"35041",0,0,2,2,"dummy"
"35042",0,0,2,2,"dummy"
"35043",0,0,0,0,"dummy"
"35044",0,0,0,0,"dummy"
"35045",0,0,0,0,"dummy"
"35047",7,3,2,12,"dummy"
"35048",1,0,0,1,"dummy"
"35055",0,0,1,1,"dummy"
"35057",0,0,1,1,"dummy"
"35058",8,0,2,10,"dummy"
"35059",0,0,1,1,"dummy"
"35060",0,0,1,1,"dummy"
"35062",0,1,0,1,"dummy"
"35063",0,0,1,1,"dummy"
"35064",0,0,1,1,"dummy"
"35065",5,1,0,6,"dummy"
"35066",0,0,1,1,"dummy"
"35067",0,0,1,1,"dummy"
"35068",0,0,1,1,"dummy"
"35069",0,0,1,1,"dummy"
"35070",0,0,1,1,"dummy"
"35071",0,0,1,1,"dummy"
"35072",0,0,1,1,"dummy"
"35073",0,0,1,1,"dummy"
"35074",0,0,1,1,"dummy"
"35075",0,0,1,1,"dummy"
"35076",0,0,2,2,"dummy"
"35077",0,0,1,1,"dummy"
"35078",0,0,4,4,"dummy"
"35079",1,4,0,5,"dummy"
"35080",0,0,1,1,"dummy"
"35082",0,0,1,1,"dummy"
"35083",3,10,3,16,"dummy"
"35084",0,0,3,3,"dummy"
"35085",0,0,1,1,"dummy"
"35086",17,19,4,40,"dummy"
"35088",0,0,3,3,"dummy"
"35090",5,3,2,10,"dummy"
"35091",0,1,0,1,"dummy"
"35093",0,2,0,2,"dummy"
"35094",23,2,2,27,"dummy"
"35095",0,0,1,1,"dummy"
"35096",0,1,0,1,"dummy"
"35098",1,1,0,2,"dummy"
"35099",0,1,1,2,"dummy"
"35100",2,2,0,4,"dummy"
"35101",0,14,0,14,"dummy"
"35102",0,2,0,2,"dummy"
"35103",2,3,3,8,"dummy"
"35104",0,0,1,1,"dummy"
"35105",0,0,1,1,"dummy"
"35106",0,1,0,1,"dummy"
"35107",0,2,0,2,"dummy"
"35108",2,0,0,2,"dummy"
"35109",1,2,1,4,"dummy"
"35110",0,2,0,2,"dummy"
"35111",0,0,0,0,"dummy"
"35112",2,1,0,3,"dummy"
"35113",1,2,0,3,"dummy"
"35114",0,0,1,1,"dummy"
"35115",14,14,0,28,"dummy"
"35116",14,14,0,28,"dummy"
"35117",18,13,8,39,"dummy"
"35118",0,2,0,2,"dummy"
"35120",0,0,1,1,"dummy"
"35136",0,0,0,0,"dummy"
"35137",3,2,1,6,"dummy"
"35140",0,2,0,2,"dummy"
"35141",2,5,0,7,"dummy"
"35142",1,0,0,1,"dummy"
"35144",0,0,1,1,"dummy"
"35145",0,0,1,1,"dummy"
"35147",0,0,4,4,"dummy"
"35148",0,1,0,1,"dummy"
"35149",0,0,0,0,"dummy"
"35150",0,1,0,1,"dummy"
"35152",0,2,0,2,"dummy"
"35153",0,1,0,1,"dummy"
"35154",1,1,0,2,"dummy"
"35155",3,4,0,7,"dummy"
"35156",0,0,2,2,"dummy"
"35157",0,2,0,2,"dummy"
"35158",0,1,0,1,"dummy"
"35159",0,3,0,3,"dummy"
"35177",0,2,0,2,"dummy"
"35178",0,1,0,1,"dummy"
"35180",2,3,1,6,"dummy"
"35183",0,3,2,5,"dummy"
"35184",1,8,2,11,"dummy"
"35185",1,1,5,7,"dummy"
"35186",0,0,3,3,"dummy"
"35187",0,0,0,0,"dummy"
"35188",0,0,1,1,"dummy"
"35189",1,1,0,2,"dummy"
"35190",0,0,1,1,"dummy"
"35191",0,0,1,1,"dummy"
"35192",2,0,1,3,"dummy"
"35193",0,2,0,2,"dummy"
"35194",0,1,0,1,"dummy"
"35195",0,0,0,0,"dummy"
"35197",0,1,0,1,"dummy"
"35207",1,2,0,3,"dummy"
"35208",3,2,2,7,"dummy"
"35209",0,0,0,0,"dummy"
"35210",0,0,1,1,"dummy"
"35211",0,0,1,1,"dummy"
"35212",0,0,0,0,"dummy"
"35213",0,8,0,8,"dummy"
"35219",0,5,0,5,"dummy"
"35221",0,2,0,2,"dummy"
"35222",0,0,1,1,"dummy"
"35223",0,0,1,1,"dummy"
"35224",0,0,1,1,"dummy"
"35225",0,2,0,2,"dummy"
"35226",5,6,1,12,"dummy"
"35227",3,3,0,6,"dummy"
"35228",4,4,1,9,"dummy"
"35229",0,2,1,3,"dummy"
"35230",1,0,0,1,"dummy"
"35231",0,1,0,1,"dummy"
"35239",0,2,0,2,"dummy"
"35243",0,0,2,2,"dummy"
"35245",0,0,1,1,"dummy"
"35246",0,1,1,2,"dummy"
"35247",0,2,0,2,"dummy"
"35248",5,0,2,7,"dummy"
"35249",1,0,0,1,"dummy"
"35253",0,2,1,3,"dummy"
"35255",0,0,0,0,"dummy"
"35256",0,0,0,0,"dummy"
"35259",0,29,3,32,"dummy"
"35260",16,12,1,29,"dummy"
"35261",0,4,0,4,"dummy"
"35262",5,5,0,10,"dummy"
"35263",0,2,0,2,"dummy"
"35264",0,2,0,2,"dummy"
"35265",0,4,0,4,"dummy"
"35266",0,0,1,1,"dummy"
"35268",0,1,0,1,"dummy"
"35285",0,1,0,1,"dummy"
"35286",1,1,1,3,"dummy"
"35289",0,0,1,1,"dummy"
"35290",1,0,1,2,"dummy"
"35293",1,14,1,16,"dummy"
"35294",0,1,0,1,"dummy"
"35296",0,2,0,2,"dummy"
"35297",0,2,0,2,"dummy"
"35298",0,0,1,1,"dummy"
"35299",0,12,0,12,"dummy"
"35300",27,4,3,34,"dummy"
"35301",0,0,0,0,"dummy"
"35302",5,4,4,13,"dummy"
"35306",0,0,2,2,"dummy"
"35310",2,3,2,7,"dummy"
"35312",0,1,0,1,"dummy"
"35314",1,1,0,2,"dummy"
"35315",0,2,0,2,"dummy"
"35316",2,2,2,6,"dummy"
"35317",0,1,0,1,"dummy"
"35320",0,0,1,1,"dummy"
"35321",0,1,0,1,"dummy"
"35325",0,1,0,1,"dummy"
"35331",7,2,0,9,"dummy"
"35332",0,3,0,3,"dummy"
"35337",0,1,0,1,"dummy"
"35338",0,1,4,5,"dummy"
"35339",0,0,1,1,"dummy"
"35341",0,0,1,1,"dummy"
"35342",0,0,1,1,"dummy"
"35343",0,4,1,5,"dummy"
"35344",0,0,1,1,"dummy"
"35345",0,0,1,1,"dummy"
"35348",0,3,1,4,"dummy"
"35349",1,9,0,10,"dummy"
"35350",0,0,1,1,"dummy"
"35351",0,0,1,1,"dummy"
"35352",0,0,1,1,"dummy"
"35356",0,0,1,1,"dummy"
"35357",0,0,1,1,"dummy"
"35358",9,0,0,9,"dummy"
"35359",0,0,0,0,"dummy"
"35360",2,11,0,13,"dummy"
"35361",0,0,0,0,"dummy"
"35362",0,0,0,0,"dummy"
"35363",2,2,0,4,"dummy"
"35364",0,0,0,0,"dummy"
"35365",0,0,0,0,"dummy"
"35366",2,2,0,4,"dummy"
"35368",0,0,1,1,"dummy"
"35371",0,0,1,1,"dummy"
"35372",15,20,7,42,"dummy"
"35373",1,0,1,2,"dummy"
"35374",2,1,0,3,"dummy"
"35375",8,9,1,18,"dummy"
"35376",1,0,0,1,"dummy"
"35377",6,6,0,12,"dummy"
"35378",7,1,1,9,"dummy"
"35381",0,1,0,1,"dummy"
"35382",0,0,1,1,"dummy"
"35388",2,0,0,2,"dummy"
"35394",1,1,0,2,"dummy"
"35397",0,0,1,1,"dummy"
"35398",0,3,0,3,"dummy"
"35399",0,1,0,1,"dummy"
"35418",0,7,1,8,"dummy"
"35419",14,0,2,16,"dummy"
"35448",1,3,1,5,"dummy"
"35498",0,2,0,2,"dummy"
"35499",0,1,1,2,"dummy"
"35502",5,7,0,12,"dummy"
"35503",0,0,0,0,"dummy"
"35504",0,3,0,3,"dummy"
"35509",0,2,1,3,"dummy"
"35510",0,1,0,1,"dummy"
"35513",0,0,2,2,"dummy"
"35516",0,2,2,4,"dummy"
"35517",6,5,1,12,"dummy"
"35518",0,1,2,3,"dummy"
"35519",1,4,1,6,"dummy"
"35520",0,2,0,2,"dummy"
"35521",16,0,3,19,"dummy"
"35522",4,3,0,7,"dummy"
"35523",0,2,3,5,"dummy"
"35524",4,0,0,4,"dummy"
"35525",0,6,0,6,"dummy"
"35526",0,0,1,1,"dummy"
"35527",0,0,1,1,"dummy"
"35528",0,1,0,1,"dummy"
"35699",0,1,1,2,"dummy"
"35707",1,1,1,3,"dummy"
"35708",0,1,1,2,"dummy"
"35709",0,4,1,5,"dummy"
"35710",1,0,3,4,"dummy"
"35711",0,0,2,2,"dummy"
"35712",0,0,1,1,"dummy"
"35713",0,1,1,2,"dummy"
"35769",2,6,0,8,"dummy"
"35401",0,0,1,1,"dummy"
"35445",0,2,2,4,"dummy"
"35446",2,0,0,2,"dummy"
"35458",0,3,1,4,"dummy"
"35463",1,8,1,10,"dummy"
"35468",1,1,3,5,"dummy"
"35473",0,1,0,1,"dummy"
"35474",1,0,0,1,"dummy"
"35475",0,2,0,2,"dummy"
"35478",0,0,1,1,"dummy"
"35483",5,4,0,9,"dummy"
"35484",0,0,0,0,"dummy"
"35485",0,0,2,2,"dummy"
"35486",4,4,0,8,"dummy"
"35487",0,0,1,1,"dummy"
"35488",0,0,1,1,"dummy"
"35489",1,1,2,4,"dummy"
"35640",0,1,0,1,"dummy"
"35641",1,2,1,4,"dummy"
"35642",0,1,0,1,"dummy"
"35643",13,12,1,26,"dummy"
"35644",5,7,3,15,"dummy"
"35645",7,1,1,9,"dummy"
"35662",0,0,0,0,"dummy"
"35663",0,1,0,1,"dummy"
"35666",0,0,1,1,"dummy"
"35667",5,0,3,8,"dummy"
"35668",0,0,1,1,"dummy"
"35669",0,0,1,1,"dummy"
"35670",0,0,1,1,"dummy"
"35690",2,0,1,3,"dummy"
"35691",0,0,3,3,"dummy"
"35692",0,0,1,1,"dummy"
"35693",1,4,0,5,"dummy"
"35694",0,1,0,1,"dummy"
"35703",0,2,0,2,"dummy"
"35704",0,0,1,1,"dummy"
"35705",0,3,0,3,"dummy"
"35771",0,6,3,9,"dummy"
"35772",0,2,0,2,"dummy"
"35773",0,1,0,1,"dummy"
"35774",0,1,0,1,"dummy"
"35775",0,4,0,4,"dummy"
"35776",0,0,1,1,"dummy"
"35777",0,1,1,2,"dummy"
"35778",1,0,1,2,"dummy"
"35779",11,1,0,12,"dummy"
"35780",1,3,0,4,"dummy"
"35781",1,9,0,10,"dummy"
"35782",7,7,1,15,"dummy"
"35783",0,1,0,1,"dummy"
"35784",0,3,0,3,"dummy"
"35785",1,0,0,1,"dummy"
"35786",0,1,0,1,"dummy"
"35787",1,2,0,3,"dummy"
"35788",0,1,0,1,"dummy"
"35789",0,1,1,2,"dummy"
"35790",0,0,0,0,"dummy"
"35791",4,0,0,4,"dummy"
"35792",0,1,0,1,"dummy"
"35793",0,1,1,2,"dummy"
"35794",3,0,1,4,"dummy"
"35795",0,2,1,3,"dummy"
"35796",2,0,1,3,"dummy"
"35797",0,1,0,1,"dummy"
"35798",0,2,0,2,"dummy"
"35799",1,0,0,1,"dummy"
"35800",0,0,0,0,"dummy"
"35801",0,0,0,0,"dummy"
"35802",0,0,2,2,"dummy"
"35803",4,1,1,6,"dummy"
"35804",1,1,0,2,"dummy"
"35805",2,2,1,5,"dummy"
"35806",2,4,0,6,"dummy"
"35807",0,1,0,1,"dummy"
"35808",0,0,1,1,"dummy"
"35809",8,5,1,14,"dummy"
"35810",2,0,0,2,"dummy"
"35811",0,1,0,1,"dummy"
"35812",2,2,0,4,"dummy"
"35813",0,0,0,0,"dummy"
"35814",0,1,0,1,"dummy"
"35815",0,5,3,8,"dummy"
"35816",3,8,1,12,"dummy"
"35817",9,14,1,24,"dummy"
"35818",3,4,1,8,"dummy"
"35819",2,4,0,6,"dummy"
"35820",0,0,0,0,"dummy"
"35826",0,2,2,4,"dummy"
"35828",0,0,1,1,"dummy"
"35830",10,4,1,15,"dummy"
"35839",0,6,0,6,"dummy"
"35840",0,13,0,13,"dummy"
"35841",2,2,6,10,"dummy"
"35842",6,1,3,10,"dummy"
"35843",0,0,1,1,"dummy"
"35851",0,4,0,4,"dummy"
"35852",2,7,2,11,"dummy"
"35854",1,2,0,3,"dummy"
"35856",0,4,0,4,"dummy"
"35857",0,5,1,6,"dummy"
"35858",0,4,0,4,"dummy"
"35859",0,0,1,1,"dummy"
"35861",0,0,1,1,"dummy"
"35863",0,0,1,1,"dummy"
"35886",0,1,0,1,"dummy"
"35887",1,0,0,1,"dummy"
"35891",0,1,0,1,"dummy"
"35892",4,5,3,12,"dummy"
"35893",0,0,0,0,"dummy"
"35894",0,0,2,2,"dummy"
"35895",1,1,0,2,"dummy"
"35896",1,3,0,4,"dummy"
"35897",3,0,3,6,"dummy"
"35898",5,1,1,7,"dummy"
"35902",0,1,1,2,"dummy"
"35903",0,0,1,1,"dummy"
"35904",1,0,0,1,"dummy"
"35905",0,0,1,1,"dummy"
"35906",0,1,3,4,"dummy"
"35907",1,0,2,3,"dummy"
"35908",2,0,0,2,"dummy"
"35909",0,0,3,3,"dummy"
"35912",0,0,0,0,"dummy"
"35916",0,0,1,1,"dummy"
"35917",0,0,2,2,"dummy"
"35918",0,0,1,1,"dummy"
"35919",0,0,1,1,"dummy"
"35920",0,0,1,1,"dummy"
"35922",0,0,1,1,"dummy"
"35923",0,0,1,1,"dummy"
"35924",0,0,1,1,"dummy"
"35925",0,0,1,1,"dummy"
"35926",8,0,2,10,"dummy"
"35927",0,0,1,1,"dummy"
"35928",0,0,1,1,"dummy"
"35929",0,0,1,1,"dummy"
"35930",0,0,1,1,"dummy"
"35931",0,0,1,1,"dummy"
"35932",0,0,1,1,"dummy"
"35933",0,0,1,1,"dummy"
"35940",0,1,0,1,"dummy"
"35941",2,5,2,9,"dummy"
"35942",0,0,0,0,"dummy"
"35943",0,1,0,1,"dummy"
"35944",2,0,0,2,"dummy"
"35945",0,0,2,2,"dummy"
"35946",0,0,2,2,"dummy"
"35947",0,0,2,2,"dummy"
"35948",0,0,1,1,"dummy"
"35950",0,0,0,0,"dummy"
"35952",2,0,0,2,"dummy"
"35954",0,1,1,2,"dummy"
"35955",0,0,0,0,"dummy"
"35956",0,0,1,1,"dummy"
"35957",1,0,0,1,"dummy"
"35958",1,2,0,3,"dummy"
"35959",0,1,0,1,"dummy"
"35964",1,1,0,2,"dummy"
"35965",1,0,1,2,"dummy"
"35966",0,0,1,1,"dummy"
"35967",0,0,1,1,"dummy"
"35968",0,0,1,1,"dummy"
"35969",0,0,1,1,"dummy"
"35970",0,0,1,1,"dummy"
"35974",0,1,0,1,"dummy"
"35975",0,4,1,5,"dummy"
"35976",1,2,0,3,"dummy"
"35977",5,5,0,10,"dummy"
"35978",0,1,0,1,"dummy"
"35979",1,0,0,1,"dummy"
"35980",0,2,0,2,"dummy"
"35981",0,1,0,1,"dummy"
"35982",0,2,3,5,"dummy"
"35983",2,2,1,5,"dummy"
"35984",0,1,0,1,"dummy"
"35985",2,2,0,4,"dummy"
"35986",5,0,0,5,"dummy"
"36000",0,6,0,6,"dummy"
"36001",2,6,0,8,"dummy"
"36002",1,2,0,3,"dummy"
"36005",0,2,0,2,"dummy"
"36006",0,2,3,5,"dummy"
"36007",0,0,3,3,"dummy"
"36008",0,0,1,1,"dummy"
"36009",1,13,0,14,"dummy"
"36010",0,1,0,1,"dummy"
"36011",2,14,3,19,"dummy"
"36012",1,1,0,2,"dummy"
"36013",0,0,1,1,"dummy"
"36014",0,2,0,2,"dummy"
"36015",22,5,3,30,"dummy"
"36017",0,0,2,2,"dummy"
"36019",0,2,0,2,"dummy"
"36020",0,1,0,1,"dummy"
"36021",0,1,0,1,"dummy"
"36023",1,0,2,3,"dummy"
"36024",0,1,2,3,"dummy"
"36025",0,1,0,1,"dummy"
"36026",0,0,0,0,"dummy"
"36027",0,0,1,1,"dummy"
"36028",0,0,3,3,"dummy"
"36029",0,0,3,3,"dummy"
"36030",0,0,4,4,"dummy"
"36031",2,3,1,6,"dummy"
"36034",0,0,1,1,"dummy"
"36035",3,5,0,8,"dummy"
"36036",0,1,0,1,"dummy"
"36037",10,2,0,12,"dummy"
"36047",2,1,1,4,"dummy"
"36050",0,0,0,0,"dummy"
"36051",0,1,0,1,"dummy"
"36052",1,0,0,1,"dummy"
"36053",0,0,1,1,"dummy"
"36058",2,2,0,4,"dummy"
"36060",0,0,3,3,"dummy"
"36061",4,2,2,8,"dummy"
"36062",0,0,2,2,"dummy"
"36065",0,1,1,2,"dummy"
"36066",0,0,1,1,"dummy"
"36067",18,2,1,21,"dummy"
"36070",5,5,0,10,"dummy"
"36075",0,0,0,0,"dummy"
"36076",0,1,0,1,"dummy"
"36079",0,2,0,2,"dummy"
"36081",1,1,0,2,"dummy"
"36082",3,4,1,8,"dummy"
"36083",0,1,0,1,"dummy"
"36084",0,8,0,8,"dummy"
"36085",12,16,0,28,"dummy"
"36086",0,8,0,8,"dummy"
"36107",0,4,1,5,"dummy"
"36112",1,0,0,1,"dummy"
"36136",0,1,1,2,"dummy"
"36149",11,9,2,22,"dummy"
"36150",3,4,0,7,"dummy"
"36151",12,1,2,15,"dummy"
"36152",1,12,2,15,"dummy"
"36153",0,0,1,1,"dummy"
"36154",2,2,3,7,"dummy"
"36155",12,1,2,15,"dummy"
"36156",0,0,0,0,"dummy"
"36171",6,2,0,8,"dummy"
"36172",8,0,3,11,"dummy"
"36173",0,0,1,1,"dummy"
"36174",2,3,0,5,"dummy"
"36175",1,1,0,2,"dummy"
"36176",1,3,0,4,"dummy"
"36177",0,0,1,1,"dummy"
"36178",1,1,0,2,"dummy"
"36181",0,1,1,2,"dummy"
"36182",1,3,1,5,"dummy"
"36184",0,5,0,5,"dummy"
"36185",0,2,0,2,"dummy"
"36186",0,0,0,0,"dummy"
"36187",0,1,0,1,"dummy"
"36188",0,0,1,1,"dummy"
"36189",0,0,0,0,"dummy"
"36191",0,0,1,1,"dummy"
"36192",0,0,0,0,"dummy"
"36193",0,0,1,1,"dummy"
"36194",4,1,0,5,"dummy"
"36195",1,4,0,5,"dummy"
"36196",0,1,0,1,"dummy"
"36197",4,0,1,5,"dummy"
"36200",4,5,0,9,"dummy"
"36201",0,1,5,6,"dummy"
"36204",4,0,1,5,"dummy"
"36213",1,6,0,7,"dummy"
"36214",0,0,2,2,"dummy"
"36215",0,0,1,1,"dummy"
"36216",0,0,1,1,"dummy"
"36217",0,0,1,1,"dummy"
"36218",0,2,3,5,"dummy"
"36219",0,0,1,1,"dummy"
"36220",0,0,1,1,"dummy"
"36221",0,0,2,2,"dummy"
"36222",0,3,1,4,"dummy"
"36223",0,0,1,1,"dummy"
"36225",0,0,2,2,"dummy"
"36226",0,7,0,7,"dummy"
"36227",0,1,0,1,"dummy"
"36228",0,0,1,1,"dummy"
"36229",0,0,1,1,"dummy"
"36230",0,0,2,2,"dummy"
"36231",0,0,2,2,"dummy"
"36236",0,0,0,0,"dummy"
"36238",0,0,1,1,"dummy"
"36239",0,0,0,0,"dummy"
"36240",0,0,0,0,"dummy"
"36241",0,0,1,1,"dummy"
"36242",0,0,1,1,"dummy"
"36243",0,0,0,0,"dummy"
"36244",0,3,0,3,"dummy"
"36245",0,0,0,0,"dummy"
"36246",0,0,0,0,"dummy"
"36247",0,0,0,0,"dummy"
"36272",0,1,1,2,"dummy"
"36273",1,1,0,2,"dummy"
"36274",0,0,1,1,"dummy"
"36295",0,2,0,2,"dummy"
"36296",1,2,0,3,"dummy"
"36297",0,1,0,1,"dummy"
"36298",1,14,0,15,"dummy"
"36342",0,3,0,3,"dummy"
"36386",1,1,2,4,"dummy"
"36387",0,4,3,7,"dummy"
"36396",3,0,0,3,"dummy"
"36420",4,3,2,9,"dummy"
"36423",0,0,0,0,"dummy"
"36429",0,0,1,1,"dummy"
"36441",0,2,0,2,"dummy"
"36442",1,0,0,1,"dummy"
"36443",0,1,0,1,"dummy"
"36444",0,7,0,7,"dummy"
"36445",0,0,3,3,"dummy"
"36446",0,0,3,3,"dummy"
"36464",2,3,0,5,"dummy"
"36479",0,0,0,0,"dummy"
"36480",0,0,0,0,"dummy"
"36481",0,0,1,1,"dummy"
"36482",1,0,0,1,"dummy"
"36483",0,0,0,0,"dummy"
"36484",0,0,0,0,"dummy"
"36485",0,0,0,0,"dummy"
"36486",0,0,0,0,"dummy"
"36487",0,0,1,1,"dummy"
"36488",0,0,0,0,"dummy"
"36489",0,0,0,0,"dummy"
"36497",2,5,2,9,"dummy"
"36518",0,0,1,1,"dummy"
"36519",0,0,1,1,"dummy"
"36520",3,2,2,7,"dummy"
"36573",0,0,1,1,"dummy"
"36574",1,0,0,1,"dummy"
"36575",1,0,0,1,"dummy"
"36580",0,12,2,14,"dummy"
"36587",0,0,1,1,"dummy"
"36588",2,0,0,2,"dummy"
"36589",0,0,1,1,"dummy"
"36590",0,0,0,0,"dummy"
"36591",0,1,2,3,"dummy"
"36592",1,0,0,1,"dummy"
"36593",0,0,1,1,"dummy"
"36594",2,0,0,2,"dummy"
"36595",0,0,1,1,"dummy"
"36596",0,1,0,1,"dummy"
"36597",0,2,0,2,"dummy"
"36598",0,0,0,0,"dummy"
"36599",0,1,0,1,"dummy"
"36600",4,0,0,4,"dummy"
"36249",0,1,0,1,"dummy"
"36250",2,0,0,2,"dummy"
"36251",4,1,3,8,"dummy"
"36252",0,0,2,2,"dummy"
"36253",0,1,3,4,"dummy"
"36256",9,11,1,21,"dummy"
"36257",4,5,1,10,"dummy"
"36258",0,0,1,1,"dummy"
"36259",0,1,0,1,"dummy"
"36260",0,1,0,1,"dummy"
"36261",0,1,0,1,"dummy"
"36262",0,0,0,0,"dummy"
"36263",5,0,0,5,"dummy"
"36264",0,1,0,1,"dummy"
"36276",0,1,0,1,"dummy"
"36277",0,0,0,0,"dummy"
"36278",0,1,0,1,"dummy"
"36279",4,11,1,16,"dummy"
"36282",0,6,0,6,"dummy"
"36293",0,1,0,1,"dummy"
"36302",0,0,1,1,"dummy"
"36303",0,0,1,1,"dummy"
"36304",0,0,1,1,"dummy"
"36305",0,0,3,3,"dummy"
"36306",0,0,1,1,"dummy"
"36307",6,3,0,9,"dummy"
"36308",1,3,0,4,"dummy"
"36309",0,1,0,1,"dummy"
"36310",5,1,0,6,"dummy"
"36311",0,0,0,0,"dummy"
"36312",0,0,2,2,"dummy"
"36313",0,0,0,0,"dummy"
"36314",0,0,1,1,"dummy"
"36315",0,0,0,0,"dummy"
"36316",0,0,0,0,"dummy"
"36317",0,0,1,1,"dummy"
"36318",1,2,0,3,"dummy"
"36319",0,0,0,0,"dummy"
"36320",2,1,0,3,"dummy"
"36321",0,0,0,0,"dummy"
"36322",0,3,1,4,"dummy"
"36331",9,4,0,13,"dummy"
"36332",0,2,0,2,"dummy"
"36333",1,1,0,2,"dummy"
"36334",0,0,0,0,"dummy"
"36335",1,5,0,6,"dummy"
"36336",0,1,0,1,"dummy"
"36337",1,0,0,1,"dummy"
"36338",1,1,0,2,"dummy"
"36339",0,0,0,0,"dummy"
"36340",0,0,0,0,"dummy"
"36381",0,6,0,6,"dummy"
"36382",0,1,0,1,"dummy"
"36383",0,1,0,1,"dummy"
"36384",0,0,1,1,"dummy"
"36400",4,3,0,7,"dummy"
"36401",0,0,1,1,"dummy"
"36402",11,2,0,13,"dummy"
"36405",0,0,1,1,"dummy"
"36406",0,0,1,1,"dummy"
"36407",0,1,0,1,"dummy"
"36410",0,0,1,1,"dummy"
"36411",0,2,0,2,"dummy"
"36412",0,0,1,1,"dummy"
"36413",0,0,1,1,"dummy"
"36414",0,0,1,1,"dummy"
"36415",0,0,2,2,"dummy"
"36416",2,2,0,4,"dummy"
"36425",12,24,2,38,"dummy"
"36426",0,1,0,1,"dummy"
"36427",0,0,1,1,"dummy"
"36448",0,0,0,0,"dummy"
"36451",0,0,1,1,"dummy"
"36454",0,0,1,1,"dummy"
"36455",0,0,1,1,"dummy"
"36460",0,0,1,1,"dummy"
"36466",1,0,2,3,"dummy"
"36467",11,4,0,15,"dummy"
"36468",21,34,3,58,"dummy"
"36469",18,1,3,22,"dummy"
"36470",0,0,1,1,"dummy"
"36471",0,0,1,1,"dummy"
"36472",0,0,1,1,"dummy"
"36473",0,0,1,1,"dummy"
"36474",0,0,1,1,"dummy"
"36475",0,16,0,16,"dummy"
"36476",2,5,0,7,"dummy"
"36477",0,2,0,2,"dummy"
"36491",0,1,0,1,"dummy"
"36492",0,0,1,1,"dummy"
"36493",0,1,0,1,"dummy"
"36494",0,0,1,1,"dummy"
"36495",0,0,1,1,"dummy"
"36501",0,2,0,2,"dummy"
"36502",0,1,0,1,"dummy"
"36503",1,0,0,1,"dummy"
"36504",0,1,0,1,"dummy"
"36505",0,0,0,0,"dummy"
"36506",4,1,0,5,"dummy"
"36507",1,0,0,1,"dummy"
"36508",0,0,0,0,"dummy"
"36509",0,0,0,0,"dummy"
"36522",0,1,0,1,"dummy"
"36523",0,1,0,1,"dummy"
"36524",0,1,0,1,"dummy"
"36525",0,0,1,1,"dummy"
"36526",0,0,1,1,"dummy"
"36531",0,4,0,4,"dummy"
"36532",4,7,0,11,"dummy"
"36537",2,2,1,5,"dummy"
"36538",0,2,0,2,"dummy"
"36539",0,0,1,1,"dummy"
"36540",0,0,1,1,"dummy"
"36541",0,0,1,1,"dummy"
"36542",0,0,1,1,"dummy"
"36543",0,0,1,1,"dummy"
"36544",0,0,1,1,"dummy"
"36545",5,9,2,16,"dummy"
"36546",0,0,0,0,"dummy"
"36547",0,0,1,1,"dummy"
"36548",0,0,0,0,"dummy"
"36549",0,0,0,0,"dummy"
"36550",10,3,2,15,"dummy"
"36551",0,0,1,1,"dummy"
"36552",0,0,1,1,"dummy"
"36553",0,3,1,4,"dummy"
"36554",0,0,1,1,"dummy"
"36555",0,0,1,1,"dummy"
"36556",0,0,1,1,"dummy"
"36557",0,0,1,1,"dummy"
"36558",0,0,1,1,"dummy"
"36559",0,0,1,1,"dummy"
"36560",0,0,1,1,"dummy"
"36561",0,0,1,1,"dummy"
"36562",3,3,0,6,"dummy"
"36563",0,0,1,1,"dummy"
"36564",0,2,0,2,"dummy"
"36565",0,1,1,2,"dummy"
"36566",0,0,1,1,"dummy"
"36569",1,2,0,3,"dummy"
"36570",0,1,0,1,"dummy"
"36571",30,56,1,87,"dummy"
"36577",0,2,1,3,"dummy"
"36578",0,0,1,1,"dummy"
"36582",0,1,0,1,"dummy"
"36585",0,2,2,4,"dummy"
"36611",0,3,0,3,"dummy"
"36618",4,0,0,4,"dummy"
"36628",0,0,1,1,"dummy"
"36629",0,1,0,1,"dummy"
"36630",0,0,1,1,"dummy"
"36648",0,0,1,1,"dummy"
"36649",0,0,2,2,"dummy"
"36650",0,5,1,6,"dummy"
"36651",0,0,1,1,"dummy"
"36652",0,0,1,1,"dummy"
"36653",0,4,0,4,"dummy"
"36654",0,1,0,1,"dummy"
"36655",40,7,6,53,"dummy"
"36601",0,0,0,0,"dummy"
"36602",0,0,0,0,"dummy"
"36603",4,0,0,4,"dummy"
"36606",0,3,0,3,"dummy"
"36609",0,6,0,6,"dummy"
"36613",0,0,1,1,"dummy"
"36616",1,2,2,5,"dummy"
"36620",0,0,1,1,"dummy"
"36621",1,0,0,1,"dummy"
"36624",6,3,0,9,"dummy"
"36632",0,0,0,0,"dummy"
"36633",0,0,1,1,"dummy"
"36634",1,2,2,5,"dummy"
"36635",3,28,0,31,"dummy"
"36643",8,2,1,11,"dummy"
"36644",2,1,0,3,"dummy"
"36661",0,0,0,0,"dummy"
"36662",0,0,1,1,"dummy"
"36673",0,2,0,2,"dummy"
"36674",0,2,0,2,"dummy"
"36675",0,0,0,0,"dummy"
"36679",0,0,1,1,"dummy"
"36680",0,0,2,2,"dummy"
"36681",0,1,1,2,"dummy"
"36682",1,0,2,3,"dummy"
"36685",0,1,0,1,"dummy"
"36691",0,1,0,1,"dummy"
"36692",0,1,0,1,"dummy"
"36693",0,1,0,1,"dummy"
"36694",0,1,0,1,"dummy"
"36695",0,0,0,0,"dummy"
"36696",0,4,0,4,"dummy"
"36697",0,0,1,1,"dummy"
"36698",0,1,0,1,"dummy"
"36699",0,3,0,3,"dummy"
"36718",0,0,1,1,"dummy"
"36723",0,1,0,1,"dummy"
"36724",1,2,2,5,"dummy"
"36728",0,0,0,0,"dummy"
"36729",0,0,0,0,"dummy"
"36730",0,0,0,0,"dummy"
"36738",0,1,0,1,"dummy"
"36739",0,0,1,1,"dummy"
"36742",0,23,0,23,"dummy"
"36743",0,1,1,2,"dummy"
"36744",0,0,2,2,"dummy"
"36745",0,0,1,1,"dummy"
"36746",0,0,1,1,"dummy"
"36747",0,0,1,1,"dummy"
"36748",0,1,0,1,"dummy"
"36749",0,0,1,1,"dummy"
"36750",0,0,1,1,"dummy"
"36751",0,0,1,1,"dummy"
"36752",0,0,2,2,"dummy"
"36753",0,0,1,1,"dummy"
"36754",0,0,1,1,"dummy"
"36755",0,3,1,4,"dummy"
"36756",0,0,0,0,"dummy"
"36786",0,1,0,1,"dummy"
"36787",0,0,1,1,"dummy"
"36790",0,0,0,0,"dummy"
"36791",0,1,2,3,"dummy"
"36830",0,1,0,1,"dummy"
"36833",0,0,0,0,"dummy"
"36834",5,0,2,7,"dummy"
"36835",0,0,0,0,"dummy"
"36656",0,1,0,1,"dummy"
"36657",0,1,0,1,"dummy"
"36664",0,0,3,3,"dummy"
"36665",0,0,0,0,"dummy"
"36666",0,0,1,1,"dummy"
"36669",0,2,1,3,"dummy"
"36689",0,0,1,1,"dummy"
"36726",0,0,1,1,"dummy"
"36734",0,0,1,1,"dummy"
"36735",1,3,1,5,"dummy"
"36736",2,1,0,3,"dummy"
"36758",0,0,2,2,"dummy"
"36761",0,0,3,3,"dummy"
"36762",5,2,2,9,"dummy"
"36763",0,0,0,0,"dummy"
"36764",0,1,0,1,"dummy"
"36765",1,3,2,6,"dummy"
"36766",3,1,2,6,"dummy"
"36767",1,0,1,2,"dummy"
"36770",0,0,0,0,"dummy"
"36771",0,2,0,2,"dummy"
"36772",0,0,1,1,"dummy"
"36773",0,4,0,4,"dummy"
"36774",1,6,0,7,"dummy"
"36775",0,2,0,2,"dummy"
"36776",0,5,0,5,"dummy"
"36777",5,0,0,5,"dummy"
"36780",0,0,2,2,"dummy"
"36781",0,5,1,6,"dummy"
"36782",8,7,1,16,"dummy"
"36783",0,3,0,3,"dummy"
"36784",2,0,1,3,"dummy"
"36795",0,1,2,3,"dummy"
"36796",0,0,1,1,"dummy"
"36797",0,0,1,1,"dummy"
"36798",0,1,0,1,"dummy"
"36799",1,0,1,2,"dummy"
"36800",0,0,1,1,"dummy"
"36805",0,0,1,1,"dummy"
"36806",0,0,1,1,"dummy"
"36809",7,9,2,18,"dummy"
"36810",11,19,1,31,"dummy"
"36811",2,1,0,3,"dummy"
"36826",18,25,1,44,"dummy"
"36841",0,0,0,0,"dummy"
"36844",0,0,1,1,"dummy"
"36859",0,3,0,3,"dummy"
"36863",0,0,1,1,"dummy"
"36905",17,4,4,25,"dummy"
"36910",0,1,0,1,"dummy"
"36911",0,2,0,2,"dummy"
"36912",4,9,8,21,"dummy"
"36913",16,0,0,16,"dummy"
"36914",0,2,0,2,"dummy"
"36915",2,0,0,2,"dummy"
"36916",4,3,1,8,"dummy"
"36846",4,0,3,7,"dummy"
"36849",0,1,0,1,"dummy"
"36861",0,1,0,1,"dummy"
"36869",0,0,1,1,"dummy"
"36877",0,1,0,1,"dummy"
"36884",0,0,3,3,"dummy"
"36921",0,0,4,4,"dummy"
"36922",6,1,5,12,"dummy"
"36923",0,5,0,5,"dummy"
"36924",0,3,0,3,"dummy"
"36925",0,0,0,0,"dummy"
"36926",3,0,0,3,"dummy"
"36927",4,1,1,6,"dummy"
"36928",1,4,2,7,"dummy"
"36942",2,3,0,5,"dummy"
"36966",0,14,3,17,"dummy"
"36967",7,9,1,17,"dummy"
"36968",0,1,0,1,"dummy"
"36976",0,6,0,6,"dummy"
"36977",0,28,0,28,"dummy"
"36978",0,0,1,1,"dummy"
"37001",0,0,1,1,"dummy"
"36917",0,2,1,3,"dummy"
"36918",0,2,0,2,"dummy"
"36919",0,2,0,2,"dummy"
"36932",11,0,1,12,"dummy"
"36933",0,2,0,2,"dummy"
"36934",1,0,1,2,"dummy"
"36935",0,0,1,1,"dummy"
"36938",2,2,0,4,"dummy"
"36939",0,0,0,0,"dummy"
"36940",4,6,0,10,"dummy"
"36946",1,4,1,6,"dummy"
"36947",0,3,0,3,"dummy"
"36948",1,0,0,1,"dummy"
"36949",0,1,0,1,"dummy"
"36950",1,0,0,1,"dummy"
"36982",0,1,0,1,"dummy"
"36983",0,1,0,1,"dummy"
"36984",6,3,1,10,"dummy"
"36987",4,1,0,5,"dummy"
"36988",0,1,0,1,"dummy"
"36989",3,2,0,5,"dummy"
"36990",3,7,0,10,"dummy"
"36991",1,1,0,2,"dummy"
"36992",0,1,0,1,"dummy"
"36993",0,1,0,1,"dummy"
"36994",0,1,0,1,"dummy"
"36995",0,1,0,1,"dummy"
"36996",1,6,0,7,"dummy"
"36997",0,1,0,1,"dummy"
"36998",4,0,0,4,"dummy"
"36999",2,0,0,2,"dummy"
"37003",0,11,2,13,"dummy"
"37004",0,0,1,1,"dummy"
"37005",0,4,1,5,"dummy"
"37006",0,0,0,0,"dummy"
"37007",4,1,0,5,"dummy"
"37008",1,4,0,5,"dummy"
"37014",0,0,3,3,"dummy"
"37015",0,0,1,1,"dummy"
"37016",0,3,1,4,"dummy"
"37017",2,2,0,4,"dummy"
"37018",2,3,0,5,"dummy"
"37019",2,2,0,4,"dummy"
"37020",2,0,1,3,"dummy"
"37021",21,0,0,21,"dummy"
"37041",0,0,1,1,"dummy"
"37042",0,1,0,1,"dummy"
"37047",0,0,0,0,"dummy"
"37048",0,0,1,1,"dummy"
"37045",0,0,1,1,"dummy"
"37044",1,0,0,1,"dummy"
"37050",0,0,1,1,"dummy"
"37051",0,0,0,0,"dummy"
"37052",4,1,0,5,"dummy"
"37053",0,0,1,1,"dummy"
"37058",0,3,0,3,"dummy"
"37059",2,1,1,4,"dummy"
"37060",0,1,0,1,"dummy"
"37065",0,6,0,6,"dummy"
"37067",2,0,3,5,"dummy"
"37071",2,3,0,5,"dummy"
"37072",5,2,1,8,"dummy"
"37073",5,6,3,14,"dummy"
"37074",0,1,0,1,"dummy"
"37075",3,4,3,10,"dummy"
"37076",2,6,1,9,"dummy"
"37077",0,6,1,7,"dummy"
"37078",0,0,1,1,"dummy"
"37079",5,0,0,5,"dummy"
"37080",0,1,0,1,"dummy"
"37083",0,0,1,1,"dummy"
"37084",0,0,2,2,"dummy"
"37085",0,3,0,3,"dummy"
"37086",0,0,1,1,"dummy"
"37090",0,2,0,2,"dummy"
"37091",0,0,0,0,"dummy"
"37092",0,4,0,4,"dummy"
"37093",4,2,1,7,"dummy"
"37096",0,1,0,1,"dummy"
"37098",0,1,0,1,"dummy"
"37119",0,1,0,1,"dummy"
"37121",6,3,0,9,"dummy"
"37125",0,8,1,9,"dummy"
"37128",0,0,1,1,"dummy"
"37129",0,1,1,2,"dummy"
"37132",0,0,1,1,"dummy"
"37133",0,0,1,1,"dummy"
"37136",3,5,0,8,"dummy"
"37137",0,1,1,2,"dummy"
"37138",1,0,0,1,"dummy"
"37141",0,1,0,1,"dummy"
"37142",1,1,0,2,"dummy"
"37143",1,0,1,2,"dummy"
"37145",0,10,0,10,"dummy"
"37146",11,1,0,12,"dummy"
"37147",0,2,0,2,"dummy"
"37150",0,1,0,1,"dummy"
"37151",1,1,0,2,"dummy"
"37153",1,0,0,1,"dummy"
"37156",0,0,0,0,"dummy"
"37157",0,1,0,1,"dummy"
"37160",0,0,1,1,"dummy"
"37163",0,0,0,0,"dummy"
"37164",2,4,1,7,"dummy"
"37165",0,0,1,1,"dummy"
"37166",0,0,1,1,"dummy"
"37167",0,0,1,1,"dummy"
"37170",0,6,0,6,"dummy"
"37171",2,1,0,3,"dummy"
"37172",0,1,0,1,"dummy"
"37173",0,1,0,1,"dummy"
"37174",1,0,0,1,"dummy"
"37175",0,1,0,1,"dummy"
"37176",1,0,0,1,"dummy"
"37178",0,1,0,1,"dummy"
"37179",0,1,0,1,"dummy"
"37180",0,3,0,3,"dummy"
"37181",0,1,0,1,"dummy"
"37182",0,0,1,1,"dummy"
"37183",0,13,0,13,"dummy"
"37184",12,0,1,13,"dummy"
"37185",0,1,0,1,"dummy"
"37186",1,14,0,15,"dummy"
"37187",1,4,1,6,"dummy"
"37188",0,3,0,3,"dummy"
"37189",0,3,0,3,"dummy"
"37190",0,5,0,5,"dummy"
"37191",0,1,0,1,"dummy"
"37192",0,2,0,2,"dummy"
"37193",2,2,2,6,"dummy"
"37194",7,7,0,14,"dummy"
"37195",0,2,0,2,"dummy"
"37196",0,12,1,13,"dummy"
"37197",13,3,0,16,"dummy"
"37198",0,0,1,1,"dummy"
"37199",0,0,0,0,"dummy"
"37200",0,1,0,1,"dummy"
"37201",0,0,0,0,"dummy"
"37202",0,1,0,1,"dummy"
"37203",0,3,4,7,"dummy"
"37204",0,4,0,4,"dummy"
"37206",0,0,0,0,"dummy"
"37218",13,20,3,36,"dummy"
"37224",10,0,0,10,"dummy"
"37225",0,1,0,1,"dummy"
"37226",0,0,1,1,"dummy"
"37227",12,0,1,13,"dummy"
"37228",0,2,0,2,"dummy"
"37232",0,0,0,0,"dummy"
"37233",4,1,0,5,"dummy"
"37234",0,4,0,4,"dummy"
"37235",0,0,1,1,"dummy"
"37245",0,0,1,1,"dummy"
"37246",0,0,1,1,"dummy"
"37249",0,1,3,4,"dummy"
"37250",0,0,1,1,"dummy"
"37251",0,0,1,1,"dummy"
"37253",0,0,1,1,"dummy"
"37254",0,0,1,1,"dummy"
"37255",0,0,1,1,"dummy"
"37256",0,0,1,1,"dummy"
"37257",0,0,1,1,"dummy"
"37262",0,1,0,1,"dummy"
"37263",1,0,1,2,"dummy"
"37266",3,1,0,4,"dummy"
"37267",2,0,0,2,"dummy"
"37268",0,3,1,4,"dummy"
"37269",0,0,2,2,"dummy"
"37270",1,0,0,1,"dummy"
"37271",1,2,0,3,"dummy"
"37272",0,1,0,1,"dummy"
"37275",0,0,1,1,"dummy"
"37276",0,0,1,1,"dummy"
"37277",1,0,0,1,"dummy"
"37278",0,1,2,3,"dummy"
"37279",1,0,2,3,"dummy"
"37280",0,1,2,3,"dummy"
"37281",1,1,0,2,"dummy"
"37282",0,0,1,1,"dummy"
"37285",0,0,1,1,"dummy"
"37286",0,1,0,1,"dummy"
"37287",0,0,1,1,"dummy"
"37288",0,0,0,0,"dummy"
"37289",0,6,0,6,"dummy"
"37290",0,0,1,1,"dummy"
"37291",0,0,1,1,"dummy"
"37292",0,0,1,1,"dummy"
"37293",0,0,2,2,"dummy"
"37294",0,0,1,1,"dummy"
"37296",5,0,0,5,"dummy"
"37297",0,0,4,4,"dummy"
"37301",0,2,0,2,"dummy"
"37302",0,0,1,1,"dummy"
"37303",2,1,2,5,"dummy"
"37304",1,4,3,8,"dummy"
"37306",0,0,0,0,"dummy"
"37307",7,0,2,9,"dummy"
"37308",0,0,1,1,"dummy"
"37309",0,0,1,1,"dummy"
"37310",0,0,2,2,"dummy"
"37313",5,5,3,13,"dummy"
"37315",0,0,1,1,"dummy"
"37317",0,0,0,0,"dummy"
"37319",0,36,0,36,"dummy"
"37320",0,2,0,2,"dummy"
"37321",10,23,4,37,"dummy"
"37322",3,3,0,6,"dummy"
"37323",0,2,0,2,"dummy"
"37324",0,0,2,2,"dummy"
"37325",0,0,1,1,"dummy"
"37326",1,0,0,1,"dummy"
"37330",0,3,1,4,"dummy"
"37342",5,3,0,8,"dummy"
"37349",0,3,0,3,"dummy"
"37352",1,2,0,3,"dummy"
"37353",1,0,0,1,"dummy"
"37354",2,2,0,4,"dummy"
"37359",0,2,0,2,"dummy"
"37360",2,3,1,6,"dummy"
"37361",0,0,1,1,"dummy"
"37362",0,0,1,1,"dummy"
"37365",4,14,1,19,"dummy"
"37366",0,0,1,1,"dummy"
"37374",3,7,2,12,"dummy"
"37375",3,2,0,5,"dummy"
"37376",0,0,0,0,"dummy"
"37377",0,1,0,1,"dummy"
"37382",5,8,1,14,"dummy"
"37391",0,0,0,0,"dummy"
"37392",1,0,0,1,"dummy"
"37393",0,0,1,1,"dummy"
"37394",2,0,0,2,"dummy"
"37395",0,0,1,1,"dummy"
"37396",0,0,1,1,"dummy"
"37397",0,2,0,2,"dummy"
"37398",0,1,0,1,"dummy"
"37399",0,3,0,3,"dummy"
"37400",3,0,1,4,"dummy"
"37401",0,3,0,3,"dummy"
"37402",0,0,0,0,"dummy"
"37403",0,0,0,0,"dummy"
"37404",10,0,0,10,"dummy"
"37405",0,0,0,0,"dummy"
"37406",0,0,0,0,"dummy"
"37411",4,4,0,8,"dummy"
"37412",7,7,0,14,"dummy"
"37413",4,5,0,9,"dummy"
"37424",1,1,0,2,"dummy"
"37427",0,1,0,1,"dummy"
"37428",0,1,0,1,"dummy"
"37434",3,6,1,10,"dummy"
"37435",1,0,0,1,"dummy"
"37436",0,1,0,1,"dummy"
"37437",0,3,0,3,"dummy"
"37460",2,0,0,2,"dummy"
"37470",0,1,1,2,"dummy"
"37471",8,13,3,24,"dummy"
"37472",2,6,0,8,"dummy"
"37473",0,1,0,1,"dummy"
"37474",0,4,1,5,"dummy"
"37475",1,1,0,2,"dummy"
"37476",0,1,0,1,"dummy"
"37477",0,0,0,0,"dummy"
"37478",0,1,0,1,"dummy"
"37479",0,0,1,1,"dummy"
"37490",0,0,1,1,"dummy"
"37491",0,0,1,1,"dummy"
"37502",9,0,5,14,"dummy"
"37521",0,1,0,1,"dummy"
"37522",0,1,0,1,"dummy"
"37575",1,0,0,1,"dummy"
"37576",2,0,0,2,"dummy"
"37328",0,4,0,4,"dummy"
"37332",0,1,0,1,"dummy"
"37333",0,0,1,1,"dummy"
"37334",1,1,0,2,"dummy"
"37335",0,1,0,1,"dummy"
"37336",16,4,1,21,"dummy"
"37337",0,0,0,0,"dummy"
"37338",0,0,1,1,"dummy"
"37339",0,2,0,2,"dummy"
"37340",0,0,4,4,"dummy"
"37368",0,2,0,2,"dummy"
"37369",0,2,1,3,"dummy"
"37372",0,1,0,1,"dummy"
"37415",8,6,3,17,"dummy"
"37416",0,0,1,1,"dummy"
"37432",2,1,0,3,"dummy"
"37439",5,1,0,6,"dummy"
"37440",5,0,0,5,"dummy"
"37441",3,0,1,4,"dummy"
"37442",0,1,3,4,"dummy"
"37443",2,2,1,5,"dummy"
"37444",2,0,1,3,"dummy"
"37445",0,0,1,1,"dummy"
"37446",0,0,1,1,"dummy"
"37449",3,8,3,14,"dummy"
"37450",0,2,1,3,"dummy"
"37451",2,0,2,4,"dummy"
"37452",1,2,2,5,"dummy"
"37453",0,1,0,1,"dummy"
"37456",2,5,3,10,"dummy"
"37457",1,10,1,12,"dummy"
"37458",0,0,0,0,"dummy"
"37464",1,2,0,3,"dummy"
"37483",0,1,2,3,"dummy"
"37484",0,0,0,0,"dummy"
"37485",0,1,0,1,"dummy"
"37486",4,0,2,6,"dummy"
"37487",1,0,0,1,"dummy"
"37488",0,0,0,0,"dummy"
"37493",0,1,0,1,"dummy"
"37494",0,2,0,2,"dummy"
"37516",0,0,0,0,"dummy"
"37519",0,2,0,2,"dummy"
"37524",0,0,2,2,"dummy"
"37525",2,0,0,2,"dummy"
"37530",1,2,0,3,"dummy"
"37531",3,9,0,12,"dummy"
"37532",17,1,0,18,"dummy"
"37533",1,18,0,19,"dummy"
"37534",0,1,1,2,"dummy"
"37535",0,0,0,0,"dummy"
"37536",17,1,0,18,"dummy"
"37537",1,0,0,1,"dummy"
"37538",0,0,0,0,"dummy"
"37539",0,1,1,2,"dummy"
"37540",2,2,0,4,"dummy"
"37541",2,3,0,5,"dummy"
"37542",0,0,1,1,"dummy"
"37543",2,2,0,4,"dummy"
"37544",0,1,0,1,"dummy"
"37545",0,3,1,4,"dummy"
"37546",3,5,2,10,"dummy"
"37547",2,2,1,5,"dummy"
"37548",0,1,0,1,"dummy"
"37549",0,1,0,1,"dummy"
"37550",4,1,0,5,"dummy"
"37551",1,1,1,3,"dummy"
"37552",2,5,2,9,"dummy"
"37553",0,0,1,1,"dummy"
"37554",5,2,1,8,"dummy"
"37555",5,2,1,8,"dummy"
"37556",12,6,0,18,"dummy"
"37557",0,0,0,0,"dummy"
"37558",0,0,0,0,"dummy"
"37559",0,0,0,0,"dummy"
"37560",0,11,0,11,"dummy"
"37561",0,1,0,1,"dummy"
"37562",3,6,0,9,"dummy"
"37563",0,1,0,1,"dummy"
"37564",0,2,0,2,"dummy"
"37565",0,0,1,1,"dummy"
"37566",0,1,0,1,"dummy"
"37567",0,1,0,1,"dummy"
"37570",2,9,0,11,"dummy"
"37571",2,1,1,4,"dummy"
"37572",1,1,1,3,"dummy"
"37573",4,0,0,4,"dummy"
"37589",2,0,1,3,"dummy"
"37590",4,3,0,7,"dummy"
"37604",0,0,2,2,"dummy"
"37605",0,0,1,1,"dummy"
"37606",0,0,2,2,"dummy"
"37618",0,2,0,2,"dummy"
"37619",0,1,0,1,"dummy"
"37620",3,3,1,7,"dummy"
"37621",2,1,0,3,"dummy"
"37622",0,0,0,0,"dummy"
"37623",0,0,3,3,"dummy"
"37690",0,1,0,1,"dummy"
"37691",0,1,0,1,"dummy"
"37692",2,13,1,16,"dummy"
"37693",0,0,0,0,"dummy"
"37694",0,1,0,1,"dummy"
"37695",1,2,0,3,"dummy"
"37696",0,3,0,3,"dummy"
"37697",0,2,1,3,"dummy"
"37698",0,3,0,3,"dummy"
"37699",1,2,0,3,"dummy"
"37700",5,0,0,5,"dummy"
"37712",0,1,0,1,"dummy"
"37713",2,2,1,5,"dummy"
"37714",1,1,0,2,"dummy"
"37715",4,2,2,8,"dummy"
"37718",0,0,0,0,"dummy"
"37719",0,2,0,2,"dummy"
"37720",1,0,0,1,"dummy"
"37728",0,0,2,2,"dummy"
"37735",0,1,0,1,"dummy"
"37744",1,4,0,5,"dummy"
"37749",0,0,2,2,"dummy"
"37750",7,7,5,19,"dummy"
"37754",0,0,0,0,"dummy"
"37774",0,0,1,1,"dummy"
"37775",1,0,0,1,"dummy"
"37781",2,2,2,6,"dummy"
"37782",0,1,1,2,"dummy"
"37783",3,2,2,7,"dummy"
"37795",0,0,0,0,"dummy"
"37796",0,0,1,1,"dummy"
"37810",1,0,0,1,"dummy"
"37811",1,1,0,2,"dummy"
"37826",2,0,0,2,"dummy"
"37583",0,0,1,1,"dummy"
"37586",1,5,2,8,"dummy"
"37587",1,0,0,1,"dummy"
"37592",0,1,0,1,"dummy"
"37593",1,0,0,1,"dummy"
"37610",0,1,0,1,"dummy"
"37613",2,5,0,7,"dummy"
"37616",0,1,0,1,"dummy"
"37625",0,0,1,1,"dummy"
"37628",5,21,1,27,"dummy"
"37629",24,0,1,25,"dummy"
"37630",0,1,0,1,"dummy"
"37631",2,2,0,4,"dummy"
"37704",2,1,0,3,"dummy"
"37707",4,2,4,10,"dummy"
"37708",0,0,1,1,"dummy"
"37709",0,0,1,1,"dummy"
"37710",0,0,1,1,"dummy"
"37722",0,0,1,1,"dummy"
"37723",4,11,0,15,"dummy"
"37724",0,0,1,1,"dummy"
"37725",0,0,0,0,"dummy"
"37726",0,1,0,1,"dummy"
"37730",0,1,1,2,"dummy"
"37731",0,1,0,1,"dummy"
"37737",0,4,0,4,"dummy"
"37738",0,8,0,8,"dummy"
"37739",1,1,0,2,"dummy"
"37740",0,0,2,2,"dummy"
"37741",0,5,0,5,"dummy"
"37742",0,0,2,2,"dummy"
"37746",6,2,0,8,"dummy"
"37747",1,5,0,6,"dummy"
"37752",0,1,0,1,"dummy"
"37758",0,0,1,1,"dummy"
"37759",0,0,0,0,"dummy"
"37760",2,3,0,5,"dummy"
"37761",2,2,0,4,"dummy"
"37764",13,20,3,36,"dummy"
"37765",14,6,1,21,"dummy"
"37766",1,7,0,8,"dummy"
"37767",0,1,0,1,"dummy"
"37768",0,1,0,1,"dummy"
"37769",1,27,5,33,"dummy"
"37770",10,4,1,15,"dummy"
"37771",0,1,0,1,"dummy"
"37772",0,1,0,1,"dummy"
"37779",0,7,1,8,"dummy"
"37785",0,1,0,1,"dummy"
"37802",0,0,3,3,"dummy"
"37803",5,6,0,11,"dummy"
"37804",0,1,0,1,"dummy"
"37805",0,0,0,0,"dummy"
"37806",0,0,1,1,"dummy"
"37813",1,1,0,2,"dummy"
"37814",0,0,3,3,"dummy"
"37817",0,0,0,0,"dummy"
"37818",0,0,0,0,"dummy"
"37828",2,6,0,8,"dummy"
"37831",15,3,2,20,"dummy"
"37844",2,4,0,6,"dummy"
"37839",0,1,0,1,"dummy"
"37840",0,1,0,1,"dummy"
"37857",3,1,0,4,"dummy"
"37858",0,1,0,1,"dummy"
"37863",0,0,2,2,"dummy"
"37864",0,0,1,1,"dummy"
"37865",0,0,1,1,"dummy"
"37881",10,2,2,14,"dummy"
"37882",0,0,1,1,"dummy"
"37883",0,3,0,3,"dummy"
"37884",1,0,0,1,"dummy"
"37885",0,2,1,3,"dummy"
"37894",0,0,9,9,"dummy"
"37895",0,0,1,1,"dummy"
"37896",0,2,9,11,"dummy"
"37897",0,0,11,11,"dummy"
"37898",0,0,1,1,"dummy"
"37899",1,3,10,14,"dummy"
"37900",0,0,11,11,"dummy"
"37901",0,0,1,1,"dummy"
"37902",2,0,11,13,"dummy"
"37903",0,0,11,11,"dummy"
"37904",0,0,1,1,"dummy"
"37905",4,6,10,20,"dummy"
"37906",0,0,11,11,"dummy"
"37907",0,0,1,1,"dummy"
"37908",0,0,11,11,"dummy"
"37909",0,0,1,1,"dummy"
"37910",0,0,1,1,"dummy"
"37911",0,2,1,3,"dummy"
"37912",0,0,1,1,"dummy"
"37941",0,0,1,1,"dummy"
"37942",7,3,0,10,"dummy"
"37943",0,1,0,1,"dummy"
"37946",0,0,2,2,"dummy"
"37952",0,0,1,1,"dummy"
"37953",0,1,0,1,"dummy"
"37954",0,0,1,1,"dummy"
"37955",0,0,1,1,"dummy"
"37956",0,0,1,1,"dummy"
"37967",0,2,0,2,"dummy"
"37968",0,3,0,3,"dummy"
"37973",0,0,0,0,"dummy"
"38150",0,0,1,1,"dummy"
"38151",0,0,1,1,"dummy"
"38152",0,1,0,1,"dummy"
"38153",4,2,1,7,"dummy"
"38154",0,0,1,1,"dummy"
"38155",3,5,0,8,"dummy"
"38176",0,0,1,1,"dummy"
"38177",0,3,2,5,"dummy"
"38178",0,4,0,4,"dummy"
"38179",0,1,1,2,"dummy"
"38180",0,0,1,1,"dummy"
"38181",0,0,2,2,"dummy"
"38193",1,1,1,3,"dummy"
"38194",0,0,0,0,"dummy"
"38195",0,3,0,3,"dummy"
"38196",0,1,0,1,"dummy"
"38197",0,0,1,1,"dummy"
"38198",0,0,0,0,"dummy"
"38201",10,4,4,18,"dummy"
"38206",0,6,2,8,"dummy"
"38207",0,1,0,1,"dummy"
"38208",0,1,0,1,"dummy"
"38209",1,1,0,2,"dummy"
"38210",0,2,0,2,"dummy"
"38211",0,0,1,1,"dummy"
"38212",0,0,1,1,"dummy"
"37845",0,2,0,2,"dummy"
"37846",0,2,0,2,"dummy"
"37847",10,2,0,12,"dummy"
"37848",0,2,0,2,"dummy"
"37849",0,0,0,0,"dummy"
"37850",0,0,3,3,"dummy"
"37851",0,5,0,5,"dummy"
"37852",1,0,1,2,"dummy"
"37853",0,0,1,1,"dummy"
"37860",0,11,1,12,"dummy"
"37861",6,6,1,13,"dummy"
"37867",0,9,0,9,"dummy"
"37868",0,0,1,1,"dummy"
"37869",8,2,1,11,"dummy"
"37870",0,0,3,3,"dummy"
"37871",0,2,0,2,"dummy"
"37872",1,2,2,5,"dummy"
"37873",0,0,3,3,"dummy"
"37887",2,5,1,8,"dummy"
"37937",1,6,2,9,"dummy"
"37938",0,1,1,2,"dummy"
"37939",0,2,3,5,"dummy"
"37964",0,0,0,0,"dummy"
"37965",0,0,0,0,"dummy"
"38143",0,1,0,1,"dummy"
"38148",0,7,0,7,"dummy"
"38173",1,1,1,3,"dummy"
"38174",1,2,0,3,"dummy"
"38183",8,10,4,22,"dummy"
"38184",0,2,0,2,"dummy"
"38185",4,1,1,6,"dummy"
"38186",7,12,2,21,"dummy"
"38187",0,2,0,2,"dummy"
"38188",3,0,0,3,"dummy"
"38191",0,5,1,6,"dummy"
"38217",0,0,2,2,"dummy"
"38226",0,2,0,2,"dummy"
"38227",0,0,1,1,"dummy"
"38228",2,1,1,4,"dummy"
"38229",0,1,1,2,"dummy"
"38237",0,0,3,3,"dummy"
"38245",2,2,4,8,"dummy"
"38246",9,5,5,19,"dummy"
"38249",0,5,0,5,"dummy"
"38250",5,1,0,6,"dummy"
"38274",3,2,1,6,"dummy"
"38275",0,2,0,2,"dummy"
"38276",1,1,0,2,"dummy"
"38288",0,0,1,1,"dummy"
"38316",0,0,1,1,"dummy"
"38213",0,0,3,3,"dummy"
"38221",2,0,0,2,"dummy"
"38222",0,0,0,0,"dummy"
"38223",1,5,0,6,"dummy"
"38224",2,2,1,5,"dummy"
"38231",0,0,2,2,"dummy"
"38232",0,1,0,1,"dummy"
"38233",0,1,0,1,"dummy"
"38234",0,0,1,1,"dummy"
"38235",0,0,1,1,"dummy"
"38241",6,3,3,12,"dummy"
"38278",0,3,0,3,"dummy"
"38279",0,0,0,0,"dummy"
"38280",0,0,0,0,"dummy"
"38281",3,0,0,3,"dummy"
"38282",0,0,2,2,"dummy"
"38283",0,0,1,1,"dummy"
"38284",2,1,0,3,"dummy"
"38285",0,0,0,0,"dummy"
"38286",2,3,1,6,"dummy"
"38290",1,9,0,10,"dummy"
"38291",1,0,0,1,"dummy"
"38292",0,0,1,1,"dummy"
"38293",0,0,0,0,"dummy"
"38294",4,1,1,6,"dummy"
"38295",16,33,1,50,"dummy"
"38296",0,6,0,6,"dummy"
"38297",0,4,0,4,"dummy"
"38298",24,7,2,33,"dummy"
"38299",2,1,3,6,"dummy"
"38300",5,0,0,5,"dummy"
"38301",2,0,0,2,"dummy"
"38302",2,24,1,27,"dummy"
"38303",3,4,0,7,"dummy"
"38304",0,0,1,1,"dummy"
"38305",8,5,0,13,"dummy"
"38306",0,0,0,0,"dummy"
"38307",0,2,1,3,"dummy"
"38308",3,21,2,26,"dummy"
"38309",0,0,0,0,"dummy"
"38312",1,0,0,1,"dummy"
"38313",0,1,0,1,"dummy"
"38314",0,0,1,1,"dummy"
"38327",9,3,4,16,"dummy"
"38328",0,0,1,1,"dummy"
"38330",5,4,0,9,"dummy"
"38340",2,0,2,4,"dummy"
"38343",0,0,1,1,"dummy"
"38346",2,2,1,5,"dummy"
"38347",0,1,0,1,"dummy"
"38348",6,4,1,11,"dummy"
"38349",0,4,0,4,"dummy"
"38350",0,1,0,1,"dummy"
"38353",0,0,0,0,"dummy"
"38354",0,1,0,1,"dummy"
"38355",0,0,0,0,"dummy"
"38356",0,0,0,0,"dummy"
"38357",0,1,1,2,"dummy"
"38360",2,4,0,6,"dummy"
"38361",0,0,1,1,"dummy"
"38362",0,6,0,6,"dummy"
"38364",0,0,0,0,"dummy"
"38368",0,6,0,6,"dummy"
"38369",0,2,0,2,"dummy"
"38370",0,1,0,1,"dummy"
"38371",2,0,0,2,"dummy"
"38372",0,0,1,1,"dummy"
"38373",3,3,0,6,"dummy"
"38374",0,3,0,3,"dummy"
"38375",0,2,0,2,"dummy"
"38376",5,0,0,5,"dummy"
"38377",0,1,0,1,"dummy"
"38379",0,0,0,0,"dummy"
"38381",1,0,0,1,"dummy"
"38382",3,7,0,10,"dummy"
"38383",2,0,0,2,"dummy"
"38384",3,0,0,3,"dummy"
"38388",0,1,0,1,"dummy"
"38389",2,4,1,7,"dummy"
"38391",7,1,3,11,"dummy"
"38402",2,4,0,6,"dummy"
"38403",0,2,0,2,"dummy"
"38404",0,2,0,2,"dummy"
"38405",10,2,0,12,"dummy"
"38406",0,2,0,2,"dummy"
"38408",0,2,0,2,"dummy"
"38409",0,1,0,1,"dummy"
"38410",1,0,1,2,"dummy"
"38412",0,2,0,2,"dummy"
"38413",0,0,0,0,"dummy"
"38414",0,0,0,0,"dummy"
"38416",0,0,1,1,"dummy"
"38417",0,0,0,0,"dummy"
"38419",0,1,0,1,"dummy"
"38420",1,0,0,1,"dummy"
"38424",4,11,0,15,"dummy"
"38426",2,5,2,9,"dummy"
"38435",0,0,0,0,"dummy"
"38436",0,0,0,0,"dummy"
"38437",0,1,0,1,"dummy"
"38438",23,1,2,26,"dummy"
"38439",2,0,0,2,"dummy"
"38440",0,0,1,1,"dummy"
"38441",0,0,0,0,"dummy"
"38442",0,0,0,0,"dummy"
"38443",0,1,0,1,"dummy"
"38445",1,4,2,7,"dummy"
"38446",0,0,2,2,"dummy"
"38449",0,5,0,5,"dummy"
"38450",0,0,5,5,"dummy"
"38451",0,2,0,2,"dummy"
"38452",0,0,2,2,"dummy"
"38453",0,0,0,0,"dummy"
"38454",0,0,1,1,"dummy"
"38456",0,0,3,3,"dummy"
"38457",0,1,0,1,"dummy"
"38458",0,1,0,1,"dummy"
"38459",2,5,0,7,"dummy"
"38461",0,0,0,0,"dummy"
"38467",0,2,1,3,"dummy"
"38469",0,1,0,1,"dummy"
"38470",0,0,2,2,"dummy"
"38471",0,0,1,1,"dummy"
"38475",0,0,1,1,"dummy"
"38476",3,2,0,5,"dummy"
"38477",0,1,0,1,"dummy"
"38478",3,1,0,4,"dummy"
"38483",0,0,0,0,"dummy"
"38484",0,0,0,0,"dummy"
"38486",8,2,0,10,"dummy"
"38487",0,0,0,0,"dummy"
"38488",4,0,1,5,"dummy"
"38490",0,2,0,2,"dummy"
"38491",0,1,0,1,"dummy"
"38492",0,8,1,9,"dummy"
"38493",0,3,0,3,"dummy"
"38494",0,0,1,1,"dummy"
"38495",0,1,0,1,"dummy"
"38496",0,1,0,1,"dummy"
"38497",0,1,0,1,"dummy"
"38498",1,2,0,3,"dummy"
"38500",1,0,0,1,"dummy"
"38501",0,3,0,3,"dummy"
"38502",0,2,0,2,"dummy"
"38503",1,4,0,5,"dummy"
"38504",2,1,1,4,"dummy"
"38505",0,4,1,5,"dummy"
"38506",1,0,0,1,"dummy"
"38507",1,2,1,4,"dummy"
"38508",0,2,0,2,"dummy"
"38509",6,7,3,16,"dummy"
"38510",0,0,1,1,"dummy"
"38511",7,0,1,8,"dummy"
"38512",0,1,0,1,"dummy"
"38513",0,2,2,4,"dummy"
"38519",0,0,0,0,"dummy"
"38520",0,0,0,0,"dummy"
"38521",0,0,0,0,"dummy"
"38522",0,0,0,0,"dummy"
"38523",1,3,0,4,"dummy"
"38524",0,4,0,4,"dummy"
"38525",0,4,0,4,"dummy"
"38526",0,1,0,1,"dummy"
"38527",0,2,0,2,"dummy"
"38529",1,0,0,1,"dummy"
"38531",1,4,1,6,"dummy"
"38544",3,10,4,17,"dummy"
"38545",19,19,1,39,"dummy"
"38546",0,0,1,1,"dummy"
"38547",14,16,5,35,"dummy"
"38548",0,0,1,1,"dummy"
"38549",0,1,0,1,"dummy"
"38550",0,0,1,1,"dummy"
"38551",0,1,0,1,"dummy"
"38552",0,1,0,1,"dummy"
"38553",0,0,1,1,"dummy"
"38554",0,0,1,1,"dummy"
"38555",6,10,3,19,"dummy"
"38556",3,0,4,7,"dummy"
"38557",0,0,2,2,"dummy"
"38558",0,2,2,4,"dummy"
"38559",0,0,2,2,"dummy"
"38560",0,0,2,2,"dummy"
"38561",0,1,0,1,"dummy"
"38562",2,0,0,2,"dummy"
"38563",0,2,0,2,"dummy"
"38566",0,2,0,2,"dummy"
"38567",0,12,0,12,"dummy"
"38568",2,0,0,2,"dummy"
"38569",10,2,0,12,"dummy"
"38570",0,3,0,3,"dummy"
"38571",0,1,0,1,"dummy"
"38572",2,5,4,11,"dummy"
"38573",0,1,0,1,"dummy"
"38574",0,0,0,0,"dummy"
"38575",1,0,0,1,"dummy"
"38576",0,2,0,2,"dummy"
"38577",0,1,0,1,"dummy"
"38578",0,1,0,1,"dummy"
"38579",0,0,0,0,"dummy"
"38580",1,0,0,1,"dummy"
"38581",0,1,0,1,"dummy"
"38582",0,1,0,1,"dummy"
"38583",0,0,0,0,"dummy"
"38584",0,0,1,1,"dummy"
"38586",0,1,0,1,"dummy"
"38588",0,0,1,1,"dummy"
"38590",1,3,1,5,"dummy"
"38591",2,1,0,3,"dummy"
"38594",0,1,0,1,"dummy"
"38597",0,0,2,2,"dummy"
"38600",0,6,1,7,"dummy"
"38602",0,3,0,3,"dummy"
"38604",0,0,1,1,"dummy"
"38607",0,1,0,1,"dummy"
"38608",0,2,0,2,"dummy"
"38609",0,1,0,1,"dummy"
"38610",0,0,1,1,"dummy"
"38614",7,19,3,29,"dummy"
"38615",3,0,0,3,"dummy"
"38616",0,3,0,3,"dummy"
"38618",0,0,4,4,"dummy"
"38619",2,0,4,6,"dummy"
"38620",2,10,0,12,"dummy"
"38621",1,0,0,1,"dummy"
"38622",7,9,0,16,"dummy"
"38623",9,9,0,18,"dummy"
"38624",0,0,0,0,"dummy"
"38625",0,0,1,1,"dummy"
"38626",9,28,0,37,"dummy"
"38627",28,19,0,47,"dummy"
"38628",0,9,0,9,"dummy"
"38632",2,2,2,6,"dummy"
"38635",2,2,0,4,"dummy"
"38638",4,23,3,30,"dummy"
"38641",0,0,1,1,"dummy"
"38642",3,6,2,11,"dummy"
"38643",1,1,0,2,"dummy"
"38644",2,1,1,4,"dummy"
"38645",0,0,3,3,"dummy"
"38646",0,1,0,1,"dummy"
"38647",1,0,0,1,"dummy"
"38648",2,0,1,3,"dummy"
"38650",0,0,0,0,"dummy"
"38651",0,0,0,0,"dummy"
"38652",0,0,0,0,"dummy"
"38653",0,0,0,0,"dummy"
"38655",1,1,0,2,"dummy"
"38693",2,7,1,10,"dummy"
"38694",0,1,0,1,"dummy"
"38695",1,0,0,1,"dummy"
"38696",0,1,0,1,"dummy"
"38697",2,0,0,2,"dummy"
"38698",0,2,0,2,"dummy"
"38699",0,6,1,7,"dummy"
"38700",0,1,0,1,"dummy"
"38701",2,2,0,4,"dummy"
"38702",3,2,0,5,"dummy"
"38703",0,1,0,1,"dummy"
"38704",0,2,0,2,"dummy"
"38705",0,0,1,1,"dummy"
"38706",0,5,1,6,"dummy"
"38708",0,0,1,1,"dummy"
"38709",0,0,0,0,"dummy"
"38712",0,1,0,1,"dummy"
"38714",0,0,0,0,"dummy"
"38715",0,0,0,0,"dummy"
"38716",0,1,0,1,"dummy"
"38717",0,0,0,0,"dummy"
"38718",0,0,0,0,"dummy"
"38720",1,0,0,1,"dummy"
"38721",0,2,2,4,"dummy"
"38724",0,0,1,1,"dummy"
"38728",1,6,1,8,"dummy"
"38729",1,2,0,3,"dummy"
"38730",2,1,0,3,"dummy"
"38732",16,7,3,26,"dummy"
"38733",9,3,0,12,"dummy"
"38734",0,5,0,5,"dummy"
"38735",3,0,0,3,"dummy"
"38736",0,1,0,1,"dummy"
"38737",0,3,0,3,"dummy"
"38738",0,0,0,0,"dummy"
"38740",0,0,1,1,"dummy"
"38741",3,0,1,4,"dummy"
"38742",0,1,0,1,"dummy"
"38744",0,0,1,1,"dummy"
"38747",0,3,0,3,"dummy"
"38748",0,1,0,1,"dummy"
"38749",0,1,0,1,"dummy"
"38750",0,5,0,5,"dummy"
"38751",0,2,0,2,"dummy"
"38752",0,0,1,1,"dummy"
"38753",0,0,1,1,"dummy"
"38754",0,2,2,4,"dummy"
"38755",0,0,1,1,"dummy"
"38757",8,4,2,14,"dummy"
"38758",0,1,0,1,"dummy"
"38759",0,0,2,2,"dummy"
"38760",0,2,0,2,"dummy"
"38765",3,1,0,4,"dummy"
"38770",1,4,0,5,"dummy"
"38797",1,1,0,2,"dummy"
"38798",1,0,1,2,"dummy"
"38800",5,1,3,9,"dummy"
"38801",0,0,1,1,"dummy"
"38802",0,1,0,1,"dummy"
"38803",0,0,2,2,"dummy"
"38804",0,0,2,2,"dummy"
"38805",1,1,0,2,"dummy"
"38806",0,0,1,1,"dummy"
"38807",0,0,1,1,"dummy"
"38808",0,0,2,2,"dummy"
"38809",0,5,0,5,"dummy"
"38810",0,0,1,1,"dummy"
"38816",0,0,1,1,"dummy"
"38817",0,0,0,0,"dummy"
"38819",3,0,0,3,"dummy"
"38820",1,0,0,1,"dummy"
"38822",1,2,4,7,"dummy"
"38825",0,2,0,2,"dummy"
"38832",1,1,1,3,"dummy"
"38835",0,0,1,1,"dummy"
"38836",0,1,0,1,"dummy"
"38837",3,12,1,16,"dummy"
"38838",14,11,4,29,"dummy"
"38839",0,0,0,0,"dummy"
"38874",0,0,1,1,"dummy"
"38875",0,0,0,0,"dummy"
"38876",0,0,4,4,"dummy"
"38878",0,0,0,0,"dummy"
"38880",0,0,1,1,"dummy"
"38881",0,5,0,5,"dummy"
"38882",0,0,1,1,"dummy"
"38883",0,1,0,1,"dummy"
"38884",0,0,1,1,"dummy"
"38885",0,1,0,1,"dummy"
"38886",8,0,3,11,"dummy"
"38887",0,3,1,4,"dummy"
"38891",0,1,0,1,"dummy"
"38894",1,0,0,1,"dummy"
"38895",0,0,2,2,"dummy"
"38896",0,0,1,1,"dummy"
"38897",0,0,0,0,"dummy"
"38898",0,1,0,1,"dummy"
"38899",1,0,0,1,"dummy"
"38903",0,1,2,3,"dummy"
"38904",0,0,0,0,"dummy"
"38905",0,1,0,1,"dummy"
"38906",4,0,2,6,"dummy"
"38907",1,0,0,1,"dummy"
"38908",0,0,0,0,"dummy"
"38909",0,0,0,0,"dummy"
"38924",0,8,0,8,"dummy"
"38925",2,12,1,15,"dummy"
"38926",0,1,0,1,"dummy"
"38931",0,0,0,0,"dummy"
"38932",0,0,0,0,"dummy"
"38944",0,0,1,1,"dummy"
"38945",7,5,0,12,"dummy"
"38948",0,0,1,1,"dummy"
"38949",0,0,1,1,"dummy"
"38950",0,0,1,1,"dummy"
"38957",1,3,0,4,"dummy"
"38958",0,0,1,1,"dummy"
"38959",0,0,1,1,"dummy"
"38960",2,0,0,2,"dummy"
"38972",20,0,1,21,"dummy"
"38973",0,2,0,2,"dummy"
"38978",1,0,2,3,"dummy"
"38979",0,0,1,1,"dummy"
"38987",0,0,2,2,"dummy"
"38988",0,10,0,10,"dummy"
"38989",0,0,3,3,"dummy"
"38990",0,0,1,1,"dummy"
"38991",0,0,1,1,"dummy"
"38992",0,0,0,0,"dummy"
"38993",0,0,1,1,"dummy"
"38994",1,0,1,2,"dummy"
"38995",0,0,1,1,"dummy"
"38996",0,0,1,1,"dummy"
"38997",0,0,1,1,"dummy"
"38998",0,0,1,1,"dummy"
"38999",0,0,1,1,"dummy"
"39000",0,0,0,0,"dummy"
"39001",0,0,0,0,"dummy"
"39002",0,0,1,1,"dummy"
"39010",0,0,0,0,"dummy"
"39013",0,1,0,1,"dummy"
"39014",1,0,1,2,"dummy"
"39015",1,1,0,2,"dummy"
"39016",1,1,0,2,"dummy"
"39017",0,2,1,3,"dummy"
"39020",0,14,2,16,"dummy"
"39021",0,1,0,1,"dummy"
"39030",0,9,0,9,"dummy"
"39031",3,0,0,3,"dummy"
"39032",1,0,0,1,"dummy"
"39033",0,1,0,1,"dummy"
"39034",2,2,0,4,"dummy"
"39035",0,1,0,1,"dummy"
"39036",0,0,1,1,"dummy"
"39044",1,0,2,3,"dummy"
"39045",2,4,4,10,"dummy"
"39049",1,4,0,5,"dummy"
"39050",0,1,0,1,"dummy"
"39051",2,1,0,3,"dummy"
"39052",0,0,1,1,"dummy"
"39053",0,0,1,1,"dummy"
"39054",0,0,2,2,"dummy"
"39055",0,0,1,1,"dummy"
"39058",3,0,0,3,"dummy"
"39059",1,1,0,2,"dummy"
"39060",1,0,0,1,"dummy"
"39061",0,2,1,3,"dummy"
"39062",0,0,1,1,"dummy"
"38889",0,0,1,1,"dummy"
"38901",0,7,2,9,"dummy"
"38913",0,0,0,0,"dummy"
"38914",0,25,0,25,"dummy"
"38915",0,1,0,1,"dummy"
"38916",0,4,0,4,"dummy"
"38917",0,2,0,2,"dummy"
"38918",1,0,1,2,"dummy"
"38934",2,6,0,8,"dummy"
"38937",1,5,0,6,"dummy"
"38938",4,2,0,6,"dummy"
"38952",2,1,1,4,"dummy"
"38953",0,0,2,2,"dummy"
"38966",3,3,2,8,"dummy"
"38967",0,2,0,2,"dummy"
"38968",0,0,1,1,"dummy"
"38969",0,0,1,1,"dummy"
"38970",5,2,3,10,"dummy"
"38975",1,9,0,10,"dummy"
"38976",9,4,0,13,"dummy"
"38983",0,1,0,1,"dummy"
"38984",0,0,0,0,"dummy"
"38985",0,0,1,1,"dummy"
"39008",0,0,0,0,"dummy"
"39023",8,1,0,9,"dummy"
"39024",0,4,0,4,"dummy"
"39025",0,0,0,0,"dummy"
"39026",0,1,0,1,"dummy"
"39027",0,0,1,1,"dummy"
"39028",3,5,1,9,"dummy"
"39047",0,0,2,2,"dummy"
"39067",2,1,0,3,"dummy"
"39070",0,0,2,2,"dummy"
"39071",0,1,0,1,"dummy"
"39072",0,2,2,4,"dummy"
"39073",0,1,0,1,"dummy"
"39074",1,2,2,5,"dummy"
"39082",3,0,0,3,"dummy"
"39087",0,3,6,9,"dummy"
"39088",0,8,1,9,"dummy"
"39089",1,0,0,1,"dummy"
"39103",1,0,0,1,"dummy"
"39104",2,2,3,7,"dummy"
"39105",2,8,4,14,"dummy"
"39112",0,6,0,6,"dummy"
"39113",0,2,0,2,"dummy"
"39117",1,1,0,2,"dummy"
"39118",1,1,5,7,"dummy"
"39119",1,0,5,6,"dummy"
"39127",1,0,0,1,"dummy"
"39128",0,0,1,1,"dummy"
"39129",0,1,0,1,"dummy"
"39130",6,2,0,8,"dummy"
"39131",4,18,0,22,"dummy"
"39132",2,4,0,6,"dummy"
"39133",3,11,4,18,"dummy"
"39134",0,0,1,1,"dummy"
"39135",0,3,1,4,"dummy"
"39136",0,0,1,1,"dummy"
"39063",0,2,0,2,"dummy"
"39064",0,0,1,1,"dummy"
"39065",0,0,1,1,"dummy"
"39080",0,0,2,2,"dummy"
"39091",3,4,1,8,"dummy"
"39092",8,20,3,31,"dummy"
"39093",0,0,1,1,"dummy"
"39094",13,10,8,31,"dummy"
"39095",0,1,0,1,"dummy"
"39096",0,1,0,1,"dummy"
"39097",2,0,0,2,"dummy"
"39098",17,10,3,30,"dummy"
"39099",0,0,2,2,"dummy"
"39100",0,0,3,3,"dummy"
"39101",0,0,3,3,"dummy"
"39107",0,0,0,0,"dummy"
"39108",0,0,0,0,"dummy"
"39115",0,0,1,1,"dummy"
"39121",0,1,0,1,"dummy"
"39122",0,1,0,1,"dummy"
"39123",1,0,0,1,"dummy"
"39124",5,0,0,5,"dummy"
"39125",0,0,0,0,"dummy"
"39146",1,0,1,2,"dummy"
"39147",5,7,0,12,"dummy"
"39148",2,2,0,4,"dummy"
"39149",0,0,0,0,"dummy"
"39150",0,1,0,1,"dummy"
"39151",0,0,0,0,"dummy"
"39153",0,1,0,1,"dummy"
"39154",8,0,2,10,"dummy"
"39155",0,1,0,1,"dummy"
"39159",0,0,1,1,"dummy"
"39160",0,0,2,2,"dummy"
"39161",0,0,1,1,"dummy"
"39163",0,2,0,2,"dummy"
"39164",0,0,1,1,"dummy"
"39165",0,0,1,1,"dummy"
"39166",0,0,1,1,"dummy"
"39171",0,2,0,2,"dummy"
"39172",1,11,1,13,"dummy"
"39173",0,1,0,1,"dummy"
"39174",0,1,0,1,"dummy"
"39175",2,0,0,2,"dummy"
"39176",1,0,0,1,"dummy"
"39177",0,6,0,6,"dummy"
"39183",0,0,1,1,"dummy"
"39184",0,0,0,0,"dummy"
"39189",6,15,5,26,"dummy"
"39190",0,4,0,4,"dummy"
"39191",0,0,0,0,"dummy"
"39192",0,0,0,0,"dummy"
"39194",5,2,1,8,"dummy"
"39195",0,0,1,1,"dummy"
"39196",0,2,0,2,"dummy"
"39197",7,0,4,11,"dummy"
"39198",0,0,1,1,"dummy"
"39201",0,0,1,1,"dummy"
"39202",0,0,1,1,"dummy"
"39203",0,1,0,1,"dummy"
"39204",0,0,1,1,"dummy"
"39220",0,0,1,1,"dummy"
"39221",0,1,0,1,"dummy"
"39222",0,1,0,1,"dummy"
"39223",4,3,1,8,"dummy"
"39224",0,1,0,1,"dummy"
"39225",0,0,1,1,"dummy"
"39226",0,0,1,1,"dummy"
"39227",2,3,1,6,"dummy"
"39228",0,0,1,1,"dummy"
"39229",1,10,0,11,"dummy"
"39239",0,2,0,2,"dummy"
"39240",0,0,1,1,"dummy"
"39241",0,1,3,4,"dummy"
"39242",0,0,1,1,"dummy"
"39246",0,1,0,1,"dummy"
"39247",9,14,2,25,"dummy"
"39248",7,9,2,18,"dummy"
"39298",0,1,0,1,"dummy"
"39299",0,1,0,1,"dummy"
"39300",10,5,2,17,"dummy"
"39301",2,1,1,4,"dummy"
"39302",1,3,1,5,"dummy"
"39303",3,1,0,4,"dummy"
"39304",2,1,1,4,"dummy"
"39305",0,0,1,1,"dummy"
"39306",2,0,0,2,"dummy"
"39323",0,0,0,0,"dummy"
"39324",0,0,0,0,"dummy"
"39329",0,7,0,7,"dummy"
"39330",8,1,0,9,"dummy"
"39333",0,0,0,0,"dummy"
"39334",0,0,0,0,"dummy"
"39335",0,0,1,1,"dummy"
"39336",0,0,1,1,"dummy"
"39337",1,1,0,2,"dummy"
"39338",0,0,2,2,"dummy"
"39339",0,0,1,1,"dummy"
"39340",2,0,0,2,"dummy"
"39341",2,0,0,2,"dummy"
"39342",0,0,0,0,"dummy"
"39343",0,3,0,3,"dummy"
"39344",3,0,0,3,"dummy"
"39345",0,3,0,3,"dummy"
"39346",4,1,0,5,"dummy"
"39347",1,0,0,1,"dummy"
"39348",0,0,0,0,"dummy"
"39349",0,0,0,0,"dummy"
"39350",1,0,0,1,"dummy"
"39365",1,1,2,4,"dummy"
"39366",1,0,0,1,"dummy"
"39371",0,1,0,1,"dummy"
"39380",0,0,1,1,"dummy"
"39421",0,2,0,2,"dummy"
"39422",0,0,0,0,"dummy"
"39423",0,3,0,3,"dummy"
"39434",6,2,1,9,"dummy"
"39435",0,0,1,1,"dummy"
"39438",0,0,1,1,"dummy"
"39237",0,1,0,1,"dummy"
"39244",0,5,0,5,"dummy"
"39250",0,1,1,2,"dummy"
"39255",3,1,2,6,"dummy"
"39256",0,0,1,1,"dummy"
"39257",0,16,2,18,"dummy"
"39258",16,0,2,18,"dummy"
"39259",2,1,1,4,"dummy"
"39260",0,0,2,2,"dummy"
"39261",0,2,0,2,"dummy"
"39262",2,0,0,2,"dummy"
"39263",0,1,0,1,"dummy"
"39264",0,0,1,1,"dummy"
"39265",0,0,1,1,"dummy"
"39266",0,0,1,1,"dummy"
"39267",0,0,1,1,"dummy"
"39268",0,0,1,1,"dummy"
"39269",1,2,1,4,"dummy"
"39270",0,0,1,1,"dummy"
"39271",0,0,1,1,"dummy"
"39272",0,0,1,1,"dummy"
"39273",0,0,1,1,"dummy"
"39274",0,0,1,1,"dummy"
"39275",0,0,1,1,"dummy"
"39276",0,0,1,1,"dummy"
"39277",0,0,1,1,"dummy"
"39278",3,3,0,6,"dummy"
"39279",0,0,1,1,"dummy"
"39280",0,0,1,1,"dummy"
"39281",0,0,1,1,"dummy"
"39282",0,0,1,1,"dummy"
"39283",0,0,1,1,"dummy"
"39284",0,0,1,1,"dummy"
"39285",0,0,1,1,"dummy"
"39288",2,3,1,6,"dummy"
"39289",0,2,0,2,"dummy"
"39290",1,0,0,1,"dummy"
"39291",0,2,2,4,"dummy"
"39292",0,1,1,2,"dummy"
"39293",3,0,0,3,"dummy"
"39294",0,1,4,5,"dummy"
"39295",0,2,0,2,"dummy"
"39296",0,1,0,1,"dummy"
"39308",1,2,0,3,"dummy"
"39309",0,0,2,2,"dummy"
"39310",0,0,2,2,"dummy"
"39311",0,0,1,1,"dummy"
"39312",0,0,1,1,"dummy"
"39313",2,0,1,3,"dummy"
"39314",0,0,1,1,"dummy"
"39315",0,0,1,1,"dummy"
"39316",0,0,1,1,"dummy"
"39317",0,0,1,1,"dummy"
"39318",0,0,1,1,"dummy"
"39319",0,0,1,1,"dummy"
"39320",0,0,1,1,"dummy"
"39321",0,0,1,1,"dummy"
"39360",3,1,2,6,"dummy"
"39373",0,0,1,1,"dummy"
"39376",0,0,0,0,"dummy"
"39377",5,0,2,7,"dummy"
"39378",0,0,0,0,"dummy"
"39382",0,0,1,1,"dummy"
"39383",0,0,1,1,"dummy"
"39384",6,9,1,16,"dummy"
"39385",1,0,0,1,"dummy"
"39425",0,0,0,0,"dummy"
"39431",11,1,0,12,"dummy"
"39432",0,2,0,2,"dummy"
"39444",0,3,1,4,"dummy"
"39445",1,2,0,3,"dummy"
"39446",0,0,1,1,"dummy"
"39449",0,3,1,4,"dummy"
"39455",0,3,2,5,"dummy"
"39456",3,1,0,4,"dummy"
"39458",1,2,0,3,"dummy"
"39459",5,0,2,7,"dummy"
"39461",4,3,1,8,"dummy"
"39463",2,0,0,2,"dummy"
"39465",0,0,1,1,"dummy"
"39466",0,1,0,1,"dummy"
"39469",4,5,1,10,"dummy"
"39470",1,1,1,3,"dummy"
"39471",3,9,1,13,"dummy"
"39473",3,2,2,7,"dummy"
"39474",2,9,1,12,"dummy"
"39475",4,0,0,4,"dummy"
"39476",0,2,0,2,"dummy"
"39477",8,2,0,10,"dummy"
"39478",0,1,0,1,"dummy"
"39479",0,6,0,6,"dummy"
"39480",3,3,0,6,"dummy"
"39481",1,0,0,1,"dummy"
"39482",5,11,1,17,"dummy"
"39483",0,0,1,1,"dummy"
"39484",1,1,4,6,"dummy"
"39485",0,0,0,0,"dummy"
"39486",0,0,1,1,"dummy"
"39490",0,1,0,1,"dummy"
"39491",1,0,0,1,"dummy"
"39492",0,1,0,1,"dummy"
"39493",0,0,1,1,"dummy"
"39494",0,0,1,1,"dummy"
"39495",0,3,1,4,"dummy"
"39497",1,1,1,3,"dummy"
"39498",2,2,2,6,"dummy"
"39500",0,0,1,1,"dummy"
"39502",1,1,0,2,"dummy"
"39503",0,0,1,1,"dummy"
"39505",0,0,0,0,"dummy"
"39506",0,0,0,0,"dummy"
"39508",0,0,1,1,"dummy"
"39510",1,1,0,2,"dummy"
"39512",0,0,0,0,"dummy"
"39513",0,11,0,11,"dummy"
"39514",0,1,0,1,"dummy"
"39515",0,2,0,2,"dummy"
"39538",0,0,0,0,"dummy"
"39542",0,5,0,5,"dummy"
"39543",5,3,2,10,"dummy"
"39544",17,17,0,34,"dummy"
"39545",0,2,0,2,"dummy"
"39547",0,2,0,2,"dummy"
"39548",2,0,0,2,"dummy"
"39559",0,1,0,1,"dummy"
"39560",0,0,1,1,"dummy"
"39561",2,1,0,3,"dummy"
"39562",0,1,0,1,"dummy"
"39563",0,1,0,1,"dummy"
"39564",1,0,0,1,"dummy"
"39565",0,0,1,1,"dummy"
"39566",19,8,3,30,"dummy"
"39567",0,1,0,1,"dummy"
"39568",2,1,1,4,"dummy"
"39569",0,0,1,1,"dummy"
"39571",0,3,1,4,"dummy"
"39572",4,2,2,8,"dummy"
"39573",0,1,0,1,"dummy"
"39575",2,4,0,6,"dummy"
"39576",0,1,0,1,"dummy"
"39578",0,1,0,1,"dummy"
"39579",0,0,1,1,"dummy"
"39580",0,0,0,0,"dummy"
"39581",0,0,2,2,"dummy"
"39582",1,35,3,39,"dummy"
"39583",0,9,6,15,"dummy"
"39584",3,0,3,6,"dummy"
"39585",0,2,2,4,"dummy"
"39586",2,2,0,4,"dummy"
"39587",0,11,0,11,"dummy"
"39588",9,2,0,11,"dummy"
"39589",0,0,2,2,"dummy"
"39590",0,0,0,0,"dummy"
"39591",0,1,0,1,"dummy"
"39592",5,3,3,11,"dummy"
"39593",11,1,0,12,"dummy"
"39594",10,20,0,30,"dummy"
"39595",0,0,1,1,"dummy"
"39596",0,0,1,1,"dummy"
"39597",28,4,3,35,"dummy"
"39598",1,6,0,7,"dummy"
"39600",31,17,2,50,"dummy"
"39601",6,1,1,8,"dummy"
"39602",0,0,2,2,"dummy"
"39603",0,0,1,1,"dummy"
"39604",1,11,1,13,"dummy"
"39607",0,0,1,1,"dummy"
"39608",0,0,2,2,"dummy"
"39610",0,1,0,1,"dummy"
"39611",0,0,0,0,"dummy"
"39612",0,1,0,1,"dummy"
"39613",0,0,1,1,"dummy"
"39615",0,3,1,4,"dummy"
"39616",1,0,0,1,"dummy"
"39617",0,1,0,1,"dummy"
"39632",9,7,7,23,"dummy"
"39633",16,15,19,50,"dummy"
"39637",0,1,0,1,"dummy"
"39642",6,0,0,6,"dummy"
"39649",0,0,1,1,"dummy"
"39653",0,1,0,1,"dummy"
"39654",0,2,0,2,"dummy"
"39655",7,12,4,23,"dummy"
"39656",0,0,5,5,"dummy"
"39661",0,22,0,22,"dummy"
"39662",2,0,0,2,"dummy"
"39663",11,26,5,42,"dummy"
"39664",3,2,4,9,"dummy"
"39665",2,9,7,18,"dummy"
"39666",1,1,0,2,"dummy"
"39667",2,1,0,3,"dummy"
"39668",1,0,0,1,"dummy"
"39669",4,0,1,5,"dummy"
"39670",0,4,0,4,"dummy"
"39672",2,1,0,3,"dummy"
"39673",1,1,1,3,"dummy"
"39674",0,0,2,2,"dummy"
"39702",0,4,2,6,"dummy"
"39704",0,0,0,0,"dummy"
"39705",0,0,0,0,"dummy"
"39706",0,0,0,0,"dummy"
"39707",0,0,0,0,"dummy"
"39708",0,0,1,1,"dummy"
"39709",0,0,0,0,"dummy"
"39712",0,1,0,1,"dummy"
"39713",0,7,0,7,"dummy"
"39714",0,0,0,0,"dummy"
"39716",6,6,0,12,"dummy"
"39720",1,1,0,2,"dummy"
"39721",4,2,1,7,"dummy"
"39724",0,1,1,2,"dummy"
"39725",0,2,0,2,"dummy"
"39726",1,0,1,2,"dummy"
"39727",0,0,2,2,"dummy"
"39728",2,1,1,4,"dummy"
"39729",7,8,2,17,"dummy"
"39730",4,2,0,6,"dummy"
"39731",2,2,0,4,"dummy"
"39734",0,0,3,3,"dummy"
"39737",1,0,0,1,"dummy"
"39740",4,4,1,9,"dummy"
"39741",0,0,1,1,"dummy"
"39742",0,3,1,4,"dummy"
"39743",4,5,1,10,"dummy"
"39744",0,1,0,1,"dummy"
"39745",0,0,1,1,"dummy"
"39746",0,0,1,1,"dummy"
"39747",6,0,0,6,"dummy"
"39748",0,1,0,1,"dummy"
"39749",2,2,0,4,"dummy"
"39750",0,0,1,1,"dummy"
"39751",0,0,2,2,"dummy"
"39752",0,0,1,1,"dummy"
"39753",0,0,1,1,"dummy"
"39754",0,0,1,1,"dummy"
"39755",8,8,1,17,"dummy"
"39756",0,0,1,1,"dummy"
"39757",0,0,1,1,"dummy"
"39758",0,0,1,1,"dummy"
"39759",0,0,1,1,"dummy"
"39760",0,0,1,1,"dummy"
"39765",0,0,0,0,"dummy"
"39766",0,0,0,0,"dummy"
"39767",3,3,0,6,"dummy"
"39769",1,1,0,2,"dummy"
"39770",9,22,3,34,"dummy"
"39771",5,0,3,8,"dummy"
"39772",0,0,2,2,"dummy"
"39773",0,4,0,4,"dummy"
"39775",2,6,0,8,"dummy"
"39776",3,1,0,4,"dummy"
"39778",0,0,2,2,"dummy"
"39780",0,0,0,0,"dummy"
"39781",1,3,1,5,"dummy"
"39782",0,0,0,0,"dummy"
"39784",0,0,1,1,"dummy"
"39786",1,2,1,4,"dummy"
"39787",2,1,0,3,"dummy"
"39788",0,2,1,3,"dummy"
"39792",0,0,1,1,"dummy"
"39794",0,1,2,3,"dummy"
"39795",0,2,0,2,"dummy"
"39799",0,1,1,2,"dummy"
"39800",0,0,0,0,"dummy"
"39802",0,3,1,4,"dummy"
"39804",0,1,0,1,"dummy"
"39805",1,11,2,14,"dummy"
"39812",0,0,0,0,"dummy"
"39814",0,0,2,2,"dummy"
"39815",0,0,1,1,"dummy"
"39816",0,0,1,1,"dummy"
"39819",0,3,2,5,"dummy"
"39821",0,0,1,1,"dummy"
"39822",0,0,0,0,"dummy"
"39825",0,0,1,1,"dummy"
"39826",0,2,0,2,"dummy"
"39827",0,2,1,3,"dummy"
"39828",12,0,0,12,"dummy"
"39829",0,0,0,0,"dummy"
"39830",0,0,3,3,"dummy"
"39831",0,0,1,1,"dummy"
"39832",2,0,0,2,"dummy"
"39833",0,1,1,2,"dummy"
"39834",2,0,0,2,"dummy"
"39835",0,0,0,0,"dummy"
"39837",4,2,1,7,"dummy"
"39839",1,2,0,3,"dummy"
"39840",0,0,1,1,"dummy"
"39842",0,0,1,1,"dummy"
"39843",0,2,0,2,"dummy"
"39845",0,1,0,1,"dummy"
"39846",0,6,1,7,"dummy"
"39847",0,0,0,0,"dummy"
"39848",1,0,0,1,"dummy"
"39849",0,1,0,1,"dummy"
"39850",1,1,3,5,"dummy"
"39851",0,1,2,3,"dummy"
"39854",8,0,0,8,"dummy"
"39855",0,1,0,1,"dummy"
"39856",7,1,0,8,"dummy"
"39857",1,4,0,5,"dummy"
"39858",0,0,0,0,"dummy"
"39859",0,0,0,0,"dummy"
"39860",0,0,1,1,"dummy"
"39861",0,1,0,1,"dummy"
"39862",0,0,1,1,"dummy"
"39863",0,0,0,0,"dummy"
"39867",7,18,2,27,"dummy"
"39869",0,1,2,3,"dummy"
"39870",0,0,1,1,"dummy"
"39872",0,0,1,1,"dummy"
"39876",0,1,0,1,"dummy"
"39878",0,0,2,2,"dummy"
"39880",0,0,1,1,"dummy"
"39881",0,1,0,1,"dummy"
"39887",0,6,2,8,"dummy"
"39888",0,3,1,4,"dummy"
"39889",0,0,4,4,"dummy"
"39890",0,1,0,1,"dummy"
"39891",0,3,1,4,"dummy"
"39892",0,0,1,1,"dummy"
"39893",0,0,1,1,"dummy"
"39894",0,0,1,1,"dummy"
"39908",0,0,3,3,"dummy"
"39909",1,0,1,2,"dummy"
"39910",0,1,0,1,"dummy"
"39911",3,3,1,7,"dummy"
"39912",0,1,0,1,"dummy"
"39914",0,0,1,1,"dummy"
"39915",0,0,0,0,"dummy"
"39916",0,1,0,1,"dummy"
"39917",1,2,0,3,"dummy"
"39918",0,1,0,1,"dummy"
"39919",1,10,1,12,"dummy"
"39920",1,1,0,2,"dummy"
"39921",0,1,0,1,"dummy"
"39922",7,2,0,9,"dummy"
"39923",0,1,0,1,"dummy"
"39924",0,0,1,1,"dummy"
"39925",0,0,2,2,"dummy"
"39926",0,0,1,1,"dummy"
"39928",2,2,1,5,"dummy"
"39929",4,1,6,11,"dummy"
"39931",0,0,0,0,"dummy"
"39932",0,2,0,2,"dummy"
"39933",0,0,2,2,"dummy"
"39934",0,0,2,2,"dummy"
"39946",0,0,1,1,"dummy"
"39947",0,0,0,0,"dummy"
"39948",0,0,0,0,"dummy"
"39949",3,0,0,3,"dummy"
"39950",1,0,0,1,"dummy"
"39951",2,4,0,6,"dummy"
"39952",0,0,0,0,"dummy"
"39953",0,0,0,0,"dummy"
"39954",0,0,0,0,"dummy"
"39955",0,1,0,1,"dummy"
"39957",1,5,1,7,"dummy"
"39960",0,0,0,0,"dummy"
"39961",0,0,3,3,"dummy"
"39962",0,0,1,1,"dummy"
"39964",0,0,1,1,"dummy"
"39967",0,1,0,1,"dummy"
"39969",0,0,1,1,"dummy"
"39970",0,2,0,2,"dummy"
"39971",0,1,0,1,"dummy"
"39972",1,0,0,1,"dummy"
"39973",0,1,0,1,"dummy"
"39974",0,4,1,5,"dummy"
"39975",0,1,0,1,"dummy"
"39976",0,1,0,1,"dummy"
"39980",0,0,1,1,"dummy"
"39981",0,0,0,0,"dummy"
"39986",0,0,1,1,"dummy"
"39987",0,2,1,3,"dummy"
"39988",0,1,0,1,"dummy"
"39992",0,1,0,1,"dummy"
"39993",1,0,0,1,"dummy"
"39994",0,1,0,1,"dummy"
"39996",0,1,0,1,"dummy"
"40000",0,1,0,1,"dummy"
"40001",0,0,1,1,"dummy"
"40002",0,0,1,1,"dummy"
"40004",0,2,0,2,"dummy"
"40005",3,6,4,13,"dummy"
"40006",0,2,0,2,"dummy"
"40007",2,5,5,12,"dummy"
"40008",0,1,0,1,"dummy"
"40009",1,3,0,4,"dummy"
"40013",0,1,0,1,"dummy"
"40014",0,1,0,1,"dummy"
"40018",10,29,1,40,"dummy"
"40019",0,0,1,1,"dummy"
"40024",0,0,0,0,"dummy"
"40047",1,5,1,7,"dummy"
"40048",0,4,0,4,"dummy"
"40049",0,1,1,2,"dummy"
"40057",1,1,2,4,"dummy"
"40058",0,0,4,4,"dummy"
"40059",0,1,0,1,"dummy"
"40065",2,2,0,4,"dummy"
"40066",30,6,0,36,"dummy"
"40067",2,0,0,2,"dummy"
"40090",0,1,0,1,"dummy"
"40091",0,0,1,1,"dummy"
"40095",6,10,2,18,"dummy"
"40096",1,2,4,7,"dummy"
"40097",2,2,0,4,"dummy"
"40098",1,2,1,4,"dummy"
"40099",0,0,2,2,"dummy"
"40100",0,0,0,0,"dummy"
"40101",0,0,1,1,"dummy"
"40102",0,4,0,4,"dummy"
"40103",0,3,1,4,"dummy"
"40122",0,1,0,1,"dummy"
"40123",0,1,0,1,"dummy"
"40124",0,1,0,1,"dummy"
"40125",0,0,1,1,"dummy"
"40126",0,0,1,1,"dummy"
"40127",3,1,1,5,"dummy"
"40128",0,0,1,1,"dummy"
"40131",0,0,1,1,"dummy"
"40132",0,1,0,1,"dummy"
"40133",0,0,1,1,"dummy"
"40136",6,6,2,14,"dummy"
"40204",0,0,0,0,"dummy"
"40205",4,11,2,17,"dummy"
"40206",0,0,0,0,"dummy"
"40207",10,2,1,13,"dummy"
"40208",2,1,0,3,"dummy"
"40209",3,6,2,11,"dummy"
"40210",0,0,0,0,"dummy"
"40211",5,0,0,5,"dummy"
"40212",0,1,0,1,"dummy"
"40213",1,0,0,1,"dummy"
"40214",1,10,0,11,"dummy"
"40215",0,0,0,0,"dummy"
"40224",0,0,1,1,"dummy"
"40227",1,0,0,1,"dummy"
"40231",0,0,0,0,"dummy"
"40234",2,2,0,4,"dummy"
"40237",0,0,1,1,"dummy"
"40238",9,1,1,11,"dummy"
"40242",0,0,1,1,"dummy"
"40243",0,0,0,0,"dummy"
"40246",0,0,4,4,"dummy"
"40247",0,3,0,3,"dummy"
"40251",0,0,1,1,"dummy"
"40252",0,0,1,1,"dummy"
"40253",2,0,0,2,"dummy"
"40274",0,0,1,1,"dummy"
"40275",3,3,0,6,"dummy"
"40276",0,0,1,1,"dummy"
"40277",0,0,0,0,"dummy"
"40284",0,2,0,2,"dummy"
"40299",0,0,1,1,"dummy"
"40300",2,1,6,9,"dummy"
"40301",2,2,0,4,"dummy"
"40305",0,0,0,0,"dummy"
"40306",0,0,0,0,"dummy"
"40307",0,0,1,1,"dummy"
"40308",0,0,0,0,"dummy"
"40071",2,3,0,5,"dummy"
"40074",1,5,2,8,"dummy"
"40075",10,4,1,15,"dummy"
"40076",0,5,0,5,"dummy"
"40077",0,1,0,1,"dummy"
"40080",0,0,1,1,"dummy"
"40081",0,2,0,2,"dummy"
"40082",0,2,0,2,"dummy"
"40083",0,0,1,1,"dummy"
"40084",0,0,2,2,"dummy"
"40085",2,0,0,2,"dummy"
"40086",5,6,1,12,"dummy"
"40093",4,23,0,27,"dummy"
"40105",0,0,1,1,"dummy"
"40106",0,0,1,1,"dummy"
"40109",0,1,1,2,"dummy"
"40138",0,0,1,1,"dummy"
"40152",0,0,0,0,"dummy"
"40155",1,1,0,2,"dummy"
"40156",0,0,1,1,"dummy"
"40161",0,0,1,1,"dummy"
"40162",7,7,1,15,"dummy"
"40163",2,2,0,4,"dummy"
"40164",0,0,1,1,"dummy"
"40178",0,1,0,1,"dummy"
"40179",1,3,0,4,"dummy"
"40180",0,0,1,1,"dummy"
"40183",0,1,0,1,"dummy"
"40184",0,1,1,2,"dummy"
"40185",0,1,0,1,"dummy"
"40186",0,1,0,1,"dummy"
"40187",1,0,0,1,"dummy"
"40188",0,0,1,1,"dummy"
"40189",0,0,1,1,"dummy"
"40190",0,0,1,1,"dummy"
"40191",1,1,0,2,"dummy"
"40192",0,0,1,1,"dummy"
"40193",0,2,0,2,"dummy"
"40194",0,1,0,1,"dummy"
"40195",0,0,0,0,"dummy"
"40196",0,1,0,1,"dummy"
"40197",0,1,1,2,"dummy"
"40198",1,0,1,2,"dummy"
"40199",0,2,1,3,"dummy"
"40200",2,0,1,3,"dummy"
"40201",0,2,1,3,"dummy"
"40202",4,4,0,8,"dummy"
"40217",2,9,0,11,"dummy"
"40220",0,0,0,0,"dummy"
"40221",1,0,0,1,"dummy"
"40222",3,6,0,9,"dummy"
"40229",0,1,0,1,"dummy"
"40240",0,1,0,1,"dummy"
"40249",0,2,0,2,"dummy"
"40257",31,18,5,54,"dummy"
"40258",0,2,0,2,"dummy"
"40259",4,4,1,9,"dummy"
"40260",0,0,1,1,"dummy"
"40261",2,2,0,4,"dummy"
"40262",2,1,0,3,"dummy"
"40263",0,5,0,5,"dummy"
"40264",0,1,0,1,"dummy"
"40265",0,2,0,2,"dummy"
"40266",10,2,0,12,"dummy"
"40267",1,5,1,7,"dummy"
"40268",2,1,0,3,"dummy"
"40269",0,3,0,3,"dummy"
"40270",2,5,0,7,"dummy"
"40271",5,3,1,9,"dummy"
"40272",1,1,1,3,"dummy"
"40281",0,1,0,1,"dummy"
"40282",0,1,0,1,"dummy"
"40303",0,3,0,3,"dummy"
"40312",24,11,0,35,"dummy"
"40313",1,0,0,1,"dummy"
"40314",0,2,0,2,"dummy"
"40324",7,0,2,9,"dummy"
"40325",1,3,0,4,"dummy"
"40352",2,6,0,8,"dummy"
"40353",1,2,0,3,"dummy"
"40367",0,1,0,1,"dummy"
"40368",1,0,0,1,"dummy"
"40369",0,10,4,14,"dummy"
"40381",0,1,0,1,"dummy"
"40382",0,1,1,2,"dummy"
"40383",0,0,1,1,"dummy"
"40384",0,0,3,3,"dummy"
"40385",0,0,1,1,"dummy"
"40434",1,14,1,16,"dummy"
"40435",0,0,0,0,"dummy"
"40436",0,1,0,1,"dummy"
"40437",0,0,1,1,"dummy"
"40448",0,12,0,12,"dummy"
"40457",0,0,1,1,"dummy"
"40468",0,0,1,1,"dummy"
"40469",0,1,0,1,"dummy"
"40470",1,5,2,8,"dummy"
"40471",0,0,2,2,"dummy"
"40476",3,3,3,9,"dummy"
"40481",36,57,6,99,"dummy"
"40482",0,0,3,3,"dummy"
"40483",1,6,1,8,"dummy"
"40521",0,2,2,4,"dummy"
"40522",0,1,0,1,"dummy"
"40523",2,3,1,6,"dummy"
"40545",0,0,0,0,"dummy"
"40546",23,2,3,28,"dummy"
"40547",2,5,1,8,"dummy"
"40548",5,2,1,8,"dummy"
"40549",0,1,0,1,"dummy"
"40550",0,0,0,0,"dummy"
"40551",0,1,0,1,"dummy"
"40552",3,7,1,11,"dummy"
"40553",8,0,1,9,"dummy"
"40554",0,8,1,9,"dummy"
"40555",8,0,1,9,"dummy"
"40558",2,1,1,4,"dummy"
"40559",0,0,0,0,"dummy"
"40612",0,1,0,1,"dummy"
"40613",0,0,1,1,"dummy"
"40614",0,6,0,6,"dummy"
"40617",0,0,1,1,"dummy"
"40630",0,0,1,1,"dummy"
"40309",0,0,1,1,"dummy"
"40310",0,0,0,0,"dummy"
"40316",0,0,0,0,"dummy"
"40317",0,0,0,0,"dummy"
"40322",0,1,0,1,"dummy"
"40327",0,0,1,1,"dummy"
"40347",0,0,3,3,"dummy"
"40348",1,0,1,2,"dummy"
"40349",0,0,1,1,"dummy"
"40350",1,3,1,5,"dummy"
"40357",0,1,1,2,"dummy"
"40358",0,0,1,1,"dummy"
"40359",0,0,1,1,"dummy"
"40360",0,0,1,1,"dummy"
"40363",0,0,0,0,"dummy"
"40373",1,0,0,1,"dummy"
"40374",0,0,1,1,"dummy"
"40375",1,1,0,2,"dummy"
"40376",0,1,0,1,"dummy"
"40377",0,0,0,0,"dummy"
"40378",0,0,1,1,"dummy"
"40379",0,0,2,2,"dummy"
"40389",0,3,4,7,"dummy"
"40390",2,2,1,5,"dummy"
"40391",0,3,0,3,"dummy"
"40392",2,7,1,10,"dummy"
"40393",0,0,1,1,"dummy"
"40394",0,1,0,1,"dummy"
"40395",2,1,0,3,"dummy"
"40396",0,1,0,1,"dummy"
"40397",0,2,0,2,"dummy"
"40398",0,0,5,5,"dummy"
"40399",0,0,1,1,"dummy"
"40400",1,6,4,11,"dummy"
"40403",0,8,0,8,"dummy"
"40404",8,0,0,8,"dummy"
"40407",0,0,1,1,"dummy"
"40408",0,0,1,1,"dummy"
"40409",0,0,0,0,"dummy"
"40410",0,0,1,1,"dummy"
"40413",0,1,2,3,"dummy"
"40414",0,0,0,0,"dummy"
"40415",0,2,0,2,"dummy"
"40416",5,0,2,7,"dummy"
"40417",1,0,0,1,"dummy"
"40422",1,1,2,4,"dummy"
"40423",1,1,0,2,"dummy"
"40424",1,2,0,3,"dummy"
"40425",1,1,1,3,"dummy"
"40426",1,0,1,2,"dummy"
"40439",0,1,1,2,"dummy"
"40442",0,8,0,8,"dummy"
"40443",0,0,1,1,"dummy"
"40444",2,3,4,9,"dummy"
"40450",5,2,1,8,"dummy"
"40451",16,12,4,32,"dummy"
"40452",3,0,2,5,"dummy"
"40453",0,0,1,1,"dummy"
"40459",0,0,1,1,"dummy"
"40460",1,1,0,2,"dummy"
"40461",3,4,0,7,"dummy"
"40462",0,2,0,2,"dummy"
"40463",0,8,2,10,"dummy"
"40464",0,0,1,1,"dummy"
"40465",0,3,1,4,"dummy"
"40466",0,0,1,1,"dummy"
"40478",1,0,4,5,"dummy"
"40479",0,0,4,4,"dummy"
"40485",0,0,1,1,"dummy"
"40486",12,1,0,13,"dummy"
"40487",1,11,0,12,"dummy"
"40488",1,0,1,2,"dummy"
"40489",9,2,1,12,"dummy"
"40490",0,0,2,2,"dummy"
"40491",0,2,0,2,"dummy"
"40492",0,0,1,1,"dummy"
"40493",0,0,1,1,"dummy"
"40494",3,20,1,24,"dummy"
"40495",0,16,0,16,"dummy"
"40496",3,3,0,6,"dummy"
"40497",3,1,0,4,"dummy"
"40498",0,0,0,0,"dummy"
"40499",0,0,0,0,"dummy"
"40500",0,0,1,1,"dummy"
"40501",0,0,0,0,"dummy"
"40502",1,16,0,17,"dummy"
"40503",2,0,0,2,"dummy"
"40504",2,1,1,4,"dummy"
"40505",0,0,0,0,"dummy"
"40506",0,2,0,2,"dummy"
"40507",0,1,0,1,"dummy"
"40508",0,2,0,2,"dummy"
"40509",0,0,1,1,"dummy"
"40510",0,0,1,1,"dummy"
"40511",0,0,0,0,"dummy"
"40512",9,5,0,14,"dummy"
"40513",0,1,1,2,"dummy"
"40514",28,21,8,57,"dummy"
"40515",0,0,0,0,"dummy"
"40516",0,1,0,1,"dummy"
"40519",1,0,2,3,"dummy"
"40525",0,27,1,28,"dummy"
"40526",16,18,2,36,"dummy"
"40527",0,3,0,3,"dummy"
"40528",2,1,1,4,"dummy"
"40529",0,0,1,1,"dummy"
"40530",1,1,1,3,"dummy"
"40531",0,2,0,2,"dummy"
"40532",1,1,0,2,"dummy"
"40533",0,6,1,7,"dummy"
"40534",0,8,0,8,"dummy"
"40535",41,0,3,44,"dummy"
"40536",0,2,1,3,"dummy"
"40537",0,1,0,1,"dummy"
"40538",0,0,1,1,"dummy"
"40539",1,1,0,2,"dummy"
"40540",0,3,0,3,"dummy"
"40541",0,1,1,2,"dummy"
"40542",0,0,1,1,"dummy"
"40543",3,0,0,3,"dummy"
"40563",6,3,4,13,"dummy"
"40564",1,0,0,1,"dummy"
"40565",10,2,0,12,"dummy"
"40566",0,0,0,0,"dummy"
"40567",0,0,0,0,"dummy"
"40568",0,0,0,0,"dummy"
"40569",0,0,0,0,"dummy"
"40570",0,0,0,0,"dummy"
"40571",0,0,0,0,"dummy"
"40572",0,0,0,0,"dummy"
"40573",0,0,1,1,"dummy"
"40574",0,0,0,0,"dummy"
"40575",0,0,0,0,"dummy"
"40576",0,1,0,1,"dummy"
"40577",0,0,0,0,"dummy"
"40578",0,5,0,5,"dummy"
"40579",4,8,2,14,"dummy"
"40580",0,0,1,1,"dummy"
"40581",0,0,1,1,"dummy"
"40582",0,2,0,2,"dummy"
"40583",0,0,0,0,"dummy"
"40584",9,0,1,10,"dummy"
"40585",1,6,0,7,"dummy"
"40619",3,0,0,3,"dummy"
"40620",0,0,0,0,"dummy"
"40621",0,2,0,2,"dummy"
"40622",1,0,0,1,"dummy"
"40623",0,0,2,2,"dummy"
"40624",0,0,1,1,"dummy"
"40625",0,2,0,2,"dummy"
"40626",4,2,3,9,"dummy"
"40634",0,1,0,1,"dummy"
"40635",0,1,0,1,"dummy"
"40636",0,1,1,2,"dummy"
"40637",1,0,0,1,"dummy"
"40647",0,3,0,3,"dummy"
"40648",0,2,0,2,"dummy"
"40663",1,3,0,4,"dummy"
"40666",30,2,2,34,"dummy"
"40667",1,2,1,4,"dummy"
"40668",0,1,0,1,"dummy"
"40669",1,0,0,1,"dummy"
"40677",0,1,0,1,"dummy"
"40678",0,7,1,8,"dummy"
"40680",0,0,0,0,"dummy"
"40681",0,0,0,0,"dummy"
"40690",2,0,3,5,"dummy"
"40691",1,0,0,1,"dummy"
"40692",0,1,0,1,"dummy"
"40693",0,1,1,2,"dummy"
"40695",1,2,0,3,"dummy"
"40697",0,4,1,5,"dummy"
"40698",1,0,0,1,"dummy"
"40699",0,1,1,2,"dummy"
"40702",0,0,1,1,"dummy"
"40703",0,1,0,1,"dummy"
"40706",0,3,0,3,"dummy"
"40707",0,1,0,1,"dummy"
"40708",0,1,0,1,"dummy"
"40709",0,8,0,8,"dummy"
"40712",11,3,0,14,"dummy"
"40713",21,23,4,48,"dummy"
"40714",2,0,0,2,"dummy"
"40715",0,0,1,1,"dummy"
"40716",0,6,0,6,"dummy"
"40719",0,4,1,5,"dummy"
"40720",1,1,1,3,"dummy"
"40721",2,0,0,2,"dummy"
"40722",0,0,0,0,"dummy"
"40723",0,0,0,0,"dummy"
"40724",0,1,0,1,"dummy"
"40725",0,1,0,1,"dummy"
"40726",0,0,0,0,"dummy"
"40728",1,0,1,2,"dummy"
"40730",1,4,1,6,"dummy"
"40733",2,13,1,16,"dummy"
"40738",0,1,1,2,"dummy"
"40739",0,1,0,1,"dummy"
"40741",0,1,1,2,"dummy"
"40742",0,1,0,1,"dummy"
"40743",6,2,0,8,"dummy"
"40744",1,0,0,1,"dummy"
"40745",7,12,2,21,"dummy"
"40746",3,4,0,7,"dummy"
"40747",0,1,0,1,"dummy"
"40748",5,3,0,8,"dummy"
"40758",54,9,3,66,"dummy"
"40759",0,0,1,1,"dummy"
"40762",5,1,1,7,"dummy"
"40764",1,0,0,1,"dummy"
"40765",0,1,0,1,"dummy"
"40767",0,0,1,1,"dummy"
"40768",0,0,1,1,"dummy"
"40798",0,0,1,1,"dummy"
"40799",0,1,0,1,"dummy"
"40803",4,0,1,5,"dummy"
"40804",0,2,0,2,"dummy"
"40805",0,0,1,1,"dummy"
"40807",2,4,1,7,"dummy"
"40855",0,0,1,1,"dummy"
"40857",0,0,1,1,"dummy"
"40858",0,1,1,2,"dummy"
"40859",0,0,2,2,"dummy"
"40866",2,5,0,7,"dummy"
"40867",5,0,0,5,"dummy"
"40868",1,8,0,9,"dummy"
"40869",2,2,0,4,"dummy"
"40870",0,0,0,0,"dummy"
"40871",8,4,0,12,"dummy"
"40872",3,8,0,11,"dummy"
"40873",1,1,0,2,"dummy"
"40874",1,1,0,2,"dummy"
"40875",0,2,0,2,"dummy"
"40876",2,0,0,2,"dummy"
"40881",1,2,0,3,"dummy"
"40882",0,0,1,1,"dummy"
"40883",0,1,2,3,"dummy"
"40884",0,0,1,1,"dummy"
"40885",1,0,2,3,"dummy"
"40905",0,0,1,1,"dummy"
"40906",0,0,1,1,"dummy"
"40907",0,0,1,1,"dummy"
"40908",0,0,1,1,"dummy"
"40912",0,0,1,1,"dummy"
"40929",0,2,0,2,"dummy"
"40930",2,1,0,3,"dummy"
"40935",0,0,1,1,"dummy"
"40936",0,0,1,1,"dummy"
"40939",0,0,1,1,"dummy"
"40940",0,0,0,0,"dummy"
"40978",1,1,0,2,"dummy"
"40979",0,4,3,7,"dummy"
"40980",3,2,1,6,"dummy"
"40981",1,0,0,1,"dummy"
"40982",0,1,0,1,"dummy"
"40983",0,0,0,0,"dummy"
"40984",0,0,0,0,"dummy"
"40985",0,0,0,0,"dummy"
"40986",2,2,1,5,"dummy"
"40987",0,1,0,1,"dummy"
"40993",6,2,0,8,"dummy"
"40994",0,0,1,1,"dummy"
"40995",0,2,0,2,"dummy"
"41019",0,1,1,2,"dummy"
"41020",0,0,0,0,"dummy"
"41033",0,0,1,1,"dummy"
"41034",0,0,0,0,"dummy"
"41037",0,0,0,0,"dummy"
"41060",0,4,0,4,"dummy"
"41061",0,0,0,0,"dummy"
"41062",1,2,0,3,"dummy"
"41063",0,0,0,0,"dummy"
"41064",2,2,0,4,"dummy"
"41065",0,0,0,0,"dummy"
"41066",0,0,0,0,"dummy"
"41067",0,0,0,0,"dummy"
"41068",0,0,0,0,"dummy"
"41069",0,0,0,0,"dummy"
"41070",0,1,0,1,"dummy"
"41071",0,1,0,1,"dummy"
"41072",0,1,0,1,"dummy"
"41073",0,3,0,3,"dummy"
"41074",2,1,0,3,"dummy"
"41075",0,0,0,0,"dummy"
"41076",3,3,3,9,"dummy"
"41077",0,0,1,1,"dummy"
"41078",0,1,1,2,"dummy"
"41079",0,0,0,0,"dummy"
"41080",4,23,4,31,"dummy"
"41081",0,0,1,1,"dummy"
"41082",20,5,6,31,"dummy"
"41083",1,0,0,1,"dummy"
"41084",0,3,0,3,"dummy"
"41085",7,24,4,35,"dummy"
"41088",0,3,0,3,"dummy"
"41089",0,0,0,0,"dummy"
"41090",0,0,3,3,"dummy"
"41091",0,0,0,0,"dummy"
"41092",1,0,4,5,"dummy"
"41093",0,0,0,0,"dummy"
"41094",0,0,1,1,"dummy"
"41095",0,0,1,1,"dummy"
"41096",0,0,1,1,"dummy"
"41097",0,0,1,1,"dummy"
"40901",0,0,2,2,"dummy"
"40902",0,0,2,2,"dummy"
"40903",0,0,1,1,"dummy"
"40910",0,0,1,1,"dummy"
"40925",0,0,2,2,"dummy"
"40942",4,1,1,6,"dummy"
"40943",0,4,0,4,"dummy"
"40970",0,0,5,5,"dummy"
"40973",0,2,1,3,"dummy"
"40974",0,3,0,3,"dummy"
"40991",0,0,3,3,"dummy"
"40997",2,4,1,7,"dummy"
"40998",0,0,1,1,"dummy"
"40999",0,1,0,1,"dummy"
"41000",2,4,0,6,"dummy"
"41001",0,0,2,2,"dummy"
"41002",2,3,1,6,"dummy"
"41003",25,36,1,62,"dummy"
"41004",1,3,0,4,"dummy"
"41005",6,39,0,45,"dummy"
"41006",2,18,3,23,"dummy"
"41007",62,5,0,67,"dummy"
"41008",8,1,1,10,"dummy"
"41009",0,0,1,1,"dummy"
"41010",0,2,1,3,"dummy"
"41011",0,0,0,0,"dummy"
"41012",5,2,1,8,"dummy"
"41013",1,0,0,1,"dummy"
"41014",0,1,0,1,"dummy"
"41015",0,0,0,0,"dummy"
"41024",1,0,0,1,"dummy"
"41025",1,0,0,1,"dummy"
"41026",0,1,0,1,"dummy"
"41027",0,1,1,2,"dummy"
"41028",0,1,0,1,"dummy"
"41029",0,1,0,1,"dummy"
"41030",0,0,1,1,"dummy"
"41031",0,0,1,1,"dummy"
"41039",6,3,0,9,"dummy"
"41040",2,1,0,3,"dummy"
"41041",0,0,1,1,"dummy"
"41042",0,0,2,2,"dummy"
"41043",0,0,2,2,"dummy"
"41044",3,1,3,7,"dummy"
"41045",0,0,1,1,"dummy"
"41046",0,1,0,1,"dummy"
"41047",0,1,0,1,"dummy"
"41048",0,1,2,3,"dummy"
"41049",0,0,1,1,"dummy"
"41056",0,0,1,1,"dummy"
"41115",3,7,1,11,"dummy"
"41116",0,0,1,1,"dummy"
"41117",2,0,1,3,"dummy"
"41118",0,0,1,1,"dummy"
"41119",0,1,0,1,"dummy"
"41120",0,0,1,1,"dummy"
"41121",1,0,0,1,"dummy"
"41126",0,1,0,1,"dummy"
"41127",0,1,0,1,"dummy"
"41187",11,5,1,17,"dummy"
"41212",2,2,0,4,"dummy"
"41213",4,0,1,5,"dummy"
"41214",0,4,1,5,"dummy"
"41215",4,0,0,4,"dummy"
"41216",0,0,0,0,"dummy"
"41217",5,10,0,15,"dummy"
"41218",0,0,1,1,"dummy"
"41219",0,1,1,2,"dummy"
"41100",0,0,1,1,"dummy"
"41101",3,1,0,4,"dummy"
"41102",0,0,1,1,"dummy"
"41112",6,0,0,6,"dummy"
"41113",2,5,2,9,"dummy"
"41129",0,0,1,1,"dummy"
"41130",2,0,0,2,"dummy"
"41131",3,9,5,17,"dummy"
"41132",7,0,1,8,"dummy"
"41133",1,3,0,4,"dummy"
"41134",2,3,0,5,"dummy"
"41135",0,0,1,1,"dummy"
"41136",0,3,1,4,"dummy"
"41137",3,0,2,5,"dummy"
"41138",1,2,0,3,"dummy"
"41139",0,4,1,5,"dummy"
"41140",0,0,1,1,"dummy"
"41141",9,1,2,12,"dummy"
"41142",0,2,0,2,"dummy"
"41143",0,2,0,2,"dummy"
"41144",0,2,0,2,"dummy"
"41145",0,4,0,4,"dummy"
"41146",2,0,0,2,"dummy"
"41147",0,0,2,2,"dummy"
"41148",0,2,0,2,"dummy"
"41149",0,0,1,1,"dummy"
"41150",0,11,0,11,"dummy"
"41151",0,1,0,1,"dummy"
"41152",11,0,0,11,"dummy"
"41153",0,10,0,10,"dummy"
"41154",0,1,0,1,"dummy"
"41155",1,0,0,1,"dummy"
"41156",0,0,1,1,"dummy"
"41157",0,0,1,1,"dummy"
"41158",0,0,1,1,"dummy"
"41159",0,5,0,5,"dummy"
"41160",0,1,0,1,"dummy"
"41161",6,13,1,20,"dummy"
"41162",0,2,0,2,"dummy"
"41163",4,8,0,12,"dummy"
"41164",23,8,2,33,"dummy"
"41165",0,1,0,1,"dummy"
"41166",1,4,0,5,"dummy"
"41167",4,1,0,5,"dummy"
"41168",1,4,0,5,"dummy"
"41169",0,0,1,1,"dummy"
"41170",0,1,0,1,"dummy"
"41171",0,1,0,1,"dummy"
"41172",0,0,0,0,"dummy"
"41173",0,1,1,2,"dummy"
"41174",0,0,1,1,"dummy"
"41175",0,0,1,1,"dummy"
"41176",0,0,1,1,"dummy"
"41177",0,0,1,1,"dummy"
"41178",0,0,1,1,"dummy"
"41179",1,0,1,2,"dummy"
"41180",0,4,0,4,"dummy"
"41181",0,0,0,0,"dummy"
"41182",0,0,2,2,"dummy"
"41183",0,1,0,1,"dummy"
"41184",0,0,0,0,"dummy"
"41185",0,2,0,2,"dummy"
"41243",0,9,0,9,"dummy"
"41244",9,0,0,9,"dummy"
"41256",0,1,1,2,"dummy"
"41257",2,1,1,4,"dummy"
"41266",0,0,1,1,"dummy"
"41273",0,4,0,4,"dummy"
"41274",1,1,1,3,"dummy"
"41275",0,0,2,2,"dummy"
"41276",0,0,2,2,"dummy"
"41277",0,0,1,1,"dummy"
"41278",0,0,1,1,"dummy"
"41220",0,0,1,1,"dummy"
"41221",0,0,1,1,"dummy"
"41222",0,0,1,1,"dummy"
"41223",0,0,1,1,"dummy"
"41224",11,4,4,19,"dummy"
"41225",4,2,2,8,"dummy"
"41226",2,0,0,2,"dummy"
"41227",0,5,3,8,"dummy"
"41228",6,5,4,15,"dummy"
"41238",1,0,0,1,"dummy"
"41239",0,0,1,1,"dummy"
"41240",0,0,1,1,"dummy"
"41241",0,1,0,1,"dummy"
"41246",2,0,1,3,"dummy"
"41247",0,0,0,0,"dummy"
"41248",0,1,0,1,"dummy"
"41249",8,1,0,9,"dummy"
"41250",0,0,0,0,"dummy"
"41251",0,0,0,0,"dummy"
"41252",1,10,0,11,"dummy"
"41253",7,1,0,8,"dummy"
"41254",2,0,3,5,"dummy"
"41259",9,37,3,49,"dummy"
"41264",1,3,0,4,"dummy"
"41285",0,3,2,5,"dummy"
"41349",1,2,2,5,"dummy"
"41363",0,18,0,18,"dummy"
"41364",0,1,0,1,"dummy"
"41365",3,9,0,12,"dummy"
"41366",3,5,0,8,"dummy"
"41367",2,0,0,2,"dummy"
"41368",9,1,0,10,"dummy"
"41369",15,0,0,15,"dummy"
"41370",0,25,0,25,"dummy"
"41371",0,3,0,3,"dummy"
"41385",0,0,0,0,"dummy"
"41386",0,0,0,0,"dummy"
"41387",0,0,0,0,"dummy"
"41388",0,0,0,0,"dummy"
"41389",0,0,0,0,"dummy"
"41390",0,0,0,0,"dummy"
"41394",0,0,2,2,"dummy"
"41403",0,1,2,3,"dummy"
"41404",0,0,0,0,"dummy"
"41405",0,8,0,8,"dummy"
"41406",1,1,0,2,"dummy"
"41407",0,1,0,1,"dummy"
"41408",0,1,1,2,"dummy"
"41409",2,2,0,4,"dummy"
"41410",0,1,0,1,"dummy"
"41411",2,0,1,3,"dummy"
"41412",0,0,0,0,"dummy"
"41427",2,3,1,6,"dummy"
"41428",2,2,0,4,"dummy"
"41431",0,0,1,1,"dummy"
"41432",0,0,1,1,"dummy"
"41433",0,0,2,2,"dummy"
"41434",0,0,1,1,"dummy"
"41435",0,0,1,1,"dummy"
"41436",0,1,1,2,"dummy"
"41446",1,3,0,4,"dummy"
"41451",7,1,2,10,"dummy"
"41452",0,0,0,0,"dummy"
"41457",1,0,0,1,"dummy"
"41458",1,2,0,3,"dummy"
"41279",12,0,0,12,"dummy"
"41280",2,0,0,2,"dummy"
"41281",0,3,0,3,"dummy"
"41287",0,0,0,0,"dummy"
"41290",0,7,1,8,"dummy"
"41291",2,5,0,7,"dummy"
"41295",0,0,1,1,"dummy"
"41296",0,1,0,1,"dummy"
"41297",0,4,1,5,"dummy"
"41302",0,0,2,2,"dummy"
"41303",0,1,1,2,"dummy"
"41306",0,0,1,1,"dummy"
"41307",0,2,0,2,"dummy"
"41308",0,3,0,3,"dummy"
"41311",6,1,2,9,"dummy"
"41312",19,0,2,21,"dummy"
"41313",0,19,2,21,"dummy"
"41314",0,0,1,1,"dummy"
"41315",1,0,0,1,"dummy"
"41316",0,3,0,3,"dummy"
"41317",0,0,1,1,"dummy"
"41318",0,0,1,1,"dummy"
"41319",2,0,0,2,"dummy"
"41320",0,0,1,1,"dummy"
"41331",0,0,1,1,"dummy"
"41347",0,2,0,2,"dummy"
"41360",0,2,0,2,"dummy"
"41361",0,0,0,0,"dummy"
"41373",0,1,1,2,"dummy"
"41374",0,0,2,2,"dummy"
"41375",0,1,0,1,"dummy"
"41376",0,1,0,1,"dummy"
"41377",0,1,0,1,"dummy"
"41378",0,1,0,1,"dummy"
"41381",1,5,1,7,"dummy"
"41382",0,2,2,4,"dummy"
"41383",4,0,2,6,"dummy"
"41392",1,2,0,3,"dummy"
"41396",3,9,0,12,"dummy"
"41397",1,1,0,2,"dummy"
"41398",27,4,3,34,"dummy"
"41401",0,1,0,1,"dummy"
"41416",0,0,1,1,"dummy"
"41417",0,0,0,0,"dummy"
"41438",0,0,0,0,"dummy"
"41439",5,1,2,8,"dummy"
"41440",0,0,1,1,"dummy"
"41441",0,0,1,1,"dummy"
"41442",0,8,2,10,"dummy"
"41494",2,0,1,3,"dummy"
"41495",8,0,0,8,"dummy"
"41498",0,0,0,0,"dummy"
"41501",2,2,1,5,"dummy"
"41502",5,10,0,15,"dummy"
"41503",2,5,3,10,"dummy"
"41504",0,1,3,4,"dummy"
"41505",0,5,0,5,"dummy"
"41506",2,5,0,7,"dummy"
"41509",0,0,2,2,"dummy"
"41510",0,1,0,1,"dummy"
"41511",0,1,0,1,"dummy"
"41459",0,0,2,2,"dummy"
"41460",2,2,0,4,"dummy"
"41480",2,14,1,17,"dummy"
"41481",0,1,0,1,"dummy"
"41482",0,0,1,1,"dummy"
"41483",0,0,1,1,"dummy"
"41484",0,0,1,1,"dummy"
"41485",0,0,1,1,"dummy"
"41486",0,0,1,1,"dummy"
"41487",0,1,0,1,"dummy"
"41488",1,2,2,5,"dummy"
"41489",1,0,0,1,"dummy"
"41490",2,1,3,6,"dummy"
"41491",8,2,2,12,"dummy"
"41492",0,0,1,1,"dummy"
"41516",0,1,0,1,"dummy"
"41523",1,1,0,2,"dummy"
"41524",0,8,0,8,"dummy"
"41525",0,2,0,2,"dummy"
"41526",1,0,0,1,"dummy"
"41527",3,1,0,4,"dummy"
"41528",0,1,0,1,"dummy"
"41529",0,3,0,3,"dummy"
"41530",2,2,0,4,"dummy"
"41531",4,0,0,4,"dummy"
"41532",8,9,5,22,"dummy"
"41533",0,2,0,2,"dummy"
"41534",0,3,1,4,"dummy"
"41535",2,4,0,6,"dummy"
"41536",4,17,4,25,"dummy"
"41537",3,4,3,10,"dummy"
"41538",4,5,0,9,"dummy"
"41539",0,2,0,2,"dummy"
"41540",2,1,0,3,"dummy"
"41541",2,2,0,4,"dummy"
"41542",0,4,1,5,"dummy"
"41543",0,2,0,2,"dummy"
"41546",0,0,0,0,"dummy"
"41547",0,0,3,3,"dummy"
"41550",2,2,1,5,"dummy"
"41551",1,1,1,3,"dummy"
"41552",0,0,1,1,"dummy"
"41553",1,1,1,3,"dummy"
"41554",3,4,1,8,"dummy"
"41555",0,0,1,1,"dummy"
"41556",0,0,1,1,"dummy"
"41557",1,0,1,2,"dummy"
"41558",9,4,1,14,"dummy"
"41559",0,0,0,0,"dummy"
"41567",0,1,0,1,"dummy"
"41568",0,0,2,2,"dummy"
"41572",0,0,1,1,"dummy"
"41573",0,0,0,0,"dummy"
"41574",0,1,0,1,"dummy"
"41595",0,2,0,2,"dummy"
"41626",0,0,2,2,"dummy"
"41627",0,0,2,2,"dummy"
"41628",0,0,2,2,"dummy"
"41629",0,0,2,2,"dummy"
"41632",1,0,0,1,"dummy"
"41633",0,0,1,1,"dummy"
"41634",0,0,2,2,"dummy"
"41661",0,0,0,0,"dummy"
"41512",0,1,0,1,"dummy"
"41513",0,1,0,1,"dummy"
"41514",0,0,1,1,"dummy"
"41518",0,3,3,6,"dummy"
"41519",4,2,4,10,"dummy"
"41563",1,0,0,1,"dummy"
"41570",0,0,0,0,"dummy"
"41622",0,0,1,1,"dummy"
"41623",0,0,1,1,"dummy"
"41624",0,2,0,2,"dummy"
"41636",0,1,0,1,"dummy"
"41637",0,2,0,2,"dummy"
"41638",2,0,0,2,"dummy"
"41641",0,0,1,1,"dummy"
"41642",0,0,1,1,"dummy"
"41643",0,3,0,3,"dummy"
"41644",0,1,3,4,"dummy"
"41645",8,8,0,16,"dummy"
"41646",5,0,1,6,"dummy"
"41647",1,0,0,1,"dummy"
"41650",0,1,0,1,"dummy"
"41651",1,6,1,8,"dummy"
"41652",2,2,0,4,"dummy"
"41657",0,0,1,1,"dummy"
"41675",0,0,4,4,"dummy"
"41679",0,0,1,1,"dummy"
"41704",0,3,0,3,"dummy"
"41705",0,0,0,0,"dummy"
"41727",1,3,0,4,"dummy"
"41728",0,1,1,2,"dummy"
"41729",2,1,0,3,"dummy"
"41730",2,1,1,4,"dummy"
"41731",0,0,1,1,"dummy"
"41744",0,0,3,3,"dummy"
"41751",0,1,3,4,"dummy"
"41778",5,11,0,16,"dummy"
"41779",8,3,1,12,"dummy"
"41780",0,0,2,2,"dummy"
"41781",0,2,0,2,"dummy"
"41782",0,2,0,2,"dummy"
"41783",0,0,1,1,"dummy"
"41784",2,4,1,7,"dummy"
"41785",8,2,6,16,"dummy"
"41786",1,0,2,3,"dummy"
"41794",0,2,0,2,"dummy"
"41795",0,2,0,2,"dummy"
"41804",5,7,0,12,"dummy"
"41805",1,0,0,1,"dummy"
"41806",1,1,0,2,"dummy"
"41807",0,1,0,1,"dummy"
"41808",1,2,0,3,"dummy"
"41809",0,0,1,1,"dummy"
"41812",0,0,1,1,"dummy"
"41815",1,3,0,4,"dummy"
"41662",0,0,0,0,"dummy"
"41669",0,0,1,1,"dummy"
"41670",11,7,2,20,"dummy"
"41673",3,4,1,8,"dummy"
"41677",0,0,1,1,"dummy"
"41685",1,0,2,3,"dummy"
"41686",1,0,0,1,"dummy"
"41687",4,2,1,7,"dummy"
"41688",0,1,0,1,"dummy"
"41689",0,0,0,0,"dummy"
"41696",0,0,0,0,"dummy"
"41697",0,0,1,1,"dummy"
"41700",0,0,1,1,"dummy"
"41701",0,2,0,2,"dummy"
"41702",0,4,2,6,"dummy"
"41707",0,0,0,0,"dummy"
"41708",0,1,0,1,"dummy"
"41709",0,2,0,2,"dummy"
"41710",0,0,1,1,"dummy"
"41711",0,0,2,2,"dummy"
"41712",0,0,1,1,"dummy"
"41715",0,0,1,1,"dummy"
"41716",0,0,0,0,"dummy"
"41733",2,0,0,2,"dummy"
"41734",0,0,1,1,"dummy"
"41735",0,0,1,1,"dummy"
"41736",0,0,1,1,"dummy"
"41737",0,0,1,1,"dummy"
"41738",0,0,1,1,"dummy"
"41739",0,0,1,1,"dummy"
"41740",0,0,1,1,"dummy"
"41741",0,0,1,1,"dummy"
"41742",0,0,1,1,"dummy"
"41746",0,2,0,2,"dummy"
"41747",0,0,1,1,"dummy"
"41748",1,2,1,4,"dummy"
"41749",1,2,2,5,"dummy"
"41753",0,2,0,2,"dummy"
"41756",2,4,0,6,"dummy"
"41757",0,2,0,2,"dummy"
"41758",0,2,0,2,"dummy"
"41759",10,2,0,12,"dummy"
"41760",0,2,0,2,"dummy"
"41763",0,2,0,2,"dummy"
"41764",1,0,0,1,"dummy"
"41765",1,0,0,1,"dummy"
"41766",0,0,1,1,"dummy"
"41767",0,2,0,2,"dummy"
"41768",1,3,0,4,"dummy"
"41769",0,4,0,4,"dummy"
"41770",0,1,0,1,"dummy"
"41771",0,0,0,0,"dummy"
"41772",7,0,1,8,"dummy"
"41773",10,1,2,13,"dummy"
"41776",0,0,2,2,"dummy"
"41790",0,0,1,1,"dummy"
"41791",0,1,0,1,"dummy"
"41792",0,0,1,1,"dummy"
"41829",0,6,0,6,"dummy"
"41830",0,2,0,2,"dummy"
"41831",0,1,2,3,"dummy"
"41832",0,0,0,0,"dummy"
"41833",0,4,0,4,"dummy"
"41834",0,2,0,2,"dummy"
"41835",0,2,0,2,"dummy"
"41836",4,3,1,8,"dummy"
"41837",3,3,0,6,"dummy"
"41838",0,1,1,2,"dummy"
"41839",1,1,4,6,"dummy"
"41840",1,1,0,2,"dummy"
"41841",0,1,0,1,"dummy"
"41842",6,4,0,10,"dummy"
"41843",0,1,0,1,"dummy"
"41844",0,0,0,0,"dummy"
"41845",0,1,1,2,"dummy"
"41846",1,0,0,1,"dummy"
"41847",3,3,0,6,"dummy"
"41848",0,1,0,1,"dummy"
"41849",0,2,0,2,"dummy"
"41850",0,0,0,0,"dummy"
"41851",0,4,0,4,"dummy"
"41852",1,3,0,4,"dummy"
"41853",0,1,0,1,"dummy"
"41854",0,1,2,3,"dummy"
"41855",0,1,0,1,"dummy"
"41856",0,1,1,2,"dummy"
"41857",0,2,0,2,"dummy"
"41858",0,4,0,4,"dummy"
"41859",0,7,0,7,"dummy"
"41860",0,1,0,1,"dummy"
"41861",0,0,1,1,"dummy"
"41862",0,1,0,1,"dummy"
"41863",0,1,0,1,"dummy"
"41864",7,7,0,14,"dummy"
"41865",7,7,0,14,"dummy"
"41866",1,1,0,2,"dummy"
"41869",0,0,0,0,"dummy"
"41870",0,2,0,2,"dummy"
"41871",1,1,0,2,"dummy"
"41872",0,0,0,0,"dummy"
"41873",0,0,0,0,"dummy"
"41874",0,2,0,2,"dummy"
"41877",0,0,2,2,"dummy"
"41878",0,0,6,6,"dummy"
"41891",5,8,0,13,"dummy"
"41893",0,2,0,2,"dummy"
"41896",1,0,3,4,"dummy"
"41897",4,2,3,9,"dummy"
"41898",0,0,0,0,"dummy"
"41900",0,0,2,2,"dummy"
"41902",0,1,0,1,"dummy"
"41904",2,0,3,5,"dummy"
"41905",1,0,0,1,"dummy"
"41906",0,1,0,1,"dummy"
"41907",0,1,1,2,"dummy"
"41912",0,0,0,0,"dummy"
"41913",0,0,0,0,"dummy"
"41914",0,0,0,0,"dummy"
"41916",0,1,0,1,"dummy"
"41918",0,0,0,0,"dummy"
"41920",0,7,0,7,"dummy"
"41921",0,0,0,0,"dummy"
"41922",1,0,0,1,"dummy"
"41923",0,1,0,1,"dummy"
"41925",0,2,0,2,"dummy"
"41926",1,1,0,2,"dummy"
"41929",0,1,0,1,"dummy"
"41931",0,0,0,0,"dummy"
"41933",0,0,2,2,"dummy"
"41934",0,1,2,3,"dummy"
"41935",0,0,1,1,"dummy"
"41936",0,0,1,1,"dummy"
"41937",0,0,1,1,"dummy"
"41938",0,0,1,1,"dummy"
"41939",0,0,1,1,"dummy"
"41940",0,0,1,1,"dummy"
"41943",0,43,1,44,"dummy"
"41944",5,7,0,12,"dummy"
"41945",3,4,5,12,"dummy"
"41946",0,1,0,1,"dummy"
"41947",0,0,1,1,"dummy"
"41948",14,2,3,19,"dummy"
"41949",0,0,0,0,"dummy"
"41950",1,0,1,2,"dummy"
"41951",0,0,1,1,"dummy"
"41952",2,0,0,2,"dummy"
"41953",6,0,0,6,"dummy"
"41954",0,0,1,1,"dummy"
"41955",2,2,1,5,"dummy"
"41956",8,27,1,36,"dummy"
"41957",1,0,0,1,"dummy"
"41958",1,0,2,3,"dummy"
"41960",0,0,0,0,"dummy"
"41970",2,10,4,16,"dummy"
"41971",0,5,0,5,"dummy"
"41972",13,3,0,16,"dummy"
"41984",0,0,1,1,"dummy"
"41985",0,1,0,1,"dummy"
"41986",0,0,1,1,"dummy"
"41988",2,4,3,9,"dummy"
"41989",0,0,1,1,"dummy"
"41991",4,4,1,9,"dummy"
"41992",0,0,1,1,"dummy"
"41993",0,2,1,3,"dummy"
"41994",2,3,2,7,"dummy"
"41995",8,10,2,20,"dummy"
"41996",0,0,0,0,"dummy"
"41997",0,0,1,1,"dummy"
"41998",0,0,1,1,"dummy"
"41999",14,5,0,19,"dummy"
"42000",0,1,0,1,"dummy"
"42001",0,0,0,0,"dummy"
"42002",2,2,0,4,"dummy"
"42003",0,0,1,1,"dummy"
"42004",0,0,1,1,"dummy"
"42005",0,0,1,1,"dummy"
"42006",0,0,2,2,"dummy"
"42007",2,1,0,3,"dummy"
"42008",0,0,1,1,"dummy"
"42009",0,0,1,1,"dummy"
"42010",0,0,1,1,"dummy"
"42011",0,0,1,1,"dummy"
"42012",0,0,1,1,"dummy"
"42013",3,7,0,10,"dummy"
"42014",0,0,1,1,"dummy"
"42015",5,5,0,10,"dummy"
"42016",1,0,0,1,"dummy"
"42017",0,1,0,1,"dummy"
"42018",10,10,1,21,"dummy"
"42019",0,0,1,1,"dummy"
"42020",0,0,1,1,"dummy"
"42028",1,0,0,1,"dummy"
"42029",2,0,0,2,"dummy"
"42030",1,0,0,1,"dummy"
"42031",0,1,0,1,"dummy"
"42032",1,0,0,1,"dummy"
"42033",0,1,1,2,"dummy"
"42034",0,1,0,1,"dummy"
"42035",0,1,0,1,"dummy"
"42036",0,1,0,1,"dummy"
"42037",3,2,1,6,"dummy"
"42038",7,0,0,7,"dummy"
"42039",0,0,0,0,"dummy"
"42040",0,7,0,7,"dummy"
"42041",2,1,1,4,"dummy"
"42042",0,0,0,0,"dummy"
"42043",0,1,0,1,"dummy"
"42044",0,1,0,1,"dummy"
"42045",0,0,1,1,"dummy"
"42046",0,2,0,2,"dummy"
"42047",0,4,0,4,"dummy"
"42048",0,0,3,3,"dummy"
"42049",0,0,1,1,"dummy"
"42050",0,1,0,1,"dummy"
"42051",0,0,1,1,"dummy"
"42052",0,16,1,17,"dummy"
"42053",0,0,2,2,"dummy"
"42054",2,4,0,6,"dummy"
"42055",0,0,1,1,"dummy"
"42056",0,0,3,3,"dummy"
"42057",4,2,1,7,"dummy"
"42058",2,0,0,2,"dummy"
"42064",2,0,1,3,"dummy"
"42066",0,1,1,2,"dummy"
"42068",2,4,1,7,"dummy"
"42069",4,4,4,12,"dummy"
"42075",0,1,1,2,"dummy"
"42076",1,2,1,4,"dummy"
"42077",1,2,0,3,"dummy"
"42078",1,1,0,2,"dummy"
"42079",0,1,0,1,"dummy"
"42080",0,2,0,2,"dummy"
"42081",0,0,1,1,"dummy"
"42082",0,0,2,2,"dummy"
"42083",0,2,0,2,"dummy"
"42084",10,0,0,10,"dummy"
"42085",1,0,0,1,"dummy"
"42089",0,1,0,1,"dummy"
"42090",0,1,0,1,"dummy"
"42091",0,3,0,3,"dummy"
"42092",0,4,0,4,"dummy"
"42093",4,7,5,16,"dummy"
"42095",0,0,1,1,"dummy"
"42096",0,1,0,1,"dummy"
"42097",0,1,0,1,"dummy"
"42098",2,10,0,12,"dummy"
"42099",0,1,0,1,"dummy"
"42100",2,4,0,6,"dummy"
"42102",0,1,0,1,"dummy"
"42103",1,1,0,2,"dummy"
"42104",0,1,0,1,"dummy"
"42105",0,0,0,0,"dummy"
"42106",0,1,0,1,"dummy"
"42107",0,0,2,2,"dummy"
"42108",0,0,1,1,"dummy"
"42158",0,9,3,12,"dummy"
"42159",0,1,1,2,"dummy"
"42160",0,5,0,5,"dummy"
"42161",0,0,0,0,"dummy"
"42162",27,5,0,32,"dummy"
"42164",0,0,1,1,"dummy"
"42168",0,1,0,1,"dummy"
"42169",0,1,0,1,"dummy"
"42170",0,2,1,3,"dummy"
"42171",2,0,0,2,"dummy"
"42172",1,0,0,1,"dummy"
"42173",0,4,0,4,"dummy"
"42174",3,0,0,3,"dummy"
"42175",1,0,0,1,"dummy"
"42177",0,2,0,2,"dummy"
"42178",0,1,0,1,"dummy"
"42179",0,0,1,1,"dummy"
"42180",0,1,0,1,"dummy"
"42181",0,1,0,1,"dummy"
"42187",1,2,1,4,"dummy"
"42189",20,10,7,37,"dummy"
"42191",0,1,0,1,"dummy"
"42197",0,0,0,0,"dummy"
"42200",0,2,0,2,"dummy"
"42201",1,1,0,2,"dummy"
"42202",0,0,0,0,"dummy"
"42204",46,10,4,60,"dummy"
"42205",5,5,0,10,"dummy"
"42206",10,11,1,22,"dummy"
"42207",14,22,3,39,"dummy"
"42208",0,1,0,1,"dummy"
"42209",11,5,2,18,"dummy"
"42210",24,9,4,37,"dummy"
"42211",0,2,1,3,"dummy"
"42212",1,9,0,10,"dummy"
"42213",0,2,1,3,"dummy"
"42214",1,11,1,13,"dummy"
"42215",25,18,0,43,"dummy"
"42217",0,0,1,1,"dummy"
"42218",1,4,0,5,"dummy"
"42219",0,0,1,1,"dummy"
"42220",1,0,0,1,"dummy"
"42221",10,5,2,17,"dummy"
"42222",2,0,0,2,"dummy"
"42223",0,0,1,1,"dummy"
"42224",3,6,0,9,"dummy"
"42228",0,0,1,1,"dummy"
"42230",4,10,2,16,"dummy"
"42231",4,1,1,6,"dummy"
"42232",0,0,1,1,"dummy"
"42233",0,1,0,1,"dummy"
"42235",0,0,0,0,"dummy"
"42236",4,4,0,8,"dummy"
"42237",0,0,1,1,"dummy"
"42238",0,1,0,1,"dummy"
"42241",0,0,3,3,"dummy"
"42247",0,2,0,2,"dummy"
"42249",0,0,1,1,"dummy"
"42251",1,2,0,3,"dummy"
"42252",1,0,0,1,"dummy"
"42274",0,1,0,1,"dummy"
"42275",0,0,2,2,"dummy"
"42276",0,1,3,4,"dummy"
"42278",0,0,1,1,"dummy"
"42284",0,0,3,3,"dummy"
"42285",0,1,1,2,"dummy"
"42286",0,0,1,1,"dummy"
"42287",0,0,1,1,"dummy"
"42288",0,0,1,1,"dummy"
"42290",4,4,5,13,"dummy"
"42291",0,1,0,1,"dummy"
"42304",1,0,0,1,"dummy"
"42305",0,0,1,1,"dummy"
"42308",3,12,1,16,"dummy"
"42310",0,0,1,1,"dummy"
"42318",8,0,1,9,"dummy"
"42320",0,0,1,1,"dummy"
"42321",0,0,1,1,"dummy"
"42322",0,0,1,1,"dummy"
"42325",0,0,1,1,"dummy"
"42326",0,1,0,1,"dummy"
"42327",1,0,0,1,"dummy"
"42328",0,2,1,3,"dummy"
"42329",0,8,0,8,"dummy"
"42330",6,0,0,6,"dummy"
"42331",1,1,0,2,"dummy"
"42334",2,0,3,5,"dummy"
"42338",0,0,1,1,"dummy"
"42339",0,2,0,2,"dummy"
"42340",0,0,1,1,"dummy"
"42341",0,0,1,1,"dummy"
"42342",0,0,1,1,"dummy"
"42343",0,0,2,2,"dummy"
"42344",2,2,0,4,"dummy"
"42346",1,1,0,2,"dummy"
"42352",0,0,2,2,"dummy"
"42353",0,0,1,1,"dummy"
"42354",0,0,2,2,"dummy"
"42355",0,2,0,2,"dummy"
"42357",0,0,1,1,"dummy"
"42365",11,0,2,13,"dummy"
"42367",1,2,0,3,"dummy"
"42368",1,0,0,1,"dummy"
"42369",0,1,0,1,"dummy"
"42370",0,4,0,4,"dummy"
"42371",0,1,0,1,"dummy"
"42372",0,0,3,3,"dummy"
"42373",1,2,0,3,"dummy"
"42374",0,2,0,2,"dummy"
"42375",0,1,0,1,"dummy"
"42376",0,3,0,3,"dummy"
"42377",1,1,0,2,"dummy"
"42378",0,1,0,1,"dummy"
"42379",0,1,0,1,"dummy"
"42380",0,0,1,1,"dummy"
"42381",0,1,0,1,"dummy"
"42382",4,2,0,6,"dummy"
"42388",0,16,0,16,"dummy"
"42389",0,1,1,2,"dummy"
"42390",1,4,6,11,"dummy"
"42391",0,0,3,3,"dummy"
"42393",0,4,0,4,"dummy"
"42396",1,0,0,1,"dummy"
"42399",0,6,0,6,"dummy"
"42400",0,0,1,1,"dummy"
"42402",1,0,1,2,"dummy"
"42403",2,1,0,3,"dummy"
"42405",0,1,1,2,"dummy"
"42413",0,7,1,8,"dummy"
"42414",13,5,0,18,"dummy"
"42415",6,10,4,20,"dummy"
"42416",16,21,2,39,"dummy"
"42417",1,0,0,1,"dummy"
"42418",0,1,0,1,"dummy"
"42419",0,0,1,1,"dummy"
"42420",0,0,1,1,"dummy"
"42421",0,0,1,1,"dummy"
"42422",0,0,1,1,"dummy"
"42423",0,0,1,1,"dummy"
"42424",0,0,2,2,"dummy"
"42425",0,0,1,1,"dummy"
"42426",0,0,1,1,"dummy"
"42427",19,2,3,24,"dummy"
"42429",1,2,0,3,"dummy"
"42431",0,0,0,0,"dummy"
"42432",0,0,1,1,"dummy"
"42433",0,0,0,0,"dummy"
"42434",3,2,5,10,"dummy"
"42440",10,26,3,39,"dummy"
"42444",0,0,2,2,"dummy"
"42447",0,1,2,3,"dummy"
"42448",1,1,0,2,"dummy"
"42450",5,0,5,10,"dummy"
"42451",3,4,2,9,"dummy"
"42452",0,0,1,1,"dummy"
"42453",5,0,0,5,"dummy"
"42454",0,0,1,1,"dummy"
"42457",1,3,1,5,"dummy"
"42459",1,5,1,7,"dummy"
"42469",1,0,0,1,"dummy"
"42470",0,1,0,1,"dummy"
"42479",8,8,0,16,"dummy"
"42480",2,1,3,6,"dummy"
"42481",0,2,0,2,"dummy"
"42482",0,0,2,2,"dummy"
"42483",7,39,3,49,"dummy"
"42484",0,5,0,5,"dummy"
"42493",0,1,0,1,"dummy"
"42494",0,4,0,4,"dummy"
"42495",0,1,0,1,"dummy"
"42523",1,0,2,3,"dummy"
"42530",0,6,0,6,"dummy"
"42531",3,3,1,7,"dummy"
"42532",2,4,0,6,"dummy"
"42533",0,3,1,4,"dummy"
"42534",2,0,0,2,"dummy"
"42539",0,0,1,1,"dummy"
"42540",0,0,1,1,"dummy"
"42545",0,1,0,1,"dummy"
"42548",0,1,0,1,"dummy"
"42549",2,1,0,3,"dummy"
"42554",0,1,1,2,"dummy"
"42555",2,3,2,7,"dummy"
"42560",0,3,0,3,"dummy"
"42569",0,0,1,1,"dummy"
"42570",0,0,1,1,"dummy"
"42571",0,0,1,1,"dummy"
"42572",1,4,0,5,"dummy"
"42573",3,4,0,7,"dummy"
"42574",2,4,0,6,"dummy"
"42575",0,1,0,1,"dummy"
"42576",0,1,0,1,"dummy"
"42577",0,1,0,1,"dummy"
"42578",9,3,0,12,"dummy"
"42580",6,17,1,24,"dummy"
"42581",9,8,0,17,"dummy"
"42583",1,1,1,3,"dummy"
"42591",0,0,1,1,"dummy"
"42592",1,0,0,1,"dummy"
"42593",2,0,0,2,"dummy"
"42594",0,0,1,1,"dummy"
"42597",0,0,4,4,"dummy"
"42599",0,1,0,1,"dummy"
"42600",1,1,0,2,"dummy"
"42601",0,1,0,1,"dummy"
"42602",1,1,0,2,"dummy"
"42603",0,2,0,2,"dummy"
"42604",0,0,1,1,"dummy"
"42605",0,0,0,0,"dummy"
"42606",1,1,0,2,"dummy"
"42607",2,0,0,2,"dummy"
"42608",0,1,0,1,"dummy"
"42609",5,4,0,9,"dummy"
"42610",0,0,1,1,"dummy"
"42611",0,0,1,1,"dummy"
"42618",1,0,1,2,"dummy"
"42623",0,1,0,1,"dummy"
"42624",0,0,1,1,"dummy"
"42625",0,0,1,1,"dummy"
"42626",0,0,1,1,"dummy"
"42627",1,0,0,1,"dummy"
"42629",0,0,0,0,"dummy"
"42630",0,0,0,0,"dummy"
"42634",0,2,0,2,"dummy"
"42636",0,0,0,0,"dummy"
"42638",0,2,3,5,"dummy"
"42639",0,0,0,0,"dummy"
"42640",1,7,0,8,"dummy"
"42641",0,2,3,5,"dummy"
"42642",8,3,1,12,"dummy"
"42643",0,2,1,3,"dummy"
"42644",1,0,1,2,"dummy"
"42645",0,0,1,1,"dummy"
"42647",0,12,0,12,"dummy"
"42648",2,5,0,7,"dummy"
"42649",0,8,0,8,"dummy"
"42650",0,1,0,1,"dummy"
"42652",0,4,1,5,"dummy"
"42653",0,0,1,1,"dummy"
"42658",0,0,0,0,"dummy"
"42659",2,5,0,7,"dummy"
"42660",2,2,0,4,"dummy"
"42661",0,1,0,1,"dummy"
"42662",0,1,0,1,"dummy"
"42663",0,0,1,1,"dummy"
"42664",0,1,0,1,"dummy"
"42665",5,6,3,14,"dummy"
"42666",2,0,6,8,"dummy"
"42667",1,0,0,1,"dummy"
"42668",4,0,0,4,"dummy"
"42669",2,0,0,2,"dummy"
"42670",0,0,0,0,"dummy"
"42671",24,20,1,45,"dummy"
"42672",0,2,3,5,"dummy"
"42673",0,1,0,1,"dummy"
"42677",0,0,0,0,"dummy"
"42678",0,1,0,1,"dummy"
"42679",1,0,0,1,"dummy"
"42680",0,4,0,4,"dummy"
"42681",0,1,0,1,"dummy"
"42682",0,1,0,1,"dummy"
"42683",0,1,0,1,"dummy"
"42684",0,0,0,0,"dummy"
"42685",4,0,2,6,"dummy"
"42686",0,0,1,1,"dummy"
"42687",0,0,1,1,"dummy"
"42689",0,2,3,5,"dummy"
"42690",0,0,0,0,"dummy"
"42691",0,1,2,3,"dummy"
"42692",0,1,0,1,"dummy"
"42693",0,0,1,1,"dummy"
"42694",2,2,0,4,"dummy"
"42697",2,2,0,4,"dummy"
"42698",0,1,0,1,"dummy"
"42701",0,1,0,1,"dummy"
"42702",0,2,0,2,"dummy"
"42704",2,0,0,2,"dummy"
"42705",0,0,0,0,"dummy"
"42707",0,2,1,3,"dummy"
"42708",0,0,1,1,"dummy"
"42710",0,0,0,0,"dummy"
"42712",2,4,0,6,"dummy"
"42713",0,1,1,2,"dummy"
"42714",4,6,0,10,"dummy"
"42715",2,2,0,4,"dummy"
"42716",0,0,0,0,"dummy"
"42720",2,2,3,7,"dummy"
"42723",0,1,0,1,"dummy"
"42724",2,0,0,2,"dummy"
"42725",0,2,0,2,"dummy"
"42732",8,12,2,22,"dummy"
"42733",12,8,2,22,"dummy"
"42734",0,0,1,1,"dummy"
"42735",0,1,0,1,"dummy"
"42755",0,0,3,3,"dummy"
"42756",0,0,1,1,"dummy"
"42757",1,0,1,2,"dummy"
"42758",0,3,0,3,"dummy"
"42759",3,0,0,3,"dummy"
"42760",0,1,0,1,"dummy"
"42762",0,2,2,4,"dummy"
"42763",1,2,1,4,"dummy"
"42764",0,6,1,7,"dummy"
"42765",0,1,1,2,"dummy"
"42766",0,2,3,5,"dummy"
"42767",2,5,2,9,"dummy"
"42768",2,2,0,4,"dummy"
"42769",0,1,0,1,"dummy"
"42770",0,1,1,2,"dummy"
"42771",0,2,0,2,"dummy"
"42772",2,0,1,3,"dummy"
"42773",1,3,0,4,"dummy"
"42774",0,1,3,4,"dummy"
"42775",0,0,1,1,"dummy"
"42776",0,0,8,8,"dummy"
"42777",0,2,0,2,"dummy"
"42778",0,0,0,0,"dummy"
"42780",0,0,1,1,"dummy"
"42782",0,4,2,6,"dummy"
"42783",0,1,0,1,"dummy"
"42784",0,0,1,1,"dummy"
"42797",2,0,0,2,"dummy"
"42800",1,7,1,9,"dummy"
"42803",1,0,0,1,"dummy"
"42804",0,1,0,1,"dummy"
"42807",0,0,1,1,"dummy"
"42808",0,0,0,0,"dummy"
"42810",0,2,1,3,"dummy"
"42811",2,7,0,9,"dummy"
"42812",0,1,1,2,"dummy"
"42814",0,1,0,1,"dummy"
"42815",0,2,0,2,"dummy"
"42817",1,0,3,4,"dummy"
"42818",0,1,3,4,"dummy"
"42819",0,1,0,1,"dummy"
"42820",0,0,1,1,"dummy"
"42821",0,0,3,3,"dummy"
"42822",0,0,2,2,"dummy"
"42823",0,0,4,4,"dummy"
"42824",2,3,1,6,"dummy"
"42828",0,0,1,1,"dummy"
"42829",1,3,1,5,"dummy"
"42842",0,0,1,1,"dummy"
"42843",0,1,0,1,"dummy"
"42844",0,0,1,1,"dummy"
"42846",0,10,5,15,"dummy"
"42850",0,0,0,0,"dummy"
"42851",0,0,0,0,"dummy"
"42852",0,0,0,0,"dummy"
"42882",0,0,1,1,"dummy"
"42883",0,0,0,0,"dummy"
"42884",0,7,6,13,"dummy"
"42885",0,1,0,1,"dummy"
"42886",0,0,1,1,"dummy"
"42887",0,0,0,0,"dummy"
"42889",0,2,0,2,"dummy"
"42894",0,0,1,1,"dummy"
"42895",1,0,1,2,"dummy"
"42896",4,1,0,5,"dummy"
"42897",1,0,0,1,"dummy"
"42900",0,0,1,1,"dummy"
"42902",0,1,0,1,"dummy"
"42903",0,0,0,0,"dummy"
"42904",0,1,0,1,"dummy"
"42911",0,0,1,1,"dummy"
"42926",0,0,1,1,"dummy"
"42927",0,0,1,1,"dummy"
"42928",0,0,1,1,"dummy"
"42929",1,11,9,21,"dummy"
"42930",0,4,0,4,"dummy"
"42933",3,3,2,8,"dummy"
"42934",0,0,1,1,"dummy"
"42935",1,2,0,3,"dummy"
"42936",0,1,0,1,"dummy"
"42937",0,0,3,3,"dummy"
"42938",0,0,1,1,"dummy"
"42939",0,1,0,1,"dummy"
"42940",0,1,4,5,"dummy"
"42941",0,0,2,2,"dummy"
"42942",0,0,1,1,"dummy"
"42943",0,0,1,1,"dummy"
"42944",0,0,1,1,"dummy"
"42947",0,1,0,1,"dummy"
"42948",1,0,0,1,"dummy"
"42949",0,0,2,2,"dummy"
"42950",0,0,2,2,"dummy"
"42953",5,21,2,28,"dummy"
"42954",3,7,1,11,"dummy"
"42955",7,3,1,11,"dummy"
"42956",1,0,2,3,"dummy"
"42957",0,0,2,2,"dummy"
"42958",0,1,0,1,"dummy"
"42961",0,0,0,0,"dummy"
"42963",0,1,1,2,"dummy"
"42964",0,2,0,2,"dummy"
"42965",0,0,2,2,"dummy"
"42966",0,3,0,3,"dummy"
"42970",1,1,0,2,"dummy"
"42971",0,9,2,11,"dummy"
"42972",12,9,1,22,"dummy"
"42973",0,0,0,0,"dummy"
"42974",0,24,0,24,"dummy"
"42975",22,0,1,23,"dummy"
"42977",4,0,2,6,"dummy"
"42978",0,1,0,1,"dummy"
"42979",2,0,0,2,"dummy"
"42981",0,0,1,1,"dummy"
"42983",2,0,1,3,"dummy"
"42990",3,3,2,8,"dummy"
"42991",0,0,1,1,"dummy"
"42992",0,0,0,0,"dummy"
"42994",1,1,3,5,"dummy"
"42997",1,1,0,2,"dummy"
"42998",1,0,1,2,"dummy"
"42999",0,1,1,2,"dummy"
"43001",1,3,0,4,"dummy"
"43002",2,6,0,8,"dummy"
"43003",0,0,2,2,"dummy"
"43004",0,0,1,1,"dummy"
"43005",0,0,1,1,"dummy"
"43008",2,2,0,4,"dummy"
"43009",1,4,1,6,"dummy"
"43010",1,3,1,5,"dummy"
"43013",0,1,0,1,"dummy"
"43014",1,1,0,2,"dummy"
"43017",0,0,1,1,"dummy"
"43018",2,3,0,5,"dummy"
"43019",0,1,0,1,"dummy"
"43020",0,3,1,4,"dummy"
"43021",0,19,0,19,"dummy"
"43022",1,0,0,1,"dummy"
"43023",3,4,0,7,"dummy"
"43024",1,1,1,3,"dummy"
"43025",0,0,1,1,"dummy"
"43026",0,0,1,1,"dummy"
"43027",0,0,0,0,"dummy"
"43028",13,6,2,21,"dummy"
"43029",0,1,1,2,"dummy"
"43030",0,1,0,1,"dummy"
"43031",1,1,0,2,"dummy"
"43032",4,0,2,6,"dummy"
"43033",0,0,0,0,"dummy"
"43034",1,0,0,1,"dummy"
"43035",11,2,4,17,"dummy"
"43036",0,0,3,3,"dummy"
"43037",2,2,0,4,"dummy"
"43038",0,0,0,0,"dummy"
"43039",1,0,0,1,"dummy"
"43040",1,1,0,2,"dummy"
"43042",0,0,0,0,"dummy"
"43045",0,4,2,6,"dummy"
"43058",5,7,0,12,"dummy"
"43059",0,0,0,0,"dummy"
"43060",0,3,0,3,"dummy"
"43062",0,2,0,2,"dummy"
"43063",0,1,3,4,"dummy"
"43064",0,0,1,1,"dummy"
"43069",0,2,1,3,"dummy"
"43071",0,2,0,2,"dummy"
"43073",0,1,0,1,"dummy"
"43075",2,5,2,9,"dummy"
"43077",4,4,0,8,"dummy"
"43078",0,2,1,3,"dummy"
"43079",0,1,0,1,"dummy"
"43080",5,6,1,12,"dummy"
"43081",0,2,0,2,"dummy"
"43085",5,8,3,16,"dummy"
"43088",4,8,2,14,"dummy"
"43089",0,1,0,1,"dummy"
"43090",3,4,1,8,"dummy"
"43091",0,1,0,1,"dummy"
"43092",7,12,4,23,"dummy"
"43093",8,5,5,18,"dummy"
"43094",6,8,4,18,"dummy"
"43095",0,0,1,1,"dummy"
"43096",8,6,4,18,"dummy"
"43098",0,3,2,5,"dummy"
"43101",1,0,0,1,"dummy"
"43103",0,1,0,1,"dummy"
"43105",0,0,1,1,"dummy"
"43106",0,0,1,1,"dummy"
"43107",0,0,2,2,"dummy"
"43109",0,0,2,2,"dummy"
"43110",1,0,0,1,"dummy"
"43114",5,3,0,8,"dummy"
"43116",0,3,0,3,"dummy"
"43117",0,0,1,1,"dummy"
"43121",0,1,1,2,"dummy"
"43122",0,0,1,1,"dummy"
"43124",0,5,0,5,"dummy"
"43133",0,1,0,1,"dummy"
"43134",1,0,0,1,"dummy"
"43136",3,5,2,10,"dummy"
"43137",13,5,3,21,"dummy"
"43139",0,0,2,2,"dummy"
"43141",0,1,0,1,"dummy"
"43142",0,7,0,7,"dummy"
"43147",5,2,2,9,"dummy"
"43151",0,2,0,2,"dummy"
"43152",1,20,4,25,"dummy"
"43153",0,1,0,1,"dummy"
"43154",1,0,0,1,"dummy"
"43157",0,0,0,0,"dummy"
"43158",0,0,1,1,"dummy"
"43159",4,8,0,12,"dummy"
"43160",2,0,0,2,"dummy"
"43161",8,3,0,11,"dummy"
"43162",0,0,1,1,"dummy"
"43163",0,1,0,1,"dummy"
"43164",0,2,0,2,"dummy"
"43165",0,2,0,2,"dummy"
"43166",0,2,0,2,"dummy"
"43167",0,2,0,2,"dummy"
"43173",1,2,0,3,"dummy"
"43174",0,0,0,0,"dummy"
"43175",0,2,0,2,"dummy"
"43176",1,1,0,2,"dummy"
"43178",0,0,1,1,"dummy"
"43179",3,0,0,3,"dummy"
"43180",5,14,0,19,"dummy"
"43181",6,2,0,8,"dummy"
"43184",0,1,0,1,"dummy"
"43188",1,3,1,5,"dummy"
"43189",2,2,0,4,"dummy"
"43190",0,0,0,0,"dummy"
"43191",0,0,0,0,"dummy"
"43192",0,0,0,0,"dummy"
"43193",0,1,0,1,"dummy"
"43197",0,3,0,3,"dummy"
"43198",0,6,0,6,"dummy"
"43200",6,4,2,12,"dummy"
"43201",0,7,0,7,"dummy"
"43202",0,1,0,1,"dummy"
"43204",0,1,0,1,"dummy"
"43205",0,1,0,1,"dummy"
"43209",0,0,1,1,"dummy"
"43210",0,5,0,5,"dummy"
"43211",0,0,4,4,"dummy"
"43214",1,0,1,2,"dummy"
"43215",0,1,0,1,"dummy"
"43216",0,0,1,1,"dummy"
"43217",0,8,0,8,"dummy"
"43218",3,3,1,7,"dummy"
"43219",1,2,1,4,"dummy"
"43220",0,3,0,3,"dummy"
"43221",6,2,0,8,"dummy"
"43222",0,3,0,3,"dummy"
"43223",0,0,1,1,"dummy"
"43224",0,1,0,1,"dummy"
"43225",0,0,0,0,"dummy"
"43226",1,0,0,1,"dummy"
"43231",0,1,0,1,"dummy"
"43238",1,5,1,7,"dummy"
"43242",0,0,1,1,"dummy"
"43243",0,0,1,1,"dummy"
"43244",0,0,1,1,"dummy"
"43245",0,0,1,1,"dummy"
"43248",2,0,1,3,"dummy"
"43249",8,0,0,8,"dummy"
"43258",1,4,0,5,"dummy"
"43259",1,0,1,2,"dummy"
"43260",0,1,0,1,"dummy"
"43261",0,1,1,2,"dummy"
"43266",0,4,1,5,"dummy"
"43269",1,0,2,3,"dummy"
"43270",3,7,0,10,"dummy"
"43271",7,17,0,24,"dummy"
"43272",2,0,0,2,"dummy"
"43273",1,0,0,1,"dummy"
"43274",9,4,0,13,"dummy"
"43281",0,0,1,1,"dummy"
"43284",1,0,0,1,"dummy"
"43287",2,0,0,2,"dummy"
"43288",0,2,0,2,"dummy"
"43298",0,0,0,0,"dummy"
"43301",0,1,5,6,"dummy"
"43302",0,0,1,1,"dummy"
"43303",0,4,0,4,"dummy"
"43305",24,25,8,57,"dummy"
"43306",3,7,1,11,"dummy"
"43307",2,3,0,5,"dummy"
"43309",0,6,1,7,"dummy"
"43311",0,0,1,1,"dummy"
"43314",0,0,1,1,"dummy"
"43315",1,2,0,3,"dummy"
"43316",1,2,0,3,"dummy"
"43317",3,1,1,5,"dummy"
"43320",0,0,0,0,"dummy"
"43321",0,1,0,1,"dummy"
"43323",1,7,1,9,"dummy"
"43324",5,14,0,19,"dummy"
"43325",0,7,0,7,"dummy"
"43326",1,15,1,17,"dummy"
"43327",0,0,2,2,"dummy"
"43329",0,1,0,1,"dummy"
"43330",5,8,0,13,"dummy"
"43331",0,1,1,2,"dummy"
"43332",0,0,3,3,"dummy"
"43333",0,0,1,1,"dummy"
"43334",11,12,0,23,"dummy"
"43335",0,1,3,4,"dummy"
"43350",3,4,0,7,"dummy"
"43351",0,3,0,3,"dummy"
"43354",2,2,0,4,"dummy"
"43355",3,3,1,7,"dummy"
"43356",3,3,1,7,"dummy"
"43358",2,0,0,2,"dummy"
"43359",0,0,0,0,"dummy"
"43380",2,0,2,4,"dummy"
"43381",0,1,0,1,"dummy"
"43383",0,4,0,4,"dummy"
"43385",0,1,0,1,"dummy"
"43386",0,3,0,3,"dummy"
"43387",2,2,0,4,"dummy"
"43388",3,2,0,5,"dummy"
"43389",2,0,1,3,"dummy"
"43391",2,0,0,2,"dummy"
"43392",0,0,1,1,"dummy"
"43393",0,0,0,0,"dummy"
"43396",1,1,0,2,"dummy"
"43398",2,0,2,4,"dummy"
"43401",1,0,0,1,"dummy"
"43403",0,0,1,1,"dummy"
"43404",0,0,2,2,"dummy"
"43405",1,0,0,1,"dummy"
"43410",0,0,1,1,"dummy"
"43411",0,0,0,0,"dummy"
"43414",2,2,2,6,"dummy"
"43415",0,1,2,3,"dummy"
"43417",4,0,1,5,"dummy"
"43418",0,4,1,5,"dummy"
"43419",0,0,0,0,"dummy"
"43422",0,0,2,2,"dummy"
"43423",1,2,0,3,"dummy"
"43424",0,0,1,1,"dummy"
"43425",2,1,0,3,"dummy"
"43435",0,8,0,8,"dummy"
"43436",0,1,0,1,"dummy"
"43439",1,5,4,10,"dummy"
"43440",3,3,0,6,"dummy"
"43441",0,0,0,0,"dummy"
"43442",3,3,0,6,"dummy"
"43443",0,0,1,1,"dummy"
"43453",0,1,0,1,"dummy"
"43455",1,0,0,1,"dummy"
"43457",0,0,0,0,"dummy"
"43458",0,0,0,0,"dummy"
"43460",0,1,0,1,"dummy"
"43461",0,2,0,2,"dummy"
"43462",1,0,0,1,"dummy"
"43465",0,0,7,7,"dummy"
"43466",0,12,0,12,"dummy"
"43467",0,1,0,1,"dummy"
"43468",3,1,0,4,"dummy"
"43469",0,5,1,6,"dummy"
"43471",0,10,4,14,"dummy"
"43476",0,2,0,2,"dummy"
"43477",0,0,1,1,"dummy"
"43478",12,1,3,16,"dummy"
"43479",0,1,0,1,"dummy"
"43480",0,0,1,1,"dummy"
"43484",0,0,1,1,"dummy"
"43544",0,0,0,0,"dummy"
"43565",0,0,0,0,"dummy"
"43569",3,2,0,5,"dummy"
"43570",1,1,0,2,"dummy"
"43571",0,0,2,2,"dummy"
"43572",0,1,3,4,"dummy"
"43573",0,1,0,1,"dummy"
"43576",3,3,0,6,"dummy"
"43577",0,0,1,1,"dummy"
"43578",0,0,0,0,"dummy"
"43581",0,0,3,3,"dummy"
"43588",0,3,0,3,"dummy"
"43591",0,6,0,6,"dummy"
"43592",0,0,4,4,"dummy"
"43601",0,0,1,1,"dummy"
"43604",0,0,1,1,"dummy"
"43610",1,1,0,2,"dummy"
"43611",0,0,1,1,"dummy"
"43614",0,1,0,1,"dummy"
"43615",4,7,3,14,"dummy"
"43616",0,0,0,0,"dummy"
"43623",0,4,0,4,"dummy"
"43624",0,4,0,4,"dummy"
"43625",0,1,0,1,"dummy"
"43626",0,1,0,1,"dummy"
"43637",0,1,0,1,"dummy"
"43638",0,0,1,1,"dummy"
"43639",0,0,1,1,"dummy"
"43640",0,0,1,1,"dummy"
"43641",0,3,0,3,"dummy"
"43642",0,0,1,1,"dummy"
"43643",1,5,1,7,"dummy"
"43644",0,0,1,1,"dummy"
"43645",6,2,1,9,"dummy"
"43646",0,0,1,1,"dummy"
"43650",0,3,0,3,"dummy"
"43651",0,2,1,3,"dummy"
"43654",0,1,0,1,"dummy"
"43655",0,0,0,0,"dummy"
"43660",1,0,1,2,"dummy"
"43661",0,0,0,0,"dummy"
"43693",2,1,0,3,"dummy"
"43698",1,0,2,3,"dummy"
"43701",0,4,0,4,"dummy"
"43702",0,1,0,1,"dummy"
"43726",0,10,1,11,"dummy"
"43727",1,3,0,4,"dummy"
"43728",0,1,0,1,"dummy"
"43729",0,3,0,3,"dummy"
"43733",0,4,0,4,"dummy"
"43734",0,0,2,2,"dummy"
"43735",8,2,3,13,"dummy"
"43736",0,2,0,2,"dummy"
"43737",2,2,0,4,"dummy"
"43750",1,8,0,9,"dummy"
"43751",3,7,4,14,"dummy"
"43752",5,4,0,9,"dummy"
"43758",0,14,0,14,"dummy"
"43759",3,1,2,6,"dummy"
"43760",0,0,1,1,"dummy"
"43761",0,2,3,5,"dummy"
"43762",0,0,2,2,"dummy"
"43482",0,0,2,2,"dummy"
"43488",0,0,2,2,"dummy"
"43489",0,11,0,11,"dummy"
"43540",2,0,0,2,"dummy"
"43541",0,3,0,3,"dummy"
"43542",0,0,0,0,"dummy"
"43546",6,10,2,18,"dummy"
"43547",7,1,1,9,"dummy"
"43548",0,0,1,1,"dummy"
"43554",3,1,0,4,"dummy"
"43555",0,2,0,2,"dummy"
"43556",2,0,1,3,"dummy"
"43563",7,5,0,12,"dummy"
"43567",0,0,4,4,"dummy"
"43583",2,0,0,2,"dummy"
"43584",0,0,1,1,"dummy"
"43585",0,4,0,4,"dummy"
"43586",1,1,0,2,"dummy"
"43596",0,0,1,1,"dummy"
"43606",0,0,1,1,"dummy"
"43618",0,1,0,1,"dummy"
"43619",0,1,1,2,"dummy"
"43620",0,0,1,1,"dummy"
"43621",0,0,1,1,"dummy"
"43628",1,1,0,2,"dummy"
"43629",0,2,0,2,"dummy"
"43630",6,5,0,11,"dummy"
"43633",4,0,0,4,"dummy"
"43634",0,2,0,2,"dummy"
"43635",0,0,1,1,"dummy"
"43648",2,0,0,2,"dummy"
"43704",0,1,0,1,"dummy"
"43705",0,0,1,1,"dummy"
"43706",1,1,1,3,"dummy"
"43707",7,4,1,12,"dummy"
"43708",0,0,2,2,"dummy"
"43709",0,1,1,2,"dummy"
"43710",1,0,1,2,"dummy"
"43711",0,0,1,1,"dummy"
"43731",0,0,0,0,"dummy"
"43743",8,11,4,23,"dummy"
"43744",0,4,0,4,"dummy"
"43745",3,1,0,4,"dummy"
"43746",1,0,0,1,"dummy"
"43747",0,1,0,1,"dummy"
"43748",0,1,0,1,"dummy"
"43754",4,5,3,12,"dummy"
"43755",9,20,1,30,"dummy"
"43756",4,2,1,7,"dummy"
"43764",0,1,0,1,"dummy"
"43765",0,0,1,1,"dummy"
"43766",0,0,2,2,"dummy"
"43767",0,0,1,1,"dummy"
"43768",1,2,1,4,"dummy"
"43769",0,9,2,11,"dummy"
"43770",1,0,1,2,"dummy"
"43771",5,5,0,10,"dummy"
"43772",0,0,4,4,"dummy"
"43773",0,0,3,3,"dummy"
"43774",0,1,0,1,"dummy"
"43777",1,1,0,2,"dummy"
"43778",2,12,0,14,"dummy"
"43781",0,1,0,1,"dummy"
"43782",0,4,0,4,"dummy"
"43783",1,0,0,1,"dummy"
"43784",1,4,1,6,"dummy"
"43785",0,0,1,1,"dummy"
"43786",8,4,2,14,"dummy"
"43787",0,0,1,1,"dummy"
"43788",5,7,2,14,"dummy"
"43789",0,1,0,1,"dummy"
"43790",2,2,1,5,"dummy"
"43791",7,6,2,15,"dummy"
"43792",0,3,0,3,"dummy"
"43793",19,1,1,21,"dummy"
"43794",0,0,0,0,"dummy"
"43795",0,1,0,1,"dummy"
"43796",0,0,0,0,"dummy"
"43797",0,0,1,1,"dummy"
"43802",0,4,2,6,"dummy"
"43803",0,0,1,1,"dummy"
"43804",0,1,1,2,"dummy"
"43805",0,0,1,1,"dummy"
"43806",0,2,0,2,"dummy"
"43807",0,0,1,1,"dummy"
"43808",0,0,1,1,"dummy"
"43811",0,3,0,3,"dummy"
"43812",3,3,0,6,"dummy"
"43813",0,0,2,2,"dummy"
"43814",0,0,2,2,"dummy"
"43815",0,0,1,1,"dummy"
"43816",0,2,0,2,"dummy"
"43817",0,0,1,1,"dummy"
"43818",0,0,2,2,"dummy"
"43819",0,0,2,2,"dummy"
"43829",2,4,0,6,"dummy"
"43830",0,2,0,2,"dummy"
"43831",0,2,0,2,"dummy"
"43832",10,2,0,12,"dummy"
"43833",0,2,0,2,"dummy"
"43834",0,0,0,0,"dummy"
"43835",0,0,3,3,"dummy"
"43838",0,0,1,1,"dummy"
"43839",2,2,0,4,"dummy"
"43842",1,3,0,4,"dummy"
"43843",0,0,1,1,"dummy"
"43858",0,1,0,1,"dummy"
"43859",0,1,0,1,"dummy"
"43860",0,0,1,1,"dummy"
"43861",0,1,1,2,"dummy"
"43862",0,0,1,1,"dummy"
"43863",0,0,3,3,"dummy"
"43864",0,0,1,1,"dummy"
"43878",3,3,0,6,"dummy"
"43879",0,0,0,0,"dummy"
"43887",11,4,1,16,"dummy"
"43888",5,5,1,11,"dummy"
"43889",5,14,2,21,"dummy"
"43890",11,13,2,26,"dummy"
"43891",3,3,5,11,"dummy"
"43892",0,5,1,6,"dummy"
"43893",0,3,0,3,"dummy"
"43894",24,15,1,40,"dummy"
"43895",3,2,0,5,"dummy"
"43896",0,0,1,1,"dummy"
"43897",0,0,1,1,"dummy"
"43898",0,0,1,1,"dummy"
"43899",0,0,1,1,"dummy"
"43900",0,0,1,1,"dummy"
"43901",0,0,1,1,"dummy"
"43902",0,0,1,1,"dummy"
"43903",0,0,1,1,"dummy"
"43904",0,0,1,1,"dummy"
"43905",0,0,1,1,"dummy"
"43906",0,0,1,1,"dummy"
"43907",0,0,1,1,"dummy"
"43908",0,0,1,1,"dummy"
"43909",0,0,1,1,"dummy"
"43910",0,0,1,1,"dummy"
"43911",0,0,1,1,"dummy"
"43917",1,0,2,3,"dummy"
"43823",0,2,0,2,"dummy"
"43824",0,2,0,2,"dummy"
"43825",2,0,0,2,"dummy"
"43826",0,0,1,1,"dummy"
"43827",0,0,0,0,"dummy"
"43845",0,0,1,1,"dummy"
"43846",1,0,0,1,"dummy"
"43847",0,1,0,1,"dummy"
"43848",2,2,0,4,"dummy"
"43849",0,8,0,8,"dummy"
"43850",0,0,0,0,"dummy"
"43851",0,4,0,4,"dummy"
"43852",2,3,0,5,"dummy"
"43853",0,0,2,2,"dummy"
"43854",2,0,0,2,"dummy"
"43866",6,4,1,11,"dummy"
"43867",1,0,1,2,"dummy"
"43868",0,2,1,3,"dummy"
"43869",1,2,0,3,"dummy"
"43870",7,4,4,15,"dummy"
"43873",0,1,1,2,"dummy"
"43874",0,2,2,4,"dummy"
"43883",0,1,0,1,"dummy"
"43913",0,2,1,3,"dummy"
"43936",0,2,1,3,"dummy"
"43937",5,14,3,22,"dummy"
"43938",0,0,2,2,"dummy"
"43939",0,1,0,1,"dummy"
"43969",0,0,2,2,"dummy"
"43970",0,0,1,1,"dummy"
"44000",5,1,0,6,"dummy"
"44001",0,1,0,1,"dummy"
"44004",0,4,2,6,"dummy"
"44005",0,1,0,1,"dummy"
"44006",0,1,3,4,"dummy"
"44007",1,3,0,4,"dummy"
"44008",2,1,0,3,"dummy"
"44011",0,1,0,1,"dummy"
"44012",1,1,1,3,"dummy"
"44013",0,0,1,1,"dummy"
"44014",0,1,0,1,"dummy"
"44015",0,1,0,1,"dummy"
"44016",0,0,1,1,"dummy"
"44023",6,0,0,6,"dummy"
"44024",2,5,2,9,"dummy"
"44027",0,1,0,1,"dummy"
"44028",1,1,0,2,"dummy"
"44029",2,4,1,7,"dummy"
"44032",0,0,3,3,"dummy"
"44035",0,0,4,4,"dummy"
"44036",0,1,0,1,"dummy"
"44048",0,0,2,2,"dummy"
"44049",0,0,2,2,"dummy"
"44050",0,0,2,2,"dummy"
"44051",0,0,2,2,"dummy"
"44052",0,0,2,2,"dummy"
"44053",0,0,2,2,"dummy"
"44054",0,0,2,2,"dummy"
"44055",0,0,2,2,"dummy"
"44056",0,0,2,2,"dummy"
"44057",0,1,0,1,"dummy"
"44058",0,0,2,2,"dummy"
"44059",0,0,2,2,"dummy"
"44060",0,0,2,2,"dummy"
"44070",0,1,0,1,"dummy"
"44089",0,0,1,1,"dummy"
"44108",0,2,0,2,"dummy"
"44109",0,1,0,1,"dummy"
"44110",3,0,0,3,"dummy"
"43930",1,3,0,4,"dummy"
"43931",2,7,0,9,"dummy"
"43932",0,1,0,1,"dummy"
"43933",0,0,0,0,"dummy"
"43934",0,0,1,1,"dummy"
"43941",3,3,0,6,"dummy"
"43942",0,1,0,1,"dummy"
"43943",0,1,0,1,"dummy"
"43944",0,1,0,1,"dummy"
"43945",0,3,3,6,"dummy"
"43946",0,3,0,3,"dummy"
"43951",1,0,0,1,"dummy"
"43952",0,0,1,1,"dummy"
"43953",0,0,2,2,"dummy"
"43954",0,2,2,4,"dummy"
"43955",0,0,2,2,"dummy"
"43956",2,7,2,11,"dummy"
"43957",3,8,0,11,"dummy"
"43958",0,0,2,2,"dummy"
"43959",6,3,0,9,"dummy"
"43960",0,2,0,2,"dummy"
"43961",0,0,1,1,"dummy"
"43962",5,0,1,6,"dummy"
"43963",0,0,2,2,"dummy"
"43964",5,5,0,10,"dummy"
"43967",3,20,1,24,"dummy"
"43972",2,0,1,3,"dummy"
"43980",0,1,0,1,"dummy"
"43981",0,3,0,3,"dummy"
"43982",0,3,0,3,"dummy"
"43983",0,2,0,2,"dummy"
"43984",0,5,0,5,"dummy"
"43985",0,2,0,2,"dummy"
"43986",0,1,0,1,"dummy"
"43987",0,2,1,3,"dummy"
"43988",0,1,0,1,"dummy"
"43989",0,0,0,0,"dummy"
"43990",0,1,0,1,"dummy"
"43991",0,0,1,1,"dummy"
"43992",0,0,0,0,"dummy"
"43993",0,0,1,1,"dummy"
"43994",2,0,0,2,"dummy"
"43995",0,0,3,3,"dummy"
"44018",0,0,1,1,"dummy"
"44019",38,1,2,41,"dummy"
"44020",1,0,0,1,"dummy"
"44021",0,0,1,1,"dummy"
"44038",0,2,0,2,"dummy"
"44039",0,0,1,1,"dummy"
"44040",0,1,0,1,"dummy"
"44041",3,2,0,5,"dummy"
"44042",4,5,0,9,"dummy"
"44043",2,6,0,8,"dummy"
"44044",3,0,0,3,"dummy"
"44062",0,0,1,1,"dummy"
"44063",0,0,1,1,"dummy"
"44064",2,4,1,7,"dummy"
"44065",0,0,0,0,"dummy"
"44066",1,1,0,2,"dummy"
"44067",0,4,0,4,"dummy"
"44068",0,1,0,1,"dummy"
"44072",0,0,2,2,"dummy"
"44073",1,0,2,3,"dummy"
"44074",1,1,2,4,"dummy"
"44075",4,0,1,5,"dummy"
"44078",2,0,1,3,"dummy"
"44079",0,3,1,4,"dummy"
"44080",0,0,1,1,"dummy"
"44081",1,0,0,1,"dummy"
"44082",0,1,0,1,"dummy"
"44083",0,0,1,1,"dummy"
"44093",1,1,0,2,"dummy"
"44094",1,1,0,2,"dummy"
"44095",0,0,1,1,"dummy"
"44096",1,1,2,4,"dummy"
"44097",0,0,1,1,"dummy"
"44100",1,2,0,3,"dummy"
"44101",1,2,0,3,"dummy"
"44102",3,1,0,4,"dummy"
"44103",0,1,2,3,"dummy"
"44104",0,2,0,2,"dummy"
"44111",0,1,0,1,"dummy"
"44112",0,0,0,0,"dummy"
"44113",1,0,0,1,"dummy"
"44114",0,3,0,3,"dummy"
"44115",0,0,0,0,"dummy"
"44116",1,0,0,1,"dummy"
"44136",0,0,1,1,"dummy"
"44137",0,0,1,1,"dummy"
"44138",0,0,1,1,"dummy"
"44139",0,0,1,1,"dummy"
"44142",1,0,1,2,"dummy"
"44148",0,1,0,1,"dummy"
"44176",2,2,1,5,"dummy"
"44181",0,1,0,1,"dummy"
"44182",0,2,0,2,"dummy"
"44210",1,0,2,3,"dummy"
"44235",0,0,1,1,"dummy"
"44236",3,0,1,4,"dummy"
"44237",0,0,1,1,"dummy"
"44238",1,0,0,1,"dummy"
"44241",0,5,1,6,"dummy"
"44242",2,5,1,8,"dummy"
"44243",7,4,4,15,"dummy"
"44254",0,3,0,3,"dummy"
"44255",0,0,1,1,"dummy"
"44256",0,0,1,1,"dummy"
"44257",0,2,0,2,"dummy"
"44258",1,0,1,2,"dummy"
"44259",0,0,0,0,"dummy"
"44260",0,2,0,2,"dummy"
"44261",0,1,0,1,"dummy"
"44262",0,0,1,1,"dummy"
"44263",0,0,1,1,"dummy"
"44264",0,1,0,1,"dummy"
"44265",0,0,1,1,"dummy"
"44266",0,4,0,4,"dummy"
"44271",0,1,0,1,"dummy"
"44272",1,0,0,1,"dummy"
"44120",0,0,0,0,"dummy"
"44121",0,0,2,2,"dummy"
"44122",0,0,0,0,"dummy"
"44125",1,1,0,2,"dummy"
"44126",0,0,2,2,"dummy"
"44127",0,0,1,1,"dummy"
"44128",2,0,0,2,"dummy"
"44144",2,6,1,9,"dummy"
"44150",2,4,3,9,"dummy"
"44151",1,0,0,1,"dummy"
"44156",4,0,0,4,"dummy"
"44159",0,4,0,4,"dummy"
"44160",0,2,2,4,"dummy"
"44163",2,4,0,6,"dummy"
"44187",0,0,0,0,"dummy"
"44188",0,1,0,1,"dummy"
"44189",1,1,0,2,"dummy"
"44190",0,9,0,9,"dummy"
"44191",0,1,0,1,"dummy"
"44192",1,0,0,1,"dummy"
"44193",1,36,1,38,"dummy"
"44194",11,21,0,32,"dummy"
"44195",0,0,0,0,"dummy"
"44196",1,3,0,4,"dummy"
"44197",0,0,1,1,"dummy"
"44198",1,2,1,4,"dummy"
"44199",0,0,1,1,"dummy"
"44200",0,0,1,1,"dummy"
"44201",7,20,1,28,"dummy"
"44212",4,3,4,11,"dummy"
"44215",1,2,1,4,"dummy"
"44216",0,0,1,1,"dummy"
"44217",0,1,0,1,"dummy"
"44222",2,0,0,2,"dummy"
"44223",0,10,2,12,"dummy"
"44224",0,1,3,4,"dummy"
"44225",0,0,1,1,"dummy"
"44226",1,2,2,5,"dummy"
"44227",0,1,0,1,"dummy"
"44268",0,0,1,1,"dummy"
"44269",0,0,1,1,"dummy"
"44279",0,1,0,1,"dummy"
"44280",1,0,0,1,"dummy"
"44296",0,0,0,0,"dummy"
"44298",0,1,0,1,"dummy"
"44301",2,4,1,7,"dummy"
"44307",0,0,1,1,"dummy"
"44308",0,1,0,1,"dummy"
"44319",1,1,0,2,"dummy"
"44320",1,1,5,7,"dummy"
"44321",1,0,5,6,"dummy"
"44323",0,0,0,0,"dummy"
"44325",1,3,3,7,"dummy"
"44326",3,0,3,6,"dummy"
"44327",0,6,0,6,"dummy"
"44328",7,6,0,13,"dummy"
"44330",1,3,2,6,"dummy"
"44331",0,0,0,0,"dummy"
"44333",0,1,0,1,"dummy"
"44334",3,0,2,5,"dummy"
"44335",0,0,3,3,"dummy"
"44336",2,4,2,8,"dummy"
"44339",0,2,0,2,"dummy"
"44340",5,0,1,6,"dummy"
"44342",0,1,0,1,"dummy"
"44343",4,1,0,5,"dummy"
"44344",2,1,0,3,"dummy"
"44345",1,0,0,1,"dummy"
"44346",0,2,0,2,"dummy"
"44347",0,1,0,1,"dummy"
"44348",1,7,0,8,"dummy"
"44351",0,14,0,14,"dummy"
"44352",0,9,0,9,"dummy"
"44354",0,0,1,1,"dummy"
"44355",0,0,1,1,"dummy"
"44360",4,9,1,14,"dummy"
"44361",7,4,1,12,"dummy"
"44362",0,1,0,1,"dummy"
"44364",0,0,1,1,"dummy"
"44365",2,2,0,4,"dummy"
"44367",6,10,0,16,"dummy"
"44368",0,0,1,1,"dummy"
"44369",4,3,0,7,"dummy"
"44372",0,0,3,3,"dummy"
"44373",3,3,0,6,"dummy"
"44385",0,2,0,2,"dummy"
"44386",15,4,0,19,"dummy"
"44387",0,3,4,7,"dummy"
"44389",3,1,0,4,"dummy"
"44390",0,1,0,1,"dummy"
"44391",0,1,2,3,"dummy"
"44393",0,1,0,1,"dummy"
"44394",1,0,0,1,"dummy"
"44397",6,0,0,6,"dummy"
"44398",2,5,2,9,"dummy"
"44401",3,4,6,13,"dummy"
"44402",0,0,0,0,"dummy"
"44403",0,2,2,4,"dummy"
"44406",0,1,0,1,"dummy"
"44407",1,0,0,1,"dummy"
"44408",0,7,2,9,"dummy"
"44411",0,4,0,4,"dummy"
"44412",0,2,9,11,"dummy"
"44414",0,2,1,3,"dummy"
"44418",2,3,0,5,"dummy"
"44419",4,0,0,4,"dummy"
"44420",0,1,0,1,"dummy"
"44422",0,0,2,2,"dummy"
"44423",0,0,2,2,"dummy"
"44424",4,12,3,19,"dummy"
"44425",4,4,5,13,"dummy"
"44426",2,2,3,7,"dummy"
"44427",2,2,3,7,"dummy"
"44428",2,2,3,7,"dummy"
"44429",0,3,0,3,"dummy"
"44430",2,2,4,8,"dummy"
"44431",3,3,0,6,"dummy"
"44437",0,0,1,1,"dummy"
"44438",0,5,0,5,"dummy"
"44439",0,1,0,1,"dummy"
"44441",0,1,1,2,"dummy"
"44443",0,0,0,0,"dummy"
"44444",0,1,0,1,"dummy"
"44445",4,0,0,4,"dummy"
"44446",0,0,0,0,"dummy"
"44447",0,0,0,0,"dummy"
"44448",0,0,0,0,"dummy"
"44450",0,2,0,2,"dummy"
"44451",0,2,0,2,"dummy"
"44452",4,6,2,12,"dummy"
"44457",6,0,0,6,"dummy"
"44458",2,5,2,9,"dummy"
"44474",0,4,1,5,"dummy"
"44479",0,3,0,3,"dummy"
"44481",4,6,3,13,"dummy"
"44482",0,0,1,1,"dummy"
"44483",1,2,0,3,"dummy"
"44484",0,1,0,1,"dummy"
"44485",1,0,0,1,"dummy"
"44486",0,3,1,4,"dummy"
"44487",0,0,1,1,"dummy"
"44488",0,0,1,1,"dummy"
"44489",0,1,0,1,"dummy"
"44490",0,0,1,1,"dummy"
"44491",0,0,1,1,"dummy"
"44492",0,1,1,2,"dummy"
"44493",0,0,1,1,"dummy"
"44495",5,4,2,11,"dummy"
"44498",1,3,2,6,"dummy"
"44499",0,0,1,1,"dummy"
"44500",0,0,1,1,"dummy"
"44501",1,0,0,1,"dummy"
"44502",0,0,1,1,"dummy"
"44503",0,1,2,3,"dummy"
"44507",0,3,0,3,"dummy"
"44508",0,1,0,1,"dummy"
"44510",0,0,0,0,"dummy"
"44511",0,0,0,0,"dummy"
"44514",6,6,0,12,"dummy"
"44515",5,10,5,20,"dummy"
"44516",5,2,0,7,"dummy"
"44517",1,0,0,1,"dummy"
"44518",1,0,1,2,"dummy"
"44519",1,2,0,3,"dummy"
"44520",1,0,0,1,"dummy"
"44522",0,0,1,1,"dummy"
"44523",0,0,1,1,"dummy"
"44524",0,0,2,2,"dummy"
"44525",26,3,7,36,"dummy"
"44527",0,0,2,2,"dummy"
"44530",0,1,0,1,"dummy"
"44531",0,0,2,2,"dummy"
"44535",1,0,0,1,"dummy"
"44536",1,58,0,59,"dummy"
"44537",0,0,0,0,"dummy"
"44538",0,1,0,1,"dummy"
"44540",0,14,0,14,"dummy"
"44541",0,2,0,2,"dummy"
"44542",0,1,0,1,"dummy"
"44569",0,2,0,2,"dummy"
"44570",0,1,0,1,"dummy"
"44571",0,2,1,3,"dummy"
"44573",2,2,0,4,"dummy"
"44575",0,1,0,1,"dummy"
"44577",0,1,0,1,"dummy"
"44578",0,0,1,1,"dummy"
"44580",0,1,0,1,"dummy"
"44582",0,1,0,1,"dummy"
"44583",2,0,0,2,"dummy"
"44586",0,2,0,2,"dummy"
"44587",2,1,0,3,"dummy"
"44588",0,2,0,2,"dummy"
"44589",0,1,0,1,"dummy"
"44590",2,4,0,6,"dummy"
"44591",0,0,1,1,"dummy"
"44592",0,1,0,1,"dummy"
"44593",1,0,0,1,"dummy"
"44594",1,2,0,3,"dummy"
"44595",0,1,0,1,"dummy"
"44596",0,2,1,3,"dummy"
"44597",0,0,1,1,"dummy"
"44598",1,1,0,2,"dummy"
"44601",0,6,5,11,"dummy"
"44680",1,2,0,3,"dummy"
"44681",3,9,0,12,"dummy"
"44682",17,1,0,18,"dummy"
"44683",1,18,0,19,"dummy"
"44684",0,1,1,2,"dummy"
"44685",0,0,0,0,"dummy"
"44686",17,1,0,18,"dummy"
"44687",1,0,0,1,"dummy"
"44688",0,0,0,0,"dummy"
"44689",0,1,1,2,"dummy"
"44690",2,2,0,4,"dummy"
"44691",2,3,0,5,"dummy"
"44692",0,0,1,1,"dummy"
"44693",2,2,0,4,"dummy"
"44694",0,1,0,1,"dummy"
"44695",0,3,1,4,"dummy"
"44696",3,5,2,10,"dummy"
"44697",2,2,1,5,"dummy"
"44698",0,1,0,1,"dummy"
"44699",0,1,0,1,"dummy"
"44700",7,3,1,11,"dummy"
"44701",0,0,1,1,"dummy"
"44707",5,1,0,6,"dummy"
"44708",1,0,3,4,"dummy"
"44712",0,6,0,6,"dummy"
"44713",0,6,0,6,"dummy"
"44718",4,5,0,9,"dummy"
"44719",0,0,1,1,"dummy"
"44720",3,0,0,3,"dummy"
"44721",0,0,1,1,"dummy"
"44731",0,1,0,1,"dummy"
"44744",0,0,1,1,"dummy"
"44745",8,1,1,10,"dummy"
"44746",0,0,1,1,"dummy"
"44747",0,1,0,1,"dummy"
"44748",1,0,0,1,"dummy"
"44749",0,0,1,1,"dummy"
"44750",0,0,1,1,"dummy"
"44758",7,13,4,24,"dummy"
"44759",1,4,0,5,"dummy"
"44763",0,2,0,2,"dummy"
"44764",9,3,2,14,"dummy"
"44765",0,0,1,1,"dummy"
"44779",0,0,2,2,"dummy"
"44783",1,0,0,1,"dummy"
"44794",0,0,1,1,"dummy"
"44795",0,0,3,3,"dummy"
"44796",0,0,3,3,"dummy"
"44797",0,0,4,4,"dummy"
"44798",2,3,1,6,"dummy"
"44800",4,4,2,10,"dummy"
"44807",0,12,0,12,"dummy"
"44808",0,2,3,5,"dummy"
"44809",1,2,2,5,"dummy"
"44810",3,5,4,12,"dummy"
"44811",2,5,8,15,"dummy"
"44812",0,2,0,2,"dummy"
"44813",1,12,3,16,"dummy"
"44814",13,0,2,15,"dummy"
"44815",0,4,0,4,"dummy"
"44816",0,0,1,1,"dummy"
"44817",6,0,0,6,"dummy"
"44818",0,6,0,6,"dummy"
"44819",0,4,0,4,"dummy"
"44820",0,1,0,1,"dummy"
"44821",0,0,1,1,"dummy"
"44822",26,13,1,40,"dummy"
"44823",0,4,0,4,"dummy"
"44603",1,0,0,1,"dummy"
"44606",0,4,0,4,"dummy"
"44607",0,1,0,1,"dummy"
"44608",0,0,1,1,"dummy"
"44648",0,1,0,1,"dummy"
"44649",0,1,1,2,"dummy"
"44650",1,0,0,1,"dummy"
"44651",0,1,1,2,"dummy"
"44654",0,0,1,1,"dummy"
"44673",0,1,0,1,"dummy"
"44674",0,2,0,2,"dummy"
"44703",0,0,3,3,"dummy"
"44723",0,0,0,0,"dummy"
"44724",0,2,0,2,"dummy"
"44725",0,1,2,3,"dummy"
"44726",1,0,0,1,"dummy"
"44727",0,1,0,1,"dummy"
"44728",3,0,0,3,"dummy"
"44729",0,0,3,3,"dummy"
"44735",0,0,1,1,"dummy"
"44738",0,12,0,12,"dummy"
"44739",0,2,0,2,"dummy"
"44740",1,1,0,2,"dummy"
"44741",0,2,0,2,"dummy"
"44742",1,4,0,5,"dummy"
"44754",0,2,0,2,"dummy"
"44755",2,11,3,16,"dummy"
"44756",0,0,3,3,"dummy"
"44761",2,5,3,10,"dummy"
"44767",0,0,0,0,"dummy"
"44768",0,0,1,1,"dummy"
"44769",0,0,0,0,"dummy"
"44770",0,0,0,0,"dummy"
"44771",0,0,0,0,"dummy"
"44772",0,0,0,0,"dummy"
"44773",0,0,0,0,"dummy"
"44774",0,0,0,0,"dummy"
"44775",0,1,0,1,"dummy"
"44776",0,0,0,0,"dummy"
"44777",0,0,1,1,"dummy"
"44781",6,21,3,30,"dummy"
"44804",3,0,0,3,"dummy"
"44805",2,4,2,8,"dummy"
"44848",1,0,1,2,"dummy"
"44849",0,0,0,0,"dummy"
"44850",0,1,0,1,"dummy"
"44851",1,1,2,4,"dummy"
"44852",0,0,0,0,"dummy"
"44853",0,1,0,1,"dummy"
"44901",0,0,1,1,"dummy"
"44909",0,0,1,1,"dummy"
"44910",0,0,0,0,"dummy"
"44913",0,1,1,2,"dummy"
"44914",0,0,1,1,"dummy"
"44915",0,0,3,3,"dummy"
"44948",3,4,4,11,"dummy"
"44951",0,3,2,5,"dummy"
"44952",0,1,0,1,"dummy"
"44953",0,0,0,0,"dummy"
"44954",7,0,1,8,"dummy"
"44955",0,0,5,5,"dummy"
"44958",3,4,2,9,"dummy"
"44824",0,0,1,1,"dummy"
"44825",0,2,0,2,"dummy"
"44826",3,3,0,6,"dummy"
"44827",1,0,0,1,"dummy"
"44828",0,2,0,2,"dummy"
"44829",0,0,1,1,"dummy"
"44830",0,0,1,1,"dummy"
"44831",0,1,0,1,"dummy"
"44832",0,2,0,2,"dummy"
"44833",2,2,1,5,"dummy"
"44838",2,1,3,6,"dummy"
"44839",0,0,1,1,"dummy"
"44840",0,0,1,1,"dummy"
"44841",2,6,4,12,"dummy"
"44842",1,2,0,3,"dummy"
"44843",0,2,0,2,"dummy"
"44844",0,0,2,2,"dummy"
"44855",0,1,0,1,"dummy"
"44856",0,3,0,3,"dummy"
"44864",0,0,0,0,"dummy"
"44867",0,0,1,1,"dummy"
"44868",0,0,1,1,"dummy"
"44869",0,2,0,2,"dummy"
"44896",2,7,1,10,"dummy"
"44897",0,0,0,0,"dummy"
"44898",1,1,2,4,"dummy"
"44899",0,1,0,1,"dummy"
"44903",0,1,0,1,"dummy"
"44904",3,4,0,7,"dummy"
"44905",2,0,0,2,"dummy"
"44906",1,2,1,4,"dummy"
"44907",1,0,0,1,"dummy"
"44939",0,0,4,4,"dummy"
"44940",6,3,4,13,"dummy"
"44941",0,2,0,2,"dummy"
"44942",0,1,0,1,"dummy"
"44945",5,7,1,13,"dummy"
"44946",0,0,1,1,"dummy"
"44963",0,1,0,1,"dummy"
"44964",6,3,0,9,"dummy"
"44965",4,3,2,9,"dummy"
"44976",0,5,1,6,"dummy"
"44977",0,2,0,2,"dummy"
"44978",3,3,1,7,"dummy"
"44979",0,0,0,0,"dummy"
"44980",0,0,0,0,"dummy"
"44981",0,0,1,1,"dummy"
"44982",0,0,1,1,"dummy"
"44983",0,0,0,0,"dummy"
"44984",0,0,1,1,"dummy"
"44985",0,0,1,1,"dummy"
"44986",0,0,2,2,"dummy"
"44989",0,2,0,2,"dummy"
"44994",0,0,2,2,"dummy"
"44995",5,5,3,13,"dummy"
"44996",0,1,4,5,"dummy"
"44997",1,0,4,5,"dummy"
"44998",1,5,3,9,"dummy"
"45050",0,1,0,1,"dummy"
"45051",1,0,0,1,"dummy"
"45054",3,6,0,9,"dummy"
"45060",0,0,1,1,"dummy"
"45241",0,0,1,1,"dummy"
"45242",0,1,1,2,"dummy"
"45243",0,0,2,2,"dummy"
"45267",0,4,0,4,"dummy"
"45268",0,2,0,2,"dummy"
"45285",0,1,0,1,"dummy"
"45286",24,16,2,42,"dummy"
"44959",0,0,1,1,"dummy"
"44960",0,0,2,2,"dummy"
"44961",0,0,2,2,"dummy"
"44967",2,0,0,2,"dummy"
"44968",0,1,0,1,"dummy"
"45000",0,2,0,2,"dummy"
"45001",1,0,0,1,"dummy"
"45002",0,2,0,2,"dummy"
"45005",2,4,0,6,"dummy"
"45006",0,2,0,2,"dummy"
"45007",0,2,0,2,"dummy"
"45008",10,2,0,12,"dummy"
"45009",0,2,0,2,"dummy"
"45010",0,0,0,0,"dummy"
"45011",0,0,3,3,"dummy"
"45012",0,5,0,5,"dummy"
"45039",8,12,0,20,"dummy"
"45040",0,3,0,3,"dummy"
"45041",2,4,1,7,"dummy"
"45042",4,0,0,4,"dummy"
"45043",10,3,1,14,"dummy"
"45044",9,6,3,18,"dummy"
"45045",1,1,0,2,"dummy"
"45046",13,0,0,13,"dummy"
"45047",0,0,1,1,"dummy"
"45048",0,4,0,4,"dummy"
"45056",0,1,0,1,"dummy"
"45062",19,4,5,28,"dummy"
"45063",0,0,1,1,"dummy"
"45064",3,0,0,3,"dummy"
"45065",0,2,0,2,"dummy"
"45066",0,0,0,0,"dummy"
"45067",1,1,0,2,"dummy"
"45068",0,1,0,1,"dummy"
"45069",19,34,1,54,"dummy"
"45070",1,0,0,1,"dummy"
"45071",3,0,0,3,"dummy"
"45072",0,1,0,1,"dummy"
"45073",0,20,0,20,"dummy"
"45074",7,2,0,9,"dummy"
"45075",0,1,0,1,"dummy"
"45076",0,1,0,1,"dummy"
"45077",0,1,0,1,"dummy"
"45078",1,1,0,2,"dummy"
"45079",0,0,1,1,"dummy"
"45080",0,0,8,8,"dummy"
"45081",2,0,0,2,"dummy"
"45082",0,1,0,1,"dummy"
"45083",0,1,0,1,"dummy"
"45084",0,2,0,2,"dummy"
"45085",0,0,1,1,"dummy"
"45086",2,1,0,3,"dummy"
"45087",0,0,0,0,"dummy"
"45088",0,0,0,0,"dummy"
"45089",0,0,0,0,"dummy"
"45090",1,2,0,3,"dummy"
"45091",0,1,0,1,"dummy"
"45092",0,4,2,6,"dummy"
"45093",0,0,0,0,"dummy"
"45094",0,1,0,1,"dummy"
"45095",1,0,1,2,"dummy"
"45096",1,2,1,4,"dummy"
"45097",0,0,2,2,"dummy"
"45098",0,1,0,1,"dummy"
"45099",2,0,0,2,"dummy"
"45100",1,0,0,1,"dummy"
"45101",2,1,0,3,"dummy"
"45102",0,0,2,2,"dummy"
"45103",0,1,1,2,"dummy"
"45104",0,1,0,1,"dummy"
"45105",0,1,1,2,"dummy"
"45106",1,0,1,2,"dummy"
"45107",0,1,0,1,"dummy"
"45108",0,0,1,1,"dummy"
"45109",1,1,0,2,"dummy"
"45110",0,0,0,0,"dummy"
"45111",1,0,0,1,"dummy"
"45112",0,1,1,2,"dummy"
"45113",0,0,1,1,"dummy"
"45114",0,0,1,1,"dummy"
"45115",0,0,1,1,"dummy"
"45116",0,0,1,1,"dummy"
"45117",0,0,1,1,"dummy"
"45118",0,0,1,1,"dummy"
"45119",0,0,1,1,"dummy"
"45120",0,0,1,1,"dummy"
"45121",0,0,1,1,"dummy"
"45122",0,0,1,1,"dummy"
"45123",1,1,1,3,"dummy"
"45124",2,0,0,2,"dummy"
"45125",0,3,1,4,"dummy"
"45126",0,1,0,1,"dummy"
"45127",0,1,0,1,"dummy"
"45128",0,1,0,1,"dummy"
"45129",0,0,0,0,"dummy"
"45130",0,1,0,1,"dummy"
"45131",0,0,8,8,"dummy"
"45132",0,0,8,8,"dummy"
"45133",0,0,1,1,"dummy"
"45134",0,1,0,1,"dummy"
"45135",0,1,0,1,"dummy"
"45136",2,0,0,2,"dummy"
"45137",6,1,0,7,"dummy"
"45138",0,0,1,1,"dummy"
"45139",0,1,0,1,"dummy"
"45140",0,0,2,2,"dummy"
"45141",0,0,2,2,"dummy"
"45142",1,0,0,1,"dummy"
"45143",0,3,0,3,"dummy"
"45144",1,1,2,4,"dummy"
"45145",0,1,0,1,"dummy"
"45146",2,2,0,4,"dummy"
"45147",52,1,0,53,"dummy"
"45148",0,0,1,1,"dummy"
"45149",0,1,0,1,"dummy"
"45150",0,6,0,6,"dummy"
"45151",0,1,0,1,"dummy"
"45152",0,1,0,1,"dummy"
"45153",0,0,1,1,"dummy"
"45154",0,2,0,2,"dummy"
"45155",0,1,0,1,"dummy"
"45156",0,0,0,0,"dummy"
"45157",0,0,0,0,"dummy"
"45158",0,0,0,0,"dummy"
"45159",0,1,0,1,"dummy"
"45160",0,1,0,1,"dummy"
"45161",1,1,0,2,"dummy"
"45162",0,0,2,2,"dummy"
"45163",0,1,0,1,"dummy"
"45164",0,0,0,0,"dummy"
"45165",0,2,1,3,"dummy"
"45166",0,0,1,1,"dummy"
"45167",0,0,2,2,"dummy"
"45168",0,1,0,1,"dummy"
"45169",0,0,2,2,"dummy"
"45170",0,1,0,1,"dummy"
"45171",0,0,1,1,"dummy"
"45172",1,1,0,2,"dummy"
"45173",0,0,1,1,"dummy"
"45174",0,0,1,1,"dummy"
"45175",1,2,1,4,"dummy"
"45176",0,0,7,7,"dummy"
"45177",0,0,7,7,"dummy"
"45178",0,1,0,1,"dummy"
"45179",0,0,0,0,"dummy"
"45180",1,1,0,2,"dummy"
"45181",1,1,1,3,"dummy"
"45182",1,1,1,3,"dummy"
"45183",1,1,1,3,"dummy"
"45184",0,0,2,2,"dummy"
"45185",0,0,2,2,"dummy"
"45186",0,0,1,1,"dummy"
"45187",0,0,1,1,"dummy"
"45188",0,0,1,1,"dummy"
"45189",0,1,0,1,"dummy"
"45190",0,0,0,0,"dummy"
"45191",0,0,1,1,"dummy"
"45192",0,0,0,0,"dummy"
"45193",0,1,0,1,"dummy"
"45194",2,0,0,2,"dummy"
"45195",0,0,1,1,"dummy"
"45196",1,0,0,1,"dummy"
"45197",0,0,1,1,"dummy"
"45198",1,6,6,13,"dummy"
"45199",1,0,0,1,"dummy"
"45200",1,0,0,1,"dummy"
"45201",0,2,0,2,"dummy"
"45202",0,1,0,1,"dummy"
"45203",9,10,0,19,"dummy"
"45204",0,0,0,0,"dummy"
"45205",2,2,0,4,"dummy"
"45206",9,9,0,18,"dummy"
"45207",2,2,4,8,"dummy"
"45208",1,1,1,3,"dummy"
"45209",4,0,0,4,"dummy"
"45210",0,0,1,1,"dummy"
"45211",0,0,1,1,"dummy"
"45212",0,0,1,1,"dummy"
"45213",0,1,0,1,"dummy"
"45214",1,0,0,1,"dummy"
"45215",1,7,3,11,"dummy"
"45216",0,0,1,1,"dummy"
"45217",0,0,1,1,"dummy"
"45218",4,0,2,6,"dummy"
"45219",2,0,0,2,"dummy"
"45220",0,1,0,1,"dummy"
"45221",0,0,1,1,"dummy"
"45224",0,1,0,1,"dummy"
"45225",0,0,0,0,"dummy"
"45226",3,2,0,5,"dummy"
"45227",0,1,0,1,"dummy"
"45228",3,1,2,6,"dummy"
"45229",0,0,0,0,"dummy"
"45230",0,1,0,1,"dummy"
"45238",6,0,0,6,"dummy"
"45239",2,5,2,9,"dummy"
"45245",0,2,0,2,"dummy"
"45248",0,0,2,2,"dummy"
"45249",8,4,5,17,"dummy"
"45250",1,4,0,5,"dummy"
"45251",0,0,3,3,"dummy"
"45252",0,0,3,3,"dummy"
"45253",0,0,1,1,"dummy"
"45254",0,0,1,1,"dummy"
"45255",0,0,3,3,"dummy"
"45256",0,4,1,5,"dummy"
"45257",3,0,1,4,"dummy"
"45258",0,0,3,3,"dummy"
"45259",0,0,3,3,"dummy"
"45260",0,0,2,2,"dummy"
"45261",0,0,1,1,"dummy"
"45262",0,0,2,2,"dummy"
"45263",0,0,1,1,"dummy"
"45264",0,0,3,3,"dummy"
"45265",4,3,1,8,"dummy"
"45278",0,3,0,3,"dummy"
"45279",0,0,0,0,"dummy"
"45282",0,2,0,2,"dummy"
"45283",0,1,0,1,"dummy"
"45302",1,2,1,4,"dummy"
"45303",0,0,0,0,"dummy"
"45309",1,1,0,2,"dummy"
"45331",0,0,0,0,"dummy"
"45332",0,1,0,1,"dummy"
"45333",0,1,0,1,"dummy"
"45334",0,0,1,1,"dummy"
"45335",2,2,2,6,"dummy"
"45336",0,0,1,1,"dummy"
"45337",0,1,0,1,"dummy"
"45338",3,11,0,14,"dummy"
"45339",4,1,4,9,"dummy"
"45340",0,0,1,1,"dummy"
"45354",0,0,2,2,"dummy"
"45355",0,4,0,4,"dummy"
"45358",0,0,0,0,"dummy"
"45359",0,0,0,0,"dummy"
"45360",0,0,0,0,"dummy"
"45361",0,0,0,0,"dummy"
"45362",0,0,0,0,"dummy"
"45371",0,0,1,1,"dummy"
"45374",5,7,7,19,"dummy"
"45375",0,1,0,1,"dummy"
"45376",0,0,1,1,"dummy"
"45379",1,3,0,4,"dummy"
"45380",0,0,1,1,"dummy"
"45381",0,0,1,1,"dummy"
"45403",3,3,0,6,"dummy"
"45407",1,0,0,1,"dummy"
"45408",0,0,0,0,"dummy"
"45409",19,21,0,40,"dummy"
"45410",4,5,0,9,"dummy"
"45411",0,1,0,1,"dummy"
"45412",0,2,1,3,"dummy"
"45413",0,2,0,2,"dummy"
"45414",3,0,0,3,"dummy"
"45417",35,35,7,77,"dummy"
"45418",3,11,0,14,"dummy"
"45419",3,3,2,8,"dummy"
"45420",0,4,0,4,"dummy"
"45421",0,3,1,4,"dummy"
"45422",0,0,0,0,"dummy"
"45423",3,3,0,6,"dummy"
"45424",0,0,0,0,"dummy"
"45425",3,3,0,6,"dummy"
"45426",3,3,0,6,"dummy"
"45427",0,0,2,2,"dummy"
"45428",0,1,0,1,"dummy"
"45429",3,3,0,6,"dummy"
"45437",4,1,1,6,"dummy"
"45438",0,0,1,1,"dummy"
"45444",0,1,0,1,"dummy"
"45287",1,12,1,14,"dummy"
"45288",0,2,0,2,"dummy"
"45289",2,2,1,5,"dummy"
"45290",0,1,0,1,"dummy"
"45291",0,0,1,1,"dummy"
"45292",3,1,0,4,"dummy"
"45293",25,2,0,27,"dummy"
"45294",0,1,0,1,"dummy"
"45297",0,0,0,0,"dummy"
"45298",0,0,0,0,"dummy"
"45305",0,1,0,1,"dummy"
"45306",0,2,1,3,"dummy"
"45307",0,1,0,1,"dummy"
"45311",0,1,0,1,"dummy"
"45312",0,0,2,2,"dummy"
"45313",3,3,0,6,"dummy"
"45320",0,0,1,1,"dummy"
"45321",0,0,1,1,"dummy"
"45322",0,0,1,1,"dummy"
"45323",0,0,1,1,"dummy"
"45324",0,0,1,1,"dummy"
"45325",0,0,1,1,"dummy"
"45326",0,0,1,1,"dummy"
"45329",0,2,0,2,"dummy"
"45342",0,1,0,1,"dummy"
"45347",0,2,0,2,"dummy"
"45350",0,2,0,2,"dummy"
"45351",15,4,0,19,"dummy"
"45352",0,3,4,7,"dummy"
"45385",0,0,1,1,"dummy"
"45386",0,0,1,1,"dummy"
"45389",0,3,1,4,"dummy"
"45390",1,2,0,3,"dummy"
"45391",0,2,0,2,"dummy"
"45392",1,2,0,3,"dummy"
"45393",0,1,0,1,"dummy"
"45394",2,0,0,2,"dummy"
"45395",0,2,0,2,"dummy"
"45396",2,0,0,2,"dummy"
"45397",0,1,0,1,"dummy"
"45398",0,5,0,5,"dummy"
"45399",3,6,1,10,"dummy"
"45400",5,2,2,9,"dummy"
"45401",1,1,0,2,"dummy"
"45405",0,1,0,1,"dummy"
"45431",0,0,0,0,"dummy"
"45432",0,0,0,0,"dummy"
"45435",0,0,2,2,"dummy"
"45440",0,1,0,1,"dummy"
"45446",0,0,1,1,"dummy"
"45447",1,1,0,2,"dummy"
"45450",1,2,0,3,"dummy"
"45451",2,2,1,5,"dummy"
"45452",1,6,1,8,"dummy"
"45453",0,1,1,2,"dummy"
"45454",1,0,0,1,"dummy"
"45469",1,1,0,2,"dummy"
"45470",0,0,1,1,"dummy"
"45473",0,1,0,1,"dummy"
"45474",0,1,0,1,"dummy"
"45475",0,0,3,3,"dummy"
"45476",0,1,0,1,"dummy"
"45483",0,7,0,7,"dummy"
"45500",4,0,3,7,"dummy"
"45517",0,9,0,9,"dummy"
"45529",0,4,1,5,"dummy"
"45456",0,0,1,1,"dummy"
"45457",0,0,1,1,"dummy"
"45458",0,0,2,2,"dummy"
"45459",26,3,7,36,"dummy"
"45478",0,1,1,2,"dummy"
"45481",0,1,0,1,"dummy"
"45485",1,0,1,2,"dummy"
"45486",0,7,1,8,"dummy"
"45487",0,1,0,1,"dummy"
"45488",0,0,0,0,"dummy"
"45489",0,1,0,1,"dummy"
"45502",0,2,0,2,"dummy"
"45505",0,0,2,2,"dummy"
"45512",0,0,0,0,"dummy"
"45515",0,1,0,1,"dummy"
"45519",3,0,4,7,"dummy"
"45520",0,2,2,4,"dummy"
"45521",0,0,3,3,"dummy"
"45526",0,0,1,1,"dummy"
"45527",1,0,1,2,"dummy"
"45531",0,4,0,4,"dummy"
"45532",0,4,0,4,"dummy"
"45533",0,3,1,4,"dummy"
"45534",0,1,1,2,"dummy"
"45535",0,0,1,1,"dummy"
"45548",0,0,1,1,"dummy"
"45551",0,0,0,0,"dummy"
"45552",0,1,0,1,"dummy"
"45553",0,1,0,1,"dummy"
"45554",2,1,0,3,"dummy"
"45555",0,0,1,1,"dummy"
"45556",0,1,0,1,"dummy"
"45557",0,1,0,1,"dummy"
"45558",1,2,0,3,"dummy"
"45573",0,1,0,1,"dummy"
"45574",0,1,0,1,"dummy"
"45539",0,0,1,1,"dummy"
"45540",4,10,0,14,"dummy"
"45541",0,1,0,1,"dummy"
"45542",1,3,0,4,"dummy"
"45543",0,1,0,1,"dummy"
"45544",0,2,0,2,"dummy"
"45545",0,0,1,1,"dummy"
"45546",0,0,1,1,"dummy"
"45578",12,1,2,15,"dummy"
"45581",0,0,0,0,"dummy"
"45582",1,1,0,2,"dummy"
"45583",0,0,1,1,"dummy"
"45590",0,0,0,0,"dummy"
"45591",0,1,0,1,"dummy"
"45594",0,0,1,1,"dummy"
"45595",0,1,0,1,"dummy"
"45600",3,11,0,14,"dummy"
"45602",2,0,0,2,"dummy"
"45605",0,1,0,1,"dummy"
"45606",0,1,0,1,"dummy"
"45616",1,1,0,2,"dummy"
"45620",0,0,0,0,"dummy"
"45621",0,2,0,2,"dummy"
"45622",0,0,0,0,"dummy"
"45632",2,0,1,3,"dummy"
"45634",4,1,0,5,"dummy"
"45635",0,0,3,3,"dummy"
"45636",0,6,2,8,"dummy"
"45637",1,4,0,5,"dummy"
"45638",0,3,1,4,"dummy"
"45639",3,0,1,4,"dummy"
"45640",4,0,0,4,"dummy"
"45642",0,2,1,3,"dummy"
"45643",2,3,1,6,"dummy"
"45644",2,0,0,2,"dummy"
"45646",0,0,0,0,"dummy"
"45651",0,3,1,4,"dummy"
"45652",4,1,0,5,"dummy"
"45653",0,4,0,4,"dummy"
"45656",0,4,0,4,"dummy"
"45657",0,0,1,1,"dummy"
"45658",4,0,0,4,"dummy"
"45662",1,0,0,1,"dummy"
"45663",0,0,1,1,"dummy"
"45702",0,0,1,1,"dummy"
"45703",3,4,2,9,"dummy"
"45707",1,0,0,1,"dummy"
"45708",0,1,0,1,"dummy"
"45709",2,2,4,8,"dummy"
"45710",0,0,2,2,"dummy"
"45711",0,1,0,1,"dummy"
"45712",0,5,0,5,"dummy"
"45713",0,1,0,1,"dummy"
"45714",2,8,1,11,"dummy"
"45715",6,7,0,13,"dummy"
"45716",1,0,0,1,"dummy"
"45720",6,3,0,9,"dummy"
"45721",0,1,0,1,"dummy"
"45722",0,2,0,2,"dummy"
"45723",0,2,0,2,"dummy"
"45724",0,2,0,2,"dummy"
"45725",4,2,0,6,"dummy"
"45726",0,0,1,1,"dummy"
"45727",3,6,7,16,"dummy"
"45728",0,0,1,1,"dummy"
"45729",0,0,1,1,"dummy"
"45730",0,1,1,2,"dummy"
"45731",0,0,1,1,"dummy"
"45732",0,0,1,1,"dummy"
"45733",0,0,1,1,"dummy"
"45734",0,0,1,1,"dummy"
"45735",0,0,1,1,"dummy"
"45736",2,6,0,8,"dummy"
"45737",0,0,1,1,"dummy"
"45739",2,2,1,5,"dummy"
"45740",2,4,2,8,"dummy"
"45741",0,0,1,1,"dummy"
"45748",0,3,0,3,"dummy"
"45749",0,0,1,1,"dummy"
"45750",5,0,2,7,"dummy"
"45752",2,1,1,4,"dummy"
"45753",0,0,0,0,"dummy"
"45754",0,0,4,4,"dummy"
"45755",0,0,1,1,"dummy"
"45756",8,7,0,15,"dummy"
"45757",0,0,2,2,"dummy"
"45758",0,0,3,3,"dummy"
"45759",0,0,0,0,"dummy"
"45760",0,0,0,0,"dummy"
"45761",0,0,0,0,"dummy"
"45762",0,0,0,0,"dummy"
"45763",0,0,0,0,"dummy"
"45765",0,0,1,1,"dummy"
"45767",0,7,0,7,"dummy"
"45768",0,1,1,2,"dummy"
"45769",1,1,0,2,"dummy"
"45770",0,7,0,7,"dummy"
"45773",1,3,1,5,"dummy"
"45774",0,0,1,1,"dummy"
"45775",0,0,1,1,"dummy"
"45776",0,0,1,1,"dummy"
"45777",0,0,1,1,"dummy"
"45778",0,0,3,3,"dummy"
"45779",0,0,1,1,"dummy"
"45780",0,0,1,1,"dummy"
"45781",0,0,1,1,"dummy"
"45782",0,0,1,1,"dummy"
"45783",0,0,2,2,"dummy"
"45784",0,0,1,1,"dummy"
"45785",0,0,1,1,"dummy"
"45786",0,0,1,1,"dummy"
"45787",0,0,2,2,"dummy"
"45788",0,0,2,2,"dummy"
"45791",0,3,1,4,"dummy"
"45792",3,11,4,18,"dummy"
"45800",0,0,1,1,"dummy"
"45809",0,3,0,3,"dummy"
"45810",0,6,0,6,"dummy"
"45811",2,3,2,7,"dummy"
"45812",6,6,3,15,"dummy"
"45813",0,1,2,3,"dummy"
"45814",0,2,0,2,"dummy"
"45815",1,9,1,11,"dummy"
"45816",0,1,0,1,"dummy"
"45817",3,0,0,3,"dummy"
"45818",0,2,0,2,"dummy"
"45819",0,1,0,1,"dummy"
"45820",0,1,0,1,"dummy"
"45821",0,1,0,1,"dummy"
"45822",0,1,0,1,"dummy"
"45823",0,1,0,1,"dummy"
"45824",2,2,0,4,"dummy"
"45825",0,4,0,4,"dummy"
"45826",6,4,0,10,"dummy"
"45827",0,4,0,4,"dummy"
"45828",0,7,0,7,"dummy"
"45829",1,2,2,5,"dummy"
"45830",6,10,0,16,"dummy"
"45831",0,2,0,2,"dummy"
"45848",1,0,1,2,"dummy"
"45849",0,1,1,2,"dummy"
"45863",0,2,0,2,"dummy"
"45866",5,5,0,10,"dummy"
"45871",6,5,2,13,"dummy"
"45872",0,3,0,3,"dummy"
"45873",0,0,1,1,"dummy"
"45874",0,0,1,1,"dummy"
"45875",0,2,0,2,"dummy"
"45876",0,0,4,4,"dummy"
"45877",0,1,0,1,"dummy"
"45878",11,2,1,14,"dummy"
"45920",0,0,1,1,"dummy"
"45928",0,2,0,2,"dummy"
"45933",3,0,0,3,"dummy"
"45934",2,2,0,4,"dummy"
"45935",2,3,0,5,"dummy"
"45936",0,0,1,1,"dummy"
"45942",0,0,1,1,"dummy"
"45943",0,0,1,1,"dummy"
"45944",0,0,1,1,"dummy"
"45945",3,1,0,4,"dummy"
"45953",0,0,1,1,"dummy"
"45954",0,1,0,1,"dummy"
"45962",0,1,0,1,"dummy"
"45963",0,1,0,1,"dummy"
"45964",0,1,0,1,"dummy"
"45965",0,0,0,0,"dummy"
"45966",1,2,0,3,"dummy"
"45967",0,2,0,2,"dummy"
"45968",0,0,1,1,"dummy"
"45969",4,1,1,6,"dummy"
"45970",2,3,1,6,"dummy"
"45971",0,1,0,1,"dummy"
"45972",0,0,1,1,"dummy"
"45973",1,2,2,5,"dummy"
"45974",1,1,0,2,"dummy"
"45975",1,0,5,6,"dummy"
"45976",1,1,0,2,"dummy"
"45977",2,1,3,6,"dummy"
"45978",4,0,0,4,"dummy"
"45979",2,1,1,4,"dummy"
"45980",0,0,0,0,"dummy"
"45981",1,2,1,4,"dummy"
"45982",2,1,1,4,"dummy"
"45983",0,1,0,1,"dummy"
"45984",1,3,1,5,"dummy"
"45985",0,0,2,2,"dummy"
"45986",0,1,0,1,"dummy"
"45987",2,0,0,2,"dummy"
"45988",2,2,1,5,"dummy"
"45989",2,4,1,7,"dummy"
"45990",3,3,3,9,"dummy"
"45991",1,0,0,1,"dummy"
"45992",1,0,1,2,"dummy"
"45993",1,1,0,2,"dummy"
"45994",1,4,4,9,"dummy"
"45995",0,3,4,7,"dummy"
"45996",0,1,0,1,"dummy"
"45997",1,1,0,2,"dummy"
"45998",0,1,0,1,"dummy"
"45999",3,0,1,4,"dummy"
"46000",0,1,0,1,"dummy"
"45804",0,1,0,1,"dummy"
"45805",4,5,1,10,"dummy"
"45806",0,0,1,1,"dummy"
"45807",0,0,0,0,"dummy"
"45835",0,0,1,1,"dummy"
"45836",0,0,1,1,"dummy"
"45837",0,1,1,2,"dummy"
"45838",0,1,0,1,"dummy"
"45845",5,0,0,5,"dummy"
"45846",0,0,0,0,"dummy"
"45851",1,4,3,8,"dummy"
"45852",1,1,0,2,"dummy"
"45853",7,0,1,8,"dummy"
"45854",8,20,3,31,"dummy"
"45859",0,0,1,1,"dummy"
"45860",34,9,2,45,"dummy"
"45861",1,0,0,1,"dummy"
"45915",0,0,1,1,"dummy"
"45916",0,1,0,1,"dummy"
"45922",0,1,0,1,"dummy"
"45923",0,1,0,1,"dummy"
"45924",1,1,0,2,"dummy"
"45925",0,1,0,1,"dummy"
"45926",5,7,0,12,"dummy"
"45938",2,5,0,7,"dummy"
"45939",2,12,0,14,"dummy"
"45940",1,0,0,1,"dummy"
"45949",0,0,1,1,"dummy"
"45950",0,1,0,1,"dummy"
"45951",0,1,0,1,"dummy"
"45956",2,1,1,4,"dummy"
"45957",0,1,0,1,"dummy"
"45958",0,0,3,3,"dummy"
"45959",0,0,1,1,"dummy"
"45960",1,1,1,3,"dummy"
"46033",0,1,0,1,"dummy"
"46034",0,0,0,0,"dummy"
"46035",2,9,1,12,"dummy"
"46036",0,0,1,1,"dummy"
"46037",0,0,1,1,"dummy"
"46038",0,0,0,0,"dummy"
"46039",0,23,1,24,"dummy"
"46040",0,0,1,1,"dummy"
"46046",16,2,1,19,"dummy"
"46047",1,0,0,1,"dummy"
"46050",0,1,0,1,"dummy"
"46051",0,0,1,1,"dummy"
"46060",0,1,1,2,"dummy"
"46061",0,1,4,5,"dummy"
"46062",0,0,1,1,"dummy"
"46063",0,0,4,4,"dummy"
"46064",0,0,2,2,"dummy"
"46065",0,0,4,4,"dummy"
"46076",0,3,1,4,"dummy"
"46077",0,4,0,4,"dummy"
"46090",0,0,1,1,"dummy"
"46110",0,1,1,2,"dummy"
"46111",0,1,0,1,"dummy"
"46119",0,3,0,3,"dummy"
"46120",3,3,3,9,"dummy"
"46121",0,2,1,3,"dummy"
"46122",0,1,0,1,"dummy"
"46123",0,0,3,3,"dummy"
"46124",0,1,3,4,"dummy"
"46125",1,1,0,2,"dummy"
"46126",0,0,0,0,"dummy"
"46133",2,0,2,4,"dummy"
"46136",0,0,1,1,"dummy"
"46137",4,20,1,25,"dummy"
"46001",0,1,0,1,"dummy"
"46002",0,1,0,1,"dummy"
"46003",1,1,1,3,"dummy"
"46004",2,1,1,4,"dummy"
"46005",0,3,2,5,"dummy"
"46006",2,0,2,4,"dummy"
"46007",0,0,2,2,"dummy"
"46008",0,0,2,2,"dummy"
"46009",0,0,1,1,"dummy"
"46010",0,1,0,1,"dummy"
"46011",1,2,1,4,"dummy"
"46012",0,2,2,4,"dummy"
"46013",0,1,0,1,"dummy"
"46014",0,1,0,1,"dummy"
"46015",1,0,0,1,"dummy"
"46016",0,1,0,1,"dummy"
"46017",8,1,0,9,"dummy"
"46018",1,2,0,3,"dummy"
"46019",0,1,0,1,"dummy"
"46020",0,2,0,2,"dummy"
"46021",0,1,0,1,"dummy"
"46022",4,4,0,8,"dummy"
"46023",6,0,0,6,"dummy"
"46024",2,6,1,9,"dummy"
"46025",2,0,0,2,"dummy"
"46026",0,2,0,2,"dummy"
"46029",0,3,0,3,"dummy"
"46044",1,0,0,1,"dummy"
"46069",0,3,3,6,"dummy"
"46072",0,2,0,2,"dummy"
"46079",0,1,0,1,"dummy"
"46080",0,6,0,6,"dummy"
"46081",3,17,2,22,"dummy"
"46082",1,2,0,3,"dummy"
"46083",2,1,0,3,"dummy"
"46084",0,1,0,1,"dummy"
"46085",0,1,0,1,"dummy"
"46086",0,1,0,1,"dummy"
"46087",0,2,0,2,"dummy"
"46088",0,1,0,1,"dummy"
"46092",1,3,2,6,"dummy"
"46093",3,1,0,4,"dummy"
"46094",0,0,3,3,"dummy"
"46097",6,1,1,8,"dummy"
"46098",0,2,0,2,"dummy"
"46107",0,2,0,2,"dummy"
"46108",0,0,2,2,"dummy"
"46115",0,3,1,4,"dummy"
"46116",1,1,0,2,"dummy"
"46117",0,0,0,0,"dummy"
"46128",0,1,1,2,"dummy"
"46129",1,1,0,2,"dummy"
"46130",1,2,0,3,"dummy"
"46131",0,1,0,1,"dummy"
"46144",0,4,1,5,"dummy"
"46149",0,0,2,2,"dummy"
"46152",0,5,2,7,"dummy"
"46153",10,11,0,21,"dummy"
"46154",0,1,0,1,"dummy"
"46155",0,0,0,0,"dummy"
"46156",1,6,0,7,"dummy"
"46157",4,0,1,5,"dummy"
"46158",0,7,0,7,"dummy"
"46159",0,7,0,7,"dummy"
"46160",0,0,0,0,"dummy"
"46161",0,0,0,0,"dummy"
"46162",15,3,0,18,"dummy"
"46190",12,8,1,21,"dummy"
"46191",0,2,0,2,"dummy"
"46192",9,6,1,16,"dummy"
"46193",1,0,1,2,"dummy"
"46194",0,1,0,1,"dummy"
"46195",0,0,1,1,"dummy"
"46196",3,3,0,6,"dummy"
"46197",0,1,0,1,"dummy"
"46198",4,4,2,10,"dummy"
"46208",0,1,0,1,"dummy"
"46211",0,4,2,6,"dummy"
"46138",0,3,0,3,"dummy"
"46139",0,0,2,2,"dummy"
"46140",9,6,0,15,"dummy"
"46141",1,4,0,5,"dummy"
"46142",2,3,0,5,"dummy"
"46146",0,1,0,1,"dummy"
"46147",0,1,2,3,"dummy"
"46166",0,1,0,1,"dummy"
"46167",0,0,1,1,"dummy"
"46170",0,1,0,1,"dummy"
"46200",0,0,2,2,"dummy"
"46201",0,0,2,2,"dummy"
"46204",2,2,0,4,"dummy"
"46205",0,0,0,0,"dummy"
"46206",0,5,3,8,"dummy"
"46219",0,0,1,1,"dummy"
"46220",0,1,0,1,"dummy"
"46221",0,0,1,1,"dummy"
"46227",0,0,2,2,"dummy"
"46232",2,5,2,9,"dummy"
"46233",1,0,0,1,"dummy"
"46234",0,1,0,1,"dummy"
"46235",0,0,0,0,"dummy"
"46236",0,0,1,1,"dummy"
"46237",1,1,0,2,"dummy"
"46238",1,1,0,2,"dummy"
"46239",1,1,0,2,"dummy"
"46251",0,3,1,4,"dummy"
"46252",0,0,1,1,"dummy"
"46253",1,2,3,6,"dummy"
"46254",2,0,0,2,"dummy"
"46257",1,0,1,2,"dummy"
"46258",0,1,0,1,"dummy"
"46259",0,6,2,8,"dummy"
"46260",0,1,0,1,"dummy"
"46274",0,0,0,0,"dummy"
"46275",0,0,0,0,"dummy"
"46288",0,0,1,1,"dummy"
"46289",0,0,1,1,"dummy"
"46290",0,0,2,2,"dummy"
"46291",26,3,7,36,"dummy"
"46294",2,8,5,15,"dummy"
"46297",0,2,0,2,"dummy"
"46298",3,4,0,7,"dummy"
"46299",2,4,0,6,"dummy"
"46303",0,1,0,1,"dummy"
"46314",0,0,1,1,"dummy"
"46315",0,0,1,1,"dummy"
"46316",0,0,2,2,"dummy"
"46317",0,0,1,1,"dummy"
"46318",0,0,1,1,"dummy"
"46319",0,0,1,1,"dummy"
"46323",0,0,4,4,"dummy"
"46324",1,0,0,1,"dummy"
"46325",6,4,1,11,"dummy"
"46326",2,0,0,2,"dummy"
"46327",1,3,0,4,"dummy"
"46328",1,1,0,2,"dummy"
"46329",1,1,0,2,"dummy"
"46330",0,0,0,0,"dummy"
"46331",0,3,0,3,"dummy"
"46332",0,1,2,3,"dummy"
"46333",8,1,1,10,"dummy"
"46334",0,0,1,1,"dummy"
"46335",0,1,1,2,"dummy"
"46336",0,0,1,1,"dummy"
"46337",0,0,1,1,"dummy"
"46338",1,2,1,4,"dummy"
"46339",2,1,1,4,"dummy"
"46340",0,0,1,1,"dummy"
"46341",0,0,1,1,"dummy"
"46342",0,0,1,1,"dummy"
"46343",0,1,0,1,"dummy"
"46212",2,0,0,2,"dummy"
"46213",0,2,0,2,"dummy"
"46214",0,0,1,1,"dummy"
"46215",0,4,2,6,"dummy"
"46216",1,0,2,3,"dummy"
"46217",2,8,0,10,"dummy"
"46225",2,2,4,8,"dummy"
"46241",0,3,1,4,"dummy"
"46242",0,0,1,1,"dummy"
"46243",2,3,0,5,"dummy"
"46244",3,2,0,5,"dummy"
"46245",2,3,0,5,"dummy"
"46262",7,1,1,9,"dummy"
"46263",0,1,0,1,"dummy"
"46264",2,1,0,3,"dummy"
"46265",0,0,0,0,"dummy"
"46266",0,0,1,1,"dummy"
"46267",0,1,0,1,"dummy"
"46268",0,0,1,1,"dummy"
"46269",0,0,0,0,"dummy"
"46270",0,0,1,1,"dummy"
"46271",1,0,0,1,"dummy"
"46272",0,0,0,0,"dummy"
"46301",2,0,3,5,"dummy"
"46305",0,1,1,2,"dummy"
"46306",1,0,1,2,"dummy"
"46307",1,3,1,5,"dummy"
"46312",0,7,0,7,"dummy"
"46321",0,2,0,2,"dummy"
"46353",3,3,0,6,"dummy"
"46385",0,0,1,1,"dummy"
"46386",0,1,2,3,"dummy"
"46389",0,2,0,2,"dummy"
"46405",0,0,1,1,"dummy"
"46406",0,0,1,1,"dummy"
"46407",0,0,1,1,"dummy"
"46408",0,0,1,1,"dummy"
"46409",0,0,1,1,"dummy"
"46410",0,0,1,1,"dummy"
"46411",0,0,1,1,"dummy"
"46431",0,0,1,1,"dummy"
"46432",0,1,0,1,"dummy"
"46433",1,0,0,1,"dummy"
"46434",0,0,1,1,"dummy"
"46435",9,8,1,18,"dummy"
"46436",1,0,1,2,"dummy"
"46437",1,0,0,1,"dummy"
"46440",0,0,2,2,"dummy"
"46441",2,2,0,4,"dummy"
"46442",14,2,0,16,"dummy"
"46443",4,1,0,5,"dummy"
"46444",20,18,0,38,"dummy"
"46445",0,0,1,1,"dummy"
"46457",0,0,1,1,"dummy"
"46344",0,0,1,1,"dummy"
"46345",0,0,1,1,"dummy"
"46346",1,0,1,2,"dummy"
"46347",0,0,0,0,"dummy"
"46348",0,0,1,1,"dummy"
"46349",0,0,1,1,"dummy"
"46350",0,0,1,1,"dummy"
"46351",0,4,0,4,"dummy"
"46355",1,1,4,6,"dummy"
"46356",0,0,4,4,"dummy"
"46357",0,2,0,2,"dummy"
"46358",0,0,1,1,"dummy"
"46359",0,2,0,2,"dummy"
"46360",0,0,0,0,"dummy"
"46361",6,8,6,20,"dummy"
"46362",9,11,2,22,"dummy"
"46363",0,0,1,1,"dummy"
"46364",0,0,1,1,"dummy"
"46365",0,0,1,1,"dummy"
"46372",0,0,0,0,"dummy"
"46422",0,0,1,1,"dummy"
"46423",0,0,0,0,"dummy"
"46424",0,1,0,1,"dummy"
"46425",0,0,1,1,"dummy"
"46426",0,0,2,2,"dummy"
"46427",0,0,2,2,"dummy"
"46428",0,0,0,0,"dummy"
"46429",0,0,0,0,"dummy"
"46452",0,1,0,1,"dummy"
"46453",53,1,0,54,"dummy"
"46454",0,0,0,0,"dummy"
"46455",0,0,1,1,"dummy"
"46598",0,1,0,1,"dummy"
"46604",0,2,1,3,"dummy"
"46607",0,0,2,2,"dummy"
"46608",5,5,2,12,"dummy"
"46622",0,1,0,1,"dummy"
"46643",0,1,0,1,"dummy"
"46644",0,0,0,0,"dummy"
"46660",0,0,1,1,"dummy"
"46661",0,0,1,1,"dummy"
"46669",0,1,0,1,"dummy"
"46670",1,1,0,2,"dummy"
"46671",0,0,1,1,"dummy"
"46672",0,1,0,1,"dummy"
"46673",2,0,0,2,"dummy"
"46674",1,0,0,1,"dummy"
"46675",0,0,2,2,"dummy"
"46676",0,3,0,3,"dummy"
"46677",2,0,0,2,"dummy"
"46678",0,2,0,2,"dummy"
"46679",3,0,0,3,"dummy"
"46683",0,5,0,5,"dummy"
"46684",0,1,0,1,"dummy"
"46699",0,0,0,0,"dummy"
"46700",0,0,0,0,"dummy"
"46701",0,0,1,1,"dummy"
"46702",3,3,1,7,"dummy"
"46703",0,0,0,0,"dummy"
"46706",0,3,0,3,"dummy"
"46709",0,0,1,1,"dummy"
"46723",7,7,1,15,"dummy"
"46742",1,18,1,20,"dummy"
"46511",4,0,0,4,"dummy"
"46512",0,0,0,0,"dummy"
"46513",0,0,0,0,"dummy"
"46514",0,0,0,0,"dummy"
"46515",0,7,0,7,"dummy"
"46516",1,0,0,1,"dummy"
"46517",1,1,0,2,"dummy"
"46518",0,1,0,1,"dummy"
"46519",0,0,1,1,"dummy"
"46520",1,2,0,3,"dummy"
"46521",1,1,0,2,"dummy"
"46522",1,1,0,2,"dummy"
"46523",5,6,0,11,"dummy"
"46524",1,2,0,3,"dummy"
"46525",0,1,0,1,"dummy"
"46526",3,4,0,7,"dummy"
"46527",0,0,0,0,"dummy"
"46528",0,4,0,4,"dummy"
"46529",1,0,1,2,"dummy"
"46530",0,0,1,1,"dummy"
"46531",0,0,1,1,"dummy"
"46532",1,1,0,2,"dummy"
"46533",0,0,1,1,"dummy"
"46534",0,2,0,2,"dummy"
"46535",1,0,0,1,"dummy"
"46536",0,0,1,1,"dummy"
"46537",0,0,1,1,"dummy"
"46538",1,2,0,3,"dummy"
"46539",1,1,1,3,"dummy"
"46540",0,0,1,1,"dummy"
"46541",2,0,1,3,"dummy"
"46542",4,5,0,9,"dummy"
"46543",0,1,0,1,"dummy"
"46544",0,0,1,1,"dummy"
"46545",1,2,0,3,"dummy"
"46546",0,0,2,2,"dummy"
"46547",0,0,2,2,"dummy"
"46548",3,0,0,3,"dummy"
"46549",3,2,1,6,"dummy"
"46550",0,5,0,5,"dummy"
"46551",0,0,1,1,"dummy"
"46552",0,2,0,2,"dummy"
"46553",2,1,0,3,"dummy"
"46554",0,1,0,1,"dummy"
"46555",0,2,0,2,"dummy"
"46556",0,1,2,3,"dummy"
"46557",0,0,0,0,"dummy"
"46558",12,1,0,13,"dummy"
"46561",0,2,1,3,"dummy"
"46562",2,3,2,7,"dummy"
"46590",4,1,0,5,"dummy"
"46591",1,0,0,1,"dummy"
"46592",0,4,0,4,"dummy"
"46593",0,0,0,0,"dummy"
"46594",0,0,0,0,"dummy"
"46595",5,0,0,5,"dummy"
"46596",2,0,0,2,"dummy"
"46600",0,0,1,1,"dummy"
"46601",0,2,0,2,"dummy"
"46602",0,2,0,2,"dummy"
"46612",1,7,2,10,"dummy"
"46613",1,0,0,1,"dummy"
"46616",2,4,0,6,"dummy"
"46617",0,2,0,2,"dummy"
"46618",0,2,0,2,"dummy"
"46619",10,2,0,12,"dummy"
"46620",0,2,0,2,"dummy"
"46624",0,1,0,1,"dummy"
"46625",0,1,0,1,"dummy"
"46626",0,0,0,0,"dummy"
"46627",0,0,0,0,"dummy"
"46628",0,1,0,1,"dummy"
"46631",1,30,4,35,"dummy"
"46632",0,1,0,1,"dummy"
"46633",1,1,0,2,"dummy"
"46634",1,1,0,2,"dummy"
"46635",0,2,0,2,"dummy"
"46636",1,4,1,6,"dummy"
"46637",0,0,1,1,"dummy"
"46646",0,0,1,1,"dummy"
"46647",1,1,0,2,"dummy"
"46648",5,0,0,5,"dummy"
"46649",2,0,0,2,"dummy"
"46650",2,6,0,8,"dummy"
"46651",5,0,0,5,"dummy"
"46652",10,4,3,17,"dummy"
"46653",4,10,3,17,"dummy"
"46654",8,4,2,14,"dummy"
"46655",1,0,0,1,"dummy"
"46656",1,0,1,2,"dummy"
"46663",0,0,1,1,"dummy"
"46664",0,4,0,4,"dummy"
"46665",0,9,2,11,"dummy"
"46666",2,0,0,2,"dummy"
"46667",2,1,0,3,"dummy"
"46681",0,0,2,2,"dummy"
"46686",1,6,2,9,"dummy"
"46687",6,1,0,7,"dummy"
"46713",0,1,1,2,"dummy"
"46714",0,0,1,1,"dummy"
"46715",0,0,1,1,"dummy"
"46716",0,0,1,1,"dummy"
"46717",0,0,1,1,"dummy"
"46718",0,0,1,1,"dummy"
"46719",0,0,1,1,"dummy"
"46720",0,1,0,1,"dummy"
"46721",0,0,1,1,"dummy"
"46727",0,11,0,11,"dummy"
"46728",2,14,5,21,"dummy"
"46729",0,2,0,2,"dummy"
"46730",6,20,1,27,"dummy"
"46731",0,2,2,4,"dummy"
"46732",14,6,2,22,"dummy"
"46733",0,0,1,1,"dummy"
"46734",0,0,0,0,"dummy"
"46735",0,2,0,2,"dummy"
"46736",8,2,2,12,"dummy"
"46737",0,0,1,1,"dummy"
"46738",1,0,0,1,"dummy"
"46749",0,2,1,3,"dummy"
"46750",0,0,0,0,"dummy"
"46755",0,0,0,0,"dummy"
"46756",0,0,1,1,"dummy"
"46757",0,2,0,2,"dummy"
"46760",1,0,0,1,"dummy"
"46761",0,1,1,2,"dummy"
"46762",2,35,2,39,"dummy"
"46763",7,3,5,15,"dummy"
"46769",0,0,1,1,"dummy"
"46772",0,0,1,1,"dummy"
"46773",0,0,1,1,"dummy"
"46774",0,0,1,1,"dummy"
"46775",3,2,0,5,"dummy"
"46776",1,3,0,4,"dummy"
"46777",0,0,1,1,"dummy"
"46778",0,0,1,1,"dummy"
"46779",0,0,1,1,"dummy"
"46780",0,0,1,1,"dummy"
"46781",0,0,1,1,"dummy"
"46782",0,0,1,1,"dummy"
"46783",0,0,3,3,"dummy"
"46784",0,0,2,2,"dummy"
"46785",0,0,1,1,"dummy"
"46786",0,0,1,1,"dummy"
"46787",0,0,1,1,"dummy"
"46788",0,0,1,1,"dummy"
"46789",0,0,1,1,"dummy"
"46790",0,0,1,1,"dummy"
"46791",0,0,1,1,"dummy"
"46792",0,0,1,1,"dummy"
"46793",0,0,1,1,"dummy"
"46794",0,0,1,1,"dummy"
"46795",0,0,1,1,"dummy"
"46796",0,0,1,1,"dummy"
"46797",0,0,1,1,"dummy"
"46798",0,0,1,1,"dummy"
"46799",0,0,1,1,"dummy"
"46800",0,0,1,1,"dummy"
"46801",0,0,1,1,"dummy"
"46802",0,0,1,1,"dummy"
"46803",0,0,1,1,"dummy"
"46804",0,0,1,1,"dummy"
"46805",0,0,1,1,"dummy"
"46806",0,0,1,1,"dummy"
"46807",0,0,1,1,"dummy"
"46808",0,0,1,1,"dummy"
"46809",0,0,1,1,"dummy"
"46810",0,0,1,1,"dummy"
"46811",0,0,1,1,"dummy"
"46812",0,0,1,1,"dummy"
"46813",0,0,1,1,"dummy"
"46814",0,0,1,1,"dummy"
"46743",1,3,1,5,"dummy"
"46744",0,0,0,0,"dummy"
"46745",4,0,0,4,"dummy"
"46752",0,0,0,0,"dummy"
"46753",0,0,0,0,"dummy"
"46765",0,0,1,1,"dummy"
"46859",6,3,2,11,"dummy"
"46860",0,0,2,2,"dummy"
"46861",0,0,2,2,"dummy"
"46865",2,1,3,6,"dummy"
"46879",1,1,0,2,"dummy"
"46880",1,1,1,3,"dummy"
"46881",1,2,1,4,"dummy"
"46882",1,5,2,8,"dummy"
"46883",0,1,0,1,"dummy"
"46892",0,1,0,1,"dummy"
"46895",0,2,2,4,"dummy"
"46815",0,0,1,1,"dummy"
"46816",0,0,1,1,"dummy"
"46817",0,0,1,1,"dummy"
"46818",0,0,1,1,"dummy"
"46819",0,0,1,1,"dummy"
"46820",0,0,1,1,"dummy"
"46821",0,0,1,1,"dummy"
"46822",0,0,1,1,"dummy"
"46823",0,0,1,1,"dummy"
"46824",0,0,1,1,"dummy"
"46825",0,0,1,1,"dummy"
"46826",0,0,1,1,"dummy"
"46827",0,0,1,1,"dummy"
"46828",0,0,1,1,"dummy"
"46829",0,0,1,1,"dummy"
"46830",0,0,1,1,"dummy"
"46831",0,0,1,1,"dummy"
"46832",0,0,1,1,"dummy"
"46833",0,0,1,1,"dummy"
"46834",0,0,1,1,"dummy"
"46835",0,0,1,1,"dummy"
"46836",0,0,1,1,"dummy"
"46837",0,0,1,1,"dummy"
"46838",0,0,1,1,"dummy"
"46839",0,0,1,1,"dummy"
"46840",0,0,1,1,"dummy"
"46841",0,0,1,1,"dummy"
"46842",0,0,1,1,"dummy"
"46843",0,0,1,1,"dummy"
"46844",0,0,1,1,"dummy"
"46845",0,0,1,1,"dummy"
"46846",0,0,1,1,"dummy"
"46847",0,0,1,1,"dummy"
"46848",0,0,1,1,"dummy"
"46849",0,0,1,1,"dummy"
"46850",0,0,1,1,"dummy"
"46851",0,0,1,1,"dummy"
"46852",0,0,1,1,"dummy"
"46853",0,0,1,1,"dummy"
"46854",0,0,1,1,"dummy"
"46855",0,0,1,1,"dummy"
"46863",0,1,1,2,"dummy"
"46867",2,2,0,4,"dummy"
"46868",0,1,0,1,"dummy"
"46869",1,0,0,1,"dummy"
"46870",2,0,0,2,"dummy"
"46871",0,0,1,1,"dummy"
"46872",0,1,0,1,"dummy"
"46873",0,0,1,1,"dummy"
"46874",0,2,0,2,"dummy"
"46875",0,0,1,1,"dummy"
"46876",0,1,0,1,"dummy"
"46877",0,0,1,1,"dummy"
"46918",0,1,0,1,"dummy"
"46919",0,2,0,2,"dummy"
"46924",0,0,1,1,"dummy"
"46926",10,10,2,22,"dummy"
"46931",0,2,0,2,"dummy"
"46932",0,1,1,2,"dummy"
"46934",3,4,2,9,"dummy"
"46944",0,1,0,1,"dummy"
"46945",0,4,1,5,"dummy"
"46946",0,6,0,6,"dummy"
"46947",0,2,0,2,"dummy"
"46951",0,1,0,1,"dummy"
"46952",6,5,1,12,"dummy"
"46954",18,36,3,57,"dummy"
"46955",3,4,0,7,"dummy"
"46956",0,9,0,9,"dummy"
"46957",0,0,1,1,"dummy"
"46958",0,0,1,1,"dummy"
"46959",0,4,0,4,"dummy"
"46960",0,0,0,0,"dummy"
"46961",0,1,0,1,"dummy"
"46962",0,1,0,1,"dummy"
"46966",0,1,0,1,"dummy"
"46968",0,1,0,1,"dummy"
"46970",3,0,3,6,"dummy"
"46971",0,0,1,1,"dummy"
"46972",1,0,0,1,"dummy"
"46973",0,0,1,1,"dummy"
"46974",0,0,1,1,"dummy"
"46977",0,4,0,4,"dummy"
"46978",0,1,0,1,"dummy"
"46979",0,0,0,0,"dummy"
"46982",2,2,0,4,"dummy"
"46984",1,0,0,1,"dummy"
"46985",3,15,2,20,"dummy"
"46986",0,2,0,2,"dummy"
"46987",2,8,1,11,"dummy"
"46988",0,3,0,3,"dummy"
"46989",0,0,0,0,"dummy"
"46990",15,3,1,19,"dummy"
"46991",0,0,1,1,"dummy"
"46994",0,4,0,4,"dummy"
"46995",0,0,1,1,"dummy"
"46996",1,1,1,3,"dummy"
"46997",0,0,1,1,"dummy"
"46998",0,0,1,1,"dummy"
"46999",0,0,1,1,"dummy"
"47000",3,1,0,4,"dummy"
"47001",0,0,1,1,"dummy"
"47002",0,0,1,1,"dummy"
"47003",0,0,1,1,"dummy"
"47004",6,0,0,6,"dummy"
"47005",0,0,1,1,"dummy"
"47011",0,0,1,1,"dummy"
"47013",0,0,0,0,"dummy"
"47014",0,0,0,0,"dummy"
"47016",0,0,1,1,"dummy"
"47019",0,5,0,5,"dummy"
"47020",0,1,0,1,"dummy"
"47021",0,0,0,0,"dummy"
"47022",0,10,0,10,"dummy"
"47023",0,0,0,0,"dummy"
"47028",0,0,0,0,"dummy"
"47031",1,1,0,2,"dummy"
"47032",0,0,0,0,"dummy"
"47033",0,0,1,1,"dummy"
"47036",0,0,2,2,"dummy"
"47041",2,4,0,6,"dummy"
"47042",0,2,0,2,"dummy"
"47043",0,2,0,2,"dummy"
"47044",10,2,0,12,"dummy"
"47045",0,2,0,2,"dummy"
"47046",0,0,0,0,"dummy"
"47047",0,0,3,3,"dummy"
"47048",0,5,0,5,"dummy"
"47049",1,0,1,2,"dummy"
"47054",0,1,0,1,"dummy"
"47057",0,0,1,1,"dummy"
"47058",0,0,1,1,"dummy"
"47062",0,0,1,1,"dummy"
"47066",0,1,0,1,"dummy"
"47067",1,0,0,1,"dummy"
"47068",0,1,0,1,"dummy"
"47069",0,1,0,1,"dummy"
"47070",2,3,1,6,"dummy"
"47071",0,0,1,1,"dummy"
"47072",0,0,1,1,"dummy"
"47073",0,0,1,1,"dummy"
"47074",0,0,1,1,"dummy"
"47075",0,1,1,2,"dummy"
"47076",0,0,1,1,"dummy"
"47077",0,0,1,1,"dummy"
"47080",5,2,1,8,"dummy"
"47081",8,8,0,16,"dummy"
"47084",0,3,0,3,"dummy"
"47085",0,0,0,0,"dummy"
"47086",5,9,2,16,"dummy"
"47087",0,1,0,1,"dummy"
"47089",0,0,0,0,"dummy"
"47092",1,1,0,2,"dummy"
"47093",0,0,0,0,"dummy"
"47094",0,0,0,0,"dummy"
"47095",0,2,1,3,"dummy"
"47096",0,0,0,0,"dummy"
"47097",0,0,1,1,"dummy"
"47098",0,1,0,1,"dummy"
"47099",4,4,0,8,"dummy"
"47100",1,1,1,3,"dummy"
"47103",0,1,0,1,"dummy"
"47104",1,6,1,8,"dummy"
"47105",5,3,0,8,"dummy"
"47106",1,3,1,5,"dummy"
"47107",1,1,0,2,"dummy"
"47108",0,6,2,8,"dummy"
"47109",0,0,1,1,"dummy"
"47110",1,1,0,2,"dummy"
"47111",0,0,1,1,"dummy"
"47113",0,3,0,3,"dummy"
"47116",1,3,1,5,"dummy"
"47117",0,1,0,1,"dummy"
"47125",0,3,0,3,"dummy"
"47126",8,2,0,10,"dummy"
"47127",1,2,1,4,"dummy"
"47128",0,2,0,2,"dummy"
"47129",4,0,2,6,"dummy"
"47131",0,1,3,4,"dummy"
"47133",2,2,0,4,"dummy"
"47134",5,3,4,12,"dummy"
"47135",0,1,0,1,"dummy"
"47136",7,0,0,7,"dummy"
"47137",0,4,0,4,"dummy"
"47138",5,8,3,16,"dummy"
"47140",2,5,2,9,"dummy"
"47142",0,0,1,1,"dummy"
"47143",0,0,1,1,"dummy"
"47145",0,1,0,1,"dummy"
"47146",0,0,1,1,"dummy"
"47148",0,1,0,1,"dummy"
"47149",1,3,0,4,"dummy"
"47150",0,5,1,6,"dummy"
"47151",0,3,0,3,"dummy"
"47152",0,3,0,3,"dummy"
"47153",0,2,0,2,"dummy"
"47155",0,1,0,1,"dummy"
"47156",0,0,2,2,"dummy"
"47157",0,1,0,1,"dummy"
"47158",3,5,0,8,"dummy"
"47159",7,5,5,17,"dummy"
"47160",2,1,0,3,"dummy"
"47161",1,0,2,3,"dummy"
"47162",5,2,1,8,"dummy"
"47163",0,1,0,1,"dummy"
"47164",0,1,0,1,"dummy"
"47166",2,5,2,9,"dummy"
"47168",2,4,0,6,"dummy"
"47169",0,2,0,2,"dummy"
"47170",0,2,0,2,"dummy"
"47171",10,2,0,12,"dummy"
"47172",0,2,0,2,"dummy"
"47176",6,0,4,10,"dummy"
"47177",1,0,0,1,"dummy"
"47180",0,0,1,1,"dummy"
"47188",2,0,2,4,"dummy"
"47191",0,2,3,5,"dummy"
"47192",0,3,0,3,"dummy"
"47193",3,0,1,4,"dummy"
"47194",0,0,1,1,"dummy"
"47195",11,3,1,15,"dummy"
"47249",0,0,0,0,"dummy"
"47252",0,0,1,1,"dummy"
"47253",2,0,0,2,"dummy"
"47254",0,0,1,1,"dummy"
"47255",0,1,0,1,"dummy"
"47256",2,0,0,2,"dummy"
"47257",0,0,1,1,"dummy"
"47258",5,2,1,8,"dummy"
"47259",0,1,0,1,"dummy"
"47260",2,12,0,14,"dummy"
"47261",15,10,3,28,"dummy"
"47290",0,1,1,2,"dummy"
"47291",0,1,0,1,"dummy"
"47293",0,2,0,2,"dummy"
"47294",0,0,1,1,"dummy"
"47297",0,0,1,1,"dummy"
"47298",2,4,1,7,"dummy"
"47305",0,0,1,1,"dummy"
"47314",0,0,1,1,"dummy"
"47315",0,2,0,2,"dummy"
"47316",3,3,3,9,"dummy"
"47357",1,0,0,1,"dummy"
"47359",10,9,2,21,"dummy"
"47360",0,1,0,1,"dummy"
"47361",0,1,0,1,"dummy"
"47363",0,1,0,1,"dummy"
"47364",4,0,5,9,"dummy"
"47365",0,0,2,2,"dummy"
"47366",0,0,4,4,"dummy"
"47367",0,1,1,2,"dummy"
"47368",0,0,3,3,"dummy"
"47369",0,10,6,16,"dummy"
"47370",0,0,1,1,"dummy"
"47371",0,0,1,1,"dummy"
"47372",0,0,1,1,"dummy"
"47373",0,1,0,1,"dummy"
"47375",5,9,2,16,"dummy"
"47376",4,1,1,6,"dummy"
"47456",4,0,0,4,"dummy"
"47457",0,4,0,4,"dummy"
"47466",0,0,1,1,"dummy"
"47467",0,1,0,1,"dummy"
"47470",0,1,0,1,"dummy"
"47471",0,0,0,0,"dummy"
"47472",2,3,0,5,"dummy"
"47473",0,0,1,1,"dummy"
"47476",0,1,0,1,"dummy"
"47477",1,0,0,1,"dummy"
"47478",0,2,1,3,"dummy"
"47479",0,8,0,8,"dummy"
"47480",0,0,1,1,"dummy"
"47481",1,1,0,2,"dummy"
"47483",0,0,0,0,"dummy"
"47484",3,2,0,5,"dummy"
"47485",0,0,1,1,"dummy"
"47492",0,2,0,2,"dummy"
"47493",0,1,2,3,"dummy"
"47494",0,13,0,13,"dummy"
"47495",0,0,1,1,"dummy"
"47496",0,0,1,1,"dummy"
"47497",8,0,0,8,"dummy"
"47498",0,4,0,4,"dummy"
"47499",1,0,0,1,"dummy"
"47500",0,3,0,3,"dummy"
"47501",1,2,1,4,"dummy"
"47502",0,0,0,0,"dummy"
"47503",1,4,0,5,"dummy"
"47504",5,11,0,16,"dummy"
"47505",11,0,0,11,"dummy"
"47506",1,1,0,2,"dummy"
"47508",0,1,0,1,"dummy"
"47509",0,2,0,2,"dummy"
"47510",0,0,1,1,"dummy"
"47511",1,0,1,2,"dummy"
"47512",0,0,1,1,"dummy"
"47513",0,0,1,1,"dummy"
"47515",0,0,0,0,"dummy"
"47517",0,2,1,3,"dummy"
"47518",3,3,0,6,"dummy"
"47521",0,0,0,0,"dummy"
"47524",0,0,1,1,"dummy"
"47525",0,0,1,1,"dummy"
"47526",0,0,1,1,"dummy"
"47527",2,0,6,8,"dummy"
"47528",0,0,1,1,"dummy"
"47529",0,0,1,1,"dummy"
"47530",0,0,1,1,"dummy"
"47531",0,0,1,1,"dummy"
"47534",0,0,0,0,"dummy"
"47535",0,3,0,3,"dummy"
"47538",0,1,1,2,"dummy"
"47539",0,2,1,3,"dummy"
"47540",2,5,0,7,"dummy"
"47541",0,2,0,2,"dummy"
"47543",0,0,2,2,"dummy"
"47545",6,0,0,6,"dummy"
"47546",2,5,2,9,"dummy"
"47548",0,1,3,4,"dummy"
"47549",1,4,2,7,"dummy"
"47550",7,10,1,18,"dummy"
"47552",0,0,1,1,"dummy"
"47554",0,0,1,1,"dummy"
"47562",8,0,1,9,"dummy"
"47563",0,0,1,1,"dummy"
"47565",0,0,3,3,"dummy"
"47607",3,7,10,20,"dummy"
"47608",0,0,0,0,"dummy"
"47609",7,13,17,37,"dummy"
"47610",0,0,1,1,"dummy"
"47611",0,0,1,1,"dummy"
"47612",1,0,0,1,"dummy"
"47613",0,2,0,2,"dummy"
"47614",0,0,0,0,"dummy"
"47615",0,1,1,2,"dummy"
"47617",0,0,0,0,"dummy"
"47618",4,3,1,8,"dummy"
"47619",1,0,0,1,"dummy"
"47620",0,1,0,1,"dummy"
"47624",0,0,1,1,"dummy"
"47625",0,0,1,1,"dummy"
"47626",0,0,1,1,"dummy"
"47627",0,0,1,1,"dummy"
"47628",0,0,1,1,"dummy"
"47629",0,0,0,0,"dummy"
"47630",0,0,1,1,"dummy"
"47631",0,0,1,1,"dummy"
"47632",0,0,1,1,"dummy"
"47636",0,1,0,1,"dummy"
"47637",0,0,1,1,"dummy"
"47639",0,1,0,1,"dummy"
"47645",1,4,2,7,"dummy"
"47646",0,0,1,1,"dummy"
"47647",0,0,1,1,"dummy"
"47648",0,0,1,1,"dummy"
"47649",0,1,1,2,"dummy"
"47650",0,0,1,1,"dummy"
"47651",0,0,1,1,"dummy"
"47652",0,0,1,1,"dummy"
"47653",0,0,1,1,"dummy"
"47657",0,1,1,2,"dummy"
"47658",0,0,3,3,"dummy"
"47659",0,2,1,3,"dummy"
"47660",0,0,2,2,"dummy"
"47663",0,1,0,1,"dummy"
"47665",5,1,2,8,"dummy"
"47666",1,0,0,1,"dummy"
"47675",1,2,2,5,"dummy"
"47676",2,8,0,10,"dummy"
"47677",1,10,1,12,"dummy"
"47691",12,2,0,14,"dummy"
"47692",1,3,1,5,"dummy"
"47693",0,6,1,7,"dummy"
"47694",1,1,0,2,"dummy"
"47695",1,3,1,5,"dummy"
"47696",3,13,0,16,"dummy"
"47697",0,7,1,8,"dummy"
"47698",0,0,1,1,"dummy"
"47699",10,13,3,26,"dummy"
"47700",2,4,0,6,"dummy"
"47701",0,1,1,2,"dummy"
"47702",11,3,0,14,"dummy"
"47703",6,8,1,15,"dummy"
"47704",2,0,1,3,"dummy"
"47705",0,0,1,1,"dummy"
"47706",0,1,0,1,"dummy"
"47707",0,0,2,2,"dummy"
"47708",0,1,2,3,"dummy"
"47710",0,0,1,1,"dummy"
"47711",1,1,1,3,"dummy"
"47713",0,2,0,2,"dummy"
"47717",0,2,0,2,"dummy"
"47719",0,5,1,6,"dummy"
"47720",0,0,1,1,"dummy"
"47724",2,5,1,8,"dummy"
"47725",1,0,0,1,"dummy"
"47726",14,4,0,18,"dummy"
"47727",0,0,0,0,"dummy"
"47728",0,1,0,1,"dummy"
"47729",0,0,0,0,"dummy"
"47730",9,6,0,15,"dummy"
"47731",27,11,1,39,"dummy"
"47732",0,0,1,1,"dummy"
"47740",0,5,0,5,"dummy"
"47741",0,2,0,2,"dummy"
"47746",1,2,0,3,"dummy"
"47747",0,1,0,1,"dummy"
"47748",0,4,0,4,"dummy"
"47749",0,0,1,1,"dummy"
"47750",1,0,0,1,"dummy"
"47751",1,1,0,2,"dummy"
"47752",4,0,0,4,"dummy"
"47753",2,0,0,2,"dummy"
"47754",3,12,0,15,"dummy"
"47755",0,0,1,1,"dummy"
"47756",4,5,1,10,"dummy"
"47757",0,0,0,0,"dummy"
"47758",3,6,0,9,"dummy"
"47759",7,7,2,16,"dummy"
"47760",2,2,0,4,"dummy"
"47761",0,0,0,0,"dummy"
"47762",1,3,0,4,"dummy"
"47763",0,0,3,3,"dummy"
"47764",0,0,0,0,"dummy"
"47765",8,4,2,14,"dummy"
"47766",2,2,3,7,"dummy"
"47767",1,0,1,2,"dummy"
"47771",0,1,0,1,"dummy"
"47772",1,0,0,1,"dummy"
"47773",1,2,2,5,"dummy"
"47774",1,1,0,2,"dummy"
"47775",0,3,0,3,"dummy"
"47776",0,2,0,2,"dummy"
"47777",0,0,1,1,"dummy"
"47778",0,1,0,1,"dummy"
"47779",0,2,0,2,"dummy"
"47780",0,1,0,1,"dummy"
"47781",7,4,0,11,"dummy"
"47782",2,3,0,5,"dummy"
"47783",0,0,0,0,"dummy"
"47784",9,6,3,18,"dummy"
"47786",1,2,0,3,"dummy"
"47789",0,10,0,10,"dummy"
"47790",11,1,0,12,"dummy"
"47791",0,2,0,2,"dummy"
"47794",0,2,0,2,"dummy"
"47795",0,1,0,1,"dummy"
"47796",0,1,0,1,"dummy"
"47797",1,0,0,1,"dummy"
"47798",0,2,0,2,"dummy"
"47801",0,4,0,4,"dummy"
"47802",1,0,0,1,"dummy"
"47812",0,2,0,2,"dummy"
"47813",4,2,0,6,"dummy"
"47814",0,4,0,4,"dummy"
"47815",4,0,0,4,"dummy"
"47817",0,0,1,1,"dummy"
"47818",0,0,0,0,"dummy"
"47821",0,0,1,1,"dummy"
"47822",0,1,0,1,"dummy"
"47824",0,1,0,1,"dummy"
"47825",0,1,0,1,"dummy"
"47826",0,0,1,1,"dummy"
"47830",2,0,0,2,"dummy"
"47832",1,0,1,2,"dummy"
"47833",0,0,1,1,"dummy"
"47834",0,1,3,4,"dummy"
"47835",0,0,0,0,"dummy"
"47836",12,3,2,17,"dummy"
"47846",0,0,1,1,"dummy"
"47857",0,1,0,1,"dummy"
"47858",0,2,0,2,"dummy"
"47859",0,0,0,0,"dummy"
"47860",0,0,0,0,"dummy"
"47861",0,4,0,4,"dummy"
"47862",0,0,1,1,"dummy"
"47863",0,0,1,1,"dummy"
"47864",0,0,1,1,"dummy"
"47865",6,6,2,14,"dummy"
"47866",0,3,0,3,"dummy"
"47867",2,0,0,2,"dummy"
"47868",1,0,0,1,"dummy"
"47878",0,3,0,3,"dummy"
"47879",4,0,0,4,"dummy"
"47880",3,1,0,4,"dummy"
"47881",0,4,1,5,"dummy"
"47882",1,1,1,3,"dummy"
"47883",3,0,0,3,"dummy"
"47884",6,1,4,11,"dummy"
"47889",3,1,5,9,"dummy"
"47890",0,0,1,1,"dummy"
"47898",2,0,3,5,"dummy"
"47919",1,2,0,3,"dummy"
"47920",0,3,1,4,"dummy"
"47921",2,2,0,4,"dummy"
"47922",0,2,0,2,"dummy"
"47923",0,0,2,2,"dummy"
"47924",0,0,2,2,"dummy"
"47925",1,1,1,3,"dummy"
"47931",0,0,1,1,"dummy"
"47932",0,1,0,1,"dummy"
"47933",0,1,0,1,"dummy"
"47951",0,20,0,20,"dummy"
"47952",1,0,1,2,"dummy"
"47967",2,4,0,6,"dummy"
"47968",0,2,0,2,"dummy"
"47969",0,2,0,2,"dummy"
"47970",10,2,0,12,"dummy"
"47971",0,2,0,2,"dummy"
"47972",0,0,0,0,"dummy"
"47973",0,0,3,3,"dummy"
"47974",0,5,0,5,"dummy"
"47975",1,0,1,2,"dummy"
"47979",0,1,0,1,"dummy"
"47980",7,19,1,27,"dummy"
"48000",0,0,1,1,"dummy"
"48001",0,0,0,0,"dummy"
"48014",0,3,0,3,"dummy"
"48017",0,0,0,0,"dummy"
"48018",0,0,0,0,"dummy"
"48019",0,0,0,0,"dummy"
"48020",0,0,0,0,"dummy"
"48021",0,0,0,0,"dummy"
"48022",0,0,0,0,"dummy"
"48023",0,0,0,0,"dummy"
"48024",0,0,0,0,"dummy"
"48025",0,0,0,0,"dummy"
"48026",0,0,0,0,"dummy"
"48031",0,0,0,0,"dummy"
"48032",0,1,0,1,"dummy"
"48043",0,0,0,0,"dummy"
"48044",1,1,0,2,"dummy"
"48045",0,3,0,3,"dummy"
"48046",0,0,1,1,"dummy"
"48047",0,0,3,3,"dummy"
"48048",2,4,0,6,"dummy"
"48049",0,0,1,1,"dummy"
"48052",0,1,0,1,"dummy"
"48053",0,0,1,1,"dummy"
"48054",0,0,1,1,"dummy"
"48055",0,0,1,1,"dummy"
"48056",0,3,0,3,"dummy"
"47838",0,0,0,0,"dummy"
"47839",0,0,1,1,"dummy"
"47840",14,0,4,18,"dummy"
"47841",0,0,3,3,"dummy"
"47842",0,0,2,2,"dummy"
"47843",1,1,0,2,"dummy"
"47844",0,0,1,1,"dummy"
"47848",0,1,0,1,"dummy"
"47849",0,0,1,1,"dummy"
"47850",0,0,1,1,"dummy"
"47851",0,1,1,2,"dummy"
"47852",1,8,1,10,"dummy"
"47853",0,0,1,1,"dummy"
"47894",0,1,1,2,"dummy"
"47895",1,0,1,2,"dummy"
"47896",0,0,1,1,"dummy"
"47903",2,1,0,3,"dummy"
"47904",1,3,1,5,"dummy"
"47927",0,0,0,0,"dummy"
"47928",0,3,0,3,"dummy"
"47929",3,0,0,3,"dummy"
"47957",7,5,0,12,"dummy"
"47960",0,1,0,1,"dummy"
"47961",0,1,0,1,"dummy"
"47964",20,4,8,32,"dummy"
"47965",0,0,0,0,"dummy"
"47977",0,2,1,3,"dummy"
"47982",0,0,1,1,"dummy"
"47983",0,0,1,1,"dummy"
"48003",0,0,1,1,"dummy"
"48004",0,0,1,1,"dummy"
"48005",0,3,0,3,"dummy"
"48006",0,1,3,4,"dummy"
"48007",8,8,0,16,"dummy"
"48008",5,0,1,6,"dummy"
"48009",1,0,0,1,"dummy"
"48010",0,0,1,1,"dummy"
"48011",0,0,1,1,"dummy"
"48012",0,1,0,1,"dummy"
"48034",2,4,0,6,"dummy"
"48035",0,2,0,2,"dummy"
"48036",0,2,0,2,"dummy"
"48037",10,2,0,12,"dummy"
"48038",0,2,0,2,"dummy"
"48039",0,0,0,0,"dummy"
"48040",0,0,3,3,"dummy"
"48041",0,5,0,5,"dummy"
"48066",4,4,1,9,"dummy"
"48067",1,4,1,6,"dummy"
"48068",0,1,3,4,"dummy"
"48090",5,0,0,5,"dummy"
"48123",7,8,0,15,"dummy"
"48133",1,0,0,1,"dummy"
"48134",0,0,2,2,"dummy"
"48135",0,0,3,3,"dummy"
"48136",0,2,0,2,"dummy"
"48137",0,1,1,2,"dummy"
"48138",1,0,0,1,"dummy"
"48139",2,1,0,3,"dummy"
"48142",7,18,0,25,"dummy"
"48143",2,0,0,2,"dummy"
"48144",1,2,0,3,"dummy"
"48145",7,7,0,14,"dummy"
"48146",1,2,0,3,"dummy"
"48147",0,0,0,0,"dummy"
"48148",0,0,0,0,"dummy"
"48149",0,0,0,0,"dummy"
"48159",0,0,1,1,"dummy"
"48057",0,0,1,1,"dummy"
"48058",1,5,1,7,"dummy"
"48059",0,0,1,1,"dummy"
"48060",6,2,1,9,"dummy"
"48061",0,0,1,1,"dummy"
"48062",0,0,1,1,"dummy"
"48074",0,1,0,1,"dummy"
"48075",0,0,1,1,"dummy"
"48076",1,4,0,5,"dummy"
"48077",0,3,1,4,"dummy"
"48080",0,0,1,1,"dummy"
"48081",0,17,0,17,"dummy"
"48082",5,33,3,41,"dummy"
"48083",0,1,0,1,"dummy"
"48084",0,1,1,2,"dummy"
"48125",2,0,0,2,"dummy"
"48126",0,1,0,1,"dummy"
"48127",0,1,0,1,"dummy"
"48128",4,3,1,8,"dummy"
"48129",0,2,0,2,"dummy"
"48151",0,0,1,1,"dummy"
"48152",0,0,1,1,"dummy"
"48153",0,0,1,1,"dummy"
"48154",0,0,1,1,"dummy"
"48155",0,0,1,1,"dummy"
"48156",0,0,1,1,"dummy"
"48157",0,0,1,1,"dummy"
"48168",0,1,0,1,"dummy"
"48171",0,0,0,0,"dummy"
"48172",2,0,1,3,"dummy"
"48173",0,1,0,1,"dummy"
"48178",0,6,0,6,"dummy"
"48181",3,0,1,4,"dummy"
"48182",0,2,0,2,"dummy"
"48185",0,0,0,0,"dummy"
"48186",0,0,0,0,"dummy"
"48190",0,0,2,2,"dummy"
"48205",0,1,0,1,"dummy"
"48206",0,0,1,1,"dummy"
"48207",0,0,1,1,"dummy"
"48213",0,1,0,1,"dummy"
"48214",0,0,0,0,"dummy"
"48219",0,0,2,2,"dummy"
"48222",0,0,0,0,"dummy"
"48223",0,0,2,2,"dummy"
"48224",0,2,0,2,"dummy"
"48225",0,0,1,1,"dummy"
"48226",0,0,1,1,"dummy"
"48227",0,0,1,1,"dummy"
"48228",0,0,1,1,"dummy"
"48229",0,0,2,2,"dummy"
"48230",0,1,1,2,"dummy"
"48231",0,0,1,1,"dummy"
"48232",0,0,1,1,"dummy"
"48233",0,0,1,1,"dummy"
"48234",0,4,0,4,"dummy"
"48235",0,0,0,0,"dummy"
"48236",0,2,0,2,"dummy"
"48237",0,0,1,1,"dummy"
"48238",0,0,1,1,"dummy"
"48239",0,0,1,1,"dummy"
"48240",3,0,1,4,"dummy"
"48241",0,0,1,1,"dummy"
"48242",0,0,2,2,"dummy"
"48243",0,0,1,1,"dummy"
"48244",2,2,1,5,"dummy"
"48245",2,0,4,6,"dummy"
"48246",0,1,0,1,"dummy"
"48247",0,0,1,1,"dummy"
"48248",0,0,1,1,"dummy"
"48249",0,0,1,1,"dummy"
"48250",0,0,1,1,"dummy"
"48251",0,0,1,1,"dummy"
"48252",0,0,1,1,"dummy"
"48160",0,2,0,2,"dummy"
"48161",8,10,1,19,"dummy"
"48162",0,3,0,3,"dummy"
"48163",0,1,0,1,"dummy"
"48164",0,0,2,2,"dummy"
"48175",0,5,8,13,"dummy"
"48176",4,4,0,8,"dummy"
"48188",6,17,0,23,"dummy"
"48192",0,4,0,4,"dummy"
"48193",0,0,0,0,"dummy"
"48194",2,5,0,7,"dummy"
"48195",1,2,0,3,"dummy"
"48196",2,4,1,7,"dummy"
"48197",0,8,0,8,"dummy"
"48198",0,0,0,0,"dummy"
"48199",0,2,0,2,"dummy"
"48200",6,3,3,12,"dummy"
"48201",3,1,0,4,"dummy"
"48202",2,0,1,3,"dummy"
"48203",2,4,0,6,"dummy"
"48256",0,1,0,1,"dummy"
"48257",0,0,1,1,"dummy"
"48279",0,1,0,1,"dummy"
"48283",0,4,0,4,"dummy"
"48284",1,1,0,2,"dummy"
"48285",0,0,3,3,"dummy"
"48287",3,0,0,3,"dummy"
"48288",2,1,1,4,"dummy"
"48289",1,1,0,2,"dummy"
"48290",0,1,0,1,"dummy"
"48293",1,0,0,1,"dummy"
"48294",0,2,1,3,"dummy"
"48296",1,1,1,3,"dummy"
"48299",0,6,2,8,"dummy"
"48301",0,2,1,3,"dummy"
"48328",1,2,1,4,"dummy"
"48329",2,1,1,4,"dummy"
"48330",0,2,1,3,"dummy"
"48331",0,1,0,1,"dummy"
"48332",4,4,1,9,"dummy"
"48355",6,11,8,25,"dummy"
"48356",3,8,5,16,"dummy"
"48360",6,7,2,15,"dummy"
"48361",0,1,0,1,"dummy"
"48362",0,0,0,0,"dummy"
"48363",2,3,0,5,"dummy"
"48364",1,0,0,1,"dummy"
"48366",0,4,0,4,"dummy"
"48367",0,0,1,1,"dummy"
"48368",12,10,0,22,"dummy"
"48369",0,0,1,1,"dummy"
"48370",0,0,1,1,"dummy"
"48371",4,0,0,4,"dummy"
"48372",0,2,0,2,"dummy"
"48373",0,0,1,1,"dummy"
"48376",0,0,1,1,"dummy"
"48378",4,7,0,11,"dummy"
"48379",10,14,1,25,"dummy"
"48380",0,1,0,1,"dummy"
"48381",1,4,1,6,"dummy"
"48383",0,0,1,1,"dummy"
"48384",0,1,0,1,"dummy"
"48385",1,3,0,4,"dummy"
"48386",1,0,0,1,"dummy"
"48387",18,6,3,27,"dummy"
"48388",0,3,0,3,"dummy"
"48389",0,0,1,1,"dummy"
"48390",0,0,1,1,"dummy"
"48393",0,0,0,0,"dummy"
"48394",0,0,0,0,"dummy"
"48395",0,27,1,28,"dummy"
"48396",0,2,0,2,"dummy"
"48397",0,0,1,1,"dummy"
"48398",8,5,0,13,"dummy"
"48399",0,0,0,0,"dummy"
"48400",1,1,0,2,"dummy"
"48401",2,2,0,4,"dummy"
"48402",1,1,0,2,"dummy"
"48403",0,11,1,12,"dummy"
"48404",3,3,0,6,"dummy"
"48405",0,2,0,2,"dummy"
"48406",0,3,0,3,"dummy"
"48407",7,6,0,13,"dummy"
"48408",0,5,0,5,"dummy"
"48409",2,2,0,4,"dummy"
"48410",0,1,0,1,"dummy"
"48411",0,1,0,1,"dummy"
"48412",1,1,0,2,"dummy"
"48413",0,1,0,1,"dummy"
"48415",1,0,0,1,"dummy"
"48416",1,1,3,5,"dummy"
"48417",0,0,0,0,"dummy"
"48418",1,2,4,7,"dummy"
"48420",2,7,0,9,"dummy"
"48421",1,4,0,5,"dummy"
"48422",0,0,1,1,"dummy"
"48423",0,0,1,1,"dummy"
"48424",0,0,1,1,"dummy"
"48426",2,3,0,5,"dummy"
"48429",0,0,0,0,"dummy"
"48430",4,12,3,19,"dummy"
"48431",4,3,0,7,"dummy"
"48432",0,0,0,0,"dummy"
"48433",5,5,0,10,"dummy"
"48434",0,0,1,1,"dummy"
"48435",0,2,2,4,"dummy"
"48436",0,2,0,2,"dummy"
"48437",0,0,1,1,"dummy"
"48438",0,0,1,1,"dummy"
"48439",0,1,0,1,"dummy"
"48440",4,3,6,13,"dummy"
"48441",0,0,4,4,"dummy"
"48442",1,0,1,2,"dummy"
"48443",0,0,1,1,"dummy"
"48444",0,0,1,1,"dummy"
"48445",0,4,0,4,"dummy"
"48447",0,1,0,1,"dummy"
"48448",1,0,0,1,"dummy"
"48449",0,2,1,3,"dummy"
"48450",0,8,0,8,"dummy"
"48451",0,0,1,1,"dummy"
"48452",1,1,0,2,"dummy"
"48456",1,0,0,1,"dummy"
"48460",3,1,0,4,"dummy"
"48461",0,0,0,0,"dummy"
"48462",0,1,0,1,"dummy"
"48465",2,0,0,2,"dummy"
"48466",0,1,0,1,"dummy"
"48468",5,0,2,7,"dummy"
"48469",1,0,0,1,"dummy"
"48470",1,1,0,2,"dummy"
"48471",0,1,0,1,"dummy"
"48472",0,0,1,1,"dummy"
"48473",0,1,1,2,"dummy"
"48474",0,0,1,1,"dummy"
"48475",0,0,3,3,"dummy"
"48476",0,0,1,1,"dummy"
"48483",0,1,0,1,"dummy"
"48484",2,4,0,6,"dummy"
"48485",0,24,0,24,"dummy"
"48486",0,1,0,1,"dummy"
"48488",0,12,1,13,"dummy"
"48492",11,1,2,14,"dummy"
"48494",3,3,0,6,"dummy"
"48495",3,2,1,6,"dummy"
"48496",0,0,1,1,"dummy"
"48497",0,1,0,1,"dummy"
"48498",6,4,0,10,"dummy"
"48499",1,4,0,5,"dummy"
"48500",0,0,1,1,"dummy"
"48516",0,0,1,1,"dummy"
"48517",0,0,1,1,"dummy"
"48518",0,1,0,1,"dummy"
"48522",0,0,1,1,"dummy"
"48524",0,5,0,5,"dummy"
"48525",2,1,0,3,"dummy"
"48526",1,1,0,2,"dummy"
"48527",0,0,1,1,"dummy"
"48528",3,0,1,4,"dummy"
"48529",0,0,1,1,"dummy"
"48530",0,1,0,1,"dummy"
"48531",2,1,0,3,"dummy"
"48532",1,0,0,1,"dummy"
"48533",0,1,0,1,"dummy"
"48534",3,4,0,7,"dummy"
"48535",1,0,0,1,"dummy"
"48536",0,1,0,1,"dummy"
"48538",0,1,0,1,"dummy"
"48541",0,4,0,4,"dummy"
"48544",1,4,0,5,"dummy"
"48545",4,0,0,4,"dummy"
"48548",0,0,2,2,"dummy"
"48549",0,0,2,2,"dummy"
"48550",0,0,2,2,"dummy"
"48552",0,1,0,1,"dummy"
"48553",0,3,0,3,"dummy"
"48555",0,0,1,1,"dummy"
"48557",0,0,1,1,"dummy"
"48558",0,0,1,1,"dummy"
"48560",1,3,3,7,"dummy"
"48561",0,1,0,1,"dummy"
"48562",5,2,0,7,"dummy"
"48563",0,0,3,3,"dummy"
"48564",0,0,2,2,"dummy"
"48565",0,0,1,1,"dummy"
"48566",3,6,0,9,"dummy"
"48568",0,2,4,6,"dummy"
"48569",0,0,0,0,"dummy"
"48570",1,0,0,1,"dummy"
"48571",0,0,0,0,"dummy"
"48572",0,1,0,1,"dummy"
"48578",0,1,0,1,"dummy"
"48579",0,4,0,4,"dummy"
"48580",0,1,0,1,"dummy"
"48588",0,1,1,2,"dummy"
"48589",0,0,0,0,"dummy"
"48591",6,3,0,9,"dummy"
"48593",0,0,0,0,"dummy"
"48594",0,0,0,0,"dummy"
"48596",0,0,1,1,"dummy"
"48597",1,0,0,1,"dummy"
"48598",0,1,0,1,"dummy"
"48599",0,12,3,15,"dummy"
"48600",0,0,2,2,"dummy"
"48601",0,0,1,1,"dummy"
"48603",0,0,0,0,"dummy"
"48605",0,1,0,1,"dummy"
"48606",0,0,0,0,"dummy"
"48607",2,3,0,5,"dummy"
"48608",1,0,0,1,"dummy"
"48610",7,4,1,12,"dummy"
"48611",0,0,3,3,"dummy"
"48612",1,3,2,6,"dummy"
"48613",1,0,1,2,"dummy"
"48615",0,3,0,3,"dummy"
"48616",0,1,0,1,"dummy"
"48617",0,1,0,1,"dummy"
"48618",0,1,0,1,"dummy"
"48619",2,7,0,9,"dummy"
"48620",0,1,0,1,"dummy"
"48622",1,7,3,11,"dummy"
"48623",0,1,0,1,"dummy"
"48624",1,8,2,11,"dummy"
"48625",0,4,0,4,"dummy"
"48626",1,1,0,2,"dummy"
"48627",1,6,1,8,"dummy"
"48628",3,0,0,3,"dummy"
"48629",0,1,0,1,"dummy"
"48630",1,0,1,2,"dummy"
"48631",0,1,0,1,"dummy"
"48632",1,4,0,5,"dummy"
"48633",0,0,1,1,"dummy"
"48634",0,1,0,1,"dummy"
"48635",0,0,1,1,"dummy"
"48636",2,3,1,6,"dummy"
"48637",3,3,1,7,"dummy"
"48638",2,3,1,6,"dummy"
"48639",0,0,1,1,"dummy"
"48640",0,1,0,1,"dummy"
"48641",0,1,0,1,"dummy"
"48642",0,0,1,1,"dummy"
"48643",0,1,0,1,"dummy"
"48644",5,5,0,10,"dummy"
"48645",0,1,0,1,"dummy"
"48646",13,0,2,15,"dummy"
"48647",0,1,0,1,"dummy"
"48650",0,1,0,1,"dummy"
"48651",0,2,0,2,"dummy"
"48653",3,1,0,4,"dummy"
"48658",1,0,1,2,"dummy"
"48659",0,1,2,3,"dummy"
"48660",1,0,1,2,"dummy"
"48661",0,0,1,1,"dummy"
"48662",0,0,2,2,"dummy"
"48663",0,0,1,1,"dummy"
"48664",0,0,0,0,"dummy"
"48665",2,0,1,3,"dummy"
"48666",0,0,1,1,"dummy"
"48667",0,1,0,1,"dummy"
"48668",0,2,0,2,"dummy"
"48669",0,0,1,1,"dummy"
"48670",0,0,1,1,"dummy"
"48671",0,1,0,1,"dummy"
"48672",0,1,0,1,"dummy"
"48673",0,0,1,1,"dummy"
"48674",0,1,0,1,"dummy"
"48675",5,0,0,5,"dummy"
"48676",0,2,0,2,"dummy"
"48677",0,1,0,1,"dummy"
"48678",0,1,0,1,"dummy"
"48679",0,0,0,0,"dummy"
"48680",4,0,0,4,"dummy"
"48681",0,0,0,0,"dummy"
"48682",4,11,0,15,"dummy"
"48683",0,0,0,0,"dummy"
"48684",4,0,0,4,"dummy"
"48687",0,0,0,0,"dummy"
"48688",0,0,0,0,"dummy"
"48689",0,0,0,0,"dummy"
"48690",1,2,0,3,"dummy"
"48691",0,1,0,1,"dummy"
"48692",0,0,1,1,"dummy"
"48693",0,0,0,0,"dummy"
"48694",0,0,0,0,"dummy"
"48695",0,0,0,0,"dummy"
"48696",0,0,0,0,"dummy"
"48697",0,6,0,6,"dummy"
"48698",6,0,0,6,"dummy"
"48699",0,0,0,0,"dummy"
"48700",0,6,0,6,"dummy"
"48701",0,0,0,0,"dummy"
"48702",0,0,0,0,"dummy"
"48703",0,0,0,0,"dummy"
"48704",0,0,0,0,"dummy"
"48705",0,0,0,0,"dummy"
"48706",0,0,0,0,"dummy"
"48707",0,0,0,0,"dummy"
"48708",0,0,0,0,"dummy"
"48710",2,5,2,9,"dummy"
"48711",0,2,0,2,"dummy"
"48712",1,1,4,6,"dummy"
"48713",5,0,0,5,"dummy"
"48714",0,3,1,4,"dummy"
"48715",0,0,2,2,"dummy"
"48716",0,0,1,1,"dummy"
"48717",0,0,0,0,"dummy"
"48718",19,0,1,20,"dummy"
"48719",0,0,1,1,"dummy"
"48720",0,2,1,3,"dummy"
"48721",1,0,0,1,"dummy"
"48729",0,0,0,0,"dummy"
"48730",0,0,0,0,"dummy"
"48741",1,4,0,5,"dummy"
"48742",4,0,0,4,"dummy"
"48743",2,2,0,4,"dummy"
"48744",4,4,1,9,"dummy"
"48745",1,1,0,2,"dummy"
"48746",0,4,0,4,"dummy"
"48747",1,1,0,2,"dummy"
"48748",1,8,0,9,"dummy"
"48749",1,1,0,2,"dummy"
"48750",0,1,0,1,"dummy"
"48751",0,1,0,1,"dummy"
"48763",0,2,2,4,"dummy"
"48765",0,0,0,0,"dummy"
"48768",0,0,1,1,"dummy"
"48769",0,0,1,1,"dummy"
"48787",0,0,0,0,"dummy"
"48803",0,0,0,0,"dummy"
"48812",0,6,0,6,"dummy"
"48813",0,1,1,2,"dummy"
"48817",0,1,0,1,"dummy"
"48820",1,12,0,13,"dummy"
"48821",0,2,1,3,"dummy"
"48822",4,2,0,6,"dummy"
"48826",4,4,1,9,"dummy"
"48827",1,7,0,8,"dummy"
"48829",0,2,0,2,"dummy"
"48830",5,12,1,18,"dummy"
"48831",0,4,0,4,"dummy"
"48832",0,2,0,2,"dummy"
"48833",0,0,4,4,"dummy"
"48834",0,1,0,1,"dummy"
"48835",0,2,0,2,"dummy"
"48836",0,0,0,0,"dummy"
"48837",0,2,0,2,"dummy"
"48838",6,0,0,6,"dummy"
"48839",0,0,1,1,"dummy"
"48840",0,3,0,3,"dummy"
"48841",1,3,0,4,"dummy"
"48842",2,0,0,2,"dummy"
"48845",10,9,3,22,"dummy"
"48846",3,0,0,3,"dummy"
"48847",0,1,0,1,"dummy"
"48848",0,1,0,1,"dummy"
"48849",0,1,0,1,"dummy"
"48850",2,4,0,6,"dummy"
"48851",0,2,0,2,"dummy"
"48877",1,0,0,1,"dummy"
"48906",0,0,1,1,"dummy"
"48909",0,10,0,10,"dummy"
"48910",7,12,3,22,"dummy"
"48911",0,0,1,1,"dummy"
"48912",0,6,3,9,"dummy"
"48915",2,0,0,2,"dummy"
"48916",0,2,2,4,"dummy"
"48926",0,0,1,1,"dummy"
"48927",0,1,0,1,"dummy"
"48929",0,0,1,1,"dummy"
"48930",0,0,1,1,"dummy"
"48934",12,10,0,22,"dummy"
"48935",0,0,1,1,"dummy"
"48938",0,3,0,3,"dummy"
"48939",0,1,0,1,"dummy"
"48940",1,12,4,17,"dummy"
"48941",1,1,0,2,"dummy"
"48942",1,0,0,1,"dummy"
"48944",3,4,0,7,"dummy"
"48945",2,0,0,2,"dummy"
"48946",0,0,1,1,"dummy"
"48947",2,1,2,5,"dummy"
"48948",2,1,0,3,"dummy"
"48950",0,1,1,2,"dummy"
"48952",0,0,0,0,"dummy"
"48953",0,0,0,0,"dummy"
"48957",1,1,0,2,"dummy"
"48976",0,3,2,5,"dummy"
"48978",0,0,0,0,"dummy"
"48979",1,0,0,1,"dummy"
"48982",0,2,0,2,"dummy"
"48998",0,0,1,1,"dummy"
"49001",0,0,1,1,"dummy"
"49002",0,0,2,2,"dummy"
"49003",0,0,1,1,"dummy"
"49007",2,0,1,3,"dummy"
"49008",0,2,1,3,"dummy"
"49009",0,0,0,0,"dummy"
"49014",0,0,1,1,"dummy"
"49016",0,2,0,2,"dummy"
"49017",0,0,1,1,"dummy"
"49018",0,0,1,1,"dummy"
"49019",0,1,0,1,"dummy"
"49020",0,5,0,5,"dummy"
"49021",5,5,0,10,"dummy"
"49023",0,1,0,1,"dummy"
"49024",0,0,1,1,"dummy"
"49025",0,0,1,1,"dummy"
"49026",0,0,0,0,"dummy"
"49027",0,0,1,1,"dummy"
"49028",1,0,0,1,"dummy"
"49029",0,4,0,4,"dummy"
"49030",0,0,0,0,"dummy"
"49031",0,1,0,1,"dummy"
"49032",0,0,0,0,"dummy"
"49033",0,0,1,1,"dummy"
"49035",0,0,0,0,"dummy"
"49036",0,1,0,1,"dummy"
"49037",4,6,0,10,"dummy"
"49038",6,0,0,6,"dummy"
"49042",14,13,1,28,"dummy"
"49043",0,3,0,3,"dummy"
"49044",0,0,3,3,"dummy"
"49045",0,0,2,2,"dummy"
"49046",0,0,0,0,"dummy"
"49050",0,3,0,3,"dummy"
"49051",9,0,2,11,"dummy"
"49052",0,9,0,9,"dummy"
"49053",0,0,1,1,"dummy"
"49054",0,1,0,1,"dummy"
"49055",0,3,2,5,"dummy"
"49056",0,0,0,0,"dummy"
"49057",0,0,1,1,"dummy"
"49058",2,5,1,8,"dummy"
"49059",2,4,0,6,"dummy"
"49060",0,2,0,2,"dummy"
"49061",2,4,1,7,"dummy"
"49062",0,2,0,2,"dummy"
"49063",0,2,0,2,"dummy"
"49064",1,3,0,4,"dummy"
"49065",0,3,0,3,"dummy"
"49066",3,10,1,14,"dummy"
"49067",0,3,0,3,"dummy"
"49068",3,0,1,4,"dummy"
"49069",0,3,0,3,"dummy"
"49070",0,0,1,1,"dummy"
"49071",0,1,1,2,"dummy"
"49072",0,1,1,2,"dummy"
"49073",0,1,1,2,"dummy"
"49074",3,6,2,11,"dummy"
"49075",7,7,2,16,"dummy"
"49076",0,5,0,5,"dummy"
"49077",5,1,0,6,"dummy"
"49078",0,5,0,5,"dummy"
"49079",2,10,0,12,"dummy"
"49080",0,0,1,1,"dummy"
"49081",1,1,1,3,"dummy"
"49082",18,2,1,21,"dummy"
"49083",0,2,0,2,"dummy"
"49084",0,0,2,2,"dummy"
"49086",98,26,6,130,"dummy"
"49087",0,4,1,5,"dummy"
"49088",14,7,0,21,"dummy"
"49089",1,18,0,19,"dummy"
"49090",1,0,0,1,"dummy"
"49091",1,1,0,2,"dummy"
"49093",0,5,0,5,"dummy"
"49096",0,1,0,1,"dummy"
"49098",0,0,2,2,"dummy"
"49101",4,4,0,8,"dummy"
"49102",1,4,0,5,"dummy"
"49103",1,2,2,5,"dummy"
"49104",0,0,1,1,"dummy"
"49106",1,0,0,1,"dummy"
"49107",6,1,0,7,"dummy"
"49108",1,2,0,3,"dummy"
"49109",1,2,0,3,"dummy"
"49110",1,0,0,1,"dummy"
"49111",0,1,0,1,"dummy"
"49116",1,0,0,1,"dummy"
"49130",0,0,1,1,"dummy"
"49131",0,1,0,1,"dummy"
"49132",0,1,0,1,"dummy"
"49133",0,2,0,2,"dummy"
"49134",7,1,0,8,"dummy"
"49135",1,5,0,6,"dummy"
"49136",0,2,0,2,"dummy"
"49137",0,3,0,3,"dummy"
"49138",0,1,0,1,"dummy"
"49139",0,1,0,1,"dummy"
"49140",0,1,0,1,"dummy"
"49141",0,0,1,1,"dummy"
"49142",0,2,0,2,"dummy"
"49143",13,1,2,16,"dummy"
"49144",3,1,0,4,"dummy"
"49147",0,0,1,1,"dummy"
"49148",1,1,0,2,"dummy"
"49149",2,0,2,4,"dummy"
"49150",0,1,0,1,"dummy"
"49151",5,6,0,11,"dummy"
"49152",6,3,2,11,"dummy"
"49153",0,0,1,1,"dummy"
"49154",0,0,1,1,"dummy"
"49155",0,0,2,2,"dummy"
"49156",1,0,0,1,"dummy"
"49157",0,2,0,2,"dummy"
"49158",4,1,0,5,"dummy"
"49159",0,1,1,2,"dummy"
"49168",0,2,0,2,"dummy"
"49170",2,1,2,5,"dummy"
"49175",0,1,0,1,"dummy"
"49176",1,7,1,9,"dummy"
"49177",1,4,0,5,"dummy"
"49178",3,1,1,5,"dummy"
"49179",0,1,0,1,"dummy"
"49180",0,3,1,4,"dummy"
"49181",3,0,1,4,"dummy"
"49206",0,0,3,3,"dummy"
"49207",9,9,1,19,"dummy"
"49209",0,0,3,3,"dummy"
"49210",0,0,1,1,"dummy"
"49237",0,0,1,1,"dummy"
"49238",1,1,3,5,"dummy"
"49240",0,1,0,1,"dummy"
"49241",0,0,0,0,"dummy"
"49242",0,0,0,0,"dummy"
"49245",0,3,0,3,"dummy"
"49246",0,0,0,0,"dummy"
"49248",0,7,0,7,"dummy"
"49249",0,0,3,3,"dummy"
"49250",1,2,0,3,"dummy"
"49251",2,6,0,8,"dummy"
"49252",7,0,3,10,"dummy"
"49253",0,3,0,3,"dummy"
"49254",0,1,0,1,"dummy"
"49255",0,0,1,1,"dummy"
"49256",2,4,0,6,"dummy"
"49260",1,0,0,1,"dummy"
"49263",0,0,1,1,"dummy"
"49267",1,2,0,3,"dummy"
"49268",6,2,1,9,"dummy"
"49270",0,1,0,1,"dummy"
"49278",9,0,3,12,"dummy"
"49281",0,0,0,0,"dummy"
"49282",0,0,0,0,"dummy"
"49283",0,0,0,0,"dummy"
"49284",0,0,0,0,"dummy"
"49286",2,23,2,27,"dummy"
"49287",0,1,1,2,"dummy"
"49288",1,0,0,1,"dummy"
"49289",0,0,0,0,"dummy"
"49290",0,3,0,3,"dummy"
"49291",1,0,0,1,"dummy"
"49292",3,0,0,3,"dummy"
"49293",0,0,1,1,"dummy"
"49303",0,0,1,1,"dummy"
"49305",2,27,1,30,"dummy"
"49306",0,2,0,2,"dummy"
"49307",2,0,0,2,"dummy"
"49308",7,8,8,23,"dummy"
"49309",3,7,3,13,"dummy"
"49310",0,6,3,9,"dummy"
"49311",0,0,3,3,"dummy"
"49312",3,7,5,15,"dummy"
"49313",0,0,1,1,"dummy"
"49315",0,2,0,2,"dummy"
"49316",3,0,3,6,"dummy"
"49319",1,2,0,3,"dummy"
"49320",2,0,0,2,"dummy"
"49321",2,1,1,4,"dummy"
"49322",0,0,0,0,"dummy"
"49335",0,3,0,3,"dummy"
"49336",0,0,1,1,"dummy"
"49337",1,24,2,27,"dummy"
"49338",0,1,0,1,"dummy"
"49339",0,1,0,1,"dummy"
"49340",0,1,0,1,"dummy"
"49341",0,0,1,1,"dummy"
"49346",0,0,1,1,"dummy"
"49347",0,0,1,1,"dummy"
"49348",0,0,1,1,"dummy"
"49350",37,41,2,80,"dummy"
"49351",0,2,0,2,"dummy"
"49352",0,0,0,0,"dummy"
"49353",0,0,0,0,"dummy"
"49354",0,0,1,1,"dummy"
"49355",0,1,0,1,"dummy"
"49356",0,1,2,3,"dummy"
"49362",4,3,1,8,"dummy"
"49363",5,2,0,7,"dummy"
"49365",0,1,0,1,"dummy"
"49368",0,1,0,1,"dummy"
"49372",0,0,3,3,"dummy"
"49376",0,0,1,1,"dummy"
"49377",0,0,1,1,"dummy"
"49379",0,10,0,10,"dummy"
"49380",0,1,0,1,"dummy"
"49382",0,0,1,1,"dummy"
"49383",0,1,0,1,"dummy"
"49385",1,1,1,3,"dummy"
"49386",0,0,2,2,"dummy"
"49387",0,0,1,1,"dummy"
"49388",1,0,2,3,"dummy"
"49391",1,8,2,11,"dummy"
"49392",1,6,1,8,"dummy"
"49395",0,0,1,1,"dummy"
"49396",5,9,6,20,"dummy"
"49398",0,2,0,2,"dummy"
"49399",0,11,0,11,"dummy"
"49400",0,1,1,2,"dummy"
"49401",1,2,0,3,"dummy"
"49402",0,2,0,2,"dummy"
"49403",0,1,0,1,"dummy"
"49404",0,2,0,2,"dummy"
"49405",0,0,1,1,"dummy"
"49406",0,0,2,2,"dummy"
"49407",0,0,2,2,"dummy"
"49408",0,0,2,2,"dummy"
"49409",0,2,1,3,"dummy"
"49412",0,1,0,1,"dummy"
"49413",0,5,0,5,"dummy"
"49414",5,1,0,6,"dummy"
"49415",1,7,0,8,"dummy"
"49418",0,3,5,8,"dummy"
"49419",0,0,2,2,"dummy"
"49420",2,1,1,4,"dummy"
"49423",0,0,0,0,"dummy"
"49424",0,0,1,1,"dummy"
"49425",1,1,0,2,"dummy"
"49426",0,18,0,18,"dummy"
"49427",2,0,0,2,"dummy"
"49428",0,2,0,2,"dummy"
"49429",0,0,0,0,"dummy"
"49430",0,0,0,0,"dummy"
"49441",0,4,0,4,"dummy"
"49443",2,2,0,4,"dummy"
"49444",0,1,0,1,"dummy"
"49448",2,2,4,8,"dummy"
"49449",9,0,0,9,"dummy"
"49450",1,1,2,4,"dummy"
"49455",2,0,1,3,"dummy"
"49456",0,0,1,1,"dummy"
"49457",0,1,0,1,"dummy"
"49458",3,2,0,5,"dummy"
"49459",0,0,1,1,"dummy"
"49460",1,1,0,2,"dummy"
"49461",0,0,2,2,"dummy"
"49462",2,0,0,2,"dummy"
"49463",2,0,0,2,"dummy"
"49464",0,0,1,1,"dummy"
"49467",0,0,0,0,"dummy"
"49468",0,0,0,0,"dummy"
"49472",10,7,5,22,"dummy"
"49473",0,0,1,1,"dummy"
"49476",2,0,3,5,"dummy"
"49478",0,0,1,1,"dummy"
"49479",0,0,1,1,"dummy"
"49480",0,0,1,1,"dummy"
"49481",0,0,1,1,"dummy"
"49482",0,0,1,1,"dummy"
"49483",0,0,1,1,"dummy"
"49484",0,0,1,1,"dummy"
"49485",0,0,1,1,"dummy"
"49486",0,0,1,1,"dummy"
"49488",0,0,1,1,"dummy"
"49489",2,2,0,4,"dummy"
"49491",0,0,1,1,"dummy"
"49492",0,0,1,1,"dummy"
"49493",0,0,1,1,"dummy"
"49494",0,0,1,1,"dummy"
"49495",0,0,1,1,"dummy"
"49496",0,1,0,1,"dummy"
"49499",4,0,0,4,"dummy"
"49500",13,3,0,16,"dummy"
"49504",10,14,2,26,"dummy"
"49505",0,1,3,4,"dummy"
"49506",0,1,0,1,"dummy"
"49507",6,14,5,25,"dummy"
"49508",3,5,2,10,"dummy"
"49509",1,0,2,3,"dummy"
"49510",0,1,0,1,"dummy"
"49512",1,1,0,2,"dummy"
"49515",11,3,2,16,"dummy"
"49516",0,0,1,1,"dummy"
"49517",0,2,0,2,"dummy"
"49518",0,1,0,1,"dummy"
"49522",2,0,0,2,"dummy"
"49523",0,0,3,3,"dummy"
"49524",1,1,0,2,"dummy"
"49525",0,4,0,4,"dummy"
"49526",0,2,1,3,"dummy"
"49527",0,2,0,2,"dummy"
"49529",0,1,0,1,"dummy"
"49530",0,0,0,0,"dummy"
"49531",0,0,0,0,"dummy"
"49533",0,0,1,1,"dummy"
"49535",0,0,0,0,"dummy"
"49536",11,12,0,23,"dummy"
"49537",0,1,0,1,"dummy"
"49538",0,0,0,0,"dummy"
"49541",0,0,2,2,"dummy"
"49544",0,4,0,4,"dummy"
"49546",0,1,0,1,"dummy"
"49547",4,0,0,4,"dummy"
"49548",0,4,1,5,"dummy"
"49552",0,0,1,1,"dummy"
"49553",0,0,1,1,"dummy"
"49554",0,0,1,1,"dummy"
"49555",0,0,1,1,"dummy"
"49556",0,0,1,1,"dummy"
"49557",0,0,1,1,"dummy"
"49558",0,0,1,1,"dummy"
"49562",2,0,3,5,"dummy"
"49564",0,1,0,1,"dummy"
"49565",0,0,1,1,"dummy"
"49566",10,43,4,57,"dummy"
"49581",0,0,3,3,"dummy"
"49582",1,0,0,1,"dummy"
"49583",0,0,0,0,"dummy"
"49584",0,0,0,0,"dummy"
"49585",1,2,0,3,"dummy"
"49586",0,0,0,0,"dummy"
"49587",4,0,2,6,"dummy"
"49588",0,0,0,0,"dummy"
"49589",0,0,0,0,"dummy"
"49590",0,0,0,0,"dummy"
"49591",0,1,0,1,"dummy"
"49592",6,1,0,7,"dummy"
"49593",1,3,0,4,"dummy"
"49594",4,0,0,4,"dummy"
"49595",0,0,3,3,"dummy"
"49596",0,5,1,6,"dummy"
"49597",0,0,0,0,"dummy"
"49598",0,0,0,0,"dummy"
"49599",0,0,0,0,"dummy"
"49600",0,1,0,1,"dummy"
"49601",0,6,0,6,"dummy"
"49602",0,0,0,0,"dummy"
"49603",0,0,0,0,"dummy"
"49604",6,0,0,6,"dummy"
"49605",0,0,0,0,"dummy"
"49606",0,0,0,0,"dummy"
"49607",2,1,0,3,"dummy"
"49608",0,0,1,1,"dummy"
"49609",0,0,2,2,"dummy"
"49610",1,4,0,5,"dummy"
"49611",4,1,0,5,"dummy"
"49612",0,0,0,0,"dummy"
"49613",0,0,0,0,"dummy"
"49614",0,0,0,0,"dummy"
"49615",0,0,0,0,"dummy"
"49616",0,0,0,0,"dummy"
"49617",0,0,1,1,"dummy"
"49618",0,0,0,0,"dummy"
"49631",0,5,0,5,"dummy"
"49632",0,1,0,1,"dummy"
"49633",0,0,1,1,"dummy"
"49634",2,1,0,3,"dummy"
"49636",0,1,0,1,"dummy"
"49637",0,1,2,3,"dummy"
"49638",0,0,0,0,"dummy"
"49639",0,0,0,0,"dummy"
"49640",4,1,2,7,"dummy"
"49641",1,0,0,1,"dummy"
"49642",0,1,0,1,"dummy"
"49643",0,0,0,0,"dummy"
"49644",2,0,0,2,"dummy"
"49645",0,0,1,1,"dummy"
"49646",2,2,1,5,"dummy"
"49647",5,2,0,7,"dummy"
"49648",0,0,0,0,"dummy"
"49649",0,0,1,1,"dummy"
"49650",0,0,1,1,"dummy"
"49651",0,0,1,1,"dummy"
"49652",2,5,0,7,"dummy"
"49653",5,2,0,7,"dummy"
"49654",0,0,0,0,"dummy"
"49655",1,3,0,4,"dummy"
"49656",10,1,0,11,"dummy"
"49657",0,2,0,2,"dummy"
"49658",6,0,0,6,"dummy"
"49659",0,1,0,1,"dummy"
"49660",3,9,2,14,"dummy"
"49661",0,1,0,1,"dummy"
"49662",0,0,1,1,"dummy"
"49663",0,0,2,2,"dummy"
"49664",3,3,0,6,"dummy"
"49665",0,0,1,1,"dummy"
"49666",3,5,1,9,"dummy"
"49667",2,0,0,2,"dummy"
"49680",0,4,1,5,"dummy"
"49681",0,1,0,1,"dummy"
"49682",0,0,1,1,"dummy"
"49683",1,3,1,5,"dummy"
"49685",0,0,1,1,"dummy"
"49686",0,0,1,1,"dummy"
"49690",0,5,0,5,"dummy"
"49691",0,1,0,1,"dummy"
"49692",0,0,1,1,"dummy"
"49693",2,1,0,3,"dummy"
"49696",0,0,1,1,"dummy"
"49697",8,8,0,16,"dummy"
"49698",2,1,0,3,"dummy"
"49699",0,1,0,1,"dummy"
"49702",0,0,1,1,"dummy"
"49704",0,0,1,1,"dummy"
"49705",0,1,0,1,"dummy"
"49706",0,0,1,1,"dummy"
"49708",0,0,1,1,"dummy"
"49721",0,0,1,1,"dummy"
"49724",3,0,1,4,"dummy"
"49731",0,16,0,16,"dummy"
"49732",0,3,0,3,"dummy"
"49733",1,3,0,4,"dummy"
"49735",0,0,1,1,"dummy"
"49736",0,1,1,2,"dummy"
"49737",0,0,1,1,"dummy"
"49739",0,0,6,6,"dummy"
"49740",0,2,0,2,"dummy"
"49741",0,0,1,1,"dummy"
"49748",0,2,0,2,"dummy"
"49749",17,0,0,17,"dummy"
"49750",0,0,0,0,"dummy"
"49751",0,18,0,18,"dummy"
"49752",18,0,0,18,"dummy"
"49758",0,1,0,1,"dummy"
"49759",0,0,0,0,"dummy"
"49760",0,2,0,2,"dummy"
"49763",0,11,0,11,"dummy"
"49766",1,0,0,1,"dummy"
"49767",0,1,0,1,"dummy"
"49768",0,2,0,2,"dummy"
"49771",2,4,0,6,"dummy"
"49772",0,2,0,2,"dummy"
"49773",0,2,0,2,"dummy"
"49774",10,2,0,12,"dummy"
"49775",0,2,0,2,"dummy"
"49776",0,0,0,0,"dummy"
"49777",0,0,3,3,"dummy"
"49778",0,5,0,5,"dummy"
"49779",1,0,1,2,"dummy"
"49781",0,0,1,1,"dummy"
"49782",0,0,2,2,"dummy"
"49783",0,1,0,1,"dummy"
"49785",0,1,1,2,"dummy"
"49786",0,0,1,1,"dummy"
"49788",0,4,0,4,"dummy"
"49792",0,1,3,4,"dummy"
"49793",0,0,1,1,"dummy"
"49794",0,1,0,1,"dummy"
"49808",1,0,0,1,"dummy"
"49809",1,1,2,4,"dummy"
"49811",0,9,0,9,"dummy"
"49813",0,0,2,2,"dummy"
"49814",0,0,2,2,"dummy"
"49815",0,0,2,2,"dummy"
"49818",0,0,1,1,"dummy"
"49821",0,0,1,1,"dummy"
"49822",8,0,4,12,"dummy"
"49824",0,5,0,5,"dummy"
"49825",0,1,0,1,"dummy"
"49826",0,2,0,2,"dummy"
"49828",2,3,1,6,"dummy"
"49829",2,0,0,2,"dummy"
"49830",1,0,0,1,"dummy"
"49832",0,0,1,1,"dummy"
"49833",1,0,1,2,"dummy"
"49834",0,0,1,1,"dummy"
"49835",0,0,3,3,"dummy"
"49836",0,9,4,13,"dummy"
"49837",0,0,3,3,"dummy"
"49838",4,0,0,4,"dummy"
"49839",1,7,5,13,"dummy"
"49840",0,0,2,2,"dummy"
"49841",0,0,1,1,"dummy"
"49842",0,0,2,2,"dummy"
"49843",0,1,0,1,"dummy"
"49844",1,0,1,2,"dummy"
"49845",6,0,0,6,"dummy"
"49846",0,0,1,1,"dummy"
"49847",0,0,1,1,"dummy"
"49848",0,0,3,3,"dummy"
"49849",5,2,1,8,"dummy"
"49850",0,0,1,1,"dummy"
"49851",0,0,2,2,"dummy"
"49852",0,1,0,1,"dummy"
"49853",0,0,0,0,"dummy"
"49855",0,1,0,1,"dummy"
"49862",13,3,5,21,"dummy"
"49863",3,8,1,12,"dummy"
"49865",0,2,0,2,"dummy"
"49866",2,3,0,5,"dummy"
"49871",0,7,0,7,"dummy"
"49872",8,8,1,17,"dummy"
"49873",1,5,0,6,"dummy"
"49874",1,7,1,9,"dummy"
"49875",5,9,0,14,"dummy"
"49876",2,0,0,2,"dummy"
"49877",0,0,1,1,"dummy"
"49879",5,0,0,5,"dummy"
"49880",0,1,0,1,"dummy"
"49881",0,2,0,2,"dummy"
"49886",11,6,4,21,"dummy"
"49887",0,0,1,1,"dummy"
"49888",0,2,0,2,"dummy"
"49889",0,1,0,1,"dummy"
"49890",0,0,2,2,"dummy"
"49891",0,3,0,3,"dummy"
"49892",3,6,0,9,"dummy"
"49893",0,1,0,1,"dummy"
"49894",0,2,0,2,"dummy"
"49895",3,2,0,5,"dummy"
"49896",0,1,0,1,"dummy"
"49897",3,2,0,5,"dummy"
"49898",1,1,0,2,"dummy"
"49899",2,0,1,3,"dummy"
"49901",0,0,1,1,"dummy"
"49902",0,0,1,1,"dummy"
"49904",0,0,1,1,"dummy"
"49905",0,0,1,1,"dummy"
"49906",0,0,1,1,"dummy"
"49907",0,0,1,1,"dummy"
"49911",0,2,1,3,"dummy"
"49913",4,8,1,13,"dummy"
"49914",0,2,2,4,"dummy"
"49916",0,2,0,2,"dummy"
"49917",0,3,0,3,"dummy"
"49918",0,0,2,2,"dummy"
"49919",0,6,0,6,"dummy"
"49920",0,0,5,5,"dummy"
"49921",0,0,3,3,"dummy"
"49923",0,5,6,11,"dummy"
"49926",0,1,0,1,"dummy"
"49928",0,7,0,7,"dummy"
"49929",6,15,2,23,"dummy"
"49930",1,2,0,3,"dummy"
"49931",0,0,0,0,"dummy"
"49935",1,4,0,5,"dummy"
"49936",0,2,0,2,"dummy"
"49937",0,2,0,2,"dummy"
"49938",4,5,5,14,"dummy"
"49939",9,2,2,13,"dummy"
"49941",0,0,1,1,"dummy"
"49942",0,0,1,1,"dummy"
"49943",0,0,1,1,"dummy"
"49944",0,1,0,1,"dummy"
"49945",0,0,1,1,"dummy"
"49946",0,0,1,1,"dummy"
"49947",0,0,1,1,"dummy"
"49948",0,0,1,1,"dummy"
"49949",0,0,1,1,"dummy"
"49950",0,0,1,1,"dummy"
"49951",6,13,2,21,"dummy"
"49952",0,0,1,1,"dummy"
"49953",1,0,1,2,"dummy"
"49954",0,0,1,1,"dummy"
"49955",0,0,1,1,"dummy"
"49956",0,0,1,1,"dummy"
"49957",3,0,1,4,"dummy"
"49958",0,0,1,1,"dummy"
"49959",6,0,1,7,"dummy"
"49960",3,0,0,3,"dummy"
"49961",0,0,1,1,"dummy"
"49962",0,0,1,1,"dummy"
"49964",0,0,0,0,"dummy"
"49966",0,1,0,1,"dummy"
"49968",11,7,0,18,"dummy"
"49969",0,1,0,1,"dummy"
"49972",0,1,0,1,"dummy"
"49973",0,2,0,2,"dummy"
"49974",0,4,1,5,"dummy"
"49982",12,17,2,31,"dummy"
"49983",0,0,0,0,"dummy"
"49984",0,0,0,0,"dummy"
"49986",1,2,0,3,"dummy"
"49989",0,0,1,1,"dummy"
"49990",0,0,1,1,"dummy"
"49991",1,3,0,4,"dummy"
"49993",1,1,0,2,"dummy"
"49996",2,1,1,4,"dummy"
"49997",4,4,0,8,"dummy"
"50000",0,1,0,1,"dummy"
"50004",0,1,0,1,"dummy"
"50005",0,1,1,2,"dummy"
"50006",0,1,0,1,"dummy"
"50009",0,1,0,1,"dummy"
"50012",4,5,1,10,"dummy"
"50013",0,0,1,1,"dummy"
"50014",0,4,1,5,"dummy"
"50015",0,2,0,2,"dummy"
"50016",0,12,0,12,"dummy"
"50017",4,2,1,7,"dummy"
"50018",6,2,0,8,"dummy"
"50023",0,0,1,1,"dummy"
"50024",4,4,0,8,"dummy"
"50025",0,0,0,0,"dummy"
"50026",5,0,1,6,"dummy"
"50029",0,3,0,3,"dummy"
"50030",0,1,0,1,"dummy"
"50031",0,1,0,1,"dummy"
"50032",0,2,3,5,"dummy"
"50033",1,0,1,2,"dummy"
"50036",0,0,1,1,"dummy"
"50037",0,1,2,3,"dummy"
"50038",0,0,1,1,"dummy"
"50039",0,1,0,1,"dummy"
"50040",0,0,1,1,"dummy"
"50041",0,0,1,1,"dummy"
"50042",0,0,2,2,"dummy"
"50044",0,2,0,2,"dummy"
"50045",15,4,0,19,"dummy"
"50046",0,3,4,7,"dummy"
"50050",0,0,1,1,"dummy"
"50051",0,1,4,5,"dummy"
"50052",0,5,0,5,"dummy"
"50056",0,0,0,0,"dummy"
"50057",0,0,0,0,"dummy"
"50060",0,0,2,2,"dummy"
"50061",0,0,0,0,"dummy"
"50062",2,0,0,2,"dummy"
"50063",0,0,0,0,"dummy"
"50064",0,0,2,2,"dummy"
"50065",1,0,0,1,"dummy"
"50067",6,0,0,6,"dummy"
"50068",2,5,2,9,"dummy"
"50070",2,0,3,5,"dummy"
"50082",4,1,0,5,"dummy"
"50083",1,0,0,1,"dummy"
"50084",1,0,0,1,"dummy"
"50087",0,1,0,1,"dummy"
"50088",0,0,2,2,"dummy"
"50089",4,1,4,9,"dummy"
"50091",0,0,1,1,"dummy"
"50093",0,0,0,0,"dummy"
"50094",0,0,0,0,"dummy"
"50097",0,2,0,2,"dummy"
"50100",0,0,2,2,"dummy"
"50101",0,0,2,2,"dummy"
"50102",0,0,1,1,"dummy"
"50107",0,0,0,0,"dummy"
"50112",1,6,0,7,"dummy"
"50113",1,0,0,1,"dummy"
"50122",0,0,1,1,"dummy"
"50123",0,1,0,1,"dummy"
"50124",3,4,2,9,"dummy"
"50125",0,1,2,3,"dummy"
"50128",0,1,0,1,"dummy"
"50129",0,0,1,1,"dummy"
"50130",0,1,0,1,"dummy"
"50131",0,0,1,1,"dummy"
"50149",1,3,0,4,"dummy"
"50150",0,1,0,1,"dummy"
"50151",1,0,0,1,"dummy"
"50163",0,0,1,1,"dummy"
"50164",0,1,0,1,"dummy"
"50165",0,0,1,1,"dummy"
"50166",1,0,0,1,"dummy"
"50167",12,8,0,20,"dummy"
"50196",0,0,1,1,"dummy"
"50222",7,1,2,10,"dummy"
"50226",1,8,1,10,"dummy"
"50227",15,13,5,33,"dummy"
"50228",0,0,0,0,"dummy"
"50232",0,0,1,1,"dummy"
"50233",0,1,0,1,"dummy"
"50234",0,0,1,1,"dummy"
"50235",0,0,1,1,"dummy"
"50236",0,2,1,3,"dummy"
"50237",0,0,1,1,"dummy"
"50238",1,2,1,4,"dummy"
"50239",4,1,0,5,"dummy"
"50240",0,0,1,1,"dummy"
"50241",0,1,1,2,"dummy"
"50242",0,0,1,1,"dummy"
"50243",0,0,2,2,"dummy"
"50244",0,0,1,1,"dummy"
"50245",0,0,2,2,"dummy"
"50246",0,0,1,1,"dummy"
"50247",1,2,1,4,"dummy"
"50248",0,0,1,1,"dummy"
"50249",0,0,1,1,"dummy"
"50250",0,0,1,1,"dummy"
"50251",3,2,2,7,"dummy"
"50252",0,0,1,1,"dummy"
"50253",0,0,2,2,"dummy"
"50254",0,0,1,1,"dummy"
"50255",1,0,0,1,"dummy"
"50256",1,1,0,2,"dummy"
"50257",0,0,1,1,"dummy"
"50258",0,0,1,1,"dummy"
"50259",0,1,1,2,"dummy"
"50264",0,2,0,2,"dummy"
"50297",0,2,0,2,"dummy"
"50298",0,0,1,1,"dummy"
"50299",0,0,1,1,"dummy"
"50300",0,1,0,1,"dummy"
"50301",0,0,1,1,"dummy"
"50302",0,0,0,0,"dummy"
"50303",0,0,1,1,"dummy"
"50304",0,0,0,0,"dummy"
"50310",0,2,1,3,"dummy"
"50313",0,1,0,1,"dummy"
"50314",0,0,1,1,"dummy"
"50324",2,0,0,2,"dummy"
"50325",0,5,0,5,"dummy"
"50117",0,0,1,1,"dummy"
"50120",3,3,0,6,"dummy"
"50142",0,0,0,0,"dummy"
"50143",0,0,0,0,"dummy"
"50144",4,7,4,15,"dummy"
"50145",4,4,1,9,"dummy"
"50146",0,1,0,1,"dummy"
"50147",0,1,0,1,"dummy"
"50155",0,3,0,3,"dummy"
"50156",0,0,1,1,"dummy"
"50157",0,0,1,1,"dummy"
"50158",7,2,2,11,"dummy"
"50159",0,0,1,1,"dummy"
"50190",0,2,1,3,"dummy"
"50191",17,7,2,26,"dummy"
"50192",2,2,2,6,"dummy"
"50193",0,2,0,2,"dummy"
"50194",0,0,0,0,"dummy"
"50198",22,2,1,25,"dummy"
"50199",0,1,0,1,"dummy"
"50200",4,0,0,4,"dummy"
"50201",3,14,3,20,"dummy"
"50202",0,7,1,8,"dummy"
"50203",0,1,0,1,"dummy"
"50204",1,0,0,1,"dummy"
"50205",25,35,1,61,"dummy"
"50206",0,0,3,3,"dummy"
"50207",0,0,0,0,"dummy"
"50208",16,16,4,36,"dummy"
"50209",0,0,1,1,"dummy"
"50210",1,2,1,4,"dummy"
"50211",0,1,5,6,"dummy"
"50212",0,2,2,4,"dummy"
"50213",0,1,0,1,"dummy"
"50214",0,1,0,1,"dummy"
"50215",0,0,0,0,"dummy"
"50216",0,0,1,1,"dummy"
"50217",10,11,0,21,"dummy"
"50218",12,12,4,28,"dummy"
"50224",0,0,0,0,"dummy"
"50230",1,0,0,1,"dummy"
"50268",0,0,0,0,"dummy"
"50269",0,0,0,0,"dummy"
"50272",0,0,1,1,"dummy"
"50273",0,0,3,3,"dummy"
"50274",0,3,0,3,"dummy"
"50275",0,1,0,1,"dummy"
"50278",0,1,0,1,"dummy"
"50279",2,1,0,3,"dummy"
"50280",1,0,0,1,"dummy"
"50327",0,2,0,2,"dummy"
"50360",5,0,5,10,"dummy"
"50352",1,4,1,6,"dummy"
"50353",2,0,0,2,"dummy"
"50354",0,2,1,3,"dummy"
"50355",0,0,1,1,"dummy"
"50356",0,0,1,1,"dummy"
"50357",2,2,2,6,"dummy"
"50358",10,11,3,24,"dummy"
"50363",3,3,0,6,"dummy"
"50364",0,0,1,1,"dummy"
"50365",0,1,0,1,"dummy"
"50366",0,3,0,3,"dummy"
"50367",0,1,0,1,"dummy"
"50368",0,1,0,1,"dummy"
"50378",0,0,1,1,"dummy"
"50381",0,2,1,3,"dummy"
"50387",0,0,1,1,"dummy"
"50397",0,0,0,0,"dummy"
"50398",0,0,0,0,"dummy"
"50399",4,3,2,9,"dummy"
"50402",0,1,0,1,"dummy"
"50416",0,0,1,1,"dummy"
"50417",0,0,1,1,"dummy"
"50475",0,0,1,1,"dummy"
"50476",1,1,0,2,"dummy"
"50477",0,1,0,1,"dummy"
"50478",0,1,0,1,"dummy"
"50479",0,1,0,1,"dummy"
"50480",0,0,1,1,"dummy"
"50481",0,0,1,1,"dummy"
"50489",5,0,1,6,"dummy"
"50490",0,5,1,6,"dummy"
"50491",5,0,1,6,"dummy"
"50501",4,1,1,6,"dummy"
"50502",5,0,0,5,"dummy"
"50503",0,0,1,1,"dummy"
"50504",4,10,0,14,"dummy"
"50505",3,0,0,3,"dummy"
"50506",1,1,0,2,"dummy"
"50509",0,0,1,1,"dummy"
"50510",0,0,4,4,"dummy"
"50511",0,0,1,1,"dummy"
"50512",1,4,0,5,"dummy"
"50513",0,0,0,0,"dummy"
"50514",0,0,1,1,"dummy"
"50515",0,0,1,1,"dummy"
"50516",0,0,1,1,"dummy"
"50517",0,0,1,1,"dummy"
"50518",0,0,1,1,"dummy"
"50519",0,0,1,1,"dummy"
"50520",0,0,1,1,"dummy"
"50521",0,0,1,1,"dummy"
"50522",0,0,1,1,"dummy"
"50523",0,0,1,1,"dummy"
"50524",0,0,1,1,"dummy"
"50525",0,0,1,1,"dummy"
"50526",0,0,1,1,"dummy"
"50527",0,0,3,3,"dummy"
"50528",0,2,0,2,"dummy"
"50529",0,0,3,3,"dummy"
"50530",0,0,1,1,"dummy"
"50531",0,0,1,1,"dummy"
"50532",0,0,1,1,"dummy"
"50533",0,0,1,1,"dummy"
"50534",2,1,0,3,"dummy"
"50535",0,0,1,1,"dummy"
"50536",0,0,1,1,"dummy"
"50537",0,2,2,4,"dummy"
"50538",0,0,1,1,"dummy"
"50539",0,1,0,1,"dummy"
"50540",0,0,1,1,"dummy"
"50541",0,0,1,1,"dummy"
"50542",0,0,1,1,"dummy"
"50543",0,0,1,1,"dummy"
"50544",0,0,1,1,"dummy"
"50545",0,0,1,1,"dummy"
"50546",0,0,1,1,"dummy"
"50547",2,3,0,5,"dummy"
"50548",0,2,0,2,"dummy"
"50549",0,0,1,1,"dummy"
"50550",0,0,1,1,"dummy"
"50361",0,0,1,1,"dummy"
"50383",0,0,0,0,"dummy"
"50406",0,1,0,1,"dummy"
"50407",0,2,0,2,"dummy"
"50408",0,1,0,1,"dummy"
"50409",0,3,2,5,"dummy"
"50410",0,1,0,1,"dummy"
"50411",2,1,0,3,"dummy"
"50412",0,6,0,6,"dummy"
"50421",0,1,0,1,"dummy"
"50422",0,0,1,1,"dummy"
"50423",3,3,1,7,"dummy"
"50432",1,1,0,2,"dummy"
"50433",3,5,0,8,"dummy"
"50434",0,1,0,1,"dummy"
"50435",20,5,1,26,"dummy"
"50436",0,0,0,0,"dummy"
"50437",0,0,1,1,"dummy"
"50438",0,3,0,3,"dummy"
"50439",2,2,1,5,"dummy"
"50440",0,1,0,1,"dummy"
"50441",0,2,0,2,"dummy"
"50444",0,0,0,0,"dummy"
"50445",9,10,0,19,"dummy"
"50446",2,3,1,6,"dummy"
"50447",0,2,0,2,"dummy"
"50448",0,1,1,2,"dummy"
"50449",0,8,0,8,"dummy"
"50450",0,5,0,5,"dummy"
"50451",1,5,0,6,"dummy"
"50452",0,2,0,2,"dummy"
"50453",1,0,0,1,"dummy"
"50454",0,0,0,0,"dummy"
"50455",0,0,5,5,"dummy"
"50456",0,13,0,13,"dummy"
"50457",0,6,0,6,"dummy"
"50460",6,17,8,31,"dummy"
"50461",4,10,9,23,"dummy"
"50462",0,0,1,1,"dummy"
"50463",0,2,0,2,"dummy"
"50464",0,0,0,0,"dummy"
"50465",0,0,0,0,"dummy"
"50466",9,2,2,13,"dummy"
"50467",0,0,3,3,"dummy"
"50468",2,10,3,15,"dummy"
"50469",2,2,1,5,"dummy"
"50470",12,4,2,18,"dummy"
"50471",0,1,0,1,"dummy"
"50472",1,0,0,1,"dummy"
"50473",2,0,0,2,"dummy"
"50495",0,1,0,1,"dummy"
"50496",0,4,0,4,"dummy"
"50497",6,3,0,9,"dummy"
"50557",0,0,0,0,"dummy"
"50558",2,0,0,2,"dummy"
"50582",0,0,0,0,"dummy"
"50586",0,0,1,1,"dummy"
"50613",0,1,1,2,"dummy"
"50614",3,2,4,9,"dummy"
"50615",0,1,0,1,"dummy"
"50616",0,0,0,0,"dummy"
"50617",1,0,0,1,"dummy"
"50618",0,7,0,7,"dummy"
"50551",0,0,1,1,"dummy"
"50554",9,8,1,18,"dummy"
"50555",0,1,0,1,"dummy"
"50568",0,2,0,2,"dummy"
"50569",0,0,1,1,"dummy"
"50570",0,0,1,1,"dummy"
"50571",0,1,0,1,"dummy"
"50572",0,0,2,2,"dummy"
"50573",0,1,0,1,"dummy"
"50574",0,1,0,1,"dummy"
"50575",1,2,0,3,"dummy"
"50576",1,0,0,1,"dummy"
"50577",0,0,1,1,"dummy"
"50578",2,2,0,4,"dummy"
"50584",1,0,0,1,"dummy"
"50588",0,0,2,2,"dummy"
"50589",0,20,1,21,"dummy"
"50590",0,0,1,1,"dummy"
"50593",1,1,0,2,"dummy"
"50598",0,0,0,0,"dummy"
"50599",13,0,0,13,"dummy"
"50600",0,1,0,1,"dummy"
"50601",0,5,0,5,"dummy"
"50602",0,0,0,0,"dummy"
"50603",0,0,1,1,"dummy"
"50604",0,1,0,1,"dummy"
"50605",0,8,0,8,"dummy"
"50606",5,1,4,10,"dummy"
"50607",0,8,0,8,"dummy"
"50608",0,1,1,2,"dummy"
"50609",4,14,1,19,"dummy"
"50638",0,0,2,2,"dummy"
"50639",4,5,0,9,"dummy"
"50642",0,0,0,0,"dummy"
"50645",0,0,0,0,"dummy"
"50648",2,2,3,7,"dummy"
"50649",1,1,0,2,"dummy"
"50653",0,22,0,22,"dummy"
"50654",0,2,0,2,"dummy"
"50655",0,0,1,1,"dummy"
"50656",2,3,0,5,"dummy"
"50658",0,1,0,1,"dummy"
"50660",0,0,1,1,"dummy"
"50663",0,1,0,1,"dummy"
"50664",0,1,0,1,"dummy"
"50665",0,1,0,1,"dummy"
"50672",1,6,0,7,"dummy"
"50697",5,20,2,27,"dummy"
"50698",7,0,3,10,"dummy"
"50699",0,0,1,1,"dummy"
"50702",0,1,0,1,"dummy"
"50704",8,0,0,8,"dummy"
"50705",0,0,5,5,"dummy"
"50706",0,0,1,1,"dummy"
"50707",0,1,0,1,"dummy"
"50708",1,0,0,1,"dummy"
"50709",2,0,4,6,"dummy"
"50711",0,4,0,4,"dummy"
"50712",9,7,7,23,"dummy"
"50716",0,0,0,0,"dummy"
"50717",0,0,1,1,"dummy"
"50718",11,1,0,12,"dummy"
"50719",0,0,1,1,"dummy"
"50720",0,0,1,1,"dummy"
"50721",0,0,1,1,"dummy"
"50722",0,0,0,0,"dummy"
"50723",0,0,0,0,"dummy"
"50724",0,0,0,0,"dummy"
"50725",0,0,1,1,"dummy"
"50726",0,0,1,1,"dummy"
"50727",0,0,0,0,"dummy"
"50728",0,0,0,0,"dummy"
"50729",0,0,0,0,"dummy"
"50730",0,0,0,0,"dummy"
"50731",0,0,0,0,"dummy"
"50732",0,0,0,0,"dummy"
"50733",0,2,0,2,"dummy"
"50734",2,0,0,2,"dummy"
"50735",0,2,0,2,"dummy"
"50736",6,3,0,9,"dummy"
"50737",0,0,1,1,"dummy"
"50738",0,0,0,0,"dummy"
"50739",0,0,1,1,"dummy"
"50740",0,0,1,1,"dummy"
"50741",0,0,1,1,"dummy"
"50743",5,11,2,18,"dummy"
"50744",11,5,1,17,"dummy"
"50745",5,13,3,21,"dummy"
"50746",2,4,1,7,"dummy"
"50747",0,0,0,0,"dummy"
"50749",1,4,0,5,"dummy"
"50752",0,1,0,1,"dummy"
"50753",1,0,0,1,"dummy"
"50754",1,0,0,1,"dummy"
"50755",0,2,0,2,"dummy"
"50756",0,2,0,2,"dummy"
"50757",0,0,0,0,"dummy"
"50758",1,0,0,1,"dummy"
"50759",1,0,0,1,"dummy"
"50760",1,1,0,2,"dummy"
"50765",0,2,0,2,"dummy"
"50767",0,0,0,0,"dummy"
"50768",5,9,2,16,"dummy"
"50769",1,0,0,1,"dummy"
"50770",3,2,1,6,"dummy"
"50771",1,1,3,5,"dummy"
"50772",1,1,1,3,"dummy"
"50773",0,0,1,1,"dummy"
"50774",2,0,1,3,"dummy"
"50775",0,0,1,1,"dummy"
"50776",6,1,1,8,"dummy"
"50777",1,0,1,2,"dummy"
"50778",0,2,1,3,"dummy"
"50779",0,0,3,3,"dummy"
"50780",0,0,1,1,"dummy"
"50781",0,0,1,1,"dummy"
"50782",0,5,1,6,"dummy"
"50783",0,2,0,2,"dummy"
"50784",0,0,1,1,"dummy"
"50786",0,0,1,1,"dummy"
"50787",0,1,0,1,"dummy"
"50788",1,1,1,3,"dummy"
"50789",0,4,0,4,"dummy"
"50790",5,0,0,5,"dummy"
"50792",0,0,2,2,"dummy"
"50793",0,0,1,1,"dummy"
"50794",0,0,2,2,"dummy"
"50795",0,0,1,1,"dummy"
"50796",0,0,2,2,"dummy"
"50797",0,0,1,1,"dummy"
"50798",6,3,1,10,"dummy"
"50799",0,0,2,2,"dummy"
"50801",0,1,0,1,"dummy"
"50802",0,1,0,1,"dummy"
"50803",0,4,0,4,"dummy"
"50804",0,1,0,1,"dummy"
"50823",0,7,0,7,"dummy"
"50824",5,7,0,12,"dummy"
"50825",0,0,0,0,"dummy"
"50826",6,0,1,7,"dummy"
"50832",0,1,0,1,"dummy"
"50833",0,0,2,2,"dummy"
"50834",0,0,2,2,"dummy"
"50835",0,0,1,1,"dummy"
"50850",0,0,1,1,"dummy"
"50851",0,0,1,1,"dummy"
"50853",0,0,0,0,"dummy"
"50863",0,3,0,3,"dummy"
"50865",3,0,0,3,"dummy"
"50866",1,0,1,2,"dummy"
"50867",0,0,1,1,"dummy"
"50868",0,1,0,1,"dummy"
"50869",0,0,1,1,"dummy"
"50870",1,0,1,2,"dummy"
"50872",10,0,1,11,"dummy"
"50873",0,3,0,3,"dummy"
"50874",1,0,1,2,"dummy"
"50875",0,1,1,2,"dummy"
"50876",1,0,0,1,"dummy"
"50877",1,0,0,1,"dummy"
"50880",7,11,0,18,"dummy"
"50906",0,6,2,8,"dummy"
"50909",1,1,2,4,"dummy"
"50912",0,1,0,1,"dummy"
"50913",1,1,0,2,"dummy"
"50915",2,16,1,19,"dummy"
"50918",0,1,0,1,"dummy"
"50919",0,0,1,1,"dummy"
"50920",0,0,3,3,"dummy"
"50921",0,0,1,1,"dummy"
"50922",1,7,4,12,"dummy"
"50924",0,4,0,4,"dummy"
"50927",0,1,0,1,"dummy"
"50929",0,0,1,1,"dummy"
"50930",1,0,0,1,"dummy"
"50931",5,3,1,9,"dummy"
"50933",0,1,0,1,"dummy"
"50934",3,6,0,9,"dummy"
"50935",0,0,0,0,"dummy"
"50936",0,0,1,1,"dummy"
"50938",0,0,0,0,"dummy"
"50942",0,0,1,1,"dummy"
"50948",0,0,0,0,"dummy"
"50949",1,0,1,2,"dummy"
"50951",2,0,0,2,"dummy"
"50959",0,1,1,2,"dummy"
"50960",3,5,0,8,"dummy"
"50961",1,0,1,2,"dummy"
"50965",1,2,0,3,"dummy"
"50966",0,1,0,1,"dummy"
"50967",0,2,0,2,"dummy"
"50979",1,0,0,1,"dummy"
"50980",0,0,1,1,"dummy"
"50981",0,5,0,5,"dummy"
"50982",3,0,0,3,"dummy"
"50983",0,0,1,1,"dummy"
"50985",0,1,0,1,"dummy"
"50986",1,0,0,1,"dummy"
"50988",2,0,1,3,"dummy"
"50989",3,2,1,6,"dummy"
"50991",0,0,0,0,"dummy"
"50992",0,0,1,1,"dummy"
"50999",0,1,3,4,"dummy"
"51000",0,2,0,2,"dummy"
"51031",0,2,0,2,"dummy"
"51033",0,1,0,1,"dummy"
"51035",0,0,0,0,"dummy"
"51036",0,0,1,1,"dummy"
"51037",0,0,1,1,"dummy"
"51038",0,0,1,1,"dummy"
"51039",0,0,1,1,"dummy"
"51040",0,0,1,1,"dummy"
"51041",0,1,0,1,"dummy"
"51042",0,0,1,1,"dummy"
"51043",0,0,1,1,"dummy"
"51044",0,0,1,1,"dummy"
"51045",0,0,1,1,"dummy"
"51049",0,0,1,1,"dummy"
"51050",0,1,0,1,"dummy"
"51052",0,4,1,5,"dummy"
"51053",0,0,1,1,"dummy"
"51055",0,0,0,0,"dummy"
"51058",0,1,0,1,"dummy"
"51060",0,2,0,2,"dummy"
"51061",0,1,0,1,"dummy"
"51062",3,3,1,7,"dummy"
"51065",0,0,1,1,"dummy"
"51066",0,1,2,3,"dummy"
"51067",0,1,0,1,"dummy"
"51068",0,1,0,1,"dummy"
"51069",0,1,0,1,"dummy"
"51071",0,1,0,1,"dummy"
"51127",0,1,1,2,"dummy"
"51128",0,1,0,1,"dummy"
"51129",1,8,1,10,"dummy"
"51130",1,0,0,1,"dummy"
"51150",0,0,1,1,"dummy"
"51151",0,0,1,1,"dummy"
"51152",0,0,1,1,"dummy"
"51153",0,0,1,1,"dummy"
"51155",1,0,1,2,"dummy"
"51156",0,0,3,3,"dummy"
"51157",1,2,0,3,"dummy"
"51158",2,1,5,8,"dummy"
"51159",1,1,4,6,"dummy"
"51160",0,2,2,4,"dummy"
"51161",1,1,3,5,"dummy"
"51162",2,10,3,15,"dummy"
"51163",0,0,1,1,"dummy"
"51164",0,0,1,1,"dummy"
"51165",0,0,1,1,"dummy"
"51166",5,3,0,8,"dummy"
"51167",0,1,1,2,"dummy"
"51168",0,1,1,2,"dummy"
"51169",0,0,3,3,"dummy"
"51170",0,0,1,1,"dummy"
"51171",0,0,1,1,"dummy"
"51172",4,6,3,13,"dummy"
"51173",0,0,1,1,"dummy"
"51174",0,0,1,1,"dummy"
"51175",0,0,1,1,"dummy"
"51176",1,0,1,2,"dummy"
"51200",0,0,2,2,"dummy"
"51201",0,0,2,2,"dummy"
"51202",0,2,0,2,"dummy"
"51203",0,1,0,1,"dummy"
"51204",1,2,0,3,"dummy"
"51205",0,1,0,1,"dummy"
"51206",1,1,0,2,"dummy"
"51207",0,1,0,1,"dummy"
"51208",1,1,0,2,"dummy"
"51209",1,1,0,2,"dummy"
"51210",0,1,1,2,"dummy"
"51211",2,1,1,4,"dummy"
"51212",1,1,0,2,"dummy"
"51213",1,0,0,1,"dummy"
"51214",0,3,0,3,"dummy"
"51215",0,0,1,1,"dummy"
"51216",1,5,3,9,"dummy"
"51236",0,10,0,10,"dummy"
"51237",0,0,1,1,"dummy"
"51238",0,23,0,23,"dummy"
"51239",1,0,0,1,"dummy"
"51240",0,0,0,0,"dummy"
"51241",2,0,0,2,"dummy"
"51242",2,0,0,2,"dummy"
"51243",2,0,0,2,"dummy"
"51244",3,0,0,3,"dummy"
"51263",12,2,0,14,"dummy"
"51264",1,11,0,12,"dummy"
"51265",0,1,0,1,"dummy"
"51266",0,0,3,3,"dummy"
"51267",1,0,0,1,"dummy"
"51268",1,0,0,1,"dummy"
"51269",11,12,0,23,"dummy"
"51290",4,4,0,8,"dummy"
"51291",0,0,3,3,"dummy"
"51294",2,4,0,6,"dummy"
"51295",0,2,0,2,"dummy"
"51296",0,2,0,2,"dummy"
"51297",10,2,0,12,"dummy"
"51298",0,2,0,2,"dummy"
"51299",0,0,0,0,"dummy"
"51300",0,0,5,5,"dummy"
"51301",0,0,1,1,"dummy"
"51302",11,39,5,55,"dummy"
"51303",30,15,10,55,"dummy"
"51304",16,18,5,39,"dummy"
"51305",0,2,0,2,"dummy"
"51306",1,0,4,5,"dummy"
"51307",0,1,0,1,"dummy"
"51308",0,0,1,1,"dummy"
"51309",3,8,2,13,"dummy"
"51310",1,2,1,4,"dummy"
"51311",0,1,1,2,"dummy"
"51312",0,0,1,1,"dummy"
"51313",0,0,1,1,"dummy"
"51314",4,4,0,8,"dummy"
"51315",1,0,4,5,"dummy"
"51320",5,1,1,7,"dummy"
"51328",0,2,0,2,"dummy"
"51329",1,2,0,3,"dummy"
"51335",0,3,0,3,"dummy"
"51336",0,1,0,1,"dummy"
"51337",0,6,0,6,"dummy"
"51353",0,1,0,1,"dummy"
"51354",0,0,1,1,"dummy"
"51359",2,12,1,15,"dummy"
"51360",2,2,0,4,"dummy"
"51361",3,6,1,10,"dummy"
"51362",1,3,1,5,"dummy"
"51363",0,1,0,1,"dummy"
"51364",0,1,0,1,"dummy"
"51180",0,9,1,10,"dummy"
"51181",9,1,0,10,"dummy"
"51188",0,0,1,1,"dummy"
"51189",0,2,2,4,"dummy"
"51190",0,2,0,2,"dummy"
"51191",2,1,0,3,"dummy"
"51192",0,1,1,2,"dummy"
"51221",6,1,3,10,"dummy"
"51222",0,0,2,2,"dummy"
"51228",0,6,0,6,"dummy"
"51229",2,0,0,2,"dummy"
"51230",6,4,0,10,"dummy"
"51231",0,0,1,1,"dummy"
"51232",0,0,1,1,"dummy"
"51252",36,24,4,64,"dummy"
"51253",2,5,1,8,"dummy"
"51254",0,1,0,1,"dummy"
"51255",0,1,0,1,"dummy"
"51256",31,20,2,53,"dummy"
"51257",6,14,0,20,"dummy"
"51258",0,0,1,1,"dummy"
"51259",0,2,0,2,"dummy"
"51260",0,2,0,2,"dummy"
"51261",0,0,0,0,"dummy"
"51287",0,3,0,3,"dummy"
"51288",4,3,1,8,"dummy"
"51324",2,2,0,4,"dummy"
"51339",0,1,0,1,"dummy"
"51380",0,1,1,2,"dummy"
"51381",0,3,3,6,"dummy"
"51382",10,14,8,32,"dummy"
"51383",0,0,0,0,"dummy"
"51384",24,2,1,27,"dummy"
"51385",0,1,0,1,"dummy"
"51386",1,3,0,4,"dummy"
"51459",0,1,0,1,"dummy"
"51460",0,0,1,1,"dummy"
"51469",0,0,0,0,"dummy"
"51470",0,0,1,1,"dummy"
"51471",0,1,0,1,"dummy"
"51472",3,2,4,9,"dummy"
"51473",1,1,0,2,"dummy"
"51474",3,5,2,10,"dummy"
"51475",0,0,1,1,"dummy"
"51476",0,0,2,2,"dummy"
"51477",0,0,0,0,"dummy"
"51478",0,0,2,2,"dummy"
"51479",0,0,2,2,"dummy"
"51483",6,1,1,8,"dummy"
"51484",0,1,0,1,"dummy"
"51485",0,1,0,1,"dummy"
"51486",1,4,0,5,"dummy"
"51487",3,3,0,6,"dummy"
"51493",0,1,0,1,"dummy"
"51494",0,0,2,2,"dummy"
"51495",0,1,0,1,"dummy"
"51496",5,3,0,8,"dummy"
"51499",0,0,1,1,"dummy"
"51365",0,1,1,2,"dummy"
"51366",2,0,3,5,"dummy"
"51367",0,0,1,1,"dummy"
"51368",0,0,1,1,"dummy"
"51369",0,0,1,1,"dummy"
"51370",0,0,1,1,"dummy"
"51371",0,0,1,1,"dummy"
"51372",0,0,1,1,"dummy"
"51373",0,2,1,3,"dummy"
"51374",0,0,0,0,"dummy"
"51377",0,2,0,2,"dummy"
"51378",0,7,0,7,"dummy"
"51388",0,0,1,1,"dummy"
"51389",0,0,1,1,"dummy"
"51390",0,0,1,1,"dummy"
"51391",0,0,1,1,"dummy"
"51392",0,0,1,1,"dummy"
"51393",0,0,1,1,"dummy"
"51394",0,0,1,1,"dummy"
"51395",0,0,1,1,"dummy"
"51481",6,1,0,7,"dummy"
"51505",0,1,0,1,"dummy"
"51524",0,2,2,4,"dummy"
"51525",0,0,0,0,"dummy"
"51526",1,0,2,3,"dummy"
"51543",0,0,1,1,"dummy"
"51546",0,0,0,0,"dummy"
"51547",0,0,0,0,"dummy"
"51548",0,0,0,0,"dummy"
"51549",0,0,0,0,"dummy"
"51550",0,1,0,1,"dummy"
"51551",1,0,0,1,"dummy"
"51552",1,5,0,6,"dummy"
"51553",5,1,1,7,"dummy"
"51554",0,0,0,0,"dummy"
"51555",0,6,0,6,"dummy"
"51556",6,1,0,7,"dummy"
"51557",0,0,0,0,"dummy"
"51558",0,0,1,1,"dummy"
"51559",0,0,0,0,"dummy"
"51560",0,0,0,0,"dummy"
"51563",11,11,3,25,"dummy"
"51564",0,2,0,2,"dummy"
"51565",2,3,0,5,"dummy"
"51566",4,9,0,13,"dummy"
"51567",1,3,0,4,"dummy"
"51568",0,1,0,1,"dummy"
"51571",11,11,0,22,"dummy"
"51575",0,0,1,1,"dummy"
"51576",0,0,2,2,"dummy"
"51577",0,0,0,0,"dummy"
"51586",0,0,1,1,"dummy"
"51587",0,1,0,1,"dummy"
"51588",1,0,0,1,"dummy"
"51589",1,0,0,1,"dummy"
"51590",1,2,0,3,"dummy"
"51591",2,1,0,3,"dummy"
"51592",1,2,0,3,"dummy"
"51593",0,1,0,1,"dummy"
"51594",0,5,0,5,"dummy"
"51595",0,1,0,1,"dummy"
"51596",0,1,0,1,"dummy"
"51597",1,0,0,1,"dummy"
"51598",0,1,0,1,"dummy"
"51599",1,0,0,1,"dummy"
"51602",0,1,0,1,"dummy"
"51603",0,2,0,2,"dummy"
"51604",1,6,0,7,"dummy"
"51605",0,3,0,3,"dummy"
"51606",4,8,2,14,"dummy"
"51607",1,1,1,3,"dummy"
"51608",0,0,1,1,"dummy"
"51609",0,0,1,1,"dummy"
"51610",2,3,5,10,"dummy"
"51611",0,0,1,1,"dummy"
"51612",5,7,2,14,"dummy"
"51613",0,0,1,1,"dummy"
"51614",4,2,1,7,"dummy"
"51615",2,6,0,8,"dummy"
"51616",2,1,0,3,"dummy"
"51617",0,1,0,1,"dummy"
"51618",0,0,1,1,"dummy"
"51500",0,0,1,1,"dummy"
"51501",0,2,1,3,"dummy"
"51511",1,2,1,4,"dummy"
"51512",2,1,1,4,"dummy"
"51513",0,2,1,3,"dummy"
"51514",0,1,0,1,"dummy"
"51515",4,4,1,9,"dummy"
"51528",0,0,1,1,"dummy"
"51529",0,0,1,1,"dummy"
"51530",3,0,4,7,"dummy"
"51531",1,3,2,6,"dummy"
"51532",1,2,0,3,"dummy"
"51533",5,2,2,9,"dummy"
"51534",0,0,0,0,"dummy"
"51535",0,0,0,0,"dummy"
"51536",0,0,0,0,"dummy"
"51537",0,2,1,3,"dummy"
"51540",0,1,0,1,"dummy"
"51541",0,0,1,1,"dummy"
"51573",1,3,0,4,"dummy"
"51581",6,6,1,13,"dummy"
"51582",2,3,0,5,"dummy"
"51583",16,0,2,18,"dummy"
"51584",16,1,0,17,"dummy"
"51640",4,1,0,5,"dummy"
"51641",0,3,0,3,"dummy"
"51642",2,3,1,6,"dummy"
"51643",0,0,1,1,"dummy"
"51644",4,4,0,8,"dummy"
"51645",1,3,0,4,"dummy"
"51646",3,0,0,3,"dummy"
"51647",1,0,0,1,"dummy"
"51653",0,1,0,1,"dummy"
"51654",0,1,0,1,"dummy"
"51655",0,0,1,1,"dummy"
"51658",0,0,1,1,"dummy"
"51659",7,11,4,22,"dummy"
"51660",0,0,2,2,"dummy"
"51661",5,0,4,9,"dummy"
"51662",0,5,6,11,"dummy"
"51663",5,0,4,9,"dummy"
"51664",0,0,1,1,"dummy"
"51665",0,2,1,3,"dummy"
"51672",1,1,2,4,"dummy"
"51678",0,0,0,0,"dummy"
"51681",6,0,0,6,"dummy"
"51682",2,5,2,9,"dummy"
"51699",2,3,0,5,"dummy"
"51700",0,1,0,1,"dummy"
"51701",2,2,1,5,"dummy"
"51702",0,0,1,1,"dummy"
"51738",4,3,1,8,"dummy"
"51739",1,0,8,9,"dummy"
"51740",0,0,0,0,"dummy"
"51778",0,0,1,1,"dummy"
"51779",0,0,1,1,"dummy"
"51782",0,0,1,1,"dummy"
"51801",0,2,0,2,"dummy"
"51802",2,0,0,2,"dummy"
"51807",2,4,0,6,"dummy"
"51808",0,2,0,2,"dummy"
"51809",0,2,0,2,"dummy"
"51810",10,2,0,12,"dummy"
"51811",0,2,0,2,"dummy"
"51812",0,0,0,0,"dummy"
"51813",0,0,3,3,"dummy"
"51814",0,5,0,5,"dummy"
"51827",1,1,2,4,"dummy"
"51828",0,0,1,1,"dummy"
"51619",7,5,1,13,"dummy"
"51620",0,1,0,1,"dummy"
"51621",0,0,3,3,"dummy"
"51622",0,1,0,1,"dummy"
"51623",0,5,1,6,"dummy"
"51624",0,0,0,0,"dummy"
"51625",0,0,1,1,"dummy"
"51626",0,0,1,1,"dummy"
"51627",4,48,1,53,"dummy"
"51628",0,7,0,7,"dummy"
"51629",7,2,2,11,"dummy"
"51630",0,0,2,2,"dummy"
"51631",42,0,1,43,"dummy"
"51632",0,4,0,4,"dummy"
"51633",13,10,1,24,"dummy"
"51634",0,0,1,1,"dummy"
"51635",0,6,1,7,"dummy"
"51636",0,0,2,2,"dummy"
"51637",2,2,5,9,"dummy"
"51638",0,0,5,5,"dummy"
"51649",6,2,3,11,"dummy"
"51650",0,1,0,1,"dummy"
"51651",2,2,2,6,"dummy"
"51674",0,0,1,1,"dummy"
"51684",0,3,0,3,"dummy"
"51685",0,0,1,1,"dummy"
"51708",0,0,0,0,"dummy"
"51709",1,2,0,3,"dummy"
"51710",0,1,0,1,"dummy"
"51711",0,2,0,2,"dummy"
"51712",0,0,0,0,"dummy"
"51713",0,0,0,0,"dummy"
"51714",0,0,0,0,"dummy"
"51715",2,2,0,4,"dummy"
"51718",0,0,1,1,"dummy"
"51719",0,0,1,1,"dummy"
"51720",0,2,0,2,"dummy"
"51742",0,1,0,1,"dummy"
"51743",0,0,0,0,"dummy"
"51744",1,2,0,3,"dummy"
"51745",2,2,0,4,"dummy"
"51746",2,8,0,10,"dummy"
"51747",1,2,0,3,"dummy"
"51748",0,1,3,4,"dummy"
"51749",1,1,0,2,"dummy"
"51750",1,0,3,4,"dummy"
"51751",0,1,3,4,"dummy"
"51752",0,1,0,1,"dummy"
"51753",10,6,2,18,"dummy"
"51754",2,0,0,2,"dummy"
"51755",0,0,1,1,"dummy"
"51756",2,2,0,4,"dummy"
"51757",1,4,0,5,"dummy"
"51758",11,3,0,14,"dummy"
"51759",1,1,0,2,"dummy"
"51760",0,1,0,1,"dummy"
"51761",5,2,1,8,"dummy"
"51762",2,0,0,2,"dummy"
"51763",1,2,0,3,"dummy"
"51764",2,0,1,3,"dummy"
"51765",2,1,0,3,"dummy"
"51766",1,2,0,3,"dummy"
"51767",2,1,0,3,"dummy"
"51768",2,0,0,2,"dummy"
"51769",0,2,0,2,"dummy"
"51770",0,0,1,1,"dummy"
"51771",7,1,0,8,"dummy"
"51772",2,0,0,2,"dummy"
"51773",7,5,3,15,"dummy"
"51774",1,1,0,2,"dummy"
"51775",0,1,0,1,"dummy"
"51776",1,1,0,2,"dummy"
"51784",2,2,1,5,"dummy"
"51785",0,3,0,3,"dummy"
"51786",0,0,1,1,"dummy"
"51787",0,0,2,2,"dummy"
"51788",0,0,1,1,"dummy"
"51789",0,1,0,1,"dummy"
"51790",0,0,1,1,"dummy"
"51791",0,0,1,1,"dummy"
"51792",0,0,0,0,"dummy"
"51797",0,1,0,1,"dummy"
"51816",0,0,2,2,"dummy"
"51817",2,1,3,6,"dummy"
"51818",4,3,1,8,"dummy"
"51819",0,1,0,1,"dummy"
"51820",0,1,0,1,"dummy"
"51821",0,2,0,2,"dummy"
"51822",0,0,1,1,"dummy"
"51823",2,14,7,23,"dummy"
"51824",6,0,1,7,"dummy"
"51825",1,0,0,1,"dummy"
"51831",1,1,4,6,"dummy"
"51832",7,0,0,7,"dummy"
"51845",0,0,0,0,"dummy"
"51848",0,2,0,2,"dummy"
"51849",2,3,0,5,"dummy"
"51850",0,0,1,1,"dummy"
"51851",0,17,2,19,"dummy"
"51852",0,2,1,3,"dummy"
"51853",0,0,1,1,"dummy"
"51854",7,8,0,15,"dummy"
"51855",4,0,0,4,"dummy"
"51856",16,0,2,18,"dummy"
"51857",0,0,1,1,"dummy"
"51858",0,0,1,1,"dummy"
"51877",0,1,2,3,"dummy"
"51878",0,0,0,0,"dummy"
"51879",0,1,0,1,"dummy"
"51880",4,0,2,6,"dummy"
"51881",1,0,0,1,"dummy"
"51882",0,0,0,0,"dummy"
"51897",0,12,0,12,"dummy"
"51898",0,7,0,7,"dummy"
"51899",4,6,5,15,"dummy"
"51900",2,11,0,13,"dummy"
"51901",0,0,0,0,"dummy"
"51902",0,0,1,1,"dummy"
"51903",0,1,1,2,"dummy"
"51904",0,2,0,2,"dummy"
"51905",0,0,0,0,"dummy"
"51906",1,2,1,4,"dummy"
"51907",4,11,8,23,"dummy"
"51908",2,4,0,6,"dummy"
"51909",5,4,0,9,"dummy"
"51910",0,2,0,2,"dummy"
"51911",0,0,1,1,"dummy"
"51912",5,22,1,28,"dummy"
"51913",0,1,0,1,"dummy"
"51914",0,3,0,3,"dummy"
"51915",4,1,1,6,"dummy"
"51916",0,4,0,4,"dummy"
"51917",0,0,1,1,"dummy"
"51918",0,2,0,2,"dummy"
"51919",0,1,0,1,"dummy"
"51920",0,1,0,1,"dummy"
"51921",0,0,0,0,"dummy"
"51922",0,1,0,1,"dummy"
"51923",0,0,0,0,"dummy"
"51924",0,1,0,1,"dummy"
"51925",1,0,1,2,"dummy"
"51926",0,1,0,1,"dummy"
"51927",44,12,5,61,"dummy"
"51928",0,0,1,1,"dummy"
"51929",1,0,2,3,"dummy"
"51930",0,4,0,4,"dummy"
"51931",0,0,1,1,"dummy"
"51932",0,0,2,2,"dummy"
"51933",1,1,1,3,"dummy"
"51934",0,0,2,2,"dummy"
"51935",0,2,0,2,"dummy"
"51936",0,0,1,1,"dummy"
"51937",0,2,0,2,"dummy"
"51938",0,1,1,2,"dummy"
"51949",0,0,0,0,"dummy"
"51971",16,1,0,17,"dummy"
"51972",1,5,2,8,"dummy"
"51973",8,0,4,12,"dummy"
"51974",0,4,0,4,"dummy"
"51978",0,1,0,1,"dummy"
"51979",3,5,4,12,"dummy"
"51980",2,2,1,5,"dummy"
"51981",0,1,0,1,"dummy"
"51982",7,0,0,7,"dummy"
"51985",0,0,1,1,"dummy"
"51829",0,0,0,0,"dummy"
"51862",0,1,0,1,"dummy"
"51863",2,2,0,4,"dummy"
"51864",15,2,3,20,"dummy"
"51865",0,0,1,1,"dummy"
"51866",1,0,0,1,"dummy"
"51867",0,7,2,9,"dummy"
"51884",6,12,1,19,"dummy"
"51885",0,0,5,5,"dummy"
"51886",12,0,1,13,"dummy"
"51887",0,0,2,2,"dummy"
"51888",0,0,1,1,"dummy"
"51889",0,0,2,2,"dummy"
"51940",0,0,1,1,"dummy"
"51943",1,1,1,3,"dummy"
"51944",0,1,2,3,"dummy"
"51947",0,10,0,10,"dummy"
"51960",16,10,0,26,"dummy"
"51961",0,3,0,3,"dummy"
"51962",0,3,0,3,"dummy"
"51963",0,2,0,2,"dummy"
"51964",16,7,5,28,"dummy"
"51965",2,0,0,2,"dummy"
"51966",0,3,0,3,"dummy"
"51967",0,1,0,1,"dummy"
"51968",2,1,0,3,"dummy"
"51969",1,2,0,3,"dummy"
"51989",0,0,0,0,"dummy"
"51993",0,0,1,1,"dummy"
"51995",1,3,2,6,"dummy"
"52001",0,0,0,0,"dummy"
"52002",1,1,1,3,"dummy"
"52004",14,19,2,35,"dummy"
"52007",3,2,0,5,"dummy"
"52009",23,8,4,35,"dummy"
"52010",0,1,0,1,"dummy"
"52011",0,0,2,2,"dummy"
"52014",0,0,1,1,"dummy"
"52015",0,0,0,0,"dummy"
"52027",0,2,0,2,"dummy"
"52028",0,1,2,3,"dummy"
"52029",0,3,0,3,"dummy"
"52030",0,2,0,2,"dummy"
"52031",0,0,3,3,"dummy"
"52032",10,5,9,24,"dummy"
"52033",4,1,1,6,"dummy"
"52034",0,2,0,2,"dummy"
"52035",0,1,0,1,"dummy"
"52036",1,3,0,4,"dummy"
"52038",0,0,2,2,"dummy"
"52040",0,0,1,1,"dummy"
"52041",0,0,1,1,"dummy"
"52042",0,0,1,1,"dummy"
"52045",0,6,0,6,"dummy"
"52046",0,2,0,2,"dummy"
"52047",1,6,0,7,"dummy"
"52048",3,2,1,6,"dummy"
"52055",0,2,0,2,"dummy"
"52056",2,0,0,2,"dummy"
"52057",0,5,2,7,"dummy"
"52058",0,1,0,1,"dummy"
"52059",0,0,2,2,"dummy"
"52061",0,2,0,2,"dummy"
"52062",2,0,0,2,"dummy"
"52064",1,2,1,4,"dummy"
"52065",0,3,0,3,"dummy"
"52066",2,0,1,3,"dummy"
"52068",3,3,0,6,"dummy"
"52072",0,5,0,5,"dummy"
"52073",0,0,0,0,"dummy"
"52076",7,16,1,24,"dummy"
"52077",0,3,1,4,"dummy"
"52078",0,2,1,3,"dummy"
"52080",0,0,6,6,"dummy"
"52081",0,0,1,1,"dummy"
"52097",0,0,1,1,"dummy"
"52103",0,2,0,2,"dummy"
"52105",0,0,1,1,"dummy"
"52106",0,0,1,1,"dummy"
"52107",0,0,2,2,"dummy"
"52108",0,0,1,1,"dummy"
"52109",0,0,0,0,"dummy"
"52110",2,0,0,2,"dummy"
"52111",0,0,1,1,"dummy"
"52112",0,0,1,1,"dummy"
"52113",0,0,1,1,"dummy"
"52114",0,1,0,1,"dummy"
"52115",0,2,0,2,"dummy"
"52116",0,2,0,2,"dummy"
"52117",0,2,0,2,"dummy"
"52118",0,1,0,1,"dummy"
"52119",0,2,0,2,"dummy"
"52120",3,0,1,4,"dummy"
"52121",0,2,0,2,"dummy"
"52122",0,3,0,3,"dummy"
"52123",0,1,0,1,"dummy"
"52124",2,0,0,2,"dummy"
"52125",2,2,0,4,"dummy"
"52126",0,2,0,2,"dummy"
"52127",0,3,0,3,"dummy"
"52128",2,2,0,4,"dummy"
"52129",0,2,0,2,"dummy"
"52130",0,0,2,2,"dummy"
"52133",1,0,0,1,"dummy"
"52134",1,12,2,15,"dummy"
"52136",0,1,0,1,"dummy"
"52138",3,10,1,14,"dummy"
"52139",0,0,0,0,"dummy"
"52141",0,0,1,1,"dummy"
"52142",0,0,1,1,"dummy"
"52143",0,0,2,2,"dummy"
"52144",26,3,7,36,"dummy"
"52148",0,0,1,1,"dummy"
"52150",1,0,0,1,"dummy"
"52151",0,0,1,1,"dummy"
"52152",1,1,0,2,"dummy"
"52153",0,1,0,1,"dummy"
"52154",0,0,0,0,"dummy"
"52155",0,0,1,1,"dummy"
"52156",0,0,2,2,"dummy"
"52157",0,0,0,0,"dummy"
"52158",0,0,0,0,"dummy"
"52159",0,0,0,0,"dummy"
"52161",5,3,0,8,"dummy"
"52162",21,70,6,97,"dummy"
"52163",3,0,0,3,"dummy"
"52164",1,1,0,2,"dummy"
"52165",1,1,0,2,"dummy"
"52166",1,1,0,2,"dummy"
"52167",1,1,0,2,"dummy"
"52168",0,0,1,1,"dummy"
"52169",26,2,2,30,"dummy"
"52170",4,1,0,5,"dummy"
"52171",0,0,1,1,"dummy"
"52172",0,1,0,1,"dummy"
"52173",0,1,0,1,"dummy"
"52174",0,0,2,2,"dummy"
"52175",0,0,2,2,"dummy"
"52176",2,2,1,5,"dummy"
"52177",0,0,2,2,"dummy"
"52178",0,0,2,2,"dummy"
"52179",0,0,1,1,"dummy"
"52183",0,1,0,1,"dummy"
"52184",2,0,2,4,"dummy"
"52187",0,6,0,6,"dummy"
"52188",5,2,0,7,"dummy"
"52189",1,0,0,1,"dummy"
"52190",0,0,0,0,"dummy"
"52191",3,1,0,4,"dummy"
"52192",0,1,0,1,"dummy"
"52193",0,0,1,1,"dummy"
"52194",0,0,1,1,"dummy"
"52195",0,0,1,1,"dummy"
"52196",22,18,5,45,"dummy"
"52197",0,2,0,2,"dummy"
"52198",2,0,0,2,"dummy"
"52199",1,0,0,1,"dummy"
"52201",0,0,1,1,"dummy"
"52204",0,1,0,1,"dummy"
"52205",0,0,1,1,"dummy"
"52206",0,0,1,1,"dummy"
"52207",0,0,1,1,"dummy"
"52208",0,0,2,2,"dummy"
"52209",0,2,1,3,"dummy"
"52210",1,0,0,1,"dummy"
"52211",0,0,1,1,"dummy"
"52213",2,5,2,9,"dummy"
"52215",0,0,2,2,"dummy"
"52216",1,0,1,2,"dummy"
"52219",0,0,3,3,"dummy"
"52220",1,1,0,2,"dummy"
"52221",0,2,0,2,"dummy"
"52222",0,1,0,1,"dummy"
"52223",0,0,0,0,"dummy"
"52224",0,1,1,2,"dummy"
"52225",6,1,2,9,"dummy"
"52226",1,6,2,9,"dummy"
"52230",2,0,0,2,"dummy"
"52233",0,0,0,0,"dummy"
"52238",1,1,1,3,"dummy"
"52240",0,1,0,1,"dummy"
"52242",0,0,1,1,"dummy"
"52244",0,5,3,8,"dummy"
"52245",4,10,3,17,"dummy"
"52246",1,5,1,7,"dummy"
"52247",4,3,0,7,"dummy"
"52248",0,3,0,3,"dummy"
"52249",0,0,1,1,"dummy"
"52251",0,1,0,1,"dummy"
"52252",1,0,0,1,"dummy"
"52254",0,0,2,2,"dummy"
"52255",0,5,0,5,"dummy"
"52256",0,0,0,0,"dummy"
"52257",1,0,0,1,"dummy"
"52258",0,3,0,3,"dummy"
"52260",0,0,0,0,"dummy"
"52261",1,4,1,6,"dummy"
"52262",8,5,3,16,"dummy"
"52263",2,5,2,9,"dummy"
"52264",0,1,0,1,"dummy"
"52265",3,9,0,12,"dummy"
"52266",1,0,0,1,"dummy"
"52268",0,4,0,4,"dummy"
"52269",11,11,3,25,"dummy"
"52270",4,3,0,7,"dummy"
"52273",0,0,0,0,"dummy"
"52274",0,1,0,1,"dummy"
"52275",1,4,1,6,"dummy"
"52276",0,1,0,1,"dummy"
"52278",0,0,1,1,"dummy"
"52281",0,0,1,1,"dummy"
"52285",0,0,1,1,"dummy"
"52286",0,0,1,1,"dummy"
"52288",1,0,0,1,"dummy"
"52289",0,1,0,1,"dummy"
"52290",2,1,0,3,"dummy"
"52291",0,1,1,2,"dummy"
"52299",1,0,0,1,"dummy"
"52301",0,0,1,1,"dummy"
"52305",2,8,0,10,"dummy"
"52306",0,0,2,2,"dummy"
"52307",7,3,0,10,"dummy"
"52308",0,0,1,1,"dummy"
"52309",4,4,0,8,"dummy"
"52311",0,5,0,5,"dummy"
"52314",0,25,0,25,"dummy"
"52315",0,1,0,1,"dummy"
"52316",0,0,1,1,"dummy"
"52317",0,0,1,1,"dummy"
"52323",0,18,0,18,"dummy"
"52324",5,0,0,5,"dummy"
"52325",14,1,2,17,"dummy"
"52329",0,0,5,5,"dummy"
"52332",0,2,3,5,"dummy"
"52333",6,1,0,7,"dummy"
"52335",2,0,0,2,"dummy"
"52336",0,0,1,1,"dummy"
"52338",2,1,0,3,"dummy"
"52340",0,1,0,1,"dummy"
"52341",0,0,0,0,"dummy"
"52342",1,2,0,3,"dummy"
"52343",2,5,5,12,"dummy"
"52344",0,2,0,2,"dummy"
"52345",2,0,0,2,"dummy"
"52348",0,9,0,9,"dummy"
"52349",1,0,0,1,"dummy"
"52350",0,1,0,1,"dummy"
"52351",0,1,0,1,"dummy"
"52353",0,0,1,1,"dummy"
"52354",6,2,2,10,"dummy"
"52355",0,0,4,4,"dummy"
"52356",2,9,1,12,"dummy"
"52358",0,2,0,2,"dummy"
"52359",0,4,0,4,"dummy"
"52360",0,0,1,1,"dummy"
"52361",0,0,1,1,"dummy"
"52362",0,0,4,4,"dummy"
"52363",0,0,1,1,"dummy"
"52364",0,0,1,1,"dummy"
"52365",0,2,2,4,"dummy"
"52366",0,0,1,1,"dummy"
"52367",9,6,4,19,"dummy"
"52368",0,3,1,4,"dummy"
"52371",0,3,4,7,"dummy"
"52386",2,5,3,10,"dummy"
"52387",62,15,2,79,"dummy"
"52388",4,10,1,15,"dummy"
"52389",0,1,0,1,"dummy"
"52390",0,2,0,2,"dummy"
"52391",12,0,0,12,"dummy"
"52392",0,0,0,0,"dummy"
"52393",0,0,0,0,"dummy"
"52394",0,1,0,1,"dummy"
"52396",0,0,1,1,"dummy"
"52397",0,0,1,1,"dummy"
"52398",0,2,0,2,"dummy"
"52399",2,0,1,3,"dummy"
"52400",4,3,0,7,"dummy"
"52401",4,3,2,9,"dummy"
"52402",0,0,2,2,"dummy"
"52410",0,2,1,3,"dummy"
"52411",3,1,1,5,"dummy"
"52412",1,0,1,2,"dummy"
"52413",1,1,3,5,"dummy"
"52414",2,1,1,4,"dummy"
"52415",0,1,0,1,"dummy"
"52416",0,0,1,1,"dummy"
"52417",0,0,1,1,"dummy"
"52418",0,0,0,0,"dummy"
"52419",0,0,0,0,"dummy"
"52420",0,0,1,1,"dummy"
"52421",0,0,1,1,"dummy"
"52422",0,0,1,1,"dummy"
"52423",0,0,1,1,"dummy"
"52424",0,0,1,1,"dummy"
"52425",0,0,1,1,"dummy"
"52426",0,0,1,1,"dummy"
"52427",0,0,1,1,"dummy"
"52428",0,0,1,1,"dummy"
"52430",0,0,5,5,"dummy"
"52431",0,0,5,5,"dummy"
"52432",2,0,0,2,"dummy"
"52433",0,1,0,1,"dummy"
"52434",0,6,0,6,"dummy"
"52435",7,8,0,15,"dummy"
"52436",1,1,0,2,"dummy"
"52437",0,0,0,0,"dummy"
"52438",0,1,0,1,"dummy"
"52439",0,1,0,1,"dummy"
"52440",0,1,0,1,"dummy"
"52442",0,0,0,0,"dummy"
"52443",0,1,1,2,"dummy"
"52444",0,1,1,2,"dummy"
"52445",0,1,0,1,"dummy"
"52447",0,0,1,1,"dummy"
"52448",2,9,0,11,"dummy"
"52449",1,1,0,2,"dummy"
"52450",3,12,0,15,"dummy"
"52451",2,2,0,4,"dummy"
"52452",7,3,0,10,"dummy"
"52453",0,0,1,1,"dummy"
"52454",4,4,0,8,"dummy"
"52456",0,1,0,1,"dummy"
"52457",7,21,0,28,"dummy"
"52458",18,1,0,19,"dummy"
"52459",2,1,4,7,"dummy"
"52460",0,1,0,1,"dummy"
"52461",0,0,0,0,"dummy"
"52462",0,0,0,0,"dummy"
"52466",0,0,1,1,"dummy"
"52470",19,1,1,21,"dummy"
"52471",1,0,1,2,"dummy"
"52474",0,0,1,1,"dummy"
"52476",0,0,0,0,"dummy"
"52490",2,1,0,3,"dummy"
"52491",1,1,0,2,"dummy"
"52492",0,1,0,1,"dummy"
"52506",0,1,1,2,"dummy"
"52507",0,10,1,11,"dummy"
"52509",0,0,1,1,"dummy"
"52510",0,0,1,1,"dummy"
"52518",0,1,0,1,"dummy"
"52521",0,1,0,1,"dummy"
"52522",0,5,1,6,"dummy"
"52523",8,23,4,35,"dummy"
"52526",4,2,0,6,"dummy"
"52527",0,1,0,1,"dummy"
"52528",1,6,1,8,"dummy"
"52529",1,0,0,1,"dummy"
"52530",4,3,0,7,"dummy"
"52531",0,1,0,1,"dummy"
"52534",1,0,0,1,"dummy"
"52537",3,2,0,5,"dummy"
"52538",1,0,0,1,"dummy"
"52539",0,1,0,1,"dummy"
"52540",0,1,0,1,"dummy"
"52542",0,1,0,1,"dummy"
"52543",0,1,0,1,"dummy"
"52546",0,0,2,2,"dummy"
"52548",3,1,1,5,"dummy"
"52550",0,1,0,1,"dummy"
"52553",2,5,0,7,"dummy"
"52554",4,3,2,9,"dummy"
"52555",4,8,1,13,"dummy"
"52556",3,4,3,10,"dummy"
"52557",10,8,0,18,"dummy"
"52559",0,1,0,1,"dummy"
"52560",0,1,0,1,"dummy"
"52561",1,0,0,1,"dummy"
"52562",0,4,0,4,"dummy"
"52563",0,3,0,3,"dummy"
"52564",0,1,0,1,"dummy"
"52565",0,2,0,2,"dummy"
"52566",3,1,0,4,"dummy"
"52567",1,3,0,4,"dummy"
"52568",1,0,0,1,"dummy"
"52569",0,0,1,1,"dummy"
"52570",0,0,1,1,"dummy"
"52571",0,0,1,1,"dummy"
"52572",0,0,1,1,"dummy"
"52573",4,5,4,13,"dummy"
"52574",1,0,0,1,"dummy"
"52575",0,1,0,1,"dummy"
"52576",0,0,1,1,"dummy"
"52577",0,1,0,1,"dummy"
"52581",1,0,0,1,"dummy"
"52582",0,0,1,1,"dummy"
"52589",0,5,3,8,"dummy"
"52590",0,0,2,2,"dummy"
"52591",0,0,2,2,"dummy"
"52595",0,0,0,0,"dummy"
"52596",0,0,0,0,"dummy"
"52623",1,1,3,5,"dummy"
"52624",0,0,1,1,"dummy"
"52625",0,4,0,4,"dummy"
"52626",0,0,1,1,"dummy"
"52627",3,1,1,5,"dummy"
"52628",0,0,1,1,"dummy"
"52629",0,0,1,1,"dummy"
"52630",0,1,0,1,"dummy"
"52631",0,1,0,1,"dummy"
"52632",1,1,0,2,"dummy"
"52633",4,4,1,9,"dummy"
"52634",5,1,0,6,"dummy"
"52635",0,0,1,1,"dummy"
"52636",1,2,0,3,"dummy"
"52637",0,0,1,1,"dummy"
"52638",1,0,0,1,"dummy"
"52639",0,0,1,1,"dummy"
"52640",0,0,1,1,"dummy"
"52641",1,1,3,5,"dummy"
"52642",0,0,1,1,"dummy"
"52643",0,2,1,3,"dummy"
"52644",0,1,0,1,"dummy"
"52645",1,1,0,2,"dummy"
"52646",4,1,0,5,"dummy"
"52647",0,0,1,1,"dummy"
"52648",1,1,1,3,"dummy"
"52649",0,0,1,1,"dummy"
"52650",0,1,1,2,"dummy"
"52651",0,0,1,1,"dummy"
"52652",1,1,1,3,"dummy"
"52653",0,0,1,1,"dummy"
"52654",0,0,2,2,"dummy"
"52655",0,0,1,1,"dummy"
"52656",0,0,1,1,"dummy"
"52657",0,0,1,1,"dummy"
"52658",7,2,2,11,"dummy"
"52659",0,0,1,1,"dummy"
"52660",0,0,3,3,"dummy"
"52661",0,0,2,2,"dummy"
"52662",0,0,1,1,"dummy"
"52663",1,0,0,1,"dummy"
"52664",1,1,1,3,"dummy"
"52665",0,0,1,1,"dummy"
"52666",0,0,1,1,"dummy"
"52667",0,0,1,1,"dummy"
"52668",0,0,1,1,"dummy"
"52669",0,1,1,2,"dummy"
"52670",0,0,1,1,"dummy"
"52671",0,0,1,1,"dummy"
"52673",0,4,0,4,"dummy"
"52674",0,2,0,2,"dummy"
"52675",0,0,0,0,"dummy"
"52676",0,0,0,0,"dummy"
"52681",0,1,0,1,"dummy"
"52682",0,0,2,2,"dummy"
"52683",0,0,1,1,"dummy"
"52684",0,9,0,9,"dummy"
"52685",0,0,4,4,"dummy"
"52686",0,0,3,3,"dummy"
"52687",1,0,3,4,"dummy"
"52688",0,1,3,4,"dummy"
"52689",0,0,1,1,"dummy"
"52690",0,0,1,1,"dummy"
"52691",1,0,4,5,"dummy"
"52692",0,0,2,2,"dummy"
"52693",0,1,3,4,"dummy"
"52694",1,0,4,5,"dummy"
"52695",0,0,0,0,"dummy"
"52696",0,0,3,3,"dummy"
"52697",0,0,1,1,"dummy"
"52698",0,0,1,1,"dummy"
"52699",0,0,1,1,"dummy"
"52700",0,0,1,1,"dummy"
"52701",0,0,1,1,"dummy"
"52702",0,0,1,1,"dummy"
"52703",0,0,1,1,"dummy"
"52704",0,0,1,1,"dummy"
"52705",0,0,1,1,"dummy"
"52706",0,0,1,1,"dummy"
"52707",0,0,1,1,"dummy"
"52708",0,0,1,1,"dummy"
"52709",0,0,1,1,"dummy"
"52710",0,0,1,1,"dummy"
"52711",0,0,1,1,"dummy"
"52712",0,0,1,1,"dummy"
"52713",0,0,1,1,"dummy"
"52714",0,0,1,1,"dummy"
"52715",0,0,1,1,"dummy"
"52716",0,0,1,1,"dummy"
"52717",0,0,1,1,"dummy"
"52718",0,0,1,1,"dummy"
"52719",0,0,1,1,"dummy"
"52720",0,0,1,1,"dummy"
"52721",0,0,1,1,"dummy"
"52722",0,0,1,1,"dummy"
"52723",0,0,1,1,"dummy"
"52724",0,0,1,1,"dummy"
"52725",0,0,1,1,"dummy"
"52726",0,0,1,1,"dummy"
"52727",0,0,1,1,"dummy"
"52728",0,0,1,1,"dummy"
"52729",0,0,1,1,"dummy"
"52738",0,2,0,2,"dummy"
"52747",0,2,0,2,"dummy"
"52748",0,2,0,2,"dummy"
"52749",0,0,1,1,"dummy"
"52823",2,0,3,5,"dummy"
"52887",0,0,1,1,"dummy"
"52890",0,3,0,3,"dummy"
"52891",0,6,0,6,"dummy"
"52892",1,3,0,4,"dummy"
"52893",0,0,1,1,"dummy"
"52894",5,4,0,9,"dummy"
"52895",0,1,0,1,"dummy"
"52896",0,0,1,1,"dummy"
"52901",1,17,0,18,"dummy"
"52902",0,0,1,1,"dummy"
"52914",0,0,1,1,"dummy"
"52915",0,0,1,1,"dummy"
"52916",0,0,1,1,"dummy"
"52937",0,0,1,1,"dummy"
"52938",0,0,1,1,"dummy"
"52939",0,0,1,1,"dummy"
"52940",0,0,1,1,"dummy"
"52731",0,0,1,1,"dummy"
"52732",0,0,1,1,"dummy"
"52740",0,1,1,2,"dummy"
"52741",5,1,0,6,"dummy"
"52742",0,2,0,2,"dummy"
"52745",0,0,1,1,"dummy"
"52765",1,1,0,2,"dummy"
"52768",0,5,0,5,"dummy"
"52769",0,1,0,1,"dummy"
"52770",0,2,0,2,"dummy"
"52771",0,10,0,10,"dummy"
"52772",8,4,1,13,"dummy"
"52773",0,0,1,1,"dummy"
"52774",0,0,1,1,"dummy"
"52779",7,52,4,63,"dummy"
"52780",0,2,1,3,"dummy"
"52781",0,1,0,1,"dummy"
"52782",0,3,0,3,"dummy"
"52783",6,0,0,6,"dummy"
"52784",0,3,0,3,"dummy"
"52785",1,4,0,5,"dummy"
"52786",2,2,1,5,"dummy"
"52787",0,2,0,2,"dummy"
"52788",0,0,0,0,"dummy"
"52789",0,1,0,1,"dummy"
"52790",5,5,4,14,"dummy"
"52791",15,15,1,31,"dummy"
"52792",12,19,1,32,"dummy"
"52793",1,2,0,3,"dummy"
"52794",0,4,0,4,"dummy"
"52795",9,13,3,25,"dummy"
"52796",0,1,0,1,"dummy"
"52797",0,2,0,2,"dummy"
"52798",0,1,0,1,"dummy"
"52799",0,0,1,1,"dummy"
"52800",0,1,0,1,"dummy"
"52801",0,1,0,1,"dummy"
"52802",30,13,2,45,"dummy"
"52803",0,3,0,3,"dummy"
"52804",0,4,1,5,"dummy"
"52805",11,6,1,18,"dummy"
"52806",6,0,0,6,"dummy"
"52807",0,0,2,2,"dummy"
"52810",0,0,2,2,"dummy"
"52813",0,0,1,1,"dummy"
"52814",0,0,0,0,"dummy"
"52815",0,0,2,2,"dummy"
"52816",0,0,0,0,"dummy"
"52821",0,1,3,4,"dummy"
"52841",0,0,0,0,"dummy"
"52842",0,1,1,2,"dummy"
"52843",1,3,1,5,"dummy"
"52844",0,1,1,2,"dummy"
"52849",0,0,0,0,"dummy"
"52850",0,0,1,1,"dummy"
"52857",7,0,0,7,"dummy"
"52858",0,4,0,4,"dummy"
"52859",2,0,0,2,"dummy"
"52860",12,14,0,26,"dummy"
"52861",0,2,0,2,"dummy"
"52862",0,0,1,1,"dummy"
"52863",21,4,2,27,"dummy"
"52864",6,35,2,43,"dummy"
"52865",0,1,1,2,"dummy"
"52879",2,5,0,7,"dummy"
"52880",0,1,0,1,"dummy"
"52881",0,0,3,3,"dummy"
"52882",0,2,0,2,"dummy"
"52883",1,2,1,4,"dummy"
"52884",0,4,0,4,"dummy"
"52885",5,0,0,5,"dummy"
"52898",0,6,1,7,"dummy"
"52899",0,0,1,1,"dummy"
"52904",1,0,0,1,"dummy"
"52958",0,1,0,1,"dummy"
"52959",1,0,0,1,"dummy"
"52960",1,0,0,1,"dummy"
"52961",0,1,0,1,"dummy"
"52962",0,1,0,1,"dummy"
"52963",0,3,0,3,"dummy"
"52966",0,1,0,1,"dummy"
"52967",7,20,3,30,"dummy"
"52968",0,1,2,3,"dummy"
"53037",0,0,3,3,"dummy"
"53038",0,1,1,2,"dummy"
"53039",6,4,0,10,"dummy"
"53040",0,1,0,1,"dummy"
"53041",0,0,1,1,"dummy"
"53042",0,0,1,1,"dummy"
"53043",0,1,0,1,"dummy"
"53044",0,0,0,0,"dummy"
"53045",0,0,2,2,"dummy"
"53046",3,4,0,7,"dummy"
"53047",1,1,0,2,"dummy"
"53060",0,1,0,1,"dummy"
"53063",0,2,0,2,"dummy"
"53064",0,0,1,1,"dummy"
"53081",0,1,0,1,"dummy"
"53082",0,0,2,2,"dummy"
"53083",1,0,0,1,"dummy"
"53084",0,1,0,1,"dummy"
"53090",0,0,1,1,"dummy"
"53091",1,0,0,1,"dummy"
"53099",0,2,0,2,"dummy"
"53100",0,1,1,2,"dummy"
"53101",0,0,1,1,"dummy"
"53104",0,0,1,1,"dummy"
"53109",0,1,0,1,"dummy"
"53110",0,0,1,1,"dummy"
"53111",0,0,1,1,"dummy"
"53112",0,0,1,1,"dummy"
"53115",2,0,3,5,"dummy"
"53118",0,0,1,1,"dummy"
"53132",0,1,0,1,"dummy"
"53149",3,1,0,4,"dummy"
"53150",1,2,0,3,"dummy"
"53151",1,7,2,10,"dummy"
"53152",0,0,1,1,"dummy"
"53153",0,6,1,7,"dummy"
"53154",0,0,1,1,"dummy"
"53173",0,0,2,2,"dummy"
"53174",0,0,1,1,"dummy"
"53175",4,0,0,4,"dummy"
"53176",0,6,0,6,"dummy"
"53177",0,1,0,1,"dummy"
"53178",22,0,0,22,"dummy"
"53190",1,0,0,1,"dummy"
"53199",0,16,0,16,"dummy"
"53200",2,1,0,3,"dummy"
"53205",0,1,0,1,"dummy"
"53257",0,3,0,3,"dummy"
"53258",0,1,0,1,"dummy"
"53259",0,1,0,1,"dummy"
"52941",0,0,1,1,"dummy"
"52942",0,0,1,1,"dummy"
"52943",0,0,1,1,"dummy"
"52944",0,0,0,0,"dummy"
"52945",0,0,1,1,"dummy"
"52946",0,0,1,1,"dummy"
"52947",0,0,1,1,"dummy"
"52948",0,0,1,1,"dummy"
"52949",0,0,1,1,"dummy"
"52950",0,0,1,1,"dummy"
"53049",3,1,0,4,"dummy"
"53050",0,1,0,1,"dummy"
"53051",1,0,0,1,"dummy"
"53052",2,0,0,2,"dummy"
"53058",1,9,0,10,"dummy"
"53066",0,0,2,2,"dummy"
"53067",6,5,1,12,"dummy"
"53068",0,0,3,3,"dummy"
"53069",0,0,1,1,"dummy"
"53070",0,0,2,2,"dummy"
"53071",0,0,3,3,"dummy"
"53072",0,0,1,1,"dummy"
"53073",0,0,1,1,"dummy"
"53074",0,1,0,1,"dummy"
"53075",0,0,1,1,"dummy"
"53078",1,6,0,7,"dummy"
"53079",1,0,0,1,"dummy"
"53088",0,10,0,10,"dummy"
"53120",0,3,0,3,"dummy"
"53121",0,2,1,3,"dummy"
"53122",0,1,0,1,"dummy"
"53123",0,0,0,0,"dummy"
"53124",1,0,0,1,"dummy"
"53134",0,0,1,1,"dummy"
"53135",0,0,1,1,"dummy"
"53156",3,4,0,7,"dummy"
"53157",0,1,4,5,"dummy"
"53160",0,1,0,1,"dummy"
"53161",1,0,0,1,"dummy"
"53182",21,98,2,121,"dummy"
"53183",0,2,0,2,"dummy"
"53184",2,2,0,4,"dummy"
"53185",61,10,0,71,"dummy"
"53186",4,4,1,9,"dummy"
"53187",0,3,0,3,"dummy"
"53188",2,2,0,4,"dummy"
"53207",0,0,1,1,"dummy"
"53208",0,0,1,1,"dummy"
"53209",1,0,0,1,"dummy"
"53210",0,0,1,1,"dummy"
"53211",0,0,3,3,"dummy"
"53212",5,5,0,10,"dummy"
"53213",0,0,0,0,"dummy"
"53214",7,4,0,11,"dummy"
"53215",1,3,0,4,"dummy"
"53216",0,0,1,1,"dummy"
"53217",7,1,0,8,"dummy"
"53218",0,0,0,0,"dummy"
"53219",6,8,2,16,"dummy"
"53220",0,0,0,0,"dummy"
"53221",0,0,1,1,"dummy"
"53222",0,0,0,0,"dummy"
"53223",0,0,1,1,"dummy"
"53224",8,6,0,14,"dummy"
"53225",12,12,0,24,"dummy"
"53226",0,0,0,0,"dummy"
"53227",0,1,0,1,"dummy"
"53228",17,17,0,34,"dummy"
"53229",0,0,0,0,"dummy"
"53230",0,0,0,0,"dummy"
"53231",0,0,0,0,"dummy"
"53232",0,3,1,4,"dummy"
"53247",0,0,1,1,"dummy"
"53277",0,17,2,19,"dummy"
"53278",0,1,3,4,"dummy"
"53279",2,1,3,6,"dummy"
"53280",0,4,0,4,"dummy"
"53281",0,0,1,1,"dummy"
"53297",0,0,1,1,"dummy"
"53298",0,0,2,2,"dummy"
"53299",0,0,1,1,"dummy"
"53303",0,1,0,1,"dummy"
"53304",0,2,0,2,"dummy"
"53305",2,2,0,4,"dummy"
"53306",2,0,0,2,"dummy"
"53307",0,0,0,0,"dummy"
"53308",0,1,0,1,"dummy"
"53309",15,0,2,17,"dummy"
"53310",0,0,1,1,"dummy"
"53260",1,5,1,7,"dummy"
"53261",1,2,0,3,"dummy"
"53262",8,0,1,9,"dummy"
"53265",1,9,1,11,"dummy"
"53266",0,0,1,1,"dummy"
"53269",1,0,0,1,"dummy"
"53270",0,1,0,1,"dummy"
"53271",0,5,0,5,"dummy"
"53272",0,3,1,4,"dummy"
"53273",4,3,1,8,"dummy"
"53274",1,6,2,9,"dummy"
"53275",0,0,1,1,"dummy"
"53293",1,0,0,1,"dummy"
"53301",0,0,1,1,"dummy"
"53320",2,2,0,4,"dummy"
"53321",2,2,0,4,"dummy"
"53324",0,6,0,6,"dummy"
"53325",0,1,2,3,"dummy"
"53328",0,0,1,1,"dummy"
"53329",0,0,1,1,"dummy"
"53330",0,1,1,2,"dummy"
"53331",2,0,0,2,"dummy"
"53332",0,3,0,3,"dummy"
"53333",0,2,0,2,"dummy"
"53334",4,6,0,10,"dummy"
"53335",0,1,0,1,"dummy"
"53337",0,0,2,2,"dummy"
"53338",0,2,0,2,"dummy"
"53339",0,0,1,1,"dummy"
"53340",1,4,3,8,"dummy"
"53341",1,0,0,1,"dummy"
"53342",0,0,0,0,"dummy"
"53343",0,0,1,1,"dummy"
"53344",0,0,1,1,"dummy"
"53346",13,29,1,43,"dummy"
"53353",3,4,3,10,"dummy"
"53354",0,0,1,1,"dummy"
"53356",0,0,0,0,"dummy"
"53357",1,0,2,3,"dummy"
"53362",0,40,0,40,"dummy"
"53363",0,0,3,3,"dummy"
"53364",0,0,2,2,"dummy"
"53365",0,0,1,1,"dummy"
"53367",0,0,1,1,"dummy"
"53368",0,0,5,5,"dummy"
"53373",0,1,1,2,"dummy"
"53376",0,2,0,2,"dummy"
"53377",0,0,2,2,"dummy"
"53380",0,0,3,3,"dummy"
"53381",0,0,1,1,"dummy"
"53382",0,0,0,0,"dummy"
"53383",0,11,0,11,"dummy"
"53384",0,0,0,0,"dummy"
"53385",0,0,0,0,"dummy"
"53386",0,0,0,0,"dummy"
"53388",2,0,0,2,"dummy"
"53389",8,7,1,16,"dummy"
"53390",0,1,0,1,"dummy"
"53391",0,0,1,1,"dummy"
"53392",4,9,2,15,"dummy"
"53394",0,1,0,1,"dummy"
"53396",0,0,2,2,"dummy"
"53398",0,3,0,3,"dummy"
"53399",0,1,0,1,"dummy"
"53400",0,1,0,1,"dummy"
"53417",0,0,1,1,"dummy"
"53419",0,0,1,1,"dummy"
"53420",0,0,2,2,"dummy"
"53421",0,27,3,30,"dummy"
"53423",0,8,1,9,"dummy"
"53424",1,1,1,3,"dummy"
"53425",0,4,1,5,"dummy"
"53430",1,1,2,4,"dummy"
"53431",0,1,0,1,"dummy"
"53432",0,3,0,3,"dummy"
"53433",0,3,4,7,"dummy"
"53434",0,0,1,1,"dummy"
"53435",0,0,1,1,"dummy"
"53438",0,4,0,4,"dummy"
"53439",2,1,0,3,"dummy"
"53440",1,0,0,1,"dummy"
"53443",0,1,0,1,"dummy"
"53444",0,2,0,2,"dummy"
"53445",0,2,0,2,"dummy"
"53446",0,2,0,2,"dummy"
"53447",0,0,1,1,"dummy"
"53448",0,0,1,1,"dummy"
"53451",0,5,0,5,"dummy"
"53452",4,0,0,4,"dummy"
"53453",0,1,1,2,"dummy"
"53454",0,0,1,1,"dummy"
"53472",0,0,3,3,"dummy"
"53473",0,0,2,2,"dummy"
"53476",0,1,0,1,"dummy"
"53478",1,4,4,9,"dummy"
"53479",1,0,0,1,"dummy"
"53480",1,2,0,3,"dummy"
"53482",0,0,2,2,"dummy"
"53483",0,5,0,5,"dummy"
"53484",0,0,0,0,"dummy"
"53485",0,0,1,1,"dummy"
"53486",0,2,1,3,"dummy"
"53487",7,1,6,14,"dummy"
"53488",0,0,5,5,"dummy"
"53490",2,2,0,4,"dummy"
"53491",2,2,0,4,"dummy"
"53492",0,5,3,8,"dummy"
"53493",3,6,1,10,"dummy"
"53494",0,16,0,16,"dummy"
"53495",29,8,3,40,"dummy"
"53500",0,0,0,0,"dummy"
"53501",3,21,1,25,"dummy"
"53502",12,6,3,21,"dummy"
"53503",3,5,2,10,"dummy"
"53504",4,25,1,30,"dummy"
"53505",1,0,0,1,"dummy"
"53506",0,0,0,0,"dummy"
"53508",0,0,2,2,"dummy"
"53509",0,0,1,1,"dummy"
"53510",0,0,2,2,"dummy"
"53511",4,1,2,7,"dummy"
"53512",0,0,1,1,"dummy"
"53515",1,0,0,1,"dummy"
"53516",0,0,1,1,"dummy"
"53517",4,1,0,5,"dummy"
"53518",0,1,0,1,"dummy"
"53520",0,1,0,1,"dummy"
"53534",0,0,0,0,"dummy"
"53535",0,0,0,0,"dummy"
"53538",0,1,0,1,"dummy"
"53539",0,0,0,0,"dummy"
"53540",0,2,1,3,"dummy"
"53541",0,0,1,1,"dummy"
"53544",0,0,1,1,"dummy"
"53583",2,3,0,5,"dummy"
"53603",0,0,1,1,"dummy"
"53604",0,0,1,1,"dummy"
"53605",1,1,0,2,"dummy"
"53606",0,0,2,2,"dummy"
"53607",0,0,1,1,"dummy"
"53608",0,1,0,1,"dummy"
"53609",0,2,0,2,"dummy"
"53610",7,1,3,11,"dummy"
"53656",0,0,1,1,"dummy"
"53657",7,0,2,9,"dummy"
"53662",0,1,0,1,"dummy"
"53663",0,1,0,1,"dummy"
"53669",2,5,0,7,"dummy"
"53708",0,0,0,0,"dummy"
"53709",0,0,1,1,"dummy"
"53710",0,0,1,1,"dummy"
"53715",0,0,0,0,"dummy"
"53716",0,0,0,0,"dummy"
"53717",0,0,0,0,"dummy"
"53718",0,0,0,0,"dummy"
"53719",0,0,1,1,"dummy"
"53720",0,0,1,1,"dummy"
"53721",0,0,1,1,"dummy"
"53724",2,0,0,2,"dummy"
"53730",1,1,0,2,"dummy"
"53731",1,2,1,4,"dummy"
"53732",0,1,0,1,"dummy"
"53736",0,1,0,1,"dummy"
"53737",0,1,0,1,"dummy"
"53738",24,2,0,26,"dummy"
"53739",2,1,0,3,"dummy"
"53740",0,0,2,2,"dummy"
"53746",1,1,0,2,"dummy"
"53750",0,0,1,1,"dummy"
"53780",0,0,0,0,"dummy"
"53781",0,0,1,1,"dummy"
"53782",1,0,0,1,"dummy"
"53787",1,3,2,6,"dummy"
"53788",0,0,1,1,"dummy"
"53789",1,1,0,2,"dummy"
"53790",0,1,1,2,"dummy"
"53791",1,1,2,4,"dummy"
"53792",0,12,0,12,"dummy"
"53795",0,0,1,1,"dummy"
"53796",0,0,1,1,"dummy"
"53797",0,0,1,1,"dummy"
"53798",0,0,1,1,"dummy"
"53799",1,0,2,3,"dummy"
"53809",0,0,1,1,"dummy"
"53810",0,0,1,1,"dummy"
"53811",0,0,1,1,"dummy"
"53832",0,3,0,3,"dummy"
"53833",0,19,3,22,"dummy"
"53834",0,3,0,3,"dummy"
"53568",11,6,4,21,"dummy"
"53573",4,2,6,12,"dummy"
"53574",0,0,0,0,"dummy"
"53577",0,2,0,2,"dummy"
"53578",0,1,0,1,"dummy"
"53579",1,0,0,1,"dummy"
"53580",0,1,0,1,"dummy"
"53581",0,0,1,1,"dummy"
"53591",0,1,0,1,"dummy"
"53592",7,2,1,10,"dummy"
"53595",0,2,0,2,"dummy"
"53596",1,1,0,2,"dummy"
"53597",0,0,2,2,"dummy"
"53598",0,1,0,1,"dummy"
"53599",3,1,0,4,"dummy"
"53614",3,1,0,4,"dummy"
"53615",0,0,2,2,"dummy"
"53616",0,0,0,0,"dummy"
"53617",1,0,0,1,"dummy"
"53632",3,0,0,3,"dummy"
"53635",0,0,0,0,"dummy"
"53640",0,5,1,6,"dummy"
"53641",0,9,0,9,"dummy"
"53642",13,23,5,41,"dummy"
"53643",0,1,1,2,"dummy"
"53644",2,38,3,43,"dummy"
"53645",7,0,0,7,"dummy"
"53646",11,4,2,17,"dummy"
"53647",0,2,0,2,"dummy"
"53648",0,10,0,10,"dummy"
"53649",1,4,1,6,"dummy"
"53650",0,5,1,6,"dummy"
"53651",0,1,0,1,"dummy"
"53652",0,4,0,4,"dummy"
"53653",0,1,0,1,"dummy"
"53654",0,2,0,2,"dummy"
"53659",2,0,0,2,"dummy"
"53660",0,0,1,1,"dummy"
"53667",0,0,0,0,"dummy"
"53673",1,19,1,21,"dummy"
"53674",12,1,0,13,"dummy"
"53675",1,8,0,9,"dummy"
"53676",0,2,0,2,"dummy"
"53677",0,1,0,1,"dummy"
"53678",0,1,0,1,"dummy"
"53683",1,0,0,1,"dummy"
"53687",6,1,0,7,"dummy"
"53688",0,5,0,5,"dummy"
"53699",0,0,1,1,"dummy"
"53700",0,4,0,4,"dummy"
"53701",0,3,0,3,"dummy"
"53704",0,2,0,2,"dummy"
"53705",0,0,0,0,"dummy"
"53706",1,2,0,3,"dummy"
"53726",0,0,5,5,"dummy"
"53727",0,0,0,0,"dummy"
"53728",0,15,1,16,"dummy"
"53734",0,2,0,2,"dummy"
"53742",3,5,2,10,"dummy"
"53748",0,0,1,1,"dummy"
"53752",0,0,1,1,"dummy"
"53753",1,0,0,1,"dummy"
"53754",3,5,0,8,"dummy"
"53755",1,9,0,10,"dummy"
"53756",4,1,4,9,"dummy"
"53759",0,0,0,0,"dummy"
"53760",0,0,1,1,"dummy"
"53761",0,0,0,0,"dummy"
"53762",0,1,0,1,"dummy"
"53763",0,1,0,1,"dummy"
"53764",0,1,0,1,"dummy"
"53765",0,1,0,1,"dummy"
"53766",1,0,0,1,"dummy"
"53767",1,3,0,4,"dummy"
"53768",3,0,0,3,"dummy"
"53769",1,3,0,4,"dummy"
"53770",3,2,0,5,"dummy"
"53771",4,5,0,9,"dummy"
"53772",0,0,1,1,"dummy"
"53773",8,1,2,11,"dummy"
"53774",5,3,0,8,"dummy"
"53775",0,1,1,2,"dummy"
"53776",0,0,1,1,"dummy"
"53777",0,0,1,1,"dummy"
"53778",0,0,1,1,"dummy"
"53784",4,0,0,4,"dummy"
"53785",0,11,0,11,"dummy"
"53801",0,1,0,1,"dummy"
"53802",0,0,1,1,"dummy"
"53803",0,0,1,1,"dummy"
"53804",0,1,0,1,"dummy"
"53805",0,0,0,0,"dummy"
"53806",0,3,0,3,"dummy"
"53807",0,0,1,1,"dummy"
"53817",0,2,0,2,"dummy"
"53818",0,1,0,1,"dummy"
"53819",1,1,1,3,"dummy"
"53820",0,0,1,1,"dummy"
"53821",0,0,3,3,"dummy"
"53822",3,4,0,7,"dummy"
"53823",0,1,0,1,"dummy"
"53824",0,5,0,5,"dummy"
"53825",12,2,1,15,"dummy"
"53826",0,0,1,1,"dummy"
"53829",0,1,0,1,"dummy"
"53830",0,0,1,1,"dummy"
"53852",0,3,0,3,"dummy"
"53887",0,1,0,1,"dummy"
"53888",7,5,0,12,"dummy"
"53889",0,1,0,1,"dummy"
"53890",1,0,1,2,"dummy"
"53959",0,1,0,1,"dummy"
"53960",0,0,0,0,"dummy"
"53961",0,1,1,2,"dummy"
"53962",0,11,0,11,"dummy"
"53963",3,1,0,4,"dummy"
"53964",0,0,1,1,"dummy"
"53967",0,0,2,2,"dummy"
"53974",2,2,0,4,"dummy"
"53975",3,0,1,4,"dummy"
"53980",0,0,0,0,"dummy"
"53981",0,0,0,0,"dummy"
"53990",0,0,0,0,"dummy"
"53991",0,0,1,1,"dummy"
"53992",3,0,0,3,"dummy"
"53993",0,1,0,1,"dummy"
"53994",1,0,1,2,"dummy"
"53995",0,1,0,1,"dummy"
"54002",0,0,1,1,"dummy"
"54010",0,1,0,1,"dummy"
"54011",1,0,0,1,"dummy"
"54014",0,1,0,1,"dummy"
"54015",1,1,0,2,"dummy"
"54016",0,1,2,3,"dummy"
"54019",0,0,2,2,"dummy"
"54020",0,0,2,2,"dummy"
"54021",3,3,4,10,"dummy"
"54022",3,2,1,6,"dummy"
"54025",0,0,1,1,"dummy"
"54026",1,2,0,3,"dummy"
"54027",2,1,0,3,"dummy"
"54028",0,1,0,1,"dummy"
"53835",0,1,0,1,"dummy"
"53840",0,1,0,1,"dummy"
"53841",0,0,3,3,"dummy"
"53842",2,0,0,2,"dummy"
"53843",0,1,0,1,"dummy"
"53844",0,1,0,1,"dummy"
"53856",0,0,1,1,"dummy"
"53857",3,0,2,5,"dummy"
"53858",0,7,2,9,"dummy"
"53859",0,0,1,1,"dummy"
"53860",1,0,1,2,"dummy"
"53861",4,3,5,12,"dummy"
"53862",0,0,0,0,"dummy"
"53863",0,2,4,6,"dummy"
"53864",8,14,1,23,"dummy"
"53865",0,0,1,1,"dummy"
"53866",0,1,0,1,"dummy"
"53867",13,17,1,31,"dummy"
"53870",0,1,0,1,"dummy"
"53871",1,0,1,2,"dummy"
"53872",1,0,0,1,"dummy"
"53873",2,0,0,2,"dummy"
"53876",2,1,3,6,"dummy"
"53879",2,0,0,2,"dummy"
"53880",0,0,0,0,"dummy"
"53896",0,1,0,1,"dummy"
"53969",0,2,0,2,"dummy"
"53970",0,1,0,1,"dummy"
"53971",1,3,1,5,"dummy"
"53972",1,0,1,2,"dummy"
"53977",3,9,3,15,"dummy"
"53978",2,4,0,6,"dummy"
"53985",8,1,0,9,"dummy"
"53988",0,0,2,2,"dummy"
"54006",0,1,0,1,"dummy"
"54007",0,1,0,1,"dummy"
"54008",0,1,0,1,"dummy"
"54042",0,0,1,1,"dummy"
"54043",0,0,1,1,"dummy"
"54044",0,0,0,0,"dummy"
"54045",0,1,0,1,"dummy"
"54122",0,8,0,8,"dummy"
"54123",0,1,0,1,"dummy"
"54124",0,1,0,1,"dummy"
"54125",0,2,0,2,"dummy"
"54126",0,4,0,4,"dummy"
"54127",0,0,1,1,"dummy"
"54049",0,0,0,0,"dummy"
"54117",0,1,0,1,"dummy"
"54118",0,1,0,1,"dummy"
"54144",0,1,0,1,"dummy"
"54147",9,4,0,13,"dummy"
"54148",2,1,0,3,"dummy"
"54149",0,1,0,1,"dummy"
"54150",2,6,3,11,"dummy"
"54151",2,0,0,2,"dummy"
"54152",6,2,1,9,"dummy"
"54153",4,1,5,10,"dummy"
"54154",2,2,1,5,"dummy"
"54155",2,2,1,5,"dummy"
"54156",1,1,3,5,"dummy"
"54157",0,0,0,0,"dummy"
"54160",5,6,4,15,"dummy"
"54161",0,4,0,4,"dummy"
"54162",3,2,1,6,"dummy"
"54163",0,2,0,2,"dummy"
"54164",0,1,0,1,"dummy"
"54165",0,3,0,3,"dummy"
"54166",2,1,0,3,"dummy"
"54167",0,0,1,1,"dummy"
"54197",1,1,5,7,"dummy"
"54206",4,6,4,14,"dummy"
"54207",1,0,1,2,"dummy"
"54208",0,0,1,1,"dummy"
"54209",0,0,3,3,"dummy"
"54210",0,1,0,1,"dummy"
"54215",0,0,0,0,"dummy"
"54216",2,11,0,13,"dummy"
"54217",4,3,0,7,"dummy"
"54218",1,0,0,1,"dummy"
"54219",7,7,1,15,"dummy"
"54220",1,2,3,6,"dummy"
"54221",3,7,2,12,"dummy"
"54222",3,3,0,6,"dummy"
"54223",0,1,1,2,"dummy"
"54236",0,1,0,1,"dummy"
"54237",0,0,0,0,"dummy"
"54238",1,0,0,1,"dummy"
"54239",0,0,1,1,"dummy"
"54240",0,0,1,1,"dummy"
"54253",0,1,0,1,"dummy"
"54254",0,8,0,8,"dummy"
"54255",0,2,0,2,"dummy"
"54256",0,2,0,2,"dummy"
"54257",8,12,1,21,"dummy"
"54360",0,1,0,1,"dummy"
"54404",0,1,0,1,"dummy"
"54405",0,1,0,1,"dummy"
"54406",2,4,0,6,"dummy"
"54407",0,0,0,0,"dummy"
"54408",0,1,0,1,"dummy"
"54409",0,5,1,6,"dummy"
"54410",11,0,1,12,"dummy"
"54441",4,4,1,9,"dummy"
"54128",11,11,0,22,"dummy"
"54129",0,1,1,2,"dummy"
"54130",0,1,0,1,"dummy"
"54131",0,1,0,1,"dummy"
"54132",0,1,0,1,"dummy"
"54133",0,2,0,2,"dummy"
"54134",0,0,1,1,"dummy"
"54135",0,2,1,3,"dummy"
"54138",0,0,0,0,"dummy"
"54139",0,0,0,0,"dummy"
"54140",0,0,0,0,"dummy"
"54141",0,0,0,0,"dummy"
"54142",0,0,0,0,"dummy"
"54212",1,0,0,1,"dummy"
"54213",2,0,0,2,"dummy"
"54231",0,3,0,3,"dummy"
"54242",0,3,0,3,"dummy"
"54243",0,0,1,1,"dummy"
"54246",0,1,0,1,"dummy"
"54247",0,0,0,0,"dummy"
"54248",0,3,1,4,"dummy"
"54249",3,0,2,5,"dummy"
"54250",0,3,1,4,"dummy"
"54251",0,0,1,1,"dummy"
"54260",2,0,0,2,"dummy"
"54261",0,0,1,1,"dummy"
"54262",0,0,1,1,"dummy"
"54263",0,0,1,1,"dummy"
"54264",0,0,2,2,"dummy"
"54265",0,0,1,1,"dummy"
"54266",0,0,1,1,"dummy"
"54267",0,0,1,1,"dummy"
"54268",0,0,1,1,"dummy"
"54269",0,0,1,1,"dummy"
"54272",0,0,0,0,"dummy"
"54273",4,3,0,7,"dummy"
"54412",0,1,0,1,"dummy"
"54413",0,0,1,1,"dummy"
"54414",0,0,1,1,"dummy"
"54415",0,4,3,7,"dummy"
"54416",4,5,0,9,"dummy"
"54417",0,6,1,7,"dummy"
"54418",0,1,0,1,"dummy"
"54419",0,0,1,1,"dummy"
"54420",1,7,0,8,"dummy"
"54421",0,0,1,1,"dummy"
"54422",0,1,0,1,"dummy"
"54423",0,0,1,1,"dummy"
"54424",0,1,0,1,"dummy"
"54425",0,0,1,1,"dummy"
"54426",0,0,0,0,"dummy"
"54427",0,0,0,0,"dummy"
"54428",1,3,0,4,"dummy"
"54429",0,0,0,0,"dummy"
"54430",0,3,0,3,"dummy"
"54431",0,1,1,2,"dummy"
"54432",0,0,0,0,"dummy"
"54433",0,0,1,1,"dummy"
"54434",0,0,0,0,"dummy"
"54435",0,0,1,1,"dummy"
"54436",1,0,1,2,"dummy"
"54437",6,5,0,11,"dummy"
"54438",0,1,1,2,"dummy"
"54439",4,1,0,5,"dummy"
"54445",2,4,0,6,"dummy"
"54446",0,2,0,2,"dummy"
"54447",0,2,0,2,"dummy"
"54448",10,2,0,12,"dummy"
"54449",0,2,0,2,"dummy"
"54452",0,5,0,5,"dummy"
"54453",1,1,3,5,"dummy"
"54454",4,0,0,4,"dummy"
"54455",0,5,0,5,"dummy"
"54456",2,4,0,6,"dummy"
"54457",0,0,3,3,"dummy"
"54458",0,0,3,3,"dummy"
"54459",1,3,3,7,"dummy"
"54460",0,0,4,4,"dummy"
"54461",1,0,0,1,"dummy"
"54462",13,6,2,21,"dummy"
"54463",0,1,0,1,"dummy"
"54464",0,0,1,1,"dummy"
"54465",1,1,3,5,"dummy"
"54466",16,4,0,20,"dummy"
"54467",0,0,1,1,"dummy"
"54468",2,2,1,5,"dummy"
"54469",0,0,1,1,"dummy"
"54470",0,0,1,1,"dummy"
"54471",0,0,1,1,"dummy"
"54472",0,0,1,1,"dummy"
"54473",0,0,1,1,"dummy"
"54474",2,0,0,2,"dummy"
"54475",0,0,1,1,"dummy"
"54476",0,0,1,1,"dummy"
"54477",6,4,2,12,"dummy"
"54478",0,0,1,1,"dummy"
"54479",0,0,1,1,"dummy"
"54480",0,0,1,1,"dummy"
"54481",0,0,1,1,"dummy"
"54482",0,0,1,1,"dummy"
"54483",0,0,1,1,"dummy"
"54486",3,9,0,12,"dummy"
"54487",1,1,0,2,"dummy"
"54502",0,0,2,2,"dummy"
"54503",0,3,0,3,"dummy"
"54504",0,0,1,1,"dummy"
"54505",0,0,1,1,"dummy"
"54506",0,0,1,1,"dummy"
"54519",0,0,0,0,"dummy"
"54520",0,1,0,1,"dummy"
"54521",0,2,0,2,"dummy"
"54522",0,0,1,1,"dummy"
"54525",0,1,0,1,"dummy"
"54535",3,1,0,4,"dummy"
"54536",0,0,0,0,"dummy"
"54537",0,0,1,1,"dummy"
"54538",0,1,0,1,"dummy"
"54539",0,0,1,1,"dummy"
"54540",0,1,0,1,"dummy"
"54608",0,0,0,0,"dummy"
"54609",0,2,0,2,"dummy"
"54610",0,0,0,0,"dummy"
"54611",0,0,1,1,"dummy"
"54612",0,1,0,1,"dummy"
"54613",0,0,0,0,"dummy"
"54620",2,1,0,3,"dummy"
"54646",1,8,2,11,"dummy"
"54647",0,0,1,1,"dummy"
"54648",1,4,1,6,"dummy"
"54657",0,0,3,3,"dummy"
"54658",0,1,1,2,"dummy"
"54663",0,1,0,1,"dummy"
"54664",3,0,2,5,"dummy"
"54675",0,2,0,2,"dummy"
"54676",0,0,0,0,"dummy"
"54489",0,0,2,2,"dummy"
"54494",0,0,0,0,"dummy"
"54495",0,2,0,2,"dummy"
"54496",0,0,1,1,"dummy"
"54497",4,0,2,6,"dummy"
"54498",0,0,2,2,"dummy"
"54517",3,4,4,11,"dummy"
"54527",5,5,2,12,"dummy"
"54528",8,0,0,8,"dummy"
"54529",8,4,0,12,"dummy"
"54530",0,0,0,0,"dummy"
"54531",2,2,1,5,"dummy"
"54532",0,0,0,0,"dummy"
"54533",0,0,0,0,"dummy"
"54542",5,0,0,5,"dummy"
"54543",0,9,1,10,"dummy"
"54544",1,2,0,3,"dummy"
"54545",0,0,1,1,"dummy"
"54546",0,0,1,1,"dummy"
"54547",0,1,0,1,"dummy"
"54548",3,2,6,11,"dummy"
"54549",0,0,1,1,"dummy"
"54550",0,0,1,1,"dummy"
"54551",0,0,1,1,"dummy"
"54552",0,0,1,1,"dummy"
"54553",0,0,1,1,"dummy"
"54554",0,0,1,1,"dummy"
"54555",1,5,0,6,"dummy"
"54556",0,0,1,1,"dummy"
"54557",0,0,1,1,"dummy"
"54558",0,0,1,1,"dummy"
"54559",0,0,1,1,"dummy"
"54560",0,0,1,1,"dummy"
"54561",0,0,1,1,"dummy"
"54562",0,0,1,1,"dummy"
"54563",0,0,1,1,"dummy"
"54564",0,3,1,4,"dummy"
"54565",0,0,1,1,"dummy"
"54566",0,0,1,1,"dummy"
"54567",0,0,1,1,"dummy"
"54568",0,2,0,2,"dummy"
"54569",0,0,1,1,"dummy"
"54570",0,0,1,1,"dummy"
"54571",0,0,1,1,"dummy"
"54572",0,7,0,7,"dummy"
"54573",0,0,1,1,"dummy"
"54574",0,0,1,1,"dummy"
"54577",0,1,0,1,"dummy"
"54581",0,1,0,1,"dummy"
"54582",0,1,0,1,"dummy"
"54583",0,2,0,2,"dummy"
"54584",0,1,0,1,"dummy"
"54587",0,7,0,7,"dummy"
"54588",3,1,0,4,"dummy"
"54591",0,0,0,0,"dummy"
"54592",0,0,0,0,"dummy"
"54593",1,1,0,2,"dummy"
"54594",0,0,1,1,"dummy"
"54595",0,0,0,0,"dummy"
"54596",0,0,1,1,"dummy"
"54597",0,0,0,0,"dummy"
"54598",0,1,1,2,"dummy"
"54599",0,0,1,1,"dummy"
"54600",0,1,0,1,"dummy"
"54601",0,0,0,0,"dummy"
"54602",0,0,1,1,"dummy"
"54603",0,1,0,1,"dummy"
"54604",0,0,2,2,"dummy"
"54605",0,0,0,0,"dummy"
"54606",0,0,1,1,"dummy"
"54615",0,4,0,4,"dummy"
"54616",0,1,0,1,"dummy"
"54624",3,0,2,5,"dummy"
"54625",0,1,0,1,"dummy"
"54626",9,5,2,16,"dummy"
"54627",0,0,0,0,"dummy"
"54628",0,0,1,1,"dummy"
"54644",0,11,0,11,"dummy"
"54654",0,5,0,5,"dummy"
"54655",2,2,2,6,"dummy"
"54660",0,1,0,1,"dummy"
"54661",2,0,0,2,"dummy"
"54666",1,0,3,4,"dummy"
"54667",0,1,0,1,"dummy"
"54668",0,1,1,2,"dummy"
"54669",0,1,0,1,"dummy"
"54672",0,0,3,3,"dummy"
"54673",1,2,0,3,"dummy"
"54678",1,0,0,1,"dummy"
"54679",0,0,2,2,"dummy"
"54680",2,0,0,2,"dummy"
"54683",0,0,0,0,"dummy"
"54684",2,1,1,4,"dummy"
"54686",1,0,0,1,"dummy"
"54688",0,0,0,0,"dummy"
"54689",0,0,0,0,"dummy"
"54690",0,0,0,0,"dummy"
"54691",0,0,0,0,"dummy"
"54694",0,1,0,1,"dummy"
"54697",0,1,0,1,"dummy"
"54703",7,1,2,10,"dummy"
"54707",0,0,1,1,"dummy"
"54709",0,0,2,2,"dummy"
"54711",0,2,0,2,"dummy"
"54712",0,0,2,2,"dummy"
"54713",0,2,0,2,"dummy"
"54714",0,2,0,2,"dummy"
"54715",0,2,0,2,"dummy"
"54716",0,2,0,2,"dummy"
"54717",1,0,1,2,"dummy"
"54718",1,0,1,2,"dummy"
"54719",0,0,1,1,"dummy"
"54723",0,1,1,2,"dummy"
"54725",2,6,0,8,"dummy"
"54726",0,1,2,3,"dummy"
"54727",6,14,6,26,"dummy"
"54728",2,5,1,8,"dummy"
"54731",0,0,0,0,"dummy"
"54734",0,0,1,1,"dummy"
"54735",0,0,1,1,"dummy"
"54737",0,3,0,3,"dummy"
"54738",2,1,0,3,"dummy"
"54739",1,1,0,2,"dummy"
"54740",0,1,1,2,"dummy"
"54741",0,0,1,1,"dummy"
"54742",0,0,1,1,"dummy"
"54745",15,0,1,16,"dummy"
"54746",1,0,0,1,"dummy"
"54747",0,1,0,1,"dummy"
"54749",0,0,0,0,"dummy"
"54750",0,2,0,2,"dummy"
"54751",1,1,0,2,"dummy"
"54752",0,0,1,1,"dummy"
"54753",0,0,1,1,"dummy"
"54754",3,1,2,6,"dummy"
"54756",0,0,1,1,"dummy"
"54757",3,7,1,11,"dummy"
"54760",0,0,3,3,"dummy"
"54761",5,5,3,13,"dummy"
"54762",0,1,0,1,"dummy"
"54764",2,8,2,12,"dummy"
"54765",2,2,1,5,"dummy"
"54769",0,0,0,0,"dummy"
"54770",0,2,0,2,"dummy"
"54771",0,0,0,0,"dummy"
"54772",0,0,0,0,"dummy"
"54774",1,1,0,2,"dummy"
"54785",0,0,1,1,"dummy"
"54788",1,1,0,2,"dummy"
"54806",0,1,0,1,"dummy"
"54818",0,3,3,6,"dummy"
"54820",0,1,0,1,"dummy"
"54821",0,0,1,1,"dummy"
"54822",0,0,2,2,"dummy"
"54823",1,9,0,10,"dummy"
"54824",4,0,0,4,"dummy"
"54826",0,2,0,2,"dummy"
"54828",3,0,3,6,"dummy"
"54829",1,0,0,1,"dummy"
"54830",0,5,1,6,"dummy"
"54831",2,8,0,10,"dummy"
"54837",1,8,0,9,"dummy"
"54838",0,0,0,0,"dummy"
"54839",0,1,0,1,"dummy"
"54840",1,27,2,30,"dummy"
"54841",0,6,0,6,"dummy"
"54843",0,2,0,2,"dummy"
"54845",6,1,1,8,"dummy"
"54846",0,0,0,0,"dummy"
"54869",0,0,1,1,"dummy"
"54872",0,3,0,3,"dummy"
"54875",0,1,0,1,"dummy"
"54876",0,1,0,1,"dummy"
"54877",4,3,1,8,"dummy"
"54878",0,1,0,1,"dummy"
"54879",2,1,1,4,"dummy"
"54880",0,0,1,1,"dummy"
"54882",1,7,1,9,"dummy"
"54883",1,1,5,7,"dummy"
"54884",7,1,1,9,"dummy"
"54885",0,0,1,1,"dummy"
"54886",0,1,0,1,"dummy"
"54887",3,4,3,10,"dummy"
"54888",0,0,2,2,"dummy"
"54889",0,1,0,1,"dummy"
"54890",0,0,2,2,"dummy"
"54892",5,17,5,27,"dummy"
"54893",2,3,0,5,"dummy"
"54894",0,0,3,3,"dummy"
"54895",0,0,1,1,"dummy"
"54897",2,1,1,4,"dummy"
"54898",0,0,1,1,"dummy"
"54899",0,8,0,8,"dummy"
"54900",0,0,1,1,"dummy"
"54902",0,0,1,1,"dummy"
"54924",7,6,1,14,"dummy"
"54925",2,4,0,6,"dummy"
"54926",2,3,1,6,"dummy"
"54927",13,14,3,30,"dummy"
"54928",2,10,0,12,"dummy"
"54929",3,7,0,10,"dummy"
"54931",0,0,0,0,"dummy"
"54932",7,4,1,12,"dummy"
"54933",3,3,0,6,"dummy"
"54935",0,0,1,1,"dummy"
"54936",0,0,1,1,"dummy"
"54937",0,0,1,1,"dummy"
"54938",0,0,1,1,"dummy"
"54940",4,5,0,9,"dummy"
"54941",0,1,0,1,"dummy"
"54942",0,1,0,1,"dummy"
"54943",1,2,2,5,"dummy"
"54944",0,0,1,1,"dummy"
"54945",0,1,2,3,"dummy"
"54946",1,0,2,3,"dummy"
"54947",0,0,3,3,"dummy"
"54948",0,0,2,2,"dummy"
"54949",0,0,1,1,"dummy"
"54951",0,4,0,4,"dummy"
"54953",0,0,1,1,"dummy"
"54955",1,2,0,3,"dummy"
"54959",0,0,1,1,"dummy"
"54961",0,0,1,1,"dummy"
"54963",1,2,0,3,"dummy"
"54964",2,3,0,5,"dummy"
"54966",0,0,1,1,"dummy"
"54967",0,0,3,3,"dummy"
"54968",0,0,3,3,"dummy"
"54975",0,0,4,4,"dummy"
"54976",0,1,0,1,"dummy"
"54977",1,0,0,1,"dummy"
"54981",0,0,1,1,"dummy"
"54983",0,1,0,1,"dummy"
"54984",4,0,2,6,"dummy"
"54987",0,3,3,6,"dummy"
"54988",3,2,3,8,"dummy"
"54989",1,0,0,1,"dummy"
"54990",0,0,1,1,"dummy"
"54991",5,1,0,6,"dummy"
"54992",0,1,2,3,"dummy"
"54993",0,0,1,1,"dummy"
"54994",0,0,4,4,"dummy"
"54995",1,3,2,6,"dummy"
"54996",0,0,1,1,"dummy"
"54997",1,1,0,2,"dummy"
"54998",0,2,4,6,"dummy"
"54999",2,2,4,8,"dummy"
"55001",0,0,0,0,"dummy"
"55005",2,3,2,7,"dummy"
"55006",2,2,0,4,"dummy"
"55007",0,1,0,1,"dummy"
"55008",1,0,0,1,"dummy"
"55009",0,0,3,3,"dummy"
"55012",2,1,2,5,"dummy"
"55013",1,2,2,5,"dummy"
"55016",0,0,1,1,"dummy"
"55022",0,3,0,3,"dummy"
"55047",0,0,1,1,"dummy"
"55050",0,1,0,1,"dummy"
"55052",2,2,1,5,"dummy"
"55053",0,0,4,4,"dummy"
"55054",0,4,3,7,"dummy"
"55055",2,2,0,4,"dummy"
"55056",4,3,1,8,"dummy"
"55057",2,2,0,4,"dummy"
"55058",0,4,4,8,"dummy"
"55059",0,2,1,3,"dummy"
"55060",0,0,1,1,"dummy"
"55061",0,2,0,2,"dummy"
"55062",3,3,0,6,"dummy"
"55063",0,0,1,1,"dummy"
"55064",0,6,0,6,"dummy"
"55065",2,10,0,12,"dummy"
"55066",3,0,0,3,"dummy"
"55088",1,0,2,3,"dummy"
"55099",1,1,0,2,"dummy"
"55102",0,1,0,1,"dummy"
"55103",1,0,0,1,"dummy"
"55104",0,1,0,1,"dummy"
"55105",1,1,0,2,"dummy"
"55106",1,1,0,2,"dummy"
"55107",1,1,0,2,"dummy"
"55108",1,0,0,1,"dummy"
"55109",0,0,0,0,"dummy"
"55110",0,0,2,2,"dummy"
"55113",4,2,0,6,"dummy"
"55114",0,0,0,0,"dummy"
"55115",5,5,0,10,"dummy"
"55116",1,3,1,5,"dummy"
"55117",3,2,0,5,"dummy"
"55118",0,3,0,3,"dummy"
"55119",0,1,0,1,"dummy"
"55120",0,1,0,1,"dummy"
"55121",2,3,0,5,"dummy"
"55122",0,0,0,0,"dummy"
"55123",0,2,0,2,"dummy"
"55124",2,1,1,4,"dummy"
"55158",0,1,0,1,"dummy"
"55159",0,1,0,1,"dummy"
"55160",0,6,0,6,"dummy"
"55163",0,1,0,1,"dummy"
"55164",0,0,3,3,"dummy"
"55170",0,3,3,6,"dummy"
"55171",1,0,0,1,"dummy"
"55172",0,0,0,0,"dummy"
"55173",0,0,1,1,"dummy"
"55174",0,6,0,6,"dummy"
"55175",0,0,1,1,"dummy"
"55176",3,2,0,5,"dummy"
"55177",0,1,0,1,"dummy"
"55178",0,0,1,1,"dummy"
"55179",0,1,1,2,"dummy"
"55180",0,0,1,1,"dummy"
"55181",0,0,1,1,"dummy"
"55182",0,0,1,1,"dummy"
"55183",0,1,0,1,"dummy"
"55184",0,0,1,1,"dummy"
"55185",1,1,1,3,"dummy"
"55189",0,0,1,1,"dummy"
"55190",0,0,0,0,"dummy"
"55191",0,0,1,1,"dummy"
"55192",0,3,0,3,"dummy"
"55193",0,1,0,1,"dummy"
"55197",2,1,0,3,"dummy"
"55198",0,2,0,2,"dummy"
"55199",0,0,0,0,"dummy"
"55200",1,1,0,2,"dummy"
"55201",8,2,1,11,"dummy"
"55211",12,6,1,19,"dummy"
"55212",4,0,1,5,"dummy"
"55213",0,1,0,1,"dummy"
"55216",0,3,0,3,"dummy"
"55217",0,0,1,1,"dummy"
"55218",0,0,1,1,"dummy"
"55219",0,0,1,1,"dummy"
"55068",1,24,0,25,"dummy"
"55077",0,0,1,1,"dummy"
"55080",0,2,0,2,"dummy"
"55081",0,0,1,1,"dummy"
"55084",0,7,0,7,"dummy"
"55097",0,0,1,1,"dummy"
"55126",0,0,0,0,"dummy"
"55127",0,0,0,0,"dummy"
"55128",0,0,0,0,"dummy"
"55137",0,1,0,1,"dummy"
"55138",0,5,0,5,"dummy"
"55139",0,0,3,3,"dummy"
"55140",0,0,0,0,"dummy"
"55141",2,3,0,5,"dummy"
"55142",3,3,0,6,"dummy"
"55143",3,3,0,6,"dummy"
"55144",6,2,0,8,"dummy"
"55145",0,0,0,0,"dummy"
"55146",0,1,0,1,"dummy"
"55166",1,17,1,19,"dummy"
"55167",0,6,0,6,"dummy"
"55168",0,10,0,10,"dummy"
"55195",5,4,0,9,"dummy"
"55203",0,1,0,1,"dummy"
"55204",0,0,1,1,"dummy"
"55205",0,0,0,0,"dummy"
"55206",0,1,0,1,"dummy"
"55209",0,2,2,4,"dummy"
"55221",0,0,2,2,"dummy"
"55222",0,0,2,2,"dummy"
"55223",0,0,1,1,"dummy"
"55270",13,43,8,64,"dummy"
"55271",3,5,2,10,"dummy"
"55272",2,4,2,8,"dummy"
"55273",13,19,6,38,"dummy"
"55274",3,10,3,16,"dummy"
"55275",0,2,0,2,"dummy"
"55276",0,0,1,1,"dummy"
"55277",1,7,0,8,"dummy"
"55278",4,4,0,8,"dummy"
"55279",5,0,1,6,"dummy"
"55280",0,0,2,2,"dummy"
"55363",0,66,0,66,"dummy"
"55364",16,11,13,40,"dummy"
"55372",0,2,0,2,"dummy"
"55375",0,2,0,2,"dummy"
"55376",0,3,0,3,"dummy"
"55377",0,2,0,2,"dummy"
"55378",0,3,0,3,"dummy"
"55264",0,7,0,7,"dummy"
"55265",6,12,2,20,"dummy"
"55266",0,0,1,1,"dummy"
"55267",0,2,0,2,"dummy"
"55268",3,4,3,10,"dummy"
"55282",0,20,2,22,"dummy"
"55283",24,6,0,30,"dummy"
"55284",1,0,1,2,"dummy"
"55285",0,2,0,2,"dummy"
"55286",1,0,0,1,"dummy"
"55287",0,1,0,1,"dummy"
"55288",0,1,0,1,"dummy"
"55289",0,2,0,2,"dummy"
"55290",3,20,0,23,"dummy"
"55291",21,10,0,31,"dummy"
"55292",0,0,1,1,"dummy"
"55293",0,1,0,1,"dummy"
"55294",0,1,0,1,"dummy"
"55295",0,1,0,1,"dummy"
"55296",5,16,1,22,"dummy"
"55297",19,10,1,30,"dummy"
"55298",0,3,0,3,"dummy"
"55299",0,0,1,1,"dummy"
"55300",9,1,1,11,"dummy"
"55301",6,14,1,21,"dummy"
"55302",19,13,1,33,"dummy"
"55303",0,1,0,1,"dummy"
"55304",1,1,0,2,"dummy"
"55305",1,1,0,2,"dummy"
"55306",0,0,1,1,"dummy"
"55307",0,0,1,1,"dummy"
"55308",0,0,1,1,"dummy"
"55309",0,0,3,3,"dummy"
"55310",0,1,0,1,"dummy"
"55311",0,11,0,11,"dummy"
"55312",3,1,1,5,"dummy"
"55313",3,2,3,8,"dummy"
"55314",8,0,2,10,"dummy"
"55315",0,1,0,1,"dummy"
"55316",1,0,0,1,"dummy"
"55317",7,13,2,22,"dummy"
"55318",17,8,2,27,"dummy"
"55319",7,13,2,22,"dummy"
"55320",17,8,2,27,"dummy"
"55321",7,13,2,22,"dummy"
"55322",0,0,0,0,"dummy"
"55323",1,0,0,1,"dummy"
"55324",0,1,1,2,"dummy"
"55325",0,3,0,3,"dummy"
"55326",0,0,0,0,"dummy"
"55327",3,0,0,3,"dummy"
"55328",0,0,0,0,"dummy"
"55329",0,0,0,0,"dummy"
"55334",0,0,1,1,"dummy"
"55354",0,0,1,1,"dummy"
"55355",4,4,0,8,"dummy"
"55358",0,2,0,2,"dummy"
"55359",0,2,0,2,"dummy"
"55368",2,1,0,3,"dummy"
"55369",0,1,0,1,"dummy"
"55370",0,0,0,0,"dummy"
"55505",0,0,1,1,"dummy"
"55506",2,0,0,2,"dummy"
"55510",4,0,0,4,"dummy"
"55511",0,4,2,6,"dummy"
"55512",0,0,1,1,"dummy"
"55513",1,1,0,2,"dummy"
"55514",4,1,1,6,"dummy"
"55515",0,0,1,1,"dummy"
"55516",1,4,1,6,"dummy"
"55517",2,0,1,3,"dummy"
"55518",0,4,3,7,"dummy"
"55519",0,2,2,4,"dummy"
"55520",0,0,1,1,"dummy"
"55521",2,1,1,4,"dummy"
"55522",1,3,1,5,"dummy"
"55523",1,1,0,2,"dummy"
"55524",1,1,0,2,"dummy"
"55428",8,14,4,26,"dummy"
"55429",0,0,1,1,"dummy"
"55430",7,5,5,17,"dummy"
"55431",0,0,0,0,"dummy"
"55432",0,4,0,4,"dummy"
"55433",0,0,0,0,"dummy"
"55434",0,1,1,2,"dummy"
"55439",0,0,2,2,"dummy"
"55440",0,2,0,2,"dummy"
"55441",2,7,5,14,"dummy"
"55442",0,0,3,3,"dummy"
"55443",1,1,0,2,"dummy"
"55444",0,0,3,3,"dummy"
"55445",1,1,4,6,"dummy"
"55448",0,0,1,1,"dummy"
"55449",0,0,1,1,"dummy"
"55450",0,0,1,1,"dummy"
"55484",2,4,1,7,"dummy"
"55485",0,0,1,1,"dummy"
"55486",2,1,3,6,"dummy"
"55500",2,0,3,5,"dummy"
"55501",1,0,0,1,"dummy"
"55502",0,1,0,1,"dummy"
"55503",0,1,1,2,"dummy"
"55508",0,0,2,2,"dummy"
"55537",4,1,1,6,"dummy"
"55538",1,0,1,2,"dummy"
"55539",2,0,1,3,"dummy"
"55540",0,1,1,2,"dummy"
"55541",1,0,1,2,"dummy"
"55542",0,2,1,3,"dummy"
"55543",0,0,1,1,"dummy"
"55544",0,1,0,1,"dummy"
"55545",1,0,0,1,"dummy"
"55546",0,1,0,1,"dummy"
"55547",1,1,0,2,"dummy"
"55550",0,0,0,0,"dummy"
"55558",1,0,0,1,"dummy"
"55525",1,1,0,2,"dummy"
"55526",0,1,0,1,"dummy"
"55527",2,1,0,3,"dummy"
"55528",0,0,2,2,"dummy"
"55529",0,0,0,0,"dummy"
"55530",2,3,0,5,"dummy"
"55531",1,1,0,2,"dummy"
"55532",1,5,0,6,"dummy"
"55533",0,1,0,1,"dummy"
"55534",0,3,0,3,"dummy"
"55535",2,2,1,5,"dummy"
"55554",0,1,0,1,"dummy"
"55555",2,3,2,7,"dummy"
"55556",1,1,0,2,"dummy"
"55564",0,0,1,1,"dummy"
"55567",0,1,0,1,"dummy"
"55568",4,0,2,6,"dummy"
"55667",0,0,1,1,"dummy"
"55668",0,1,0,1,"dummy"
"55671",1,0,0,1,"dummy"
"55672",0,0,1,1,"dummy"
"55673",1,1,0,2,"dummy"
"55674",0,0,1,1,"dummy"
"55675",0,1,0,1,"dummy"
"55676",0,2,0,2,"dummy"
"55677",0,0,2,2,"dummy"
"55726",2,9,0,11,"dummy"
"55752",0,0,0,0,"dummy"
"55753",0,0,0,0,"dummy"
"55754",0,0,1,1,"dummy"
"55755",0,0,0,0,"dummy"
"55756",0,0,1,1,"dummy"
"55757",0,0,0,0,"dummy"
"55793",0,0,1,1,"dummy"
"55794",0,0,1,1,"dummy"
"55795",0,0,1,1,"dummy"
"55796",0,0,1,1,"dummy"
"55799",0,0,0,0,"dummy"
"55800",0,4,0,4,"dummy"
"55810",0,0,1,1,"dummy"
"55811",0,0,0,0,"dummy"
"55816",0,1,0,1,"dummy"
"55817",1,0,0,1,"dummy"
"55818",0,0,0,0,"dummy"
"55819",0,3,0,3,"dummy"
"55823",0,2,0,2,"dummy"
"55844",0,5,0,5,"dummy"
"55845",0,0,0,0,"dummy"
"55846",0,1,0,1,"dummy"
"55847",0,0,1,1,"dummy"
"55848",0,0,1,1,"dummy"
"55849",0,0,1,1,"dummy"
"55850",5,0,0,5,"dummy"
"55633",0,1,0,1,"dummy"
"55634",1,1,0,2,"dummy"
"55635",0,1,0,1,"dummy"
"55636",24,28,1,53,"dummy"
"55637",4,0,0,4,"dummy"
"55638",18,17,1,36,"dummy"
"55639",0,1,0,1,"dummy"
"55640",0,1,2,3,"dummy"
"55643",1,1,0,2,"dummy"
"55644",1,3,0,4,"dummy"
"55645",2,1,1,4,"dummy"
"55646",1,1,0,2,"dummy"
"55647",0,2,0,2,"dummy"
"55648",0,1,2,3,"dummy"
"55718",4,4,0,8,"dummy"
"55719",0,1,0,1,"dummy"
"55720",0,2,0,2,"dummy"
"55721",3,1,0,4,"dummy"
"55722",0,2,0,2,"dummy"
"55723",0,0,1,1,"dummy"
"55724",1,1,0,2,"dummy"
"55736",0,2,0,2,"dummy"
"55737",1,0,0,1,"dummy"
"55738",2,5,0,7,"dummy"
"55739",0,0,1,1,"dummy"
"55740",1,0,0,1,"dummy"
"55741",1,3,0,4,"dummy"
"55742",0,1,0,1,"dummy"
"55743",0,1,0,1,"dummy"
"55744",0,1,0,1,"dummy"
"55749",0,1,0,1,"dummy"
"55750",0,1,0,1,"dummy"
"55759",8,9,0,17,"dummy"
"55760",4,4,0,8,"dummy"
"55761",4,4,0,8,"dummy"
"55762",1,0,0,1,"dummy"
"55763",10,12,0,22,"dummy"
"55764",0,2,0,2,"dummy"
"55765",2,0,0,2,"dummy"
"55766",2,10,2,14,"dummy"
"55767",0,0,1,1,"dummy"
"55768",0,1,0,1,"dummy"
"55769",0,1,0,1,"dummy"
"55770",0,1,0,1,"dummy"
"55771",0,1,0,1,"dummy"
"55772",3,1,0,4,"dummy"
"55773",0,0,0,0,"dummy"
"55774",1,1,0,2,"dummy"
"55775",0,1,0,1,"dummy"
"55776",0,0,0,0,"dummy"
"55777",0,1,0,1,"dummy"
"55780",1,3,1,5,"dummy"
"55781",2,5,0,7,"dummy"
"55782",0,0,0,0,"dummy"
"55783",0,0,0,0,"dummy"
"55784",0,0,1,1,"dummy"
"55785",1,0,0,1,"dummy"
"55786",0,0,1,1,"dummy"
"55787",0,0,1,1,"dummy"
"55804",0,1,0,1,"dummy"
"55805",0,1,0,1,"dummy"
"55808",0,3,0,3,"dummy"
"55821",0,0,2,2,"dummy"
"55852",2,0,1,3,"dummy"
"55853",0,0,1,1,"dummy"
"55854",0,0,1,1,"dummy"
"55867",0,0,1,1,"dummy"
"55868",0,0,1,1,"dummy"
"55869",0,0,1,1,"dummy"
"55870",2,1,0,3,"dummy"
"55871",0,0,1,1,"dummy"
"55882",0,1,0,1,"dummy"
"55883",3,2,2,7,"dummy"
"55884",0,0,2,2,"dummy"
"55885",0,1,0,1,"dummy"
"55886",0,7,1,8,"dummy"
"55894",3,0,0,3,"dummy"
"55910",1,5,0,6,"dummy"
"55928",2,3,1,6,"dummy"
"55929",0,1,1,2,"dummy"
"55930",0,1,0,1,"dummy"
"55931",3,1,0,4,"dummy"
"55932",0,1,0,1,"dummy"
"55933",0,0,0,0,"dummy"
"55934",0,0,2,2,"dummy"
"55935",1,0,1,2,"dummy"
"55939",10,0,2,12,"dummy"
"55940",3,3,0,6,"dummy"
"55961",2,6,0,8,"dummy"
"55962",2,4,0,6,"dummy"
"55965",0,0,1,1,"dummy"
"55966",1,3,0,4,"dummy"
"55967",0,6,0,6,"dummy"
"55968",6,0,0,6,"dummy"
"55969",2,2,0,4,"dummy"
"55970",0,1,0,1,"dummy"
"55971",3,2,1,6,"dummy"
"55972",6,4,3,13,"dummy"
"55973",0,0,1,1,"dummy"
"55974",0,1,1,2,"dummy"
"55985",19,2,2,23,"dummy"
"55990",0,0,0,0,"dummy"
"55856",0,0,1,1,"dummy"
"55865",0,1,1,2,"dummy"
"55878",1,0,0,1,"dummy"
"55879",0,0,0,0,"dummy"
"55880",0,0,1,1,"dummy"
"55888",2,9,0,11,"dummy"
"55891",7,1,1,9,"dummy"
"55892",6,1,3,10,"dummy"
"55904",1,3,0,4,"dummy"
"55905",14,2,3,19,"dummy"
"55908",0,2,0,2,"dummy"
"55912",1,3,0,4,"dummy"
"55913",0,1,0,1,"dummy"
"55914",0,1,0,1,"dummy"
"55915",1,4,0,5,"dummy"
"55916",0,0,0,0,"dummy"
"55917",0,4,0,4,"dummy"
"55918",0,0,2,2,"dummy"
"55919",0,2,0,2,"dummy"
"55920",1,3,4,8,"dummy"
"55921",0,0,0,0,"dummy"
"55922",0,0,1,1,"dummy"
"55923",0,1,0,1,"dummy"
"55926",0,0,0,0,"dummy"
"55937",0,1,0,1,"dummy"
"55945",0,3,2,5,"dummy"
"55946",9,1,2,12,"dummy"
"55947",0,0,2,2,"dummy"
"55948",1,3,0,4,"dummy"
"55949",2,0,0,2,"dummy"
"55950",0,1,2,3,"dummy"
"55951",0,1,4,5,"dummy"
"55952",0,4,0,4,"dummy"
"55953",0,1,0,1,"dummy"
"55954",4,0,0,4,"dummy"
"55955",2,8,5,15,"dummy"
"55956",0,0,0,0,"dummy"
"55957",0,0,1,1,"dummy"
"55958",0,0,1,1,"dummy"
"55959",0,0,1,1,"dummy"
"55976",1,3,1,5,"dummy"
"55977",2,3,0,5,"dummy"
"55978",1,0,0,1,"dummy"
"55979",0,6,0,6,"dummy"
"55980",0,1,0,1,"dummy"
"55981",0,1,1,2,"dummy"
"55982",0,3,1,4,"dummy"
"55983",0,0,0,0,"dummy"
"55987",0,0,0,0,"dummy"
"55988",0,0,0,0,"dummy"
"55992",8,0,1,9,"dummy"
"55994",1,0,0,1,"dummy"
"55995",3,0,0,3,"dummy"
"55998",0,2,0,2,"dummy"
"55999",0,4,0,4,"dummy"
"56002",0,0,0,0,"dummy"
"56003",0,2,0,2,"dummy"
"56005",0,1,0,1,"dummy"
"56015",1,0,0,1,"dummy"
"56016",6,4,0,10,"dummy"
"56017",2,2,0,4,"dummy"
"56018",0,1,1,2,"dummy"
"56020",4,0,1,5,"dummy"
"56021",1,4,1,6,"dummy"
"56023",1,11,1,13,"dummy"
"56024",0,0,2,2,"dummy"
"56025",0,0,0,0,"dummy"
"56026",0,0,0,0,"dummy"
"56027",0,2,0,2,"dummy"
"56028",9,9,1,19,"dummy"
"56029",0,1,0,1,"dummy"
"56030",0,1,0,1,"dummy"
"56031",0,1,0,1,"dummy"
"56032",3,9,0,12,"dummy"
"56033",0,1,0,1,"dummy"
"56035",0,2,1,3,"dummy"
"56037",0,0,0,0,"dummy"
"56048",0,0,0,0,"dummy"
"56049",0,0,0,0,"dummy"
"56068",2,3,0,5,"dummy"
"56069",0,1,0,1,"dummy"
"56073",14,21,5,40,"dummy"
"56075",1,0,0,1,"dummy"
"56076",4,0,3,7,"dummy"
"56078",3,5,3,11,"dummy"
"56081",1,4,2,7,"dummy"
"56082",0,2,0,2,"dummy"
"56083",0,1,0,1,"dummy"
"56091",0,2,0,2,"dummy"
"56093",7,10,5,22,"dummy"
"56094",13,3,4,20,"dummy"
"56096",0,2,0,2,"dummy"
"56097",0,1,0,1,"dummy"
"56098",7,5,4,16,"dummy"
"56099",0,2,0,2,"dummy"
"56100",0,7,0,7,"dummy"
"56101",0,11,0,11,"dummy"
"56102",0,1,0,1,"dummy"
"56103",0,3,0,3,"dummy"
"56110",2,0,3,5,"dummy"
"56111",1,0,0,1,"dummy"
"56112",0,1,0,1,"dummy"
"56113",0,1,1,2,"dummy"
"56116",0,1,0,1,"dummy"
"56123",3,1,0,4,"dummy"
"56130",0,0,0,0,"dummy"
"56131",0,0,0,0,"dummy"
"56133",1,0,0,1,"dummy"
"56134",2,0,2,4,"dummy"
"56135",0,5,0,5,"dummy"
"56136",2,0,0,2,"dummy"
"56148",0,0,1,1,"dummy"
"56149",0,1,0,1,"dummy"
"56150",0,0,0,0,"dummy"
"56151",0,2,0,2,"dummy"
"56152",0,0,1,1,"dummy"
"56153",3,7,0,10,"dummy"
"56155",0,4,0,4,"dummy"
"56156",0,2,0,2,"dummy"
"56157",0,1,0,1,"dummy"
"56158",4,28,0,32,"dummy"
"56159",0,0,1,1,"dummy"
"56160",0,1,1,2,"dummy"
"56161",0,4,0,4,"dummy"
"56162",1,0,0,1,"dummy"
"56163",0,2,0,2,"dummy"
"56164",1,0,0,1,"dummy"
"56165",0,3,0,3,"dummy"
"56166",0,1,0,1,"dummy"
"56167",0,0,1,1,"dummy"
"56170",0,0,1,1,"dummy"
"56176",1,0,1,2,"dummy"
"56179",0,10,0,10,"dummy"
"56180",0,0,5,5,"dummy"
"56181",0,0,0,0,"dummy"
"56183",0,0,2,2,"dummy"
"56184",0,0,2,2,"dummy"
"56185",0,0,3,3,"dummy"
"56186",2,1,2,5,"dummy"
"56187",0,1,1,2,"dummy"
"56188",0,0,2,2,"dummy"
"56189",0,0,2,2,"dummy"
"56190",1,0,0,1,"dummy"
"56191",0,2,0,2,"dummy"
"56192",2,2,0,4,"dummy"
"56193",0,0,2,2,"dummy"
"56194",2,2,0,4,"dummy"
"56195",0,1,0,1,"dummy"
"56196",1,0,0,1,"dummy"
"56197",0,0,1,1,"dummy"
"56198",0,0,1,1,"dummy"
"56199",0,0,1,1,"dummy"
"56200",0,0,1,1,"dummy"
"56201",0,0,1,1,"dummy"
"56228",0,1,0,1,"dummy"
"56229",0,0,1,1,"dummy"
"56231",0,0,3,3,"dummy"
"56242",6,3,5,14,"dummy"
"56246",0,9,0,9,"dummy"
"56249",0,0,1,1,"dummy"
"56257",0,0,5,5,"dummy"
"56259",0,1,1,2,"dummy"
"56260",0,2,0,2,"dummy"
"56261",0,0,1,1,"dummy"
"56262",0,0,3,3,"dummy"
"56263",0,0,0,0,"dummy"
"56264",0,6,0,6,"dummy"
"56265",0,0,1,1,"dummy"
"56266",1,1,0,2,"dummy"
"56267",1,1,1,3,"dummy"
"56268",1,1,1,3,"dummy"
"56269",0,0,1,1,"dummy"
"56271",0,6,0,6,"dummy"
"56272",1,0,2,3,"dummy"
"56273",0,1,0,1,"dummy"
"56281",6,2,2,10,"dummy"
"56282",0,0,1,1,"dummy"
"56284",2,5,2,9,"dummy"
"56288",0,2,0,2,"dummy"
"56289",0,1,0,1,"dummy"
"56290",0,0,1,1,"dummy"
"56291",0,0,1,1,"dummy"
"56292",6,0,0,6,"dummy"
"56293",8,4,3,15,"dummy"
"56294",0,2,0,2,"dummy"
"56295",4,0,0,4,"dummy"
"56296",0,3,0,3,"dummy"
"56299",0,0,0,0,"dummy"
"56300",0,2,0,2,"dummy"
"56301",0,0,2,2,"dummy"
"56302",0,0,2,2,"dummy"
"56332",2,2,0,4,"dummy"
"56333",0,0,1,1,"dummy"
"56335",8,3,5,16,"dummy"
"56336",0,1,0,1,"dummy"
"56337",6,8,5,19,"dummy"
"56341",4,9,1,14,"dummy"
"56342",1,1,3,5,"dummy"
"56343",0,0,1,1,"dummy"
"56348",0,0,1,1,"dummy"
"56352",1,0,0,1,"dummy"
"56356",0,0,1,1,"dummy"
"56358",8,2,1,11,"dummy"
"56361",3,4,1,8,"dummy"
"56362",0,1,0,1,"dummy"
"56365",1,5,0,6,"dummy"
"56366",0,3,3,6,"dummy"
"56367",0,0,1,1,"dummy"
"56368",1,1,2,4,"dummy"
"56369",2,0,0,2,"dummy"
"56370",0,1,0,1,"dummy"
"56371",0,3,0,3,"dummy"
"56372",0,0,0,0,"dummy"
"56373",0,0,1,1,"dummy"
"56374",3,0,0,3,"dummy"
"56375",0,0,1,1,"dummy"
"56376",0,0,1,1,"dummy"
"56377",0,1,0,1,"dummy"
"56378",0,1,0,1,"dummy"
"56379",8,5,0,13,"dummy"
"56383",5,6,3,14,"dummy"
"56384",0,2,0,2,"dummy"
"56387",0,3,0,3,"dummy"
"56388",0,4,0,4,"dummy"
"56389",2,0,1,3,"dummy"
"56390",0,1,0,1,"dummy"
"56391",1,1,1,3,"dummy"
"56392",0,5,1,6,"dummy"
"56395",1,10,1,12,"dummy"
"56396",0,0,1,1,"dummy"
"56397",0,0,0,0,"dummy"
"56398",0,1,2,3,"dummy"
"56399",0,1,1,2,"dummy"
"56400",1,0,1,2,"dummy"
"56401",0,1,1,2,"dummy"
"56402",0,0,1,1,"dummy"
"56403",0,5,2,7,"dummy"
"56405",5,15,3,23,"dummy"
"56406",0,1,1,2,"dummy"
"56407",6,13,0,19,"dummy"
"56408",0,3,1,4,"dummy"
"56409",0,0,1,1,"dummy"
"56410",1,5,0,6,"dummy"
"56411",1,9,1,11,"dummy"
"56412",4,14,1,19,"dummy"
"56413",2,0,2,4,"dummy"
"56414",4,2,1,7,"dummy"
"56415",0,0,1,1,"dummy"
"56416",0,0,1,1,"dummy"
"56417",0,0,1,1,"dummy"
"56418",0,0,1,1,"dummy"
"56419",0,0,1,1,"dummy"
"56420",0,0,1,1,"dummy"
"56421",0,6,1,7,"dummy"
"56422",5,2,2,9,"dummy"
"56423",1,0,0,1,"dummy"
"56424",0,1,0,1,"dummy"
"56425",1,1,0,2,"dummy"
"56426",4,0,1,5,"dummy"
"56427",0,0,1,1,"dummy"
"56428",0,0,1,1,"dummy"
"56429",0,0,1,1,"dummy"
"56430",0,0,1,1,"dummy"
"56431",0,0,1,1,"dummy"
"56432",0,0,1,1,"dummy"
"56433",0,0,1,1,"dummy"
"56434",0,0,2,2,"dummy"
"56435",0,0,1,1,"dummy"
"56436",0,0,1,1,"dummy"
"56437",0,0,1,1,"dummy"
"56441",7,16,1,24,"dummy"
"56442",0,0,2,2,"dummy"
"56443",0,1,2,3,"dummy"
"56444",0,0,1,1,"dummy"
"56445",0,0,2,2,"dummy"
"56446",0,0,1,1,"dummy"
"56447",0,0,2,2,"dummy"
"56448",0,0,1,1,"dummy"
"56449",0,0,1,1,"dummy"
"56450",0,0,1,1,"dummy"
"56451",0,0,1,1,"dummy"
"56469",0,3,0,3,"dummy"
"56470",0,0,1,1,"dummy"
"56474",0,0,1,1,"dummy"
"56475",1,3,2,6,"dummy"
"56476",1,0,1,2,"dummy"
"56477",2,0,2,4,"dummy"
"56478",0,0,1,1,"dummy"
"56479",0,0,1,1,"dummy"
"56480",0,0,1,1,"dummy"
"56481",0,0,1,1,"dummy"
"56482",0,0,1,1,"dummy"
"56483",0,0,0,0,"dummy"
"56484",0,0,1,1,"dummy"
"56489",0,4,4,8,"dummy"
"56494",0,1,0,1,"dummy"
"56495",0,6,0,6,"dummy"
"56496",0,3,0,3,"dummy"
"56497",0,10,0,10,"dummy"
"56498",0,1,0,1,"dummy"
"56499",11,2,1,14,"dummy"
"56500",2,10,2,14,"dummy"
"56501",0,0,1,1,"dummy"
"56502",10,2,3,15,"dummy"
"56503",0,0,2,2,"dummy"
"56587",0,2,0,2,"dummy"
"56588",0,1,0,1,"dummy"
"56589",1,2,0,3,"dummy"
"56590",0,0,1,1,"dummy"
"56591",0,0,1,1,"dummy"
"56592",0,2,0,2,"dummy"
"56593",0,0,1,1,"dummy"
"56594",0,0,1,1,"dummy"
"56595",0,0,1,1,"dummy"
"56598",0,0,1,1,"dummy"
"56599",0,4,0,4,"dummy"
"56600",0,3,0,3,"dummy"
"56601",0,1,0,1,"dummy"
"56602",0,1,0,1,"dummy"
"56603",0,1,0,1,"dummy"
"56604",0,1,0,1,"dummy"
"56605",0,0,3,3,"dummy"
"56610",2,10,1,13,"dummy"
"56611",2,2,0,4,"dummy"
"56639",0,1,1,2,"dummy"
"56642",0,2,0,2,"dummy"
"56671",1,1,0,2,"dummy"
"56672",3,1,1,5,"dummy"
"56673",0,3,0,3,"dummy"
"56674",0,2,0,2,"dummy"
"56675",1,0,0,1,"dummy"
"56678",1,0,0,1,"dummy"
"56679",0,2,0,2,"dummy"
"56682",0,0,1,1,"dummy"
"56683",0,0,1,1,"dummy"
"56699",2,1,2,5,"dummy"
"56700",1,2,1,4,"dummy"
"56453",0,0,0,0,"dummy"
"56454",0,6,0,6,"dummy"
"56455",3,2,1,6,"dummy"
"56456",1,0,0,1,"dummy"
"56457",0,0,1,1,"dummy"
"56458",0,5,0,5,"dummy"
"56459",0,2,0,2,"dummy"
"56460",0,2,3,5,"dummy"
"56461",0,3,0,3,"dummy"
"56462",0,0,0,0,"dummy"
"56463",0,1,2,3,"dummy"
"56464",2,12,1,15,"dummy"
"56465",0,0,1,1,"dummy"
"56466",6,0,0,6,"dummy"
"56467",5,1,2,8,"dummy"
"56472",24,7,5,36,"dummy"
"56491",3,2,0,5,"dummy"
"56492",0,0,1,1,"dummy"
"56505",0,0,2,2,"dummy"
"56506",0,1,0,1,"dummy"
"56511",0,0,1,1,"dummy"
"56512",24,26,4,54,"dummy"
"56513",4,4,1,9,"dummy"
"56514",9,6,2,17,"dummy"
"56515",3,1,1,5,"dummy"
"56516",0,1,0,1,"dummy"
"56517",0,0,1,1,"dummy"
"56518",9,8,0,17,"dummy"
"56519",0,0,0,0,"dummy"
"56520",2,2,0,4,"dummy"
"56521",0,0,1,1,"dummy"
"56522",0,0,2,2,"dummy"
"56523",3,0,0,3,"dummy"
"56524",0,0,1,1,"dummy"
"56525",0,0,1,1,"dummy"
"56526",0,0,1,1,"dummy"
"56527",0,0,1,1,"dummy"
"56528",0,0,1,1,"dummy"
"56529",0,0,1,1,"dummy"
"56530",8,8,1,17,"dummy"
"56574",9,9,5,23,"dummy"
"56585",0,0,1,1,"dummy"
"56613",0,0,4,4,"dummy"
"56614",2,0,0,2,"dummy"
"56615",0,1,0,1,"dummy"
"56616",0,1,0,1,"dummy"
"56617",1,2,0,3,"dummy"
"56618",1,0,0,1,"dummy"
"56619",0,0,1,1,"dummy"
"56620",2,2,0,4,"dummy"
"56623",0,0,4,4,"dummy"
"56624",2,0,0,2,"dummy"
"56625",0,0,1,1,"dummy"
"56626",0,0,1,1,"dummy"
"56627",0,0,1,1,"dummy"
"56628",1,0,0,1,"dummy"
"56629",2,0,0,2,"dummy"
"56630",0,10,0,10,"dummy"
"56631",2,2,0,4,"dummy"
"56632",0,2,0,2,"dummy"
"56633",1,5,0,6,"dummy"
"56634",0,4,0,4,"dummy"
"56635",2,1,0,3,"dummy"
"56646",1,2,3,6,"dummy"
"56647",0,1,2,3,"dummy"
"56648",10,14,9,33,"dummy"
"56649",0,0,0,0,"dummy"
"56650",29,3,0,32,"dummy"
"56651",1,2,0,3,"dummy"
"56652",1,3,0,4,"dummy"
"56658",5,7,0,12,"dummy"
"56659",2,3,2,7,"dummy"
"56660",0,0,1,1,"dummy"
"56661",0,0,1,1,"dummy"
"56662",0,0,1,1,"dummy"
"56663",0,1,0,1,"dummy"
"56664",0,0,2,2,"dummy"
"56665",0,0,1,1,"dummy"
"56666",8,3,3,14,"dummy"
"56667",0,0,1,1,"dummy"
"56685",0,0,0,0,"dummy"
"56688",0,2,0,2,"dummy"
"56689",0,2,0,2,"dummy"
"56690",0,2,0,2,"dummy"
"56691",1,4,1,6,"dummy"
"56692",2,1,0,3,"dummy"
"56693",0,8,0,8,"dummy"
"56694",8,0,0,8,"dummy"
"56695",0,0,1,1,"dummy"
"56696",0,0,1,1,"dummy"
"56697",0,1,0,1,"dummy"
"56710",0,1,0,1,"dummy"
"56711",0,7,0,7,"dummy"
"56712",0,1,0,1,"dummy"
"56713",1,1,0,2,"dummy"
"56714",5,0,0,5,"dummy"
"56715",0,1,0,1,"dummy"
"56718",0,0,1,1,"dummy"
"56719",0,0,1,1,"dummy"
"56774",0,0,1,1,"dummy"
"56784",0,1,0,1,"dummy"
"56785",0,4,1,5,"dummy"
"56813",7,3,0,10,"dummy"
"56814",1,2,1,4,"dummy"
"56815",0,0,1,1,"dummy"
"56816",1,0,1,2,"dummy"
"56817",0,0,1,1,"dummy"
"56844",0,0,1,1,"dummy"
"56879",0,3,0,3,"dummy"
"56885",0,0,3,3,"dummy"
"56894",0,0,2,2,"dummy"
"56895",4,2,1,7,"dummy"
"56896",1,15,3,19,"dummy"
"56897",1,1,0,2,"dummy"
"56898",0,0,0,0,"dummy"
"56899",15,0,2,17,"dummy"
"56900",0,1,0,1,"dummy"
"56901",0,7,2,9,"dummy"
"56902",0,0,1,1,"dummy"
"56903",0,0,1,1,"dummy"
"56904",0,0,1,1,"dummy"
"56910",0,3,0,3,"dummy"
"56911",0,2,0,2,"dummy"
"56916",0,0,3,3,"dummy"
"56917",0,0,5,5,"dummy"
"56918",20,6,4,30,"dummy"
"56919",0,20,0,20,"dummy"
"56920",3,14,3,20,"dummy"
"56921",8,35,0,43,"dummy"
"56922",0,0,1,1,"dummy"
"56923",2,2,0,4,"dummy"
"56926",34,23,8,65,"dummy"
"56927",0,2,0,2,"dummy"
"56928",1,0,0,1,"dummy"
"56929",0,1,0,1,"dummy"
"56967",2,0,0,2,"dummy"
"56971",1,10,0,11,"dummy"
"56974",2,2,1,5,"dummy"
"56975",0,0,1,1,"dummy"
"56984",0,2,1,3,"dummy"
"56985",0,4,0,4,"dummy"
"56988",0,7,1,8,"dummy"
"56991",0,4,0,4,"dummy"
"56992",0,2,0,2,"dummy"
"56993",1,1,0,2,"dummy"
"56994",0,0,1,1,"dummy"
"56995",2,0,1,3,"dummy"
"56996",4,2,1,7,"dummy"
"56997",28,8,1,37,"dummy"
"56998",1,1,1,3,"dummy"
"56999",7,1,3,11,"dummy"
"57000",0,1,0,1,"dummy"
"57001",46,6,1,53,"dummy"
"57002",1,1,0,2,"dummy"
"57003",3,4,0,7,"dummy"
"57004",1,3,0,4,"dummy"
"57007",0,1,1,2,"dummy"
"57008",1,4,0,5,"dummy"
"57009",0,1,2,3,"dummy"
"56701",3,0,2,5,"dummy"
"56704",0,0,1,1,"dummy"
"56707",0,0,2,2,"dummy"
"56725",2,0,0,2,"dummy"
"56726",0,0,0,0,"dummy"
"56776",0,2,0,2,"dummy"
"56787",4,13,3,20,"dummy"
"56788",0,1,0,1,"dummy"
"56789",0,1,0,1,"dummy"
"56790",5,4,3,12,"dummy"
"56791",0,0,4,4,"dummy"
"56792",2,0,2,4,"dummy"
"56793",0,0,1,1,"dummy"
"56794",0,0,3,3,"dummy"
"56795",3,3,0,6,"dummy"
"56796",1,3,6,10,"dummy"
"56797",0,1,0,1,"dummy"
"56798",0,1,0,1,"dummy"
"56799",0,0,0,0,"dummy"
"56800",0,0,0,0,"dummy"
"56801",6,0,1,7,"dummy"
"56802",2,0,0,2,"dummy"
"56803",0,2,0,2,"dummy"
"56804",2,0,0,2,"dummy"
"56805",0,0,0,0,"dummy"
"56819",4,4,2,10,"dummy"
"56820",0,1,0,1,"dummy"
"56821",0,0,0,0,"dummy"
"56822",0,0,1,1,"dummy"
"56823",1,1,0,2,"dummy"
"56824",1,2,0,3,"dummy"
"56825",0,0,1,1,"dummy"
"56826",0,0,0,0,"dummy"
"56827",0,0,0,0,"dummy"
"56828",0,0,0,0,"dummy"
"56829",0,1,0,1,"dummy"
"56830",0,1,0,1,"dummy"
"56831",0,0,1,1,"dummy"
"56834",2,4,0,6,"dummy"
"56835",0,2,0,2,"dummy"
"56836",0,2,0,2,"dummy"
"56837",10,2,0,12,"dummy"
"56838",0,2,0,2,"dummy"
"56839",0,0,0,0,"dummy"
"56840",0,0,3,3,"dummy"
"56841",0,5,0,5,"dummy"
"56842",1,0,1,2,"dummy"
"56846",7,17,3,27,"dummy"
"56847",8,9,2,19,"dummy"
"56848",1,0,0,1,"dummy"
"56849",0,1,0,1,"dummy"
"56850",0,3,1,4,"dummy"
"56851",1,0,0,1,"dummy"
"56852",0,0,0,0,"dummy"
"56853",0,0,0,0,"dummy"
"56854",0,2,0,2,"dummy"
"56855",3,3,0,6,"dummy"
"56856",4,3,2,9,"dummy"
"56857",0,1,0,1,"dummy"
"56858",1,0,0,1,"dummy"
"56870",0,24,0,24,"dummy"
"56871",0,1,0,1,"dummy"
"56872",0,0,1,1,"dummy"
"56873",0,0,1,1,"dummy"
"56874",0,0,0,0,"dummy"
"56875",0,0,0,0,"dummy"
"56876",0,0,1,1,"dummy"
"56877",0,0,1,1,"dummy"
"56883",0,0,0,0,"dummy"
"56889",0,0,1,1,"dummy"
"56890",0,0,1,1,"dummy"
"56891",0,0,0,0,"dummy"
"56892",0,0,1,1,"dummy"
"56906",0,8,4,12,"dummy"
"56933",0,0,1,1,"dummy"
"56934",0,0,1,1,"dummy"
"56935",0,0,2,2,"dummy"
"56936",0,0,1,1,"dummy"
"56937",0,0,0,0,"dummy"
"56938",0,2,0,2,"dummy"
"56939",0,3,0,3,"dummy"
"56940",2,0,0,2,"dummy"
"56941",0,0,1,1,"dummy"
"56942",0,6,0,6,"dummy"
"56943",6,2,0,8,"dummy"
"56944",0,6,0,6,"dummy"
"56945",0,1,0,1,"dummy"
"56946",0,3,0,3,"dummy"
"56947",0,2,0,2,"dummy"
"56948",0,0,1,1,"dummy"
"56949",0,0,1,1,"dummy"
"56950",0,1,0,1,"dummy"
"56951",1,1,0,2,"dummy"
"56952",1,4,0,5,"dummy"
"56953",1,1,0,2,"dummy"
"56954",6,0,0,6,"dummy"
"56955",2,2,0,4,"dummy"
"56956",0,2,0,2,"dummy"
"56957",0,0,0,0,"dummy"
"56958",0,0,2,2,"dummy"
"56959",12,2,0,14,"dummy"
"56960",2,0,0,2,"dummy"
"56961",0,0,0,0,"dummy"
"56962",6,0,0,6,"dummy"
"56963",0,0,0,0,"dummy"
"56964",0,0,0,0,"dummy"
"56965",1,0,0,1,"dummy"
"56977",5,5,1,11,"dummy"
"56980",0,0,1,1,"dummy"
"56981",5,8,2,15,"dummy"
"56982",0,1,0,1,"dummy"
"57011",0,1,0,1,"dummy"
"57018",0,0,1,1,"dummy"
"57042",0,3,0,3,"dummy"
"57043",0,1,0,1,"dummy"
"57044",0,2,0,2,"dummy"
"57045",3,3,0,6,"dummy"
"57046",1,3,0,4,"dummy"
"57047",3,1,0,4,"dummy"
"57048",0,1,0,1,"dummy"
"57049",4,0,1,5,"dummy"
"57050",0,1,2,3,"dummy"
"57051",1,5,0,6,"dummy"
"57052",0,4,1,5,"dummy"
"57053",0,1,0,1,"dummy"
"57054",0,1,0,1,"dummy"
"57055",0,1,0,1,"dummy"
"57056",0,1,0,1,"dummy"
"57057",3,2,2,7,"dummy"
"57063",1,0,0,1,"dummy"
"57075",0,0,1,1,"dummy"
"57090",1,3,0,4,"dummy"
"57091",0,1,0,1,"dummy"
"57092",0,1,0,1,"dummy"
"57093",1,3,5,9,"dummy"
"57094",0,1,0,1,"dummy"
"57095",0,1,0,1,"dummy"
"57107",1,3,0,4,"dummy"
"57108",1,3,0,4,"dummy"
"57109",2,3,0,5,"dummy"
"57126",1,3,2,6,"dummy"
"57127",3,1,0,4,"dummy"
"57128",0,0,3,3,"dummy"
"57024",0,1,0,1,"dummy"
"57027",1,1,0,2,"dummy"
"57028",0,0,1,1,"dummy"
"57029",0,1,0,1,"dummy"
"57030",0,0,1,1,"dummy"
"57031",0,2,0,2,"dummy"
"57032",0,0,2,2,"dummy"
"57033",0,1,0,1,"dummy"
"57036",0,0,0,0,"dummy"
"57061",0,0,1,1,"dummy"
"57065",0,2,0,2,"dummy"
"57066",9,1,1,11,"dummy"
"57067",0,0,0,0,"dummy"
"57068",0,2,1,3,"dummy"
"57069",0,10,0,10,"dummy"
"57070",1,0,0,1,"dummy"
"57071",9,9,0,18,"dummy"
"57072",3,8,0,11,"dummy"
"57073",0,0,0,0,"dummy"
"57077",0,1,0,1,"dummy"
"57078",0,0,1,1,"dummy"
"57079",0,0,1,1,"dummy"
"57080",0,0,1,1,"dummy"
"57081",0,1,0,1,"dummy"
"57084",0,0,0,0,"dummy"
"57099",0,2,4,6,"dummy"
"57100",0,0,0,0,"dummy"
"57101",0,1,0,1,"dummy"
"57102",1,0,0,1,"dummy"
"57103",0,1,0,1,"dummy"
"57104",0,1,0,1,"dummy"
"57105",1,0,0,1,"dummy"
"57111",0,2,0,2,"dummy"
"57114",1,6,3,10,"dummy"
"57115",0,2,1,3,"dummy"
"57118",0,0,1,1,"dummy"
"57119",2,7,1,10,"dummy"
"57120",2,1,1,4,"dummy"
"57121",1,2,0,3,"dummy"
"57124",12,0,1,13,"dummy"
"57160",0,1,0,1,"dummy"
"57163",0,0,1,1,"dummy"
"57164",0,0,1,1,"dummy"
"57165",0,0,1,1,"dummy"
"57166",0,0,1,1,"dummy"
"57167",0,0,1,1,"dummy"
"57168",0,0,1,1,"dummy"
"57169",0,1,0,1,"dummy"
"57170",0,0,1,1,"dummy"
"57175",0,1,0,1,"dummy"
"57182",0,1,0,1,"dummy"
"57192",2,2,0,4,"dummy"
"57193",0,1,0,1,"dummy"
"57194",1,0,0,1,"dummy"
"57195",2,0,0,2,"dummy"
"57196",0,0,1,1,"dummy"
"57215",0,2,0,2,"dummy"
"57129",0,2,0,2,"dummy"
"57130",0,0,2,2,"dummy"
"57135",0,0,1,1,"dummy"
"57138",0,1,2,3,"dummy"
"57139",0,0,0,0,"dummy"
"57140",0,1,0,1,"dummy"
"57141",4,0,2,6,"dummy"
"57142",1,0,0,1,"dummy"
"57143",0,0,0,0,"dummy"
"57152",0,1,0,1,"dummy"
"57153",0,4,1,5,"dummy"
"57154",1,1,1,3,"dummy"
"57157",6,1,5,12,"dummy"
"57158",0,1,0,1,"dummy"
"57177",0,2,0,2,"dummy"
"57178",0,0,1,1,"dummy"
"57184",2,3,1,6,"dummy"
"57185",0,1,0,1,"dummy"
"57186",0,0,0,0,"dummy"
"57189",0,0,0,0,"dummy"
"57190",0,0,0,0,"dummy"
"57217",0,2,0,2,"dummy"
"57221",0,0,2,2,"dummy"
"57225",8,2,3,13,"dummy"
"57228",0,1,1,2,"dummy"
"57229",0,1,0,1,"dummy"
"57230",0,0,1,1,"dummy"
"57231",0,0,1,1,"dummy"
"57232",0,0,1,1,"dummy"
"57236",1,2,0,3,"dummy"
"57237",0,3,0,3,"dummy"
"57242",1,1,0,2,"dummy"
"57244",0,0,0,0,"dummy"
"57245",0,0,0,0,"dummy"
"57249",0,0,1,1,"dummy"
"57250",4,4,0,8,"dummy"
"57252",2,0,0,2,"dummy"
"57254",0,0,1,1,"dummy"
"57258",0,0,1,1,"dummy"
"57261",0,4,0,4,"dummy"
"57262",1,7,0,8,"dummy"
"57263",0,1,0,1,"dummy"
"57264",0,0,1,1,"dummy"
"57265",0,1,0,1,"dummy"
"57266",2,0,1,3,"dummy"
"57267",1,0,0,1,"dummy"
"57268",0,1,0,1,"dummy"
"57269",0,1,0,1,"dummy"
"57270",0,1,0,1,"dummy"
"57271",0,0,1,1,"dummy"
"57272",2,1,0,3,"dummy"
"57274",0,1,0,1,"dummy"
"57276",0,3,0,3,"dummy"
"57277",0,1,0,1,"dummy"
"57280",0,1,0,1,"dummy"
"57281",0,2,0,2,"dummy"
"57282",0,2,0,2,"dummy"
"57283",0,0,1,1,"dummy"
"57284",0,0,1,1,"dummy"
"57285",0,0,2,2,"dummy"
"57286",0,0,1,1,"dummy"
"57287",0,0,1,1,"dummy"
"57289",0,0,1,1,"dummy"
"57290",0,0,1,1,"dummy"
"57293",1,2,1,4,"dummy"
"57296",0,12,4,16,"dummy"
"57297",1,15,1,17,"dummy"
"57300",2,1,0,3,"dummy"
"57302",0,1,0,1,"dummy"
"57304",0,0,1,1,"dummy"
"57305",8,0,1,9,"dummy"
"57307",0,1,0,1,"dummy"
"57309",0,1,0,1,"dummy"
"57310",0,0,1,1,"dummy"
"57315",0,0,1,1,"dummy"
"57317",0,1,1,2,"dummy"
"57320",2,3,4,9,"dummy"
"57321",3,1,0,4,"dummy"
"57322",0,2,2,4,"dummy"
"57330",3,6,0,9,"dummy"
"57331",0,4,0,4,"dummy"
"57333",1,1,0,2,"dummy"
"57334",0,1,0,1,"dummy"
"57362",0,0,1,1,"dummy"
"57363",0,0,1,1,"dummy"
"57364",0,0,1,1,"dummy"
"57365",0,0,1,1,"dummy"
"57366",0,0,1,1,"dummy"
"57367",0,0,1,1,"dummy"
"57370",0,0,1,1,"dummy"
"57371",0,2,1,3,"dummy"
"57379",0,0,1,1,"dummy"
"57380",1,4,0,5,"dummy"
"57381",1,1,0,2,"dummy"
"57382",0,0,1,1,"dummy"
"57383",7,3,0,10,"dummy"
"57384",0,0,1,1,"dummy"
"57385",0,0,1,1,"dummy"
"57386",4,4,0,8,"dummy"
"57389",0,0,1,1,"dummy"
"57390",0,0,1,1,"dummy"
"57391",0,0,1,1,"dummy"
"57393",0,2,0,2,"dummy"
"57394",3,3,0,6,"dummy"
"57397",2,2,0,4,"dummy"
"57398",0,1,1,2,"dummy"
"57399",0,1,1,2,"dummy"
"57400",0,1,0,1,"dummy"
"57401",0,0,2,2,"dummy"
"57402",0,4,1,5,"dummy"
"57403",0,0,1,1,"dummy"
"57404",1,0,0,1,"dummy"
"57405",0,1,0,1,"dummy"
"57407",0,1,0,1,"dummy"
"57408",1,2,0,3,"dummy"
"57409",0,4,2,6,"dummy"
"57412",0,0,1,1,"dummy"
"57414",1,4,2,7,"dummy"
"57415",0,1,0,1,"dummy"
"57416",0,0,0,0,"dummy"
"57417",1,0,1,2,"dummy"
"57418",0,1,1,2,"dummy"
"57419",2,2,0,4,"dummy"
"57420",0,0,1,1,"dummy"
"57421",0,0,1,1,"dummy"
"57422",0,1,0,1,"dummy"
"57423",21,16,2,39,"dummy"
"57425",0,2,0,2,"dummy"
"57427",1,7,0,8,"dummy"
"57428",1,5,0,6,"dummy"
"57429",0,2,0,2,"dummy"
"57430",1,0,0,1,"dummy"
"57431",0,1,1,2,"dummy"
"57432",0,2,1,3,"dummy"
"57465",0,0,1,1,"dummy"
"57469",1,2,1,4,"dummy"
"57470",0,0,1,1,"dummy"
"57476",0,1,0,1,"dummy"
"57477",0,0,1,1,"dummy"
"57478",0,1,0,1,"dummy"
"57479",0,0,0,0,"dummy"
"57480",2,4,0,6,"dummy"
"57481",0,1,1,2,"dummy"
"57482",0,1,0,1,"dummy"
"57483",14,1,1,16,"dummy"
"57484",0,6,0,6,"dummy"
"57485",1,1,4,6,"dummy"
"57486",0,0,2,2,"dummy"
"57487",0,2,0,2,"dummy"
"57488",0,1,3,4,"dummy"
"57489",0,2,3,5,"dummy"
"57490",4,2,2,8,"dummy"
"57491",0,3,0,3,"dummy"
"57492",2,0,1,3,"dummy"
"57493",0,0,2,2,"dummy"
"57494",0,0,0,0,"dummy"
"57495",0,0,1,1,"dummy"
"57496",0,1,0,1,"dummy"
"57497",0,2,0,2,"dummy"
"57498",0,1,2,3,"dummy"
"57499",0,0,1,1,"dummy"
"57500",0,0,1,1,"dummy"
"57501",0,1,1,2,"dummy"
"57502",3,0,0,3,"dummy"
"57504",0,1,0,1,"dummy"
"57506",1,1,1,3,"dummy"
"57508",0,0,2,2,"dummy"
"57509",0,0,2,2,"dummy"
"57510",0,0,2,2,"dummy"
"57511",0,0,3,3,"dummy"
"57512",0,0,1,1,"dummy"
"57513",4,3,1,8,"dummy"
"57514",1,2,3,6,"dummy"
"57515",0,0,1,1,"dummy"
"57516",0,0,3,3,"dummy"
"57517",0,0,3,3,"dummy"
"57518",0,0,3,3,"dummy"
"57519",0,0,3,3,"dummy"
"57520",0,0,2,2,"dummy"
"57523",0,1,0,1,"dummy"
"57524",1,1,0,2,"dummy"
"57526",0,1,0,1,"dummy"
"57527",0,0,1,1,"dummy"
"57534",2,1,1,4,"dummy"
"57535",0,0,1,1,"dummy"
"57536",2,2,0,4,"dummy"
"57537",7,9,1,17,"dummy"
"57550",0,0,1,1,"dummy"
"57552",0,0,3,3,"dummy"
"57558",0,4,0,4,"dummy"
"57559",0,0,0,0,"dummy"
"57560",2,5,0,7,"dummy"
"57561",1,2,0,3,"dummy"
"57562",2,4,1,7,"dummy"
"57563",0,8,0,8,"dummy"
"57564",0,0,0,0,"dummy"
"57565",0,2,0,2,"dummy"
"57566",6,3,3,12,"dummy"
"57567",3,1,0,4,"dummy"
"57568",2,0,1,3,"dummy"
"57569",2,4,0,6,"dummy"
"57572",0,3,0,3,"dummy"
"57573",0,0,0,0,"dummy"
"57574",0,1,0,1,"dummy"
"57577",0,4,1,5,"dummy"
"57587",0,1,0,1,"dummy"
"57588",0,0,1,1,"dummy"
"57589",5,1,1,7,"dummy"
"57593",0,2,2,4,"dummy"
"57595",17,0,3,20,"dummy"
"57601",0,19,0,19,"dummy"
"57602",0,7,0,7,"dummy"
"57603",0,0,2,2,"dummy"
"57604",0,0,2,2,"dummy"
"57605",4,0,0,4,"dummy"
"57607",4,5,1,10,"dummy"
"57608",4,3,2,9,"dummy"
"57609",0,0,1,1,"dummy"
"57610",1,3,2,6,"dummy"
"57611",0,0,1,1,"dummy"
"57612",0,1,0,1,"dummy"
"57613",1,1,0,2,"dummy"
"57614",1,0,0,1,"dummy"
"57615",2,0,0,2,"dummy"
"57616",0,1,0,1,"dummy"
"57617",0,0,1,1,"dummy"
"57619",0,0,0,0,"dummy"
"57620",0,0,0,0,"dummy"
"57621",0,0,0,0,"dummy"
"57622",0,0,0,0,"dummy"
"57624",0,0,1,1,"dummy"
"57634",0,1,0,1,"dummy"
"57636",0,0,1,1,"dummy"
"57647",0,0,0,0,"dummy"
"57648",0,0,0,0,"dummy"
"57649",0,0,1,1,"dummy"
"57650",3,3,1,7,"dummy"
"57651",0,0,0,0,"dummy"
"57654",0,5,0,5,"dummy"
"57655",0,1,0,1,"dummy"
"57656",0,1,0,1,"dummy"
"57659",2,0,0,2,"dummy"
"57661",0,0,1,1,"dummy"
"57662",0,0,1,1,"dummy"
"57663",0,0,1,1,"dummy"
"57664",0,2,0,2,"dummy"
"57666",0,2,0,2,"dummy"
"57667",2,2,2,6,"dummy"
"57674",1,1,0,2,"dummy"
"57679",0,0,1,1,"dummy"
"57680",0,0,1,1,"dummy"
"57681",0,0,1,1,"dummy"
"57682",2,1,0,3,"dummy"
"57683",0,0,1,1,"dummy"
"57689",0,3,0,3,"dummy"
"57690",0,0,1,1,"dummy"
"57692",2,0,2,4,"dummy"
"57695",0,0,2,2,"dummy"
"57696",0,2,0,2,"dummy"
"57697",9,9,1,19,"dummy"
"57698",0,0,4,4,"dummy"
"57699",1,2,1,4,"dummy"
"57704",0,0,2,2,"dummy"
"57705",1,0,0,1,"dummy"
"57719",0,2,0,2,"dummy"
"57720",2,0,0,2,"dummy"
"57721",0,3,0,3,"dummy"
"57722",0,1,0,1,"dummy"
"57723",0,1,0,1,"dummy"
"57746",3,2,3,8,"dummy"
"57757",0,4,1,5,"dummy"
"57775",0,0,0,0,"dummy"
"57776",0,0,0,0,"dummy"
"57781",0,1,0,1,"dummy"
"57782",0,0,0,0,"dummy"
"57783",0,2,0,2,"dummy"
"57784",0,0,1,1,"dummy"
"57785",1,0,0,1,"dummy"
"57791",3,1,1,5,"dummy"
"57812",6,5,0,11,"dummy"
"57813",0,0,1,1,"dummy"
"57820",0,0,0,0,"dummy"
"57821",0,0,0,0,"dummy"
"57822",0,0,0,0,"dummy"
"57823",0,0,0,0,"dummy"
"57824",0,0,0,0,"dummy"
"57707",6,0,0,6,"dummy"
"57708",2,5,2,9,"dummy"
"57714",0,1,0,1,"dummy"
"57715",0,0,0,0,"dummy"
"57716",2,2,0,4,"dummy"
"57717",0,0,1,1,"dummy"
"57725",0,0,2,2,"dummy"
"57728",0,0,2,2,"dummy"
"57729",0,1,1,2,"dummy"
"57730",0,0,1,1,"dummy"
"57731",0,1,0,1,"dummy"
"57732",0,0,1,1,"dummy"
"57733",0,0,1,1,"dummy"
"57734",0,0,1,1,"dummy"
"57735",0,0,1,1,"dummy"
"57748",0,0,0,0,"dummy"
"57749",0,0,0,0,"dummy"
"57750",0,0,0,0,"dummy"
"57751",0,0,0,0,"dummy"
"57759",1,0,4,5,"dummy"
"57760",0,0,1,1,"dummy"
"57761",0,1,3,4,"dummy"
"57762",0,0,1,1,"dummy"
"57763",0,0,1,1,"dummy"
"57764",0,0,2,2,"dummy"
"57765",0,0,3,3,"dummy"
"57766",0,1,1,2,"dummy"
"57767",66,7,2,75,"dummy"
"57770",2,3,0,5,"dummy"
"57771",1,0,3,4,"dummy"
"57772",0,2,0,2,"dummy"
"57773",0,0,0,0,"dummy"
"57789",0,0,2,2,"dummy"
"57815",0,0,0,0,"dummy"
"57816",0,0,0,0,"dummy"
"57817",0,0,0,0,"dummy"
"57818",0,0,0,0,"dummy"
"57826",13,6,5,24,"dummy"
"57827",0,1,0,1,"dummy"
"57828",0,1,0,1,"dummy"
"57829",0,1,0,1,"dummy"
"57830",1,1,0,2,"dummy"
"57831",1,1,0,2,"dummy"
"57832",0,1,0,1,"dummy"
"57833",2,6,3,11,"dummy"
"57834",0,0,1,1,"dummy"
"57835",1,0,2,3,"dummy"
"57836",1,0,0,1,"dummy"
"57837",0,0,1,1,"dummy"
"57838",0,2,0,2,"dummy"
"57839",1,0,1,2,"dummy"
"57840",0,0,1,1,"dummy"
"57841",1,0,0,1,"dummy"
"57842",0,0,1,1,"dummy"
"57843",1,0,0,1,"dummy"
"57844",1,0,0,1,"dummy"
"57845",2,5,0,7,"dummy"
"57846",0,0,1,1,"dummy"
"57847",0,0,1,1,"dummy"
"57848",0,0,1,1,"dummy"
"57849",0,0,1,1,"dummy"
"57852",0,1,0,1,"dummy"
"57853",0,0,0,0,"dummy"
"57854",0,1,0,1,"dummy"
"57855",0,1,0,1,"dummy"
"57856",0,0,1,1,"dummy"
"57857",1,0,0,1,"dummy"
"57858",0,2,0,2,"dummy"
"57859",0,1,0,1,"dummy"
"57860",2,0,0,2,"dummy"
"57861",0,0,1,1,"dummy"
"57862",0,0,1,1,"dummy"
"57863",0,0,1,1,"dummy"
"57864",0,0,1,1,"dummy"
"57865",0,0,1,1,"dummy"
"57866",0,0,1,1,"dummy"
"57867",0,0,1,1,"dummy"
"57868",0,0,1,1,"dummy"
"57869",0,1,0,1,"dummy"
"57870",0,1,0,1,"dummy"
"57871",0,1,0,1,"dummy"
"57872",0,0,1,1,"dummy"
"57873",0,4,0,4,"dummy"
"57874",4,0,0,4,"dummy"
"57875",0,0,1,1,"dummy"
"57876",0,0,1,1,"dummy"
"57878",0,0,1,1,"dummy"
"57879",0,0,0,0,"dummy"
"57880",1,1,0,2,"dummy"
"57881",0,5,0,5,"dummy"
"57882",1,2,7,10,"dummy"
"57883",1,0,1,2,"dummy"
"57884",0,3,0,3,"dummy"
"57885",0,1,1,2,"dummy"
"57886",7,8,0,15,"dummy"
"58024",4,0,0,4,"dummy"
"58025",1,2,0,3,"dummy"
"58026",0,0,2,2,"dummy"
"58027",0,1,0,1,"dummy"
"58030",0,0,1,1,"dummy"
"58031",0,6,0,6,"dummy"
"58032",0,2,0,2,"dummy"
"58047",10,3,4,17,"dummy"
"58048",3,2,1,6,"dummy"
"58049",0,0,1,1,"dummy"
"58050",0,0,1,1,"dummy"
"58051",3,2,0,5,"dummy"
"58052",0,1,0,1,"dummy"
"58053",0,2,0,2,"dummy"
"58056",0,0,1,1,"dummy"
"58076",4,6,1,11,"dummy"
"58077",1,0,0,1,"dummy"
"58078",2,4,0,6,"dummy"
"58079",3,0,0,3,"dummy"
"58080",0,0,0,0,"dummy"
"58081",0,2,0,2,"dummy"
"58082",2,5,0,7,"dummy"
"58083",0,0,0,0,"dummy"
"58088",1,2,0,3,"dummy"
"58094",8,0,4,12,"dummy"
"58099",0,0,2,2,"dummy"
"58118",0,0,1,1,"dummy"
"58122",0,0,0,0,"dummy"
"58125",0,0,0,0,"dummy"
"58143",0,0,1,1,"dummy"
"58165",2,1,1,4,"dummy"
"58183",5,2,1,8,"dummy"
"58184",0,2,0,2,"dummy"
"58196",0,0,1,1,"dummy"
"58199",0,1,0,1,"dummy"
"58200",0,0,1,1,"dummy"
"58208",0,1,0,1,"dummy"
"58209",4,5,0,9,"dummy"
"58214",2,4,0,6,"dummy"
"58215",0,2,0,2,"dummy"
"58216",0,2,0,2,"dummy"
"58217",10,2,0,12,"dummy"
"58218",0,2,0,2,"dummy"
"58221",4,3,2,9,"dummy"
"58222",0,0,0,0,"dummy"
"57888",0,0,2,2,"dummy"
"57889",4,2,1,7,"dummy"
"57890",1,15,3,19,"dummy"
"57891",1,1,0,2,"dummy"
"57892",0,0,0,0,"dummy"
"57893",15,0,2,17,"dummy"
"57894",0,1,0,1,"dummy"
"57895",0,7,2,9,"dummy"
"57896",0,0,1,1,"dummy"
"57897",0,0,1,1,"dummy"
"57898",0,0,1,1,"dummy"
"58036",0,0,1,1,"dummy"
"58037",0,0,2,2,"dummy"
"58041",3,3,2,8,"dummy"
"58058",33,10,2,45,"dummy"
"58059",3,1,1,5,"dummy"
"58060",11,21,4,36,"dummy"
"58061",0,2,0,2,"dummy"
"58065",0,0,3,3,"dummy"
"58066",0,6,0,6,"dummy"
"58067",5,1,0,6,"dummy"
"58068",4,0,0,4,"dummy"
"58071",4,12,2,18,"dummy"
"58072",0,0,1,1,"dummy"
"58073",12,5,0,17,"dummy"
"58074",0,0,0,0,"dummy"
"58090",6,6,0,12,"dummy"
"58091",0,0,0,0,"dummy"
"58092",0,1,0,1,"dummy"
"58109",0,0,1,1,"dummy"
"58112",0,0,1,1,"dummy"
"58113",0,0,1,1,"dummy"
"58114",0,0,2,2,"dummy"
"58115",0,0,1,1,"dummy"
"58116",0,0,1,1,"dummy"
"58120",0,1,4,5,"dummy"
"58127",0,4,0,4,"dummy"
"58130",0,1,0,1,"dummy"
"58131",0,1,0,1,"dummy"
"58132",0,0,1,1,"dummy"
"58133",0,2,0,2,"dummy"
"58134",0,2,0,2,"dummy"
"58140",2,1,0,3,"dummy"
"58141",1,0,0,1,"dummy"
"58149",5,1,1,7,"dummy"
"58158",0,1,0,1,"dummy"
"58159",0,2,0,2,"dummy"
"58162",0,1,0,1,"dummy"
"58163",0,4,0,4,"dummy"
"58167",0,1,0,1,"dummy"
"58170",4,17,0,21,"dummy"
"58171",0,4,1,5,"dummy"
"58172",5,9,1,15,"dummy"
"58173",5,18,3,26,"dummy"
"58202",0,0,1,1,"dummy"
"58203",0,0,0,0,"dummy"
"58204",0,1,0,1,"dummy"
"58205",0,0,1,1,"dummy"
"58206",0,0,0,0,"dummy"
"58223",0,0,0,0,"dummy"
"58224",3,14,0,17,"dummy"
"58225",3,0,0,3,"dummy"
"58226",0,0,1,1,"dummy"
"58227",0,0,3,3,"dummy"
"58228",0,1,0,1,"dummy"
"58229",0,0,3,3,"dummy"
"58230",0,0,1,1,"dummy"
"58231",0,1,0,1,"dummy"
"58232",0,0,1,1,"dummy"
"58255",0,1,0,1,"dummy"
"58256",0,1,1,2,"dummy"
"58257",2,1,0,3,"dummy"
"58258",1,8,0,9,"dummy"
"58259",0,1,0,1,"dummy"
"58260",1,1,1,3,"dummy"
"58261",2,4,0,6,"dummy"
"58262",2,2,1,5,"dummy"
"58263",0,1,0,1,"dummy"
"58264",3,5,2,10,"dummy"
"58265",3,8,0,11,"dummy"
"58266",12,4,4,20,"dummy"
"58283",2,13,1,16,"dummy"
"58284",10,13,1,24,"dummy"
"58285",0,5,0,5,"dummy"
"58286",0,2,0,2,"dummy"
"58300",0,7,2,9,"dummy"
"58301",0,0,1,1,"dummy"
"58330",4,1,0,5,"dummy"
"58331",1,0,0,1,"dummy"
"58332",0,0,0,0,"dummy"
"58333",0,0,0,0,"dummy"
"58350",0,0,0,0,"dummy"
"58351",5,0,2,7,"dummy"
"58352",0,0,0,0,"dummy"
"58358",0,0,0,0,"dummy"
"58361",0,0,1,1,"dummy"
"58362",0,1,0,1,"dummy"
"58363",1,3,0,4,"dummy"
"58364",0,0,1,1,"dummy"
"58365",3,2,1,6,"dummy"
"58366",2,1,0,3,"dummy"
"58367",0,3,0,3,"dummy"
"58368",0,2,0,2,"dummy"
"58369",0,0,1,1,"dummy"
"58370",0,1,0,1,"dummy"
"58371",0,1,0,1,"dummy"
"58372",0,1,0,1,"dummy"
"58373",0,1,0,1,"dummy"
"58374",0,1,0,1,"dummy"
"58375",0,4,0,4,"dummy"
"58376",0,8,0,8,"dummy"
"58381",4,16,0,20,"dummy"
"58405",0,3,1,4,"dummy"
"58406",0,1,0,1,"dummy"
"58410",5,25,0,30,"dummy"
"58411",0,0,0,0,"dummy"
"58412",2,2,1,5,"dummy"
"58413",3,3,1,7,"dummy"
"58414",23,44,4,71,"dummy"
"58415",1,6,0,7,"dummy"
"58416",0,0,1,1,"dummy"
"58417",0,1,0,1,"dummy"
"58418",2,3,3,8,"dummy"
"58419",47,2,0,49,"dummy"
"58290",0,0,1,1,"dummy"
"58294",0,2,0,2,"dummy"
"58303",1,2,0,3,"dummy"
"58304",0,0,0,0,"dummy"
"58305",0,1,0,1,"dummy"
"58306",0,1,0,1,"dummy"
"58307",10,0,0,10,"dummy"
"58308",1,0,0,1,"dummy"
"58311",0,0,2,2,"dummy"
"58356",0,0,0,0,"dummy"
"58385",1,6,1,8,"dummy"
"58386",11,20,5,36,"dummy"
"58387",0,0,1,1,"dummy"
"58388",1,0,1,2,"dummy"
"58389",19,9,1,29,"dummy"
"58390",0,5,0,5,"dummy"
"58391",0,5,0,5,"dummy"
"58392",2,1,1,4,"dummy"
"58393",1,0,2,3,"dummy"
"58394",0,1,0,1,"dummy"
"58395",0,1,2,3,"dummy"
"58396",2,0,0,2,"dummy"
"58397",0,1,0,1,"dummy"
"58398",1,1,0,2,"dummy"
"58399",1,1,0,2,"dummy"
"58400",16,25,7,48,"dummy"
"58403",0,0,1,1,"dummy"
"58408",0,4,0,4,"dummy"
"58430",0,1,0,1,"dummy"
"58431",0,0,2,2,"dummy"
"58432",0,2,1,3,"dummy"
"58433",0,1,3,4,"dummy"
"58434",0,2,0,2,"dummy"
"58435",8,13,4,25,"dummy"
"58436",1,1,0,2,"dummy"
"58437",10,25,3,38,"dummy"
"58438",9,14,3,26,"dummy"
"58439",2,9,0,11,"dummy"
"58442",4,0,0,4,"dummy"
"58443",0,1,0,1,"dummy"
"58444",1,1,1,3,"dummy"
"58445",0,0,1,1,"dummy"
"58516",0,0,0,0,"dummy"
"58517",0,0,1,1,"dummy"
"58518",0,0,0,0,"dummy"
"58519",0,0,0,0,"dummy"
"58520",0,0,0,0,"dummy"
"58521",4,1,0,5,"dummy"
"58522",0,1,0,1,"dummy"
"58523",0,0,0,0,"dummy"
"58524",1,0,0,1,"dummy"
"58525",17,19,3,39,"dummy"
"58526",3,0,0,3,"dummy"
"58527",10,18,1,29,"dummy"
"58528",1,2,0,3,"dummy"
"58581",0,2,0,2,"dummy"
"58420",1,0,0,1,"dummy"
"58421",3,5,0,8,"dummy"
"58422",0,14,3,17,"dummy"
"58423",0,1,0,1,"dummy"
"58424",5,0,0,5,"dummy"
"58425",0,6,3,9,"dummy"
"58426",0,1,0,1,"dummy"
"58427",0,2,0,2,"dummy"
"58428",2,2,4,8,"dummy"
"58447",0,1,0,1,"dummy"
"58448",2,3,0,5,"dummy"
"58451",0,0,1,1,"dummy"
"58452",1,0,0,1,"dummy"
"58453",0,0,0,0,"dummy"
"58454",3,7,0,10,"dummy"
"58455",0,1,0,1,"dummy"
"58502",1,0,1,2,"dummy"
"58503",0,0,2,2,"dummy"
"58504",0,1,0,1,"dummy"
"58507",3,5,4,12,"dummy"
"58508",0,1,0,1,"dummy"
"58509",0,0,1,1,"dummy"
"58510",7,5,1,13,"dummy"
"58511",6,2,0,8,"dummy"
"58512",0,0,1,1,"dummy"
"58513",1,0,0,1,"dummy"
"58514",1,0,0,1,"dummy"
"58530",0,0,1,1,"dummy"
"58531",0,0,1,1,"dummy"
"58532",0,0,1,1,"dummy"
"58535",2,3,1,6,"dummy"
"58536",6,0,0,6,"dummy"
"58537",4,11,1,16,"dummy"
"58538",17,15,3,35,"dummy"
"58539",15,17,3,35,"dummy"
"58540",0,1,0,1,"dummy"
"58541",0,1,0,1,"dummy"
"58542",0,0,0,0,"dummy"
"58543",1,0,0,1,"dummy"
"58544",3,0,0,3,"dummy"
"58545",0,0,1,1,"dummy"
"58546",0,0,1,1,"dummy"
"58547",6,0,0,6,"dummy"
"58548",1,0,0,1,"dummy"
"58549",0,9,0,9,"dummy"
"58550",0,1,0,1,"dummy"
"58551",0,1,0,1,"dummy"
"58552",4,6,2,12,"dummy"
"58553",0,3,0,3,"dummy"
"58554",1,1,0,2,"dummy"
"58555",4,1,0,5,"dummy"
"58556",5,0,1,6,"dummy"
"58557",0,1,1,2,"dummy"
"58558",0,2,0,2,"dummy"
"58559",2,4,0,6,"dummy"
"58560",0,2,1,3,"dummy"
"58561",3,3,0,6,"dummy"
"58562",0,1,0,1,"dummy"
"58563",1,0,0,1,"dummy"
"58564",16,5,3,24,"dummy"
"58565",0,1,0,1,"dummy"
"58566",0,1,0,1,"dummy"
"58567",1,0,0,1,"dummy"
"58568",4,0,0,4,"dummy"
"58569",6,6,0,12,"dummy"
"58570",0,0,0,0,"dummy"
"58571",0,1,0,1,"dummy"
"58572",0,0,1,1,"dummy"
"58573",0,1,0,1,"dummy"
"58576",0,0,1,1,"dummy"
"58577",0,35,0,35,"dummy"
"58578",4,4,0,8,"dummy"
"58579",0,0,0,0,"dummy"
"58583",0,2,2,4,"dummy"
"58584",0,2,1,3,"dummy"
"58619",0,1,0,1,"dummy"
"58620",0,0,2,2,"dummy"
"58621",3,1,0,4,"dummy"
"58622",0,1,0,1,"dummy"
"58623",1,2,0,3,"dummy"
"58624",1,1,1,3,"dummy"
"58625",1,0,0,1,"dummy"
"58626",0,2,0,2,"dummy"
"58719",0,8,2,10,"dummy"
"58720",0,1,0,1,"dummy"
"58723",0,1,0,1,"dummy"
"58724",1,3,0,4,"dummy"
"58725",0,1,0,1,"dummy"
"58727",8,5,10,23,"dummy"
"58728",3,0,0,3,"dummy"
"58729",3,0,0,3,"dummy"
"58730",16,0,2,18,"dummy"
"58737",1,1,0,2,"dummy"
"58738",1,0,1,2,"dummy"
"58740",0,0,1,1,"dummy"
"58743",6,0,0,6,"dummy"
"58744",2,5,2,9,"dummy"
"58751",0,1,0,1,"dummy"
"58752",0,1,0,1,"dummy"
"58754",0,1,0,1,"dummy"
"58755",0,3,0,3,"dummy"
"58756",0,1,1,2,"dummy"
"58757",0,1,0,1,"dummy"
"58758",0,1,0,1,"dummy"
"58759",0,1,0,1,"dummy"
"58760",2,3,4,9,"dummy"
"58762",0,0,0,0,"dummy"
"58763",0,1,0,1,"dummy"
"58768",0,16,0,16,"dummy"
"58773",1,2,0,3,"dummy"
"58777",1,0,1,2,"dummy"
"58818",0,7,5,12,"dummy"
"58819",0,1,0,1,"dummy"
"58820",1,1,0,2,"dummy"
"58822",0,3,0,3,"dummy"
"58823",0,17,2,19,"dummy"
"58824",0,1,0,1,"dummy"
"58825",6,9,0,15,"dummy"
"58826",1,2,0,3,"dummy"
"58827",0,2,0,2,"dummy"
"58828",0,0,1,1,"dummy"
"58829",0,0,1,1,"dummy"
"58830",0,0,1,1,"dummy"
"58831",0,1,0,1,"dummy"
"58832",0,1,0,1,"dummy"
"58833",0,0,2,2,"dummy"
"58836",0,0,1,1,"dummy"
"58840",0,0,0,0,"dummy"
"58841",0,0,1,1,"dummy"
"58842",0,2,1,3,"dummy"
"58844",0,1,0,1,"dummy"
"58845",0,2,0,2,"dummy"
"58846",0,1,0,1,"dummy"
"58847",0,0,0,0,"dummy"
"58848",0,0,0,0,"dummy"
"58849",0,0,0,0,"dummy"
"58850",0,0,0,0,"dummy"
"58851",1,1,1,3,"dummy"
"58852",0,0,0,0,"dummy"
"58853",7,0,4,11,"dummy"
"58854",0,0,0,0,"dummy"
"58855",1,0,0,1,"dummy"
"58856",0,0,0,0,"dummy"
"58857",0,0,1,1,"dummy"
"58858",0,0,1,1,"dummy"
"58859",5,6,2,13,"dummy"
"58860",2,2,0,4,"dummy"
"58861",2,2,0,4,"dummy"
"58862",0,0,0,0,"dummy"
"58863",0,0,1,1,"dummy"
"58864",0,1,0,1,"dummy"
"58865",0,0,0,0,"dummy"
"58866",0,0,1,1,"dummy"
"58867",0,0,0,0,"dummy"
"58868",0,1,0,1,"dummy"
"58869",0,0,1,1,"dummy"
"58870",1,7,0,8,"dummy"
"58871",0,0,0,0,"dummy"
"58872",0,0,0,0,"dummy"
"58873",0,2,0,2,"dummy"
"58874",0,2,0,2,"dummy"
"58875",0,3,1,4,"dummy"
"58876",0,1,0,1,"dummy"
"58877",0,0,0,0,"dummy"
"58878",0,1,0,1,"dummy"
"58879",0,0,1,1,"dummy"
"58880",0,0,0,0,"dummy"
"58881",0,0,1,1,"dummy"
"58882",0,1,0,1,"dummy"
"58883",0,3,0,3,"dummy"
"58884",0,1,0,1,"dummy"
"58885",0,0,0,0,"dummy"
"58886",0,0,0,0,"dummy"
"58887",0,0,0,0,"dummy"
"58888",0,0,1,1,"dummy"
"58889",1,0,0,1,"dummy"
"58890",3,0,0,3,"dummy"
"58891",0,0,1,1,"dummy"
"58892",1,2,0,3,"dummy"
"58893",0,0,0,0,"dummy"
"58894",0,0,1,1,"dummy"
"58895",0,0,1,1,"dummy"
"58896",0,0,0,0,"dummy"
"58897",0,0,1,1,"dummy"
"58898",0,0,1,1,"dummy"
"58899",0,3,0,3,"dummy"
"58900",0,0,1,1,"dummy"
"58901",0,0,1,1,"dummy"
"58902",0,0,1,1,"dummy"
"58903",0,0,0,0,"dummy"
"58904",0,0,0,0,"dummy"
"58905",0,5,0,5,"dummy"
"58906",0,0,1,1,"dummy"
"58907",5,0,0,5,"dummy"
"58908",0,0,1,1,"dummy"
"58909",0,0,1,1,"dummy"
"58910",0,0,1,1,"dummy"
"58911",0,0,1,1,"dummy"
"58912",0,0,1,1,"dummy"
"58913",0,0,1,1,"dummy"
"58914",0,0,1,1,"dummy"
"58915",0,0,1,1,"dummy"
"58916",0,0,1,1,"dummy"
"58917",0,2,0,2,"dummy"
"58918",0,0,1,1,"dummy"
"58919",0,0,1,1,"dummy"
"58921",1,0,0,1,"dummy"
"58922",0,1,0,1,"dummy"
"58923",0,0,1,1,"dummy"
"58924",1,0,1,2,"dummy"
"58925",0,1,1,2,"dummy"
"58926",0,0,1,1,"dummy"
"58927",0,0,1,1,"dummy"
"58928",0,4,0,4,"dummy"
"58929",1,2,0,3,"dummy"
"58930",0,0,1,1,"dummy"
"58931",0,18,1,19,"dummy"
"58932",0,1,0,1,"dummy"
"58933",0,1,1,2,"dummy"
"58934",0,1,0,1,"dummy"
"58935",2,2,1,5,"dummy"
"58936",0,1,0,1,"dummy"
"58937",0,0,1,1,"dummy"
"58938",16,16,3,35,"dummy"
"58939",13,4,2,19,"dummy"
"58942",0,1,0,1,"dummy"
"58943",3,0,0,3,"dummy"
"58944",1,0,0,1,"dummy"
"58945",0,0,0,0,"dummy"
"58946",0,0,0,0,"dummy"
"58947",0,0,0,0,"dummy"
"58969",1,0,0,1,"dummy"
"58970",0,0,1,1,"dummy"
"58972",0,3,0,3,"dummy"
"58973",0,0,0,0,"dummy"
"58974",0,3,1,4,"dummy"
"58977",5,9,2,16,"dummy"
"58979",1,0,3,4,"dummy"
"58980",0,0,1,1,"dummy"
"58981",0,0,1,1,"dummy"
"58984",0,0,1,1,"dummy"
"58985",1,1,0,2,"dummy"
"58986",1,2,3,6,"dummy"
"58987",7,6,1,14,"dummy"
"58988",0,0,0,0,"dummy"
"58989",0,6,0,6,"dummy"
"58990",0,0,0,0,"dummy"
"58991",6,5,0,11,"dummy"
"59002",1,1,0,2,"dummy"
"59007",0,1,0,1,"dummy"
"59009",0,1,0,1,"dummy"
"59010",1,0,0,1,"dummy"
"59011",0,1,0,1,"dummy"
"59012",0,0,3,3,"dummy"
"59020",0,23,0,23,"dummy"
"59021",0,10,0,10,"dummy"
"59022",0,2,0,2,"dummy"
"59023",6,6,1,13,"dummy"
"59024",0,1,2,3,"dummy"
"59025",0,0,1,1,"dummy"
"59029",0,1,0,1,"dummy"
"59031",0,0,1,1,"dummy"
"59032",0,0,2,2,"dummy"
"59037",0,3,0,3,"dummy"
"59038",0,1,0,1,"dummy"
"59040",0,0,1,1,"dummy"
"59041",0,0,1,1,"dummy"
"59042",0,0,2,2,"dummy"
"59043",0,0,1,1,"dummy"
"59044",0,1,0,1,"dummy"
"59046",5,1,3,9,"dummy"
"59047",0,2,0,2,"dummy"
"59048",2,19,6,27,"dummy"
"59051",0,0,1,1,"dummy"
"59054",0,1,1,2,"dummy"
"59055",0,0,1,1,"dummy"
"59057",0,0,1,1,"dummy"
"59058",0,0,1,1,"dummy"
"59060",0,0,3,3,"dummy"
"59087",1,3,2,6,"dummy"
"59089",0,0,1,1,"dummy"
"59090",0,1,0,1,"dummy"
"59092",0,0,4,4,"dummy"
"59096",0,3,0,3,"dummy"
"59097",1,1,0,2,"dummy"
"59098",1,0,0,1,"dummy"
"59099",1,0,0,1,"dummy"
"59103",0,4,1,5,"dummy"
"59104",0,1,0,1,"dummy"
"59105",5,4,0,9,"dummy"
"59106",0,0,0,0,"dummy"
"59107",0,0,2,2,"dummy"
"59108",4,4,0,8,"dummy"
"59109",0,1,1,2,"dummy"
"59110",0,0,1,1,"dummy"
"59111",0,0,1,1,"dummy"
"59112",3,3,3,9,"dummy"
"59114",0,8,1,9,"dummy"
"59115",0,0,0,0,"dummy"
"59116",0,0,0,0,"dummy"
"59117",0,3,1,4,"dummy"
"59118",0,5,0,5,"dummy"
"59119",0,0,1,1,"dummy"
"59120",0,0,0,0,"dummy"
"59121",0,1,1,2,"dummy"
"59191",0,1,0,1,"dummy"
"59192",0,1,0,1,"dummy"
"59193",0,0,1,1,"dummy"
"59194",1,0,0,1,"dummy"
"59195",0,1,0,1,"dummy"
"59196",1,0,0,1,"dummy"
"59197",0,0,0,0,"dummy"
"59198",12,2,1,15,"dummy"
"59199",0,0,1,1,"dummy"
"59200",1,1,0,2,"dummy"
"59201",0,1,0,1,"dummy"
"59202",1,1,0,2,"dummy"
"59203",0,0,1,1,"dummy"
"59204",3,5,0,8,"dummy"
"59205",1,0,0,1,"dummy"
"59206",0,1,0,1,"dummy"
"59207",3,1,1,5,"dummy"
"59208",0,1,0,1,"dummy"
"59209",0,0,1,1,"dummy"
"59212",0,0,2,2,"dummy"
"59213",1,0,0,1,"dummy"
"59222",0,8,0,8,"dummy"
"59225",4,4,3,11,"dummy"
"59226",0,1,0,1,"dummy"
"59227",2,0,3,5,"dummy"
"59228",3,0,1,4,"dummy"
"59230",0,1,0,1,"dummy"
"59231",0,1,0,1,"dummy"
"59232",0,3,0,3,"dummy"
"59233",0,0,1,1,"dummy"
"59234",1,0,1,2,"dummy"
"59235",0,0,1,1,"dummy"
"59236",0,0,1,1,"dummy"
"59237",0,7,0,7,"dummy"
"59238",8,2,0,10,"dummy"
"59239",0,3,0,3,"dummy"
"59240",4,6,0,10,"dummy"
"59241",0,0,6,6,"dummy"
"59242",5,5,0,10,"dummy"
"59244",0,2,0,2,"dummy"
"59247",1,2,3,6,"dummy"
"59248",0,0,1,1,"dummy"
"59249",2,3,0,5,"dummy"
"59250",1,1,0,2,"dummy"
"59251",16,0,1,17,"dummy"
"59252",0,11,0,11,"dummy"
"59253",1,0,0,1,"dummy"
"59254",0,3,0,3,"dummy"
"59255",0,6,0,6,"dummy"
"59256",0,1,0,1,"dummy"
"59257",0,1,0,1,"dummy"
"59258",0,0,1,1,"dummy"
"59259",0,0,1,1,"dummy"
"59260",0,0,1,1,"dummy"
"59261",0,0,1,1,"dummy"
"59262",0,0,1,1,"dummy"
"59263",0,0,1,1,"dummy"
"59264",5,0,0,5,"dummy"
"59265",0,3,0,3,"dummy"
"59266",0,0,1,1,"dummy"
"59267",0,0,1,1,"dummy"
"59268",0,0,1,1,"dummy"
"59269",0,3,0,3,"dummy"
"59270",0,0,1,1,"dummy"
"59271",0,0,1,1,"dummy"
"59272",0,0,1,1,"dummy"
"59273",0,0,1,1,"dummy"
"59274",0,0,1,1,"dummy"
"59275",0,0,1,1,"dummy"
"59276",0,0,1,1,"dummy"
"59277",1,1,0,2,"dummy"
"59278",1,0,0,1,"dummy"
"59279",0,0,1,1,"dummy"
"59280",0,0,1,1,"dummy"
"59281",0,0,1,1,"dummy"
"59282",0,0,0,0,"dummy"
"59283",0,10,1,11,"dummy"
"59284",0,0,1,1,"dummy"
"59285",0,0,1,1,"dummy"
"59286",0,0,1,1,"dummy"
"59287",1,2,0,3,"dummy"
"59288",0,0,1,1,"dummy"
"59289",1,1,0,2,"dummy"
"59290",5,2,2,9,"dummy"
"59291",0,0,1,1,"dummy"
"59292",0,0,1,1,"dummy"
"59293",0,0,1,1,"dummy"
"59294",0,1,2,3,"dummy"
"59295",0,0,1,1,"dummy"
"59296",2,2,1,5,"dummy"
"59297",0,0,1,1,"dummy"
"59298",0,0,1,1,"dummy"
"59299",0,0,1,1,"dummy"
"59300",0,1,1,2,"dummy"
"59301",0,2,0,2,"dummy"
"59302",0,0,1,1,"dummy"
"59303",0,0,1,1,"dummy"
"59304",1,2,0,3,"dummy"
"59305",4,1,0,5,"dummy"
"59306",0,2,0,2,"dummy"
"59307",0,0,1,1,"dummy"
"59308",0,1,0,1,"dummy"
"59309",0,0,1,1,"dummy"
"59310",0,0,1,1,"dummy"
"59311",1,1,0,2,"dummy"
"59312",1,1,0,2,"dummy"
"59314",4,5,0,9,"dummy"
"59317",0,1,0,1,"dummy"
"59318",0,0,1,1,"dummy"
"59320",0,2,0,2,"dummy"
"59322",0,0,0,0,"dummy"
"59323",0,1,1,2,"dummy"
"59324",0,0,0,0,"dummy"
"59329",0,0,1,1,"dummy"
"59330",0,0,1,1,"dummy"
"59332",0,11,0,11,"dummy"
"59333",0,1,0,1,"dummy"
"59334",0,1,0,1,"dummy"
"59335",8,9,0,17,"dummy"
"59336",3,5,1,9,"dummy"
"59337",0,3,0,3,"dummy"
"59338",0,5,0,5,"dummy"
"59339",0,1,0,1,"dummy"
"59340",0,1,0,1,"dummy"
"59341",0,1,0,1,"dummy"
"59342",0,1,0,1,"dummy"
"59343",3,2,0,5,"dummy"
"59345",0,1,0,1,"dummy"
"59347",0,0,0,0,"dummy"
"59349",0,1,0,1,"dummy"
"59350",1,0,0,1,"dummy"
"59352",0,4,0,4,"dummy"
"59354",0,2,3,5,"dummy"
"59358",0,0,4,4,"dummy"
"59363",0,4,0,4,"dummy"
"59366",1,3,1,5,"dummy"
"59367",1,6,2,9,"dummy"
"59368",0,1,1,2,"dummy"
"59369",0,1,0,1,"dummy"
"59371",0,2,0,2,"dummy"
"59373",0,0,2,2,"dummy"
"59374",0,1,0,1,"dummy"
"59375",0,4,0,4,"dummy"
"59376",2,3,0,5,"dummy"
"59377",0,0,0,0,"dummy"
"59378",11,7,0,18,"dummy"
"59379",0,1,0,1,"dummy"
"59380",0,0,0,0,"dummy"
"59384",3,3,0,6,"dummy"
"59385",10,19,3,32,"dummy"
"59386",1,7,0,8,"dummy"
"59387",10,16,1,27,"dummy"
"59388",0,0,2,2,"dummy"
"59389",2,2,0,4,"dummy"
"59390",18,0,3,21,"dummy"
"59391",2,0,0,2,"dummy"
"59392",0,1,0,1,"dummy"
"59393",1,0,0,1,"dummy"
"59395",3,4,1,8,"dummy"
"59396",1,1,3,5,"dummy"
"59397",0,0,0,0,"dummy"
"59398",3,3,0,6,"dummy"
"59400",0,0,0,0,"dummy"
"59402",0,0,4,4,"dummy"
"59404",0,1,0,1,"dummy"
"59405",0,0,1,1,"dummy"
"59406",0,0,1,1,"dummy"
"59407",0,0,1,1,"dummy"
"59408",4,0,0,4,"dummy"
"59409",0,0,1,1,"dummy"
"59410",0,0,1,1,"dummy"
"59411",0,0,1,1,"dummy"
"59412",0,0,1,1,"dummy"
"59413",0,0,1,1,"dummy"
"59414",0,0,1,1,"dummy"
"59415",0,0,1,1,"dummy"
"59416",0,0,1,1,"dummy"
"59417",0,0,1,1,"dummy"
"59418",0,0,1,1,"dummy"
"59419",0,0,1,1,"dummy"
"59420",0,0,1,1,"dummy"
"59421",0,0,1,1,"dummy"
"59422",0,0,1,1,"dummy"
"59423",0,0,1,1,"dummy"
"59424",0,0,1,1,"dummy"
"59425",0,0,1,1,"dummy"
"59426",0,0,1,1,"dummy"
"59427",0,0,1,1,"dummy"
"59437",0,0,2,2,"dummy"
"59439",3,3,2,8,"dummy"
"59440",0,0,1,1,"dummy"
"59441",13,3,1,17,"dummy"
"59444",0,0,1,1,"dummy"
"59445",1,13,2,16,"dummy"
"59446",0,1,0,1,"dummy"
"59447",0,1,1,2,"dummy"
"59448",1,0,0,1,"dummy"
"59449",0,1,0,1,"dummy"
"59450",0,0,0,0,"dummy"
"59452",0,0,1,1,"dummy"
"59454",0,0,2,2,"dummy"
"59455",0,0,2,2,"dummy"
"59456",0,2,0,2,"dummy"
"59457",0,1,1,2,"dummy"
"59458",0,2,0,2,"dummy"
"59459",0,4,0,4,"dummy"
"59460",0,7,1,8,"dummy"
"59461",0,5,0,5,"dummy"
"59462",1,0,0,1,"dummy"
"59463",1,0,1,2,"dummy"
"59464",0,1,1,2,"dummy"
"59466",0,0,0,0,"dummy"
"59467",0,0,1,1,"dummy"
"59469",2,2,0,4,"dummy"
"59470",0,1,0,1,"dummy"
"59471",0,0,2,2,"dummy"
"59473",1,0,2,3,"dummy"
"59474",1,2,3,6,"dummy"
"59475",3,0,4,7,"dummy"
"59476",0,3,4,7,"dummy"
"59477",0,0,2,2,"dummy"
"59478",10,0,2,12,"dummy"
"59479",0,0,1,1,"dummy"
"59483",2,5,0,7,"dummy"
"59484",1,1,0,2,"dummy"
"59485",1,36,1,38,"dummy"
"59486",2,2,1,5,"dummy"
"59488",0,10,0,10,"dummy"
"59490",1,0,1,2,"dummy"
"59491",0,1,0,1,"dummy"
"59492",0,0,1,1,"dummy"
"59493",2,1,4,7,"dummy"
"59494",0,1,0,1,"dummy"
"59497",0,0,1,1,"dummy"
"59498",0,0,1,1,"dummy"
"59500",3,0,1,4,"dummy"
"59503",1,0,0,1,"dummy"
"59505",1,14,4,19,"dummy"
"59506",0,1,0,1,"dummy"
"59507",7,20,0,27,"dummy"
"59508",2,1,0,3,"dummy"
"59509",7,1,0,8,"dummy"
"59510",3,1,0,4,"dummy"
"59511",1,5,0,6,"dummy"
"59512",0,0,0,0,"dummy"
"59513",1,0,0,1,"dummy"
"59514",4,1,0,5,"dummy"
"59515",0,1,0,1,"dummy"
"59516",0,1,0,1,"dummy"
"59517",3,14,0,17,"dummy"
"59518",0,1,0,1,"dummy"
"59519",0,0,1,1,"dummy"
"59520",2,1,0,3,"dummy"
"59521",2,2,0,4,"dummy"
"59522",0,0,1,1,"dummy"
"59523",7,1,1,9,"dummy"
"59524",0,3,0,3,"dummy"
"59525",0,0,0,0,"dummy"
"59526",0,0,0,0,"dummy"
"59527",2,0,0,2,"dummy"
"59528",0,0,0,0,"dummy"
"59530",0,0,1,1,"dummy"
"59531",0,2,0,2,"dummy"
"59532",2,1,2,5,"dummy"
"59533",0,0,1,1,"dummy"
"59551",3,4,0,7,"dummy"
"59554",0,0,1,1,"dummy"
"59555",1,1,5,7,"dummy"
"59556",0,0,0,0,"dummy"
"59557",0,0,0,0,"dummy"
"59558",0,2,0,2,"dummy"
"59559",0,2,0,2,"dummy"
"59560",6,1,4,11,"dummy"
"59562",4,5,4,13,"dummy"
"59564",4,6,0,10,"dummy"
"59566",1,1,2,4,"dummy"
"59567",7,8,3,18,"dummy"
"59569",1,2,0,3,"dummy"
"59570",2,1,0,3,"dummy"
"59572",0,1,0,1,"dummy"
"59573",1,0,0,1,"dummy"
"59576",3,2,0,5,"dummy"
"59577",4,1,0,5,"dummy"
"59578",0,0,0,0,"dummy"
"59580",0,0,0,0,"dummy"
"59582",0,1,0,1,"dummy"
"59583",0,1,0,1,"dummy"
"59585",0,0,6,6,"dummy"
"59586",1,6,8,15,"dummy"
"59587",0,0,0,0,"dummy"
"59589",0,0,1,1,"dummy"
"59591",0,1,0,1,"dummy"
"59592",5,6,3,14,"dummy"
"59593",0,0,1,1,"dummy"
"59595",1,5,1,7,"dummy"
"59598",0,0,1,1,"dummy"
"59599",11,7,2,20,"dummy"
"59602",1,2,0,3,"dummy"
"59603",0,1,0,1,"dummy"
"59604",0,1,1,2,"dummy"
"59605",0,1,0,1,"dummy"
"59606",0,0,1,1,"dummy"
"59607",0,0,1,1,"dummy"
"59608",0,0,1,1,"dummy"
"59610",0,0,0,0,"dummy"
"59615",1,0,0,1,"dummy"
"59617",0,3,0,3,"dummy"
"59618",1,0,1,2,"dummy"
"59621",0,0,0,0,"dummy"
"59622",1,3,0,4,"dummy"
"59623",2,1,0,3,"dummy"
"59624",0,1,0,1,"dummy"
"59625",0,0,0,0,"dummy"
"59626",1,2,0,3,"dummy"
"59627",2,1,0,3,"dummy"
"59628",1,1,0,2,"dummy"
"59629",0,5,0,5,"dummy"
"59630",3,0,0,3,"dummy"
"59631",1,0,0,1,"dummy"
"59632",0,2,0,2,"dummy"
"59633",0,0,1,1,"dummy"
"59634",1,0,2,3,"dummy"
"59635",0,0,0,0,"dummy"
"59636",0,3,0,3,"dummy"
"59637",0,0,1,1,"dummy"
"59638",0,0,1,1,"dummy"
"59640",0,0,0,0,"dummy"
"59641",0,0,0,0,"dummy"
"59642",0,0,0,0,"dummy"
"59643",0,0,0,0,"dummy"
"59650",0,2,0,2,"dummy"
"59651",0,0,0,0,"dummy"
"59652",0,2,0,2,"dummy"
"59653",1,0,0,1,"dummy"
"59654",1,2,1,4,"dummy"
"59655",0,1,0,1,"dummy"
"59656",2,0,0,2,"dummy"
"59657",0,3,0,3,"dummy"
"59658",3,0,0,3,"dummy"
"59659",3,5,1,9,"dummy"
"59660",11,6,1,18,"dummy"
"59661",6,4,0,10,"dummy"
"59662",0,1,0,1,"dummy"
"59663",0,0,0,0,"dummy"
"59664",4,5,0,9,"dummy"
"59665",0,0,3,3,"dummy"
"59666",0,0,0,0,"dummy"
"59667",0,0,3,3,"dummy"
"59672",0,0,0,0,"dummy"
"59673",0,0,1,1,"dummy"
"59674",1,0,0,1,"dummy"
"59677",5,3,6,14,"dummy"
"59678",0,1,0,1,"dummy"
"59679",0,2,0,2,"dummy"
"59683",0,0,1,1,"dummy"
"59684",0,2,0,2,"dummy"
"59685",0,5,5,10,"dummy"
"59686",5,0,1,6,"dummy"
"59688",18,2,1,21,"dummy"
"59689",1,0,0,1,"dummy"
"59690",0,0,0,0,"dummy"
"59691",0,0,0,0,"dummy"
"59692",0,0,1,1,"dummy"
"59693",0,0,1,1,"dummy"
"59694",0,1,0,1,"dummy"
"59695",0,0,1,1,"dummy"
"59696",0,0,1,1,"dummy"
"59697",0,0,1,1,"dummy"
"59698",0,0,1,1,"dummy"
"59699",0,0,1,1,"dummy"
"59702",0,2,0,2,"dummy"
"59703",15,3,1,19,"dummy"
"59704",0,0,0,0,"dummy"
"59705",0,3,0,3,"dummy"
"59719",0,0,1,1,"dummy"
"59720",0,1,0,1,"dummy"
"59724",3,0,0,3,"dummy"
"59725",0,1,0,1,"dummy"
"59726",0,0,1,1,"dummy"
"59727",0,1,0,1,"dummy"
"59728",0,0,1,1,"dummy"
"59729",0,0,1,1,"dummy"
"59738",12,1,0,13,"dummy"
"59742",2,0,0,2,"dummy"
"59747",0,0,1,1,"dummy"
"59748",1,1,0,2,"dummy"
"59751",0,0,1,1,"dummy"
"59753",0,0,1,1,"dummy"
"59756",0,3,0,3,"dummy"
"59759",4,3,2,9,"dummy"
"59760",1,2,0,3,"dummy"
"59761",1,2,1,4,"dummy"
"59763",4,0,0,4,"dummy"
"59764",0,2,0,2,"dummy"
"59765",0,0,1,1,"dummy"
"59798",0,2,0,2,"dummy"
"59799",0,0,4,4,"dummy"
"59802",1,3,2,6,"dummy"
"59803",3,1,0,4,"dummy"
"59804",0,0,3,3,"dummy"
"59805",0,0,1,1,"dummy"
"59851",0,0,1,1,"dummy"
"59856",1,5,0,6,"dummy"
"59857",8,4,3,15,"dummy"
"59862",0,0,1,1,"dummy"
"59863",0,1,0,1,"dummy"
"59864",1,0,2,3,"dummy"
"59865",1,0,0,1,"dummy"
"59866",0,0,1,1,"dummy"
"59867",0,1,1,2,"dummy"
"59868",8,7,0,15,"dummy"
"59869",5,0,0,5,"dummy"
"59870",6,3,0,9,"dummy"
"59871",0,8,0,8,"dummy"
"59872",8,0,0,8,"dummy"
"59873",0,0,1,1,"dummy"
"59895",2,1,3,6,"dummy"
"59896",0,0,1,1,"dummy"
"59897",0,0,1,1,"dummy"
"59898",0,0,1,1,"dummy"
"59899",0,1,0,1,"dummy"
"59900",0,0,2,2,"dummy"
"59915",0,0,0,0,"dummy"
"59925",0,1,0,1,"dummy"
"59926",0,2,0,2,"dummy"
"59941",0,0,2,2,"dummy"
"59942",0,0,1,1,"dummy"
"59943",33,3,2,38,"dummy"
"59980",0,4,0,4,"dummy"
"59981",0,7,0,7,"dummy"
"59982",1,1,0,2,"dummy"
"59983",12,10,0,22,"dummy"
"59984",6,6,0,12,"dummy"
"59985",4,13,0,17,"dummy"
"59986",22,17,0,39,"dummy"
"59987",11,12,0,23,"dummy"
"59994",0,1,0,1,"dummy"
"60001",0,0,1,1,"dummy"
"60002",0,4,0,4,"dummy"
"60003",2,2,1,5,"dummy"
"60004",0,1,0,1,"dummy"
"60005",13,7,3,23,"dummy"
"60006",0,5,0,5,"dummy"
"60007",0,9,2,11,"dummy"
"60008",1,0,0,1,"dummy"
"60016",1,1,0,2,"dummy"
"60029",1,0,2,3,"dummy"
"60030",0,6,1,7,"dummy"
"60035",0,2,0,2,"dummy"
"60050",3,2,0,5,"dummy"
"60051",0,2,0,2,"dummy"
"60052",21,2,1,24,"dummy"
"60053",0,3,1,4,"dummy"
"60054",0,0,2,2,"dummy"
"60055",0,0,2,2,"dummy"
"60056",0,14,2,16,"dummy"
"60057",11,0,2,13,"dummy"
"60058",0,2,2,4,"dummy"
"60059",0,3,0,3,"dummy"
"60060",0,2,0,2,"dummy"
"60061",3,3,0,6,"dummy"
"60062",0,0,2,2,"dummy"
"60063",0,0,2,2,"dummy"
"60064",0,0,2,2,"dummy"
"60065",0,0,2,2,"dummy"
"60066",0,0,2,2,"dummy"
"60067",0,0,2,2,"dummy"
"60068",0,0,2,2,"dummy"
"60069",0,0,2,2,"dummy"
"60070",0,0,2,2,"dummy"
"60071",0,0,2,2,"dummy"
"60072",0,0,2,2,"dummy"
"60073",1,2,0,3,"dummy"
"60074",2,1,0,3,"dummy"
"59835",2,9,1,12,"dummy"
"59836",0,6,0,6,"dummy"
"59837",10,14,7,31,"dummy"
"59838",0,0,1,1,"dummy"
"59839",0,3,0,3,"dummy"
"59840",0,0,2,2,"dummy"
"59843",0,6,0,6,"dummy"
"59844",0,1,0,1,"dummy"
"59845",1,2,0,3,"dummy"
"59846",0,0,0,0,"dummy"
"59847",3,3,0,6,"dummy"
"59848",8,15,5,28,"dummy"
"59849",0,0,1,1,"dummy"
"59859",6,5,0,11,"dummy"
"59860",0,0,1,1,"dummy"
"59877",0,0,1,1,"dummy"
"59886",0,0,0,0,"dummy"
"59891",0,0,0,0,"dummy"
"59906",0,0,1,1,"dummy"
"59907",7,0,1,8,"dummy"
"59908",0,1,0,1,"dummy"
"59909",2,11,1,14,"dummy"
"59910",9,12,4,25,"dummy"
"59911",0,0,1,1,"dummy"
"59912",0,2,0,2,"dummy"
"59913",0,1,0,1,"dummy"
"59917",10,2,2,14,"dummy"
"59918",0,2,0,2,"dummy"
"59919",1,3,2,6,"dummy"
"59920",0,1,0,1,"dummy"
"59921",4,5,0,9,"dummy"
"59922",2,3,0,5,"dummy"
"59923",11,2,2,15,"dummy"
"59928",1,1,0,2,"dummy"
"59929",0,4,0,4,"dummy"
"59930",0,1,0,1,"dummy"
"59931",2,0,3,5,"dummy"
"59932",0,1,1,2,"dummy"
"59933",0,0,0,0,"dummy"
"59936",3,4,0,7,"dummy"
"59937",1,1,0,2,"dummy"
"59945",0,7,0,7,"dummy"
"59946",0,0,0,0,"dummy"
"59947",1,3,0,4,"dummy"
"59948",0,1,0,1,"dummy"
"59949",0,1,0,1,"dummy"
"59950",3,31,1,35,"dummy"
"59951",0,2,0,2,"dummy"
"59952",0,2,0,2,"dummy"
"59955",0,6,0,6,"dummy"
"59956",0,0,0,0,"dummy"
"59957",0,0,0,0,"dummy"
"59958",0,3,0,3,"dummy"
"59959",9,0,0,9,"dummy"
"59960",0,3,0,3,"dummy"
"59961",0,8,0,8,"dummy"
"59962",0,1,2,3,"dummy"
"59963",1,2,0,3,"dummy"
"59964",0,1,0,1,"dummy"
"59965",0,1,0,1,"dummy"
"59966",2,0,0,2,"dummy"
"59967",0,1,2,3,"dummy"
"59968",0,0,1,1,"dummy"
"59969",0,0,2,2,"dummy"
"59970",0,0,1,1,"dummy"
"59971",0,3,0,3,"dummy"
"59972",3,0,0,3,"dummy"
"59973",0,0,0,0,"dummy"
"59974",0,2,0,2,"dummy"
"59989",0,0,1,1,"dummy"
"59990",0,0,1,1,"dummy"
"59991",4,0,1,5,"dummy"
"59992",0,0,1,1,"dummy"
"59996",0,2,0,2,"dummy"
"60010",0,1,1,2,"dummy"
"60011",1,2,1,4,"dummy"
"60012",0,1,0,1,"dummy"
"60013",1,0,0,1,"dummy"
"60014",1,0,0,1,"dummy"
"60018",4,15,0,19,"dummy"
"60019",0,0,1,1,"dummy"
"60020",0,1,0,1,"dummy"
"60021",9,3,0,12,"dummy"
"60032",0,0,1,1,"dummy"
"60033",1,1,0,2,"dummy"
"60037",2,4,1,7,"dummy"
"60038",0,0,1,1,"dummy"
"60039",0,1,0,1,"dummy"
"60040",2,3,1,6,"dummy"
"60041",0,3,0,3,"dummy"
"60042",0,0,1,1,"dummy"
"60043",2,0,2,4,"dummy"
"60044",0,1,0,1,"dummy"
"60045",1,4,0,5,"dummy"
"60046",0,0,0,0,"dummy"
"60047",0,1,0,1,"dummy"
"60048",2,1,0,3,"dummy"
"60119",0,1,0,1,"dummy"
"60120",0,1,0,1,"dummy"
"60121",0,1,0,1,"dummy"
"60122",0,0,1,1,"dummy"
"60123",0,0,1,1,"dummy"
"60124",0,2,1,3,"dummy"
"60125",1,3,2,6,"dummy"
"60126",1,0,0,1,"dummy"
"60127",1,0,0,1,"dummy"
"60128",3,2,1,6,"dummy"
"60129",0,1,1,2,"dummy"
"60130",1,0,0,1,"dummy"
"60131",0,0,1,1,"dummy"
"60134",0,0,0,0,"dummy"
"60138",2,0,0,2,"dummy"
"60139",4,3,0,7,"dummy"
"60140",0,1,0,1,"dummy"
"60141",4,5,2,11,"dummy"
"60190",1,0,0,1,"dummy"
"60193",0,0,1,1,"dummy"
"60204",32,51,5,88,"dummy"
"60205",0,0,1,1,"dummy"
"60206",10,3,0,13,"dummy"
"60209",0,1,0,1,"dummy"
"60217",0,3,1,4,"dummy"
"60218",0,0,0,0,"dummy"
"60219",0,0,3,3,"dummy"
"60220",0,0,1,1,"dummy"
"60225",0,1,0,1,"dummy"
"60226",0,0,0,0,"dummy"
"60256",0,2,3,5,"dummy"
"60257",4,4,2,10,"dummy"
"60261",0,15,1,16,"dummy"
"60273",1,3,3,7,"dummy"
"60277",0,0,0,0,"dummy"
"60278",0,2,0,2,"dummy"
"60279",4,6,0,10,"dummy"
"60280",0,0,1,1,"dummy"
"60281",6,4,0,10,"dummy"
"60282",1,4,0,5,"dummy"
"60283",0,0,5,5,"dummy"
"60284",0,1,1,2,"dummy"
"60285",0,0,1,1,"dummy"
"60288",0,0,0,0,"dummy"
"60289",0,0,0,0,"dummy"
"60318",1,0,1,2,"dummy"
"60319",4,2,7,13,"dummy"
"60320",0,0,0,0,"dummy"
"60075",0,0,2,2,"dummy"
"60076",0,0,2,2,"dummy"
"60077",0,0,2,2,"dummy"
"60078",1,2,0,3,"dummy"
"60079",0,0,2,2,"dummy"
"60080",0,0,2,2,"dummy"
"60081",0,0,2,2,"dummy"
"60082",0,0,2,2,"dummy"
"60083",0,0,2,2,"dummy"
"60084",0,0,2,2,"dummy"
"60085",0,0,2,2,"dummy"
"60086",0,0,2,2,"dummy"
"60087",0,0,2,2,"dummy"
"60088",0,0,2,2,"dummy"
"60089",0,0,2,2,"dummy"
"60090",0,0,2,2,"dummy"
"60091",0,0,2,2,"dummy"
"60092",0,0,2,2,"dummy"
"60093",0,0,2,2,"dummy"
"60094",0,0,2,2,"dummy"
"60095",0,0,2,2,"dummy"
"60096",0,0,2,2,"dummy"
"60097",0,0,2,2,"dummy"
"60098",0,0,2,2,"dummy"
"60099",0,0,2,2,"dummy"
"60100",0,0,2,2,"dummy"
"60101",0,0,2,2,"dummy"
"60102",0,0,2,2,"dummy"
"60103",0,0,2,2,"dummy"
"60104",0,0,2,2,"dummy"
"60105",0,0,2,2,"dummy"
"60106",0,3,0,3,"dummy"
"60107",4,2,2,8,"dummy"
"60108",2,0,0,2,"dummy"
"60109",0,0,2,2,"dummy"
"60110",0,0,2,2,"dummy"
"60111",0,0,2,2,"dummy"
"60112",0,0,2,2,"dummy"
"60113",0,0,2,2,"dummy"
"60114",0,0,2,2,"dummy"
"60115",0,0,2,2,"dummy"
"60116",0,0,2,2,"dummy"
"60117",0,0,2,2,"dummy"
"60136",18,0,1,19,"dummy"
"60143",2,2,0,4,"dummy"
"60144",0,1,0,1,"dummy"
"60145",2,2,0,4,"dummy"
"60146",0,0,0,0,"dummy"
"60147",14,18,0,32,"dummy"
"60148",0,0,0,0,"dummy"
"60149",0,3,0,3,"dummy"
"60150",0,0,0,0,"dummy"
"60151",0,0,0,0,"dummy"
"60154",0,1,0,1,"dummy"
"60157",3,3,8,14,"dummy"
"60158",0,3,0,3,"dummy"
"60181",0,2,0,2,"dummy"
"60182",1,2,0,3,"dummy"
"60183",0,1,0,1,"dummy"
"60184",0,1,0,1,"dummy"
"60185",0,3,0,3,"dummy"
"60186",0,0,1,1,"dummy"
"60187",0,1,0,1,"dummy"
"60188",0,1,1,2,"dummy"
"60195",4,4,0,8,"dummy"
"60196",1,0,0,1,"dummy"
"60197",0,2,0,2,"dummy"
"60198",1,0,0,1,"dummy"
"60199",0,0,1,1,"dummy"
"60200",1,2,0,3,"dummy"
"60201",0,1,0,1,"dummy"
"60202",4,0,2,6,"dummy"
"60215",0,1,0,1,"dummy"
"60230",0,0,2,2,"dummy"
"60231",0,0,1,1,"dummy"
"60232",1,1,0,2,"dummy"
"60233",0,3,0,3,"dummy"
"60234",0,3,2,5,"dummy"
"60235",0,0,1,1,"dummy"
"60236",0,0,1,1,"dummy"
"60237",1,1,4,6,"dummy"
"60238",2,3,0,5,"dummy"
"60239",3,3,3,9,"dummy"
"60240",0,2,0,2,"dummy"
"60241",1,0,1,2,"dummy"
"60242",0,41,0,41,"dummy"
"60243",4,4,4,12,"dummy"
"60244",1,1,0,2,"dummy"
"60245",0,1,0,1,"dummy"
"60246",3,2,0,5,"dummy"
"60247",0,1,0,1,"dummy"
"60248",48,1,2,51,"dummy"
"60249",0,1,0,1,"dummy"
"60263",2,0,0,2,"dummy"
"60275",0,0,3,3,"dummy"
"60293",8,12,3,23,"dummy"
"60294",0,0,1,1,"dummy"
"60295",0,0,1,1,"dummy"
"60296",0,0,1,1,"dummy"
"60297",0,0,1,1,"dummy"
"60298",0,0,1,1,"dummy"
"60299",0,0,1,1,"dummy"
"60300",0,0,1,1,"dummy"
"60301",0,0,1,1,"dummy"
"60302",0,0,1,1,"dummy"
"60303",0,0,1,1,"dummy"
"60304",0,0,1,1,"dummy"
"60305",0,0,1,1,"dummy"
"60306",0,0,1,1,"dummy"
"60307",0,0,1,1,"dummy"
"60308",0,0,1,1,"dummy"
"60309",2,0,1,3,"dummy"
"60310",0,2,0,2,"dummy"
"60311",0,0,1,1,"dummy"
"60312",0,0,1,1,"dummy"
"60313",0,0,1,1,"dummy"
"60314",0,2,0,2,"dummy"
"60315",2,0,0,2,"dummy"
"60316",0,0,1,1,"dummy"
"60322",0,4,0,4,"dummy"
"60323",0,0,2,2,"dummy"
"60324",2,0,0,2,"dummy"
"60362",0,0,1,1,"dummy"
"60366",0,1,0,1,"dummy"
"60370",1,0,0,1,"dummy"
"60371",0,1,0,1,"dummy"
"60373",0,2,0,2,"dummy"
"60374",1,4,0,5,"dummy"
"60375",1,1,0,2,"dummy"
"60378",0,0,1,1,"dummy"
"60388",0,0,2,2,"dummy"
"60389",1,0,1,2,"dummy"
"60390",0,3,1,4,"dummy"
"60391",7,0,0,7,"dummy"
"60392",0,6,0,6,"dummy"
"60393",0,1,0,1,"dummy"
"60396",6,0,0,6,"dummy"
"60397",2,5,2,9,"dummy"
"60399",7,0,0,7,"dummy"
"60402",4,4,0,8,"dummy"
"60405",0,0,0,0,"dummy"
"60406",0,0,0,0,"dummy"
"60407",0,0,0,0,"dummy"
"60408",0,0,0,0,"dummy"
"60409",0,0,0,0,"dummy"
"60410",0,0,0,0,"dummy"
"60416",0,0,2,2,"dummy"
"60419",0,5,0,5,"dummy"
"60422",1,3,0,4,"dummy"
"60423",0,11,0,11,"dummy"
"60425",3,1,3,7,"dummy"
"60426",0,0,1,1,"dummy"
"60431",0,0,0,0,"dummy"
"60433",0,4,0,4,"dummy"
"60437",3,2,1,6,"dummy"
"60438",0,1,0,1,"dummy"
"60439",0,0,1,1,"dummy"
"60440",1,0,1,2,"dummy"
"60441",0,0,0,0,"dummy"
"60442",0,0,1,1,"dummy"
"60443",0,0,0,0,"dummy"
"60444",0,0,2,2,"dummy"
"60446",2,7,0,9,"dummy"
"60449",1,1,0,2,"dummy"
"60451",0,0,2,2,"dummy"
"60452",0,1,0,1,"dummy"
"60453",0,2,2,4,"dummy"
"60454",0,1,0,1,"dummy"
"60455",1,2,2,5,"dummy"
"60495",1,1,0,2,"dummy"
"60500",0,2,0,2,"dummy"
"60502",1,0,0,1,"dummy"
"60504",0,0,1,1,"dummy"
"60507",0,1,0,1,"dummy"
"60508",1,3,0,4,"dummy"
"60509",3,1,0,4,"dummy"
"60510",7,0,0,7,"dummy"
"60511",0,1,0,1,"dummy"
"60513",0,1,0,1,"dummy"
"60515",2,4,0,6,"dummy"
"60516",0,2,0,2,"dummy"
"60517",0,2,0,2,"dummy"
"60518",10,2,0,12,"dummy"
"60519",0,2,0,2,"dummy"
"60520",0,0,0,0,"dummy"
"60523",0,0,1,1,"dummy"
"60524",0,0,1,1,"dummy"
"60549",0,6,0,6,"dummy"
"60551",0,0,3,3,"dummy"
"60552",0,0,2,2,"dummy"
"60554",0,1,0,1,"dummy"
"60561",0,1,0,1,"dummy"
"60565",0,1,0,1,"dummy"
"60566",0,1,0,1,"dummy"
"60568",0,2,0,2,"dummy"
"60570",1,4,0,5,"dummy"
"60571",0,0,2,2,"dummy"
"60575",0,3,0,3,"dummy"
"60579",1,0,0,1,"dummy"
"60583",0,2,0,2,"dummy"
"60585",0,0,0,0,"dummy"
"60586",0,0,0,0,"dummy"
"60587",0,0,0,0,"dummy"
"60589",2,13,5,20,"dummy"
"60590",0,2,0,2,"dummy"
"60591",0,0,3,3,"dummy"
"60608",0,0,0,0,"dummy"
"60609",0,2,0,2,"dummy"
"60610",0,0,0,0,"dummy"
"60611",0,0,1,1,"dummy"
"60612",0,0,0,0,"dummy"
"60613",0,0,1,1,"dummy"
"60614",0,0,0,0,"dummy"
"60615",1,2,0,3,"dummy"
"60616",0,0,1,1,"dummy"
"60617",0,0,1,1,"dummy"
"60618",0,0,1,1,"dummy"
"60619",0,0,0,0,"dummy"
"60620",0,0,1,1,"dummy"
"60621",0,0,1,1,"dummy"
"60622",0,0,1,1,"dummy"
"60623",0,0,1,1,"dummy"
"60624",0,0,0,0,"dummy"
"60625",0,0,0,0,"dummy"
"60643",6,0,0,6,"dummy"
"60644",0,0,1,1,"dummy"
"60646",0,11,6,17,"dummy"
"60647",0,0,1,1,"dummy"
"60648",0,0,1,1,"dummy"
"60649",0,0,1,1,"dummy"
"60651",0,2,0,2,"dummy"
"60653",0,0,0,0,"dummy"
"60654",0,1,0,1,"dummy"
"60656",0,0,1,1,"dummy"
"60657",0,0,1,1,"dummy"
"60659",0,7,0,7,"dummy"
"60662",1,0,1,2,"dummy"
"60663",0,0,1,1,"dummy"
"60670",0,0,0,0,"dummy"
"60671",1,4,0,5,"dummy"
"60672",3,2,4,9,"dummy"
"60673",1,0,4,5,"dummy"
"60674",1,0,4,5,"dummy"
"60675",0,0,1,1,"dummy"
"60676",0,0,0,0,"dummy"
"60677",0,0,1,1,"dummy"
"60678",0,0,0,0,"dummy"
"60679",0,0,0,0,"dummy"
"60680",1,7,0,8,"dummy"
"60681",0,5,0,5,"dummy"
"60682",0,2,0,2,"dummy"
"60683",0,0,1,1,"dummy"
"60684",0,0,1,1,"dummy"
"60685",0,0,0,0,"dummy"
"60686",0,0,0,0,"dummy"
"60687",0,1,0,1,"dummy"
"60688",0,0,3,3,"dummy"
"60689",2,1,3,6,"dummy"
"60690",1,0,0,1,"dummy"
"60691",0,0,1,1,"dummy"
"60692",0,1,0,1,"dummy"
"60693",0,1,1,2,"dummy"
"60694",0,1,0,1,"dummy"
"60695",6,1,0,7,"dummy"
"60696",0,1,0,1,"dummy"
"60697",0,1,0,1,"dummy"
"60698",3,14,0,17,"dummy"
"60699",6,6,0,12,"dummy"
"60700",11,0,3,14,"dummy"
"60701",0,1,0,1,"dummy"
"60702",0,0,0,0,"dummy"
"60703",0,2,0,2,"dummy"
"60704",1,0,0,1,"dummy"
"60705",0,0,0,0,"dummy"
"60706",0,0,0,0,"dummy"
"60707",0,12,2,14,"dummy"
"60708",0,0,0,0,"dummy"
"60709",0,0,0,0,"dummy"
"60710",0,0,0,0,"dummy"
"60711",0,0,0,0,"dummy"
"60712",0,0,0,0,"dummy"
"60713",5,0,0,5,"dummy"
"60714",0,1,0,1,"dummy"
"60715",0,0,1,1,"dummy"
"60716",0,0,1,1,"dummy"
"60717",1,1,0,2,"dummy"
"60732",0,3,0,3,"dummy"
"60735",0,0,2,2,"dummy"
"60736",0,6,0,6,"dummy"
"60741",0,9,1,10,"dummy"
"60742",1,3,0,4,"dummy"
"60743",0,0,1,1,"dummy"
"60744",0,0,1,1,"dummy"
"60745",0,0,1,1,"dummy"
"60746",1,3,0,4,"dummy"
"60747",0,2,0,2,"dummy"
"60748",0,1,0,1,"dummy"
"60749",0,2,0,2,"dummy"
"60750",0,1,0,1,"dummy"
"60751",0,3,0,3,"dummy"
"60752",0,0,1,1,"dummy"
"60753",0,3,0,3,"dummy"
"60754",19,23,2,44,"dummy"
"60755",0,0,4,4,"dummy"
"60756",0,0,2,2,"dummy"
"60757",0,0,2,2,"dummy"
"60774",0,0,1,1,"dummy"
"60775",0,1,0,1,"dummy"
"60777",3,3,1,7,"dummy"
"60778",0,1,0,1,"dummy"
"60779",0,1,0,1,"dummy"
"60780",0,2,1,3,"dummy"
"60781",1,0,0,1,"dummy"
"60782",0,1,0,1,"dummy"
"60783",0,0,1,1,"dummy"
"60784",0,0,1,1,"dummy"
"60785",0,0,1,1,"dummy"
"60786",1,1,0,2,"dummy"
"60787",0,0,1,1,"dummy"
"60789",0,2,0,2,"dummy"
"60790",0,3,0,3,"dummy"
"60791",0,3,0,3,"dummy"
"60792",0,0,1,1,"dummy"
"60794",0,0,1,1,"dummy"
"60796",0,0,1,1,"dummy"
"60797",29,2,1,32,"dummy"
"60798",1,0,0,1,"dummy"
"60800",0,3,0,3,"dummy"
"60802",0,4,0,4,"dummy"
"60803",3,5,0,8,"dummy"
"60804",0,3,0,3,"dummy"
"60805",0,1,0,1,"dummy"
"60806",0,0,2,2,"dummy"
"60807",0,0,2,2,"dummy"
"60808",1,1,0,2,"dummy"
"60809",3,16,1,20,"dummy"
"60810",0,0,2,2,"dummy"
"60811",0,0,1,1,"dummy"
"60812",2,4,0,6,"dummy"
"60813",0,6,0,6,"dummy"
"60814",0,0,1,1,"dummy"
"60815",0,0,1,1,"dummy"
"60816",1,0,0,1,"dummy"
"60817",0,0,0,0,"dummy"
"60818",0,0,1,1,"dummy"
"60819",0,0,0,0,"dummy"
"60820",0,2,0,2,"dummy"
"60821",0,1,0,1,"dummy"
"60822",0,0,1,1,"dummy"
"60823",1,3,3,7,"dummy"
"60824",0,0,1,1,"dummy"
"60825",1,2,1,4,"dummy"
"60826",2,1,1,4,"dummy"
"60827",6,6,7,19,"dummy"
"60828",0,4,0,4,"dummy"
"60829",6,6,2,14,"dummy"
"60830",0,3,0,3,"dummy"
"60831",1,5,0,6,"dummy"
"60832",0,3,1,4,"dummy"
"60833",39,43,17,99,"dummy"
"60834",39,36,14,89,"dummy"
"60835",39,43,17,99,"dummy"
"60836",39,36,14,89,"dummy"
"60837",39,49,17,105,"dummy"
"60838",1,0,1,2,"dummy"
"60839",0,1,0,1,"dummy"
"60840",1,0,0,1,"dummy"
"60841",0,1,0,1,"dummy"
"60842",1,1,0,2,"dummy"
"60843",0,0,1,1,"dummy"
"60844",8,4,2,14,"dummy"
"60845",1,4,1,6,"dummy"
"60846",0,3,0,3,"dummy"
"60847",0,6,1,7,"dummy"
"60848",0,1,1,2,"dummy"
"60849",5,8,1,14,"dummy"
"60850",0,2,0,2,"dummy"
"60863",1,0,0,1,"dummy"
"60864",6,2,0,8,"dummy"
"60896",0,0,0,0,"dummy"
"60913",0,2,0,2,"dummy"
"60914",1,0,0,1,"dummy"
"60928",4,11,0,15,"dummy"
"60929",0,3,2,5,"dummy"
"60930",0,2,0,2,"dummy"
"60940",18,0,0,18,"dummy"
"60941",0,3,0,3,"dummy"
"60942",0,0,2,2,"dummy"
"60943",0,0,3,3,"dummy"
"60946",1,0,0,1,"dummy"
"60947",0,2,2,4,"dummy"
"61027",0,15,1,16,"dummy"
"61028",0,3,0,3,"dummy"
"61029",0,0,1,1,"dummy"
"61030",0,0,1,1,"dummy"
"61031",1,1,0,2,"dummy"
"61032",1,1,0,2,"dummy"
"61033",0,2,2,4,"dummy"
"61034",1,1,0,2,"dummy"
"61035",5,1,0,6,"dummy"
"61036",0,0,1,1,"dummy"
"61037",4,1,0,5,"dummy"
"61038",1,5,0,6,"dummy"
"61039",1,0,1,2,"dummy"
"61040",2,3,1,6,"dummy"
"61041",1,3,0,4,"dummy"
"61042",8,0,0,8,"dummy"
"61043",1,2,1,4,"dummy"
"61044",0,0,1,1,"dummy"
"61045",0,0,3,3,"dummy"
"61046",0,0,3,3,"dummy"
"61047",0,0,3,3,"dummy"
"61048",1,0,0,1,"dummy"
"61049",0,0,1,1,"dummy"
"61050",1,0,2,3,"dummy"
"61051",0,1,0,1,"dummy"
"61052",0,0,0,0,"dummy"
"61053",0,1,0,1,"dummy"
"61054",1,1,3,5,"dummy"
"61055",0,0,0,0,"dummy"
"61056",0,0,0,0,"dummy"
"61057",0,0,1,1,"dummy"
"61058",23,5,5,33,"dummy"
"61081",0,1,1,2,"dummy"
"61089",0,1,0,1,"dummy"
"61100",0,1,0,1,"dummy"
"61101",0,1,0,1,"dummy"
"61102",0,5,0,5,"dummy"
"61103",0,4,0,4,"dummy"
"61104",0,2,0,2,"dummy"
"61105",1,5,0,6,"dummy"
"61106",0,1,0,1,"dummy"
"61107",0,4,0,4,"dummy"
"61108",0,4,1,5,"dummy"
"60852",0,1,0,1,"dummy"
"60853",0,1,0,1,"dummy"
"60854",1,0,0,1,"dummy"
"60857",3,0,0,3,"dummy"
"60858",0,2,1,3,"dummy"
"60859",1,1,0,2,"dummy"
"60860",0,0,2,2,"dummy"
"60861",1,0,0,1,"dummy"
"60866",2,0,0,2,"dummy"
"60867",1,0,2,3,"dummy"
"60898",11,2,3,16,"dummy"
"60899",11,20,0,31,"dummy"
"60900",1,1,0,2,"dummy"
"60901",0,6,0,6,"dummy"
"60902",0,0,1,1,"dummy"
"60903",0,2,0,2,"dummy"
"60904",0,4,0,4,"dummy"
"60905",0,1,1,2,"dummy"
"60906",0,11,0,11,"dummy"
"60907",0,1,0,1,"dummy"
"60908",0,3,0,3,"dummy"
"60909",0,0,1,1,"dummy"
"60910",3,0,8,11,"dummy"
"60911",2,0,0,2,"dummy"
"60918",0,0,1,1,"dummy"
"60919",0,0,1,1,"dummy"
"60920",0,0,2,2,"dummy"
"60921",2,0,4,6,"dummy"
"60922",0,0,4,4,"dummy"
"60923",0,0,1,1,"dummy"
"60926",0,1,0,1,"dummy"
"60932",0,1,0,1,"dummy"
"60933",0,1,0,1,"dummy"
"60934",4,4,1,9,"dummy"
"60935",6,1,0,7,"dummy"
"60936",0,0,0,0,"dummy"
"60953",0,1,0,1,"dummy"
"60954",0,1,0,1,"dummy"
"60955",0,2,0,2,"dummy"
"60956",0,2,0,2,"dummy"
"60957",0,0,1,1,"dummy"
"60958",9,2,1,12,"dummy"
"60984",0,0,1,1,"dummy"
"60985",0,1,0,1,"dummy"
"60988",0,1,0,1,"dummy"
"60989",0,1,0,1,"dummy"
"60990",1,0,0,1,"dummy"
"60995",0,1,0,1,"dummy"
"60996",2,2,0,4,"dummy"
"60997",3,1,1,5,"dummy"
"60998",0,6,0,6,"dummy"
"60999",0,1,0,1,"dummy"
"61018",0,4,0,4,"dummy"
"61019",0,8,0,8,"dummy"
"61020",0,17,3,20,"dummy"
"61021",0,3,0,3,"dummy"
"61022",0,1,0,1,"dummy"
"61023",2,12,4,18,"dummy"
"61024",0,8,0,8,"dummy"
"61025",8,17,0,25,"dummy"
"61064",0,2,0,2,"dummy"
"61065",0,0,1,1,"dummy"
"61066",2,0,0,2,"dummy"
"61067",0,0,1,1,"dummy"
"61091",0,0,1,1,"dummy"
"61094",0,1,0,1,"dummy"
"61095",0,1,0,1,"dummy"
"61096",0,0,1,1,"dummy"
"61117",0,2,0,2,"dummy"
"61118",0,0,0,0,"dummy"
"61119",0,0,1,1,"dummy"
"61120",0,0,1,1,"dummy"
"61121",0,0,1,1,"dummy"
"61122",0,0,1,1,"dummy"
"61123",0,0,1,1,"dummy"
"61109",0,1,0,1,"dummy"
"61110",0,3,0,3,"dummy"
"61111",0,3,0,3,"dummy"
"61112",0,4,0,4,"dummy"
"61113",12,10,3,25,"dummy"
"61114",0,0,2,2,"dummy"
"61115",0,2,0,2,"dummy"
"61125",0,0,5,5,"dummy"
"61128",2,3,0,5,"dummy"
"61129",2,0,0,2,"dummy"
"61130",7,0,0,7,"dummy"
"61131",1,0,0,1,"dummy"
"61132",0,0,0,0,"dummy"
"61133",0,0,0,0,"dummy"
"61136",1,0,0,1,"dummy"
"61137",0,1,0,1,"dummy"
"61138",8,3,0,11,"dummy"
"61139",0,1,0,1,"dummy"
"61140",7,0,2,9,"dummy"
"61153",0,2,0,2,"dummy"
"61154",6,8,2,16,"dummy"
"61168",0,0,0,0,"dummy"
"61310",0,0,1,1,"dummy"
"61311",0,0,1,1,"dummy"
"61312",3,4,1,8,"dummy"
"61313",0,0,1,1,"dummy"
"61314",0,0,2,2,"dummy"
"61315",0,0,2,2,"dummy"
"61316",0,0,1,1,"dummy"
"61317",0,0,1,1,"dummy"
"61318",0,0,1,1,"dummy"
"61319",0,0,1,1,"dummy"
"61320",0,0,1,1,"dummy"
"61321",0,0,1,1,"dummy"
"61322",0,0,1,1,"dummy"
"61323",0,0,1,1,"dummy"
"61331",0,3,2,5,"dummy"
"61332",2,1,2,5,"dummy"
"61360",2,3,0,5,"dummy"
"61361",0,0,3,3,"dummy"
"61366",0,0,1,1,"dummy"
"61367",0,1,0,1,"dummy"
"61380",0,0,0,0,"dummy"
"61381",0,0,4,4,"dummy"
"61382",0,2,0,2,"dummy"
"61383",0,0,0,0,"dummy"
"61384",1,3,0,4,"dummy"
"61391",1,8,0,9,"dummy"
"61392",0,0,2,2,"dummy"
"61393",0,5,0,5,"dummy"
"61394",9,2,2,13,"dummy"
"61395",0,1,0,1,"dummy"
"61396",0,1,0,1,"dummy"
"61407",0,3,0,3,"dummy"
"61413",0,0,0,0,"dummy"
"61414",0,0,0,0,"dummy"
"61415",0,0,0,0,"dummy"
"61416",0,0,0,0,"dummy"
"61417",0,0,0,0,"dummy"
"61418",0,0,0,0,"dummy"
"61419",0,0,0,0,"dummy"
"61440",0,1,2,3,"dummy"
"61443",0,3,0,3,"dummy"
"61444",0,0,0,0,"dummy"
"61445",0,1,0,1,"dummy"
"61452",2,3,1,6,"dummy"
"61453",2,1,0,3,"dummy"
"61454",0,0,0,0,"dummy"
"61466",0,1,0,1,"dummy"
"61467",1,0,0,1,"dummy"
"61142",23,6,0,29,"dummy"
"61143",1,2,4,7,"dummy"
"61144",3,5,0,8,"dummy"
"61145",0,5,0,5,"dummy"
"61148",0,7,0,7,"dummy"
"61149",0,6,1,7,"dummy"
"61150",2,3,2,7,"dummy"
"61151",0,8,1,9,"dummy"
"61158",0,0,2,2,"dummy"
"61159",0,2,0,2,"dummy"
"61160",0,0,0,0,"dummy"
"61161",0,2,0,2,"dummy"
"61162",4,1,0,5,"dummy"
"61163",1,0,0,1,"dummy"
"61164",0,0,0,0,"dummy"
"61165",0,0,0,0,"dummy"
"61166",0,0,0,0,"dummy"
"61172",0,0,1,1,"dummy"
"61173",0,0,3,3,"dummy"
"61174",0,0,3,3,"dummy"
"61175",0,0,1,1,"dummy"
"61176",0,0,1,1,"dummy"
"61177",0,0,1,1,"dummy"
"61178",0,0,1,1,"dummy"
"61179",0,0,1,1,"dummy"
"61180",0,0,1,1,"dummy"
"61181",0,0,1,1,"dummy"
"61182",0,0,1,1,"dummy"
"61183",0,0,1,1,"dummy"
"61184",0,0,1,1,"dummy"
"61185",0,0,1,1,"dummy"
"61186",0,0,1,1,"dummy"
"61187",0,0,1,1,"dummy"
"61188",0,0,1,1,"dummy"
"61189",0,0,1,1,"dummy"
"61190",0,0,1,1,"dummy"
"61191",0,0,1,1,"dummy"
"61192",0,0,1,1,"dummy"
"61193",0,0,1,1,"dummy"
"61194",0,0,1,1,"dummy"
"61195",0,0,1,1,"dummy"
"61196",0,0,1,1,"dummy"
"61197",0,0,1,1,"dummy"
"61198",0,0,2,2,"dummy"
"61199",0,0,2,2,"dummy"
"61200",0,0,1,1,"dummy"
"61201",0,0,1,1,"dummy"
"61202",0,0,1,1,"dummy"
"61203",0,0,1,1,"dummy"
"61204",0,0,1,1,"dummy"
"61205",0,0,1,1,"dummy"
"61206",0,0,1,1,"dummy"
"61207",0,0,1,1,"dummy"
"61208",0,0,1,1,"dummy"
"61209",0,0,1,1,"dummy"
"61210",0,0,2,2,"dummy"
"61211",0,0,1,1,"dummy"
"61212",0,0,1,1,"dummy"
"61213",0,0,1,1,"dummy"
"61214",0,0,1,1,"dummy"
"61215",0,0,2,2,"dummy"
"61216",0,0,1,1,"dummy"
"61217",0,0,1,1,"dummy"
"61218",0,0,1,1,"dummy"
"61219",0,0,1,1,"dummy"
"61220",0,0,1,1,"dummy"
"61221",0,0,1,1,"dummy"
"61222",0,0,1,1,"dummy"
"61223",0,0,1,1,"dummy"
"61224",0,0,1,1,"dummy"
"61225",0,0,1,1,"dummy"
"61226",0,0,2,2,"dummy"
"61227",0,0,1,1,"dummy"
"61228",0,0,1,1,"dummy"
"61229",0,0,1,1,"dummy"
"61230",0,0,1,1,"dummy"
"61231",0,0,1,1,"dummy"
"61232",0,0,1,1,"dummy"
"61233",0,0,1,1,"dummy"
"61234",0,0,1,1,"dummy"
"61235",0,0,1,1,"dummy"
"61236",0,0,1,1,"dummy"
"61237",0,0,1,1,"dummy"
"61238",0,0,1,1,"dummy"
"61239",0,0,1,1,"dummy"
"61240",0,0,1,1,"dummy"
"61241",0,0,1,1,"dummy"
"61242",0,0,1,1,"dummy"
"61243",0,0,1,1,"dummy"
"61244",0,0,1,1,"dummy"
"61245",0,0,1,1,"dummy"
"61246",0,0,1,1,"dummy"
"61247",0,0,1,1,"dummy"
"61248",0,0,1,1,"dummy"
"61249",0,0,1,1,"dummy"
"61250",0,0,1,1,"dummy"
"61251",0,0,1,1,"dummy"
"61252",0,0,1,1,"dummy"
"61253",0,0,1,1,"dummy"
"61254",0,0,1,1,"dummy"
"61255",0,0,1,1,"dummy"
"61256",0,0,1,1,"dummy"
"61257",0,0,1,1,"dummy"
"61258",0,0,1,1,"dummy"
"61259",0,0,1,1,"dummy"
"61260",0,0,1,1,"dummy"
"61261",0,0,1,1,"dummy"
"61262",0,0,1,1,"dummy"
"61263",0,0,1,1,"dummy"
"61264",0,0,1,1,"dummy"
"61265",0,0,1,1,"dummy"
"61266",0,0,1,1,"dummy"
"61267",0,0,1,1,"dummy"
"61268",0,0,1,1,"dummy"
"61269",0,0,1,1,"dummy"
"61270",0,0,1,1,"dummy"
"61271",0,0,1,1,"dummy"
"61272",0,0,1,1,"dummy"
"61273",0,0,1,1,"dummy"
"61274",0,0,1,1,"dummy"
"61275",0,0,1,1,"dummy"
"61276",0,0,1,1,"dummy"
"61277",0,0,1,1,"dummy"
"61278",0,0,1,1,"dummy"
"61279",0,0,1,1,"dummy"
"61280",0,0,1,1,"dummy"
"61281",0,0,1,1,"dummy"
"61282",0,0,1,1,"dummy"
"61283",0,0,1,1,"dummy"
"61284",0,0,2,2,"dummy"
"61285",0,0,1,1,"dummy"
"61286",0,0,1,1,"dummy"
"61287",0,0,1,1,"dummy"
"61288",0,0,1,1,"dummy"
"61289",0,0,1,1,"dummy"
"61290",0,0,1,1,"dummy"
"61291",0,0,2,2,"dummy"
"61292",0,0,1,1,"dummy"
"61293",0,0,1,1,"dummy"
"61294",0,0,1,1,"dummy"
"61295",0,0,1,1,"dummy"
"61296",0,0,1,1,"dummy"
"61297",0,0,1,1,"dummy"
"61298",0,0,1,1,"dummy"
"61299",0,0,1,1,"dummy"
"61300",0,0,1,1,"dummy"
"61301",0,0,1,1,"dummy"
"61302",0,0,1,1,"dummy"
"61303",0,0,1,1,"dummy"
"61304",0,0,1,1,"dummy"
"61305",0,0,1,1,"dummy"
"61306",0,0,1,1,"dummy"
"61307",0,0,1,1,"dummy"
"61308",0,0,2,2,"dummy"
"61334",1,1,0,2,"dummy"
"61335",1,1,5,7,"dummy"
"61336",1,0,5,6,"dummy"
"61339",0,0,1,1,"dummy"
"61340",0,0,1,1,"dummy"
"61341",0,0,1,1,"dummy"
"61342",0,0,1,1,"dummy"
"61343",0,0,0,0,"dummy"
"61344",0,0,0,0,"dummy"
"61369",0,2,1,3,"dummy"
"61370",2,0,1,3,"dummy"
"61371",2,1,0,3,"dummy"
"61372",0,1,0,1,"dummy"
"61373",0,1,0,1,"dummy"
"61374",2,6,0,8,"dummy"
"61386",0,3,1,4,"dummy"
"61387",0,0,1,1,"dummy"
"61388",0,0,1,1,"dummy"
"61389",0,0,1,1,"dummy"
"61402",0,0,1,1,"dummy"
"61403",2,7,1,10,"dummy"
"61421",5,4,4,13,"dummy"
"61422",0,0,1,1,"dummy"
"61423",0,0,1,1,"dummy"
"61424",2,0,0,2,"dummy"
"61425",0,0,1,1,"dummy"
"61426",0,0,1,1,"dummy"
"61427",0,0,1,1,"dummy"
"61428",0,0,1,1,"dummy"
"61429",0,0,1,1,"dummy"
"61430",0,0,1,1,"dummy"
"61431",0,0,1,1,"dummy"
"61434",1,5,1,7,"dummy"
"61435",2,4,1,7,"dummy"
"61438",0,1,1,2,"dummy"
"61447",1,1,0,2,"dummy"
"61448",1,1,0,2,"dummy"
"61449",1,2,0,3,"dummy"
"61450",1,0,1,2,"dummy"
"61456",0,2,2,4,"dummy"
"61457",0,0,4,4,"dummy"
"61458",0,0,1,1,"dummy"
"61459",18,1,0,19,"dummy"
"61460",0,0,1,1,"dummy"
"61461",0,2,0,2,"dummy"
"61462",0,0,1,1,"dummy"
"61486",7,1,1,9,"dummy"
"61489",0,0,1,1,"dummy"
"61490",0,1,0,1,"dummy"
"61491",0,0,1,1,"dummy"
"61492",0,1,4,5,"dummy"
"61493",1,3,4,8,"dummy"
"61494",0,1,4,5,"dummy"
"61502",2,2,0,4,"dummy"
"61503",4,4,0,8,"dummy"
"61504",3,5,0,8,"dummy"
"61505",0,5,0,5,"dummy"
"61513",0,0,0,0,"dummy"
"61514",0,2,3,5,"dummy"
"61515",2,2,3,7,"dummy"
"61518",0,1,0,1,"dummy"
"61541",41,17,3,61,"dummy"
"61542",0,1,0,1,"dummy"
"61543",0,2,0,2,"dummy"
"61544",0,1,0,1,"dummy"
"61554",0,0,0,0,"dummy"
"61555",0,2,0,2,"dummy"
"61561",0,0,1,1,"dummy"
"61572",0,1,0,1,"dummy"
"61578",0,3,0,3,"dummy"
"61579",6,8,3,17,"dummy"
"61580",1,3,0,4,"dummy"
"61581",2,4,0,6,"dummy"
"61582",6,3,0,9,"dummy"
"61583",1,1,0,2,"dummy"
"61584",0,0,2,2,"dummy"
"61585",1,1,0,2,"dummy"
"61615",0,4,0,4,"dummy"
"61623",0,0,2,2,"dummy"
"61632",0,0,0,0,"dummy"
"61647",0,1,0,1,"dummy"
"61648",3,8,0,11,"dummy"
"61683",0,0,0,0,"dummy"
"61496",0,0,0,0,"dummy"
"61499",0,0,1,1,"dummy"
"61500",0,0,1,1,"dummy"
"61511",0,0,1,1,"dummy"
"61537",0,0,0,0,"dummy"
"61538",0,0,1,1,"dummy"
"61539",0,0,1,1,"dummy"
"61546",12,2,5,19,"dummy"
"61547",5,0,3,8,"dummy"
"61548",0,0,2,2,"dummy"
"61567",0,0,0,0,"dummy"
"61568",0,0,0,0,"dummy"
"61587",1,16,1,18,"dummy"
"61588",1,3,0,4,"dummy"
"61619",0,0,0,0,"dummy"
"61625",0,1,0,1,"dummy"
"61630",0,0,2,2,"dummy"
"61652",0,2,3,5,"dummy"
"61653",1,2,1,4,"dummy"
"61654",1,0,0,1,"dummy"
"61655",0,1,0,1,"dummy"
"61656",0,4,0,4,"dummy"
"61657",1,0,0,1,"dummy"
"61658",0,3,0,3,"dummy"
"61659",0,1,0,1,"dummy"
"61660",0,1,0,1,"dummy"
"61681",14,0,1,15,"dummy"
"61685",0,0,1,1,"dummy"
"61686",0,5,0,5,"dummy"
"61687",0,0,1,1,"dummy"
"61704",0,1,0,1,"dummy"
"61705",0,4,0,4,"dummy"
"61706",0,0,1,1,"dummy"
"61707",5,0,0,5,"dummy"
"61708",0,0,1,1,"dummy"
"61709",0,0,2,2,"dummy"
"61736",12,12,2,26,"dummy"
"61737",5,1,1,7,"dummy"
"61738",0,0,1,1,"dummy"
"61739",0,0,1,1,"dummy"
"61740",0,0,1,1,"dummy"
"61741",6,1,0,7,"dummy"
"61742",1,0,0,1,"dummy"
"61743",2,4,3,9,"dummy"
"61689",0,1,0,1,"dummy"
"61690",0,0,1,1,"dummy"
"61691",0,0,1,1,"dummy"
"61692",0,0,0,0,"dummy"
"61693",0,0,0,0,"dummy"
"61694",0,0,0,0,"dummy"
"61695",0,1,0,1,"dummy"
"61696",2,0,1,3,"dummy"
"61697",0,1,0,1,"dummy"
"61698",0,1,1,2,"dummy"
"61699",2,0,0,2,"dummy"
"61700",0,1,0,1,"dummy"
"61701",1,0,0,1,"dummy"
"61702",3,1,0,4,"dummy"
"61720",1,0,0,1,"dummy"
"61723",4,6,4,14,"dummy"
"61724",1,4,0,5,"dummy"
"61725",0,1,0,1,"dummy"
"61726",0,0,1,1,"dummy"
"61727",0,1,1,2,"dummy"
"61728",0,0,1,1,"dummy"
"61729",0,0,1,1,"dummy"
"61730",0,0,2,2,"dummy"
"61731",0,0,1,1,"dummy"
"61732",0,0,1,1,"dummy"
"61733",0,0,1,1,"dummy"
"61734",0,0,1,1,"dummy"
"61747",2,5,2,9,"dummy"
"61753",3,4,1,8,"dummy"
"61754",7,4,0,11,"dummy"
"61755",4,1,0,5,"dummy"
"61757",2,4,2,8,"dummy"
"61758",3,0,0,3,"dummy"
"61759",4,0,0,4,"dummy"
"61761",4,9,0,13,"dummy"
"61762",0,0,1,1,"dummy"
"61763",2,0,0,2,"dummy"
"61767",0,4,0,4,"dummy"
"61768",4,0,0,4,"dummy"
"61769",0,2,0,2,"dummy"
"61770",0,3,0,3,"dummy"
"61771",0,0,1,1,"dummy"
"61773",0,1,0,1,"dummy"
"61774",2,3,1,6,"dummy"
"61777",0,1,0,1,"dummy"
"61778",10,3,3,16,"dummy"
"61780",0,2,3,5,"dummy"
"61782",0,0,2,2,"dummy"
"61783",3,0,1,4,"dummy"
"61784",0,0,2,2,"dummy"
"61785",0,1,0,1,"dummy"
"61786",0,0,2,2,"dummy"
"61790",1,1,0,2,"dummy"
"61791",1,0,0,1,"dummy"
"61792",8,11,0,19,"dummy"
"61794",8,1,0,9,"dummy"
"61796",0,0,1,1,"dummy"
"61797",0,1,0,1,"dummy"
"61798",0,4,0,4,"dummy"
"61799",5,5,1,11,"dummy"
"61803",0,0,0,0,"dummy"
"61804",11,4,2,17,"dummy"
"61805",1,0,2,3,"dummy"
"61807",0,2,0,2,"dummy"
"61809",0,2,2,4,"dummy"
"61815",2,4,0,6,"dummy"
"61816",0,2,0,2,"dummy"
"61817",0,2,0,2,"dummy"
"61818",10,2,0,12,"dummy"
"61819",0,2,0,2,"dummy"
"61820",0,0,0,0,"dummy"
"61832",0,1,0,1,"dummy"
"61834",0,0,0,0,"dummy"
"61835",0,0,0,0,"dummy"
"61837",0,0,1,1,"dummy"
"61838",0,13,0,13,"dummy"
"61839",0,1,0,1,"dummy"
"61840",0,1,0,1,"dummy"
"61842",0,0,1,1,"dummy"
"61848",5,7,0,12,"dummy"
"61849",0,0,3,3,"dummy"
"61852",2,2,0,4,"dummy"
"61853",0,0,3,3,"dummy"
"61856",2,4,0,6,"dummy"
"61857",0,2,0,2,"dummy"
"61858",0,2,0,2,"dummy"
"61859",10,2,0,12,"dummy"
"61860",0,2,0,2,"dummy"
"61861",0,0,0,0,"dummy"
"61862",0,0,3,3,"dummy"
"61865",0,0,0,0,"dummy"
"61866",0,1,0,1,"dummy"
"61867",0,1,0,1,"dummy"
"61868",0,0,1,1,"dummy"
"61869",2,2,2,6,"dummy"
"61870",0,0,1,1,"dummy"
"61871",0,1,0,1,"dummy"
"61874",3,17,2,22,"dummy"
"61875",0,1,0,1,"dummy"
"61876",0,9,0,9,"dummy"
"61877",3,4,0,7,"dummy"
"61878",2,8,0,10,"dummy"
"61881",4,9,1,14,"dummy"
"61882",1,4,0,5,"dummy"
"61883",0,0,0,0,"dummy"
"61884",0,1,0,1,"dummy"
"61885",0,1,0,1,"dummy"
"61886",0,3,0,3,"dummy"
"61887",0,0,1,1,"dummy"
"61888",0,1,0,1,"dummy"
"61889",6,8,0,14,"dummy"
"61890",1,0,0,1,"dummy"
"61893",2,4,0,6,"dummy"
"61894",0,2,0,2,"dummy"
"61895",0,2,0,2,"dummy"
"61896",10,2,0,12,"dummy"
"61897",0,2,0,2,"dummy"
"61898",0,0,0,0,"dummy"
"61899",0,0,3,3,"dummy"
"61900",0,5,0,5,"dummy"
"61902",0,0,1,1,"dummy"
"61903",0,1,1,2,"dummy"
"61905",3,2,6,11,"dummy"
"61906",0,3,0,3,"dummy"
"61907",2,1,1,4,"dummy"
"61908",0,2,0,2,"dummy"
"61909",0,4,1,5,"dummy"
"61911",0,0,1,1,"dummy"
"61912",0,0,2,2,"dummy"
"61913",0,1,2,3,"dummy"
"61914",0,0,3,3,"dummy"
"61915",2,0,4,6,"dummy"
"61916",0,1,0,1,"dummy"
"61917",0,0,1,1,"dummy"
"61919",0,0,0,0,"dummy"
"61921",1,0,1,2,"dummy"
"61925",0,0,3,3,"dummy"
"61926",0,0,0,0,"dummy"
"61927",0,0,0,0,"dummy"
"61928",0,0,3,3,"dummy"
"61929",0,0,0,0,"dummy"
"61930",0,1,0,1,"dummy"
"61931",0,3,5,8,"dummy"
"61932",0,0,1,1,"dummy"
"61933",2,4,1,7,"dummy"
"61934",0,1,0,1,"dummy"
"61935",0,0,1,1,"dummy"
"61936",0,0,1,1,"dummy"
"61937",0,0,1,1,"dummy"
"61938",1,0,0,1,"dummy"
"61939",7,3,2,12,"dummy"
"61940",1,2,3,6,"dummy"
"61941",0,3,0,3,"dummy"
"61942",2,2,2,6,"dummy"
"61944",0,0,0,0,"dummy"
"61945",0,1,0,1,"dummy"
"61946",2,3,0,5,"dummy"
"61948",0,1,0,1,"dummy"
"61949",0,2,0,2,"dummy"
"61950",0,1,1,2,"dummy"
"61952",0,13,0,13,"dummy"
"61953",6,3,3,12,"dummy"
"61954",0,0,1,1,"dummy"
"61955",0,2,0,2,"dummy"
"61958",0,0,0,0,"dummy"
"61959",0,0,0,0,"dummy"
"61961",0,0,1,1,"dummy"
"61962",0,1,0,1,"dummy"
"61963",0,0,2,2,"dummy"
"61964",0,0,2,2,"dummy"
"61965",0,0,1,1,"dummy"
"61968",0,2,1,3,"dummy"
"61969",0,0,1,1,"dummy"
"61971",0,0,2,2,"dummy"
"61972",7,7,2,16,"dummy"
"61973",0,0,1,1,"dummy"
"61974",3,3,1,7,"dummy"
"61975",0,1,0,1,"dummy"
"61976",3,4,2,9,"dummy"
"61977",4,3,2,9,"dummy"
"61978",0,1,0,1,"dummy"
"61979",0,0,1,1,"dummy"
"61980",0,2,0,2,"dummy"
"61982",0,0,0,0,"dummy"
"61983",0,0,2,2,"dummy"
"61984",0,0,0,0,"dummy"
"61985",0,0,1,1,"dummy"
"61986",0,0,0,0,"dummy"
"61987",2,0,1,3,"dummy"
"61988",2,0,0,2,"dummy"
"61991",1,0,5,6,"dummy"
"61992",1,4,1,6,"dummy"
"61996",0,0,1,1,"dummy"
"61997",0,4,1,5,"dummy"
"61998",0,10,1,11,"dummy"
"62000",0,0,1,1,"dummy"
"62005",1,0,0,1,"dummy"
"62006",0,1,0,1,"dummy"
"62009",0,1,0,1,"dummy"
"62011",7,7,1,15,"dummy"
"62012",1,7,0,8,"dummy"
"62013",0,0,1,1,"dummy"
"62015",0,0,4,4,"dummy"
"62018",2,4,0,6,"dummy"
"62019",0,2,0,2,"dummy"
"62020",0,2,0,2,"dummy"
"62021",10,2,0,12,"dummy"
"62022",0,2,0,2,"dummy"
"62023",0,0,0,0,"dummy"
"62024",0,0,3,3,"dummy"
"62025",0,5,0,5,"dummy"
"62026",1,0,1,2,"dummy"
"62029",0,2,0,2,"dummy"
"62031",0,0,1,1,"dummy"
"62032",0,1,0,1,"dummy"
"62033",0,4,0,4,"dummy"
"62035",0,0,0,0,"dummy"
"62038",0,1,0,1,"dummy"
"62043",0,3,0,3,"dummy"
"62044",0,3,0,3,"dummy"
"62045",0,2,0,2,"dummy"
"62046",0,10,0,10,"dummy"
"62047",0,7,0,7,"dummy"
"62048",2,0,0,2,"dummy"
"62049",0,1,1,2,"dummy"
"62050",0,0,1,1,"dummy"
"62051",0,0,2,2,"dummy"
"62052",0,3,0,3,"dummy"
"62053",1,3,0,4,"dummy"
"62054",0,2,0,2,"dummy"
"62055",0,2,0,2,"dummy"
"62056",0,0,1,1,"dummy"
"62057",0,0,2,2,"dummy"
"62058",0,5,1,6,"dummy"
"62059",0,2,1,3,"dummy"
"62060",0,1,0,1,"dummy"
"62061",0,0,1,1,"dummy"
"62067",0,0,2,2,"dummy"
"62068",0,0,2,2,"dummy"
"62069",0,2,0,2,"dummy"
"62070",0,0,1,1,"dummy"
"62071",0,1,0,1,"dummy"
"62072",0,2,1,3,"dummy"
"62074",0,0,1,1,"dummy"
"62079",0,0,2,2,"dummy"
"62080",0,0,0,0,"dummy"
"62081",0,0,0,0,"dummy"
"62082",0,1,0,1,"dummy"
"62083",0,1,0,1,"dummy"
"62084",1,0,0,1,"dummy"
"62086",15,2,2,19,"dummy"
"62087",2,15,2,19,"dummy"
"62108",0,6,0,6,"dummy"
"62111",0,0,0,0,"dummy"
"62112",0,0,0,0,"dummy"
"62115",0,1,0,1,"dummy"
"62116",0,2,0,2,"dummy"
"62118",0,0,1,1,"dummy"
"62119",0,0,1,1,"dummy"
"62120",0,1,0,1,"dummy"
"62122",0,1,0,1,"dummy"
"62125",13,2,1,16,"dummy"
"62126",2,0,1,3,"dummy"
"62129",0,8,1,9,"dummy"
"62133",2,4,0,6,"dummy"
"62134",0,4,7,11,"dummy"
"62135",0,0,1,1,"dummy"
"62136",0,1,0,1,"dummy"
"62137",0,1,0,1,"dummy"
"62138",0,0,13,13,"dummy"
"62139",0,0,14,14,"dummy"
"62145",7,3,0,10,"dummy"
"62168",1,6,0,7,"dummy"
"62169",0,2,0,2,"dummy"
"62170",0,1,0,1,"dummy"
"62171",4,4,2,10,"dummy"
"62186",0,0,1,1,"dummy"
"62187",0,0,1,1,"dummy"
"62188",0,0,1,1,"dummy"
"62189",0,3,0,3,"dummy"
"62190",0,0,1,1,"dummy"
"62191",0,0,1,1,"dummy"
"62192",0,0,1,1,"dummy"
"62193",0,0,1,1,"dummy"
"62194",0,0,1,1,"dummy"
"62201",0,1,0,1,"dummy"
"62202",0,0,0,0,"dummy"
"62203",0,3,1,4,"dummy"
"62204",9,0,0,9,"dummy"
"62205",0,1,0,1,"dummy"
"62206",0,0,0,0,"dummy"
"62239",0,2,0,2,"dummy"
"62240",0,2,3,5,"dummy"
"62241",0,8,0,8,"dummy"
"62318",0,0,1,1,"dummy"
"62329",3,2,0,5,"dummy"
"62330",0,0,0,0,"dummy"
"62331",2,10,1,13,"dummy"
"62332",2,5,0,7,"dummy"
"62335",0,0,0,0,"dummy"
"62336",0,0,0,0,"dummy"
"62355",0,0,0,0,"dummy"
"62363",22,10,0,32,"dummy"
"62364",0,0,1,1,"dummy"
"62365",10,22,0,32,"dummy"
"62366",11,10,0,21,"dummy"
"62367",18,0,0,18,"dummy"
"62368",0,5,0,5,"dummy"
"62369",2,0,0,2,"dummy"
"62370",0,2,0,2,"dummy"
"62371",5,1,0,6,"dummy"
"62372",2,17,0,19,"dummy"
"62380",0,0,1,1,"dummy"
"62381",0,0,1,1,"dummy"
"62382",4,11,4,19,"dummy"
"62383",0,0,1,1,"dummy"
"62384",0,4,0,4,"dummy"
"62385",0,1,0,1,"dummy"
"62398",2,0,2,4,"dummy"
"62402",2,0,2,4,"dummy"
"62407",2,10,0,12,"dummy"
"62415",0,1,0,1,"dummy"
"62478",0,0,0,0,"dummy"
"62483",1,0,1,2,"dummy"
"62484",4,4,0,8,"dummy"
"62485",0,5,0,5,"dummy"
"62486",0,2,1,3,"dummy"
"62487",0,2,0,2,"dummy"
"62488",2,1,0,3,"dummy"
"62489",1,2,0,3,"dummy"
"62490",2,0,0,2,"dummy"
"62491",2,0,1,3,"dummy"
"62492",4,4,0,8,"dummy"
"62493",0,0,1,1,"dummy"
"62504",0,2,2,4,"dummy"
"62505",1,2,1,4,"dummy"
"62506",0,0,0,0,"dummy"
"62529",0,1,0,1,"dummy"
"62530",0,0,1,1,"dummy"
"62531",0,0,1,1,"dummy"
"62532",0,0,1,1,"dummy"
"62535",0,0,1,1,"dummy"
"62196",1,2,0,3,"dummy"
"62197",1,1,0,2,"dummy"
"62198",0,4,0,4,"dummy"
"62199",0,0,0,0,"dummy"
"62210",0,1,1,2,"dummy"
"62211",8,7,1,16,"dummy"
"62212",7,25,0,32,"dummy"
"62213",7,6,3,16,"dummy"
"62214",1,0,0,1,"dummy"
"62215",0,1,0,1,"dummy"
"62216",2,1,0,3,"dummy"
"62217",6,1,7,14,"dummy"
"62218",7,6,3,16,"dummy"
"62219",0,0,0,0,"dummy"
"62220",0,0,0,0,"dummy"
"62221",0,3,1,4,"dummy"
"62222",0,2,0,2,"dummy"
"62223",3,4,2,9,"dummy"
"62224",7,0,0,7,"dummy"
"62243",0,1,0,1,"dummy"
"62244",0,0,1,1,"dummy"
"62245",0,0,0,0,"dummy"
"62246",0,0,0,0,"dummy"
"62249",3,3,1,7,"dummy"
"62264",6,0,0,6,"dummy"
"62265",2,5,2,9,"dummy"
"62268",0,0,0,0,"dummy"
"62269",0,0,0,0,"dummy"
"62314",1,1,1,3,"dummy"
"62338",23,13,2,38,"dummy"
"62339",2,2,0,4,"dummy"
"62340",18,2,2,22,"dummy"
"62341",1,0,0,1,"dummy"
"62342",0,0,0,0,"dummy"
"62343",0,0,0,0,"dummy"
"62344",0,0,1,1,"dummy"
"62345",0,0,2,2,"dummy"
"62346",0,0,1,1,"dummy"
"62347",0,0,1,1,"dummy"
"62348",0,1,1,2,"dummy"
"62349",0,0,1,1,"dummy"
"62350",0,0,1,1,"dummy"
"62351",0,0,1,1,"dummy"
"62352",0,0,1,1,"dummy"
"62353",0,0,1,1,"dummy"
"62359",10,18,3,31,"dummy"
"62376",2,0,0,2,"dummy"
"62400",2,15,1,18,"dummy"
"62404",3,11,0,14,"dummy"
"62405",0,0,0,0,"dummy"
"62411",0,1,0,1,"dummy"
"62412",0,0,1,1,"dummy"
"62413",4,12,1,17,"dummy"
"62419",0,7,4,11,"dummy"
"62420",2,2,2,6,"dummy"
"62421",0,1,0,1,"dummy"
"62422",10,2,2,14,"dummy"
"62423",6,6,1,13,"dummy"
"62424",5,5,0,10,"dummy"
"62425",5,5,0,10,"dummy"
"62426",1,1,0,2,"dummy"
"62427",2,2,0,4,"dummy"
"62428",1,1,1,3,"dummy"
"62429",0,2,1,3,"dummy"
"62430",1,10,1,12,"dummy"
"62431",6,5,1,12,"dummy"
"62432",2,0,0,2,"dummy"
"62433",1,2,1,4,"dummy"
"62434",3,1,0,4,"dummy"
"62435",2,1,0,3,"dummy"
"62436",3,3,0,6,"dummy"
"62437",0,6,0,6,"dummy"
"62438",1,1,0,2,"dummy"
"62439",1,1,0,2,"dummy"
"62440",1,1,0,2,"dummy"
"62441",0,0,0,0,"dummy"
"62442",0,0,0,0,"dummy"
"62443",0,1,0,1,"dummy"
"62444",2,2,0,4,"dummy"
"62445",1,1,0,2,"dummy"
"62446",0,2,0,2,"dummy"
"62447",0,1,0,1,"dummy"
"62448",0,1,0,1,"dummy"
"62449",1,1,0,2,"dummy"
"62450",0,0,1,1,"dummy"
"62451",0,0,1,1,"dummy"
"62452",2,2,2,6,"dummy"
"62453",1,2,2,5,"dummy"
"62454",0,0,0,0,"dummy"
"62455",1,0,1,2,"dummy"
"62456",1,1,0,2,"dummy"
"62457",1,1,0,2,"dummy"
"62458",2,1,0,3,"dummy"
"62459",0,0,1,1,"dummy"
"62460",0,1,0,1,"dummy"
"62461",1,0,0,1,"dummy"
"62462",0,0,1,1,"dummy"
"62463",1,1,1,3,"dummy"
"62464",0,1,0,1,"dummy"
"62465",4,7,1,12,"dummy"
"62466",3,0,0,3,"dummy"
"62467",0,0,1,1,"dummy"
"62468",2,3,0,5,"dummy"
"62469",0,1,0,1,"dummy"
"62470",3,2,1,6,"dummy"
"62471",0,0,2,2,"dummy"
"62474",0,1,0,1,"dummy"
"62475",0,1,0,1,"dummy"
"62476",0,0,2,2,"dummy"
"62480",0,1,0,1,"dummy"
"62481",0,9,0,9,"dummy"
"62495",0,0,1,1,"dummy"
"62496",0,2,0,2,"dummy"
"62497",0,0,1,1,"dummy"
"62498",1,0,0,1,"dummy"
"62499",0,1,0,1,"dummy"
"62500",0,0,0,0,"dummy"
"62501",3,1,1,5,"dummy"
"62502",0,1,0,1,"dummy"
"62522",1,0,0,1,"dummy"
"62523",0,1,1,2,"dummy"
"62524",0,1,0,1,"dummy"
"62527",4,3,6,13,"dummy"
"62538",0,0,3,3,"dummy"
"62539",1,0,1,2,"dummy"
"62540",0,0,0,0,"dummy"
"62543",0,20,0,20,"dummy"
"62544",1,3,0,4,"dummy"
"62547",0,0,1,1,"dummy"
"62548",11,7,2,20,"dummy"
"62551",1,1,1,3,"dummy"
"62552",1,1,0,2,"dummy"
"62553",1,1,0,2,"dummy"
"62554",5,4,2,11,"dummy"
"62555",5,1,2,8,"dummy"
"62556",0,0,1,1,"dummy"
"62557",1,1,0,2,"dummy"
"62558",0,2,0,2,"dummy"
"62559",1,15,0,16,"dummy"
"62562",2,5,0,7,"dummy"
"62563",2,4,0,6,"dummy"
"62571",0,1,5,6,"dummy"
"62572",0,0,4,4,"dummy"
"62590",0,1,0,1,"dummy"
"62591",0,1,0,1,"dummy"
"62592",0,0,0,0,"dummy"
"62593",0,0,0,0,"dummy"
"62594",2,31,0,33,"dummy"
"62595",3,0,0,3,"dummy"
"62596",0,1,0,1,"dummy"
"62604",0,9,1,10,"dummy"
"62605",1,0,1,2,"dummy"
"62606",0,1,0,1,"dummy"
"62607",4,6,0,10,"dummy"
"62608",2,8,1,11,"dummy"
"62634",0,0,0,0,"dummy"
"62635",0,1,0,1,"dummy"
"62636",0,1,0,1,"dummy"
"62637",0,0,0,0,"dummy"
"62638",5,5,0,10,"dummy"
"62639",0,1,0,1,"dummy"
"62640",6,0,0,6,"dummy"
"62536",1,1,0,2,"dummy"
"62565",0,0,1,1,"dummy"
"62566",0,0,1,1,"dummy"
"62567",0,0,2,2,"dummy"
"62568",0,0,2,2,"dummy"
"62569",0,2,2,4,"dummy"
"62600",0,1,0,1,"dummy"
"62601",0,0,1,1,"dummy"
"62602",10,43,4,57,"dummy"
"62610",2,4,1,7,"dummy"
"62611",2,3,0,5,"dummy"
"62625",0,0,1,1,"dummy"
"62626",0,0,0,0,"dummy"
"62627",0,0,0,0,"dummy"
"62628",0,0,0,0,"dummy"
"62629",0,0,0,0,"dummy"
"62630",0,0,1,1,"dummy"
"62631",0,0,1,1,"dummy"
"62632",0,0,1,1,"dummy"
"62642",1,0,2,3,"dummy"
"62645",0,0,2,2,"dummy"
"62646",0,0,2,2,"dummy"
"62647",0,0,1,1,"dummy"
"62660",0,0,1,1,"dummy"
"62661",0,0,0,0,"dummy"
"62674",0,0,0,0,"dummy"
"62675",0,0,0,0,"dummy"
"62676",0,1,0,1,"dummy"
"62683",0,0,1,1,"dummy"
"62684",0,0,1,1,"dummy"
"62685",0,0,1,1,"dummy"
"62686",0,0,1,1,"dummy"
"62687",0,0,1,1,"dummy"
"62688",0,0,0,0,"dummy"
"62689",0,1,0,1,"dummy"
"62690",0,0,1,1,"dummy"
"62691",0,0,0,0,"dummy"
"62692",0,0,0,0,"dummy"
"62693",0,2,0,2,"dummy"
"62694",0,0,0,0,"dummy"
"62695",0,3,0,3,"dummy"
"62696",0,0,1,1,"dummy"
"62697",1,3,0,4,"dummy"
"62698",0,0,1,1,"dummy"
"62699",0,1,0,1,"dummy"
"62700",0,0,1,1,"dummy"
"62701",0,0,1,1,"dummy"
"62702",0,0,1,1,"dummy"
"62798",1,0,1,2,"dummy"
"62907",0,0,1,1,"dummy"
"62908",0,1,0,1,"dummy"
"62909",9,9,0,18,"dummy"
"62910",2,0,0,2,"dummy"
"62919",0,0,1,1,"dummy"
"62665",0,0,1,1,"dummy"
"62666",1,1,0,2,"dummy"
"62667",0,0,3,3,"dummy"
"62670",0,0,4,4,"dummy"
"62680",0,1,1,2,"dummy"
"62681",0,0,1,1,"dummy"
"62706",0,0,0,0,"dummy"
"62707",0,0,1,1,"dummy"
"62708",0,0,0,0,"dummy"
"62709",0,0,3,3,"dummy"
"62710",1,6,3,10,"dummy"
"62711",0,1,3,4,"dummy"
"62712",5,1,0,6,"dummy"
"62713",4,0,0,4,"dummy"
"62716",0,2,0,2,"dummy"
"62717",0,11,0,11,"dummy"
"62718",0,1,4,5,"dummy"
"62721",11,4,2,17,"dummy"
"62722",1,0,2,3,"dummy"
"62796",0,0,1,1,"dummy"
"62802",0,1,2,3,"dummy"
"62912",0,1,0,1,"dummy"
"62913",0,0,1,1,"dummy"
"62914",1,0,0,1,"dummy"
"62915",0,0,0,0,"dummy"
"62916",0,0,0,0,"dummy"
"62917",0,0,1,1,"dummy"
"62924",2,0,3,5,"dummy"
"62925",3,1,2,6,"dummy"
"62928",0,1,0,1,"dummy"
"62929",0,10,0,10,"dummy"
"62930",0,1,0,1,"dummy"
"62931",0,0,0,0,"dummy"
"62932",3,3,0,6,"dummy"
"62933",0,0,1,1,"dummy"
"62934",0,2,2,4,"dummy"
"62935",0,0,0,0,"dummy"
"62938",9,14,3,26,"dummy"
"62939",1,0,0,1,"dummy"
"62943",1,1,0,2,"dummy"
"62920",0,0,1,1,"dummy"
"62921",0,0,1,1,"dummy"
"62922",11,0,2,13,"dummy"
"62941",0,1,0,1,"dummy"
"62962",0,2,0,2,"dummy"
"62977",1,0,0,1,"dummy"
"62978",11,7,0,18,"dummy"
"62979",0,1,0,1,"dummy"
"62980",0,0,1,1,"dummy"
"62981",7,0,0,7,"dummy"
"63002",0,2,0,2,"dummy"
"63066",0,0,0,0,"dummy"
"63067",0,3,0,3,"dummy"
"63068",3,3,3,9,"dummy"
"63080",0,0,1,1,"dummy"
"63081",0,0,1,1,"dummy"
"63082",0,0,1,1,"dummy"
"63083",0,0,1,1,"dummy"
"63084",0,0,1,1,"dummy"
"63085",0,0,1,1,"dummy"
"63086",0,0,1,1,"dummy"
"63087",0,0,1,1,"dummy"
"63088",0,0,1,1,"dummy"
"63089",0,0,1,1,"dummy"
"63090",0,0,1,1,"dummy"
"63091",0,0,1,1,"dummy"
"63092",0,0,1,1,"dummy"
"63093",0,0,1,1,"dummy"
"63094",0,0,1,1,"dummy"
"63095",0,0,1,1,"dummy"
"63096",0,0,1,1,"dummy"
"63097",0,0,1,1,"dummy"
"63098",0,0,1,1,"dummy"
"63099",0,0,1,1,"dummy"
"63100",0,0,1,1,"dummy"
"63106",11,18,4,33,"dummy"
"63107",3,0,0,3,"dummy"
"63108",3,1,3,7,"dummy"
"63109",0,0,2,2,"dummy"
"63110",0,0,0,0,"dummy"
"63111",2,50,1,53,"dummy"
"63112",18,14,13,45,"dummy"
"63113",0,2,0,2,"dummy"
"63123",0,0,0,0,"dummy"
"63129",0,6,0,6,"dummy"
"63130",0,0,0,0,"dummy"
"63131",0,6,0,6,"dummy"
"63135",0,1,0,1,"dummy"
"63136",6,27,1,34,"dummy"
"63137",1,0,0,1,"dummy"
"63161",1,2,2,5,"dummy"
"63162",1,1,0,2,"dummy"
"62944",1,2,2,5,"dummy"
"62945",1,0,0,1,"dummy"
"62946",0,1,0,1,"dummy"
"62947",0,3,1,4,"dummy"
"62948",2,0,3,5,"dummy"
"62949",2,1,0,3,"dummy"
"62950",0,1,0,1,"dummy"
"62954",0,2,0,2,"dummy"
"62957",0,0,1,1,"dummy"
"62958",6,0,1,7,"dummy"
"62964",0,5,0,5,"dummy"
"62967",0,0,1,1,"dummy"
"62968",1,0,0,1,"dummy"
"62969",0,6,0,6,"dummy"
"62970",0,0,1,1,"dummy"
"62973",0,2,2,4,"dummy"
"62974",3,0,2,5,"dummy"
"62975",0,3,2,5,"dummy"
"62999",8,0,2,10,"dummy"
"63000",3,4,0,7,"dummy"
"63127",1,1,2,4,"dummy"
"63133",0,0,1,1,"dummy"
"63139",0,2,1,3,"dummy"
"63140",1,10,1,12,"dummy"
"63145",1,6,0,7,"dummy"
"63146",0,2,0,2,"dummy"
"63147",0,1,0,1,"dummy"
"63217",0,1,2,3,"dummy"
"63173",1,1,0,2,"dummy"
"63175",0,1,2,3,"dummy"
"63176",7,4,0,11,"dummy"
"63178",0,0,0,0,"dummy"
"63179",0,0,0,0,"dummy"
"63181",0,1,0,1,"dummy"
"63182",0,2,0,2,"dummy"
"63183",0,1,0,1,"dummy"
"63185",0,1,0,1,"dummy"
"63192",0,4,0,4,"dummy"
"63199",0,1,0,1,"dummy"
"63200",0,5,0,5,"dummy"
"63201",0,7,2,9,"dummy"
"63203",0,9,2,11,"dummy"
"63204",0,0,1,1,"dummy"
"63207",0,0,1,1,"dummy"
"63209",0,0,0,0,"dummy"
"63210",0,1,0,1,"dummy"
"63212",8,1,2,11,"dummy"
"63213",0,0,0,0,"dummy"
"63214",0,2,0,2,"dummy"
"63215",0,2,0,2,"dummy"
"63218",3,3,0,6,"dummy"
"63221",0,2,0,2,"dummy"
"63222",0,3,0,3,"dummy"
"63224",0,1,0,1,"dummy"
"63225",0,3,0,3,"dummy"
"63226",1,0,0,1,"dummy"
"63227",3,1,0,4,"dummy"
"63228",0,0,1,1,"dummy"
"63229",0,0,1,1,"dummy"
"63230",2,2,0,4,"dummy"
"63231",2,2,0,4,"dummy"
"63232",2,2,0,4,"dummy"
"63233",0,0,1,1,"dummy"
"63234",0,1,0,1,"dummy"
"63235",2,3,1,6,"dummy"
"63236",4,6,2,12,"dummy"
"63237",0,0,0,0,"dummy"
"63238",0,0,0,0,"dummy"
"63242",6,0,1,7,"dummy"
"63257",0,2,1,3,"dummy"
"63275",25,1,0,26,"dummy"
"63283",1,0,0,1,"dummy"
"63285",3,5,2,10,"dummy"
"63290",2,2,0,4,"dummy"
"63291",23,22,3,48,"dummy"
"63292",0,3,1,4,"dummy"
"63293",12,10,2,24,"dummy"
"63294",0,0,1,1,"dummy"
"63295",0,0,1,1,"dummy"
"63296",0,0,1,1,"dummy"
"63297",0,0,1,1,"dummy"
"63298",0,0,1,1,"dummy"
"63299",0,0,1,1,"dummy"
"63300",13,10,4,27,"dummy"
"63301",0,0,0,0,"dummy"
"63302",1,0,1,2,"dummy"
"63303",2,2,0,4,"dummy"
"63304",0,0,1,1,"dummy"
"63305",0,0,1,1,"dummy"
"63306",0,0,1,1,"dummy"
"63307",0,2,0,2,"dummy"
"63308",0,0,2,2,"dummy"
"63309",0,0,1,1,"dummy"
"63310",0,0,1,1,"dummy"
"63311",0,0,1,1,"dummy"
"63312",3,0,0,3,"dummy"
"63313",0,1,0,1,"dummy"
"63314",0,0,1,1,"dummy"
"63315",0,0,1,1,"dummy"
"63316",0,0,1,1,"dummy"
"63317",0,0,1,1,"dummy"
"63318",0,0,1,1,"dummy"
"63319",0,0,1,1,"dummy"
"63320",8,8,1,17,"dummy"
"63321",0,0,2,2,"dummy"
"63322",0,0,1,1,"dummy"
"63323",0,0,1,1,"dummy"
"63327",1,0,0,1,"dummy"
"63332",2,1,1,4,"dummy"
"63333",4,3,0,7,"dummy"
"63335",1,0,0,1,"dummy"
"63338",1,1,0,2,"dummy"
"63339",1,1,2,4,"dummy"
"63347",0,0,0,0,"dummy"
"63348",1,4,1,6,"dummy"
"63349",0,0,0,0,"dummy"
"63350",0,0,0,0,"dummy"
"63351",0,0,0,0,"dummy"
"63352",0,0,0,0,"dummy"
"63353",0,3,1,4,"dummy"
"63354",0,0,0,0,"dummy"
"63355",0,0,0,0,"dummy"
"63356",0,0,0,0,"dummy"
"63357",0,0,1,1,"dummy"
"63358",3,1,0,4,"dummy"
"63359",0,0,0,0,"dummy"
"63360",0,0,0,0,"dummy"
"63361",0,0,0,0,"dummy"
"63362",0,0,0,0,"dummy"
"63364",3,1,0,4,"dummy"
"63365",1,0,0,1,"dummy"
"63366",0,1,2,3,"dummy"
"63367",0,0,1,1,"dummy"
"63368",0,3,0,3,"dummy"
"63369",1,0,6,7,"dummy"
"63370",0,0,1,1,"dummy"
"63371",1,1,0,2,"dummy"
"63372",0,2,4,6,"dummy"
"63373",3,2,4,9,"dummy"
"63387",0,1,0,1,"dummy"
"63388",0,0,1,1,"dummy"
"63390",15,12,7,34,"dummy"
"63391",8,16,8,32,"dummy"
"63392",14,6,9,29,"dummy"
"63393",24,0,0,24,"dummy"
"63394",0,24,0,24,"dummy"
"63395",7,11,9,27,"dummy"
"63396",28,0,0,28,"dummy"
"63397",0,24,0,24,"dummy"
"63398",7,11,9,27,"dummy"
"63399",3,1,0,4,"dummy"
"63400",8,6,5,19,"dummy"
"63401",0,0,1,1,"dummy"
"63402",0,0,3,3,"dummy"
"63405",0,0,1,1,"dummy"
"63406",0,1,0,1,"dummy"
"63407",0,1,0,1,"dummy"
"63409",2,5,2,9,"dummy"
"63423",1,17,0,18,"dummy"
"63424",5,3,3,11,"dummy"
"63425",4,5,0,9,"dummy"
"63426",4,7,2,13,"dummy"
"63427",0,3,0,3,"dummy"
"63428",3,0,0,3,"dummy"
"63429",0,1,0,1,"dummy"
"63431",5,0,0,5,"dummy"
"63432",0,0,0,0,"dummy"
"63433",0,0,1,1,"dummy"
"63435",0,0,0,0,"dummy"
"63436",0,0,1,1,"dummy"
"63438",2,6,0,8,"dummy"
"63442",6,12,3,21,"dummy"
"63443",0,0,1,1,"dummy"
"63444",12,6,3,21,"dummy"
"63445",1,7,0,8,"dummy"
"63446",0,0,3,3,"dummy"
"63447",0,4,0,4,"dummy"
"63448",22,7,5,34,"dummy"
"63455",0,0,1,1,"dummy"
"63456",2,1,1,4,"dummy"
"63465",0,11,1,12,"dummy"
"63466",0,5,0,5,"dummy"
"63467",0,12,1,13,"dummy"
"63474",0,0,1,1,"dummy"
"63475",0,0,1,1,"dummy"
"63476",0,0,1,1,"dummy"
"63477",0,0,1,1,"dummy"
"63478",0,0,1,1,"dummy"
"63479",0,0,1,1,"dummy"
"63481",0,0,1,1,"dummy"
"63482",0,0,0,0,"dummy"
"63488",0,4,0,4,"dummy"
"63489",0,2,0,2,"dummy"
"63491",1,2,2,5,"dummy"
"63493",2,0,3,5,"dummy"
"63494",0,0,1,1,"dummy"
"63495",0,1,0,1,"dummy"
"63496",0,0,0,0,"dummy"
"63497",0,0,0,0,"dummy"
"63499",8,9,2,19,"dummy"
"63500",1,7,0,8,"dummy"
"63501",0,2,0,2,"dummy"
"63502",2,3,0,5,"dummy"
"63503",4,4,0,8,"dummy"
"63505",2,1,0,3,"dummy"
"63506",3,0,0,3,"dummy"
"63509",0,1,0,1,"dummy"
"63514",0,0,1,1,"dummy"
"63516",0,1,0,1,"dummy"
"63518",0,0,1,1,"dummy"
"63519",5,4,3,12,"dummy"
"63520",2,8,2,12,"dummy"
"63521",0,4,0,4,"dummy"
"63522",5,7,2,14,"dummy"
"63523",0,4,0,4,"dummy"
"63524",2,0,0,2,"dummy"
"63525",0,0,4,4,"dummy"
"63526",2,3,1,6,"dummy"
"63527",0,1,0,1,"dummy"
"63549",0,0,0,0,"dummy"
"63550",2,0,0,2,"dummy"
"63551",2,1,0,3,"dummy"
"63552",0,2,0,2,"dummy"
"63553",3,0,0,3,"dummy"
"63554",0,0,0,0,"dummy"
"63555",0,0,0,0,"dummy"
"63556",3,0,0,3,"dummy"
"63557",0,0,0,0,"dummy"
"63558",0,0,2,2,"dummy"
"63559",0,0,1,1,"dummy"
"63560",1,0,0,1,"dummy"
"63561",0,0,0,0,"dummy"
"63563",1,0,0,1,"dummy"
"63565",5,3,2,10,"dummy"
"63566",0,0,1,1,"dummy"
"63573",0,0,0,0,"dummy"
"63577",0,0,0,0,"dummy"
"63578",0,1,0,1,"dummy"
"63579",1,0,4,5,"dummy"
"63581",5,0,0,5,"dummy"
"63582",0,3,1,4,"dummy"
"63587",0,1,0,1,"dummy"
"63588",0,0,1,1,"dummy"
"63589",0,0,1,1,"dummy"
"63590",0,0,1,1,"dummy"
"63595",0,1,0,1,"dummy"
"63596",1,0,0,1,"dummy"
"63597",0,1,1,2,"dummy"
"63598",0,0,1,1,"dummy"
"63599",0,0,0,0,"dummy"
"63600",0,1,0,1,"dummy"
"63601",0,1,0,1,"dummy"
"63602",0,0,1,1,"dummy"
"63604",0,1,0,1,"dummy"
"63605",0,1,0,1,"dummy"
"63606",0,2,0,2,"dummy"
"63614",1,1,1,3,"dummy"
"63617",0,0,0,0,"dummy"
"63629",0,6,1,7,"dummy"
"63630",0,2,2,4,"dummy"
"63633",1,0,0,1,"dummy"
"63634",2,0,0,2,"dummy"
"63635",0,4,0,4,"dummy"
"63639",0,2,2,4,"dummy"
"63642",9,18,3,30,"dummy"
"63643",0,2,1,3,"dummy"
"63645",0,7,0,7,"dummy"
"63646",7,0,0,7,"dummy"
"63653",0,0,0,0,"dummy"
"63656",0,1,0,1,"dummy"
"63676",0,0,1,1,"dummy"
"63679",0,1,0,1,"dummy"
"63680",2,10,1,13,"dummy"
"63681",0,8,2,10,"dummy"
"63682",2,1,0,3,"dummy"
"63683",0,0,2,2,"dummy"
"63684",0,0,2,2,"dummy"
"63685",0,1,0,1,"dummy"
"63686",0,0,0,0,"dummy"
"63687",0,3,0,3,"dummy"
"63688",4,11,6,21,"dummy"
"63689",0,2,0,2,"dummy"
"63690",3,14,0,17,"dummy"
"63691",7,6,1,14,"dummy"
"63692",0,1,3,4,"dummy"
"63693",1,0,5,6,"dummy"
"63694",0,0,0,0,"dummy"
"63695",0,1,0,1,"dummy"
"63696",7,15,0,22,"dummy"
"63697",0,0,1,1,"dummy"
"63701",8,2,4,14,"dummy"
"63702",0,3,0,3,"dummy"
"63703",0,3,0,3,"dummy"
"63704",0,1,0,1,"dummy"
"63705",1,0,0,1,"dummy"
"63710",1,2,4,7,"dummy"
"63711",0,0,1,1,"dummy"
"63712",0,3,0,3,"dummy"
"63713",0,0,1,1,"dummy"
"63714",0,0,1,1,"dummy"
"63717",0,0,1,1,"dummy"
"63718",0,13,0,13,"dummy"
"63719",2,4,0,6,"dummy"
"63720",7,48,6,61,"dummy"
"63721",4,4,0,8,"dummy"
"63722",7,14,5,26,"dummy"
"63723",0,3,0,3,"dummy"
"63724",0,2,0,2,"dummy"
"63725",1,0,0,1,"dummy"
"63726",0,1,0,1,"dummy"
"63727",159,5,9,173,"dummy"
"63730",1,9,0,10,"dummy"
"63733",1,18,0,19,"dummy"
"63735",5,0,1,6,"dummy"
"63740",0,0,1,1,"dummy"
"63741",0,2,0,2,"dummy"
"63743",0,0,2,2,"dummy"
"63745",2,0,4,6,"dummy"
"63746",1,2,0,3,"dummy"
"63747",1,2,0,3,"dummy"
"63748",0,6,2,8,"dummy"
"63749",0,0,1,1,"dummy"
"63750",2,0,0,2,"dummy"
"63751",0,5,0,5,"dummy"
"63752",1,1,0,2,"dummy"
"63753",1,0,0,1,"dummy"
"63754",0,2,4,6,"dummy"
"63755",0,2,0,2,"dummy"
"63756",0,2,0,2,"dummy"
"63757",2,4,0,6,"dummy"
"63760",3,8,2,13,"dummy"
"63764",0,5,0,5,"dummy"
"63765",0,0,1,1,"dummy"
"63766",0,1,0,1,"dummy"
"63767",0,1,0,1,"dummy"
"63768",1,0,2,3,"dummy"
"63769",0,2,1,3,"dummy"
"63770",0,1,0,1,"dummy"
"63771",0,5,1,6,"dummy"
"63772",0,1,1,2,"dummy"
"63773",0,4,0,4,"dummy"
"63774",0,5,0,5,"dummy"
"63775",3,0,0,3,"dummy"
"63776",0,8,0,8,"dummy"
"63777",3,3,0,6,"dummy"
"63778",5,4,0,9,"dummy"
"63779",4,4,0,8,"dummy"
"63780",5,6,0,11,"dummy"
"63781",2,2,0,4,"dummy"
"63782",3,3,0,6,"dummy"
"63783",5,5,0,10,"dummy"
"63784",0,1,0,1,"dummy"
"63785",4,4,0,8,"dummy"
"63786",8,5,0,13,"dummy"
"63787",2,0,0,2,"dummy"
"63788",0,0,1,1,"dummy"
"63789",5,25,5,35,"dummy"
"63790",3,2,1,6,"dummy"
"63791",4,4,0,8,"dummy"
"63792",0,0,2,2,"dummy"
"63807",0,0,1,1,"dummy"
"63812",0,1,1,2,"dummy"
"63813",0,1,0,1,"dummy"
"63818",0,1,0,1,"dummy"
"63821",0,0,0,0,"dummy"
"63825",0,16,0,16,"dummy"
"63826",2,1,0,3,"dummy"
"63837",1,1,4,6,"dummy"
"63838",0,0,1,1,"dummy"
"63839",0,1,0,1,"dummy"
"63840",0,1,1,2,"dummy"
"63843",0,0,1,1,"dummy"
"63844",0,0,1,1,"dummy"
"63845",0,0,1,1,"dummy"
"63846",0,0,0,0,"dummy"
"63847",0,1,0,1,"dummy"
"63848",0,0,1,1,"dummy"
"63849",0,1,1,2,"dummy"
"63850",0,0,1,1,"dummy"
"63851",0,0,1,1,"dummy"
"63852",0,0,1,1,"dummy"
"63855",0,0,3,3,"dummy"
"63856",28,2,0,30,"dummy"
"63857",0,1,0,1,"dummy"
"63858",0,2,0,2,"dummy"
"63859",0,0,1,1,"dummy"
"63860",0,4,0,4,"dummy"
"63861",0,2,0,2,"dummy"
"63862",2,0,0,2,"dummy"
"63863",0,1,0,1,"dummy"
"63864",0,1,0,1,"dummy"
"63865",2,1,0,3,"dummy"
"63866",0,0,1,1,"dummy"
"63867",0,1,0,1,"dummy"
"63870",0,4,2,6,"dummy"
"63871",4,0,2,6,"dummy"
"63872",0,3,2,5,"dummy"
"63873",0,1,0,1,"dummy"
"63874",0,0,1,1,"dummy"
"63875",4,2,2,8,"dummy"
"63876",2,4,2,8,"dummy"
"63887",2,2,0,4,"dummy"
"63892",0,0,1,1,"dummy"
"63893",0,1,0,1,"dummy"
"63894",0,0,0,0,"dummy"
"63898",11,2,0,13,"dummy"
"63762",0,0,1,1,"dummy"
"63794",0,16,0,16,"dummy"
"63795",1,1,4,6,"dummy"
"63796",0,0,1,1,"dummy"
"63797",0,0,1,1,"dummy"
"63798",0,0,1,1,"dummy"
"63799",0,0,1,1,"dummy"
"63800",0,0,1,1,"dummy"
"63801",0,0,1,1,"dummy"
"63802",0,0,1,1,"dummy"
"63803",0,0,1,1,"dummy"
"63804",0,0,1,1,"dummy"
"63805",0,0,1,1,"dummy"
"63823",21,7,1,29,"dummy"
"63832",0,3,0,3,"dummy"
"63833",0,4,0,4,"dummy"
"63878",8,13,2,23,"dummy"
"63883",3,0,0,3,"dummy"
"63884",1,2,0,3,"dummy"
"63885",0,1,0,1,"dummy"
"63896",2,1,1,4,"dummy"
"63905",0,0,1,1,"dummy"
"63906",0,1,0,1,"dummy"
"63907",0,2,0,2,"dummy"
"63910",2,0,0,2,"dummy"
"63918",7,10,15,32,"dummy"
"63919",1,7,9,17,"dummy"
"63920",1,4,0,5,"dummy"
"63921",15,0,6,21,"dummy"
"63922",0,3,0,3,"dummy"
"63923",1,0,0,1,"dummy"
"63924",0,1,0,1,"dummy"
"63925",2,1,0,3,"dummy"
"63926",2,1,0,3,"dummy"
"63927",1,0,0,1,"dummy"
"63928",1,4,0,5,"dummy"
"63929",2,1,0,3,"dummy"
"63930",0,1,0,1,"dummy"
"63931",2,0,1,3,"dummy"
"63941",0,0,2,2,"dummy"
"63942",0,2,0,2,"dummy"
"63943",0,1,0,1,"dummy"
"63944",1,0,0,1,"dummy"
"63945",2,1,3,6,"dummy"
"63946",0,0,3,3,"dummy"
"63947",1,3,0,4,"dummy"
"63952",2,1,1,4,"dummy"
"63953",0,2,0,2,"dummy"
"63954",0,0,1,1,"dummy"
"63955",0,0,1,1,"dummy"
"63956",0,0,1,1,"dummy"
"63957",0,4,0,4,"dummy"
"63958",0,0,1,1,"dummy"
"63959",0,2,0,2,"dummy"
"63960",0,2,2,4,"dummy"
"63961",0,3,1,4,"dummy"
"63962",0,0,1,1,"dummy"
"63963",0,0,1,1,"dummy"
"63964",0,0,1,1,"dummy"
"63965",0,0,1,1,"dummy"
"63966",0,0,1,1,"dummy"
"63967",0,0,1,1,"dummy"
"63968",0,0,1,1,"dummy"
"63969",0,0,1,1,"dummy"
"63970",0,0,1,1,"dummy"
"63971",0,0,1,1,"dummy"
"63972",0,0,1,1,"dummy"
"63973",0,0,1,1,"dummy"
"63974",0,0,1,1,"dummy"
"63975",0,0,1,1,"dummy"
"63976",0,0,1,1,"dummy"
"63977",0,0,1,1,"dummy"
"63978",0,0,1,1,"dummy"
"63979",0,0,1,1,"dummy"
"63980",0,0,1,1,"dummy"
"63981",0,0,1,1,"dummy"
"63982",0,0,1,1,"dummy"
"63983",0,0,1,1,"dummy"
"63984",0,0,1,1,"dummy"
"63985",0,0,1,1,"dummy"
"63986",0,0,1,1,"dummy"
"63987",0,0,1,1,"dummy"
"63933",1,1,0,2,"dummy"
"63934",0,0,1,1,"dummy"
"63935",0,3,0,3,"dummy"
"63936",1,8,2,11,"dummy"
"63937",0,1,1,2,"dummy"
"63938",1,0,1,2,"dummy"
"63939",2,0,0,2,"dummy"
"63949",0,0,1,1,"dummy"
"63950",0,0,1,1,"dummy"
"63996",0,0,0,0,"dummy"
"63997",0,0,0,0,"dummy"
"63998",0,0,0,0,"dummy"
"63999",0,0,0,0,"dummy"
"64000",0,0,0,0,"dummy"
"64001",0,0,0,0,"dummy"
"64007",0,0,0,0,"dummy"
"64008",0,0,0,0,"dummy"
"64009",0,0,0,0,"dummy"
"64010",0,0,0,0,"dummy"
"64025",1,2,0,3,"dummy"
"64026",0,0,0,0,"dummy"
"64046",1,1,1,3,"dummy"
"64057",1,4,0,5,"dummy"
"64060",0,0,1,1,"dummy"
"64061",0,0,1,1,"dummy"
"64062",0,0,1,1,"dummy"
"64063",0,0,1,1,"dummy"
"64064",0,0,1,1,"dummy"
"64065",2,2,1,5,"dummy"
"64066",0,0,1,1,"dummy"
"64067",0,0,1,1,"dummy"
"64068",0,0,1,1,"dummy"
"64069",0,0,1,1,"dummy"
"64070",0,0,1,1,"dummy"
"64071",0,0,1,1,"dummy"
"64072",0,0,1,1,"dummy"
"64073",0,0,1,1,"dummy"
"64074",0,0,1,1,"dummy"
"64075",0,0,1,1,"dummy"
"64076",0,0,1,1,"dummy"
"64077",0,0,1,1,"dummy"
"64078",0,0,1,1,"dummy"
"64079",0,0,1,1,"dummy"
"64080",0,0,1,1,"dummy"
"64081",0,0,1,1,"dummy"
"64082",0,0,1,1,"dummy"
"64083",0,0,1,1,"dummy"
"64084",0,0,1,1,"dummy"
"64085",0,0,1,1,"dummy"
"64086",0,0,1,1,"dummy"
"64087",0,0,1,1,"dummy"
"64088",0,0,1,1,"dummy"
"64089",0,0,0,0,"dummy"
"64090",0,0,1,1,"dummy"
"64091",0,0,1,1,"dummy"
"64092",0,0,1,1,"dummy"
"64093",0,0,1,1,"dummy"
"64094",0,0,1,1,"dummy"
"64095",0,0,1,1,"dummy"
"64096",0,0,1,1,"dummy"
"64097",0,0,1,1,"dummy"
"64098",0,0,1,1,"dummy"
"64099",0,0,1,1,"dummy"
"64100",0,0,1,1,"dummy"
"64101",0,0,1,1,"dummy"
"64102",0,0,1,1,"dummy"
"64103",0,0,1,1,"dummy"
"64104",0,0,1,1,"dummy"
"64105",0,0,1,1,"dummy"
"64106",0,0,1,1,"dummy"
"64107",0,0,1,1,"dummy"
"64108",0,0,1,1,"dummy"
"64109",0,0,1,1,"dummy"
"64112",2,9,1,12,"dummy"
"64113",0,4,0,4,"dummy"
"64121",36,19,4,59,"dummy"
"64122",0,4,0,4,"dummy"
"64150",0,0,1,1,"dummy"
"63988",0,0,1,1,"dummy"
"63989",0,0,1,1,"dummy"
"63990",0,0,1,1,"dummy"
"63991",0,0,1,1,"dummy"
"63992",0,0,0,0,"dummy"
"63993",3,5,1,9,"dummy"
"63994",7,21,8,36,"dummy"
"64003",0,0,4,4,"dummy"
"64004",1,3,0,4,"dummy"
"64005",0,0,1,1,"dummy"
"64012",2,1,0,3,"dummy"
"64013",1,3,0,4,"dummy"
"64041",0,1,0,1,"dummy"
"64042",1,0,2,3,"dummy"
"64043",1,0,0,1,"dummy"
"64044",0,1,0,1,"dummy"
"64055",1,2,5,8,"dummy"
"64115",1,0,0,1,"dummy"
"64116",0,1,0,1,"dummy"
"64117",0,4,0,4,"dummy"
"64124",16,21,0,37,"dummy"
"64127",0,0,2,2,"dummy"
"64130",0,0,0,0,"dummy"
"64131",0,0,0,0,"dummy"
"64134",0,2,0,2,"dummy"
"64135",0,0,1,1,"dummy"
"64136",2,2,0,4,"dummy"
"64137",0,0,1,1,"dummy"
"64138",0,1,0,1,"dummy"
"64139",0,0,1,1,"dummy"
"64140",0,0,0,0,"dummy"
"64141",0,3,1,4,"dummy"
"64142",3,0,2,5,"dummy"
"64143",0,3,1,4,"dummy"
"64144",0,0,1,1,"dummy"
"64147",0,1,0,1,"dummy"
"64148",3,17,0,20,"dummy"
"64154",0,0,1,1,"dummy"
"64160",6,1,1,8,"dummy"
"64161",4,5,2,11,"dummy"
"64162",6,0,0,6,"dummy"
"64163",0,2,0,2,"dummy"
"64164",0,2,0,2,"dummy"
"64165",1,0,0,1,"dummy"
"64166",0,0,1,1,"dummy"
"64167",2,2,0,4,"dummy"
"64168",6,2,2,10,"dummy"
"64169",2,0,0,2,"dummy"
"64170",0,2,0,2,"dummy"
"64171",1,0,0,1,"dummy"
"64172",0,0,1,1,"dummy"
"64183",0,0,2,2,"dummy"
"64184",0,0,1,1,"dummy"
"64185",0,0,2,2,"dummy"
"64186",0,0,1,1,"dummy"
"64187",0,0,1,1,"dummy"
"64188",0,0,1,1,"dummy"
"64189",0,0,1,1,"dummy"
"64203",2,1,0,3,"dummy"
"64204",0,0,2,2,"dummy"
"64205",0,1,0,1,"dummy"
"64206",2,0,1,3,"dummy"
"64207",2,2,1,5,"dummy"
"64208",0,1,0,1,"dummy"
"64209",0,1,0,1,"dummy"
"64211",0,0,1,1,"dummy"
"64216",0,1,0,1,"dummy"
"64219",2,4,1,7,"dummy"
"64220",0,0,1,1,"dummy"
"64222",0,0,1,1,"dummy"
"64223",0,0,1,1,"dummy"
"64224",0,0,1,1,"dummy"
"64225",0,1,0,1,"dummy"
"64226",0,0,1,1,"dummy"
"64227",2,3,0,5,"dummy"
"64228",1,0,0,1,"dummy"
"64229",2,0,0,2,"dummy"
"64230",1,0,0,1,"dummy"
"64231",0,3,0,3,"dummy"
"64232",0,0,1,1,"dummy"
"64235",1,4,0,5,"dummy"
"64240",0,0,3,3,"dummy"
"64244",4,0,0,4,"dummy"
"64247",0,1,0,1,"dummy"
"64251",0,24,0,24,"dummy"
"64258",1,3,1,5,"dummy"
"64264",2,15,1,18,"dummy"
"64265",4,4,1,9,"dummy"
"64266",0,1,0,1,"dummy"
"64267",0,0,2,2,"dummy"
"64268",2,0,2,4,"dummy"
"64269",0,0,1,1,"dummy"
"64270",0,0,1,1,"dummy"
"64273",0,0,1,1,"dummy"
"64274",4,4,0,8,"dummy"
"64277",0,6,1,7,"dummy"
"64278",0,5,2,7,"dummy"
"64286",11,1,0,12,"dummy"
"64287",2,10,0,12,"dummy"
"64288",0,0,3,3,"dummy"
"64289",0,1,0,1,"dummy"
"64292",0,1,0,1,"dummy"
"64293",2,1,0,3,"dummy"
"64294",0,0,1,1,"dummy"
"64295",0,2,0,2,"dummy"
"64296",0,1,0,1,"dummy"
"64297",3,3,1,7,"dummy"
"64298",2,0,0,2,"dummy"
"64299",1,4,1,6,"dummy"
"64300",1,4,0,5,"dummy"
"64301",0,1,0,1,"dummy"
"64302",1,0,0,1,"dummy"
"64303",0,1,0,1,"dummy"
"64307",0,1,0,1,"dummy"
"64308",1,0,0,1,"dummy"
"64309",1,4,0,5,"dummy"
"64242",0,0,1,1,"dummy"
"64249",0,0,1,1,"dummy"
"64253",3,1,1,5,"dummy"
"64254",1,7,1,9,"dummy"
"64262",1,0,0,1,"dummy"
"64280",0,1,0,1,"dummy"
"64281",0,1,0,1,"dummy"
"64284",1,4,3,8,"dummy"
"64305",0,0,1,1,"dummy"
"64313",0,1,0,1,"dummy"
"64314",3,5,1,9,"dummy"
"64315",0,1,0,1,"dummy"
"64316",2,3,1,6,"dummy"
"64317",1,3,0,4,"dummy"
"64318",0,0,0,0,"dummy"
"64319",2,0,1,3,"dummy"
"64320",0,1,0,1,"dummy"
"64321",0,3,0,3,"dummy"
"64322",0,0,1,1,"dummy"
"64323",0,5,0,5,"dummy"
"64324",0,1,0,1,"dummy"
"64325",0,0,1,1,"dummy"
"64331",4,4,1,9,"dummy"
"64332",0,2,2,4,"dummy"
"64334",1,6,0,7,"dummy"
"64336",0,0,1,1,"dummy"
"64338",2,5,2,9,"dummy"
"64341",0,0,4,4,"dummy"
"64342",0,0,0,0,"dummy"
"64343",0,0,3,3,"dummy"
"64344",3,2,3,8,"dummy"
"64347",0,1,0,1,"dummy"
"64348",0,0,7,7,"dummy"
"64351",0,0,1,1,"dummy"
"64352",0,0,1,1,"dummy"
"64353",0,0,0,0,"dummy"
"64354",0,1,0,1,"dummy"
"64356",3,0,4,7,"dummy"
"64357",0,0,2,2,"dummy"
"64358",0,1,0,1,"dummy"
"64359",0,0,1,1,"dummy"
"64360",0,1,0,1,"dummy"
"64361",0,1,1,2,"dummy"
"64368",0,3,0,3,"dummy"
"64369",2,2,0,4,"dummy"
"64371",10,7,4,21,"dummy"
"64373",1,3,0,4,"dummy"
"64374",0,0,1,1,"dummy"
"64375",0,16,0,16,"dummy"
"64378",0,7,0,7,"dummy"
"64381",0,1,0,1,"dummy"
"64383",0,0,0,0,"dummy"
"64386",0,2,0,2,"dummy"
"64387",6,3,0,9,"dummy"
"64388",0,1,0,1,"dummy"
"64389",0,0,1,1,"dummy"
"64390",0,0,1,1,"dummy"
"64391",0,0,1,1,"dummy"
"64392",16,1,1,18,"dummy"
"64393",0,0,1,1,"dummy"
"64394",0,0,1,1,"dummy"
"64395",0,0,1,1,"dummy"
"64396",0,0,1,1,"dummy"
"64397",0,0,1,1,"dummy"
"64398",0,0,1,1,"dummy"
"64399",6,1,1,8,"dummy"
"64400",0,0,1,1,"dummy"
"64402",0,0,2,2,"dummy"
"64406",0,0,1,1,"dummy"
"64407",0,0,1,1,"dummy"
"64408",1,0,0,1,"dummy"
"64409",0,1,1,2,"dummy"
"64410",0,2,0,2,"dummy"
"64418",1,0,0,1,"dummy"
"64420",0,1,0,1,"dummy"
"64421",21,2,2,25,"dummy"
"64422",0,1,0,1,"dummy"
"64426",0,0,1,1,"dummy"
"64428",0,0,0,0,"dummy"
"64429",0,0,0,0,"dummy"
"64430",0,0,0,0,"dummy"
"64432",0,2,0,2,"dummy"
"64433",0,6,1,7,"dummy"
"64435",0,1,0,1,"dummy"
"64440",0,5,0,5,"dummy"
"64441",5,1,1,7,"dummy"
"64442",0,1,0,1,"dummy"
"64443",0,0,1,1,"dummy"
"64444",0,0,0,0,"dummy"
"64445",0,0,1,1,"dummy"
"64446",0,5,0,5,"dummy"
"64447",3,0,0,3,"dummy"
"64448",0,1,0,1,"dummy"
"64449",1,3,3,7,"dummy"
"64450",0,1,1,2,"dummy"
"64451",1,2,1,4,"dummy"
"64452",0,4,0,4,"dummy"
"64454",2,2,2,6,"dummy"
"64455",0,0,1,1,"dummy"
"64456",0,1,1,2,"dummy"
"64457",0,1,1,2,"dummy"
"64458",8,4,3,15,"dummy"
"64459",0,0,1,1,"dummy"
"64460",0,0,1,1,"dummy"
"64461",0,0,0,0,"dummy"
"64462",0,0,1,1,"dummy"
"64463",7,1,1,9,"dummy"
"64464",0,0,2,2,"dummy"
"64465",7,1,0,8,"dummy"
"64466",1,11,0,12,"dummy"
"64467",6,5,0,11,"dummy"
"64468",5,1,0,6,"dummy"
"64469",0,0,0,0,"dummy"
"64470",0,0,0,0,"dummy"
"64471",0,0,0,0,"dummy"
"64472",0,0,0,0,"dummy"
"64473",0,0,2,2,"dummy"
"64474",0,0,0,0,"dummy"
"64475",0,0,0,0,"dummy"
"64476",4,4,0,8,"dummy"
"64477",0,0,0,0,"dummy"
"64480",0,0,1,1,"dummy"
"64482",0,0,0,0,"dummy"
"64487",0,1,1,2,"dummy"
"64488",1,2,2,5,"dummy"
"64489",0,1,0,1,"dummy"
"64490",0,5,2,7,"dummy"
"64491",7,2,2,11,"dummy"
"64493",2,2,1,5,"dummy"
"64495",20,0,1,21,"dummy"
"64506",0,0,0,0,"dummy"
"64507",0,0,0,0,"dummy"
"64508",0,0,1,1,"dummy"
"64509",3,2,0,5,"dummy"
"64510",0,3,1,4,"dummy"
"64511",0,3,1,4,"dummy"
"64512",0,5,0,5,"dummy"
"64513",0,0,1,1,"dummy"
"64514",2,0,2,4,"dummy"
"64515",0,2,0,2,"dummy"
"64516",0,0,2,2,"dummy"
"64520",0,3,3,6,"dummy"
"64524",5,10,1,16,"dummy"
"64525",0,0,1,1,"dummy"
"64526",0,0,0,0,"dummy"
"64528",1,2,1,4,"dummy"
"64529",0,4,0,4,"dummy"
"64530",0,3,0,3,"dummy"
"64531",1,3,0,4,"dummy"
"64532",0,1,0,1,"dummy"
"64533",0,0,1,1,"dummy"
"64534",0,3,0,3,"dummy"
"64535",0,3,0,3,"dummy"
"64536",3,0,0,3,"dummy"
"64537",3,0,0,3,"dummy"
"64538",0,2,0,2,"dummy"
"64539",0,1,0,1,"dummy"
"64566",0,13,1,14,"dummy"
"64567",1,1,0,2,"dummy"
"64568",1,1,0,2,"dummy"
"64570",0,0,1,1,"dummy"
"64572",0,0,2,2,"dummy"
"64575",3,6,1,10,"dummy"
"64576",5,5,3,13,"dummy"
"64579",2,3,0,5,"dummy"
"64582",0,0,0,0,"dummy"
"64583",0,0,1,1,"dummy"
"64584",0,0,1,1,"dummy"
"64586",0,1,0,1,"dummy"
"64587",1,1,1,3,"dummy"
"64588",2,1,0,3,"dummy"
"64589",0,2,0,2,"dummy"
"64590",2,1,0,3,"dummy"
"64594",0,2,0,2,"dummy"
"64595",0,2,0,2,"dummy"
"64596",0,0,1,1,"dummy"
"64597",0,1,0,1,"dummy"
"64598",0,0,1,1,"dummy"
"64599",0,0,1,1,"dummy"
"64601",4,8,5,17,"dummy"
"64602",8,5,2,15,"dummy"
"64603",0,1,2,3,"dummy"
"64604",0,0,2,2,"dummy"
"64605",0,1,0,1,"dummy"
"64606",0,0,1,1,"dummy"
"64607",0,0,1,1,"dummy"
"64608",0,0,1,1,"dummy"
"64609",0,0,1,1,"dummy"
"64610",3,5,5,13,"dummy"
"64611",0,0,1,1,"dummy"
"64612",9,1,1,11,"dummy"
"64614",0,2,1,3,"dummy"
"64615",0,3,0,3,"dummy"
"64617",0,1,0,1,"dummy"
"64618",0,0,2,2,"dummy"
"64619",0,0,1,1,"dummy"
"64621",0,0,1,1,"dummy"
"64622",0,0,0,0,"dummy"
"64623",3,1,0,4,"dummy"
"64624",4,0,1,5,"dummy"
"64625",9,5,3,17,"dummy"
"64626",0,1,0,1,"dummy"
"64627",1,2,0,3,"dummy"
"64628",1,0,0,1,"dummy"
"64629",2,6,1,9,"dummy"
"64630",0,0,0,0,"dummy"
"64631",0,0,0,0,"dummy"
"64633",5,5,5,15,"dummy"
"64634",0,0,1,1,"dummy"
"64635",1,0,0,1,"dummy"
"64636",5,1,0,6,"dummy"
"64637",0,2,0,2,"dummy"
"64638",2,0,1,3,"dummy"
"64639",0,2,0,2,"dummy"
"64642",0,1,0,1,"dummy"
"64644",1,4,3,8,"dummy"
"64645",0,1,0,1,"dummy"
"64646",0,4,0,4,"dummy"
"64647",0,0,1,1,"dummy"
"64648",0,1,0,1,"dummy"
"64649",0,1,0,1,"dummy"
"64650",0,1,0,1,"dummy"
"64651",2,0,2,4,"dummy"
"64671",0,1,0,1,"dummy"
"64672",0,1,0,1,"dummy"
"64675",0,0,1,1,"dummy"
"64678",0,0,1,1,"dummy"
"64679",0,0,0,0,"dummy"
"64680",0,2,0,2,"dummy"
"64687",11,1,0,12,"dummy"
"64688",0,2,0,2,"dummy"
"64703",0,0,3,3,"dummy"
"64704",2,1,1,4,"dummy"
"64705",4,1,0,5,"dummy"
"64706",0,0,1,1,"dummy"
"64707",1,3,2,6,"dummy"
"64713",3,4,2,9,"dummy"
"64714",4,3,2,9,"dummy"
"64746",0,0,1,1,"dummy"
"64750",1,0,1,2,"dummy"
"64751",2,1,1,4,"dummy"
"64752",1,2,0,3,"dummy"
"64753",1,1,0,2,"dummy"
"64756",0,0,0,0,"dummy"
"64759",0,0,0,0,"dummy"
"64830",0,0,0,0,"dummy"
"64831",0,0,0,0,"dummy"
"64832",1,2,2,5,"dummy"
"64833",0,2,0,2,"dummy"
"64834",0,0,1,1,"dummy"
"64835",0,9,0,9,"dummy"
"64836",2,0,1,3,"dummy"
"64837",0,0,1,1,"dummy"
"64838",9,0,0,9,"dummy"
"64839",0,0,0,0,"dummy"
"64840",0,0,1,1,"dummy"
"64843",0,0,1,1,"dummy"
"64844",0,0,0,0,"dummy"
"64847",6,2,1,9,"dummy"
"64848",0,8,0,8,"dummy"
"64849",0,0,1,1,"dummy"
"64850",2,0,0,2,"dummy"
"64851",6,0,2,8,"dummy"
"64872",0,3,0,3,"dummy"
"64873",1,1,0,2,"dummy"
"64874",1,0,0,1,"dummy"
"64875",1,4,0,5,"dummy"
"64906",4,19,3,26,"dummy"
"64909",0,22,0,22,"dummy"
"64910",13,26,5,44,"dummy"
"64911",1,1,4,6,"dummy"
"64912",0,0,0,0,"dummy"
"64917",0,0,1,1,"dummy"
"64918",0,0,1,1,"dummy"
"64921",2,11,4,17,"dummy"
"64924",0,0,0,0,"dummy"
"64925",0,0,0,0,"dummy"
"64928",0,2,0,2,"dummy"
"64929",0,0,1,1,"dummy"
"64930",2,2,0,4,"dummy"
"64931",0,0,1,1,"dummy"
"64932",0,1,0,1,"dummy"
"64940",2,2,0,4,"dummy"
"64941",2,1,0,3,"dummy"
"64942",8,10,1,19,"dummy"
"64943",3,5,0,8,"dummy"
"64953",0,2,0,2,"dummy"
"64657",2,0,0,2,"dummy"
"64658",0,1,0,1,"dummy"
"64659",1,3,1,5,"dummy"
"64660",2,3,0,5,"dummy"
"64661",3,0,1,4,"dummy"
"64662",0,0,1,1,"dummy"
"64663",0,0,1,1,"dummy"
"64664",0,0,1,1,"dummy"
"64667",4,13,3,20,"dummy"
"64668",2,1,2,5,"dummy"
"64669",0,5,0,5,"dummy"
"64682",0,0,1,1,"dummy"
"64683",1,2,0,3,"dummy"
"64690",0,2,0,2,"dummy"
"64691",0,1,1,2,"dummy"
"64694",0,4,3,7,"dummy"
"64695",0,0,2,2,"dummy"
"64696",1,0,0,1,"dummy"
"64697",0,0,3,3,"dummy"
"64698",1,0,0,1,"dummy"
"64699",5,1,0,6,"dummy"
"64700",4,0,0,4,"dummy"
"64701",7,3,4,14,"dummy"
"64709",2,1,0,3,"dummy"
"64710",0,2,0,2,"dummy"
"64711",0,1,0,1,"dummy"
"64748",0,1,0,1,"dummy"
"64761",0,1,3,4,"dummy"
"64857",0,0,1,1,"dummy"
"64858",0,0,0,0,"dummy"
"64859",0,1,0,1,"dummy"
"64860",4,1,0,5,"dummy"
"64861",0,0,0,0,"dummy"
"64862",0,1,0,1,"dummy"
"64863",1,4,0,5,"dummy"
"64864",4,0,0,4,"dummy"
"64865",0,3,2,5,"dummy"
"64866",0,0,3,3,"dummy"
"64867",0,0,3,3,"dummy"
"64868",1,1,2,4,"dummy"
"64879",2,0,0,2,"dummy"
"64882",1,6,1,8,"dummy"
"64883",1,0,0,1,"dummy"
"64884",0,1,0,1,"dummy"
"64885",2,2,0,4,"dummy"
"64886",6,13,4,23,"dummy"
"64887",7,0,5,12,"dummy"
"64888",0,0,1,1,"dummy"
"64889",2,2,1,5,"dummy"
"64892",0,2,0,2,"dummy"
"64893",7,5,0,12,"dummy"
"64894",7,10,0,17,"dummy"
"64895",0,2,0,2,"dummy"
"64896",2,5,0,7,"dummy"
"64897",0,4,0,4,"dummy"
"64898",0,0,2,2,"dummy"
"64899",6,16,7,29,"dummy"
"64900",0,2,10,12,"dummy"
"64947",0,1,0,1,"dummy"
"64948",0,4,0,4,"dummy"
"64949",0,0,1,1,"dummy"
"64950",0,6,0,6,"dummy"
"64951",12,7,1,20,"dummy"
"64962",0,4,1,5,"dummy"
"64971",3,2,2,7,"dummy"
"64972",0,1,1,2,"dummy"
"64973",0,1,0,1,"dummy"
"64978",2,2,1,5,"dummy"
"64979",2,0,1,3,"dummy"
"64983",0,0,1,1,"dummy"
"64984",0,0,1,1,"dummy"
"64985",0,0,1,1,"dummy"
"64999",0,2,0,2,"dummy"
"65000",0,3,0,3,"dummy"
"65001",0,1,0,1,"dummy"
"65002",0,2,0,2,"dummy"
"65003",0,2,0,2,"dummy"
"65004",0,2,0,2,"dummy"
"65005",4,6,0,10,"dummy"
"65006",0,1,1,2,"dummy"
"65007",14,30,2,46,"dummy"
"65008",2,2,5,9,"dummy"
"64954",0,1,0,1,"dummy"
"64955",0,0,1,1,"dummy"
"64956",0,4,2,6,"dummy"
"64975",0,2,0,2,"dummy"
"64976",0,3,3,6,"dummy"
"64981",0,0,1,1,"dummy"
"64987",3,3,1,7,"dummy"
"64988",0,1,0,1,"dummy"
"64989",0,1,0,1,"dummy"
"64996",0,0,2,2,"dummy"
"64997",0,0,2,2,"dummy"
"65014",3,2,6,11,"dummy"
"65015",0,2,0,2,"dummy"
"65029",1,1,0,2,"dummy"
"65030",3,5,5,13,"dummy"
"65033",2,4,0,6,"dummy"
"65034",0,2,0,2,"dummy"
"65035",0,2,0,2,"dummy"
"65036",10,2,0,12,"dummy"
"65037",0,2,0,2,"dummy"
"65038",0,0,0,0,"dummy"
"65041",0,0,1,1,"dummy"
"65046",0,1,0,1,"dummy"
"65052",0,0,1,1,"dummy"
"65053",0,0,1,1,"dummy"
"65058",0,3,0,3,"dummy"
"65059",0,0,1,1,"dummy"
"65060",0,0,2,2,"dummy"
"65061",0,0,1,1,"dummy"
"65062",0,1,1,2,"dummy"
"65063",0,0,1,1,"dummy"
"65064",0,1,1,2,"dummy"
"65065",9,8,0,17,"dummy"
"65078",0,0,3,3,"dummy"
"65090",0,0,1,1,"dummy"
"65091",0,0,0,0,"dummy"
"65092",0,0,0,0,"dummy"
"65093",1,1,2,4,"dummy"
"65100",0,1,0,1,"dummy"
"65111",3,3,0,6,"dummy"
"65123",0,0,1,1,"dummy"
"65129",0,1,0,1,"dummy"
"65130",1,9,4,14,"dummy"
"65133",0,0,3,3,"dummy"
"65136",0,0,2,2,"dummy"
"65157",0,2,0,2,"dummy"
"65158",0,0,0,0,"dummy"
"65159",0,0,0,0,"dummy"
"65190",4,5,4,13,"dummy"
"65191",5,4,3,12,"dummy"
"65192",0,1,0,1,"dummy"
"65193",0,2,0,2,"dummy"
"65194",1,0,0,1,"dummy"
"65195",2,0,0,2,"dummy"
"65196",0,2,0,2,"dummy"
"65197",0,1,0,1,"dummy"
"65198",1,5,0,6,"dummy"
"65199",2,3,0,5,"dummy"
"65050",0,0,2,2,"dummy"
"65069",0,0,2,2,"dummy"
"65070",0,0,2,2,"dummy"
"65071",22,5,4,31,"dummy"
"65072",0,0,1,1,"dummy"
"65073",5,22,4,31,"dummy"
"65074",0,0,2,2,"dummy"
"65080",0,0,0,0,"dummy"
"65081",1,1,0,2,"dummy"
"65082",1,0,0,1,"dummy"
"65085",0,1,0,1,"dummy"
"65086",1,0,0,1,"dummy"
"65087",1,1,0,2,"dummy"
"65088",0,1,0,1,"dummy"
"65109",0,0,1,1,"dummy"
"65113",0,1,0,1,"dummy"
"65114",1,0,1,2,"dummy"
"65118",0,0,1,1,"dummy"
"65119",7,11,4,22,"dummy"
"65120",0,1,0,1,"dummy"
"65121",0,1,0,1,"dummy"
"65127",0,0,2,2,"dummy"
"65142",1,1,0,2,"dummy"
"65143",0,4,1,5,"dummy"
"65146",5,28,0,33,"dummy"
"65147",7,0,1,8,"dummy"
"65152",1,2,1,4,"dummy"
"65153",0,0,0,0,"dummy"
"65170",0,10,0,10,"dummy"
"65171",0,1,0,1,"dummy"
"65172",5,9,0,14,"dummy"
"65173",0,1,0,1,"dummy"
"65174",10,0,2,12,"dummy"
"65175",2,0,0,2,"dummy"
"65176",1,3,0,4,"dummy"
"65177",0,5,0,5,"dummy"
"65178",4,0,0,4,"dummy"
"65179",0,3,0,3,"dummy"
"65180",2,2,0,4,"dummy"
"65181",0,2,0,2,"dummy"
"65182",0,2,0,2,"dummy"
"65183",5,6,0,11,"dummy"
"65184",0,0,0,0,"dummy"
"65208",0,0,1,1,"dummy"
"65217",0,3,0,3,"dummy"
"65218",0,0,1,1,"dummy"
"65219",0,2,0,2,"dummy"
"65225",0,0,3,3,"dummy"
"65226",0,0,1,1,"dummy"
"65227",0,9,0,9,"dummy"
"65228",0,0,1,1,"dummy"
"65229",2,4,0,6,"dummy"
"65230",0,0,2,2,"dummy"
"65231",0,0,1,1,"dummy"
"65232",0,0,1,1,"dummy"
"65233",1,4,3,8,"dummy"
"65234",0,0,2,2,"dummy"
"65235",0,3,0,3,"dummy"
"65236",0,0,2,2,"dummy"
"65237",0,0,1,1,"dummy"
"65247",0,6,0,6,"dummy"
"65252",0,0,1,1,"dummy"
"65253",3,3,0,6,"dummy"
"65254",0,0,1,1,"dummy"
"65255",0,0,1,1,"dummy"
"65260",0,0,1,1,"dummy"
"65261",10,9,1,20,"dummy"
"65262",0,0,2,2,"dummy"
"65263",0,0,1,1,"dummy"
"65264",0,0,1,1,"dummy"
"65265",0,0,1,1,"dummy"
"65266",0,0,2,2,"dummy"
"65200",0,1,0,1,"dummy"
"65201",2,0,0,2,"dummy"
"65202",0,0,1,1,"dummy"
"65203",1,0,0,1,"dummy"
"65204",1,5,0,6,"dummy"
"65205",12,21,0,33,"dummy"
"65206",21,12,0,33,"dummy"
"65221",1,3,1,5,"dummy"
"65222",1,1,0,2,"dummy"
"65223",0,3,0,3,"dummy"
"65239",0,0,1,1,"dummy"
"65240",0,0,1,1,"dummy"
"65241",0,0,1,1,"dummy"
"65242",0,0,1,1,"dummy"
"65243",0,0,1,1,"dummy"
"65244",0,3,0,3,"dummy"
"65245",0,0,1,1,"dummy"
"65270",0,1,0,1,"dummy"
"65284",1,2,0,3,"dummy"
"65285",2,1,0,3,"dummy"
"65286",2,6,3,11,"dummy"
"65296",0,0,2,2,"dummy"
"65309",0,0,0,0,"dummy"
"65310",0,1,0,1,"dummy"
"65311",2,1,0,3,"dummy"
"65312",0,0,1,1,"dummy"
"65326",0,1,1,2,"dummy"
"65327",0,2,0,2,"dummy"
"65330",0,1,0,1,"dummy"
"65348",0,1,0,1,"dummy"
"65349",0,0,0,0,"dummy"
"65354",0,2,0,2,"dummy"
"65355",2,0,0,2,"dummy"
"65356",7,0,1,8,"dummy"
"65357",0,0,0,0,"dummy"
"65358",0,0,0,0,"dummy"
"65359",0,0,0,0,"dummy"
"65373",1,22,2,25,"dummy"
"65374",2,0,4,6,"dummy"
"65375",0,1,1,2,"dummy"
"65376",0,0,2,2,"dummy"
"65377",0,3,4,7,"dummy"
"65378",0,0,1,1,"dummy"
"65379",0,0,1,1,"dummy"
"65380",1,0,0,1,"dummy"
"65387",0,2,0,2,"dummy"
"65388",0,2,0,2,"dummy"
"65389",0,0,0,0,"dummy"
"65399",0,1,2,3,"dummy"
"65400",0,0,0,0,"dummy"
"65401",0,2,0,2,"dummy"
"65402",5,0,2,7,"dummy"
"65403",1,0,0,1,"dummy"
"65429",0,3,0,3,"dummy"
"65430",0,0,2,2,"dummy"
"65431",0,0,2,2,"dummy"
"65272",1,2,0,3,"dummy"
"65275",0,1,0,1,"dummy"
"65278",6,0,0,6,"dummy"
"65279",2,5,2,9,"dummy"
"65282",0,1,0,1,"dummy"
"65288",0,1,1,2,"dummy"
"65291",0,0,1,1,"dummy"
"65292",0,0,1,1,"dummy"
"65293",1,10,2,13,"dummy"
"65294",0,0,1,1,"dummy"
"65298",0,0,1,1,"dummy"
"65299",0,0,1,1,"dummy"
"65300",0,0,1,1,"dummy"
"65301",0,0,2,2,"dummy"
"65302",0,1,0,1,"dummy"
"65314",0,3,0,3,"dummy"
"65315",1,0,0,1,"dummy"
"65316",0,0,2,2,"dummy"
"65321",1,7,2,10,"dummy"
"65324",0,0,1,1,"dummy"
"65332",0,1,0,1,"dummy"
"65333",1,5,1,7,"dummy"
"65334",0,7,0,7,"dummy"
"65335",0,3,0,3,"dummy"
"65336",0,1,0,1,"dummy"
"65341",7,1,1,9,"dummy"
"65342",5,1,1,7,"dummy"
"65343",1,0,0,1,"dummy"
"65344",0,1,0,1,"dummy"
"65351",2,2,2,6,"dummy"
"65352",2,2,2,6,"dummy"
"65363",0,0,1,1,"dummy"
"65364",0,1,0,1,"dummy"
"65365",0,1,0,1,"dummy"
"65366",15,1,0,16,"dummy"
"65367",0,0,0,0,"dummy"
"65368",0,0,1,1,"dummy"
"65369",0,0,1,1,"dummy"
"65370",0,0,0,0,"dummy"
"65371",0,0,0,0,"dummy"
"65382",0,1,0,1,"dummy"
"65391",1,1,0,2,"dummy"
"65392",2,0,0,2,"dummy"
"65393",0,0,0,0,"dummy"
"65394",0,0,0,0,"dummy"
"65395",0,0,1,1,"dummy"
"65396",0,3,0,3,"dummy"
"65397",0,21,0,21,"dummy"
"65416",0,19,0,19,"dummy"
"65417",0,1,0,1,"dummy"
"65418",1,4,0,5,"dummy"
"65419",4,10,1,15,"dummy"
"65420",1,1,2,4,"dummy"
"65421",1,1,0,2,"dummy"
"65422",0,0,1,1,"dummy"
"65423",1,0,0,1,"dummy"
"65424",0,0,1,1,"dummy"
"65427",0,0,0,0,"dummy"
"65435",4,8,0,12,"dummy"
"65451",0,5,0,5,"dummy"
"65458",0,1,0,1,"dummy"
"65459",0,0,1,1,"dummy"
"65460",9,42,2,53,"dummy"
"65466",3,5,0,8,"dummy"
"65467",3,6,5,14,"dummy"
"65470",0,3,0,3,"dummy"
"65471",0,1,0,1,"dummy"
"65472",0,1,2,3,"dummy"
"65473",1,17,0,18,"dummy"
"65474",2,1,0,3,"dummy"
"65453",0,2,0,2,"dummy"
"65456",4,3,0,7,"dummy"
"65462",3,7,1,11,"dummy"
"65482",0,0,1,1,"dummy"
"65483",0,2,0,2,"dummy"
"65484",1,1,0,2,"dummy"
"65485",0,0,1,1,"dummy"
"65486",3,3,1,7,"dummy"
"65475",0,8,0,8,"dummy"
"65476",13,8,3,24,"dummy"
"65477",0,3,0,3,"dummy"
"65478",0,0,2,2,"dummy"
"65525",2,2,0,4,"dummy"
"65526",0,1,0,1,"dummy"
"65527",0,2,0,2,"dummy"
"65528",0,0,1,1,"dummy"
"65529",0,0,1,1,"dummy"
"65530",0,1,0,1,"dummy"
"65531",0,0,1,1,"dummy"
"65532",0,0,0,0,"dummy"
"65533",0,3,1,4,"dummy"
"65534",3,0,2,5,"dummy"
"65535",0,3,1,4,"dummy"
"65544",0,0,2,2,"dummy"
"65546",0,4,0,4,"dummy"
"65547",1,4,0,5,"dummy"
"65548",3,0,0,3,"dummy"
"65550",6,0,0,6,"dummy"
"65551",2,5,2,9,"dummy"
"65553",1,0,0,1,"dummy"
"65554",1,0,0,1,"dummy"
"65556",1,0,1,2,"dummy"
"65558",0,4,1,5,"dummy"
"65559",2,2,0,4,"dummy"
"65564",0,0,2,2,"dummy"
"65567",3,2,0,5,"dummy"
"65569",1,8,1,10,"dummy"
"65570",8,1,1,10,"dummy"
"65571",0,1,0,1,"dummy"
"65575",0,7,0,7,"dummy"
"65576",1,0,0,1,"dummy"
"65581",1,4,0,5,"dummy"
"65582",1,6,0,7,"dummy"
"65583",1,1,0,2,"dummy"
"65584",0,0,0,0,"dummy"
"65585",0,0,0,0,"dummy"
"65586",1,1,1,3,"dummy"
"65587",0,0,1,1,"dummy"
"65588",1,1,1,3,"dummy"
"65589",0,1,0,1,"dummy"
"65591",0,6,0,6,"dummy"
"65592",2,1,2,5,"dummy"
"65595",1,3,2,6,"dummy"
"65609",0,1,0,1,"dummy"
"65611",13,4,3,20,"dummy"
"65612",0,0,0,0,"dummy"
"65613",0,1,0,1,"dummy"
"65614",0,0,0,0,"dummy"
"65615",0,0,1,1,"dummy"
"65616",0,0,1,1,"dummy"
"65617",0,0,1,1,"dummy"
"65618",0,0,2,2,"dummy"
"65619",0,0,2,2,"dummy"
"65620",0,0,0,0,"dummy"
"65621",0,0,1,1,"dummy"
"65622",0,0,1,1,"dummy"
"65623",0,0,2,2,"dummy"
"65624",0,0,1,1,"dummy"
"65625",0,0,1,1,"dummy"
"65626",0,0,1,1,"dummy"
"65627",0,2,1,3,"dummy"
"65628",0,0,0,0,"dummy"
"65629",0,0,1,1,"dummy"
"65630",1,0,0,1,"dummy"
"65631",0,0,0,0,"dummy"
"65632",0,2,0,2,"dummy"
"65634",0,0,2,2,"dummy"
"65636",0,1,0,1,"dummy"
"65637",0,1,0,1,"dummy"
"65640",0,0,1,1,"dummy"
"65641",2,0,0,2,"dummy"
"65642",0,0,0,0,"dummy"
"65643",0,0,0,0,"dummy"
"65644",0,2,0,2,"dummy"
"65645",0,0,2,2,"dummy"
"65646",0,0,0,0,"dummy"
"65647",0,0,0,0,"dummy"
"65649",0,0,1,1,"dummy"
"65650",0,0,1,1,"dummy"
"65651",3,1,2,6,"dummy"
"65652",0,0,2,2,"dummy"
"65653",0,1,0,1,"dummy"
"65654",0,0,1,1,"dummy"
"65655",0,0,1,1,"dummy"
"65656",2,2,2,6,"dummy"
"65657",0,9,0,9,"dummy"
"65658",0,0,1,1,"dummy"
"65662",1,0,1,2,"dummy"
"65663",0,0,2,2,"dummy"
"65664",5,5,3,13,"dummy"
"65665",0,1,3,4,"dummy"
"65666",0,3,0,3,"dummy"
"65667",0,2,0,2,"dummy"
"65685",0,0,3,3,"dummy"
"65688",1,0,0,1,"dummy"
"65689",9,39,2,50,"dummy"
"65690",8,7,2,17,"dummy"
"65695",1,3,0,4,"dummy"
"65701",0,4,1,5,"dummy"
"65703",0,0,2,2,"dummy"
"65705",2,2,0,4,"dummy"
"65708",0,2,0,2,"dummy"
"65711",0,0,3,3,"dummy"
"65712",0,2,0,2,"dummy"
"65713",0,2,0,2,"dummy"
"65714",0,1,0,1,"dummy"
"65718",0,0,1,1,"dummy"
"65719",0,1,2,3,"dummy"
"65720",0,0,1,1,"dummy"
"65721",0,0,1,1,"dummy"
"65722",0,0,1,1,"dummy"
"65723",0,0,1,1,"dummy"
"65724",0,0,1,1,"dummy"
"65725",0,0,1,1,"dummy"
"65726",0,0,1,1,"dummy"
"65727",0,0,1,1,"dummy"
"65728",0,0,1,1,"dummy"
"65729",0,0,1,1,"dummy"
"65730",0,0,0,0,"dummy"
"65731",0,0,1,1,"dummy"
"65732",0,0,1,1,"dummy"
"65739",1,3,0,4,"dummy"
"65741",1,1,1,3,"dummy"
"65742",1,0,0,1,"dummy"
"65743",0,0,2,2,"dummy"
"65745",9,4,0,13,"dummy"
"65746",1,1,1,3,"dummy"
"65747",1,1,1,3,"dummy"
"65749",0,1,2,3,"dummy"
"65750",2,3,0,5,"dummy"
"65751",2,6,2,10,"dummy"
"65752",0,1,0,1,"dummy"
"65753",52,7,2,61,"dummy"
"65754",0,1,2,3,"dummy"
"65755",0,1,0,1,"dummy"
"65756",7,2,3,12,"dummy"
"65759",0,1,0,1,"dummy"
"65760",0,0,1,1,"dummy"
"65762",1,0,0,1,"dummy"
"65764",0,0,1,1,"dummy"
"65766",2,2,0,4,"dummy"
"65767",0,0,1,1,"dummy"
"65768",0,1,0,1,"dummy"
"65770",0,0,1,1,"dummy"
"65777",1,21,0,22,"dummy"
"65778",0,3,1,4,"dummy"
"65779",0,1,0,1,"dummy"
"65780",0,1,0,1,"dummy"
"65781",0,2,0,2,"dummy"
"65782",6,8,0,14,"dummy"
"65783",8,0,0,8,"dummy"
"65784",0,7,0,7,"dummy"
"65785",17,5,0,22,"dummy"
"65786",0,0,0,0,"dummy"
"65787",2,4,2,8,"dummy"
"65789",0,0,1,1,"dummy"
"65790",0,0,0,0,"dummy"
"65791",0,12,0,12,"dummy"
"65792",0,1,0,1,"dummy"
"65793",0,0,1,1,"dummy"
"65795",2,5,2,9,"dummy"
"65796",0,0,2,2,"dummy"
"65799",1,1,0,2,"dummy"
"65800",0,0,0,0,"dummy"
"65801",0,0,3,3,"dummy"
"65813",0,6,1,7,"dummy"
"65814",0,0,1,1,"dummy"
"65815",0,1,2,3,"dummy"
"65816",1,2,1,4,"dummy"
"65819",0,1,0,1,"dummy"
"65820",0,2,0,2,"dummy"
"65821",0,1,0,1,"dummy"
"65823",0,6,1,7,"dummy"
"65824",8,2,0,10,"dummy"
"65825",5,9,1,15,"dummy"
"65826",0,1,0,1,"dummy"
"65827",0,2,0,2,"dummy"
"65828",0,2,0,2,"dummy"
"65830",0,1,0,1,"dummy"
"65831",0,0,0,0,"dummy"
"65832",0,0,0,0,"dummy"
"65833",0,1,0,1,"dummy"
"65834",0,0,1,1,"dummy"
"65836",0,4,0,4,"dummy"
"65837",0,1,0,1,"dummy"
"65838",0,2,0,2,"dummy"
"65839",1,0,0,1,"dummy"
"65840",3,5,1,9,"dummy"
"65842",0,2,0,2,"dummy"
"65846",6,0,0,6,"dummy"
"65848",0,0,1,1,"dummy"
"65854",0,1,0,1,"dummy"
"65860",3,0,0,3,"dummy"
"65876",1,0,0,1,"dummy"
"65877",12,0,1,13,"dummy"
"65878",3,0,0,3,"dummy"
"65879",0,1,0,1,"dummy"
"65880",0,0,2,2,"dummy"
"65881",0,0,2,2,"dummy"
"65882",0,0,1,1,"dummy"
"65884",0,1,0,1,"dummy"
"65885",0,0,1,1,"dummy"
"65886",0,0,1,1,"dummy"
"65887",0,1,2,3,"dummy"
"65890",0,9,1,10,"dummy"
"65891",0,2,0,2,"dummy"
"65892",0,1,0,1,"dummy"
"65893",1,0,0,1,"dummy"
"65894",1,2,1,4,"dummy"
"65895",3,1,0,4,"dummy"
"65896",0,0,2,2,"dummy"
"65897",3,4,0,7,"dummy"
"65898",9,3,0,12,"dummy"
"65899",0,1,0,1,"dummy"
"65900",0,0,3,3,"dummy"
"65916",0,1,0,1,"dummy"
"65917",0,2,0,2,"dummy"
"65918",2,0,0,2,"dummy"
"65927",0,0,1,1,"dummy"
"65938",1,1,1,3,"dummy"
"65941",9,2,0,11,"dummy"
"65942",0,0,3,3,"dummy"
"65946",0,1,1,2,"dummy"
"65947",0,0,1,1,"dummy"
"65958",0,0,1,1,"dummy"
"65959",0,1,0,1,"dummy"
"65960",0,1,0,1,"dummy"
"65961",0,0,2,2,"dummy"
"65962",27,0,3,30,"dummy"
"65963",0,0,2,2,"dummy"
"65964",0,0,2,2,"dummy"
"65965",2,0,0,2,"dummy"
"65966",0,0,2,2,"dummy"
"65970",4,9,1,14,"dummy"
"65972",3,6,3,12,"dummy"
"65973",0,3,0,3,"dummy"
"65974",6,15,0,21,"dummy"
"65975",2,0,0,2,"dummy"
"65976",2,2,0,4,"dummy"
"65977",3,5,0,8,"dummy"
"65979",2,4,0,6,"dummy"
"65980",0,2,0,2,"dummy"
"65981",0,2,0,2,"dummy"
"65982",10,2,0,12,"dummy"
"65983",0,2,0,2,"dummy"
"65984",0,0,0,0,"dummy"
"65985",0,0,3,3,"dummy"
"65986",0,5,0,5,"dummy"
"65987",1,0,1,2,"dummy"
"65992",0,1,1,2,"dummy"
"65993",1,2,1,4,"dummy"
"65994",1,2,0,3,"dummy"
"65995",1,1,0,2,"dummy"
"65996",0,1,0,1,"dummy"
"65997",0,2,0,2,"dummy"
"65998",0,0,1,1,"dummy"
"65999",0,0,2,2,"dummy"
"66000",0,2,0,2,"dummy"
"66001",10,0,0,10,"dummy"
"66002",1,0,0,1,"dummy"
"66003",2,0,0,2,"dummy"
"66007",2,2,0,4,"dummy"
"66008",0,1,1,2,"dummy"
"66009",1,0,0,1,"dummy"
"66059",4,5,1,10,"dummy"
"66067",4,4,0,8,"dummy"
"66070",0,0,0,0,"dummy"
"66071",4,0,0,4,"dummy"
"66072",0,0,0,0,"dummy"
"66074",5,1,4,10,"dummy"
"66075",6,10,4,20,"dummy"
"66076",0,0,3,3,"dummy"
"66077",0,1,0,1,"dummy"
"66079",0,0,1,1,"dummy"
"66081",0,0,0,0,"dummy"
"66082",0,0,0,0,"dummy"
"66084",4,23,3,30,"dummy"
"66085",7,10,1,18,"dummy"
"66086",2,0,2,4,"dummy"
"66087",0,4,0,4,"dummy"
"66088",2,0,0,2,"dummy"
"66089",4,4,0,8,"dummy"
"66091",0,4,0,4,"dummy"
"66092",0,0,1,1,"dummy"
"66093",0,3,3,6,"dummy"
"66094",0,1,0,1,"dummy"
"66095",2,10,0,12,"dummy"
"66096",0,1,0,1,"dummy"
"66097",0,1,0,1,"dummy"
"66099",0,2,0,2,"dummy"
"66101",1,4,3,8,"dummy"
"66103",0,0,1,1,"dummy"
"66105",0,1,2,3,"dummy"
"66205",0,3,0,3,"dummy"
"66206",0,0,0,0,"dummy"
"66207",3,0,0,3,"dummy"
"66208",0,3,0,3,"dummy"
"66209",0,0,1,1,"dummy"
"66211",0,0,0,0,"dummy"
"66212",0,0,0,0,"dummy"
"66215",0,3,3,6,"dummy"
"66220",0,0,1,1,"dummy"
"66223",1,1,0,2,"dummy"
"66224",1,2,0,3,"dummy"
"66225",1,1,0,2,"dummy"
"66226",0,1,0,1,"dummy"
"66227",0,2,0,2,"dummy"
"66228",1,1,1,3,"dummy"
"66229",0,1,0,1,"dummy"
"66230",1,3,0,4,"dummy"
"66231",0,0,1,1,"dummy"
"66232",1,1,0,2,"dummy"
"66233",0,1,0,1,"dummy"
"66234",0,1,0,1,"dummy"
"66235",0,1,0,1,"dummy"
"66236",1,0,0,1,"dummy"
"66237",2,1,0,3,"dummy"
"66238",1,7,1,9,"dummy"
"66239",0,0,3,3,"dummy"
"66240",0,2,0,2,"dummy"
"66241",0,1,0,1,"dummy"
"66242",0,1,0,1,"dummy"
"66243",2,10,0,12,"dummy"
"66244",2,1,1,4,"dummy"
"66245",1,3,0,4,"dummy"
"66246",0,0,0,0,"dummy"
"66247",1,0,1,2,"dummy"
"66248",2,1,0,3,"dummy"
"66249",1,3,0,4,"dummy"
"66250",0,0,1,1,"dummy"
"66251",1,1,0,2,"dummy"
"66252",2,5,0,7,"dummy"
"66253",0,1,0,1,"dummy"
"66254",0,1,1,2,"dummy"
"66255",1,1,0,2,"dummy"
"66256",0,2,0,2,"dummy"
"66257",0,6,0,6,"dummy"
"66258",1,2,1,4,"dummy"
"66259",1,1,0,2,"dummy"
"66260",2,3,1,6,"dummy"
"66261",8,4,1,13,"dummy"
"66262",0,2,1,3,"dummy"
"66263",0,9,0,9,"dummy"
"66265",1,14,4,19,"dummy"
"66266",0,2,0,2,"dummy"
"66270",0,1,0,1,"dummy"
"66271",0,8,0,8,"dummy"
"66272",0,2,0,2,"dummy"
"66274",2,0,1,3,"dummy"
"66276",1,0,2,3,"dummy"
"66277",0,0,1,1,"dummy"
"66278",0,0,1,1,"dummy"
"66304",0,1,0,1,"dummy"
"66305",0,0,1,1,"dummy"
"66352",1,1,1,3,"dummy"
"66353",0,4,0,4,"dummy"
"66354",4,0,3,7,"dummy"
"66355",1,2,0,3,"dummy"
"66356",1,1,0,2,"dummy"
"66357",1,0,0,1,"dummy"
"66358",0,3,0,3,"dummy"
"66359",12,19,4,35,"dummy"
"66360",11,5,0,16,"dummy"
"66361",13,16,4,33,"dummy"
"66362",0,2,0,2,"dummy"
"66364",0,3,1,4,"dummy"
"66366",0,1,0,1,"dummy"
"66368",2,2,1,5,"dummy"
"66369",1,2,0,3,"dummy"
"66370",0,0,1,1,"dummy"
"66371",2,4,1,7,"dummy"
"66372",1,1,0,2,"dummy"
"66373",0,4,2,6,"dummy"
"66374",0,0,1,1,"dummy"
"66376",3,0,0,3,"dummy"
"66378",0,3,0,3,"dummy"
"66379",0,0,0,0,"dummy"
"66381",0,0,1,1,"dummy"
"66383",0,0,1,1,"dummy"
"66384",0,0,3,3,"dummy"
"66386",5,0,1,6,"dummy"
"66387",2,0,0,2,"dummy"
"66388",0,1,1,2,"dummy"
"66390",0,0,0,0,"dummy"
"66392",0,0,0,0,"dummy"
"66393",1,0,0,1,"dummy"
"66394",0,0,1,1,"dummy"
"66395",1,1,0,2,"dummy"
"66396",0,0,1,1,"dummy"
"66397",0,1,0,1,"dummy"
"66398",0,2,0,2,"dummy"
"66399",0,0,2,2,"dummy"
"66400",0,0,0,0,"dummy"
"66401",0,0,0,0,"dummy"
"66402",4,0,0,4,"dummy"
"66403",0,0,0,0,"dummy"
"66404",0,0,0,0,"dummy"
"66405",0,0,0,0,"dummy"
"66409",1,1,0,2,"dummy"
"66410",1,0,0,1,"dummy"
"66411",0,3,0,3,"dummy"
"66412",0,1,0,1,"dummy"
"66413",0,1,0,1,"dummy"
"66415",12,12,2,26,"dummy"
"66416",0,0,0,0,"dummy"
"66417",0,0,0,0,"dummy"
"66418",0,0,0,0,"dummy"
"66420",0,0,1,1,"dummy"
"66422",0,14,1,15,"dummy"
"66423",3,27,2,32,"dummy"
"66424",0,4,0,4,"dummy"
"66425",0,18,0,18,"dummy"
"66426",0,3,0,3,"dummy"
"66427",43,13,0,56,"dummy"
"66436",0,3,0,3,"dummy"
"66437",0,0,0,0,"dummy"
"66452",11,36,4,51,"dummy"
"66453",1,1,0,2,"dummy"
"66454",1,0,0,1,"dummy"
"66463",0,1,0,1,"dummy"
"66464",1,0,0,1,"dummy"
"66465",1,0,0,1,"dummy"
"66467",3,9,0,12,"dummy"
"66468",1,0,0,1,"dummy"
"66469",0,1,0,1,"dummy"
"66476",0,0,0,0,"dummy"
"66478",0,0,1,1,"dummy"
"66482",6,0,0,6,"dummy"
"66484",1,0,1,2,"dummy"
"66485",0,2,0,2,"dummy"
"66491",0,1,0,1,"dummy"
"66493",3,3,1,7,"dummy"
"66496",0,1,0,1,"dummy"
"66509",0,0,2,2,"dummy"
"66510",9,21,5,35,"dummy"
"66511",14,4,4,22,"dummy"
"66512",1,2,0,3,"dummy"
"66513",0,1,0,1,"dummy"
"66514",1,1,2,4,"dummy"
"66515",2,17,0,19,"dummy"
"66516",1,1,0,2,"dummy"
"66517",17,6,0,23,"dummy"
"66518",4,3,4,11,"dummy"
"66519",0,0,1,1,"dummy"
"66520",4,3,1,8,"dummy"
"66521",0,0,1,1,"dummy"
"66522",0,9,1,10,"dummy"
"66525",0,1,0,1,"dummy"
"66526",3,2,0,5,"dummy"
"66527",0,1,0,1,"dummy"
"66528",0,3,0,3,"dummy"
"66529",0,0,0,0,"dummy"
"66530",3,0,0,3,"dummy"
"66531",0,0,2,2,"dummy"
"66532",0,0,1,1,"dummy"
"66533",0,2,1,3,"dummy"
"66534",5,1,1,7,"dummy"
"66535",0,0,1,1,"dummy"
"66536",0,0,0,0,"dummy"
"66537",0,0,0,0,"dummy"
"66538",0,2,1,3,"dummy"
"66539",0,0,1,1,"dummy"
"66541",3,3,1,7,"dummy"
"66542",0,3,0,3,"dummy"
"66544",1,3,0,4,"dummy"
"66569",0,2,0,2,"dummy"
"66573",1,0,0,1,"dummy"
"66574",0,1,0,1,"dummy"
"66575",0,2,2,4,"dummy"
"66576",0,0,1,1,"dummy"
"66577",1,0,1,2,"dummy"
"66578",1,1,4,6,"dummy"
"66579",0,0,1,1,"dummy"
"66592",0,2,0,2,"dummy"
"66593",0,0,1,1,"dummy"
"66594",1,2,0,3,"dummy"
"66596",0,4,0,4,"dummy"
"66607",2,2,1,5,"dummy"
"66608",3,5,0,8,"dummy"
"66612",3,0,2,5,"dummy"
"66614",2,0,1,3,"dummy"
"66615",0,6,0,6,"dummy"
"66616",0,1,0,1,"dummy"
"66617",2,0,0,2,"dummy"
"66618",6,0,0,6,"dummy"
"66619",0,1,0,1,"dummy"
"66620",1,0,1,2,"dummy"
"66621",0,1,0,1,"dummy"
"66622",0,0,2,2,"dummy"
"66623",1,0,0,1,"dummy"
"66624",0,2,0,2,"dummy"
"66625",1,0,0,1,"dummy"
"66626",7,4,1,12,"dummy"
"66627",0,2,0,2,"dummy"
"66628",0,0,0,0,"dummy"
"66629",4,1,0,5,"dummy"
"66632",0,0,0,0,"dummy"
"66633",0,1,0,1,"dummy"
"66634",2,2,1,5,"dummy"
"66635",0,1,0,1,"dummy"
"66636",0,1,0,1,"dummy"
"66637",0,3,0,3,"dummy"
"66638",5,13,0,18,"dummy"
"66639",5,4,1,10,"dummy"
"66640",3,0,0,3,"dummy"
"66641",0,2,0,2,"dummy"
"66642",0,2,2,4,"dummy"
"66643",0,9,0,9,"dummy"
"66644",0,0,2,2,"dummy"
"66645",4,4,0,8,"dummy"
"66646",0,0,4,4,"dummy"
"66647",0,0,4,4,"dummy"
"66648",0,1,3,4,"dummy"
"66649",0,0,4,4,"dummy"
"66650",0,10,1,11,"dummy"
"66651",0,0,2,2,"dummy"
"66652",6,3,1,10,"dummy"
"66653",0,0,1,1,"dummy"
"66654",0,0,1,1,"dummy"
"66655",7,0,1,8,"dummy"
"66656",0,0,1,1,"dummy"
"66657",0,0,1,1,"dummy"
"66658",0,0,1,1,"dummy"
"66659",1,0,0,1,"dummy"
"66660",0,1,2,3,"dummy"
"66661",6,13,3,22,"dummy"
"66662",32,0,0,32,"dummy"
"66664",6,7,3,16,"dummy"
"66665",0,1,0,1,"dummy"
"66666",2,2,3,7,"dummy"
"66667",0,1,0,1,"dummy"
"66668",2,2,0,4,"dummy"
"66669",0,0,1,1,"dummy"
"66670",0,0,1,1,"dummy"
"66671",0,0,1,1,"dummy"
"66672",2,4,1,7,"dummy"
"66673",0,0,1,1,"dummy"
"66674",0,0,1,1,"dummy"
"66675",0,0,1,1,"dummy"
"66676",1,1,0,2,"dummy"
"66677",2,2,0,4,"dummy"
"66678",0,2,0,2,"dummy"
"66679",0,0,1,1,"dummy"
"66680",0,0,1,1,"dummy"
"66681",0,0,1,1,"dummy"
"66682",0,1,0,1,"dummy"
"66683",0,0,1,1,"dummy"
"66684",0,1,0,1,"dummy"
"66685",2,2,0,4,"dummy"
"66686",0,24,0,24,"dummy"
"66687",0,0,1,1,"dummy"
"66688",1,1,0,2,"dummy"
"66694",2,0,1,3,"dummy"
"66702",1,1,1,3,"dummy"
"66703",1,3,0,4,"dummy"
"66704",0,1,2,3,"dummy"
"66705",0,0,2,2,"dummy"
"66708",0,1,0,1,"dummy"
"66709",1,0,0,1,"dummy"
"66710",0,0,1,1,"dummy"
"66711",0,0,1,1,"dummy"
"66715",0,9,0,9,"dummy"
"66716",2,13,2,17,"dummy"
"66717",0,1,0,1,"dummy"
"66719",0,0,0,0,"dummy"
"66725",1,1,0,2,"dummy"
"66727",0,0,1,1,"dummy"
"66730",13,0,2,15,"dummy"
"66732",1,1,0,2,"dummy"
"66733",1,2,1,4,"dummy"
"66734",4,3,0,7,"dummy"
"66737",2,0,0,2,"dummy"
"66740",0,0,2,2,"dummy"
"66741",0,0,2,2,"dummy"
"66742",1,1,0,2,"dummy"
"66744",2,0,0,2,"dummy"
"66746",0,2,0,2,"dummy"
"66747",2,2,0,4,"dummy"
"66748",1,0,0,1,"dummy"
"66749",0,0,1,1,"dummy"
"66750",7,6,0,13,"dummy"
"66751",1,2,1,4,"dummy"
"66752",0,1,0,1,"dummy"
"66753",2,2,2,6,"dummy"
"66754",2,2,0,4,"dummy"
"66755",4,2,0,6,"dummy"
"66757",1,3,2,6,"dummy"
"66758",0,1,1,2,"dummy"
"66762",8,1,0,9,"dummy"
"66765",0,11,0,11,"dummy"
"66767",0,0,1,1,"dummy"
"66769",0,0,0,0,"dummy"
"66770",5,2,0,7,"dummy"
"66771",8,7,1,16,"dummy"
"66772",1,0,1,2,"dummy"
"66778",1,13,0,14,"dummy"
"66779",4,1,0,5,"dummy"
"66780",0,1,0,1,"dummy"
"66781",0,4,0,4,"dummy"
"66784",16,17,0,33,"dummy"
"66785",2,0,0,2,"dummy"
"66787",0,1,0,1,"dummy"
"66788",1,0,2,3,"dummy"
"66789",0,0,0,0,"dummy"
"66790",0,1,0,1,"dummy"
"66791",0,1,0,1,"dummy"
"66792",1,0,0,1,"dummy"
"66793",0,2,0,2,"dummy"
"66796",0,1,0,1,"dummy"
"66797",2,3,0,5,"dummy"
"66798",0,0,1,1,"dummy"
"66800",0,1,0,1,"dummy"
"66804",0,0,1,1,"dummy"
"66805",0,0,1,1,"dummy"
"66806",0,0,1,1,"dummy"
"66807",8,6,2,16,"dummy"
"66808",0,0,1,1,"dummy"
"66809",0,2,0,2,"dummy"
"66810",6,2,0,8,"dummy"
"66811",0,0,1,1,"dummy"
"66812",0,0,1,1,"dummy"
"66813",0,0,1,1,"dummy"
"66814",0,0,1,1,"dummy"
"66816",4,8,1,13,"dummy"
"66817",2,3,1,6,"dummy"
"66818",0,1,0,1,"dummy"
"66819",0,1,0,1,"dummy"
"66820",0,1,0,1,"dummy"
"66821",0,0,2,2,"dummy"
"66822",0,0,1,1,"dummy"
"66823",2,2,2,6,"dummy"
"66824",0,0,1,1,"dummy"
"66825",3,0,1,4,"dummy"
"66826",0,0,1,1,"dummy"
"66833",0,2,0,2,"dummy"
"66834",3,0,0,3,"dummy"
"66874",1,1,3,5,"dummy"
"66876",0,0,2,2,"dummy"
"66878",0,0,1,1,"dummy"
"66885",0,0,0,0,"dummy"
"66887",1,0,2,3,"dummy"
"66888",6,13,1,20,"dummy"
"66889",0,1,0,1,"dummy"
"66890",0,4,3,7,"dummy"
"66892",0,1,0,1,"dummy"
"66895",1,0,1,2,"dummy"
"66901",0,0,0,0,"dummy"
"66903",0,0,1,1,"dummy"
"66907",4,8,1,13,"dummy"
"66908",0,0,3,3,"dummy"
"66910",0,2,0,2,"dummy"
"66919",0,0,0,0,"dummy"
"66920",1,5,1,7,"dummy"
"66921",3,2,0,5,"dummy"
"66922",3,4,0,7,"dummy"
"66923",1,1,0,2,"dummy"
"66924",0,0,1,1,"dummy"
"66925",1,2,0,3,"dummy"
"66926",1,1,1,3,"dummy"
"66927",0,1,0,1,"dummy"
"66946",0,0,2,2,"dummy"
"66947",0,0,1,1,"dummy"
"66948",0,3,0,3,"dummy"
"66949",0,3,1,4,"dummy"
"66950",1,0,5,6,"dummy"
"66952",0,0,1,1,"dummy"
"66953",0,0,1,1,"dummy"
"66954",0,0,1,1,"dummy"
"66955",0,0,1,1,"dummy"
"66970",0,2,0,2,"dummy"
"66971",0,0,1,1,"dummy"
"66972",0,0,1,1,"dummy"
"66973",0,1,0,1,"dummy"
"66974",0,5,0,5,"dummy"
"66975",5,5,0,10,"dummy"
"66978",0,2,0,2,"dummy"
"66979",0,2,2,4,"dummy"
"66980",1,0,1,2,"dummy"
"66981",1,0,0,1,"dummy"
"66983",0,1,1,2,"dummy"
"66984",0,0,1,1,"dummy"
"66985",0,3,0,3,"dummy"
"66987",3,5,0,8,"dummy"
"66989",0,0,0,0,"dummy"
"66990",4,1,0,5,"dummy"
"66991",0,3,3,6,"dummy"
"66992",0,0,3,3,"dummy"
"66993",0,0,0,0,"dummy"
"66994",0,0,1,1,"dummy"
"66998",13,8,0,21,"dummy"
"66999",0,5,3,8,"dummy"
"67003",0,1,1,2,"dummy"
"67004",1,0,1,2,"dummy"
"67007",0,0,1,1,"dummy"
"67008",0,0,1,1,"dummy"
"67009",0,2,1,3,"dummy"
"67013",0,0,1,1,"dummy"
"67014",0,0,1,1,"dummy"
"67015",1,0,0,1,"dummy"
"67016",0,0,1,1,"dummy"
"67017",0,0,3,3,"dummy"
"67018",5,5,0,10,"dummy"
"67019",7,4,0,11,"dummy"
"67020",1,3,0,4,"dummy"
"67021",0,0,1,1,"dummy"
"67022",7,1,0,8,"dummy"
"67023",0,0,0,0,"dummy"
"67024",6,8,2,16,"dummy"
"67025",0,0,0,0,"dummy"
"67026",0,0,1,1,"dummy"
"67027",0,0,0,0,"dummy"
"67028",0,0,1,1,"dummy"
"67029",8,6,0,14,"dummy"
"67030",12,12,0,24,"dummy"
"67031",0,0,0,0,"dummy"
"67032",0,1,0,1,"dummy"
"67033",17,17,0,34,"dummy"
"67034",0,0,0,0,"dummy"
"67035",0,0,0,0,"dummy"
"67036",0,0,0,0,"dummy"
"67037",0,3,1,4,"dummy"
"67040",0,0,1,1,"dummy"
"67042",0,0,1,1,"dummy"
"67044",0,2,0,2,"dummy"
"67045",4,4,0,8,"dummy"
"67046",0,2,0,2,"dummy"
"67050",0,0,0,0,"dummy"
"67051",0,0,0,0,"dummy"
"67060",4,0,3,7,"dummy"
"67061",0,2,0,2,"dummy"
"67062",1,2,1,4,"dummy"
"67063",0,0,1,1,"dummy"
"67064",1,0,1,2,"dummy"
"67065",0,3,1,4,"dummy"
"67066",0,1,0,1,"dummy"
"67067",0,1,0,1,"dummy"
"67068",0,2,0,2,"dummy"
"67069",1,0,0,1,"dummy"
"67070",0,0,4,4,"dummy"
"67071",1,0,0,1,"dummy"
"67072",0,0,3,3,"dummy"
"67073",0,0,1,1,"dummy"
"67074",0,1,0,1,"dummy"
"67075",0,8,0,8,"dummy"
"67081",0,0,1,1,"dummy"
"67082",0,5,0,5,"dummy"
"67083",0,2,0,2,"dummy"
"67084",0,1,0,1,"dummy"
"67089",4,3,0,7,"dummy"
"67092",2,2,0,4,"dummy"
"67093",1,2,1,4,"dummy"
"67094",1,2,0,3,"dummy"
"67096",0,5,2,7,"dummy"
"67104",2,8,2,12,"dummy"
"67105",4,5,0,9,"dummy"
"67106",0,6,2,8,"dummy"
"67112",1,0,0,1,"dummy"
"67113",0,2,0,2,"dummy"
"67114",0,1,1,2,"dummy"
"67115",1,0,0,1,"dummy"
"67116",1,2,0,3,"dummy"
"67117",1,0,0,1,"dummy"
"67119",0,1,0,1,"dummy"
"67120",0,1,0,1,"dummy"
"67121",0,1,0,1,"dummy"
"67122",0,0,1,1,"dummy"
"67123",0,0,4,4,"dummy"
"67124",0,0,1,1,"dummy"
"67126",1,0,0,1,"dummy"
"67127",0,4,0,4,"dummy"
"67129",2,1,0,3,"dummy"
"67131",2,7,1,10,"dummy"
"67132",0,1,0,1,"dummy"
"67133",0,1,0,1,"dummy"
"67135",7,7,0,14,"dummy"
"67136",3,5,1,9,"dummy"
"67137",8,5,1,14,"dummy"
"67140",0,0,5,5,"dummy"
"67141",1,0,0,1,"dummy"
"67186",2,0,0,2,"dummy"
"67187",0,0,3,3,"dummy"
"67226",1,1,0,2,"dummy"
"67227",0,5,0,5,"dummy"
"67228",7,3,2,12,"dummy"
"67229",0,0,1,1,"dummy"
"67230",0,0,1,1,"dummy"
"67231",0,0,0,0,"dummy"
"67239",1,4,2,7,"dummy"
"67240",0,0,1,1,"dummy"
"67241",2,0,1,3,"dummy"
"67242",0,0,1,1,"dummy"
"67243",0,0,1,1,"dummy"
"67244",0,0,1,1,"dummy"
"67277",0,0,1,1,"dummy"
"67278",3,2,1,6,"dummy"
"67279",0,0,1,1,"dummy"
"67280",1,1,3,5,"dummy"
"67281",0,1,0,1,"dummy"
"67282",0,0,0,0,"dummy"
"67284",0,0,1,1,"dummy"
"67285",0,1,1,2,"dummy"
"67286",2,2,0,4,"dummy"
"67287",0,0,1,1,"dummy"
"67288",42,8,3,53,"dummy"
"67289",17,9,2,28,"dummy"
"67290",6,9,2,17,"dummy"
"67291",4,12,3,19,"dummy"
"67292",1,0,0,1,"dummy"
"67293",7,3,2,12,"dummy"
"67294",15,5,0,20,"dummy"
"67295",4,1,0,5,"dummy"
"67298",0,1,0,1,"dummy"
"67310",2,2,0,4,"dummy"
"67311",28,0,0,28,"dummy"
"67312",3,3,0,6,"dummy"
"67313",1,19,0,20,"dummy"
"67314",0,1,0,1,"dummy"
"67315",0,0,1,1,"dummy"
"67316",1,2,0,3,"dummy"
"67317",2,1,0,3,"dummy"
"67318",1,3,0,4,"dummy"
"67319",0,0,0,0,"dummy"
"67322",0,2,0,2,"dummy"
"67326",0,1,0,1,"dummy"
"67327",0,1,0,1,"dummy"
"67344",0,0,1,1,"dummy"
"67345",1,1,0,2,"dummy"
"67346",0,0,4,4,"dummy"
"67347",0,0,2,2,"dummy"
"67348",0,0,0,0,"dummy"
"67351",0,4,2,6,"dummy"
"67352",3,4,1,8,"dummy"
"67353",0,0,2,2,"dummy"
"67354",2,3,0,5,"dummy"
"67355",1,2,4,7,"dummy"
"67356",1,0,1,2,"dummy"
"67357",0,0,7,7,"dummy"
"67358",0,1,1,2,"dummy"
"67359",1,0,3,4,"dummy"
"67360",1,0,0,1,"dummy"
"67361",0,0,1,1,"dummy"
"67362",0,1,1,2,"dummy"
"67363",4,4,2,10,"dummy"
"67364",0,0,1,1,"dummy"
"67365",0,0,4,4,"dummy"
"67366",0,4,4,8,"dummy"
"67367",6,0,0,6,"dummy"
"67368",0,5,0,5,"dummy"
"67369",0,0,1,1,"dummy"
"67371",0,0,0,0,"dummy"
"67372",0,0,0,0,"dummy"
"67373",0,0,0,0,"dummy"
"67374",0,0,0,0,"dummy"
"67375",0,0,0,0,"dummy"
"67376",0,0,0,0,"dummy"
"67378",0,0,0,0,"dummy"
"67379",0,0,0,0,"dummy"
"67381",0,0,0,0,"dummy"
"67382",0,0,0,0,"dummy"
"67383",6,0,1,7,"dummy"
"67384",0,1,1,2,"dummy"
"67385",0,0,1,1,"dummy"
"67386",1,3,0,4,"dummy"
"67390",5,0,0,5,"dummy"
"67391",0,1,0,1,"dummy"
"67392",0,1,0,1,"dummy"
"67393",0,2,0,2,"dummy"
"67394",0,6,0,6,"dummy"
"67396",0,2,0,2,"dummy"
"67397",2,2,0,4,"dummy"
"67398",2,2,0,4,"dummy"
"67399",1,1,0,2,"dummy"
"67400",0,0,1,1,"dummy"
"67401",5,4,3,12,"dummy"
"67402",1,1,0,2,"dummy"
"67404",0,0,0,0,"dummy"
"67405",0,0,0,0,"dummy"
"67408",0,1,0,1,"dummy"
"67415",2,1,3,6,"dummy"
"67416",0,0,0,0,"dummy"
"67417",0,1,0,1,"dummy"
"67418",0,0,0,0,"dummy"
"67419",1,0,1,2,"dummy"
"67420",0,0,0,0,"dummy"
"67421",0,0,1,1,"dummy"
"67422",0,0,0,0,"dummy"
"67425",0,0,1,1,"dummy"
"67426",0,0,1,1,"dummy"
"67427",0,0,1,1,"dummy"
"67428",0,0,1,1,"dummy"
"67429",0,6,5,11,"dummy"
"67430",0,0,0,0,"dummy"
"67433",0,0,0,0,"dummy"
"67434",0,3,1,4,"dummy"
"67458",0,1,0,1,"dummy"
"67459",5,4,0,9,"dummy"
"67460",0,1,1,2,"dummy"
"67461",0,0,1,1,"dummy"
"67462",0,2,0,2,"dummy"
"67463",3,2,1,6,"dummy"
"67466",0,2,0,2,"dummy"
"67467",0,0,1,1,"dummy"
"67468",0,0,1,1,"dummy"
"67471",4,3,1,8,"dummy"
"67472",1,0,0,1,"dummy"
"67473",0,1,0,1,"dummy"
"67474",0,1,0,1,"dummy"
"67475",0,0,1,1,"dummy"
"67476",0,0,1,1,"dummy"
"67477",0,0,0,0,"dummy"
"67480",0,6,1,7,"dummy"
"67481",1,10,0,11,"dummy"
"67482",0,1,2,3,"dummy"
"67483",0,4,0,4,"dummy"
"67484",0,2,0,2,"dummy"
"67485",0,0,0,0,"dummy"
"67489",0,1,0,1,"dummy"
"67506",0,1,0,1,"dummy"
"67515",0,0,0,0,"dummy"
"67516",2,2,1,5,"dummy"
"67526",1,0,4,5,"dummy"
"67541",0,3,2,5,"dummy"
"67552",1,0,0,1,"dummy"
"67553",0,0,0,0,"dummy"
"67554",0,1,0,1,"dummy"
"67555",7,4,5,16,"dummy"
"67558",3,4,0,7,"dummy"
"67572",0,0,1,1,"dummy"
"67573",0,10,0,10,"dummy"
"67596",0,3,2,5,"dummy"
"67597",0,1,4,5,"dummy"
"67598",0,0,3,3,"dummy"
"67599",0,0,2,2,"dummy"
"67600",0,0,1,1,"dummy"
"67601",6,3,4,13,"dummy"
"67602",3,6,4,13,"dummy"
"67622",6,5,0,11,"dummy"
"67623",1,5,0,6,"dummy"
"67626",0,1,1,2,"dummy"
"67644",0,0,0,0,"dummy"
"67651",0,0,1,1,"dummy"
"67436",32,34,2,68,"dummy"
"67437",4,16,1,21,"dummy"
"67438",2,2,0,4,"dummy"
"67439",6,0,0,6,"dummy"
"67440",1,0,1,2,"dummy"
"67441",0,0,1,1,"dummy"
"67442",0,0,1,1,"dummy"
"67443",1,15,2,18,"dummy"
"67444",2,2,0,4,"dummy"
"67445",2,2,0,4,"dummy"
"67446",2,2,0,4,"dummy"
"67447",0,6,0,6,"dummy"
"67448",2,2,0,4,"dummy"
"67449",2,2,0,4,"dummy"
"67450",2,0,0,2,"dummy"
"67451",0,1,3,4,"dummy"
"67452",0,0,2,2,"dummy"
"67453",0,0,2,2,"dummy"
"67454",0,2,0,2,"dummy"
"67455",1,2,0,3,"dummy"
"67456",4,0,0,4,"dummy"
"67487",1,0,0,1,"dummy"
"67495",0,2,1,3,"dummy"
"67498",3,2,0,5,"dummy"
"67499",2,3,0,5,"dummy"
"67500",0,0,0,0,"dummy"
"67508",7,8,14,29,"dummy"
"67511",2,2,4,8,"dummy"
"67520",0,0,2,2,"dummy"
"67523",0,1,0,1,"dummy"
"67524",0,1,0,1,"dummy"
"67528",2,7,0,9,"dummy"
"67529",2,7,1,10,"dummy"
"67530",6,5,0,11,"dummy"
"67531",2,3,0,5,"dummy"
"67532",0,1,0,1,"dummy"
"67533",1,1,0,2,"dummy"
"67549",0,0,0,0,"dummy"
"67550",0,0,0,0,"dummy"
"67560",0,2,0,2,"dummy"
"67561",0,0,1,1,"dummy"
"67562",0,0,1,1,"dummy"
"67563",0,0,1,1,"dummy"
"67564",0,0,1,1,"dummy"
"67567",0,2,1,3,"dummy"
"67568",0,4,0,4,"dummy"
"67569",0,2,0,2,"dummy"
"67570",1,1,0,2,"dummy"
"67575",1,1,0,2,"dummy"
"67576",0,1,0,1,"dummy"
"67577",1,0,0,1,"dummy"
"67582",0,0,0,0,"dummy"
"67583",2,1,5,8,"dummy"
"67586",3,3,0,6,"dummy"
"67587",0,4,1,5,"dummy"
"67588",1,1,1,3,"dummy"
"67589",2,0,0,2,"dummy"
"67590",8,1,3,12,"dummy"
"67604",3,0,0,3,"dummy"
"67605",1,1,1,3,"dummy"
"67606",3,0,0,3,"dummy"
"67628",3,8,1,12,"dummy"
"67629",0,0,1,1,"dummy"
"67630",0,1,0,1,"dummy"
"67631",17,7,5,29,"dummy"
"67632",3,0,3,6,"dummy"
"67635",0,0,4,4,"dummy"
"67636",1,3,5,9,"dummy"
"67637",0,0,1,1,"dummy"
"67638",0,1,0,1,"dummy"
"67639",0,0,0,0,"dummy"
"67640",0,0,0,0,"dummy"
"67641",1,2,5,8,"dummy"
"67642",0,0,6,6,"dummy"
"67677",0,0,1,1,"dummy"
"67683",0,0,0,0,"dummy"
"67686",1,0,0,1,"dummy"
"67687",0,0,4,4,"dummy"
"67688",8,7,5,20,"dummy"
"67704",4,21,2,27,"dummy"
"67711",16,5,2,23,"dummy"
"67714",2,4,0,6,"dummy"
"67715",0,1,0,1,"dummy"
"67729",0,1,0,1,"dummy"
"67730",1,1,0,2,"dummy"
"67757",0,0,1,1,"dummy"
"67758",1,0,0,1,"dummy"
"67763",0,0,1,1,"dummy"
"67764",0,0,1,1,"dummy"
"67795",2,0,0,2,"dummy"
"67796",0,3,0,3,"dummy"
"67799",3,5,0,8,"dummy"
"67800",2,0,0,2,"dummy"
"67801",4,0,0,4,"dummy"
"67834",0,8,2,10,"dummy"
"67855",3,4,1,8,"dummy"
"67862",0,1,0,1,"dummy"
"67868",1,7,1,9,"dummy"
"67869",0,0,1,1,"dummy"
"67877",0,2,1,3,"dummy"
"67878",1,3,4,8,"dummy"
"67879",2,2,0,4,"dummy"
"67880",0,0,0,0,"dummy"
"67881",2,9,1,12,"dummy"
"67882",2,2,0,4,"dummy"
"67883",6,2,1,9,"dummy"
"67884",3,3,0,6,"dummy"
"67885",0,0,4,4,"dummy"
"67886",3,6,2,11,"dummy"
"67895",0,0,1,1,"dummy"
"67896",0,3,0,3,"dummy"
"67897",0,0,1,1,"dummy"
"67898",3,2,1,6,"dummy"
"67901",0,0,1,1,"dummy"
"67652",3,0,1,4,"dummy"
"67653",0,0,1,1,"dummy"
"67656",0,1,0,1,"dummy"
"67657",0,1,0,1,"dummy"
"67658",1,1,1,3,"dummy"
"67659",0,0,2,2,"dummy"
"67660",8,14,0,22,"dummy"
"67661",0,0,0,0,"dummy"
"67662",0,0,0,0,"dummy"
"67665",1,10,4,15,"dummy"
"67666",0,4,0,4,"dummy"
"67667",0,0,0,0,"dummy"
"67668",0,1,0,1,"dummy"
"67669",0,0,1,1,"dummy"
"67670",0,2,0,2,"dummy"
"67671",0,1,1,2,"dummy"
"67672",0,0,1,1,"dummy"
"67673",0,0,0,0,"dummy"
"67679",0,0,2,2,"dummy"
"67692",0,0,1,1,"dummy"
"67693",0,2,0,2,"dummy"
"67694",0,3,0,3,"dummy"
"67695",4,3,0,7,"dummy"
"67696",3,1,2,6,"dummy"
"67697",0,0,1,1,"dummy"
"67698",0,3,0,3,"dummy"
"67699",3,0,1,4,"dummy"
"67700",0,3,0,3,"dummy"
"67706",1,1,0,2,"dummy"
"67707",0,0,1,1,"dummy"
"67717",0,2,0,2,"dummy"
"67718",0,1,0,1,"dummy"
"67719",0,0,1,1,"dummy"
"67720",0,1,0,1,"dummy"
"67721",0,1,0,1,"dummy"
"67722",17,14,2,33,"dummy"
"67723",1,0,0,1,"dummy"
"67724",2,1,0,3,"dummy"
"67727",0,41,1,42,"dummy"
"67760",0,0,0,0,"dummy"
"67761",0,0,0,0,"dummy"
"67766",0,4,1,5,"dummy"
"67791",0,0,1,1,"dummy"
"67792",0,0,1,1,"dummy"
"67793",0,0,1,1,"dummy"
"67810",1,5,0,6,"dummy"
"67811",0,0,0,0,"dummy"
"67812",0,2,0,2,"dummy"
"67813",0,1,0,1,"dummy"
"67814",8,8,0,16,"dummy"
"67815",1,1,0,2,"dummy"
"67816",2,2,2,6,"dummy"
"67817",0,1,0,1,"dummy"
"67818",1,4,0,5,"dummy"
"67819",4,5,0,9,"dummy"
"67820",0,0,1,1,"dummy"
"67821",0,6,1,7,"dummy"
"67844",1,5,3,9,"dummy"
"67845",1,6,0,7,"dummy"
"67848",1,2,0,3,"dummy"
"67849",1,1,0,2,"dummy"
"67850",0,0,1,1,"dummy"
"67851",0,0,1,1,"dummy"
"67852",0,1,1,2,"dummy"
"67853",1,2,0,3,"dummy"
"67866",0,0,0,0,"dummy"
"67874",0,10,0,10,"dummy"
"67875",13,3,0,16,"dummy"
"67892",0,1,0,1,"dummy"
"67893",0,1,0,1,"dummy"
"67917",0,0,3,3,"dummy"
"67918",0,0,0,0,"dummy"
"67924",0,5,0,5,"dummy"
"67928",0,38,0,38,"dummy"
"67929",10,16,0,26,"dummy"
"67938",2,13,2,17,"dummy"
"67944",5,10,9,24,"dummy"
"67947",2,0,0,2,"dummy"
"67948",0,6,0,6,"dummy"
"67949",0,2,0,2,"dummy"
"67954",1,4,0,5,"dummy"
"67955",1,7,1,9,"dummy"
"67956",1,7,0,8,"dummy"
"67957",0,0,1,1,"dummy"
"67958",0,0,1,1,"dummy"
"67959",1,2,0,3,"dummy"
"67960",0,1,0,1,"dummy"
"67961",3,3,0,6,"dummy"
"67962",0,0,1,1,"dummy"
"67969",0,0,1,1,"dummy"
"67970",0,1,0,1,"dummy"
"67971",3,2,7,12,"dummy"
"67976",1,1,1,3,"dummy"
"67977",0,2,2,4,"dummy"
"67982",2,15,1,18,"dummy"
"67983",4,4,1,9,"dummy"
"68002",0,0,1,1,"dummy"
"68003",0,0,1,1,"dummy"
"68007",0,0,0,0,"dummy"
"68008",0,0,0,0,"dummy"
"68014",0,0,0,0,"dummy"
"68015",0,0,3,3,"dummy"
"68016",0,0,1,1,"dummy"
"68017",3,0,0,3,"dummy"
"68018",0,0,2,2,"dummy"
"68019",0,0,1,1,"dummy"
"68020",0,0,0,0,"dummy"
"68023",0,0,2,2,"dummy"
"68024",0,0,1,1,"dummy"
"68025",0,1,0,1,"dummy"
"68026",0,0,1,1,"dummy"
"67920",1,2,0,3,"dummy"
"67926",0,1,0,1,"dummy"
"67931",0,0,0,0,"dummy"
"67932",0,0,0,0,"dummy"
"67933",1,2,0,3,"dummy"
"67934",1,0,0,1,"dummy"
"67935",0,1,0,1,"dummy"
"67936",1,0,0,1,"dummy"
"67940",0,1,0,1,"dummy"
"67951",17,24,0,41,"dummy"
"67952",0,9,1,10,"dummy"
"67964",0,0,1,1,"dummy"
"67965",0,0,1,1,"dummy"
"67966",0,0,1,1,"dummy"
"67967",0,0,1,1,"dummy"
"67973",5,13,1,19,"dummy"
"67974",0,3,0,3,"dummy"
"67979",0,0,1,1,"dummy"
"67980",0,1,0,1,"dummy"
"67998",1,7,0,8,"dummy"
"68005",5,1,1,7,"dummy"
"68010",3,6,4,13,"dummy"
"68040",4,6,4,14,"dummy"
"68043",0,1,0,1,"dummy"
"68044",0,1,0,1,"dummy"
"68046",0,3,0,3,"dummy"
"68057",0,0,1,1,"dummy"
"68058",2,0,0,2,"dummy"
"68059",0,2,0,2,"dummy"
"68061",1,2,0,3,"dummy"
"68062",4,5,1,10,"dummy"
"68063",0,0,0,0,"dummy"
"68064",0,0,0,0,"dummy"
"68065",0,0,0,0,"dummy"
"68066",4,4,0,8,"dummy"
"68067",1,1,1,3,"dummy"
"68071",0,0,3,3,"dummy"
"68075",0,0,1,1,"dummy"
"68078",1,4,0,5,"dummy"
"68079",0,0,1,1,"dummy"
"68082",0,0,2,2,"dummy"
"68085",0,3,0,3,"dummy"
"68086",3,0,0,3,"dummy"
"68088",0,2,0,2,"dummy"
"68089",0,3,2,5,"dummy"
"68092",0,1,0,1,"dummy"
"68093",0,3,0,3,"dummy"
"68094",0,3,0,3,"dummy"
"68095",0,0,1,1,"dummy"
"68096",0,2,1,3,"dummy"
"68097",2,2,1,5,"dummy"
"68098",0,0,3,3,"dummy"
"68099",1,0,0,1,"dummy"
"68100",0,0,0,0,"dummy"
"68101",0,0,0,0,"dummy"
"68102",1,0,0,1,"dummy"
"68103",0,1,0,1,"dummy"
"68104",0,0,0,0,"dummy"
"68105",0,0,1,1,"dummy"
"68109",0,2,0,2,"dummy"
"68111",1,2,1,4,"dummy"
"68112",1,2,0,3,"dummy"
"68114",0,1,0,1,"dummy"
"68115",2,0,2,4,"dummy"
"68119",0,6,1,7,"dummy"
"68120",6,0,1,7,"dummy"
"68121",0,0,1,1,"dummy"
"68122",0,3,0,3,"dummy"
"68123",0,3,0,3,"dummy"
"68125",3,0,0,3,"dummy"
"68130",0,0,1,1,"dummy"
"68131",0,1,0,1,"dummy"
"68132",0,0,1,1,"dummy"
"68133",1,0,0,1,"dummy"
"68135",0,26,1,27,"dummy"
"68136",0,4,1,5,"dummy"
"68137",0,0,1,1,"dummy"
"68138",0,0,1,1,"dummy"
"68139",0,2,0,2,"dummy"
"68140",0,0,1,1,"dummy"
"68141",0,0,0,0,"dummy"
"68142",1,0,0,1,"dummy"
"68143",0,2,0,2,"dummy"
"68144",0,0,1,1,"dummy"
"68146",0,1,0,1,"dummy"
"68147",0,2,0,2,"dummy"
"68152",0,0,0,0,"dummy"
"68155",7,1,2,10,"dummy"
"68157",0,4,0,4,"dummy"
"68158",0,2,0,2,"dummy"
"68159",1,2,1,4,"dummy"
"68160",2,3,1,6,"dummy"
"68161",0,2,0,2,"dummy"
"68162",0,3,0,3,"dummy"
"68170",0,0,1,1,"dummy"
"68171",0,0,0,0,"dummy"
"68188",1,1,3,5,"dummy"
"68189",1,8,0,9,"dummy"
"68190",11,10,1,22,"dummy"
"68193",0,0,1,1,"dummy"
"68195",2,0,0,2,"dummy"
"68196",0,0,1,1,"dummy"
"68197",1,0,0,1,"dummy"
"68200",1,4,0,5,"dummy"
"68202",2,2,0,4,"dummy"
"68203",1,1,1,3,"dummy"
"68204",1,1,1,3,"dummy"
"68205",0,1,0,1,"dummy"
"68208",0,2,1,3,"dummy"
"68210",2,12,1,15,"dummy"
"68211",1,1,0,2,"dummy"
"68212",4,3,1,8,"dummy"
"68213",0,0,1,1,"dummy"
"68214",2,4,1,7,"dummy"
"68215",1,0,0,1,"dummy"
"68216",0,1,0,1,"dummy"
"68218",0,0,1,1,"dummy"
"68219",0,1,0,1,"dummy"
"68220",0,0,3,3,"dummy"
"68221",1,5,0,6,"dummy"
"68224",0,1,0,1,"dummy"
"68225",0,5,0,5,"dummy"
"68226",0,0,2,2,"dummy"
"68227",0,2,0,2,"dummy"
"68228",0,1,0,1,"dummy"
"68229",0,3,1,4,"dummy"
"68230",1,0,0,1,"dummy"
"68231",2,2,1,5,"dummy"
"68232",6,4,0,10,"dummy"
"68233",3,3,0,6,"dummy"
"68235",3,31,1,35,"dummy"
"68238",0,1,0,1,"dummy"
"68239",2,0,0,2,"dummy"
"68240",0,2,0,2,"dummy"
"68241",0,1,0,1,"dummy"
"68242",0,1,1,2,"dummy"
"68243",0,1,0,1,"dummy"
"68244",1,1,0,2,"dummy"
"68245",0,0,1,1,"dummy"
"68246",0,0,1,1,"dummy"
"68247",0,0,1,1,"dummy"
"68248",7,0,0,7,"dummy"
"68256",1,8,1,10,"dummy"
"68257",0,1,1,2,"dummy"
"68258",10,7,1,18,"dummy"
"68259",4,4,1,9,"dummy"
"68260",2,0,0,2,"dummy"
"68263",1,0,1,2,"dummy"
"68264",0,2,0,2,"dummy"
"68265",0,1,0,1,"dummy"
"68268",0,2,0,2,"dummy"
"68274",0,0,1,1,"dummy"
"68275",0,1,0,1,"dummy"
"68277",0,2,0,2,"dummy"
"68279",2,0,1,3,"dummy"
"68280",0,0,0,0,"dummy"
"68288",0,2,0,2,"dummy"
"68289",1,1,0,2,"dummy"
"68293",1,1,0,2,"dummy"
"68294",0,1,1,2,"dummy"
"68296",5,6,0,11,"dummy"
"68297",0,2,0,2,"dummy"
"68298",5,0,0,5,"dummy"
"68299",4,4,0,8,"dummy"
"68300",0,0,1,1,"dummy"
"68301",0,0,1,1,"dummy"
"68302",0,0,0,0,"dummy"
"68307",1,0,0,1,"dummy"
"68318",0,5,0,5,"dummy"
"68319",0,0,1,1,"dummy"
"68326",9,11,3,23,"dummy"
"68360",0,3,0,3,"dummy"
"68364",0,2,0,2,"dummy"
"68365",0,3,1,4,"dummy"
"68366",0,1,1,2,"dummy"
"68367",0,0,2,2,"dummy"
"68368",0,0,1,1,"dummy"
"68369",0,1,1,2,"dummy"
"68370",0,0,2,2,"dummy"
"68371",1,0,0,1,"dummy"
"68372",0,3,1,4,"dummy"
"68373",21,0,3,24,"dummy"
"68374",2,0,0,2,"dummy"
"68375",0,3,0,3,"dummy"
"68376",5,8,0,13,"dummy"
"68377",0,0,0,0,"dummy"
"68379",2,12,1,15,"dummy"
"68380",0,1,0,1,"dummy"
"68383",0,1,0,1,"dummy"
"68393",0,1,2,3,"dummy"
"68394",0,0,1,1,"dummy"
"68395",0,0,1,1,"dummy"
"68396",0,0,1,1,"dummy"
"68397",1,6,0,7,"dummy"
"68398",0,0,1,1,"dummy"
"68399",0,0,1,1,"dummy"
"68400",0,0,1,1,"dummy"
"68401",0,0,1,1,"dummy"
"68404",0,0,1,1,"dummy"
"68416",2,4,0,6,"dummy"
"68417",0,2,0,2,"dummy"
"68418",0,2,0,2,"dummy"
"68419",10,2,0,12,"dummy"
"68420",0,2,0,2,"dummy"
"68429",6,17,3,26,"dummy"
"68432",0,0,1,1,"dummy"
"68433",0,1,0,1,"dummy"
"68434",0,1,0,1,"dummy"
"68446",0,2,0,2,"dummy"
"68447",0,1,0,1,"dummy"
"68450",0,2,0,2,"dummy"
"68451",0,1,0,1,"dummy"
"68452",0,1,0,1,"dummy"
"68453",2,2,1,5,"dummy"
"68454",0,1,0,1,"dummy"
"68455",6,10,3,19,"dummy"
"68456",0,1,0,1,"dummy"
"68457",0,9,0,9,"dummy"
"68466",5,0,0,5,"dummy"
"68467",3,0,0,3,"dummy"
"68496",2,2,0,4,"dummy"
"68503",0,0,10,10,"dummy"
"68504",0,0,1,1,"dummy"
"68532",0,2,0,2,"dummy"
"68533",0,8,0,8,"dummy"
"68534",0,5,0,5,"dummy"
"68535",0,1,0,1,"dummy"
"68536",0,5,0,5,"dummy"
"68537",7,6,1,14,"dummy"
"68538",1,1,0,2,"dummy"
"68539",0,1,0,1,"dummy"
"68540",6,1,1,8,"dummy"
"68541",0,0,1,1,"dummy"
"68542",0,4,0,4,"dummy"
"68543",0,1,0,1,"dummy"
"68544",0,1,0,1,"dummy"
"68545",0,1,0,1,"dummy"
"68546",0,1,0,1,"dummy"
"68550",6,21,2,29,"dummy"
"68553",4,6,1,11,"dummy"
"68554",0,0,2,2,"dummy"
"68563",0,3,0,3,"dummy"
"68573",0,1,0,1,"dummy"
"68574",1,0,0,1,"dummy"
"68575",0,0,1,1,"dummy"
"68580",0,2,0,2,"dummy"
"68581",2,3,1,6,"dummy"
"68597",1,2,3,6,"dummy"
"68598",4,4,0,8,"dummy"
"68605",0,0,0,0,"dummy"
"68606",10,3,2,15,"dummy"
"68607",9,8,2,19,"dummy"
"68608",6,0,2,8,"dummy"
"68609",0,0,1,1,"dummy"
"68610",0,0,0,0,"dummy"
"68387",2,0,0,2,"dummy"
"68388",13,11,2,26,"dummy"
"68389",0,5,0,5,"dummy"
"68390",3,23,0,26,"dummy"
"68391",1,1,0,2,"dummy"
"68406",0,7,1,8,"dummy"
"68407",13,5,0,18,"dummy"
"68408",6,10,4,20,"dummy"
"68409",16,21,2,39,"dummy"
"68410",1,0,0,1,"dummy"
"68411",0,1,0,1,"dummy"
"68412",0,0,1,1,"dummy"
"68413",0,0,1,1,"dummy"
"68414",0,0,1,1,"dummy"
"68436",0,2,0,2,"dummy"
"68459",0,0,1,1,"dummy"
"68462",0,1,0,1,"dummy"
"68469",0,2,0,2,"dummy"
"68470",0,0,0,0,"dummy"
"68471",0,1,0,1,"dummy"
"68472",1,0,1,2,"dummy"
"68473",0,1,0,1,"dummy"
"68474",0,0,0,0,"dummy"
"68475",0,1,1,2,"dummy"
"68476",2,0,1,3,"dummy"
"68477",0,1,1,2,"dummy"
"68478",0,0,1,1,"dummy"
"68479",1,0,1,2,"dummy"
"68480",0,1,1,2,"dummy"
"68481",0,0,0,0,"dummy"
"68491",4,2,0,6,"dummy"
"68492",0,1,0,1,"dummy"
"68500",6,0,3,9,"dummy"
"68501",0,0,1,1,"dummy"
"68508",26,2,2,30,"dummy"
"68509",0,0,1,1,"dummy"
"68510",0,0,1,1,"dummy"
"68511",0,1,0,1,"dummy"
"68548",1,3,0,4,"dummy"
"68558",0,5,0,5,"dummy"
"68559",0,2,0,2,"dummy"
"68560",0,4,0,4,"dummy"
"68561",0,3,0,3,"dummy"
"68565",0,0,1,1,"dummy"
"68566",0,2,0,2,"dummy"
"68567",0,6,1,7,"dummy"
"68568",0,0,2,2,"dummy"
"68569",0,0,2,2,"dummy"
"68570",0,0,3,3,"dummy"
"68571",0,0,1,1,"dummy"
"68621",0,2,0,2,"dummy"
"68622",1,5,0,6,"dummy"
"68623",0,2,0,2,"dummy"
"68624",1,2,1,4,"dummy"
"68625",4,10,2,16,"dummy"
"68626",2,0,0,2,"dummy"
"68629",0,0,1,1,"dummy"
"68632",0,1,0,1,"dummy"
"68633",0,1,0,1,"dummy"
"68634",1,1,0,2,"dummy"
"68635",1,1,0,2,"dummy"
"68638",5,0,0,5,"dummy"
"68639",0,1,0,1,"dummy"
"68640",0,0,0,0,"dummy"
"68611",0,0,2,2,"dummy"
"68612",0,0,0,0,"dummy"
"68613",0,2,0,2,"dummy"
"68614",0,0,0,0,"dummy"
"68615",0,0,1,1,"dummy"
"68616",0,0,0,0,"dummy"
"68617",2,0,0,2,"dummy"
"68618",2,0,1,3,"dummy"
"68619",0,2,0,2,"dummy"
"68644",2,1,0,3,"dummy"
"68650",0,0,0,0,"dummy"
"68702",0,0,1,1,"dummy"
"68705",0,0,1,1,"dummy"
"68710",0,1,0,1,"dummy"
"68711",0,0,0,0,"dummy"
"68712",0,0,0,0,"dummy"
"68713",0,0,0,0,"dummy"
"68714",0,0,0,0,"dummy"
"68778",7,5,0,12,"dummy"
"68783",0,1,0,1,"dummy"
"68784",0,1,0,1,"dummy"
"68785",0,0,0,0,"dummy"
"68786",1,1,0,2,"dummy"
"68787",1,1,0,2,"dummy"
"68788",7,0,0,7,"dummy"
"68792",12,2,0,14,"dummy"
"68793",1,3,1,5,"dummy"
"68794",0,6,1,7,"dummy"
"68795",1,1,0,2,"dummy"
"68796",1,3,1,5,"dummy"
"68797",3,13,0,16,"dummy"
"68798",0,7,1,8,"dummy"
"68799",0,0,1,1,"dummy"
"68800",10,13,3,26,"dummy"
"68801",2,4,0,6,"dummy"
"68802",0,1,1,2,"dummy"
"68803",11,3,0,14,"dummy"
"68804",6,8,1,15,"dummy"
"68805",2,0,1,3,"dummy"
"68806",0,0,1,1,"dummy"
"68807",0,1,0,1,"dummy"
"68808",0,0,2,2,"dummy"
"68809",0,1,2,3,"dummy"
"68819",2,8,2,12,"dummy"
"68820",2,2,1,5,"dummy"
"68821",0,0,1,1,"dummy"
"68832",0,0,0,0,"dummy"
"68838",0,1,0,1,"dummy"
"68839",0,2,0,2,"dummy"
"68842",0,1,2,3,"dummy"
"68852",0,1,0,1,"dummy"
"68853",0,0,1,1,"dummy"
"68854",0,0,1,1,"dummy"
"68855",7,5,3,15,"dummy"
"68869",3,1,1,5,"dummy"
"68872",11,0,1,12,"dummy"
"68873",1,3,0,4,"dummy"
"68874",1,2,0,3,"dummy"
"68875",0,0,1,1,"dummy"
"68876",0,0,1,1,"dummy"
"68903",0,0,0,0,"dummy"
"68904",0,0,1,1,"dummy"
"68905",3,0,0,3,"dummy"
"68906",0,0,1,1,"dummy"
"68907",0,1,0,1,"dummy"
"68908",0,0,0,0,"dummy"
"68909",0,0,1,1,"dummy"
"68910",0,2,0,2,"dummy"
"68911",0,0,0,0,"dummy"
"68912",0,0,0,0,"dummy"
"68913",0,2,0,2,"dummy"
"68914",4,1,0,5,"dummy"
"68915",1,0,0,1,"dummy"
"68646",7,12,0,19,"dummy"
"68647",4,2,4,10,"dummy"
"68648",1,1,0,2,"dummy"
"68666",0,0,1,1,"dummy"
"68667",1,0,0,1,"dummy"
"68668",0,0,1,1,"dummy"
"68669",0,1,0,1,"dummy"
"68670",5,11,2,18,"dummy"
"68671",0,1,1,2,"dummy"
"68672",0,2,1,3,"dummy"
"68673",0,0,0,0,"dummy"
"68674",0,1,0,1,"dummy"
"68675",3,2,0,5,"dummy"
"68676",24,1,0,25,"dummy"
"68677",0,1,0,1,"dummy"
"68678",0,0,0,0,"dummy"
"68679",0,0,0,0,"dummy"
"68680",0,0,0,0,"dummy"
"68681",0,2,0,2,"dummy"
"68682",0,0,0,0,"dummy"
"68683",0,0,1,1,"dummy"
"68684",0,1,0,1,"dummy"
"68685",1,0,0,1,"dummy"
"68686",0,1,0,1,"dummy"
"68687",5,5,1,11,"dummy"
"68688",0,0,0,0,"dummy"
"68689",8,0,0,8,"dummy"
"68690",0,0,0,0,"dummy"
"68691",0,0,0,0,"dummy"
"68692",0,0,0,0,"dummy"
"68695",2,6,2,10,"dummy"
"68696",2,0,1,3,"dummy"
"68716",0,0,1,1,"dummy"
"68717",7,1,1,9,"dummy"
"68718",0,0,0,0,"dummy"
"68719",2,3,2,7,"dummy"
"68766",1,0,0,1,"dummy"
"68767",1,2,0,3,"dummy"
"68768",2,1,1,4,"dummy"
"68769",0,0,3,3,"dummy"
"68770",0,1,0,1,"dummy"
"68780",6,1,1,8,"dummy"
"68781",0,0,0,0,"dummy"
"68790",0,0,2,2,"dummy"
"68811",1,1,0,2,"dummy"
"68817",0,1,0,1,"dummy"
"68825",0,0,0,0,"dummy"
"68826",0,0,1,1,"dummy"
"68834",0,0,1,1,"dummy"
"68835",0,0,0,0,"dummy"
"68836",0,0,0,0,"dummy"
"68857",1,0,0,1,"dummy"
"68858",0,1,0,1,"dummy"
"68859",2,2,2,6,"dummy"
"68860",0,0,1,1,"dummy"
"68861",3,0,1,4,"dummy"
"68862",0,1,0,1,"dummy"
"68865",0,0,0,0,"dummy"
"68866",0,0,0,0,"dummy"
"68867",0,0,0,0,"dummy"
"68878",0,0,3,3,"dummy"
"68885",0,1,1,2,"dummy"
"68886",3,8,0,11,"dummy"
"68887",1,2,2,5,"dummy"
"68888",6,6,3,15,"dummy"
"68889",0,1,0,1,"dummy"
"68890",0,3,0,3,"dummy"
"68891",0,6,0,6,"dummy"
"68892",2,0,0,2,"dummy"
"68893",0,1,0,1,"dummy"
"68894",0,0,0,0,"dummy"
"68895",0,1,0,1,"dummy"
"68896",0,0,0,0,"dummy"
"68897",0,0,0,0,"dummy"
"68898",21,3,0,24,"dummy"
"68899",0,2,0,2,"dummy"
"68900",0,0,1,1,"dummy"
"68901",0,0,1,1,"dummy"
"69032",0,0,0,0,"dummy"
"69033",0,0,0,0,"dummy"
"69034",0,0,0,0,"dummy"
"69035",0,0,0,0,"dummy"
"69036",0,0,0,0,"dummy"
"69037",0,0,0,0,"dummy"
"69038",0,0,0,0,"dummy"
"69039",0,0,0,0,"dummy"
"69040",0,0,0,0,"dummy"
"69041",0,0,0,0,"dummy"
"69042",0,0,0,0,"dummy"
"69043",0,0,0,0,"dummy"
"69044",0,0,0,0,"dummy"
"69045",0,0,0,0,"dummy"
"69046",0,0,0,0,"dummy"
"69047",0,1,0,1,"dummy"
"69048",0,0,0,0,"dummy"
"69049",0,0,0,0,"dummy"
"69050",0,0,0,0,"dummy"
"69051",0,0,0,0,"dummy"
"69052",0,6,0,6,"dummy"
"69053",0,0,0,0,"dummy"
"69054",0,0,0,0,"dummy"
"69055",0,0,1,1,"dummy"
"69056",0,0,0,0,"dummy"
"69057",0,0,1,1,"dummy"
"69058",0,0,0,0,"dummy"
"69059",0,0,0,0,"dummy"
"69085",2,0,3,5,"dummy"
"69111",0,0,3,3,"dummy"
"69112",0,0,3,3,"dummy"
"69113",0,1,0,1,"dummy"
"69114",0,0,1,1,"dummy"
"69115",0,0,0,0,"dummy"
"69116",0,2,3,5,"dummy"
"69117",2,2,3,7,"dummy"
"69130",0,0,0,0,"dummy"
"69131",0,17,2,19,"dummy"
"69132",1,0,0,1,"dummy"
"69152",0,0,1,1,"dummy"
"69153",0,0,1,1,"dummy"
"69154",4,5,4,13,"dummy"
"69155",0,1,1,2,"dummy"
"69156",1,0,1,2,"dummy"
"69157",2,2,0,4,"dummy"
"69158",4,6,4,14,"dummy"
"69176",0,0,3,3,"dummy"
"69185",0,0,0,0,"dummy"
"69186",0,0,0,0,"dummy"
"69190",1,0,0,1,"dummy"
"69191",0,2,0,2,"dummy"
"68916",0,0,0,0,"dummy"
"68917",0,0,0,0,"dummy"
"68918",0,0,2,2,"dummy"
"68919",0,0,0,0,"dummy"
"68920",0,0,0,0,"dummy"
"68925",0,0,1,1,"dummy"
"68926",0,0,1,1,"dummy"
"68927",1,1,0,2,"dummy"
"68928",4,3,2,9,"dummy"
"68929",0,0,0,0,"dummy"
"68930",0,0,1,1,"dummy"
"68931",0,0,1,1,"dummy"
"68932",0,0,1,1,"dummy"
"68933",0,1,0,1,"dummy"
"68934",0,0,1,1,"dummy"
"68935",0,0,1,1,"dummy"
"68936",0,0,1,1,"dummy"
"68937",0,0,0,0,"dummy"
"68938",0,0,1,1,"dummy"
"68939",1,1,1,3,"dummy"
"68940",0,0,1,1,"dummy"
"68941",1,1,1,3,"dummy"
"68942",0,0,1,1,"dummy"
"68943",0,0,1,1,"dummy"
"68944",0,0,1,1,"dummy"
"68945",1,1,0,2,"dummy"
"68946",0,0,1,1,"dummy"
"68947",0,0,1,1,"dummy"
"68948",0,0,1,1,"dummy"
"68949",0,0,1,1,"dummy"
"68950",0,0,1,1,"dummy"
"68951",0,0,1,1,"dummy"
"68952",0,0,1,1,"dummy"
"68953",0,0,1,1,"dummy"
"68954",0,0,1,1,"dummy"
"68955",0,0,1,1,"dummy"
"68956",0,0,1,1,"dummy"
"68957",0,0,1,1,"dummy"
"68958",0,0,1,1,"dummy"
"68959",0,0,1,1,"dummy"
"68960",0,0,1,1,"dummy"
"68961",0,0,1,1,"dummy"
"68962",0,0,1,1,"dummy"
"68963",0,0,1,1,"dummy"
"68964",0,0,1,1,"dummy"
"68965",0,0,1,1,"dummy"
"68966",0,0,1,1,"dummy"
"68967",0,0,1,1,"dummy"
"68968",0,0,1,1,"dummy"
"68969",0,0,1,1,"dummy"
"68970",0,0,1,1,"dummy"
"68971",0,0,1,1,"dummy"
"68972",0,0,1,1,"dummy"
"68973",0,0,1,1,"dummy"
"68974",0,0,1,1,"dummy"
"68975",0,0,1,1,"dummy"
"68976",0,0,1,1,"dummy"
"68977",0,0,1,1,"dummy"
"68978",0,0,1,1,"dummy"
"68979",0,0,1,1,"dummy"
"68980",0,0,1,1,"dummy"
"68981",0,0,1,1,"dummy"
"68982",0,0,1,1,"dummy"
"68983",0,0,1,1,"dummy"
"68984",0,0,1,1,"dummy"
"68985",0,0,1,1,"dummy"
"68986",0,0,1,1,"dummy"
"68987",0,0,1,1,"dummy"
"68988",0,0,1,1,"dummy"
"68989",0,0,1,1,"dummy"
"68990",0,0,1,1,"dummy"
"68991",0,0,1,1,"dummy"
"68992",0,0,1,1,"dummy"
"68993",0,0,1,1,"dummy"
"68994",0,0,1,1,"dummy"
"68995",0,0,1,1,"dummy"
"68996",0,0,1,1,"dummy"
"68997",0,0,1,1,"dummy"
"68998",0,0,1,1,"dummy"
"68999",0,0,1,1,"dummy"
"69000",0,0,1,1,"dummy"
"69001",0,0,1,1,"dummy"
"69002",0,0,1,1,"dummy"
"69003",0,0,1,1,"dummy"
"69004",0,0,1,1,"dummy"
"69061",1,0,1,2,"dummy"
"69062",3,5,2,10,"dummy"
"69063",1,0,0,1,"dummy"
"69064",0,0,0,0,"dummy"
"69065",0,0,0,0,"dummy"
"69066",0,0,2,2,"dummy"
"69067",5,3,0,8,"dummy"
"69068",0,0,0,0,"dummy"
"69069",5,0,0,5,"dummy"
"69070",0,0,0,0,"dummy"
"69071",0,0,0,0,"dummy"
"69072",0,0,0,0,"dummy"
"69073",0,1,0,1,"dummy"
"69074",0,0,0,0,"dummy"
"69075",0,0,0,0,"dummy"
"69076",0,0,0,0,"dummy"
"69077",0,0,0,0,"dummy"
"69078",0,1,0,1,"dummy"
"69079",0,0,0,0,"dummy"
"69080",0,0,0,0,"dummy"
"69081",0,1,0,1,"dummy"
"69082",0,0,0,0,"dummy"
"69083",1,0,0,1,"dummy"
"69124",0,0,1,1,"dummy"
"69127",0,2,0,2,"dummy"
"69128",0,0,1,1,"dummy"
"69134",2,2,0,4,"dummy"
"69135",0,0,1,1,"dummy"
"69136",0,1,0,1,"dummy"
"69137",0,0,1,1,"dummy"
"69138",3,7,4,14,"dummy"
"69139",0,0,1,1,"dummy"
"69140",0,2,0,2,"dummy"
"69141",0,1,0,1,"dummy"
"69142",0,0,1,1,"dummy"
"69143",2,3,0,5,"dummy"
"69144",0,0,1,1,"dummy"
"69145",0,0,1,1,"dummy"
"69148",0,0,0,0,"dummy"
"69160",0,1,0,1,"dummy"
"69165",0,0,0,0,"dummy"
"69166",0,6,0,6,"dummy"
"69167",1,0,0,1,"dummy"
"69168",0,1,0,1,"dummy"
"69169",2,9,0,11,"dummy"
"69170",1,6,3,10,"dummy"
"69182",0,4,0,4,"dummy"
"69183",0,1,0,1,"dummy"
"69188",0,0,2,2,"dummy"
"69195",2,2,0,4,"dummy"
"69196",0,1,0,1,"dummy"
"69197",1,0,0,1,"dummy"
"69198",0,1,0,1,"dummy"
"69199",0,0,1,1,"dummy"
"69200",0,2,0,2,"dummy"
"69201",0,0,1,1,"dummy"
"69202",0,1,0,1,"dummy"
"69203",0,1,0,1,"dummy"
"69204",1,0,1,2,"dummy"
"69205",0,1,0,1,"dummy"
"69206",0,0,1,1,"dummy"
"69212",2,1,2,5,"dummy"
"69227",19,14,6,39,"dummy"
"69232",0,0,1,1,"dummy"
"69233",0,0,1,1,"dummy"
"69234",0,0,1,1,"dummy"
"69248",2,2,1,5,"dummy"
"69249",2,4,2,8,"dummy"
"69250",0,0,1,1,"dummy"
"69284",0,6,0,6,"dummy"
"69285",1,0,0,1,"dummy"
"69286",2,1,0,3,"dummy"
"69287",1,0,0,1,"dummy"
"69288",0,1,0,1,"dummy"
"69289",3,0,0,3,"dummy"
"69290",1,0,0,1,"dummy"
"69291",0,1,0,1,"dummy"
"69292",0,1,0,1,"dummy"
"69192",1,0,0,1,"dummy"
"69193",3,11,1,15,"dummy"
"69208",2,1,0,3,"dummy"
"69209",3,2,1,6,"dummy"
"69210",0,0,1,1,"dummy"
"69216",0,0,1,1,"dummy"
"69217",0,0,1,1,"dummy"
"69218",0,0,1,1,"dummy"
"69219",0,1,0,1,"dummy"
"69220",0,0,1,1,"dummy"
"69221",0,0,1,1,"dummy"
"69222",0,2,2,4,"dummy"
"69223",0,1,1,2,"dummy"
"69224",0,1,1,2,"dummy"
"69225",1,7,1,9,"dummy"
"69236",1,1,0,2,"dummy"
"69237",0,2,0,2,"dummy"
"69238",0,1,0,1,"dummy"
"69298",0,0,0,0,"dummy"
"69299",3,3,1,7,"dummy"
"69300",1,1,0,2,"dummy"
"69302",2,1,0,3,"dummy"
"69303",3,2,1,6,"dummy"
"69304",0,0,1,1,"dummy"
"69307",2,1,0,3,"dummy"
"69309",0,0,7,7,"dummy"
"69310",0,0,5,5,"dummy"
"69311",0,0,0,0,"dummy"
"69312",2,3,8,13,"dummy"
"69313",0,2,0,2,"dummy"
"69316",0,0,1,1,"dummy"
"69318",3,3,0,6,"dummy"
"69319",3,0,2,5,"dummy"
"69320",0,0,1,1,"dummy"
"69321",1,0,0,1,"dummy"
"69322",0,0,0,0,"dummy"
"69323",1,2,0,3,"dummy"
"69324",0,2,0,2,"dummy"
"69325",0,2,0,2,"dummy"
"69326",0,2,1,3,"dummy"
"69327",0,0,1,1,"dummy"
"69328",0,1,1,2,"dummy"
"69329",7,7,0,14,"dummy"
"69334",0,0,0,0,"dummy"
"69335",0,0,0,0,"dummy"
"69338",0,1,0,1,"dummy"
"69340",0,1,0,1,"dummy"
"69341",0,1,1,2,"dummy"
"69344",0,7,0,7,"dummy"
"69348",5,7,0,12,"dummy"
"69349",0,1,0,1,"dummy"
"69350",0,0,1,1,"dummy"
"69352",0,4,0,4,"dummy"
"69356",0,0,0,0,"dummy"
"69357",0,0,0,0,"dummy"
"69358",0,0,0,0,"dummy"
"69362",0,1,1,2,"dummy"
"69363",0,0,3,3,"dummy"
"69365",4,0,1,5,"dummy"
"69366",0,1,0,1,"dummy"
"69370",2,4,0,6,"dummy"
"69371",3,1,3,7,"dummy"
"69372",0,4,1,5,"dummy"
"69373",1,0,0,1,"dummy"
"69374",8,19,1,28,"dummy"
"69375",4,2,0,6,"dummy"
"69376",0,0,0,0,"dummy"
"69377",0,2,0,2,"dummy"
"69378",0,0,1,1,"dummy"
"69379",0,1,0,1,"dummy"
"69380",0,2,0,2,"dummy"
"69381",0,0,1,1,"dummy"
"69382",0,0,1,1,"dummy"
"69383",0,0,1,1,"dummy"
"69384",0,0,1,1,"dummy"
"69385",0,0,1,1,"dummy"
"69386",0,2,1,3,"dummy"
"69387",0,0,1,1,"dummy"
"69388",0,0,1,1,"dummy"
"69389",0,0,1,1,"dummy"
"69390",0,0,0,0,"dummy"
"69391",0,0,1,1,"dummy"
"69392",0,0,1,1,"dummy"
"69393",0,0,1,1,"dummy"
"69394",0,0,1,1,"dummy"
"69395",0,0,1,1,"dummy"
"69396",0,0,1,1,"dummy"
"69397",0,0,1,1,"dummy"
"69398",0,0,1,1,"dummy"
"69399",1,2,1,4,"dummy"
"69400",0,0,1,1,"dummy"
"69403",2,4,0,6,"dummy"
"69404",0,2,0,2,"dummy"
"69405",0,2,0,2,"dummy"
"69406",10,2,0,12,"dummy"
"69407",0,2,0,2,"dummy"
"69420",1,3,3,7,"dummy"
"69422",0,0,2,2,"dummy"
"69423",0,0,1,1,"dummy"
"69425",0,2,1,3,"dummy"
"69427",6,4,0,10,"dummy"
"69428",0,1,0,1,"dummy"
"69429",0,1,0,1,"dummy"
"69430",0,1,0,1,"dummy"
"69431",0,4,0,4,"dummy"
"69432",0,0,1,1,"dummy"
"69433",0,1,0,1,"dummy"
"69434",1,0,0,1,"dummy"
"69435",0,0,1,1,"dummy"
"69436",0,0,1,1,"dummy"
"69437",3,3,1,7,"dummy"
"69438",2,0,2,4,"dummy"
"69439",0,1,1,2,"dummy"
"69440",0,1,1,2,"dummy"
"69441",1,0,0,1,"dummy"
"69442",0,0,1,1,"dummy"
"69443",0,0,2,2,"dummy"
"69444",3,2,3,8,"dummy"
"69445",0,0,1,1,"dummy"
"69446",0,1,0,1,"dummy"
"69447",1,0,3,4,"dummy"
"69448",0,2,0,2,"dummy"
"69449",0,0,1,1,"dummy"
"69450",0,1,0,1,"dummy"
"69451",3,0,3,6,"dummy"
"69452",0,3,1,4,"dummy"
"69453",0,0,2,2,"dummy"
"69455",0,1,0,1,"dummy"
"69456",1,0,0,1,"dummy"
"69457",0,0,1,1,"dummy"
"69461",0,2,1,3,"dummy"
"69462",0,0,1,1,"dummy"
"69474",0,33,0,33,"dummy"
"69475",5,29,1,35,"dummy"
"69476",0,0,3,3,"dummy"
"69477",41,4,5,50,"dummy"
"69478",4,41,5,50,"dummy"
"69479",41,4,5,50,"dummy"
"69493",0,0,1,1,"dummy"
"69494",0,1,0,1,"dummy"
"69497",4,4,0,8,"dummy"
"69498",0,0,1,1,"dummy"
"69499",0,0,0,0,"dummy"
"69500",1,0,0,1,"dummy"
"69501",0,0,0,0,"dummy"
"69502",0,5,0,5,"dummy"
"69503",0,0,0,0,"dummy"
"69504",0,0,0,0,"dummy"
"69511",1,9,3,13,"dummy"
"69512",3,1,0,4,"dummy"
"69513",0,2,2,4,"dummy"
"69515",0,0,3,3,"dummy"
"69544",0,0,0,0,"dummy"
"69545",0,0,1,1,"dummy"
"69546",3,0,0,3,"dummy"
"69547",0,0,1,1,"dummy"
"69548",0,1,0,1,"dummy"
"69549",1,2,0,3,"dummy"
"69553",0,3,0,3,"dummy"
"69554",9,7,3,19,"dummy"
"69564",1,0,0,1,"dummy"
"69566",0,0,1,1,"dummy"
"69568",0,0,1,1,"dummy"
"69569",2,2,0,4,"dummy"
"69570",2,2,0,4,"dummy"
"69571",0,2,0,2,"dummy"
"69572",0,1,0,1,"dummy"
"69574",0,7,0,7,"dummy"
"69576",1,0,1,2,"dummy"
"69578",12,9,1,22,"dummy"
"69580",0,1,0,1,"dummy"
"69583",3,0,0,3,"dummy"
"69591",0,0,1,1,"dummy"
"69593",3,7,1,11,"dummy"
"69595",10,11,5,26,"dummy"
"69596",0,2,0,2,"dummy"
"69597",0,0,0,0,"dummy"
"69599",0,3,0,3,"dummy"
"69602",0,1,0,1,"dummy"
"69603",1,0,1,2,"dummy"
"69604",1,1,2,4,"dummy"
"69605",2,2,6,10,"dummy"
"69618",9,12,3,24,"dummy"
"69619",2,3,0,5,"dummy"
"69620",2,2,0,4,"dummy"
"69621",2,2,0,4,"dummy"
"69622",2,2,0,4,"dummy"
"69623",2,2,0,4,"dummy"
"69624",2,2,0,4,"dummy"
"69625",2,2,0,4,"dummy"
"69626",2,4,0,6,"dummy"
"69627",4,2,0,6,"dummy"
"69628",0,3,0,3,"dummy"
"69629",5,12,1,18,"dummy"
"69630",2,2,0,4,"dummy"
"69631",2,2,0,4,"dummy"
"69632",2,0,0,2,"dummy"
"69633",0,3,0,3,"dummy"
"69634",21,0,1,22,"dummy"
"69635",0,3,0,3,"dummy"
"69636",0,1,0,1,"dummy"
"69637",0,18,1,19,"dummy"
"69638",2,0,0,2,"dummy"
"69639",0,0,1,1,"dummy"
"69640",0,0,1,1,"dummy"
"69641",3,0,0,3,"dummy"
"69642",3,3,0,6,"dummy"
"69643",3,3,0,6,"dummy"
"69644",0,1,0,1,"dummy"
"69649",0,0,2,2,"dummy"
"69658",3,10,2,15,"dummy"
"69659",9,10,2,21,"dummy"
"69660",8,9,2,19,"dummy"
"69661",1,0,1,2,"dummy"
"69664",5,0,1,6,"dummy"
"69666",2,2,0,4,"dummy"
"69667",0,0,1,1,"dummy"
"69668",0,0,1,1,"dummy"
"69669",0,0,1,1,"dummy"
"69670",0,0,1,1,"dummy"
"69671",0,0,1,1,"dummy"
"69721",0,1,0,1,"dummy"
"69722",0,0,1,1,"dummy"
"69723",0,4,0,4,"dummy"
"69724",0,0,1,1,"dummy"
"69727",0,1,0,1,"dummy"
"69728",0,3,0,3,"dummy"
"69729",0,1,0,1,"dummy"
"69730",2,2,0,4,"dummy"
"69731",2,2,0,4,"dummy"
"69732",2,2,0,4,"dummy"
"69733",3,0,0,3,"dummy"
"69734",0,0,0,0,"dummy"
"69735",0,0,0,0,"dummy"
"69736",0,0,0,0,"dummy"
"69737",0,0,0,0,"dummy"
"69738",0,0,0,0,"dummy"
"69766",0,4,0,4,"dummy"
"69767",0,1,0,1,"dummy"
"69768",0,2,0,2,"dummy"
"69770",6,1,6,13,"dummy"
"69771",1,6,3,10,"dummy"
"69772",0,0,1,1,"dummy"
"69773",0,1,0,1,"dummy"
"69774",1,1,4,6,"dummy"
"69775",4,0,0,4,"dummy"
"69777",0,0,1,1,"dummy"
"69778",1,0,0,1,"dummy"
"69779",0,0,1,1,"dummy"
"69781",0,0,0,0,"dummy"
"69782",0,1,0,1,"dummy"
"69783",1,0,0,1,"dummy"
"69784",0,0,0,0,"dummy"
"69785",2,0,0,2,"dummy"
"69786",0,1,0,1,"dummy"
"69787",0,3,0,3,"dummy"
"69788",6,14,3,23,"dummy"
"69789",0,0,0,0,"dummy"
"69790",0,0,0,0,"dummy"
"69791",0,0,0,0,"dummy"
"69792",6,1,1,8,"dummy"
"69793",0,0,2,2,"dummy"
"69794",0,0,1,1,"dummy"
"69795",0,0,1,1,"dummy"
"69796",0,0,0,0,"dummy"
"69799",0,3,1,4,"dummy"
"69802",0,31,0,31,"dummy"
"69803",0,0,1,1,"dummy"
"69804",0,0,1,1,"dummy"
"69805",0,0,1,1,"dummy"
"69806",0,0,1,1,"dummy"
"69807",0,0,1,1,"dummy"
"69808",0,0,1,1,"dummy"
"69809",0,0,2,2,"dummy"
"69816",17,6,3,26,"dummy"
"69824",9,9,0,18,"dummy"
"69825",48,3,2,53,"dummy"
"69826",5,0,0,5,"dummy"
"69827",0,5,0,5,"dummy"
"69828",0,0,1,1,"dummy"
"69829",0,0,1,1,"dummy"
"69834",0,1,0,1,"dummy"
"69835",0,2,0,2,"dummy"
"69838",0,1,0,1,"dummy"
"69839",0,1,1,2,"dummy"
"69840",0,1,0,1,"dummy"
"69841",0,2,0,2,"dummy"
"69842",0,1,0,1,"dummy"
"69843",2,3,1,6,"dummy"
"69844",1,0,0,1,"dummy"
"69845",0,1,0,1,"dummy"
"69846",0,1,1,2,"dummy"
"69847",0,0,1,1,"dummy"
"69848",0,1,0,1,"dummy"
"69849",0,0,2,2,"dummy"
"69850",0,0,1,1,"dummy"
"69852",1,0,1,2,"dummy"
"69854",2,0,0,2,"dummy"
"69858",0,0,1,1,"dummy"
"69859",0,2,0,2,"dummy"
"69861",0,4,1,5,"dummy"
"69865",0,0,0,0,"dummy"
"69866",0,2,0,2,"dummy"
"69867",0,0,2,2,"dummy"
"69868",0,0,2,2,"dummy"
"69870",0,0,0,0,"dummy"
"69872",1,0,0,1,"dummy"
"69875",0,1,0,1,"dummy"
"69876",4,5,0,9,"dummy"
"69902",0,0,0,0,"dummy"
"69905",0,0,0,0,"dummy"
"69923",1,1,1,3,"dummy"
"69930",1,0,0,1,"dummy"
"69931",0,0,1,1,"dummy"
"69932",0,7,0,7,"dummy"
"69933",0,0,4,4,"dummy"
"69934",3,4,2,9,"dummy"
"69935",1,1,0,2,"dummy"
"69936",0,0,2,2,"dummy"
"69937",14,13,1,28,"dummy"
"69938",0,0,2,2,"dummy"
"69939",0,2,0,2,"dummy"
"69941",0,4,0,4,"dummy"
"69943",0,0,1,1,"dummy"
"69947",0,0,0,0,"dummy"
"69950",0,7,0,7,"dummy"
"69951",6,5,0,11,"dummy"
"69952",0,6,0,6,"dummy"
"69953",0,2,0,2,"dummy"
"69954",0,1,0,1,"dummy"
"69955",3,2,2,7,"dummy"
"69956",0,6,0,6,"dummy"
"69957",0,1,0,1,"dummy"
"69958",1,1,2,4,"dummy"
"69959",0,2,3,5,"dummy"
"69960",0,2,0,2,"dummy"
"69961",0,2,1,3,"dummy"
"69962",0,1,3,4,"dummy"
"69977",1,0,4,5,"dummy"
"69984",0,1,0,1,"dummy"
"69985",0,0,0,0,"dummy"
"69986",0,0,0,0,"dummy"
"69987",0,0,0,0,"dummy"
"69989",1,6,0,7,"dummy"
"69990",1,1,2,4,"dummy"
"69991",1,2,3,6,"dummy"
"70026",0,0,1,1,"dummy"
"70031",0,0,1,1,"dummy"
"70033",3,0,2,5,"dummy"
"70034",1,0,2,3,"dummy"
"70035",0,3,3,6,"dummy"
"70039",2,6,3,11,"dummy"
"70040",0,0,1,1,"dummy"
"70044",0,2,0,2,"dummy"
"70045",0,0,1,1,"dummy"
"70046",0,0,1,1,"dummy"
"70048",0,0,3,3,"dummy"
"70049",2,0,0,2,"dummy"
"70050",0,2,3,5,"dummy"
"70051",0,0,1,1,"dummy"
"70052",0,0,2,2,"dummy"
"70058",0,0,1,1,"dummy"
"70059",1,0,0,1,"dummy"
"70060",0,0,1,1,"dummy"
"70061",1,20,3,24,"dummy"
"70062",2,7,6,15,"dummy"
"70063",0,2,0,2,"dummy"
"70064",4,1,0,5,"dummy"
"70065",22,5,3,30,"dummy"
"70066",0,0,1,1,"dummy"
"70067",0,0,1,1,"dummy"
"70068",0,0,2,2,"dummy"
"70069",0,0,1,1,"dummy"
"70070",3,6,0,9,"dummy"
"70074",0,0,0,0,"dummy"
"70075",0,1,0,1,"dummy"
"70076",1,1,0,2,"dummy"
"70077",0,0,0,0,"dummy"
"70078",0,0,0,0,"dummy"
"70079",0,0,0,0,"dummy"
"70080",0,2,0,2,"dummy"
"70081",0,0,0,0,"dummy"
"70082",0,0,0,0,"dummy"
"70083",0,0,0,0,"dummy"
"70084",1,0,0,1,"dummy"
"70085",0,0,0,0,"dummy"
"70086",0,0,2,2,"dummy"
"70087",0,0,0,0,"dummy"
"70088",0,0,0,0,"dummy"
"70089",0,0,1,1,"dummy"
"70090",0,0,3,3,"dummy"
"70091",0,0,0,0,"dummy"
"70092",1,0,1,2,"dummy"
"70093",0,0,0,0,"dummy"
"70094",0,0,0,0,"dummy"
"70095",0,0,0,0,"dummy"
"70096",0,0,0,0,"dummy"
"70097",0,0,0,0,"dummy"
"70098",0,0,1,1,"dummy"
"70099",0,0,0,0,"dummy"
"70100",0,0,0,0,"dummy"
"70101",0,0,0,0,"dummy"
"70102",0,0,0,0,"dummy"
"70103",0,0,0,0,"dummy"
"70104",0,0,0,0,"dummy"
"70105",0,0,0,0,"dummy"
"70106",0,0,0,0,"dummy"
"70107",0,0,0,0,"dummy"
"70108",0,0,0,0,"dummy"
"70109",0,0,0,0,"dummy"
"70110",0,0,0,0,"dummy"
"70111",0,0,0,0,"dummy"
"70112",0,0,0,0,"dummy"
"70113",0,0,0,0,"dummy"
"70114",0,0,0,0,"dummy"
"70115",0,0,0,0,"dummy"
"70116",0,0,0,0,"dummy"
"70117",0,0,0,0,"dummy"
"70118",0,0,0,0,"dummy"
"70119",0,0,0,0,"dummy"
"70120",0,0,0,0,"dummy"
"70121",0,0,0,0,"dummy"
"70122",0,0,0,0,"dummy"
"70123",0,0,0,0,"dummy"
"70124",0,0,0,0,"dummy"
"70125",0,0,0,0,"dummy"
"70126",0,24,1,25,"dummy"
"70127",0,0,0,0,"dummy"
"70128",0,0,0,0,"dummy"
"70129",0,1,0,1,"dummy"
"70132",0,3,0,3,"dummy"
"70135",0,2,1,3,"dummy"
"70137",0,0,0,0,"dummy"
"70138",0,0,1,1,"dummy"
"70139",0,0,0,0,"dummy"
"70140",0,0,1,1,"dummy"
"70143",0,3,0,3,"dummy"
"70144",0,2,0,2,"dummy"
"70145",0,3,0,3,"dummy"
"70147",4,5,1,10,"dummy"
"70148",12,1,2,15,"dummy"
"70149",0,1,0,1,"dummy"
"70150",0,5,1,6,"dummy"
"70153",0,0,1,1,"dummy"
"70154",0,2,0,2,"dummy"
"70155",1,0,1,2,"dummy"
"70161",0,4,0,4,"dummy"
"70163",0,0,1,1,"dummy"
"70164",1,7,0,8,"dummy"
"70165",3,1,0,4,"dummy"
"70166",0,2,0,2,"dummy"
"70167",17,33,2,52,"dummy"
"70168",0,3,1,4,"dummy"
"70180",0,1,0,1,"dummy"
"70181",2,4,0,6,"dummy"
"70182",2,1,0,3,"dummy"
"70184",1,2,0,3,"dummy"
"70185",0,1,0,1,"dummy"
"70186",0,1,0,1,"dummy"
"70187",1,10,0,11,"dummy"
"70191",0,0,1,1,"dummy"
"70194",2,1,1,4,"dummy"
"70197",0,1,0,1,"dummy"
"70200",0,3,0,3,"dummy"
"70201",0,3,0,3,"dummy"
"70202",0,2,0,2,"dummy"
"70203",0,6,0,6,"dummy"
"70204",0,1,0,1,"dummy"
"70205",0,4,0,4,"dummy"
"70206",6,0,0,6,"dummy"
"70208",3,4,1,8,"dummy"
"70210",4,5,0,9,"dummy"
"70211",4,4,0,8,"dummy"
"70213",1,3,2,6,"dummy"
"70214",0,4,0,4,"dummy"
"70218",0,0,1,1,"dummy"
"70223",0,2,0,2,"dummy"
"70224",3,11,2,16,"dummy"
"70225",0,2,0,2,"dummy"
"70226",2,3,0,5,"dummy"
"70227",11,5,1,17,"dummy"
"70228",1,1,1,3,"dummy"
"70229",0,0,0,0,"dummy"
"70230",1,0,1,2,"dummy"
"70232",4,0,0,4,"dummy"
"70233",8,0,2,10,"dummy"
"70234",0,2,0,2,"dummy"
"70235",1,1,1,3,"dummy"
"70236",2,0,0,2,"dummy"
"70237",0,2,0,2,"dummy"
"70238",0,3,0,3,"dummy"
"70239",2,0,0,2,"dummy"
"70241",6,0,0,6,"dummy"
"70242",2,5,2,9,"dummy"
"70249",0,1,0,1,"dummy"
"70251",0,0,1,1,"dummy"
"70252",0,1,0,1,"dummy"
"70253",0,0,0,0,"dummy"
"70254",0,0,0,0,"dummy"
"70255",0,12,0,12,"dummy"
"70256",0,1,0,1,"dummy"
"70257",0,0,1,1,"dummy"
"70258",0,1,0,1,"dummy"
"70259",0,0,0,0,"dummy"
"70260",0,1,0,1,"dummy"
"70269",1,0,0,1,"dummy"
"70268",0,1,0,1,"dummy"
"70267",1,0,0,1,"dummy"
"70266",0,0,0,0,"dummy"
"70265",0,1,0,1,"dummy"
"70264",2,0,1,3,"dummy"
"70263",0,1,0,1,"dummy"
"70262",0,1,0,1,"dummy"
"70272",3,7,1,11,"dummy"
"70273",0,1,0,1,"dummy"
"70275",1,3,1,5,"dummy"
"70276",7,1,2,10,"dummy"
"70278",0,1,0,1,"dummy"
"70279",0,0,1,1,"dummy"
"70280",1,1,0,2,"dummy"
"70281",4,0,1,5,"dummy"
"70282",2,6,3,11,"dummy"
"70283",0,0,1,1,"dummy"
"70284",0,0,1,1,"dummy"
"70285",8,7,2,17,"dummy"
"70289",0,1,0,1,"dummy"
"70290",1,0,0,1,"dummy"
"70292",0,0,2,2,"dummy"
"70293",7,36,2,45,"dummy"
"70301",0,1,0,1,"dummy"
"70303",0,0,1,1,"dummy"
"70307",1,1,0,2,"dummy"
"70309",0,1,0,1,"dummy"
"70310",0,1,0,1,"dummy"
"70314",1,1,0,2,"dummy"
"70320",6,6,2,14,"dummy"
"70322",1,0,0,1,"dummy"
"70323",2,1,0,3,"dummy"
"70326",0,0,1,1,"dummy"
"70327",0,0,1,1,"dummy"
"70334",0,0,0,0,"dummy"
"70337",2,6,1,9,"dummy"
"70341",0,0,0,0,"dummy"
"70344",0,1,0,1,"dummy"
"70345",0,0,0,0,"dummy"
"70346",2,0,1,3,"dummy"
"70347",2,4,1,7,"dummy"
"70348",3,2,1,6,"dummy"
"70349",0,2,0,2,"dummy"
"70350",1,4,2,7,"dummy"
"70351",0,4,0,4,"dummy"
"70352",0,2,0,2,"dummy"
"70353",2,0,0,2,"dummy"
"70354",0,1,0,1,"dummy"
"70355",0,0,1,1,"dummy"
"70356",0,2,0,2,"dummy"
"70357",0,1,0,1,"dummy"
"70358",1,3,0,4,"dummy"
"70359",2,1,0,3,"dummy"
"70360",0,2,0,2,"dummy"
"70361",0,0,1,1,"dummy"
"70362",12,4,0,16,"dummy"
"70363",0,0,0,0,"dummy"
"70364",0,0,0,0,"dummy"
"70365",1,1,0,2,"dummy"
"70366",0,0,0,0,"dummy"
"70367",0,0,0,0,"dummy"
"70368",0,0,1,1,"dummy"
"70369",0,0,0,0,"dummy"
"70370",0,0,0,0,"dummy"
"70371",0,0,1,1,"dummy"
"70372",0,0,1,1,"dummy"
"70373",0,0,1,1,"dummy"
"70374",0,0,1,1,"dummy"
"70375",0,0,1,1,"dummy"
"70376",0,0,1,1,"dummy"
"70377",0,0,1,1,"dummy"
"70378",0,0,1,1,"dummy"
"70379",0,0,2,2,"dummy"
"70380",0,0,1,1,"dummy"
"70381",0,0,2,2,"dummy"
"70382",0,0,1,1,"dummy"
"70383",0,0,1,1,"dummy"
"70384",0,0,1,1,"dummy"
"70453",0,1,0,1,"dummy"
"70454",0,2,0,2,"dummy"
"70455",0,2,0,2,"dummy"
"70456",0,2,0,2,"dummy"
"70458",0,0,0,0,"dummy"
"70459",0,0,0,0,"dummy"
"70460",0,0,0,0,"dummy"
"70461",0,0,0,0,"dummy"
"70462",0,0,0,0,"dummy"
"70463",0,0,0,0,"dummy"
"70464",0,0,0,0,"dummy"
"70467",8,1,0,9,"dummy"
"70468",0,26,3,29,"dummy"
"70469",26,0,3,29,"dummy"
"70470",0,5,0,5,"dummy"
"70471",2,0,0,2,"dummy"
"70472",3,0,0,3,"dummy"
"70473",0,1,1,2,"dummy"
"70474",1,2,0,3,"dummy"
"70475",0,0,1,1,"dummy"
"70476",0,0,1,1,"dummy"
"70477",0,1,0,1,"dummy"
"70480",0,0,3,3,"dummy"
"70481",0,0,1,1,"dummy"
"70482",0,0,1,1,"dummy"
"70483",6,7,1,14,"dummy"
"70485",0,0,0,0,"dummy"
"70488",4,5,1,10,"dummy"
"70489",1,0,0,1,"dummy"
"70490",1,1,2,4,"dummy"
"70502",0,0,0,0,"dummy"
"70504",0,1,0,1,"dummy"
"70505",3,5,0,8,"dummy"
"70506",0,2,0,2,"dummy"
"70507",0,0,1,1,"dummy"
"70508",0,4,0,4,"dummy"
"70509",0,0,0,0,"dummy"
"70518",31,35,0,66,"dummy"
"70519",14,9,0,23,"dummy"
"70520",12,6,1,19,"dummy"
"70521",27,0,1,28,"dummy"
"70522",0,5,1,6,"dummy"
"70523",0,1,0,1,"dummy"
"70524",0,24,0,24,"dummy"
"70525",1,0,0,1,"dummy"
"70526",4,1,1,6,"dummy"
"70527",0,1,0,1,"dummy"
"70528",0,1,0,1,"dummy"
"70530",9,3,1,13,"dummy"
"70531",0,1,0,1,"dummy"
"70532",1,4,2,7,"dummy"
"70533",2,7,0,9,"dummy"
"70536",2,1,1,4,"dummy"
"70537",0,0,1,1,"dummy"
"70542",0,2,0,2,"dummy"
"70544",3,2,0,5,"dummy"
"70545",0,2,0,2,"dummy"
"70546",0,1,0,1,"dummy"
"70547",1,0,0,1,"dummy"
"70548",1,5,1,7,"dummy"
"70549",1,0,0,1,"dummy"
"70550",0,1,0,1,"dummy"
"70551",0,3,0,3,"dummy"
"70552",0,0,0,0,"dummy"
"70553",0,4,0,4,"dummy"
"70554",0,1,0,1,"dummy"
"70555",9,0,0,9,"dummy"
"70556",0,1,0,1,"dummy"
"70557",0,1,0,1,"dummy"
"70560",1,0,0,1,"dummy"
"70562",2,2,1,5,"dummy"
"70563",0,0,1,1,"dummy"
"70564",0,0,0,0,"dummy"
"70565",0,0,1,1,"dummy"
"70566",0,0,1,1,"dummy"
"70568",3,4,5,12,"dummy"
"70569",0,0,1,1,"dummy"
"70570",11,6,1,18,"dummy"
"70571",0,0,2,2,"dummy"
"70572",0,0,1,1,"dummy"
"70573",1,0,1,2,"dummy"
"70574",0,1,0,1,"dummy"
"70575",4,12,1,17,"dummy"
"70576",8,2,5,15,"dummy"
"70577",0,1,2,3,"dummy"
"70578",0,0,4,4,"dummy"
"70579",0,0,5,5,"dummy"
"70580",0,0,2,2,"dummy"
"70581",0,0,1,1,"dummy"
"70582",0,0,1,1,"dummy"
"70585",0,1,1,2,"dummy"
"70586",0,0,1,1,"dummy"
"70587",0,0,0,0,"dummy"
"70588",0,1,0,1,"dummy"
"70589",2,0,1,3,"dummy"
"70590",0,1,0,1,"dummy"
"70591",1,0,0,1,"dummy"
"70592",0,1,0,1,"dummy"
"70593",2,0,1,3,"dummy"
"70594",0,0,0,0,"dummy"
"70595",8,1,1,10,"dummy"
"70598",2,4,3,9,"dummy"
"70599",0,1,0,1,"dummy"
"70602",1,1,6,8,"dummy"
"70603",1,0,6,7,"dummy"
"70605",0,0,0,0,"dummy"
"70606",0,0,0,0,"dummy"
"70608",2,2,0,4,"dummy"
"70610",0,1,0,1,"dummy"
"70612",0,4,0,4,"dummy"
"70613",0,2,1,3,"dummy"
"70616",0,1,7,8,"dummy"
"70617",0,4,0,4,"dummy"
"70618",0,0,1,1,"dummy"
"70619",0,0,1,1,"dummy"
"70635",0,0,1,1,"dummy"
"70636",2,0,0,2,"dummy"
"70637",0,4,0,4,"dummy"
"70638",0,0,1,1,"dummy"
"70639",0,0,1,1,"dummy"
"70640",0,0,1,1,"dummy"
"70641",14,3,0,17,"dummy"
"70642",0,0,0,0,"dummy"
"70643",0,1,0,1,"dummy"
"70661",0,0,2,2,"dummy"
"70663",0,0,0,0,"dummy"
"70664",3,4,0,7,"dummy"
"70665",2,0,1,3,"dummy"
"70666",0,0,3,3,"dummy"
"70667",0,0,1,1,"dummy"
"70668",0,1,1,2,"dummy"
"70669",0,0,0,0,"dummy"
"70670",0,0,1,1,"dummy"
"70671",0,0,1,1,"dummy"
"70676",4,12,1,17,"dummy"
"70677",9,2,1,12,"dummy"
"70680",0,2,2,4,"dummy"
"70682",0,1,0,1,"dummy"
"70685",0,0,1,1,"dummy"
"70687",0,3,0,3,"dummy"
"70691",0,1,0,1,"dummy"
"70693",1,0,0,1,"dummy"
"70695",5,8,2,15,"dummy"
"70696",0,0,1,1,"dummy"
"70697",3,20,1,24,"dummy"
"70698",4,0,0,4,"dummy"
"70699",0,12,0,12,"dummy"
"70700",0,0,0,0,"dummy"
"70701",0,5,1,6,"dummy"
"70703",1,0,0,1,"dummy"
"70705",2,4,0,6,"dummy"
"70706",0,2,0,2,"dummy"
"70707",0,2,0,2,"dummy"
"70708",10,2,0,12,"dummy"
"70709",0,2,0,2,"dummy"
"70710",0,0,0,0,"dummy"
"70711",0,0,3,3,"dummy"
"70761",1,1,5,7,"dummy"
"70719",0,0,2,2,"dummy"
"70720",0,1,0,1,"dummy"
"70725",0,4,0,4,"dummy"
"70731",1,5,0,6,"dummy"
"70732",6,12,0,18,"dummy"
"70733",8,2,3,13,"dummy"
"70736",0,0,0,0,"dummy"
"70743",0,0,1,1,"dummy"
"70744",0,2,0,2,"dummy"
"70745",0,1,0,1,"dummy"
"70747",0,0,1,1,"dummy"
"70748",0,3,1,4,"dummy"
"70749",0,0,1,1,"dummy"
"70750",0,0,1,1,"dummy"
"70751",1,0,1,2,"dummy"
"70752",0,1,0,1,"dummy"
"70759",0,0,1,1,"dummy"
"70760",0,2,0,2,"dummy"
"70762",1,0,5,6,"dummy"
"70764",2,0,0,2,"dummy"
"70766",0,2,0,2,"dummy"
"70769",1,0,0,1,"dummy"
"70770",0,1,1,2,"dummy"
"70776",1,0,1,2,"dummy"
"70777",0,1,2,3,"dummy"
"70780",3,2,1,6,"dummy"
"70781",0,12,0,12,"dummy"
"70784",1,20,0,21,"dummy"
"70785",0,3,0,3,"dummy"
"70787",1,8,1,10,"dummy"
"70788",8,2,1,11,"dummy"
"70789",1,2,0,3,"dummy"
"70790",1,1,0,2,"dummy"
"70791",0,2,0,2,"dummy"
"70793",0,0,0,0,"dummy"
"70794",0,0,0,0,"dummy"
"70798",6,0,0,6,"dummy"
"70799",2,5,2,9,"dummy"
"70805",0,6,0,6,"dummy"
"70806",0,1,0,1,"dummy"
"70808",0,1,0,1,"dummy"
"70809",1,4,0,5,"dummy"
"70811",41,4,4,49,"dummy"
"70812",0,0,2,2,"dummy"
"70813",0,0,2,2,"dummy"
"70828",0,1,0,1,"dummy"
"70830",3,3,0,6,"dummy"
"70831",9,10,6,25,"dummy"
"70832",0,0,1,1,"dummy"
"70833",1,4,0,5,"dummy"
"70838",0,1,5,6,"dummy"
"70839",1,0,0,1,"dummy"
"70840",0,0,1,1,"dummy"
"70841",7,11,10,28,"dummy"
"70842",0,1,5,6,"dummy"
"70843",0,0,3,3,"dummy"
"70853",0,1,0,1,"dummy"
"70854",4,0,2,6,"dummy"
"70861",0,4,1,5,"dummy"
"70868",0,0,1,1,"dummy"
"70869",0,1,0,1,"dummy"
"70875",0,1,0,1,"dummy"
"70877",0,11,0,11,"dummy"
"70878",8,0,3,11,"dummy"
"70880",1,0,0,1,"dummy"
"70886",0,0,4,4,"dummy"
"70887",0,0,2,2,"dummy"
"70888",0,1,1,2,"dummy"
"70889",0,0,2,2,"dummy"
"70890",1,0,1,2,"dummy"
"70893",1,0,0,1,"dummy"
"70905",0,0,1,1,"dummy"
"70906",0,0,1,1,"dummy"
"70907",5,2,2,9,"dummy"
"70908",0,1,0,1,"dummy"
"70909",0,0,0,0,"dummy"
"70910",2,4,5,11,"dummy"
"70911",0,0,1,1,"dummy"
"70912",0,0,1,1,"dummy"
"70913",12,12,4,28,"dummy"
"70914",0,0,1,1,"dummy"
"70915",0,0,1,1,"dummy"
"70916",0,0,1,1,"dummy"
"70917",6,7,2,15,"dummy"
"70918",0,0,0,0,"dummy"
"70919",0,0,1,1,"dummy"
"70920",1,0,0,1,"dummy"
"70921",0,0,1,1,"dummy"
"70924",0,7,0,7,"dummy"
"70925",20,15,3,38,"dummy"
"70926",0,0,0,0,"dummy"
"70927",0,1,0,1,"dummy"
"70928",0,3,1,4,"dummy"
"70929",0,1,0,1,"dummy"
"70943",3,9,0,12,"dummy"
"70944",0,1,0,1,"dummy"
"70956",0,4,0,4,"dummy"
"70957",0,1,0,1,"dummy"
"70959",0,1,0,1,"dummy"
"70960",0,0,0,0,"dummy"
"70961",1,3,2,6,"dummy"
"70962",0,0,1,1,"dummy"
"70963",0,3,1,4,"dummy"
"70964",0,0,0,0,"dummy"
"70965",0,0,1,1,"dummy"
"70967",2,4,1,7,"dummy"
"70968",3,1,0,4,"dummy"
"70969",0,2,0,2,"dummy"
"70970",3,4,3,10,"dummy"
"70971",0,1,1,2,"dummy"
"70977",0,1,0,1,"dummy"
"70978",0,1,0,1,"dummy"
"70979",0,0,1,1,"dummy"
"70980",0,0,1,1,"dummy"
"70981",1,3,1,5,"dummy"
"70983",0,2,0,2,"dummy"
"70984",0,1,0,1,"dummy"
"70986",0,0,0,0,"dummy"
"70987",0,0,0,0,"dummy"
"70988",0,2,0,2,"dummy"
"70989",0,0,2,2,"dummy"
"70990",0,0,0,0,"dummy"
"70991",0,0,1,1,"dummy"
"70997",0,0,2,2,"dummy"
"70998",0,0,1,1,"dummy"
"70999",0,0,1,1,"dummy"
"71002",0,1,0,1,"dummy"
"71003",0,1,0,1,"dummy"
"71004",1,0,0,1,"dummy"
"71005",6,7,1,14,"dummy"
"71007",6,0,1,7,"dummy"
"71012",0,9,1,10,"dummy"
"71013",1,0,1,2,"dummy"
"71014",0,1,0,1,"dummy"
"71015",4,6,0,10,"dummy"
"71016",2,8,1,11,"dummy"
"71018",3,19,4,26,"dummy"
"71021",0,1,0,1,"dummy"
"71022",1,5,0,6,"dummy"
"71024",0,2,0,2,"dummy"
"71025",0,1,2,3,"dummy"
"71026",0,0,1,1,"dummy"
"71027",1,0,0,1,"dummy"
"71044",0,1,0,1,"dummy"
"71045",2,0,0,2,"dummy"
"71046",0,0,1,1,"dummy"
"71047",0,0,1,1,"dummy"
"71049",0,0,0,0,"dummy"
"71050",1,5,2,8,"dummy"
"71052",4,13,0,17,"dummy"
"71053",1,2,0,3,"dummy"
"71054",2,1,0,3,"dummy"
"71055",2,2,1,5,"dummy"
"71056",3,3,0,6,"dummy"
"71057",0,1,1,2,"dummy"
"71058",1,0,1,2,"dummy"
"71059",0,2,0,2,"dummy"
"71060",0,1,0,1,"dummy"
"71061",0,0,1,1,"dummy"
"71062",0,2,0,2,"dummy"
"71063",1,0,0,1,"dummy"
"71064",1,2,0,3,"dummy"
"71065",1,4,0,5,"dummy"
"71066",2,0,0,2,"dummy"
"71067",0,0,1,1,"dummy"
"71068",0,3,0,3,"dummy"
"71069",0,1,0,1,"dummy"
"71070",0,3,0,3,"dummy"
"71071",1,3,0,4,"dummy"
"71078",0,1,0,1,"dummy"
"71079",0,0,1,1,"dummy"
"71080",0,0,0,0,"dummy"
"71081",1,0,0,1,"dummy"
"71082",0,0,1,1,"dummy"
"71083",0,0,1,1,"dummy"
"71084",0,1,0,1,"dummy"
"71085",0,0,1,1,"dummy"
"71086",0,0,1,1,"dummy"
"71087",1,2,0,3,"dummy"
"71118",0,0,1,1,"dummy"
"71124",0,1,0,1,"dummy"
"71127",0,0,1,1,"dummy"
"71128",0,3,0,3,"dummy"
"71129",0,1,0,1,"dummy"
"71130",0,1,0,1,"dummy"
"71131",0,0,0,0,"dummy"
"71132",0,0,0,0,"dummy"
"71137",2,0,3,5,"dummy"
"71146",0,0,1,1,"dummy"
"71147",2,0,0,2,"dummy"
"71148",0,2,0,2,"dummy"
"71149",0,1,0,1,"dummy"
"71150",1,3,0,4,"dummy"
"71151",0,6,2,8,"dummy"
"71152",0,2,0,2,"dummy"
"71155",0,1,0,1,"dummy"
"71156",0,1,1,2,"dummy"
"71159",6,4,3,13,"dummy"
"71160",1,1,0,2,"dummy"
"71161",0,1,1,2,"dummy"
"71196",0,0,1,1,"dummy"
"71197",0,2,0,2,"dummy"
"71198",0,0,1,1,"dummy"
"71199",2,22,1,25,"dummy"
"71202",4,2,1,7,"dummy"
"71203",2,3,0,5,"dummy"
"71204",0,0,2,2,"dummy"
"71205",0,1,0,1,"dummy"
"71210",7,5,1,13,"dummy"
"71211",0,1,0,1,"dummy"
"71212",0,1,0,1,"dummy"
"71213",0,1,0,1,"dummy"
"71214",0,4,0,4,"dummy"
"71215",0,1,0,1,"dummy"
"71256",59,59,1,119,"dummy"
"71264",0,1,0,1,"dummy"
"71265",0,0,1,1,"dummy"
"71266",0,0,1,1,"dummy"
"71272",0,7,0,7,"dummy"
"71273",5,1,0,6,"dummy"
"71274",0,0,1,1,"dummy"
"71290",1,10,1,12,"dummy"
"71089",2,23,1,26,"dummy"
"71090",0,0,2,2,"dummy"
"71093",0,2,0,2,"dummy"
"71094",0,0,1,1,"dummy"
"71095",0,1,0,1,"dummy"
"71096",1,1,0,2,"dummy"
"71097",0,0,1,1,"dummy"
"71100",0,2,0,2,"dummy"
"71101",0,2,0,2,"dummy"
"71102",0,1,1,2,"dummy"
"71103",0,1,0,1,"dummy"
"71104",0,0,1,1,"dummy"
"71105",2,1,4,7,"dummy"
"71106",0,0,1,1,"dummy"
"71139",1,0,0,1,"dummy"
"71140",0,0,0,0,"dummy"
"71143",0,1,0,1,"dummy"
"71144",1,0,0,1,"dummy"
"71163",0,0,1,1,"dummy"
"71164",0,0,1,1,"dummy"
"71165",0,0,1,1,"dummy"
"71166",0,0,0,0,"dummy"
"71167",0,1,0,1,"dummy"
"71168",0,0,1,1,"dummy"
"71169",0,1,1,2,"dummy"
"71170",0,0,1,1,"dummy"
"71171",0,0,1,1,"dummy"
"71172",0,0,1,1,"dummy"
"71175",2,4,1,7,"dummy"
"71176",7,1,0,8,"dummy"
"71177",0,0,2,2,"dummy"
"71180",0,0,1,1,"dummy"
"71183",0,1,0,1,"dummy"
"71184",4,7,1,12,"dummy"
"71185",5,1,0,6,"dummy"
"71186",0,0,1,1,"dummy"
"71192",2,2,0,4,"dummy"
"71193",1,4,1,6,"dummy"
"71194",1,0,0,1,"dummy"
"71240",0,0,3,3,"dummy"
"71241",18,6,0,24,"dummy"
"71242",0,2,1,3,"dummy"
"71258",0,3,0,3,"dummy"
"71268",0,3,0,3,"dummy"
"71269",0,0,1,1,"dummy"
"71270",6,6,0,12,"dummy"
"71276",0,0,0,0,"dummy"
"71277",0,2,0,2,"dummy"
"71278",0,0,1,1,"dummy"
"71279",3,0,0,3,"dummy"
"71282",1,1,0,2,"dummy"
"71283",1,1,5,7,"dummy"
"71284",1,0,5,6,"dummy"
"71296",0,4,0,4,"dummy"
"71304",1,5,1,7,"dummy"
"71305",0,0,0,0,"dummy"
"71306",4,4,0,8,"dummy"
"71307",0,0,1,1,"dummy"
"71308",0,0,1,1,"dummy"
"71309",1,2,0,3,"dummy"
"71310",0,1,0,1,"dummy"
"71316",0,1,0,1,"dummy"
"71317",0,0,2,2,"dummy"
"71318",1,3,1,5,"dummy"
"71322",12,10,4,26,"dummy"
"71325",0,0,1,1,"dummy"
"71326",0,1,0,1,"dummy"
"71327",0,1,0,1,"dummy"
"71328",0,1,0,1,"dummy"
"71329",1,0,0,1,"dummy"
"71330",0,2,0,2,"dummy"
"71298",0,10,0,10,"dummy"
"71299",7,7,0,14,"dummy"
"71300",1,2,0,3,"dummy"
"71301",0,6,0,6,"dummy"
"71302",1,1,0,2,"dummy"
"71312",1,1,1,3,"dummy"
"71313",4,1,0,5,"dummy"
"71314",0,0,1,1,"dummy"
"71320",0,0,2,2,"dummy"
"71340",0,0,0,0,"dummy"
"71341",0,0,0,0,"dummy"
"71342",0,0,0,0,"dummy"
"71343",0,0,0,0,"dummy"
"71344",0,0,0,0,"dummy"
"71345",0,0,0,0,"dummy"
"71346",0,0,0,0,"dummy"
"71347",0,0,0,0,"dummy"
"71348",0,0,0,0,"dummy"
"71352",0,0,1,1,"dummy"
"71353",0,3,0,3,"dummy"
"71354",0,3,0,3,"dummy"
"71355",2,2,2,6,"dummy"
"71360",0,0,1,1,"dummy"
"71361",0,0,1,1,"dummy"
"71362",0,0,1,1,"dummy"
"71363",0,0,0,0,"dummy"
"71364",0,0,1,1,"dummy"
"71365",0,0,1,1,"dummy"
"71368",8,0,0,8,"dummy"
"71369",1,2,1,4,"dummy"
"71370",5,1,1,7,"dummy"
"71371",0,0,2,2,"dummy"
"71378",0,1,0,1,"dummy"
"71382",0,0,1,1,"dummy"
"71383",0,0,0,0,"dummy"
"71384",0,7,6,13,"dummy"
"71385",0,1,0,1,"dummy"
"71386",0,0,1,1,"dummy"
"71387",0,0,0,0,"dummy"
"71394",0,4,0,4,"dummy"
"71395",0,2,0,2,"dummy"
"71396",0,1,0,1,"dummy"
"71397",0,2,0,2,"dummy"
"71398",0,0,0,0,"dummy"
"71401",0,1,2,3,"dummy"
"71402",0,0,0,0,"dummy"
"71403",0,1,0,1,"dummy"
"71404",4,0,2,6,"dummy"
"71405",1,0,0,1,"dummy"
"71406",0,0,0,0,"dummy"
"71407",0,0,0,0,"dummy"
"71416",0,1,4,5,"dummy"
"71417",0,0,1,1,"dummy"
"71418",0,0,1,1,"dummy"
"71419",2,1,0,3,"dummy"
"71420",0,0,1,1,"dummy"
"71428",0,1,0,1,"dummy"
"71439",0,6,0,6,"dummy"
"71440",2,6,4,12,"dummy"
"71441",0,4,2,6,"dummy"
"71442",0,0,3,3,"dummy"
"71447",0,0,1,1,"dummy"
"71471",0,1,0,1,"dummy"
"71479",0,5,0,5,"dummy"
"71480",0,2,0,2,"dummy"
"71481",3,3,1,7,"dummy"
"71482",6,1,0,7,"dummy"
"71483",1,6,0,7,"dummy"
"71484",2,3,1,6,"dummy"
"71485",0,0,1,1,"dummy"
"71486",2,2,2,6,"dummy"
"71487",5,3,0,8,"dummy"
"71488",0,2,0,2,"dummy"
"71489",3,3,1,7,"dummy"
"71490",4,4,1,9,"dummy"
"71491",3,9,4,16,"dummy"
"71492",0,1,0,1,"dummy"
"71493",1,10,1,12,"dummy"
"71494",8,2,0,10,"dummy"
"71495",1,1,0,2,"dummy"
"71496",0,0,1,1,"dummy"
"71497",2,8,1,11,"dummy"
"71498",7,2,1,10,"dummy"
"71331",0,0,3,3,"dummy"
"71332",0,1,1,2,"dummy"
"71333",0,1,1,2,"dummy"
"71334",0,0,2,2,"dummy"
"71335",1,3,2,6,"dummy"
"71336",3,3,0,6,"dummy"
"71337",3,3,2,8,"dummy"
"71338",3,3,0,6,"dummy"
"71350",0,0,0,0,"dummy"
"71373",6,0,0,6,"dummy"
"71374",0,0,0,0,"dummy"
"71375",0,0,1,1,"dummy"
"71376",2,0,0,2,"dummy"
"71380",2,2,0,4,"dummy"
"71389",0,1,1,2,"dummy"
"71390",2,0,1,3,"dummy"
"71391",1,1,0,2,"dummy"
"71392",0,1,0,1,"dummy"
"71412",0,4,2,6,"dummy"
"71424",0,0,0,0,"dummy"
"71425",0,1,0,1,"dummy"
"71426",0,0,0,0,"dummy"
"71430",0,2,0,2,"dummy"
"71454",0,0,0,0,"dummy"
"71455",1,0,0,1,"dummy"
"71456",13,1,0,14,"dummy"
"71457",0,0,1,1,"dummy"
"71458",2,0,0,2,"dummy"
"71459",0,1,0,1,"dummy"
"71460",0,0,0,0,"dummy"
"71461",0,0,1,1,"dummy"
"71462",0,2,0,2,"dummy"
"71463",0,0,0,0,"dummy"
"71464",5,1,0,6,"dummy"
"71465",1,0,0,1,"dummy"
"71466",0,0,0,0,"dummy"
"71467",0,0,0,0,"dummy"
"71473",0,0,1,1,"dummy"
"71474",0,0,1,1,"dummy"
"71475",1,0,0,1,"dummy"
"71476",0,1,1,2,"dummy"
"71477",0,2,0,2,"dummy"
"71511",15,21,5,41,"dummy"
"71512",1,0,0,1,"dummy"
"71513",24,0,4,28,"dummy"
"71523",4,5,2,11,"dummy"
"71524",0,0,0,0,"dummy"
"71534",2,0,0,2,"dummy"
"71535",0,0,0,0,"dummy"
"71540",0,1,0,1,"dummy"
"71541",1,0,0,1,"dummy"
"71542",0,1,2,3,"dummy"
"71543",7,0,2,9,"dummy"
"71544",0,7,2,9,"dummy"
"71545",2,0,0,2,"dummy"
"71550",3,3,0,6,"dummy"
"71551",0,0,1,1,"dummy"
"71552",0,0,1,1,"dummy"
"71553",0,0,1,1,"dummy"
"71554",0,0,1,1,"dummy"
"71557",1,1,0,2,"dummy"
"71573",1,0,0,1,"dummy"
"71576",0,0,1,1,"dummy"
"71499",0,0,1,1,"dummy"
"71500",0,0,1,1,"dummy"
"71501",0,0,1,1,"dummy"
"71502",10,0,1,11,"dummy"
"71503",0,10,1,11,"dummy"
"71504",0,0,1,1,"dummy"
"71505",0,2,0,2,"dummy"
"71506",13,0,0,13,"dummy"
"71507",0,1,0,1,"dummy"
"71508",0,1,0,1,"dummy"
"71509",0,3,0,3,"dummy"
"71517",0,4,0,4,"dummy"
"71518",0,0,0,0,"dummy"
"71519",0,2,2,4,"dummy"
"71559",21,32,4,57,"dummy"
"71560",1,0,0,1,"dummy"
"71561",1,0,0,1,"dummy"
"71566",0,1,0,1,"dummy"
"71581",0,0,1,1,"dummy"
"71582",0,2,0,2,"dummy"
"71583",0,0,1,1,"dummy"
"71584",0,0,1,1,"dummy"
"71593",0,1,0,1,"dummy"
"71594",3,1,1,5,"dummy"
"71600",0,2,2,4,"dummy"
"71601",0,0,1,1,"dummy"
"71603",4,8,3,15,"dummy"
"71604",1,1,0,2,"dummy"
"71609",0,0,1,1,"dummy"
"71610",0,1,0,1,"dummy"
"71611",0,0,1,1,"dummy"
"71613",13,3,5,21,"dummy"
"71625",0,3,0,3,"dummy"
"71626",0,1,0,1,"dummy"
"71627",1,0,0,1,"dummy"
"71629",0,0,1,1,"dummy"
"71636",0,0,0,0,"dummy"
"71637",0,0,0,0,"dummy"
"71638",0,0,0,0,"dummy"
"71639",0,0,0,0,"dummy"
"71640",0,0,0,0,"dummy"
"71641",3,2,0,5,"dummy"
"71659",1,0,0,1,"dummy"
"71660",0,1,0,1,"dummy"
"71661",0,0,0,0,"dummy"
"71662",3,2,0,5,"dummy"
"71663",0,8,2,10,"dummy"
"71664",0,4,0,4,"dummy"
"71665",0,1,0,1,"dummy"
"71669",0,2,0,2,"dummy"
"71681",0,1,0,1,"dummy"
"71683",0,0,0,0,"dummy"
"71684",0,0,0,0,"dummy"
"71691",3,3,2,8,"dummy"
"71692",4,1,3,8,"dummy"
"71693",0,0,1,1,"dummy"
"71694",0,1,0,1,"dummy"
"71695",0,0,0,0,"dummy"
"71696",0,0,1,1,"dummy"
"71698",0,6,0,6,"dummy"
"71699",6,0,0,6,"dummy"
"71700",0,1,0,1,"dummy"
"71702",0,0,1,1,"dummy"
"71704",0,0,1,1,"dummy"
"71706",0,0,1,1,"dummy"
"71709",3,3,0,6,"dummy"
"71710",1,1,0,2,"dummy"
"71727",0,2,0,2,"dummy"
"71728",1,5,1,7,"dummy"
"71729",2,0,0,2,"dummy"
"71730",0,1,0,1,"dummy"
"71740",3,8,0,11,"dummy"
"71747",0,1,0,1,"dummy"
"71749",2,0,0,2,"dummy"
"71750",3,2,1,6,"dummy"
"71751",2,3,0,5,"dummy"
"71752",1,0,0,1,"dummy"
"71754",0,1,0,1,"dummy"
"71755",0,1,0,1,"dummy"
"71756",0,2,0,2,"dummy"
"71757",1,1,0,2,"dummy"
"71758",0,1,1,2,"dummy"
"71760",1,0,0,1,"dummy"
"71762",1,1,1,3,"dummy"
"71763",1,1,0,2,"dummy"
"71764",0,2,1,3,"dummy"
"71765",4,4,0,8,"dummy"
"71766",6,13,3,22,"dummy"
"71767",0,3,0,3,"dummy"
"71768",0,0,1,1,"dummy"
"71769",0,0,1,1,"dummy"
"71770",0,1,0,1,"dummy"
"71772",9,5,0,14,"dummy"
"71773",1,0,0,1,"dummy"
"71774",0,2,0,2,"dummy"
"71776",0,0,0,0,"dummy"
"71777",0,15,1,16,"dummy"
"71778",4,1,0,5,"dummy"
"71779",0,1,0,1,"dummy"
"71780",1,2,0,3,"dummy"
"71781",0,1,0,1,"dummy"
"71782",1,0,0,1,"dummy"
"71783",12,8,1,21,"dummy"
"71786",2,0,3,5,"dummy"
"71791",0,1,0,1,"dummy"
"71793",0,0,1,1,"dummy"
"71794",0,14,1,15,"dummy"
"71796",0,1,0,1,"dummy"
"71797",1,1,1,3,"dummy"
"71798",0,0,1,1,"dummy"
"71799",6,0,1,7,"dummy"
"71804",7,8,0,15,"dummy"
"71805",8,8,0,16,"dummy"
"71806",0,0,1,1,"dummy"
"71807",0,1,1,2,"dummy"
"71808",2,0,0,2,"dummy"
"71809",7,8,0,15,"dummy"
"71810",8,8,0,16,"dummy"
"71814",0,1,0,1,"dummy"
"71815",1,2,0,3,"dummy"
"71818",0,1,0,1,"dummy"
"71824",0,2,0,2,"dummy"
"71837",0,0,1,1,"dummy"
"71838",11,1,0,12,"dummy"
"71839",0,2,0,2,"dummy"
"71840",0,4,1,5,"dummy"
"71841",2,0,0,2,"dummy"
"71842",0,1,0,1,"dummy"
"71843",2,1,0,3,"dummy"
"71844",0,1,0,1,"dummy"
"71845",0,3,0,3,"dummy"
"71846",0,0,1,1,"dummy"
"71858",0,7,0,7,"dummy"
"71862",0,2,0,2,"dummy"
"71863",0,0,0,0,"dummy"
"71864",0,0,0,0,"dummy"
"71865",1,0,1,2,"dummy"
"71866",0,1,0,1,"dummy"
"71867",0,1,0,1,"dummy"
"71868",1,0,0,1,"dummy"
"71869",3,3,1,7,"dummy"
"71870",0,0,2,2,"dummy"
"71873",1,3,2,6,"dummy"
"71874",1,11,1,13,"dummy"
"71875",2,3,3,8,"dummy"
"71876",8,6,1,15,"dummy"
"71877",1,2,0,3,"dummy"
"71879",5,0,0,5,"dummy"
"71883",0,0,0,0,"dummy"
"71884",0,0,1,1,"dummy"
"71893",2,0,1,3,"dummy"
"71894",1,1,1,3,"dummy"
"71895",0,0,1,1,"dummy"
"71897",0,0,1,1,"dummy"
"71900",6,0,1,7,"dummy"
"71901",0,2,0,2,"dummy"
"71929",0,0,1,1,"dummy"
"71930",0,1,0,1,"dummy"
"71931",0,0,1,1,"dummy"
"71932",0,0,1,1,"dummy"
"71933",0,1,0,1,"dummy"
"71935",0,0,1,1,"dummy"
"71936",0,1,0,1,"dummy"
"71937",1,0,0,1,"dummy"
"71938",12,1,1,14,"dummy"
"71939",0,1,0,1,"dummy"
"71941",0,0,1,1,"dummy"
"71944",1,0,0,1,"dummy"
"71945",3,7,0,10,"dummy"
"71946",2,4,0,6,"dummy"
"71947",0,2,0,2,"dummy"
"71948",0,1,0,1,"dummy"
"71949",0,0,1,1,"dummy"
"71950",0,2,0,2,"dummy"
"71951",0,1,0,1,"dummy"
"71952",0,1,0,1,"dummy"
"71953",0,5,0,5,"dummy"
"71954",0,0,0,0,"dummy"
"71955",0,0,0,0,"dummy"
"71956",2,4,1,7,"dummy"
"71957",1,4,0,5,"dummy"
"71958",1,8,0,9,"dummy"
"71959",0,2,0,2,"dummy"
"71960",0,0,1,1,"dummy"
"71961",0,0,1,1,"dummy"
"71962",0,4,0,4,"dummy"
"71966",0,1,0,1,"dummy"
"71967",0,2,0,2,"dummy"
"71968",1,0,0,1,"dummy"
"71969",0,1,0,1,"dummy"
"71970",0,1,0,1,"dummy"
"71971",1,3,0,4,"dummy"
"71972",0,2,1,3,"dummy"
"71977",2,0,0,2,"dummy"
"71978",0,0,0,0,"dummy"
"71982",0,0,2,2,"dummy"
"71986",6,3,0,9,"dummy"
"71987",1,2,0,3,"dummy"
"71988",1,1,0,2,"dummy"
"71989",1,0,0,1,"dummy"
"71990",0,1,0,1,"dummy"
"71991",0,1,0,1,"dummy"
"71992",1,5,0,6,"dummy"
"71993",4,1,0,5,"dummy"
"71994",0,1,0,1,"dummy"
"71995",0,4,0,4,"dummy"
"71996",0,1,0,1,"dummy"
"71997",0,2,0,2,"dummy"
"72002",2,2,4,8,"dummy"
"72003",0,0,0,0,"dummy"
"72004",0,0,3,3,"dummy"
"72005",0,0,2,2,"dummy"
"72006",0,0,5,5,"dummy"
"72007",0,0,0,0,"dummy"
"72008",0,0,0,0,"dummy"
"72009",0,0,0,0,"dummy"
"72010",0,0,5,5,"dummy"
"72011",0,0,0,0,"dummy"
"72012",0,0,0,0,"dummy"
"72013",0,0,0,0,"dummy"
"72014",1,2,0,3,"dummy"
"72016",0,0,1,1,"dummy"
"72017",0,0,1,1,"dummy"
"72018",0,0,0,0,"dummy"
"72019",0,0,1,1,"dummy"
"72020",0,0,1,1,"dummy"
"72021",0,0,1,1,"dummy"
"72022",0,0,1,1,"dummy"
"72023",0,0,1,1,"dummy"
"72025",0,0,1,1,"dummy"
"72027",2,0,3,5,"dummy"
"72030",1,2,0,3,"dummy"
"72031",0,0,1,1,"dummy"
"72032",0,2,2,4,"dummy"
"72033",0,0,2,2,"dummy"
"72034",0,0,1,1,"dummy"
"72035",7,0,1,8,"dummy"
"72037",0,0,0,0,"dummy"
"72038",0,0,0,0,"dummy"
"72040",0,1,0,1,"dummy"
"72041",0,0,1,1,"dummy"
"72044",0,0,1,1,"dummy"
"72045",0,0,1,1,"dummy"
"72046",0,0,0,0,"dummy"
"72047",0,0,1,1,"dummy"
"72048",0,0,1,1,"dummy"
"72049",0,0,1,1,"dummy"
"72050",0,0,1,1,"dummy"
"72051",0,0,1,1,"dummy"
"72052",0,0,1,1,"dummy"
"72053",0,0,1,1,"dummy"
"72054",0,0,1,1,"dummy"
"72058",1,0,0,1,"dummy"
"72059",6,2,0,8,"dummy"
"72060",2,11,1,14,"dummy"
"72061",0,0,1,1,"dummy"
"72062",0,0,1,1,"dummy"
"72066",7,1,3,11,"dummy"
"72067",0,1,0,1,"dummy"
"72068",0,0,0,0,"dummy"
"72069",3,2,0,5,"dummy"
"72070",25,13,1,39,"dummy"
"72071",23,2,2,27,"dummy"
"72072",1,2,0,3,"dummy"
"72073",0,0,1,1,"dummy"
"72074",0,0,1,1,"dummy"
"72075",0,2,0,2,"dummy"
"72076",0,0,1,1,"dummy"
"72079",3,5,0,8,"dummy"
"72080",2,10,2,14,"dummy"
"72123",0,1,1,2,"dummy"
"72124",0,2,0,2,"dummy"
"72125",0,2,0,2,"dummy"
"72126",2,0,0,2,"dummy"
"72146",0,0,0,0,"dummy"
"72147",0,0,0,0,"dummy"
"72150",5,13,1,19,"dummy"
"72151",2,4,1,7,"dummy"
"72152",8,6,0,14,"dummy"
"72153",0,1,0,1,"dummy"
"72154",0,4,2,6,"dummy"
"72155",0,1,0,1,"dummy"
"72156",2,3,0,5,"dummy"
"72157",3,4,0,7,"dummy"
"72158",4,0,0,4,"dummy"
"72159",2,4,1,7,"dummy"
"72160",9,0,2,11,"dummy"
"72161",0,0,0,0,"dummy"
"72162",1,2,1,4,"dummy"
"72163",0,1,0,1,"dummy"
"72164",0,1,0,1,"dummy"
"72165",1,0,0,1,"dummy"
"72166",0,1,0,1,"dummy"
"72173",1,0,1,2,"dummy"
"72174",0,0,0,0,"dummy"
"72175",0,0,0,0,"dummy"
"72196",1,2,0,3,"dummy"
"72197",1,2,0,3,"dummy"
"72219",1,0,1,2,"dummy"
"72220",4,2,1,7,"dummy"
"72221",0,0,1,1,"dummy"
"72224",0,1,0,1,"dummy"
"72231",0,0,1,1,"dummy"
"72232",0,0,1,1,"dummy"
"72236",2,0,0,2,"dummy"
"72239",4,0,1,5,"dummy"
"72240",0,1,0,1,"dummy"
"72241",0,0,0,0,"dummy"
"72242",1,0,0,1,"dummy"
"72056",0,1,0,1,"dummy"
"72064",0,0,0,0,"dummy"
"72082",0,1,1,2,"dummy"
"72083",0,1,0,1,"dummy"
"72084",0,0,2,2,"dummy"
"72085",0,1,0,1,"dummy"
"72086",0,3,0,3,"dummy"
"72087",0,2,1,3,"dummy"
"72109",1,2,1,4,"dummy"
"72110",0,1,1,2,"dummy"
"72111",0,2,0,2,"dummy"
"72112",0,0,1,1,"dummy"
"72117",41,13,3,57,"dummy"
"72118",0,1,0,1,"dummy"
"72119",0,1,0,1,"dummy"
"72120",0,2,0,2,"dummy"
"72121",0,1,0,1,"dummy"
"72128",0,0,2,2,"dummy"
"72129",0,0,1,1,"dummy"
"72130",0,0,1,1,"dummy"
"72131",0,2,0,2,"dummy"
"72138",0,1,0,1,"dummy"
"72139",0,2,1,3,"dummy"
"72140",0,0,0,0,"dummy"
"72141",0,1,1,2,"dummy"
"72142",0,1,0,1,"dummy"
"72143",0,0,0,0,"dummy"
"72144",0,0,3,3,"dummy"
"72168",0,1,4,5,"dummy"
"72169",0,0,4,4,"dummy"
"72170",0,18,5,23,"dummy"
"72171",5,16,0,21,"dummy"
"72181",0,0,1,1,"dummy"
"72184",0,0,1,1,"dummy"
"72187",1,0,0,1,"dummy"
"72188",0,0,1,1,"dummy"
"72189",0,1,0,1,"dummy"
"72190",1,6,3,10,"dummy"
"72191",0,2,0,2,"dummy"
"72192",0,1,0,1,"dummy"
"72193",0,0,2,2,"dummy"
"72194",0,0,2,2,"dummy"
"72205",0,2,0,2,"dummy"
"72206",0,2,0,2,"dummy"
"72207",0,3,0,3,"dummy"
"72208",0,0,2,2,"dummy"
"72209",0,5,1,6,"dummy"
"72210",0,2,0,2,"dummy"
"72211",0,1,0,1,"dummy"
"72212",0,1,0,1,"dummy"
"72213",1,0,0,1,"dummy"
"72226",1,3,0,4,"dummy"
"72227",3,0,0,3,"dummy"
"72228",0,1,0,1,"dummy"
"72229",0,0,1,1,"dummy"
"72234",0,0,0,0,"dummy"
"72284",0,5,0,5,"dummy"
"72285",5,9,0,14,"dummy"
"72286",0,4,1,5,"dummy"
"72287",5,5,0,10,"dummy"
"72288",2,0,0,2,"dummy"
"72289",26,13,4,43,"dummy"
"72290",0,1,0,1,"dummy"
"72291",0,0,1,1,"dummy"
"72295",2,4,2,8,"dummy"
"72296",4,3,0,7,"dummy"
"72297",0,1,0,1,"dummy"
"72298",0,0,0,0,"dummy"
"72311",2,5,2,9,"dummy"
"72318",3,1,1,5,"dummy"
"72319",0,1,0,1,"dummy"
"72320",0,1,0,1,"dummy"
"72293",0,2,0,2,"dummy"
"72300",0,21,0,21,"dummy"
"72301",0,1,0,1,"dummy"
"72316",0,0,2,2,"dummy"
"72324",0,0,2,2,"dummy"
"72337",0,2,1,3,"dummy"
"72349",0,1,0,1,"dummy"
"72350",0,2,0,2,"dummy"
"72351",0,3,0,3,"dummy"
"72352",0,1,0,1,"dummy"
"72353",1,1,0,2,"dummy"
"72354",0,2,0,2,"dummy"
"72365",0,6,1,7,"dummy"
"72366",12,19,1,32,"dummy"
"72367",3,9,5,17,"dummy"
"72368",24,27,2,53,"dummy"
"72386",2,5,0,7,"dummy"
"72387",0,1,1,2,"dummy"
"72392",0,0,0,0,"dummy"
"72406",4,2,7,13,"dummy"
"72407",0,0,1,1,"dummy"
"72412",3,7,3,13,"dummy"
"72413",3,4,0,7,"dummy"
"72414",0,1,0,1,"dummy"
"72415",0,1,0,1,"dummy"
"72416",1,2,0,3,"dummy"
"72417",0,1,0,1,"dummy"
"72418",0,1,0,1,"dummy"
"72423",0,19,0,19,"dummy"
"72424",2,2,1,5,"dummy"
"72425",0,1,0,1,"dummy"
"72433",0,2,3,5,"dummy"
"72441",2,0,0,2,"dummy"
"72442",0,0,1,1,"dummy"
"72443",0,6,0,6,"dummy"
"72446",1,0,0,1,"dummy"
"72459",0,0,2,2,"dummy"
"72460",0,2,1,3,"dummy"
"72471",0,0,0,0,"dummy"
"72472",0,1,2,3,"dummy"
"72473",0,1,5,6,"dummy"
"72474",0,0,0,0,"dummy"
"72475",0,0,1,1,"dummy"
"72476",0,1,2,3,"dummy"
"72477",0,0,1,1,"dummy"
"72480",1,5,1,7,"dummy"
"72481",2,2,0,4,"dummy"
"72482",0,1,0,1,"dummy"
"72483",0,2,0,2,"dummy"
"72484",0,4,1,5,"dummy"
"72485",2,3,0,5,"dummy"
"72486",0,1,0,1,"dummy"
"72487",13,0,1,14,"dummy"
"72488",0,0,1,1,"dummy"
"72489",2,0,1,3,"dummy"
"72490",0,1,1,2,"dummy"
"72328",0,4,0,4,"dummy"
"72329",0,25,0,25,"dummy"
"72330",0,1,0,1,"dummy"
"72331",0,4,0,4,"dummy"
"72332",0,2,0,2,"dummy"
"72333",1,0,1,2,"dummy"
"72341",0,1,0,1,"dummy"
"72342",0,1,0,1,"dummy"
"72358",2,1,1,4,"dummy"
"72359",0,8,0,8,"dummy"
"72362",0,0,2,2,"dummy"
"72363",1,0,1,2,"dummy"
"72370",0,1,0,1,"dummy"
"72384",1,4,5,10,"dummy"
"72409",5,1,2,8,"dummy"
"72410",0,0,2,2,"dummy"
"72427",0,1,0,1,"dummy"
"72428",0,1,0,1,"dummy"
"72431",0,0,0,0,"dummy"
"72450",0,3,0,3,"dummy"
"72462",0,0,0,0,"dummy"
"72465",0,0,1,1,"dummy"
"72466",1,1,0,2,"dummy"
"72467",0,2,0,2,"dummy"
"72492",0,1,0,1,"dummy"
"72493",0,1,0,1,"dummy"
"72506",0,0,0,0,"dummy"
"72507",0,0,0,0,"dummy"
"72508",4,2,0,6,"dummy"
"72509",2,0,0,2,"dummy"
"72510",0,0,0,0,"dummy"
"72511",0,0,0,0,"dummy"
"72515",0,0,1,1,"dummy"
"72516",0,0,1,1,"dummy"
"72517",0,0,0,0,"dummy"
"72518",0,1,0,1,"dummy"
"72523",1,0,0,1,"dummy"
"72524",0,1,0,1,"dummy"
"72527",1,4,0,5,"dummy"
"72528",7,1,0,8,"dummy"
"72529",1,7,0,8,"dummy"
"72530",5,1,0,6,"dummy"
"72531",0,3,0,3,"dummy"
"72532",0,1,0,1,"dummy"
"72533",0,0,1,1,"dummy"
"72534",0,1,0,1,"dummy"
"72535",0,1,0,1,"dummy"
"72536",0,2,0,2,"dummy"
"72537",0,0,1,1,"dummy"
"72538",5,4,1,10,"dummy"
"72547",0,1,0,1,"dummy"
"72583",0,1,0,1,"dummy"
"72584",0,1,0,1,"dummy"
"72585",0,0,1,1,"dummy"
"72586",0,4,0,4,"dummy"
"72587",0,0,1,1,"dummy"
"72495",0,5,0,5,"dummy"
"72496",0,3,0,3,"dummy"
"72497",4,7,0,11,"dummy"
"72498",0,2,0,2,"dummy"
"72499",1,0,0,1,"dummy"
"72500",4,1,1,6,"dummy"
"72501",5,0,0,5,"dummy"
"72502",0,2,0,2,"dummy"
"72503",10,4,1,15,"dummy"
"72504",1,0,0,1,"dummy"
"72520",0,3,0,3,"dummy"
"72521",0,0,1,1,"dummy"
"72549",0,5,0,5,"dummy"
"72550",1,1,1,3,"dummy"
"72551",0,4,0,4,"dummy"
"72552",1,0,0,1,"dummy"
"72553",1,2,1,4,"dummy"
"72554",0,0,0,0,"dummy"
"72555",0,2,0,2,"dummy"
"72556",0,2,1,3,"dummy"
"72557",0,2,0,2,"dummy"
"72558",0,0,1,1,"dummy"
"72559",2,0,1,3,"dummy"
"72560",1,0,0,1,"dummy"
"72561",1,0,0,1,"dummy"
"72562",0,12,1,13,"dummy"
"72563",1,0,1,2,"dummy"
"72564",11,0,1,12,"dummy"
"72565",0,0,1,1,"dummy"
"72566",0,5,1,6,"dummy"
"72567",0,2,0,2,"dummy"
"72568",0,0,1,1,"dummy"
"72569",0,0,0,0,"dummy"
"72570",0,1,0,1,"dummy"
"72571",0,1,0,1,"dummy"
"72572",0,1,0,1,"dummy"
"72573",0,3,0,3,"dummy"
"72574",0,1,0,1,"dummy"
"72575",2,0,1,3,"dummy"
"72576",8,1,1,10,"dummy"
"72577",0,0,1,1,"dummy"
"72598",10,25,10,45,"dummy"
"72611",0,0,1,1,"dummy"
"72628",0,2,0,2,"dummy"
"72629",0,1,0,1,"dummy"
"72636",0,0,4,4,"dummy"
"72637",0,1,0,1,"dummy"
"72638",0,1,0,1,"dummy"
"72639",0,2,0,2,"dummy"
"72640",1,0,0,1,"dummy"
"72646",0,0,0,0,"dummy"
"72647",2,0,0,2,"dummy"
"72648",2,0,0,2,"dummy"
"72649",0,0,0,0,"dummy"
"72650",0,0,1,1,"dummy"
"72651",0,0,1,1,"dummy"
"72652",1,0,0,1,"dummy"
"72662",0,1,0,1,"dummy"
"72663",4,4,0,8,"dummy"
"72664",0,2,0,2,"dummy"
"72665",0,1,0,1,"dummy"
"72673",0,0,0,0,"dummy"
"72674",0,0,0,0,"dummy"
"72710",0,0,1,1,"dummy"
"72711",1,0,0,1,"dummy"
"72712",0,0,2,2,"dummy"
"72740",0,1,0,1,"dummy"
"72741",0,1,0,1,"dummy"
"72742",0,0,1,1,"dummy"
"72743",0,0,1,1,"dummy"
"72744",0,0,1,1,"dummy"
"72745",0,0,1,1,"dummy"
"72746",0,0,1,1,"dummy"
"72747",9,10,3,22,"dummy"
"72748",0,0,1,1,"dummy"
"72588",0,1,1,2,"dummy"
"72589",0,1,1,2,"dummy"
"72590",0,1,0,1,"dummy"
"72591",0,1,1,2,"dummy"
"72592",0,0,2,2,"dummy"
"72593",6,1,2,9,"dummy"
"72594",1,3,1,5,"dummy"
"72602",1,8,1,10,"dummy"
"72603",0,0,2,2,"dummy"
"72606",4,18,2,24,"dummy"
"72609",3,4,0,7,"dummy"
"72613",0,4,0,4,"dummy"
"72614",0,0,1,1,"dummy"
"72623",4,16,9,29,"dummy"
"72626",1,0,0,1,"dummy"
"72644",2,0,3,5,"dummy"
"72656",3,3,4,10,"dummy"
"72657",3,0,1,4,"dummy"
"72658",0,0,1,1,"dummy"
"72667",6,0,0,6,"dummy"
"72668",2,5,2,9,"dummy"
"72671",0,0,0,0,"dummy"
"72716",0,0,1,1,"dummy"
"72717",1,10,0,11,"dummy"
"72718",0,1,0,1,"dummy"
"72719",2,2,2,6,"dummy"
"72720",5,13,1,19,"dummy"
"72721",2,1,0,3,"dummy"
"72722",0,11,0,11,"dummy"
"72723",3,2,0,5,"dummy"
"72724",0,0,1,1,"dummy"
"72725",1,2,0,3,"dummy"
"72726",0,1,0,1,"dummy"
"72727",2,3,0,5,"dummy"
"72728",0,0,1,1,"dummy"
"72729",0,0,1,1,"dummy"
"72730",0,0,1,1,"dummy"
"72731",2,2,1,5,"dummy"
"72732",1,1,0,2,"dummy"
"72733",0,1,1,2,"dummy"
"72734",12,6,2,20,"dummy"
"72735",1,2,0,3,"dummy"
"72736",1,2,0,3,"dummy"
"72737",0,2,0,2,"dummy"
"72738",0,0,0,0,"dummy"
"72750",0,0,1,1,"dummy"
"72753",3,0,2,5,"dummy"
"72756",0,0,1,1,"dummy"
"72757",11,16,3,30,"dummy"
"72758",13,15,1,29,"dummy"
"72764",1,10,1,12,"dummy"
"72775",0,2,1,3,"dummy"
"72776",2,0,1,3,"dummy"
"72777",0,3,0,3,"dummy"
"72778",1,0,0,1,"dummy"
"72779",0,0,1,1,"dummy"
"72782",0,2,0,2,"dummy"
"72783",0,2,0,2,"dummy"
"72784",1,0,0,1,"dummy"
"72785",1,8,1,10,"dummy"
"72786",2,2,0,4,"dummy"
"72787",1,0,0,1,"dummy"
"72824",0,18,0,18,"dummy"
"72825",0,0,0,0,"dummy"
"72826",0,0,0,0,"dummy"
"72827",0,0,0,0,"dummy"
"72830",0,0,0,0,"dummy"
"72831",0,0,0,0,"dummy"
"72832",0,0,0,0,"dummy"
"72833",0,0,0,0,"dummy"
"72834",0,0,0,0,"dummy"
"72835",0,0,0,0,"dummy"
"72762",0,0,3,3,"dummy"
"72766",0,1,0,1,"dummy"
"72769",0,4,0,4,"dummy"
"72789",0,0,0,0,"dummy"
"72790",0,2,0,2,"dummy"
"72791",0,0,0,0,"dummy"
"72792",0,0,1,1,"dummy"
"72797",1,2,3,6,"dummy"
"72798",4,2,2,8,"dummy"
"72799",0,0,1,1,"dummy"
"72800",0,0,1,1,"dummy"
"72801",2,4,2,8,"dummy"
"72804",0,0,0,0,"dummy"
"72805",1,0,0,1,"dummy"
"72806",0,0,0,0,"dummy"
"72807",0,0,1,1,"dummy"
"72808",0,0,0,0,"dummy"
"72809",0,0,0,0,"dummy"
"72810",0,0,0,0,"dummy"
"72811",0,0,0,0,"dummy"
"72812",0,0,1,1,"dummy"
"72813",0,1,0,1,"dummy"
"72814",0,1,0,1,"dummy"
"72815",0,0,1,1,"dummy"
"72816",1,0,0,1,"dummy"
"72819",0,2,2,4,"dummy"
"72820",0,2,0,2,"dummy"
"72821",0,2,1,3,"dummy"
"72822",0,0,2,2,"dummy"
"72837",0,0,0,0,"dummy"
"72838",0,0,0,0,"dummy"
"72843",0,1,0,1,"dummy"
"72847",0,16,0,16,"dummy"
"72849",0,1,0,1,"dummy"
"72850",1,1,0,2,"dummy"
"72853",1,5,0,6,"dummy"
"72858",0,1,0,1,"dummy"
"72861",0,1,0,1,"dummy"
"72862",0,7,0,7,"dummy"
"72863",0,1,0,1,"dummy"
"72864",0,1,0,1,"dummy"
"72865",0,1,0,1,"dummy"
"72867",1,1,4,6,"dummy"
"72868",1,1,2,4,"dummy"
"72869",1,0,1,2,"dummy"
"72870",0,1,2,3,"dummy"
"72872",6,9,3,18,"dummy"
"72873",0,1,0,1,"dummy"
"72874",3,0,0,3,"dummy"
"72875",0,1,0,1,"dummy"
"72876",0,2,0,2,"dummy"
"72877",5,0,3,8,"dummy"
"72878",4,0,0,4,"dummy"
"72884",1,2,0,3,"dummy"
"72885",0,0,1,1,"dummy"
"72886",0,0,1,1,"dummy"
"72893",3,7,0,10,"dummy"
"72894",0,0,0,0,"dummy"
"72907",0,0,1,1,"dummy"
"72910",0,2,0,2,"dummy"
"72911",0,0,1,1,"dummy"
"72915",0,2,3,5,"dummy"
"72920",0,0,1,1,"dummy"
"72921",0,0,2,2,"dummy"
"72927",0,0,0,0,"dummy"
"72928",0,0,1,1,"dummy"
"72929",0,3,0,3,"dummy"
"72930",0,2,0,2,"dummy"
"72931",0,0,0,0,"dummy"
"72932",0,2,0,2,"dummy"
"72933",0,0,1,1,"dummy"
"72934",0,1,0,1,"dummy"
"72940",1,6,2,9,"dummy"
"72942",8,5,3,16,"dummy"
"72943",3,19,1,23,"dummy"
"72944",0,4,2,6,"dummy"
"72945",3,3,0,6,"dummy"
"72946",4,3,2,9,"dummy"
"72947",0,0,5,5,"dummy"
"72948",0,2,0,2,"dummy"
"72949",10,7,2,19,"dummy"
"72950",2,0,0,2,"dummy"
"72951",13,0,2,15,"dummy"
"72953",0,0,1,1,"dummy"
"72955",0,5,0,5,"dummy"
"72957",0,1,0,1,"dummy"
"72959",0,2,0,2,"dummy"
"72960",0,0,1,1,"dummy"
"72962",0,4,0,4,"dummy"
"72963",0,2,0,2,"dummy"
"72964",2,0,0,2,"dummy"
"72965",0,2,0,2,"dummy"
"72966",8,5,0,13,"dummy"
"72967",3,1,1,5,"dummy"
"72995",1,1,0,2,"dummy"
"72996",2,0,0,2,"dummy"
"72997",0,0,1,1,"dummy"
"73001",0,0,0,0,"dummy"
"73003",0,0,1,1,"dummy"
"73006",1,0,0,1,"dummy"
"73007",0,1,2,3,"dummy"
"73008",0,0,1,1,"dummy"
"73009",2,1,0,3,"dummy"
"73010",0,2,0,2,"dummy"
"73011",0,4,0,4,"dummy"
"73012",0,2,0,2,"dummy"
"73013",0,0,1,1,"dummy"
"73014",0,0,4,4,"dummy"
"73015",0,0,0,0,"dummy"
"73016",1,2,0,3,"dummy"
"73017",1,7,0,8,"dummy"
"73018",0,2,0,2,"dummy"
"73024",0,0,1,1,"dummy"
"73025",2,1,0,3,"dummy"
"73032",0,1,0,1,"dummy"
"73033",0,0,0,0,"dummy"
"73034",0,1,0,1,"dummy"
"73035",0,1,0,1,"dummy"
"73036",0,4,0,4,"dummy"
"73037",4,1,0,5,"dummy"
"73038",0,2,4,6,"dummy"
"73039",3,0,0,3,"dummy"
"73040",0,2,0,2,"dummy"
"73041",3,0,0,3,"dummy"
"73044",0,0,0,0,"dummy"
"73045",0,0,0,0,"dummy"
"73046",0,0,0,0,"dummy"
"73047",0,7,0,7,"dummy"
"73048",0,0,0,0,"dummy"
"73052",0,0,1,1,"dummy"
"73056",0,10,1,11,"dummy"
"73057",0,8,0,8,"dummy"
"73061",0,5,0,5,"dummy"
"73062",0,1,0,1,"dummy"
"73063",5,0,0,5,"dummy"
"73064",1,0,1,2,"dummy"
"73065",0,1,0,1,"dummy"
"73071",0,23,1,24,"dummy"
"73072",0,1,0,1,"dummy"
"73074",0,0,0,0,"dummy"
"73075",1,0,1,2,"dummy"
"73077",0,0,1,1,"dummy"
"73078",0,0,1,1,"dummy"
"73079",1,0,0,1,"dummy"
"73080",0,0,3,3,"dummy"
"73083",0,1,0,1,"dummy"
"73084",1,0,0,1,"dummy"
"73085",0,3,1,4,"dummy"
"73086",4,0,0,4,"dummy"
"73087",0,4,0,4,"dummy"
"73088",0,1,0,1,"dummy"
"73089",0,1,0,1,"dummy"
"73091",2,0,3,5,"dummy"
"73097",2,4,2,8,"dummy"
"73098",0,1,0,1,"dummy"
"73099",0,4,0,4,"dummy"
"73100",0,1,0,1,"dummy"
"73101",0,1,0,1,"dummy"
"73102",22,0,0,22,"dummy"
"73103",0,9,0,9,"dummy"
"73104",10,6,1,17,"dummy"
"73105",19,30,0,49,"dummy"
"73106",20,18,1,39,"dummy"
"73107",1,0,1,2,"dummy"
"73108",1,9,0,10,"dummy"
"73109",4,6,1,11,"dummy"
"73110",0,1,2,3,"dummy"
"73112",0,0,1,1,"dummy"
"73116",0,1,0,1,"dummy"
"73117",0,0,1,1,"dummy"
"73118",0,0,2,2,"dummy"
"73119",9,3,2,14,"dummy"
"73120",2,4,1,7,"dummy"
"73121",0,0,1,1,"dummy"
"73123",0,16,0,16,"dummy"
"73124",2,1,0,3,"dummy"
"73126",0,0,0,0,"dummy"
"73127",0,0,0,0,"dummy"
"73128",0,0,1,1,"dummy"
"73134",1,2,0,3,"dummy"
"73135",26,57,3,86,"dummy"
"73136",2,0,0,2,"dummy"
"73137",7,4,2,13,"dummy"
"73138",0,0,0,0,"dummy"
"73139",9,0,0,9,"dummy"
"73140",13,4,0,17,"dummy"
"73142",0,0,1,1,"dummy"
"73143",0,0,2,2,"dummy"
"73144",2,0,1,3,"dummy"
"73145",0,4,1,5,"dummy"
"73146",0,0,1,1,"dummy"
"73147",3,1,0,4,"dummy"
"73148",1,0,1,2,"dummy"
"73195",0,0,1,1,"dummy"
"73196",1,1,0,2,"dummy"
"73201",10,0,1,11,"dummy"
"73202",0,0,1,1,"dummy"
"73203",0,0,1,1,"dummy"
"73205",0,0,0,0,"dummy"
"73206",0,6,0,6,"dummy"
"73207",3,2,1,6,"dummy"
"73208",1,0,0,1,"dummy"
"73209",0,0,1,1,"dummy"
"73210",0,5,0,5,"dummy"
"73211",0,2,0,2,"dummy"
"73212",0,2,3,5,"dummy"
"73213",0,3,0,3,"dummy"
"73214",0,0,0,0,"dummy"
"73215",0,1,2,3,"dummy"
"73216",2,12,1,15,"dummy"
"73217",0,0,1,1,"dummy"
"73218",6,0,0,6,"dummy"
"73219",5,1,2,8,"dummy"
"73224",1,3,1,5,"dummy"
"73226",0,0,1,1,"dummy"
"73227",1,3,2,6,"dummy"
"73228",0,0,1,1,"dummy"
"73229",0,7,0,7,"dummy"
"73233",4,0,1,5,"dummy"
"73234",0,10,0,10,"dummy"
"73238",0,1,0,1,"dummy"
"73239",0,4,1,5,"dummy"
"73241",0,0,3,3,"dummy"
"73243",0,0,1,1,"dummy"
"73244",0,0,1,1,"dummy"
"73245",0,0,1,1,"dummy"
"73246",0,0,1,1,"dummy"
"73248",0,1,0,1,"dummy"
"73250",0,2,0,2,"dummy"
"73251",0,0,0,0,"dummy"
"73252",0,0,0,0,"dummy"
"73253",0,11,0,11,"dummy"
"73254",0,0,2,2,"dummy"
"73255",0,0,2,2,"dummy"
"73256",9,24,3,36,"dummy"
"73257",1,1,0,2,"dummy"
"73258",0,1,0,1,"dummy"
"73259",7,0,0,7,"dummy"
"73260",0,0,1,1,"dummy"
"73261",0,0,2,2,"dummy"
"73262",0,0,0,0,"dummy"
"73263",0,0,0,0,"dummy"
"73264",0,2,0,2,"dummy"
"73265",0,0,0,0,"dummy"
"73266",0,0,2,2,"dummy"
"73267",0,0,1,1,"dummy"
"73270",12,1,1,14,"dummy"
"73271",0,1,0,1,"dummy"
"73272",2,2,0,4,"dummy"
"73273",2,1,0,3,"dummy"
"73274",1,0,1,2,"dummy"
"73276",0,0,3,3,"dummy"
"73277",0,0,3,3,"dummy"
"73280",2,3,3,8,"dummy"
"73281",0,4,2,6,"dummy"
"73282",0,0,1,1,"dummy"
"73283",0,1,0,1,"dummy"
"73284",0,0,1,1,"dummy"
"73285",0,1,0,1,"dummy"
"73287",0,2,0,2,"dummy"
"73288",2,0,0,2,"dummy"
"73291",0,1,1,2,"dummy"
"73292",0,2,1,3,"dummy"
"73293",0,2,0,2,"dummy"
"73295",0,1,1,2,"dummy"
"73296",6,4,0,10,"dummy"
"73297",0,2,0,2,"dummy"
"73298",9,8,0,17,"dummy"
"73317",1,0,0,1,"dummy"
"73319",0,3,2,5,"dummy"
"73320",0,0,1,1,"dummy"
"73322",3,1,2,6,"dummy"
"73323",0,0,1,1,"dummy"
"73339",0,1,1,2,"dummy"
"73341",2,4,0,6,"dummy"
"73342",0,2,0,2,"dummy"
"73343",0,2,0,2,"dummy"
"73344",10,2,0,12,"dummy"
"73345",0,2,0,2,"dummy"
"73347",1,0,0,1,"dummy"
"73354",0,0,2,2,"dummy"
"73355",2,5,0,7,"dummy"
"73372",0,0,1,1,"dummy"
"73373",0,0,1,1,"dummy"
"73374",0,2,0,2,"dummy"
"73375",3,3,0,6,"dummy"
"73379",1,2,0,3,"dummy"
"73380",0,3,0,3,"dummy"
"73382",6,11,0,17,"dummy"
"73383",0,1,0,1,"dummy"
"73385",0,1,0,1,"dummy"
"73386",0,0,1,1,"dummy"
"73387",0,1,0,1,"dummy"
"73388",0,0,2,2,"dummy"
"73389",0,1,0,1,"dummy"
"73390",0,0,1,1,"dummy"
"73395",0,1,0,1,"dummy"
"73396",0,1,0,1,"dummy"
"73397",1,4,0,5,"dummy"
"73399",0,2,0,2,"dummy"
"73400",0,1,2,3,"dummy"
"73401",0,8,1,9,"dummy"
"73402",0,2,0,2,"dummy"
"73403",2,0,0,2,"dummy"
"73404",0,2,0,2,"dummy"
"73405",0,2,0,2,"dummy"
"73406",0,1,0,1,"dummy"
"73407",1,0,0,1,"dummy"
"73408",12,4,1,17,"dummy"
"73409",0,0,4,4,"dummy"
"73410",2,8,2,12,"dummy"
"73411",1,0,0,1,"dummy"
"73412",0,0,0,0,"dummy"
"73413",1,1,0,2,"dummy"
"73414",1,0,0,1,"dummy"
"73415",0,0,4,4,"dummy"
"73416",0,0,4,4,"dummy"
"73417",0,0,4,4,"dummy"
"73418",0,0,4,4,"dummy"
"73419",0,2,0,2,"dummy"
"73420",0,0,4,4,"dummy"
"73421",0,0,1,1,"dummy"
"73422",0,1,5,6,"dummy"
"73423",0,0,1,1,"dummy"
"73424",0,0,1,1,"dummy"
"73425",0,0,2,2,"dummy"
"73426",0,0,1,1,"dummy"
"73427",0,0,2,2,"dummy"
"73428",0,0,1,1,"dummy"
"73429",0,0,1,1,"dummy"
"73430",0,0,1,1,"dummy"
"73431",0,3,0,3,"dummy"
"73432",3,5,1,9,"dummy"
"73433",0,2,0,2,"dummy"
"73434",0,1,0,1,"dummy"
"73435",0,1,0,1,"dummy"
"73436",0,1,0,1,"dummy"
"73437",1,0,0,1,"dummy"
"73438",23,1,6,30,"dummy"
"73439",0,1,0,1,"dummy"
"73442",0,0,1,1,"dummy"
"73444",0,1,0,1,"dummy"
"73456",0,1,2,3,"dummy"
"73457",0,0,0,0,"dummy"
"73458",0,2,0,2,"dummy"
"73459",5,0,2,7,"dummy"
"73460",1,0,0,1,"dummy"
"73463",2,6,3,11,"dummy"
"73464",0,0,1,1,"dummy"
"73465",0,0,1,1,"dummy"
"73466",2,2,0,4,"dummy"
"73468",0,0,1,1,"dummy"
"73469",0,0,1,1,"dummy"
"73470",0,0,1,1,"dummy"
"73471",0,0,1,1,"dummy"
"73472",0,0,1,1,"dummy"
"73474",0,0,1,1,"dummy"
"73475",1,0,0,1,"dummy"
"73476",0,1,0,1,"dummy"
"73477",0,0,0,0,"dummy"
"73478",0,2,0,2,"dummy"
"73479",0,0,0,0,"dummy"
"73480",0,0,0,0,"dummy"
"73481",0,0,0,0,"dummy"
"73483",0,0,1,1,"dummy"
"73484",0,2,0,2,"dummy"
"73485",0,3,0,3,"dummy"
"73486",0,1,0,1,"dummy"
"73487",3,3,0,6,"dummy"
"73489",2,0,0,2,"dummy"
"73492",0,1,0,1,"dummy"
"73493",0,1,0,1,"dummy"
"73494",0,0,1,1,"dummy"
"73495",0,0,3,3,"dummy"
"73496",0,0,1,1,"dummy"
"73497",0,1,1,2,"dummy"
"73498",0,0,2,2,"dummy"
"73499",0,0,1,1,"dummy"
"73500",0,0,1,1,"dummy"
"73501",0,0,1,1,"dummy"
"73502",3,9,3,15,"dummy"
"73503",0,0,1,1,"dummy"
"73504",0,0,1,1,"dummy"
"73505",0,0,1,1,"dummy"
"73506",0,0,1,1,"dummy"
"73507",0,0,1,1,"dummy"
"73508",0,0,2,2,"dummy"
"73509",0,0,1,1,"dummy"
"73512",1,2,2,5,"dummy"
"73514",0,2,0,2,"dummy"
"73519",1,1,3,5,"dummy"
"73520",0,0,1,1,"dummy"
"73522",0,3,0,3,"dummy"
"73523",4,0,5,9,"dummy"
"73525",0,0,1,1,"dummy"
"73535",0,2,0,2,"dummy"
"73536",0,0,3,3,"dummy"
"73537",0,2,0,2,"dummy"
"73538",0,4,0,4,"dummy"
"73539",3,1,0,4,"dummy"
"73540",1,0,0,1,"dummy"
"73541",0,1,0,1,"dummy"
"73543",7,7,1,15,"dummy"
"73551",0,3,0,3,"dummy"
"73553",0,0,4,4,"dummy"
"73555",1,7,0,8,"dummy"
"73556",5,0,1,6,"dummy"
"73557",3,1,1,5,"dummy"
"73558",0,0,0,0,"dummy"
"73559",1,1,0,2,"dummy"
"73560",0,1,0,1,"dummy"
"73561",0,1,1,2,"dummy"
"73562",1,2,1,4,"dummy"
"73563",0,1,0,1,"dummy"
"73566",1,9,0,10,"dummy"
"73567",2,4,1,7,"dummy"
"73575",0,0,0,0,"dummy"
"73576",0,0,2,2,"dummy"
"73577",0,0,1,1,"dummy"
"73578",0,0,0,0,"dummy"
"73580",0,0,0,0,"dummy"
"73583",2,1,4,7,"dummy"
"73584",1,0,0,1,"dummy"
"73585",0,2,0,2,"dummy"
"73586",2,0,0,2,"dummy"
"73587",1,3,2,6,"dummy"
"73588",0,5,3,8,"dummy"
"73589",0,0,0,0,"dummy"
"73590",0,1,0,1,"dummy"
"73591",0,2,1,3,"dummy"
"73593",2,5,2,9,"dummy"
"73594",0,0,2,2,"dummy"
"73597",3,1,0,4,"dummy"
"73598",0,4,0,4,"dummy"
"73599",0,0,1,1,"dummy"
"73600",0,2,0,2,"dummy"
"73601",0,0,1,1,"dummy"
"73602",0,1,0,1,"dummy"
"73603",32,10,0,42,"dummy"
"73604",1,0,0,1,"dummy"
"73605",14,11,2,27,"dummy"
"73606",0,1,0,1,"dummy"
"73607",0,4,0,4,"dummy"
"73608",0,0,1,1,"dummy"
"73610",5,2,1,8,"dummy"
"73611",1,0,0,1,"dummy"
"73613",3,3,2,8,"dummy"
"73615",0,0,0,0,"dummy"
"73622",13,0,2,15,"dummy"
"73623",2,3,0,5,"dummy"
"73624",0,4,0,4,"dummy"
"73625",1,0,0,1,"dummy"
"73626",4,2,1,7,"dummy"
"73627",0,0,0,0,"dummy"
"73628",3,1,0,4,"dummy"
"73629",0,0,1,1,"dummy"
"73630",0,3,1,4,"dummy"
"73631",0,0,0,0,"dummy"
"73632",0,0,1,1,"dummy"
"73634",0,2,0,2,"dummy"
"73635",2,0,0,2,"dummy"
"73636",0,2,0,2,"dummy"
"73637",0,0,0,0,"dummy"
"73638",0,0,1,1,"dummy"
"73639",0,0,0,0,"dummy"
"73640",0,0,2,2,"dummy"
"73644",0,1,0,1,"dummy"
"73647",2,4,0,6,"dummy"
"73648",0,2,0,2,"dummy"
"73649",0,2,0,2,"dummy"
"73650",10,2,0,12,"dummy"
"73651",0,2,0,2,"dummy"
"73652",0,0,0,0,"dummy"
"73653",0,0,3,3,"dummy"
"73654",0,5,0,5,"dummy"
"73655",1,0,1,2,"dummy"
"73663",0,0,0,0,"dummy"
"73664",0,0,2,2,"dummy"
"73665",0,0,2,2,"dummy"
"73670",1,1,0,2,"dummy"
"73671",1,8,2,11,"dummy"
"73674",0,7,2,9,"dummy"
"73675",0,0,1,1,"dummy"
"73676",0,0,1,1,"dummy"
"73677",1,0,0,1,"dummy"
"73679",1,2,2,5,"dummy"
"73680",0,1,0,1,"dummy"
"73681",0,1,0,1,"dummy"
"73684",0,0,1,1,"dummy"
"73685",0,0,1,1,"dummy"
"73686",0,0,2,2,"dummy"
"73690",2,2,0,4,"dummy"
"73691",0,0,1,1,"dummy"
"73693",0,1,0,1,"dummy"
"73695",2,0,2,4,"dummy"
"73696",1,3,0,4,"dummy"
"73697",3,1,0,4,"dummy"
"73698",0,0,2,2,"dummy"
"73702",0,1,0,1,"dummy"
"73703",7,7,3,17,"dummy"
"73706",0,0,0,0,"dummy"
"73707",0,1,0,1,"dummy"
"73708",0,0,2,2,"dummy"
"73709",0,0,1,1,"dummy"
"73711",0,1,0,1,"dummy"
"73719",0,0,1,1,"dummy"
"73720",0,0,1,1,"dummy"
"73721",0,0,1,1,"dummy"
"73722",0,0,1,1,"dummy"
"73723",0,0,1,1,"dummy"
"73724",1,1,2,4,"dummy"
"73725",0,0,1,1,"dummy"
"73726",1,0,1,2,"dummy"
"73730",0,0,1,1,"dummy"
"73731",0,2,1,3,"dummy"
"73734",5,2,0,7,"dummy"
"73740",0,0,0,0,"dummy"
"73742",0,0,0,0,"dummy"
"73743",0,0,0,0,"dummy"
"73748",0,7,0,7,"dummy"
"73751",0,0,0,0,"dummy"
"73752",5,26,1,32,"dummy"
"73753",0,0,1,1,"dummy"
"73768",0,2,1,3,"dummy"
"73769",3,1,1,5,"dummy"
"73771",0,0,1,1,"dummy"
"73774",1,0,0,1,"dummy"
"73775",0,0,1,1,"dummy"
"73776",1,1,0,2,"dummy"
"73777",0,0,1,1,"dummy"
"73778",0,0,0,0,"dummy"
"73779",0,0,0,0,"dummy"
"73780",0,0,0,0,"dummy"
"73782",0,1,1,2,"dummy"
"73783",0,1,0,1,"dummy"
"73784",0,1,0,1,"dummy"
"73786",2,0,0,2,"dummy"
"73791",6,2,1,9,"dummy"
"73792",34,0,1,35,"dummy"
"73793",0,0,1,1,"dummy"
"73794",0,0,1,1,"dummy"
"73795",0,0,1,1,"dummy"
"73796",0,0,1,1,"dummy"
"73797",0,0,1,1,"dummy"
"73798",0,0,1,1,"dummy"
"73807",1,9,1,11,"dummy"
"73808",8,0,1,9,"dummy"
"73816",1,3,1,5,"dummy"
"73836",0,0,2,2,"dummy"
"73838",0,0,1,1,"dummy"
"73847",0,3,0,3,"dummy"
"73851",0,1,0,1,"dummy"
"73852",0,3,0,3,"dummy"
"73853",9,9,0,18,"dummy"
"73854",2,2,0,4,"dummy"
"73855",9,9,0,18,"dummy"
"73856",0,5,0,5,"dummy"
"73857",0,0,1,1,"dummy"
"73858",4,1,5,10,"dummy"
"73859",0,2,1,3,"dummy"
"73860",0,0,1,1,"dummy"
"73861",0,4,0,4,"dummy"
"73862",1,0,1,2,"dummy"
"73863",0,1,0,1,"dummy"
"73864",7,7,0,14,"dummy"
"73865",2,0,0,2,"dummy"
"73866",0,3,0,3,"dummy"
"73867",8,2,0,10,"dummy"
"73868",0,1,0,1,"dummy"
"73869",2,3,0,5,"dummy"
"73870",0,0,1,1,"dummy"
"73871",0,0,0,0,"dummy"
"73872",0,0,0,0,"dummy"
"73874",2,0,0,2,"dummy"
"73875",0,0,0,0,"dummy"
"73878",1,0,1,2,"dummy"
"73882",3,17,0,20,"dummy"
"73885",0,3,0,3,"dummy"
"73886",1,0,2,3,"dummy"
"73887",0,1,0,1,"dummy"
"73890",0,2,0,2,"dummy"
"73892",0,3,2,5,"dummy"
"73893",3,10,0,13,"dummy"
"73894",0,0,3,3,"dummy"
"73895",0,2,0,2,"dummy"
"73896",2,7,0,9,"dummy"
"73897",0,0,1,1,"dummy"
"73898",0,0,1,1,"dummy"
"73899",0,0,2,2,"dummy"
"73900",0,0,2,2,"dummy"
"73901",1,0,1,2,"dummy"
"73902",0,0,2,2,"dummy"
"73903",5,1,0,6,"dummy"
"73904",0,0,2,2,"dummy"
"73905",0,0,3,3,"dummy"
"73906",0,0,2,2,"dummy"
"73907",0,0,2,2,"dummy"
"73908",0,0,2,2,"dummy"
"73911",2,3,0,5,"dummy"
"73912",0,1,0,1,"dummy"
"73915",0,1,0,1,"dummy"
"73916",0,1,0,1,"dummy"
"73917",0,0,0,0,"dummy"
"73919",0,0,1,1,"dummy"
"73920",0,1,0,1,"dummy"
"73921",0,0,1,1,"dummy"
"73922",0,0,1,1,"dummy"
"73923",0,0,1,1,"dummy"
"73925",1,7,2,10,"dummy"
"73933",0,2,0,2,"dummy"
"73941",0,1,0,1,"dummy"
"73954",0,1,0,1,"dummy"
"73956",1,1,1,3,"dummy"
"73961",17,21,4,42,"dummy"
"73962",0,1,0,1,"dummy"
"73964",0,0,1,1,"dummy"
"73965",0,1,0,1,"dummy"
"73966",0,1,0,1,"dummy"
"73969",0,2,1,3,"dummy"
"73971",0,1,0,1,"dummy"
"73973",0,0,1,1,"dummy"
"73976",0,1,0,1,"dummy"
"73977",0,0,0,0,"dummy"
"73978",0,3,0,3,"dummy"
"73979",0,0,0,0,"dummy"
"73980",0,0,1,1,"dummy"
"73981",0,2,0,2,"dummy"
"73982",0,0,0,0,"dummy"
"73983",0,1,0,1,"dummy"
"73984",0,2,0,2,"dummy"
"73985",0,0,1,1,"dummy"
"73986",1,0,0,1,"dummy"
"73987",0,1,0,1,"dummy"
"73988",0,2,0,2,"dummy"
"73990",0,0,2,2,"dummy"
"73991",0,0,2,2,"dummy"
"73992",0,0,1,1,"dummy"
"73993",0,0,2,2,"dummy"
"73994",0,0,2,2,"dummy"
"73995",0,0,2,2,"dummy"
"73996",0,0,1,1,"dummy"
"73997",0,0,2,2,"dummy"
"73998",0,0,2,2,"dummy"
"73999",0,0,2,2,"dummy"
"74000",0,0,2,2,"dummy"
"74001",0,0,1,1,"dummy"
"74002",0,0,2,2,"dummy"
"74003",0,0,1,1,"dummy"
"74004",0,0,1,1,"dummy"
"74005",0,0,1,1,"dummy"
"74006",0,0,1,1,"dummy"
"74007",1,1,0,2,"dummy"
"74008",0,0,2,2,"dummy"
"74009",0,0,1,1,"dummy"
"74010",6,3,0,9,"dummy"
"74011",0,0,1,1,"dummy"
"74012",3,6,0,9,"dummy"
"74013",0,0,1,1,"dummy"
"74014",0,0,1,1,"dummy"
"74015",0,1,2,3,"dummy"
"74016",0,0,1,1,"dummy"
"74017",0,0,1,1,"dummy"
"74018",0,0,2,2,"dummy"
"74019",0,0,2,2,"dummy"
"74020",0,0,2,2,"dummy"
"74021",0,0,1,1,"dummy"
"74022",0,0,2,2,"dummy"
"74023",0,0,1,1,"dummy"
"74024",0,0,1,1,"dummy"
"74025",0,0,1,1,"dummy"
"74026",0,0,1,1,"dummy"
"74027",0,0,2,2,"dummy"
"74028",0,0,1,1,"dummy"
"74029",0,0,1,1,"dummy"
"74030",0,0,1,1,"dummy"
"74031",0,0,1,1,"dummy"
"74032",0,0,1,1,"dummy"
"74033",0,0,1,1,"dummy"
"74034",0,0,2,2,"dummy"
"74035",1,7,2,10,"dummy"
"74036",1,0,0,1,"dummy"
"74037",0,0,1,1,"dummy"
"74038",0,0,1,1,"dummy"
"74039",0,0,1,1,"dummy"
"74040",0,0,1,1,"dummy"
"74041",0,0,1,1,"dummy"
"74042",0,0,1,1,"dummy"
"74043",0,0,1,1,"dummy"
"74044",0,0,1,1,"dummy"
"74045",0,0,1,1,"dummy"
"74046",0,0,1,1,"dummy"
"74047",0,0,1,1,"dummy"
"74048",0,0,1,1,"dummy"
"74049",0,0,1,1,"dummy"
"74050",0,0,1,1,"dummy"
"74051",0,0,1,1,"dummy"
"74052",0,0,1,1,"dummy"
"74053",0,0,1,1,"dummy"
"74054",0,0,1,1,"dummy"
"74055",0,0,1,1,"dummy"
"74056",0,0,1,1,"dummy"
"74057",0,0,1,1,"dummy"
"74058",0,0,1,1,"dummy"
"74059",0,0,1,1,"dummy"
"74060",2,2,1,5,"dummy"
"74061",0,0,1,1,"dummy"
"74062",0,0,1,1,"dummy"
"74063",0,0,1,1,"dummy"
"74064",0,0,1,1,"dummy"
"74065",0,0,1,1,"dummy"
"74066",0,0,1,1,"dummy"
"74067",0,0,1,1,"dummy"
"74068",0,0,1,1,"dummy"
"74069",0,0,1,1,"dummy"
"74070",0,0,1,1,"dummy"
"74071",0,0,1,1,"dummy"
"74072",0,0,1,1,"dummy"
"74073",0,0,1,1,"dummy"
"74074",0,0,1,1,"dummy"
"74075",0,0,1,1,"dummy"
"74076",0,0,1,1,"dummy"
"74077",0,0,1,1,"dummy"
"74078",0,0,1,1,"dummy"
"74079",0,0,1,1,"dummy"
"74080",0,0,1,1,"dummy"
"74081",0,0,1,1,"dummy"
"74082",0,0,1,1,"dummy"
"74083",0,0,1,1,"dummy"
"74084",0,0,1,1,"dummy"
"74085",0,0,1,1,"dummy"
"74086",0,0,1,1,"dummy"
"74087",0,0,1,1,"dummy"
"74088",0,0,1,1,"dummy"
"74089",0,0,1,1,"dummy"
"74090",0,0,1,1,"dummy"
"74095",0,2,0,2,"dummy"
"74096",0,4,0,4,"dummy"
"74098",0,0,0,0,"dummy"
"74099",0,0,0,0,"dummy"
"74100",0,0,0,0,"dummy"
"74102",6,7,2,15,"dummy"
"74104",0,1,0,1,"dummy"
"74106",2,8,0,10,"dummy"
"74107",0,0,1,1,"dummy"
"74108",0,0,1,1,"dummy"
"74109",1,7,3,11,"dummy"
"74111",1,1,0,2,"dummy"
"74112",1,0,0,1,"dummy"
"74114",0,1,0,1,"dummy"
"74115",0,1,0,1,"dummy"
"74116",0,4,0,4,"dummy"
"74118",0,0,0,0,"dummy"
"74119",0,3,0,3,"dummy"
"74120",0,0,1,1,"dummy"
"74121",0,2,0,2,"dummy"
"74122",0,0,1,1,"dummy"
"74123",0,2,0,2,"dummy"
"74124",0,2,0,2,"dummy"
"74125",0,2,0,2,"dummy"
"74126",0,0,0,0,"dummy"
"74127",4,1,0,5,"dummy"
"74128",1,0,0,1,"dummy"
"74129",3,0,0,3,"dummy"
"74130",0,0,0,0,"dummy"
"74131",0,1,0,1,"dummy"
"74132",0,0,0,0,"dummy"
"74133",0,0,0,0,"dummy"
"74134",0,0,0,0,"dummy"
"74135",1,0,0,1,"dummy"
"74136",0,0,0,0,"dummy"
"74169",0,2,1,3,"dummy"
"74170",2,1,0,3,"dummy"
"74171",0,0,1,1,"dummy"
"74172",0,3,0,3,"dummy"
"74176",1,1,0,2,"dummy"
"74178",0,1,0,1,"dummy"
"74180",0,2,0,2,"dummy"
"74183",7,3,3,13,"dummy"
"74184",0,1,0,1,"dummy"
"74185",0,0,0,0,"dummy"
"74186",0,4,0,4,"dummy"
"74187",2,1,0,3,"dummy"
"74199",0,0,1,1,"dummy"
"74200",0,0,1,1,"dummy"
"74209",9,16,1,26,"dummy"
"74210",0,1,0,1,"dummy"
"74211",19,10,5,34,"dummy"
"74216",0,2,0,2,"dummy"
"74217",0,1,3,4,"dummy"
"74218",0,0,3,3,"dummy"
"74219",2,2,0,4,"dummy"
"74220",0,3,0,3,"dummy"
"74223",0,14,0,14,"dummy"
"74226",0,0,0,0,"dummy"
"74227",0,0,1,1,"dummy"
"74229",0,5,2,7,"dummy"
"74230",0,2,0,2,"dummy"
"74236",0,0,1,1,"dummy"
"74239",0,1,0,1,"dummy"
"74242",0,0,1,1,"dummy"
"74243",0,0,1,1,"dummy"
"74248",19,14,2,35,"dummy"
"74249",14,18,3,35,"dummy"
"74251",1,3,0,4,"dummy"
"74252",2,4,0,6,"dummy"
"74253",1,1,0,2,"dummy"
"74254",0,4,1,5,"dummy"
"74255",0,0,1,1,"dummy"
"74256",10,0,4,14,"dummy"
"74257",5,7,1,13,"dummy"
"74258",1,0,0,1,"dummy"
"74259",9,9,0,18,"dummy"
"74260",5,0,0,5,"dummy"
"74261",1,0,0,1,"dummy"
"74263",9,0,1,10,"dummy"
"74264",0,9,0,9,"dummy"
"74265",1,5,0,6,"dummy"
"74266",0,1,0,1,"dummy"
"74267",3,19,0,22,"dummy"
"74268",25,1,0,26,"dummy"
"74269",1,1,0,2,"dummy"
"74271",2,10,0,12,"dummy"
"74272",1,12,1,14,"dummy"
"74273",27,24,5,56,"dummy"
"74274",2,3,0,5,"dummy"
"74277",0,1,1,2,"dummy"
"74278",0,0,1,1,"dummy"
"74279",0,0,1,1,"dummy"
"74280",0,0,0,0,"dummy"
"74282",0,0,0,0,"dummy"
"74283",0,1,0,1,"dummy"
"74286",0,0,0,0,"dummy"
"74287",0,2,0,2,"dummy"
"74288",0,2,0,2,"dummy"
"74290",1,2,0,3,"dummy"
"74293",0,0,1,1,"dummy"
"74294",2,0,0,2,"dummy"
"74295",0,1,0,1,"dummy"
"74296",7,25,0,32,"dummy"
"74297",0,2,0,2,"dummy"
"74298",2,6,0,8,"dummy"
"74300",1,0,0,1,"dummy"
"74301",0,1,1,2,"dummy"
"74302",0,0,1,1,"dummy"
"74303",0,0,1,1,"dummy"
"74306",0,28,0,28,"dummy"
"74307",15,12,6,33,"dummy"
"74308",1,2,0,3,"dummy"
"74310",0,0,1,1,"dummy"
"74311",0,0,1,1,"dummy"
"74312",0,0,1,1,"dummy"
"74313",0,0,1,1,"dummy"
"74315",0,3,0,3,"dummy"
"74318",0,2,0,2,"dummy"
"74354",0,2,0,2,"dummy"
"74355",0,1,0,1,"dummy"
"74356",0,1,1,2,"dummy"
"74358",2,0,1,3,"dummy"
"74382",8,19,4,31,"dummy"
"74384",0,1,0,1,"dummy"
"74385",1,1,0,2,"dummy"
"74386",10,1,2,13,"dummy"
"74387",1,0,1,2,"dummy"
"74388",0,0,1,1,"dummy"
"74389",0,0,1,1,"dummy"
"74391",1,0,0,1,"dummy"
"74392",0,1,1,2,"dummy"
"74393",0,0,1,1,"dummy"
"74395",2,4,0,6,"dummy"
"74396",0,2,0,2,"dummy"
"74397",0,2,0,2,"dummy"
"74398",10,2,0,12,"dummy"
"74399",0,2,0,2,"dummy"
"74403",0,0,0,0,"dummy"
"74404",0,0,0,0,"dummy"
"74405",0,0,1,1,"dummy"
"74406",3,2,0,5,"dummy"
"74407",0,3,1,4,"dummy"
"74408",0,3,1,4,"dummy"
"74409",0,5,0,5,"dummy"
"74410",0,0,1,1,"dummy"
"74411",2,0,2,4,"dummy"
"74412",0,2,0,2,"dummy"
"74413",0,0,0,0,"dummy"
"74414",0,4,0,4,"dummy"
"74415",0,0,2,2,"dummy"
"74416",8,0,0,8,"dummy"
"74417",0,0,0,0,"dummy"
"74418",2,2,0,4,"dummy"
"74419",0,0,0,0,"dummy"
"74420",0,0,1,1,"dummy"
"74421",0,1,1,2,"dummy"
"74422",0,0,0,0,"dummy"
"74423",1,0,0,1,"dummy"
"74424",0,0,0,0,"dummy"
"74428",0,5,0,5,"dummy"
"74435",2,2,2,6,"dummy"
"74436",2,2,0,4,"dummy"
"74437",1,10,1,12,"dummy"
"74438",2,1,1,4,"dummy"
"74439",12,12,0,24,"dummy"
"74440",0,0,1,1,"dummy"
"74441",1,1,0,2,"dummy"
"74443",0,0,0,0,"dummy"
"74444",0,0,0,0,"dummy"
"74445",1,4,0,5,"dummy"
"74446",0,1,0,1,"dummy"
"74449",0,4,0,4,"dummy"
"74459",0,0,1,1,"dummy"
"74494",1,0,0,1,"dummy"
"74495",0,1,0,1,"dummy"
"74496",0,1,1,2,"dummy"
"74497",0,0,1,1,"dummy"
"74498",0,0,1,1,"dummy"
"74534",0,0,1,1,"dummy"
"74535",0,0,0,0,"dummy"
"74538",0,1,0,1,"dummy"
"74539",0,0,1,1,"dummy"
"74540",0,0,0,0,"dummy"
"74571",3,3,0,6,"dummy"
"74583",0,0,1,1,"dummy"
"74591",0,2,0,2,"dummy"
"74592",0,1,1,2,"dummy"
"74593",0,0,2,2,"dummy"
"74594",0,0,2,2,"dummy"
"74658",1,0,0,1,"dummy"
"74686",0,5,0,5,"dummy"
"74692",2,2,0,4,"dummy"
"74693",0,0,1,1,"dummy"
"74694",0,0,0,0,"dummy"
"74695",3,7,4,14,"dummy"
"74706",0,0,2,2,"dummy"
"74728",0,3,0,3,"dummy"
"74729",0,5,2,7,"dummy"
"74730",0,0,1,1,"dummy"
"74731",2,4,0,6,"dummy"
"74732",0,1,0,1,"dummy"
"74735",1,0,0,1,"dummy"
"74736",1,4,0,5,"dummy"
"74737",0,0,1,1,"dummy"
"74788",2,8,2,12,"dummy"
"74791",0,0,0,0,"dummy"
"74792",4,1,0,5,"dummy"
"74806",2,0,0,2,"dummy"
"74807",0,0,0,0,"dummy"
"74814",1,1,0,2,"dummy"
"74815",0,0,0,0,"dummy"
"74816",0,1,0,1,"dummy"
"74817",1,1,0,2,"dummy"
"74818",1,0,1,2,"dummy"
"74819",0,2,2,4,"dummy"
"74820",0,2,0,2,"dummy"
"74821",0,0,0,0,"dummy"
"74822",0,0,0,0,"dummy"
"74823",1,0,0,1,"dummy"
"74831",0,0,2,2,"dummy"
"74832",13,24,5,42,"dummy"
"74841",0,1,0,1,"dummy"
"74842",2,0,2,4,"dummy"
"74853",0,1,0,1,"dummy"
"74854",0,1,0,1,"dummy"
"74855",0,0,1,1,"dummy"
"74453",2,0,0,2,"dummy"
"74454",2,0,0,2,"dummy"
"74455",0,5,0,5,"dummy"
"74456",5,0,0,5,"dummy"
"74457",0,2,1,3,"dummy"
"74463",2,2,0,4,"dummy"
"74464",0,1,0,1,"dummy"
"74465",2,2,0,4,"dummy"
"74466",1,1,0,2,"dummy"
"74467",1,1,0,2,"dummy"
"74468",0,0,1,1,"dummy"
"74469",0,7,0,7,"dummy"
"74470",0,0,0,0,"dummy"
"74471",0,0,1,1,"dummy"
"74472",0,0,0,0,"dummy"
"74473",0,2,0,2,"dummy"
"74474",1,1,0,2,"dummy"
"74475",0,0,1,1,"dummy"
"74476",0,0,0,0,"dummy"
"74477",0,0,0,0,"dummy"
"74478",9,0,1,10,"dummy"
"74479",0,1,0,1,"dummy"
"74480",3,3,0,6,"dummy"
"74481",2,2,0,4,"dummy"
"74482",1,1,0,2,"dummy"
"74483",0,1,0,1,"dummy"
"74484",0,0,0,0,"dummy"
"74485",0,1,0,1,"dummy"
"74486",0,1,0,1,"dummy"
"74487",1,1,0,2,"dummy"
"74488",1,0,0,1,"dummy"
"74489",1,7,0,8,"dummy"
"74490",3,3,0,6,"dummy"
"74527",1,0,0,1,"dummy"
"74528",0,1,0,1,"dummy"
"74529",0,0,0,0,"dummy"
"74532",0,0,2,2,"dummy"
"74542",0,1,0,1,"dummy"
"74543",0,3,1,4,"dummy"
"74544",4,0,1,5,"dummy"
"74545",0,3,2,5,"dummy"
"74546",1,0,0,1,"dummy"
"74547",0,0,0,0,"dummy"
"74548",0,0,1,1,"dummy"
"74549",0,1,0,1,"dummy"
"74550",11,0,2,13,"dummy"
"74551",10,12,3,25,"dummy"
"74552",12,10,3,25,"dummy"
"74553",10,12,3,25,"dummy"
"74554",12,10,3,25,"dummy"
"74555",10,12,3,25,"dummy"
"74556",0,2,1,3,"dummy"
"74557",1,1,0,2,"dummy"
"74558",0,1,1,2,"dummy"
"74559",0,0,2,2,"dummy"
"74560",0,0,2,2,"dummy"
"74561",19,33,5,57,"dummy"
"74562",0,2,0,2,"dummy"
"74565",1,7,3,11,"dummy"
"74566",3,10,1,14,"dummy"
"74567",1,3,0,4,"dummy"
"74568",13,10,1,24,"dummy"
"74569",0,0,0,0,"dummy"
"74575",2,0,0,2,"dummy"
"74576",0,2,0,2,"dummy"
"74581",2,2,0,4,"dummy"
"74596",1,5,0,6,"dummy"
"74597",5,1,0,6,"dummy"
"74598",0,1,0,1,"dummy"
"74599",0,2,0,2,"dummy"
"74600",0,0,1,1,"dummy"
"74601",0,1,0,1,"dummy"
"74602",1,1,0,2,"dummy"
"74603",1,0,0,1,"dummy"
"74604",1,1,0,2,"dummy"
"74605",0,1,0,1,"dummy"
"74606",0,0,1,1,"dummy"
"74616",0,0,0,0,"dummy"
"74617",0,0,0,0,"dummy"
"74618",0,0,1,1,"dummy"
"74619",0,0,0,0,"dummy"
"74620",0,0,0,0,"dummy"
"74621",0,0,0,0,"dummy"
"74622",0,0,0,0,"dummy"
"74623",0,0,0,0,"dummy"
"74624",0,0,1,1,"dummy"
"74625",0,0,0,0,"dummy"
"74626",0,0,0,0,"dummy"
"74627",0,0,0,0,"dummy"
"74628",0,0,0,0,"dummy"
"74629",0,0,1,1,"dummy"
"74630",0,0,1,1,"dummy"
"74631",0,0,0,0,"dummy"
"74632",0,1,0,1,"dummy"
"74633",0,0,0,0,"dummy"
"74634",0,0,0,0,"dummy"
"74635",0,0,0,0,"dummy"
"74636",0,0,0,0,"dummy"
"74637",0,0,0,0,"dummy"
"74638",0,0,0,0,"dummy"
"74639",0,0,0,0,"dummy"
"74640",0,0,0,0,"dummy"
"74641",0,0,0,0,"dummy"
"74642",0,0,0,0,"dummy"
"74643",0,0,0,0,"dummy"
"74644",0,1,0,1,"dummy"
"74647",0,1,0,1,"dummy"
"74648",0,0,1,1,"dummy"
"74655",0,1,0,1,"dummy"
"74656",1,1,0,2,"dummy"
"74660",0,0,1,1,"dummy"
"74661",0,2,0,2,"dummy"
"74662",0,2,0,2,"dummy"
"74663",1,0,0,1,"dummy"
"74664",6,6,1,13,"dummy"
"74665",1,0,0,1,"dummy"
"74666",0,0,1,1,"dummy"
"74667",0,1,0,1,"dummy"
"74668",0,1,0,1,"dummy"
"74684",0,0,1,1,"dummy"
"74688",0,0,1,1,"dummy"
"74712",6,4,0,10,"dummy"
"74713",0,2,0,2,"dummy"
"74714",0,3,0,3,"dummy"
"74715",0,1,0,1,"dummy"
"74716",3,3,2,8,"dummy"
"74717",5,1,3,9,"dummy"
"74718",0,1,0,1,"dummy"
"74719",0,0,1,1,"dummy"
"74720",43,8,1,52,"dummy"
"74721",1,0,0,1,"dummy"
"74722",5,2,0,7,"dummy"
"74723",9,5,0,14,"dummy"
"74724",0,1,0,1,"dummy"
"74725",0,3,1,4,"dummy"
"74726",0,0,1,1,"dummy"
"74739",0,0,1,1,"dummy"
"74740",0,0,1,1,"dummy"
"74741",0,0,1,1,"dummy"
"74742",0,0,1,1,"dummy"
"74743",0,0,1,1,"dummy"
"74744",0,0,1,1,"dummy"
"74745",0,0,1,1,"dummy"
"74746",0,0,1,1,"dummy"
"74747",0,0,1,1,"dummy"
"74748",0,0,1,1,"dummy"
"74749",0,2,0,2,"dummy"
"74750",0,0,1,1,"dummy"
"74751",0,0,1,1,"dummy"
"74752",0,0,1,1,"dummy"
"74753",0,0,1,1,"dummy"
"74754",0,0,1,1,"dummy"
"74759",0,0,1,1,"dummy"
"74760",0,2,0,2,"dummy"
"74761",6,0,0,6,"dummy"
"74762",1,0,0,1,"dummy"
"74763",2,0,0,2,"dummy"
"74764",1,0,0,1,"dummy"
"74765",0,1,0,1,"dummy"
"74766",0,0,0,0,"dummy"
"74773",6,3,2,11,"dummy"
"74774",0,0,0,0,"dummy"
"74775",2,2,0,4,"dummy"
"74776",1,0,0,1,"dummy"
"74777",0,0,1,1,"dummy"
"74778",0,0,2,2,"dummy"
"74779",0,0,1,1,"dummy"
"74780",2,1,0,3,"dummy"
"74781",0,0,1,1,"dummy"
"74782",0,0,1,1,"dummy"
"74783",0,0,1,1,"dummy"
"74784",0,0,1,1,"dummy"
"74785",0,0,1,1,"dummy"
"74786",6,6,2,14,"dummy"
"74794",2,0,0,2,"dummy"
"74795",1,0,0,1,"dummy"
"74796",0,2,0,2,"dummy"
"74797",1,1,0,2,"dummy"
"74798",0,0,1,1,"dummy"
"74801",0,0,0,0,"dummy"
"74802",0,0,0,0,"dummy"
"74803",1,0,2,3,"dummy"
"74804",0,0,0,0,"dummy"
"74811",0,0,1,1,"dummy"
"74812",0,0,1,1,"dummy"
"74825",1,0,3,4,"dummy"
"74826",0,2,0,2,"dummy"
"74827",1,0,0,1,"dummy"
"74828",3,4,0,7,"dummy"
"74829",0,0,1,1,"dummy"
"74837",1,0,0,1,"dummy"
"74838",0,0,1,1,"dummy"
"74839",0,1,0,1,"dummy"
"74846",0,0,1,1,"dummy"
"74851",3,0,5,8,"dummy"
"74862",0,1,0,1,"dummy"
"74871",0,0,1,1,"dummy"
"74872",0,0,1,1,"dummy"
"74873",0,2,2,4,"dummy"
"74887",0,5,0,5,"dummy"
"74888",1,2,0,3,"dummy"
"74889",0,16,1,17,"dummy"
"74890",0,1,0,1,"dummy"
"74891",0,4,0,4,"dummy"
"74892",0,4,0,4,"dummy"
"74893",4,1,0,5,"dummy"
"74894",3,0,0,3,"dummy"
"74898",1,0,0,1,"dummy"
"74899",1,4,1,6,"dummy"
"74900",2,0,0,2,"dummy"
"74901",0,1,0,1,"dummy"
"74902",0,3,0,3,"dummy"
"74903",1,1,1,3,"dummy"
"74904",0,0,1,1,"dummy"
"74905",0,0,1,1,"dummy"
"74925",0,0,0,0,"dummy"
"74942",0,6,1,7,"dummy"
"74943",3,0,1,4,"dummy"
"74948",21,0,2,23,"dummy"
"74949",0,0,0,0,"dummy"
"74971",4,0,1,5,"dummy"
"74985",0,1,0,1,"dummy"
"74986",11,7,2,20,"dummy"
"74987",1,0,0,1,"dummy"
"74988",0,0,1,1,"dummy"
"74989",0,0,1,1,"dummy"
"74998",0,0,1,1,"dummy"
"75008",0,21,0,21,"dummy"
"75009",5,2,1,8,"dummy"
"75016",0,2,0,2,"dummy"
"75017",0,1,0,1,"dummy"
"75021",1,8,3,12,"dummy"
"75022",0,2,1,3,"dummy"
"75025",2,5,2,9,"dummy"
"75026",8,8,0,16,"dummy"
"75027",0,1,0,1,"dummy"
"75028",2,1,0,3,"dummy"
"75029",0,0,0,0,"dummy"
"75030",0,0,0,0,"dummy"
"75031",0,1,0,1,"dummy"
"74856",0,0,1,1,"dummy"
"74857",0,0,1,1,"dummy"
"74858",1,1,0,2,"dummy"
"74859",1,1,1,3,"dummy"
"74860",0,0,1,1,"dummy"
"74864",1,0,1,2,"dummy"
"74867",0,1,0,1,"dummy"
"74868",0,0,1,1,"dummy"
"74869",0,0,0,0,"dummy"
"74879",1,0,0,1,"dummy"
"74880",3,3,0,6,"dummy"
"74883",1,0,0,1,"dummy"
"74884",0,1,0,1,"dummy"
"74885",3,2,0,5,"dummy"
"74896",0,0,1,1,"dummy"
"74907",0,3,0,3,"dummy"
"74908",0,0,0,0,"dummy"
"74909",3,0,0,3,"dummy"
"74912",5,13,2,20,"dummy"
"74913",0,0,1,1,"dummy"
"74914",0,0,1,1,"dummy"
"74921",0,0,2,2,"dummy"
"74922",1,0,0,1,"dummy"
"74923",0,0,2,2,"dummy"
"74927",27,0,2,29,"dummy"
"74945",2,2,1,5,"dummy"
"74946",1,2,0,3,"dummy"
"74973",0,2,0,2,"dummy"
"74974",3,1,1,5,"dummy"
"74975",0,1,0,1,"dummy"
"74976",0,0,2,2,"dummy"
"74977",2,0,2,4,"dummy"
"74978",0,2,0,2,"dummy"
"74979",2,0,0,2,"dummy"
"74980",0,1,0,1,"dummy"
"74981",0,2,0,2,"dummy"
"74982",0,1,0,1,"dummy"
"74983",2,3,1,6,"dummy"
"74991",0,0,1,1,"dummy"
"74994",0,5,0,5,"dummy"
"74995",0,2,0,2,"dummy"
"74996",0,2,2,4,"dummy"
"75004",0,1,0,1,"dummy"
"75005",0,2,0,2,"dummy"
"75006",0,0,1,1,"dummy"
"75019",1,0,2,3,"dummy"
"75052",13,1,2,16,"dummy"
"75053",1,0,0,1,"dummy"
"75054",0,1,0,1,"dummy"
"75055",8,0,0,8,"dummy"
"75056",13,10,2,25,"dummy"
"75057",1,0,0,1,"dummy"
"75058",0,1,0,1,"dummy"
"75059",0,0,1,1,"dummy"
"75060",0,0,1,1,"dummy"
"75061",0,2,1,3,"dummy"
"75062",0,0,1,1,"dummy"
"75063",0,7,0,7,"dummy"
"75064",17,7,2,26,"dummy"
"75065",0,1,0,1,"dummy"
"75066",0,0,2,2,"dummy"
"75071",13,9,2,24,"dummy"
"75072",0,0,1,1,"dummy"
"75073",3,0,0,3,"dummy"
"75074",0,3,0,3,"dummy"
"75087",0,0,1,1,"dummy"
"75090",2,0,1,3,"dummy"
"75091",0,0,2,2,"dummy"
"75092",0,0,1,1,"dummy"
"75110",0,2,1,3,"dummy"
"75032",17,5,7,29,"dummy"
"75033",0,0,6,6,"dummy"
"75034",0,0,4,4,"dummy"
"75035",0,0,1,1,"dummy"
"75036",7,4,3,14,"dummy"
"75037",0,3,0,3,"dummy"
"75038",0,0,0,0,"dummy"
"75039",2,0,0,2,"dummy"
"75040",0,1,0,1,"dummy"
"75041",5,51,0,56,"dummy"
"75044",0,1,0,1,"dummy"
"75045",3,0,0,3,"dummy"
"75046",1,0,0,1,"dummy"
"75047",0,5,0,5,"dummy"
"75048",1,0,0,1,"dummy"
"75049",0,1,0,1,"dummy"
"75050",0,3,0,3,"dummy"
"75068",6,0,0,6,"dummy"
"75069",2,5,2,9,"dummy"
"75078",0,0,1,1,"dummy"
"75079",0,0,2,2,"dummy"
"75080",2,2,0,4,"dummy"
"75081",0,1,0,1,"dummy"
"75082",0,0,4,4,"dummy"
"75083",1,1,0,2,"dummy"
"75084",0,0,1,1,"dummy"
"75085",0,0,2,2,"dummy"
"75096",0,0,1,1,"dummy"
"75101",1,2,0,3,"dummy"
"75112",5,0,0,5,"dummy"
"75113",0,1,0,1,"dummy"
"75118",16,3,0,19,"dummy"
"75119",0,0,0,0,"dummy"
"75120",3,3,1,7,"dummy"
"75129",0,0,1,1,"dummy"
"75130",0,1,0,1,"dummy"
"75146",0,0,1,1,"dummy"
"75147",0,2,0,2,"dummy"
"75150",0,0,2,2,"dummy"
"75151",2,0,0,2,"dummy"
"75152",1,0,1,2,"dummy"
"75157",1,11,4,16,"dummy"
"75158",0,0,0,0,"dummy"
"75165",0,6,1,7,"dummy"
"75191",0,0,1,1,"dummy"
"75198",0,13,3,16,"dummy"
"75199",8,8,5,21,"dummy"
"75200",2,10,4,16,"dummy"
"75201",13,9,3,25,"dummy"
"75202",0,2,0,2,"dummy"
"75203",0,1,1,2,"dummy"
"75204",1,0,2,3,"dummy"
"75210",6,0,0,6,"dummy"
"75211",2,5,2,9,"dummy"
"75216",0,3,0,3,"dummy"
"75217",0,1,0,1,"dummy"
"75218",1,2,0,3,"dummy"
"75219",0,0,2,2,"dummy"
"75226",1,0,0,1,"dummy"
"75227",0,0,0,0,"dummy"
"75251",0,0,1,1,"dummy"
"75252",2,2,2,6,"dummy"
"75253",2,2,0,4,"dummy"
"75256",0,2,3,5,"dummy"
"75257",1,2,3,6,"dummy"
"75266",0,1,1,2,"dummy"
"75267",1,1,0,2,"dummy"
"75268",0,1,0,1,"dummy"
"75269",1,0,0,1,"dummy"
"75115",0,0,0,0,"dummy"
"75116",0,1,1,2,"dummy"
"75132",0,2,0,2,"dummy"
"75133",0,0,1,1,"dummy"
"75134",0,0,2,2,"dummy"
"75137",0,0,0,0,"dummy"
"75138",0,0,1,1,"dummy"
"75139",0,0,2,2,"dummy"
"75140",1,7,5,13,"dummy"
"75141",7,1,5,13,"dummy"
"75142",1,7,5,13,"dummy"
"75143",6,0,2,8,"dummy"
"75144",0,1,1,2,"dummy"
"75154",0,1,0,1,"dummy"
"75155",0,1,0,1,"dummy"
"75160",0,0,1,1,"dummy"
"75163",0,0,1,1,"dummy"
"75183",1,1,0,2,"dummy"
"75184",0,1,1,2,"dummy"
"75185",0,1,0,1,"dummy"
"75186",0,0,3,3,"dummy"
"75187",0,0,1,1,"dummy"
"75188",1,0,0,1,"dummy"
"75189",2,4,3,9,"dummy"
"75206",1,1,0,2,"dummy"
"75221",0,0,1,1,"dummy"
"75222",0,0,1,1,"dummy"
"75229",0,0,1,1,"dummy"
"75230",0,0,2,2,"dummy"
"75231",0,0,1,1,"dummy"
"75232",0,0,1,1,"dummy"
"75233",0,0,1,1,"dummy"
"75234",0,1,0,1,"dummy"
"75235",1,6,4,11,"dummy"
"75238",1,1,0,2,"dummy"
"75239",0,1,0,1,"dummy"
"75240",0,1,0,1,"dummy"
"75241",0,0,1,1,"dummy"
"75242",0,1,0,1,"dummy"
"75261",2,0,3,5,"dummy"
"75264",0,0,1,1,"dummy"
"75277",0,4,0,4,"dummy"
"75278",1,0,0,1,"dummy"
"75279",0,10,0,10,"dummy"
"75280",0,0,5,5,"dummy"
"75281",0,0,0,0,"dummy"
"75282",0,2,0,2,"dummy"
"75283",2,1,0,3,"dummy"
"75292",0,2,2,4,"dummy"
"75303",0,6,1,7,"dummy"
"75304",0,0,1,1,"dummy"
"75305",0,5,0,5,"dummy"
"75318",6,0,0,6,"dummy"
"75319",2,5,2,9,"dummy"
"75342",0,1,0,1,"dummy"
"75343",0,1,0,1,"dummy"
"75357",1,2,2,5,"dummy"
"75358",1,1,0,2,"dummy"
"75359",2,3,0,5,"dummy"
"75360",0,0,0,0,"dummy"
"75361",0,1,0,1,"dummy"
"75398",3,2,1,6,"dummy"
"75270",0,0,4,4,"dummy"
"75273",0,0,0,0,"dummy"
"75274",0,0,1,1,"dummy"
"75275",0,0,0,0,"dummy"
"75287",0,0,1,1,"dummy"
"75288",2,1,1,4,"dummy"
"75294",0,0,1,1,"dummy"
"75295",0,0,1,1,"dummy"
"75296",1,1,0,2,"dummy"
"75297",0,3,0,3,"dummy"
"75298",4,6,0,10,"dummy"
"75299",0,0,0,0,"dummy"
"75300",0,0,2,2,"dummy"
"75301",14,0,2,16,"dummy"
"75310",1,0,0,1,"dummy"
"75338",2,2,0,4,"dummy"
"75339",2,7,1,10,"dummy"
"75340",6,1,0,7,"dummy"
"75345",1,3,1,5,"dummy"
"75354",1,3,0,4,"dummy"
"75355",0,1,0,1,"dummy"
"75367",4,4,0,8,"dummy"
"75368",4,4,0,8,"dummy"
"75369",0,0,1,1,"dummy"
"75370",1,0,0,1,"dummy"
"75371",0,0,1,1,"dummy"
"75372",2,0,0,2,"dummy"
"75373",0,2,0,2,"dummy"
"75374",2,4,0,6,"dummy"
"75375",0,0,1,1,"dummy"
"75376",0,0,1,1,"dummy"
"75377",1,4,0,5,"dummy"
"75378",0,1,0,1,"dummy"
"75379",0,0,1,1,"dummy"
"75380",0,0,1,1,"dummy"
"75381",1,8,0,9,"dummy"
"75382",0,0,0,0,"dummy"
"75383",0,0,0,0,"dummy"
"75384",1,0,0,1,"dummy"
"75385",0,2,0,2,"dummy"
"75386",0,0,1,1,"dummy"
"75387",2,7,0,9,"dummy"
"75388",0,4,0,4,"dummy"
"75389",0,0,2,2,"dummy"
"75390",19,0,0,19,"dummy"
"75391",0,2,0,2,"dummy"
"75392",0,1,1,2,"dummy"
"75395",3,1,1,5,"dummy"
"75396",0,1,0,1,"dummy"
"75414",1,5,1,7,"dummy"
"75418",6,1,1,8,"dummy"
"75419",0,0,0,0,"dummy"
"75433",0,3,0,3,"dummy"
"75436",2,4,0,6,"dummy"
"75437",0,2,0,2,"dummy"
"75438",0,2,0,2,"dummy"
"75439",10,2,0,12,"dummy"
"75440",0,2,0,2,"dummy"
"75443",0,0,1,1,"dummy"
"75444",0,0,2,2,"dummy"
"75445",0,0,3,3,"dummy"
"75446",0,0,2,2,"dummy"
"75447",0,0,2,2,"dummy"
"75448",5,4,5,14,"dummy"
"75449",0,4,1,5,"dummy"
"75450",0,3,2,5,"dummy"
"75469",6,1,0,7,"dummy"
"75470",1,1,0,2,"dummy"
"75399",2,1,0,3,"dummy"
"75400",0,1,0,1,"dummy"
"75401",4,4,2,10,"dummy"
"75402",1,0,0,1,"dummy"
"75403",0,1,0,1,"dummy"
"75404",2,2,1,5,"dummy"
"75405",0,0,1,1,"dummy"
"75406",0,1,0,1,"dummy"
"75407",0,0,0,0,"dummy"
"75408",1,0,1,2,"dummy"
"75409",5,6,4,15,"dummy"
"75410",0,0,0,0,"dummy"
"75411",0,0,1,1,"dummy"
"75412",6,6,4,16,"dummy"
"75416",1,3,1,5,"dummy"
"75421",6,6,0,12,"dummy"
"75422",0,2,0,2,"dummy"
"75423",0,0,2,2,"dummy"
"75424",1,0,0,1,"dummy"
"75425",0,2,0,2,"dummy"
"75426",4,4,4,12,"dummy"
"75427",0,14,0,14,"dummy"
"75428",2,0,0,2,"dummy"
"75429",10,0,0,10,"dummy"
"75452",0,0,1,1,"dummy"
"75573",0,1,0,1,"dummy"
"75574",0,0,0,0,"dummy"
"75575",0,0,0,0,"dummy"
"75576",1,8,0,9,"dummy"
"75578",0,15,0,15,"dummy"
"75579",0,0,1,1,"dummy"
"75580",4,6,2,12,"dummy"
"75584",0,5,0,5,"dummy"
"75588",0,1,0,1,"dummy"
"75589",0,0,0,0,"dummy"
"75591",0,1,0,1,"dummy"
"75592",0,2,0,2,"dummy"
"75595",0,0,2,2,"dummy"
"75596",11,10,3,24,"dummy"
"75597",0,0,1,1,"dummy"
"75598",0,3,2,5,"dummy"
"75599",3,0,2,5,"dummy"
"75601",9,13,0,22,"dummy"
"75608",0,0,1,1,"dummy"
"75622",0,0,1,1,"dummy"
"75623",0,0,1,1,"dummy"
"75624",0,0,0,0,"dummy"
"75625",0,0,1,1,"dummy"
"75626",0,0,1,1,"dummy"
"75627",0,0,1,1,"dummy"
"75628",0,0,0,0,"dummy"
"75630",0,0,0,0,"dummy"
"75631",0,0,0,0,"dummy"
"75633",0,4,0,4,"dummy"
"75634",0,0,1,1,"dummy"
"75639",3,0,4,7,"dummy"
"75640",0,1,1,2,"dummy"
"75641",4,2,2,8,"dummy"
"75642",0,0,1,1,"dummy"
"75644",0,5,0,5,"dummy"
"75645",0,1,0,1,"dummy"
"75648",6,13,0,19,"dummy"
"75649",3,5,0,8,"dummy"
"75650",6,7,3,16,"dummy"
"75656",0,0,1,1,"dummy"
"75657",0,0,0,0,"dummy"
"75661",0,0,1,1,"dummy"
"75662",0,7,0,7,"dummy"
"75680",6,2,1,9,"dummy"
"75681",0,2,3,5,"dummy"
"75682",0,0,1,1,"dummy"
"75684",0,0,1,1,"dummy"
"75687",0,0,2,2,"dummy"
"75688",0,0,1,1,"dummy"
"75689",0,4,0,4,"dummy"
"75690",0,1,0,1,"dummy"
"75691",0,4,3,7,"dummy"
"75692",4,0,3,7,"dummy"
"75695",0,1,1,2,"dummy"
"75696",0,0,3,3,"dummy"
"75697",0,0,1,1,"dummy"
"75698",0,0,1,1,"dummy"
"75699",0,1,1,2,"dummy"
"75700",0,0,4,4,"dummy"
"75701",0,0,0,0,"dummy"
"75702",7,2,2,11,"dummy"
"75703",0,0,0,0,"dummy"
"75704",0,0,2,2,"dummy"
"75705",0,1,1,2,"dummy"
"75710",0,0,1,1,"dummy"
"75711",0,0,1,1,"dummy"
"75712",0,0,2,2,"dummy"
"75713",26,3,7,36,"dummy"
"75715",0,1,0,1,"dummy"
"75716",0,0,1,1,"dummy"
"75717",2,1,4,7,"dummy"
"75720",0,0,0,0,"dummy"
"75721",0,0,0,0,"dummy"
"75722",0,0,0,0,"dummy"
"75723",0,0,0,0,"dummy"
"75724",1,0,2,3,"dummy"
"75725",3,0,0,3,"dummy"
"75726",0,3,0,3,"dummy"
"75727",7,0,0,7,"dummy"
"75728",0,4,0,4,"dummy"
"75729",0,1,0,1,"dummy"
"75730",1,1,0,2,"dummy"
"75731",0,1,0,1,"dummy"
"75732",4,0,0,4,"dummy"
"75733",0,0,2,2,"dummy"
"75734",0,0,3,3,"dummy"
"75735",0,0,3,3,"dummy"
"75736",0,0,2,2,"dummy"
"75737",0,0,0,0,"dummy"
"75738",0,0,0,0,"dummy"
"75739",0,0,0,0,"dummy"
"75740",0,0,3,3,"dummy"
"75742",0,0,1,1,"dummy"
"75743",0,0,0,0,"dummy"
"75746",0,7,0,7,"dummy"
"75748",0,0,0,0,"dummy"
"75749",0,2,0,2,"dummy"
"75750",3,1,1,5,"dummy"
"75751",1,1,0,2,"dummy"
"75752",1,0,0,1,"dummy"
"75753",0,1,0,1,"dummy"
"75754",0,2,0,2,"dummy"
"75755",4,10,3,17,"dummy"
"75756",3,1,0,4,"dummy"
"75757",1,2,6,9,"dummy"
"75758",0,0,1,1,"dummy"
"75759",3,3,1,7,"dummy"
"75760",21,3,2,26,"dummy"
"75762",0,0,1,1,"dummy"
"75763",0,2,0,2,"dummy"
"75764",2,1,0,3,"dummy"
"75765",1,0,0,1,"dummy"
"75766",2,0,2,4,"dummy"
"75771",1,0,0,1,"dummy"
"75773",0,0,2,2,"dummy"
"75774",0,0,2,2,"dummy"
"75775",0,0,1,1,"dummy"
"75776",0,0,1,1,"dummy"
"75777",0,0,4,4,"dummy"
"75778",0,0,4,4,"dummy"
"75779",0,0,4,4,"dummy"
"75780",0,0,4,4,"dummy"
"75781",0,0,1,1,"dummy"
"75782",0,0,4,4,"dummy"
"75783",1,1,0,2,"dummy"
"75784",1,1,0,2,"dummy"
"75785",1,2,0,3,"dummy"
"75786",1,0,0,1,"dummy"
"75787",1,1,3,5,"dummy"
"75788",0,0,1,1,"dummy"
"75789",0,0,1,1,"dummy"
"75790",3,1,0,4,"dummy"
"75791",0,0,1,1,"dummy"
"75792",1,1,2,4,"dummy"
"75793",0,2,0,2,"dummy"
"75794",0,1,0,1,"dummy"
"75795",4,1,0,5,"dummy"
"75796",0,1,0,1,"dummy"
"75797",0,0,1,1,"dummy"
"75798",0,0,0,0,"dummy"
"75799",3,2,1,6,"dummy"
"75800",0,0,2,2,"dummy"
"75801",0,3,0,3,"dummy"
"75802",3,0,3,6,"dummy"
"75803",2,1,0,3,"dummy"
"75804",0,0,2,2,"dummy"
"75805",0,0,2,2,"dummy"
"75806",0,1,0,1,"dummy"
"75809",0,1,0,1,"dummy"
"75811",0,0,1,1,"dummy"
"75812",0,0,1,1,"dummy"
"75813",0,0,0,0,"dummy"
"75814",0,0,1,1,"dummy"
"75815",0,0,1,1,"dummy"
"75816",0,0,1,1,"dummy"
"75817",0,0,0,0,"dummy"
"75820",2,14,4,20,"dummy"
"75821",2,5,0,7,"dummy"
"75822",0,4,0,4,"dummy"
"75823",1,3,1,5,"dummy"
"75824",0,3,0,3,"dummy"
"75825",0,0,1,1,"dummy"
"75826",0,0,1,1,"dummy"
"75827",0,0,1,1,"dummy"
"75828",0,0,1,1,"dummy"
"75829",0,0,2,2,"dummy"
"75830",0,0,1,1,"dummy"
"75831",0,0,3,3,"dummy"
"75832",0,0,1,1,"dummy"
"75833",6,6,10,22,"dummy"
"75834",2,1,5,8,"dummy"
"75835",0,4,0,4,"dummy"
"75837",10,3,0,13,"dummy"
"75839",0,4,1,5,"dummy"
"75840",0,6,1,7,"dummy"
"75841",6,1,1,8,"dummy"
"75846",0,0,1,1,"dummy"
"75847",0,0,1,1,"dummy"
"75848",0,0,1,1,"dummy"
"75850",2,9,2,13,"dummy"
"75859",0,2,0,2,"dummy"
"75865",0,0,1,1,"dummy"
"75870",0,4,0,4,"dummy"
"75871",0,1,2,3,"dummy"
"75872",9,0,2,11,"dummy"
"75874",1,23,0,24,"dummy"
"75888",1,20,2,23,"dummy"
"75892",1,0,0,1,"dummy"
"75893",0,0,1,1,"dummy"
"75894",4,3,5,12,"dummy"
"75895",0,0,2,2,"dummy"
"75896",3,0,1,4,"dummy"
"75897",0,0,1,1,"dummy"
"75898",0,1,0,1,"dummy"
"75899",0,1,0,1,"dummy"
"75900",2,0,0,2,"dummy"
"75901",0,1,2,3,"dummy"
"75903",0,1,0,1,"dummy"
"75908",1,4,0,5,"dummy"
"75909",0,5,0,5,"dummy"
"75910",0,1,0,1,"dummy"
"75913",0,1,0,1,"dummy"
"75914",0,1,0,1,"dummy"
"75915",2,1,2,5,"dummy"
"75916",0,0,1,1,"dummy"
"75927",0,2,0,2,"dummy"
"75928",1,2,4,7,"dummy"
"75929",0,0,1,1,"dummy"
"75931",4,0,1,5,"dummy"
"75932",4,10,3,17,"dummy"
"75933",0,0,1,1,"dummy"
"75936",0,2,0,2,"dummy"
"75937",0,0,1,1,"dummy"
"75938",0,1,0,1,"dummy"
"75940",0,0,1,1,"dummy"
"75941",0,0,1,1,"dummy"
"75942",0,0,1,1,"dummy"
"75944",0,1,0,1,"dummy"
"75945",0,0,3,3,"dummy"
"75949",0,1,0,1,"dummy"
"75950",0,0,1,1,"dummy"
"75953",0,1,0,1,"dummy"
"75987",0,0,2,2,"dummy"
"75988",0,0,1,1,"dummy"
"75989",0,0,1,1,"dummy"
"75990",0,0,2,2,"dummy"
"75993",0,2,0,2,"dummy"
"75994",0,0,1,1,"dummy"
"75996",0,0,1,1,"dummy"
"75997",0,0,1,1,"dummy"
"75998",0,2,0,2,"dummy"
"76006",0,0,0,0,"dummy"
"76007",0,0,0,0,"dummy"
"76014",0,1,0,1,"dummy"
"76015",0,5,0,5,"dummy"
"76016",4,3,1,8,"dummy"
"76017",0,1,0,1,"dummy"
"76018",2,2,0,4,"dummy"
"76019",2,2,1,5,"dummy"
"76020",0,1,0,1,"dummy"
"76021",0,2,0,2,"dummy"
"76022",0,1,0,1,"dummy"
"76026",0,0,0,0,"dummy"
"76027",0,4,0,4,"dummy"
"76028",0,2,1,3,"dummy"
"76029",0,4,8,12,"dummy"
"76030",0,4,0,4,"dummy"
"76031",0,1,0,1,"dummy"
"76032",0,1,0,1,"dummy"
"76033",0,2,0,2,"dummy"
"76035",19,26,3,48,"dummy"
"76036",0,0,8,8,"dummy"
"76037",0,0,7,7,"dummy"
"76038",0,0,1,1,"dummy"
"76040",0,0,1,1,"dummy"
"76041",0,0,1,1,"dummy"
"76042",0,0,1,1,"dummy"
"76043",3,8,3,14,"dummy"
"76044",2,1,2,5,"dummy"
"76045",0,0,1,1,"dummy"
"76046",0,1,0,1,"dummy"
"76047",0,0,2,2,"dummy"
"76048",0,0,2,2,"dummy"
"76049",0,0,2,2,"dummy"
"76050",0,0,1,1,"dummy"
"76051",0,0,3,3,"dummy"
"76052",0,0,1,1,"dummy"
"76053",0,0,1,1,"dummy"
"76054",0,0,1,1,"dummy"
"76055",0,0,1,1,"dummy"
"76056",0,0,1,1,"dummy"
"76057",0,0,1,1,"dummy"
"76058",0,0,1,1,"dummy"
"76059",0,0,1,1,"dummy"
"76063",0,0,1,1,"dummy"
"76064",0,1,0,1,"dummy"
"76086",0,1,0,1,"dummy"
"76089",0,0,1,1,"dummy"
"76096",0,0,0,0,"dummy"
"76097",1,0,0,1,"dummy"
"76098",1,1,1,3,"dummy"
"76099",1,1,1,3,"dummy"
"76100",0,1,0,1,"dummy"
"76101",0,0,1,1,"dummy"
"76102",1,1,1,3,"dummy"
"76122",1,5,1,7,"dummy"
"76128",0,0,1,1,"dummy"
"76129",3,3,0,6,"dummy"
"76130",0,7,0,7,"dummy"
"76136",0,0,0,0,"dummy"
"76158",0,1,0,1,"dummy"
"76159",1,0,0,1,"dummy"
"76160",0,0,1,1,"dummy"
"76161",1,1,1,3,"dummy"
"76162",0,0,1,1,"dummy"
"76163",0,0,1,1,"dummy"
"76164",0,0,1,1,"dummy"
"76165",0,0,1,1,"dummy"
"76166",0,0,1,1,"dummy"
"76167",0,0,1,1,"dummy"
"76168",0,0,1,1,"dummy"
"76169",0,0,1,1,"dummy"
"76195",0,0,1,1,"dummy"
"76218",6,0,0,6,"dummy"
"76219",9,21,1,31,"dummy"
"76220",36,22,1,59,"dummy"
"76221",1,5,0,6,"dummy"
"76222",0,5,0,5,"dummy"
"76223",0,0,0,0,"dummy"
"76268",0,1,0,1,"dummy"
"76278",0,1,0,1,"dummy"
"76294",3,20,0,23,"dummy"
"76295",1,3,2,6,"dummy"
"76296",0,0,2,2,"dummy"
"76297",0,0,2,2,"dummy"
"76324",0,0,1,1,"dummy"
"76339",0,1,0,1,"dummy"
"76342",1,2,0,3,"dummy"
"76345",10,3,0,13,"dummy"
"76346",10,18,1,29,"dummy"
"76347",0,2,0,2,"dummy"
"76348",0,3,0,3,"dummy"
"76061",0,7,0,7,"dummy"
"76068",1,0,0,1,"dummy"
"76069",7,0,1,8,"dummy"
"76072",2,4,0,6,"dummy"
"76073",0,2,0,2,"dummy"
"76074",0,2,0,2,"dummy"
"76075",10,2,0,12,"dummy"
"76076",0,2,0,2,"dummy"
"76077",0,0,0,0,"dummy"
"76080",0,0,1,1,"dummy"
"76081",4,5,2,11,"dummy"
"76082",0,0,3,3,"dummy"
"76083",2,0,0,2,"dummy"
"76084",3,0,1,4,"dummy"
"76091",5,0,2,7,"dummy"
"76092",0,0,1,1,"dummy"
"76104",0,2,0,2,"dummy"
"76105",3,10,1,14,"dummy"
"76106",0,0,3,3,"dummy"
"76107",7,7,8,22,"dummy"
"76108",13,8,4,25,"dummy"
"76109",7,4,2,13,"dummy"
"76110",0,4,0,4,"dummy"
"76111",0,2,0,2,"dummy"
"76112",0,0,0,0,"dummy"
"76113",1,0,0,1,"dummy"
"76114",8,4,3,15,"dummy"
"76115",0,0,1,1,"dummy"
"76120",0,0,1,1,"dummy"
"76124",0,3,0,3,"dummy"
"76125",3,0,0,3,"dummy"
"76126",0,3,0,3,"dummy"
"76138",0,1,2,3,"dummy"
"76139",0,0,1,1,"dummy"
"76140",0,0,1,1,"dummy"
"76141",0,0,1,1,"dummy"
"76142",2,1,5,8,"dummy"
"76143",1,8,2,11,"dummy"
"76144",3,3,1,7,"dummy"
"76145",0,0,1,1,"dummy"
"76146",0,1,0,1,"dummy"
"76147",1,0,0,1,"dummy"
"76148",0,1,0,1,"dummy"
"76149",0,2,0,2,"dummy"
"76150",0,0,1,1,"dummy"
"76151",0,1,0,1,"dummy"
"76152",2,2,2,6,"dummy"
"76153",2,4,0,6,"dummy"
"76154",4,1,0,5,"dummy"
"76171",0,1,0,1,"dummy"
"76172",0,1,0,1,"dummy"
"76173",17,0,1,18,"dummy"
"76174",0,20,2,22,"dummy"
"76175",2,3,1,6,"dummy"
"76176",0,0,1,1,"dummy"
"76177",20,7,4,31,"dummy"
"76178",6,2,0,8,"dummy"
"76179",0,0,1,1,"dummy"
"76182",7,0,1,8,"dummy"
"76183",2,6,1,9,"dummy"
"76184",0,2,0,2,"dummy"
"76185",3,0,0,3,"dummy"
"76186",0,1,2,3,"dummy"
"76187",2,1,0,3,"dummy"
"76188",0,1,0,1,"dummy"
"76189",1,2,0,3,"dummy"
"76190",0,0,1,1,"dummy"
"76191",9,1,0,10,"dummy"
"76192",8,4,0,12,"dummy"
"76193",0,0,2,2,"dummy"
"76197",1,0,0,1,"dummy"
"76198",0,0,0,0,"dummy"
"76201",0,2,0,2,"dummy"
"76202",0,1,1,2,"dummy"
"76203",0,0,2,2,"dummy"
"76204",0,0,1,1,"dummy"
"76205",5,0,4,9,"dummy"
"76206",0,0,1,1,"dummy"
"76207",0,1,0,1,"dummy"
"76208",0,3,0,3,"dummy"
"76209",0,0,2,2,"dummy"
"76210",5,3,3,11,"dummy"
"76213",0,14,0,14,"dummy"
"76214",16,0,0,16,"dummy"
"76215",0,10,0,10,"dummy"
"76216",0,0,1,1,"dummy"
"76263",1,23,0,24,"dummy"
"76264",23,12,1,36,"dummy"
"76276",0,0,0,0,"dummy"
"76280",0,0,0,0,"dummy"
"76299",0,0,0,0,"dummy"
"76300",2,0,0,2,"dummy"
"76301",0,2,0,2,"dummy"
"76302",0,0,0,0,"dummy"
"76303",0,1,0,1,"dummy"
"76304",1,0,0,1,"dummy"
"76305",0,1,0,1,"dummy"
"76306",5,16,0,21,"dummy"
"76311",0,0,1,1,"dummy"
"76322",3,1,1,5,"dummy"
"76328",3,60,2,65,"dummy"
"76331",0,2,0,2,"dummy"
"76358",8,5,1,14,"dummy"
"76359",0,0,2,2,"dummy"
"76360",0,0,1,1,"dummy"
"76373",0,0,1,1,"dummy"
"76374",1,0,0,1,"dummy"
"76375",0,1,0,1,"dummy"
"76384",1,2,0,3,"dummy"
"76385",0,1,0,1,"dummy"
"76386",1,0,0,1,"dummy"
"76387",1,1,0,2,"dummy"
"76388",2,4,1,7,"dummy"
"76389",0,3,1,4,"dummy"
"76390",0,1,0,1,"dummy"
"76391",0,1,0,1,"dummy"
"76408",0,0,1,1,"dummy"
"76409",0,0,1,1,"dummy"
"76428",0,1,0,1,"dummy"
"76429",2,0,0,2,"dummy"
"76430",0,0,1,1,"dummy"
"76431",0,0,0,0,"dummy"
"76432",0,0,0,0,"dummy"
"76433",0,0,0,0,"dummy"
"76434",0,0,0,0,"dummy"
"76483",0,1,0,1,"dummy"
"76484",3,5,2,10,"dummy"
"76485",0,0,1,1,"dummy"
"76486",0,0,1,1,"dummy"
"76487",0,6,1,7,"dummy"
"76488",0,0,1,1,"dummy"
"76489",1,4,2,7,"dummy"
"76490",0,0,2,2,"dummy"
"76491",0,1,1,2,"dummy"
"76492",0,0,1,1,"dummy"
"76493",0,0,1,1,"dummy"
"76494",1,1,0,2,"dummy"
"76495",0,0,1,1,"dummy"
"76496",0,0,1,1,"dummy"
"76497",0,0,1,1,"dummy"
"76498",0,0,1,1,"dummy"
"76499",0,0,1,1,"dummy"
"76500",0,0,1,1,"dummy"
"76501",0,0,1,1,"dummy"
"76502",0,0,1,1,"dummy"
"76503",0,0,1,1,"dummy"
"76504",0,0,1,1,"dummy"
"76505",0,0,1,1,"dummy"
"76349",0,0,1,1,"dummy"
"76350",0,1,0,1,"dummy"
"76351",0,1,0,1,"dummy"
"76352",3,3,1,7,"dummy"
"76353",0,0,2,2,"dummy"
"76354",0,1,0,1,"dummy"
"76355",0,0,0,0,"dummy"
"76356",0,0,1,1,"dummy"
"76362",18,37,10,65,"dummy"
"76363",1,3,3,7,"dummy"
"76366",2,2,2,6,"dummy"
"76367",0,0,0,0,"dummy"
"76368",0,0,2,2,"dummy"
"76369",2,2,2,6,"dummy"
"76370",0,0,2,2,"dummy"
"76371",0,0,0,0,"dummy"
"76377",0,1,1,2,"dummy"
"76378",3,7,1,11,"dummy"
"76379",0,0,2,2,"dummy"
"76380",0,0,1,1,"dummy"
"76381",0,0,2,2,"dummy"
"76382",0,0,2,2,"dummy"
"76393",5,0,1,6,"dummy"
"76394",1,1,0,2,"dummy"
"76395",0,0,1,1,"dummy"
"76396",0,2,0,2,"dummy"
"76397",0,0,1,1,"dummy"
"76398",0,1,0,1,"dummy"
"76399",0,0,1,1,"dummy"
"76400",0,0,1,1,"dummy"
"76401",0,1,1,2,"dummy"
"76402",0,0,1,1,"dummy"
"76403",0,0,3,3,"dummy"
"76404",0,0,1,1,"dummy"
"76438",1,0,0,1,"dummy"
"76439",0,1,0,1,"dummy"
"76440",4,3,0,7,"dummy"
"76441",2,3,0,5,"dummy"
"76442",1,0,0,1,"dummy"
"76445",2,2,0,4,"dummy"
"76446",0,1,1,2,"dummy"
"76447",1,0,0,1,"dummy"
"76450",2,0,3,5,"dummy"
"76455",0,1,0,1,"dummy"
"76456",0,0,0,0,"dummy"
"76457",0,1,0,1,"dummy"
"76458",0,0,0,0,"dummy"
"76459",1,0,0,1,"dummy"
"76460",0,2,0,2,"dummy"
"76461",0,6,0,6,"dummy"
"76464",43,13,3,59,"dummy"
"76465",0,1,0,1,"dummy"
"76466",1,1,0,2,"dummy"
"76467",0,2,0,2,"dummy"
"76468",0,1,0,1,"dummy"
"76471",0,3,0,3,"dummy"
"76472",3,0,0,3,"dummy"
"76473",0,2,0,2,"dummy"
"76474",0,0,1,1,"dummy"
"76475",11,10,3,24,"dummy"
"76478",2,0,3,5,"dummy"
"76481",3,3,2,8,"dummy"
"76531",1,7,2,10,"dummy"
"76532",0,0,1,1,"dummy"
"76533",7,11,1,19,"dummy"
"76534",3,9,0,12,"dummy"
"76535",0,0,2,2,"dummy"
"76536",0,2,0,2,"dummy"
"76537",16,6,2,24,"dummy"
"76538",0,0,0,0,"dummy"
"76541",1,2,1,4,"dummy"
"76542",2,2,0,4,"dummy"
"76545",0,0,0,0,"dummy"
"76551",0,1,0,1,"dummy"
"76552",0,3,0,3,"dummy"
"76585",1,0,0,1,"dummy"
"76586",8,0,0,8,"dummy"
"76590",5,5,1,11,"dummy"
"76506",0,0,1,1,"dummy"
"76507",0,0,1,1,"dummy"
"76508",0,0,1,1,"dummy"
"76509",0,0,1,1,"dummy"
"76510",0,0,1,1,"dummy"
"76511",0,0,1,1,"dummy"
"76512",0,0,1,1,"dummy"
"76513",0,0,1,1,"dummy"
"76514",0,0,1,1,"dummy"
"76515",0,0,1,1,"dummy"
"76516",0,0,1,1,"dummy"
"76517",0,0,0,0,"dummy"
"76518",0,0,0,0,"dummy"
"76519",0,0,1,1,"dummy"
"76520",0,0,1,1,"dummy"
"76521",0,0,1,1,"dummy"
"76522",0,0,1,1,"dummy"
"76523",0,0,0,0,"dummy"
"76524",0,0,1,1,"dummy"
"76525",0,0,1,1,"dummy"
"76526",0,0,1,1,"dummy"
"76527",0,0,1,1,"dummy"
"76547",0,3,1,4,"dummy"
"76548",0,0,1,1,"dummy"
"76549",0,0,1,1,"dummy"
"76554",0,1,0,1,"dummy"
"76555",0,3,0,3,"dummy"
"76561",0,4,0,4,"dummy"
"76562",1,3,0,4,"dummy"
"76563",0,1,1,2,"dummy"
"76564",4,4,8,16,"dummy"
"76567",4,0,4,8,"dummy"
"76568",18,2,1,21,"dummy"
"76573",3,1,0,4,"dummy"
"76576",0,0,1,1,"dummy"
"76581",0,0,1,1,"dummy"
"76588",0,2,1,3,"dummy"
"76599",0,0,1,1,"dummy"
"76602",0,0,1,1,"dummy"
"76603",1,3,0,4,"dummy"
"76604",0,0,1,1,"dummy"
"76605",0,0,0,0,"dummy"
"76606",0,0,1,1,"dummy"
"76607",0,0,1,1,"dummy"
"76608",2,2,1,5,"dummy"
"76609",1,0,1,2,"dummy"
"76610",1,2,2,5,"dummy"
"76615",0,2,1,3,"dummy"
"76616",1,0,0,1,"dummy"
"76617",0,2,0,2,"dummy"
"76618",2,1,0,3,"dummy"
"76619",3,5,0,8,"dummy"
"76620",7,7,0,14,"dummy"
"76623",2,0,2,4,"dummy"
"76633",2,2,0,4,"dummy"
"76638",0,3,0,3,"dummy"
"76641",0,0,2,2,"dummy"
"76642",0,0,3,3,"dummy"
"76643",3,3,1,7,"dummy"
"76644",3,2,1,6,"dummy"
"76645",0,0,1,1,"dummy"
"76646",0,0,1,1,"dummy"
"76649",4,5,2,11,"dummy"
"76650",1,0,0,1,"dummy"
"76651",0,0,8,8,"dummy"
"76652",0,3,1,4,"dummy"
"76653",0,1,1,2,"dummy"
"76654",2,9,0,11,"dummy"
"76657",3,1,1,5,"dummy"
"76669",0,0,0,0,"dummy"
"76673",0,0,1,1,"dummy"
"76688",0,0,0,0,"dummy"
"76689",0,0,0,0,"dummy"
"76690",0,0,0,0,"dummy"
"76691",0,0,0,0,"dummy"
"76697",0,1,0,1,"dummy"
"76591",0,0,4,4,"dummy"
"76592",0,5,3,8,"dummy"
"76593",17,17,7,41,"dummy"
"76594",2,2,0,4,"dummy"
"76595",0,1,3,4,"dummy"
"76596",0,0,8,8,"dummy"
"76597",1,1,0,2,"dummy"
"76625",0,0,1,1,"dummy"
"76626",0,0,1,1,"dummy"
"76627",4,4,0,8,"dummy"
"76630",0,1,0,1,"dummy"
"76631",0,4,1,5,"dummy"
"76661",0,1,0,1,"dummy"
"76662",0,0,1,1,"dummy"
"76663",0,0,3,3,"dummy"
"76664",0,3,0,3,"dummy"
"76665",0,4,0,4,"dummy"
"76666",2,0,1,3,"dummy"
"76667",1,1,0,2,"dummy"
"76671",0,1,0,1,"dummy"
"76675",0,0,1,1,"dummy"
"76678",1,4,1,6,"dummy"
"76679",8,5,3,16,"dummy"
"76680",2,5,2,9,"dummy"
"76681",0,1,0,1,"dummy"
"76682",3,9,0,12,"dummy"
"76683",1,0,0,1,"dummy"
"76686",0,1,0,1,"dummy"
"76693",0,1,0,1,"dummy"
"76699",1,0,0,1,"dummy"
"76702",1,0,0,1,"dummy"
"76705",1,1,0,2,"dummy"
"76706",1,1,5,7,"dummy"
"76707",1,0,5,6,"dummy"
"76721",11,1,0,12,"dummy"
"76722",0,2,0,2,"dummy"
"76732",2,0,3,5,"dummy"
"76737",0,0,1,1,"dummy"
"76738",2,0,0,2,"dummy"
"76751",0,0,1,1,"dummy"
"76711",2,4,0,6,"dummy"
"76712",0,2,0,2,"dummy"
"76713",0,2,0,2,"dummy"
"76714",10,2,0,12,"dummy"
"76715",0,2,0,2,"dummy"
"76716",0,0,0,0,"dummy"
"76717",0,0,3,3,"dummy"
"76718",0,5,0,5,"dummy"
"76719",1,0,1,2,"dummy"
"76724",2,0,0,2,"dummy"
"76725",0,2,0,2,"dummy"
"76726",0,1,0,1,"dummy"
"76727",0,0,1,1,"dummy"
"76728",6,7,1,14,"dummy"
"76729",0,2,0,2,"dummy"
"76730",0,0,1,1,"dummy"
"76734",0,3,0,3,"dummy"
"76735",9,7,3,19,"dummy"
"76740",0,0,1,1,"dummy"
"76745",0,1,0,1,"dummy"
"76757",0,2,0,2,"dummy"
"76758",0,0,2,2,"dummy"
"76780",0,1,0,1,"dummy"
"76783",0,0,1,1,"dummy"
"76785",0,0,0,0,"dummy"
"76786",0,2,0,2,"dummy"
"76788",0,0,1,1,"dummy"
"76790",0,2,0,2,"dummy"
"76792",0,1,0,1,"dummy"
"76793",0,1,0,1,"dummy"
"76794",0,0,1,1,"dummy"
"76795",1,1,0,2,"dummy"
"76796",0,1,1,2,"dummy"
"76798",0,0,0,0,"dummy"
"76799",0,0,2,2,"dummy"
"76800",0,0,2,2,"dummy"
"76802",0,0,1,1,"dummy"
"76809",5,9,1,15,"dummy"
"76810",0,1,0,1,"dummy"
"76811",3,0,0,3,"dummy"
"76812",0,1,0,1,"dummy"
"76813",3,9,0,12,"dummy"
"76814",0,0,5,5,"dummy"
"76816",0,2,0,2,"dummy"
"76819",0,3,1,4,"dummy"
"76820",0,2,0,2,"dummy"
"76821",0,0,1,1,"dummy"
"76822",2,9,0,11,"dummy"
"76823",0,1,0,1,"dummy"
"76824",0,1,0,1,"dummy"
"76825",0,2,0,2,"dummy"
"76826",2,0,0,2,"dummy"
"76827",14,9,5,28,"dummy"
"76828",4,5,4,13,"dummy"
"76829",1,1,0,2,"dummy"
"76830",0,4,0,4,"dummy"
"76831",6,3,1,10,"dummy"
"76833",0,0,1,1,"dummy"
"76834",0,0,1,1,"dummy"
"76836",0,2,0,2,"dummy"
"76837",1,1,0,2,"dummy"
"76838",0,4,0,4,"dummy"
"76839",1,0,0,1,"dummy"
"76840",2,5,0,7,"dummy"
"76845",5,1,1,7,"dummy"
"76848",0,7,4,11,"dummy"
"76851",0,0,3,3,"dummy"
"76852",0,7,4,11,"dummy"
"76853",0,0,2,2,"dummy"
"76854",0,0,3,3,"dummy"
"76855",0,0,1,1,"dummy"
"76856",0,1,1,2,"dummy"
"76857",0,0,1,1,"dummy"
"76858",0,1,0,1,"dummy"
"76859",0,0,1,1,"dummy"
"76860",0,0,1,1,"dummy"
"76891",0,0,1,1,"dummy"
"76892",0,0,1,1,"dummy"
"76893",0,5,1,6,"dummy"
"76894",0,2,0,2,"dummy"
"76895",0,0,3,3,"dummy"
"76896",0,1,0,1,"dummy"
"76897",0,1,0,1,"dummy"
"76898",0,1,0,1,"dummy"
"76899",0,3,0,3,"dummy"
"76900",0,0,1,1,"dummy"
"76901",0,1,0,1,"dummy"
"76938",1,1,0,2,"dummy"
"76941",0,0,1,1,"dummy"
"76942",0,0,1,1,"dummy"
"76943",0,2,0,2,"dummy"
"76944",0,1,0,1,"dummy"
"76945",2,7,2,11,"dummy"
"76946",5,8,0,13,"dummy"
"76947",2,0,0,2,"dummy"
"76948",0,1,0,1,"dummy"
"76950",0,1,0,1,"dummy"
"76953",2,1,0,3,"dummy"
"76956",15,24,4,43,"dummy"
"76959",0,1,0,1,"dummy"
"76960",1,0,0,1,"dummy"
"76961",2,12,2,16,"dummy"
"76965",2,2,0,4,"dummy"
"76966",3,3,0,6,"dummy"
"76967",0,8,2,10,"dummy"
"76968",11,3,0,14,"dummy"
"76969",3,3,0,6,"dummy"
"76970",0,1,0,1,"dummy"
"76971",0,3,0,3,"dummy"
"76972",0,2,0,2,"dummy"
"76973",0,1,0,1,"dummy"
"76976",0,1,0,1,"dummy"
"76977",0,1,0,1,"dummy"
"76981",0,1,0,1,"dummy"
"76983",0,1,0,1,"dummy"
"76984",0,0,2,2,"dummy"
"76989",3,8,1,12,"dummy"
"76990",1,0,3,4,"dummy"
"76991",0,2,0,2,"dummy"
"76992",0,0,0,0,"dummy"
"76993",0,3,0,3,"dummy"
"76994",8,0,0,8,"dummy"
"76997",2,4,0,6,"dummy"
"77001",0,7,0,7,"dummy"
"77002",5,0,0,5,"dummy"
"77003",1,13,0,14,"dummy"
"77004",13,5,0,18,"dummy"
"77005",1,13,0,14,"dummy"
"77006",0,0,1,1,"dummy"
"77007",3,1,0,4,"dummy"
"77008",0,0,0,0,"dummy"
"77009",0,0,0,0,"dummy"
"77010",0,0,0,0,"dummy"
"77011",0,0,1,1,"dummy"
"77012",13,15,0,28,"dummy"
"77013",0,0,2,2,"dummy"
"77014",0,0,1,1,"dummy"
"77015",0,0,1,1,"dummy"
"77016",0,0,1,1,"dummy"
"77017",0,0,3,3,"dummy"
"77018",0,0,1,1,"dummy"
"77019",5,3,0,8,"dummy"
"77020",1,3,0,4,"dummy"
"77021",0,1,0,1,"dummy"
"77022",5,1,0,6,"dummy"
"77023",0,0,2,2,"dummy"
"77024",0,0,1,1,"dummy"
"77025",0,0,0,0,"dummy"
"77026",0,0,0,0,"dummy"
"77027",0,0,0,0,"dummy"
"77028",0,0,0,0,"dummy"
"77029",0,0,0,0,"dummy"
"77030",1,5,1,7,"dummy"
"77055",2,0,3,5,"dummy"
"77142",2,0,3,5,"dummy"
"77145",0,1,2,3,"dummy"
"77146",0,0,0,0,"dummy"
"77147",0,1,0,1,"dummy"
"77148",4,0,2,6,"dummy"
"77149",1,0,0,1,"dummy"
"77150",0,0,0,0,"dummy"
"77151",0,0,0,0,"dummy"
"77162",0,1,0,1,"dummy"
"77165",2,1,4,7,"dummy"
"77166",6,6,7,19,"dummy"
"77167",0,0,1,1,"dummy"
"77170",0,0,0,0,"dummy"
"77171",0,0,1,1,"dummy"
"77174",0,0,0,0,"dummy"
"77177",0,0,1,1,"dummy"
"77178",0,1,1,2,"dummy"
"77179",0,1,0,1,"dummy"
"77180",0,0,1,1,"dummy"
"77181",0,12,2,14,"dummy"
"77184",1,0,0,1,"dummy"
"77185",1,1,0,2,"dummy"
"77186",1,0,0,1,"dummy"
"77187",0,0,1,1,"dummy"
"77188",0,0,1,1,"dummy"
"77189",0,1,0,1,"dummy"
"77192",0,1,0,1,"dummy"
"77193",0,0,7,7,"dummy"
"77223",21,0,0,21,"dummy"
"77228",0,1,0,1,"dummy"
"77263",4,1,0,5,"dummy"
"77266",4,0,2,6,"dummy"
"77267",0,2,0,2,"dummy"
"77312",0,0,0,0,"dummy"
"76999",0,0,0,0,"dummy"
"77132",0,1,0,1,"dummy"
"77133",0,2,0,2,"dummy"
"77134",2,1,1,4,"dummy"
"77135",4,4,0,8,"dummy"
"77138",2,0,0,2,"dummy"
"77139",0,3,0,3,"dummy"
"77140",0,3,0,3,"dummy"
"77160",0,1,0,1,"dummy"
"77195",18,10,1,29,"dummy"
"77196",2,2,0,4,"dummy"
"77197",4,4,0,8,"dummy"
"77198",0,0,1,1,"dummy"
"77199",3,5,0,8,"dummy"
"77230",3,11,1,15,"dummy"
"77231",0,0,1,1,"dummy"
"77232",0,1,0,1,"dummy"
"77233",0,1,0,1,"dummy"
"77234",1,0,1,2,"dummy"
"77235",0,0,1,1,"dummy"
"77236",12,4,1,17,"dummy"
"77237",0,0,0,0,"dummy"
"77238",2,0,0,2,"dummy"
"77239",2,12,1,15,"dummy"
"77240",2,22,1,25,"dummy"
"77241",1,1,0,2,"dummy"
"77242",0,0,0,0,"dummy"
"77243",0,0,0,0,"dummy"
"77244",0,1,0,1,"dummy"
"77245",2,3,1,6,"dummy"
"77246",0,1,0,1,"dummy"
"77247",1,0,0,1,"dummy"
"77248",0,1,0,1,"dummy"
"77249",1,0,0,1,"dummy"
"77250",3,2,1,6,"dummy"
"77251",0,0,2,2,"dummy"
"77252",9,2,3,14,"dummy"
"77255",1,3,2,6,"dummy"
"77256",0,1,0,1,"dummy"
"77259",0,0,2,2,"dummy"
"77260",0,0,2,2,"dummy"
"77261",0,0,1,1,"dummy"
"77287",3,3,0,6,"dummy"
"77288",2,2,0,4,"dummy"
"77289",1,1,0,2,"dummy"
"77290",0,3,0,3,"dummy"
"77291",0,0,1,1,"dummy"
"77292",2,0,1,3,"dummy"
"77293",1,0,0,1,"dummy"
"77294",2,1,0,3,"dummy"
"77295",1,1,0,2,"dummy"
"77296",1,1,0,2,"dummy"
"77297",1,2,0,3,"dummy"
"77298",1,1,0,2,"dummy"
"77299",1,1,0,2,"dummy"
"77300",1,1,0,2,"dummy"
"77301",3,2,0,5,"dummy"
"77302",6,3,0,9,"dummy"
"77303",0,2,0,2,"dummy"
"77308",0,1,0,1,"dummy"
"77329",0,1,1,2,"dummy"
"77332",0,0,2,2,"dummy"
"77317",0,1,0,1,"dummy"
"77318",0,0,1,1,"dummy"
"77319",0,0,1,1,"dummy"
"77320",0,0,1,1,"dummy"
"77321",0,0,1,1,"dummy"
"77322",0,0,1,1,"dummy"
"77323",0,0,1,1,"dummy"
"77324",0,0,1,1,"dummy"
"77325",0,0,7,7,"dummy"
"77326",4,7,4,15,"dummy"
"77327",0,0,1,1,"dummy"
"77340",4,0,0,4,"dummy"
"77347",0,0,1,1,"dummy"
"77348",0,0,0,0,"dummy"
"77370",3,2,1,6,"dummy"
"77391",2,8,2,12,"dummy"
"77392",2,2,1,5,"dummy"
"77393",0,0,1,1,"dummy"
"77397",1,0,0,1,"dummy"
"77398",5,5,0,10,"dummy"
"77399",1,0,0,1,"dummy"
"77402",1,3,0,4,"dummy"
"77403",0,3,0,3,"dummy"
"77404",0,0,3,3,"dummy"
"77410",3,2,0,5,"dummy"
"77425",6,2,3,11,"dummy"
"77437",0,0,0,0,"dummy"
"77438",2,0,0,2,"dummy"
"77439",0,0,0,0,"dummy"
"77473",0,31,0,31,"dummy"
"77474",0,0,1,1,"dummy"
"77475",7,7,0,14,"dummy"
"77481",0,4,0,4,"dummy"
"77482",0,7,0,7,"dummy"
"77483",0,0,0,0,"dummy"
"77484",0,0,1,1,"dummy"
"77490",2,0,4,6,"dummy"
"77493",0,2,0,2,"dummy"
"77496",1,6,0,7,"dummy"
"77497",5,2,1,8,"dummy"
"77498",4,0,1,5,"dummy"
"77501",0,0,1,1,"dummy"
"77502",0,4,1,5,"dummy"
"77507",0,0,1,1,"dummy"
"77523",1,5,1,7,"dummy"
"77538",0,0,1,1,"dummy"
"77539",0,0,0,0,"dummy"
"77540",0,5,0,5,"dummy"
"77541",0,4,1,5,"dummy"
"77542",1,1,0,2,"dummy"
"77543",0,1,0,1,"dummy"
"77547",0,13,2,15,"dummy"
"77555",0,0,1,1,"dummy"
"77560",0,2,0,2,"dummy"
"77603",0,1,0,1,"dummy"
"77604",0,0,0,0,"dummy"
"77611",1,0,0,1,"dummy"
"77612",66,4,4,74,"dummy"
"77613",0,0,1,1,"dummy"
"77614",0,1,0,1,"dummy"
"77344",0,0,2,2,"dummy"
"77345",0,0,1,1,"dummy"
"77352",2,6,5,13,"dummy"
"77353",2,2,1,5,"dummy"
"77354",0,0,1,1,"dummy"
"77355",2,0,0,2,"dummy"
"77356",0,1,0,1,"dummy"
"77357",0,0,1,1,"dummy"
"77358",1,2,3,6,"dummy"
"77359",0,1,0,1,"dummy"
"77360",0,1,0,1,"dummy"
"77361",1,0,0,1,"dummy"
"77362",1,2,0,3,"dummy"
"77363",4,0,0,4,"dummy"
"77364",0,2,0,2,"dummy"
"77365",3,0,0,3,"dummy"
"77366",0,1,0,1,"dummy"
"77367",2,1,0,3,"dummy"
"77368",0,0,1,1,"dummy"
"77379",1,0,1,2,"dummy"
"77380",0,1,0,1,"dummy"
"77381",0,1,0,1,"dummy"
"77382",0,0,2,2,"dummy"
"77383",0,0,0,0,"dummy"
"77384",0,2,0,2,"dummy"
"77385",0,1,0,1,"dummy"
"77386",0,1,0,1,"dummy"
"77387",0,4,2,6,"dummy"
"77388",0,1,0,1,"dummy"
"77389",0,1,0,1,"dummy"
"77395",1,0,0,1,"dummy"
"77406",0,1,0,1,"dummy"
"77414",0,1,0,1,"dummy"
"77415",1,0,0,1,"dummy"
"77416",1,4,0,5,"dummy"
"77417",0,3,2,5,"dummy"
"77418",0,1,0,1,"dummy"
"77419",0,0,1,1,"dummy"
"77420",0,0,1,1,"dummy"
"77421",2,17,0,19,"dummy"
"77427",1,3,1,5,"dummy"
"77430",2,0,1,3,"dummy"
"77431",0,0,2,2,"dummy"
"77432",0,0,0,0,"dummy"
"77433",0,1,2,3,"dummy"
"77434",2,3,0,5,"dummy"
"77435",8,1,1,10,"dummy"
"77441",3,8,4,15,"dummy"
"77444",0,0,0,0,"dummy"
"77445",0,0,0,0,"dummy"
"77446",0,0,0,0,"dummy"
"77447",0,0,0,0,"dummy"
"77450",0,0,0,0,"dummy"
"77453",0,0,1,1,"dummy"
"77454",0,0,3,3,"dummy"
"77455",0,0,3,3,"dummy"
"77456",0,0,4,4,"dummy"
"77457",2,3,1,6,"dummy"
"77460",2,15,1,18,"dummy"
"77461",3,0,0,3,"dummy"
"77462",18,5,3,26,"dummy"
"77463",1,1,2,4,"dummy"
"77464",0,0,0,0,"dummy"
"77465",0,0,0,0,"dummy"
"77466",3,3,0,6,"dummy"
"77467",0,1,0,1,"dummy"
"77468",0,1,0,1,"dummy"
"77469",0,0,0,0,"dummy"
"77470",1,1,0,2,"dummy"
"77471",1,0,0,1,"dummy"
"77479",1,0,0,1,"dummy"
"77488",1,2,1,4,"dummy"
"77509",1,3,1,5,"dummy"
"77510",0,3,1,4,"dummy"
"77525",0,0,2,2,"dummy"
"77530",0,0,1,1,"dummy"
"77531",0,1,0,1,"dummy"
"77532",5,5,0,10,"dummy"
"77533",0,2,0,2,"dummy"
"77536",4,0,2,6,"dummy"
"77545",0,0,1,1,"dummy"
"77551",1,1,0,2,"dummy"
"77601",15,1,5,21,"dummy"
"77606",0,0,0,0,"dummy"
"77607",0,7,0,7,"dummy"
"77608",0,7,2,9,"dummy"
"77609",11,0,0,11,"dummy"
"77620",1,2,1,4,"dummy"
"77621",0,1,1,2,"dummy"
"77622",0,0,1,1,"dummy"
"77623",0,5,3,8,"dummy"
"77645",1,2,0,3,"dummy"
"77646",0,2,0,2,"dummy"
"77653",1,2,0,3,"dummy"
"77656",1,0,0,1,"dummy"
"77679",0,0,1,1,"dummy"
"77680",0,1,0,1,"dummy"
"77681",0,1,3,4,"dummy"
"77689",0,2,0,2,"dummy"
"77700",1,2,7,10,"dummy"
"77701",0,2,0,2,"dummy"
"77702",2,2,5,9,"dummy"
"77703",2,2,5,9,"dummy"
"77709",0,1,1,2,"dummy"
"77710",0,1,0,1,"dummy"
"77711",0,2,0,2,"dummy"
"77712",0,1,0,1,"dummy"
"77713",3,0,0,3,"dummy"
"77717",1,7,0,8,"dummy"
"77718",4,12,2,18,"dummy"
"77719",1,3,0,4,"dummy"
"77720",9,7,0,16,"dummy"
"77721",1,1,0,2,"dummy"
"77732",0,0,1,1,"dummy"
"77733",0,0,1,1,"dummy"
"77734",0,0,1,1,"dummy"
"77735",0,0,1,1,"dummy"
"77736",0,0,1,1,"dummy"
"77737",0,0,1,1,"dummy"
"77738",0,0,1,1,"dummy"
"77739",0,0,1,1,"dummy"
"77740",0,0,1,1,"dummy"
"77741",0,0,1,1,"dummy"
"77744",1,0,0,1,"dummy"
"77754",0,1,0,1,"dummy"
"77755",0,0,1,1,"dummy"
"77615",0,17,0,17,"dummy"
"77616",1,1,1,3,"dummy"
"77617",0,4,0,4,"dummy"
"77618",0,2,0,2,"dummy"
"77625",0,1,0,1,"dummy"
"77626",0,1,0,1,"dummy"
"77627",0,1,0,1,"dummy"
"77637",0,1,0,1,"dummy"
"77640",0,2,0,2,"dummy"
"77643",0,0,0,0,"dummy"
"77660",2,1,0,3,"dummy"
"77661",0,2,0,2,"dummy"
"77662",3,1,1,5,"dummy"
"77663",0,1,0,1,"dummy"
"77664",7,12,1,20,"dummy"
"77665",1,5,0,6,"dummy"
"77666",1,1,0,2,"dummy"
"77667",16,5,2,23,"dummy"
"77668",5,20,1,26,"dummy"
"77669",2,2,1,5,"dummy"
"77670",15,4,1,20,"dummy"
"77677",0,2,0,2,"dummy"
"77687",11,6,1,18,"dummy"
"77691",0,1,0,1,"dummy"
"77692",0,2,0,2,"dummy"
"77693",0,2,0,2,"dummy"
"77694",6,4,0,10,"dummy"
"77695",0,0,0,0,"dummy"
"77696",0,0,1,1,"dummy"
"77697",2,1,0,3,"dummy"
"77698",1,0,0,1,"dummy"
"77705",0,1,0,1,"dummy"
"77715",0,0,1,1,"dummy"
"77723",0,3,0,3,"dummy"
"77724",0,0,0,0,"dummy"
"77725",0,0,0,0,"dummy"
"77726",0,0,0,0,"dummy"
"77727",0,0,0,0,"dummy"
"77728",2,0,0,2,"dummy"
"77729",0,6,0,6,"dummy"
"77730",0,1,0,1,"dummy"
"77760",0,1,0,1,"dummy"
"77762",4,19,2,25,"dummy"
"77767",0,0,2,2,"dummy"
"77770",0,1,0,1,"dummy"
"77773",4,2,1,7,"dummy"
"77776",2,1,3,6,"dummy"
"77777",1,2,3,6,"dummy"
"77778",0,1,1,2,"dummy"
"77779",5,4,1,10,"dummy"
"77781",2,0,3,5,"dummy"
"77782",1,0,0,1,"dummy"
"77783",0,1,0,1,"dummy"
"77784",0,1,1,2,"dummy"
"77787",32,12,1,45,"dummy"
"77788",0,2,0,2,"dummy"
"77790",0,2,0,2,"dummy"
"77791",0,0,0,0,"dummy"
"77792",0,1,0,1,"dummy"
"77794",0,2,4,6,"dummy"
"77796",0,1,2,3,"dummy"
"77797",2,2,1,5,"dummy"
"77798",2,2,0,4,"dummy"
"77799",0,1,0,1,"dummy"
"77800",0,0,1,1,"dummy"
"77803",4,7,0,11,"dummy"
"77808",1,0,0,1,"dummy"
"77817",2,0,0,2,"dummy"
"77818",0,8,1,9,"dummy"
"77819",0,0,1,1,"dummy"
"77820",0,0,1,1,"dummy"
"77821",0,2,0,2,"dummy"
"77822",0,0,3,3,"dummy"
"77823",0,0,3,3,"dummy"
"77824",0,0,3,3,"dummy"
"77825",0,0,1,1,"dummy"
"77826",1,4,0,5,"dummy"
"77827",0,0,1,1,"dummy"
"77828",0,0,1,1,"dummy"
"77831",1,0,0,1,"dummy"
"77832",4,38,3,45,"dummy"
"77833",4,1,0,5,"dummy"
"77834",0,0,0,0,"dummy"
"77835",8,12,0,20,"dummy"
"77836",0,0,0,0,"dummy"
"77837",0,1,0,1,"dummy"
"77838",2,2,0,4,"dummy"
"77839",0,0,1,1,"dummy"
"77840",0,7,0,7,"dummy"
"77841",0,2,0,2,"dummy"
"77842",1,0,0,1,"dummy"
"77843",1,1,0,2,"dummy"
"77844",0,2,0,2,"dummy"
"77845",39,5,5,49,"dummy"
"77854",2,3,0,5,"dummy"
"77855",0,1,0,1,"dummy"
"77856",1,8,0,9,"dummy"
"77857",0,2,0,2,"dummy"
"77858",0,0,1,1,"dummy"
"77859",0,0,2,2,"dummy"
"77860",0,0,3,3,"dummy"
"77861",0,2,0,2,"dummy"
"77862",0,0,1,1,"dummy"
"77863",0,1,0,1,"dummy"
"77864",1,4,0,5,"dummy"
"77865",0,0,1,1,"dummy"
"77866",0,0,1,1,"dummy"
"77867",0,0,1,1,"dummy"
"77870",0,0,0,0,"dummy"
"77871",5,0,0,5,"dummy"
"77883",0,0,2,2,"dummy"
"77884",0,5,0,5,"dummy"
"77885",1,0,0,1,"dummy"
"77886",0,2,0,2,"dummy"
"77887",0,1,0,1,"dummy"
"77897",0,0,0,0,"dummy"
"77900",0,1,0,1,"dummy"
"77941",0,0,0,0,"dummy"
"77942",1,0,1,2,"dummy"
"77943",0,0,1,1,"dummy"
"77971",0,1,0,1,"dummy"
"77972",0,1,0,1,"dummy"
"77979",0,1,0,1,"dummy"
"77806",0,0,1,1,"dummy"
"77814",6,0,0,6,"dummy"
"77815",2,5,2,9,"dummy"
"77849",0,0,0,0,"dummy"
"77850",0,1,0,1,"dummy"
"77881",0,1,1,2,"dummy"
"77889",0,0,2,2,"dummy"
"77890",0,0,1,1,"dummy"
"77891",0,1,1,2,"dummy"
"77892",0,0,1,1,"dummy"
"77893",0,0,1,1,"dummy"
"77894",0,0,1,1,"dummy"
"77895",0,0,1,1,"dummy"
"77902",5,6,2,13,"dummy"
"77903",6,5,2,13,"dummy"
"77945",0,3,4,7,"dummy"
"77946",1,0,0,1,"dummy"
"77947",0,5,0,5,"dummy"
"77948",0,0,1,1,"dummy"
"77949",0,0,1,1,"dummy"
"77950",0,6,0,6,"dummy"
"77951",0,0,1,1,"dummy"
"77952",0,0,1,1,"dummy"
"77953",3,2,0,5,"dummy"
"77954",0,1,0,1,"dummy"
"77955",0,0,1,1,"dummy"
"77956",0,1,1,2,"dummy"
"77957",0,0,1,1,"dummy"
"77958",0,0,1,1,"dummy"
"77959",0,0,1,1,"dummy"
"77960",0,0,1,1,"dummy"
"77961",0,0,1,1,"dummy"
"77962",0,1,0,1,"dummy"
"77963",0,0,1,1,"dummy"
"77964",1,1,1,3,"dummy"
"77967",0,2,0,2,"dummy"
"77968",2,0,0,2,"dummy"
"77969",1,1,1,3,"dummy"
"77974",0,2,1,3,"dummy"
"77975",0,1,0,1,"dummy"
"77976",1,0,0,1,"dummy"
"77977",0,1,0,1,"dummy"
"77981",0,0,1,1,"dummy"
"77989",1,1,0,2,"dummy"
"77990",0,1,0,1,"dummy"
"77991",0,0,1,1,"dummy"
"77992",0,0,1,1,"dummy"
"78059",0,0,0,0,"dummy"
"78060",0,0,0,0,"dummy"
"78107",0,1,0,1,"dummy"
"78108",0,1,1,2,"dummy"
"78109",10,2,0,12,"dummy"
"78110",0,0,1,1,"dummy"
"78111",0,0,2,2,"dummy"
"78112",0,1,0,1,"dummy"
"78157",0,1,2,3,"dummy"
"78158",0,1,0,1,"dummy"
"78159",0,0,1,1,"dummy"
"77983",3,20,0,23,"dummy"
"77984",16,3,0,19,"dummy"
"77985",3,1,0,4,"dummy"
"77986",0,1,1,2,"dummy"
"77987",4,0,0,4,"dummy"
"78007",0,0,1,1,"dummy"
"78008",0,0,1,1,"dummy"
"78009",0,1,0,1,"dummy"
"78010",2,2,0,4,"dummy"
"78011",0,0,1,1,"dummy"
"78012",2,2,0,4,"dummy"
"78013",0,1,0,1,"dummy"
"78014",0,1,0,1,"dummy"
"78015",0,0,1,1,"dummy"
"78016",1,0,0,1,"dummy"
"78017",1,1,2,4,"dummy"
"78018",0,0,1,1,"dummy"
"78019",2,0,0,2,"dummy"
"78020",0,0,1,1,"dummy"
"78021",0,0,1,1,"dummy"
"78022",0,0,1,1,"dummy"
"78023",0,0,1,1,"dummy"
"78024",0,0,1,1,"dummy"
"78025",0,0,1,1,"dummy"
"78026",0,0,1,1,"dummy"
"78027",0,1,1,2,"dummy"
"78028",0,0,1,1,"dummy"
"78029",0,2,1,3,"dummy"
"78030",1,2,0,3,"dummy"
"78031",4,1,0,5,"dummy"
"78032",0,1,0,1,"dummy"
"78033",1,2,0,3,"dummy"
"78034",0,0,1,1,"dummy"
"78035",0,1,1,2,"dummy"
"78036",0,0,1,1,"dummy"
"78037",0,0,2,2,"dummy"
"78038",0,0,1,1,"dummy"
"78039",3,1,1,5,"dummy"
"78040",0,0,1,1,"dummy"
"78041",0,0,1,1,"dummy"
"78042",0,0,1,1,"dummy"
"78043",3,2,2,7,"dummy"
"78044",0,0,1,1,"dummy"
"78045",0,0,2,2,"dummy"
"78046",0,0,1,1,"dummy"
"78047",1,0,0,1,"dummy"
"78048",1,1,0,2,"dummy"
"78049",0,0,1,1,"dummy"
"78050",0,0,1,1,"dummy"
"78051",0,0,2,2,"dummy"
"78052",0,0,1,1,"dummy"
"78053",1,2,0,3,"dummy"
"78054",0,0,1,1,"dummy"
"78055",0,0,1,1,"dummy"
"78056",0,1,1,2,"dummy"
"78057",0,0,1,1,"dummy"
"78062",14,5,4,23,"dummy"
"78063",0,1,0,1,"dummy"
"78064",0,5,0,5,"dummy"
"78065",0,2,0,2,"dummy"
"78066",0,1,0,1,"dummy"
"78067",0,1,0,1,"dummy"
"78089",1,0,1,2,"dummy"
"78090",5,0,3,8,"dummy"
"78091",1,1,0,2,"dummy"
"78096",0,3,0,3,"dummy"
"78097",0,3,0,3,"dummy"
"78100",0,0,0,0,"dummy"
"78101",0,0,1,1,"dummy"
"78102",0,0,1,1,"dummy"
"78103",0,0,0,0,"dummy"
"78104",3,9,1,13,"dummy"
"78105",0,0,0,0,"dummy"
"78114",0,3,0,3,"dummy"
"78115",0,3,2,5,"dummy"
"78116",0,0,1,1,"dummy"
"78117",1,2,1,4,"dummy"
"78118",20,29,3,52,"dummy"
"78119",11,5,4,20,"dummy"
"78120",0,0,0,0,"dummy"
"78121",1,17,1,19,"dummy"
"78122",2,2,0,4,"dummy"
"78123",0,2,0,2,"dummy"
"78124",1,1,0,2,"dummy"
"78125",0,1,0,1,"dummy"
"78126",0,1,0,1,"dummy"
"78127",1,2,0,3,"dummy"
"78128",0,0,1,1,"dummy"
"78129",13,13,3,29,"dummy"
"78130",0,1,0,1,"dummy"
"78131",2,7,0,9,"dummy"
"78132",0,2,0,2,"dummy"
"78133",0,0,1,1,"dummy"
"78134",5,13,2,20,"dummy"
"78135",0,6,0,6,"dummy"
"78136",1,1,0,2,"dummy"
"78137",11,1,0,12,"dummy"
"78138",1,7,0,8,"dummy"
"78139",0,5,0,5,"dummy"
"78140",1,11,0,12,"dummy"
"78141",2,2,0,4,"dummy"
"78142",12,0,1,13,"dummy"
"78143",5,0,0,5,"dummy"
"78144",0,0,0,0,"dummy"
"78145",0,1,1,2,"dummy"
"78146",0,0,5,5,"dummy"
"78147",0,0,1,1,"dummy"
"78148",0,1,0,1,"dummy"
"78149",3,2,0,5,"dummy"
"78150",0,5,0,5,"dummy"
"78151",0,23,0,23,"dummy"
"78152",0,2,3,5,"dummy"
"78153",42,6,3,51,"dummy"
"78154",8,8,0,16,"dummy"
"78155",0,0,4,4,"dummy"
"78170",0,1,0,1,"dummy"
"78171",0,0,1,1,"dummy"
"78172",0,0,1,1,"dummy"
"78173",0,0,1,1,"dummy"
"78174",0,0,1,1,"dummy"
"78181",19,1,1,21,"dummy"
"78182",1,0,1,2,"dummy"
"78185",0,0,1,1,"dummy"
"78187",0,3,0,3,"dummy"
"78189",6,10,0,16,"dummy"
"78190",0,1,0,1,"dummy"
"78194",0,5,1,6,"dummy"
"78195",5,4,3,12,"dummy"
"78196",0,1,1,2,"dummy"
"78207",11,3,9,23,"dummy"
"78234",7,4,1,12,"dummy"
"78236",0,0,0,0,"dummy"
"78237",0,0,0,0,"dummy"
"78238",0,0,0,0,"dummy"
"78240",0,0,1,1,"dummy"
"78241",0,4,0,4,"dummy"
"78242",2,2,1,5,"dummy"
"78243",0,3,2,5,"dummy"
"78244",3,1,1,5,"dummy"
"78245",1,0,1,2,"dummy"
"78246",0,0,1,1,"dummy"
"78247",0,0,2,2,"dummy"
"78248",0,0,1,1,"dummy"
"78249",0,1,0,1,"dummy"
"78250",0,1,0,1,"dummy"
"78251",1,0,0,1,"dummy"
"78256",0,3,0,3,"dummy"
"78273",0,2,0,2,"dummy"
"78274",1,10,1,12,"dummy"
"78275",1,1,0,2,"dummy"
"78276",0,1,0,1,"dummy"
"78277",7,2,0,9,"dummy"
"78278",0,1,0,1,"dummy"
"78279",0,0,1,1,"dummy"
"78280",0,0,2,2,"dummy"
"78284",0,0,1,1,"dummy"
"78285",0,2,0,2,"dummy"
"78287",0,0,1,1,"dummy"
"78290",1,6,0,7,"dummy"
"78292",0,10,2,12,"dummy"
"78293",3,7,2,12,"dummy"
"78294",0,1,0,1,"dummy"
"78295",0,1,0,1,"dummy"
"78296",0,0,0,0,"dummy"
"78297",0,0,0,0,"dummy"
"78298",0,0,2,2,"dummy"
"78299",10,1,2,13,"dummy"
"78300",0,1,0,1,"dummy"
"78301",0,0,3,3,"dummy"
"78302",0,0,1,1,"dummy"
"78304",0,0,0,0,"dummy"
"78305",0,0,0,0,"dummy"
"78306",1,1,0,2,"dummy"
"78307",0,0,0,0,"dummy"
"78309",0,0,1,1,"dummy"
"78310",3,19,2,24,"dummy"
"78311",1,4,0,5,"dummy"
"78312",0,0,1,1,"dummy"
"78313",0,0,0,0,"dummy"
"78314",0,0,1,1,"dummy"
"78315",0,0,0,0,"dummy"
"78316",0,0,0,0,"dummy"
"78317",0,0,1,1,"dummy"
"78318",7,0,0,7,"dummy"
"78319",10,1,2,13,"dummy"
"78321",0,0,1,1,"dummy"
"78322",0,0,1,1,"dummy"
"78323",1,10,1,12,"dummy"
"78328",0,1,0,1,"dummy"
"78329",6,4,1,11,"dummy"
"78330",1,2,0,3,"dummy"
"78331",3,2,1,6,"dummy"
"78332",5,5,3,13,"dummy"
"78334",0,1,0,1,"dummy"
"78335",0,1,0,1,"dummy"
"78336",0,2,0,2,"dummy"
"78341",0,9,0,9,"dummy"
"78342",3,0,0,3,"dummy"
"78343",1,0,0,1,"dummy"
"78344",0,0,0,0,"dummy"
"78345",9,1,0,10,"dummy"
"78351",0,0,1,1,"dummy"
"78356",0,1,0,1,"dummy"
"78357",0,0,0,0,"dummy"
"78367",0,0,3,3,"dummy"
"78368",9,17,5,31,"dummy"
"78369",3,1,0,4,"dummy"
"78370",8,3,0,11,"dummy"
"78371",0,3,0,3,"dummy"
"78373",0,0,0,0,"dummy"
"78374",0,0,1,1,"dummy"
"78375",0,0,1,1,"dummy"
"78376",0,0,1,1,"dummy"
"78378",0,1,1,2,"dummy"
"78380",0,11,1,12,"dummy"
"78384",0,1,0,1,"dummy"
"78385",0,0,7,7,"dummy"
"78387",0,0,2,2,"dummy"
"78388",0,0,1,1,"dummy"
"78389",0,0,1,1,"dummy"
"78390",0,1,0,1,"dummy"
"78391",0,2,0,2,"dummy"
"78392",2,0,0,2,"dummy"
"78393",8,0,1,9,"dummy"
"78394",0,0,0,0,"dummy"
"78395",0,0,0,0,"dummy"
"78396",0,0,0,0,"dummy"
"78399",0,0,1,1,"dummy"
"78400",0,0,4,4,"dummy"
"78401",0,0,1,1,"dummy"
"78404",3,7,1,11,"dummy"
"78405",1,6,1,8,"dummy"
"78408",0,0,1,1,"dummy"
"78409",0,0,1,1,"dummy"
"78410",0,0,1,1,"dummy"
"78411",2,0,6,8,"dummy"
"78412",0,0,1,1,"dummy"
"78413",0,0,1,1,"dummy"
"78414",0,0,1,1,"dummy"
"78415",0,0,1,1,"dummy"
"78417",0,0,1,1,"dummy"
"78418",0,0,0,0,"dummy"
"78422",0,1,0,1,"dummy"
"78426",0,26,0,26,"dummy"
"78427",1,4,3,8,"dummy"
"78428",0,0,2,2,"dummy"
"78429",0,0,2,2,"dummy"
"78430",0,0,1,1,"dummy"
"78431",0,0,1,1,"dummy"
"78432",0,0,1,1,"dummy"
"78433",0,0,0,0,"dummy"
"78434",1,1,0,2,"dummy"
"78435",1,1,0,2,"dummy"
"78439",1,0,0,1,"dummy"
"78440",2,4,0,6,"dummy"
"78442",0,1,1,2,"dummy"
"78443",0,0,2,2,"dummy"
"78448",0,0,1,1,"dummy"
"78451",1,3,0,4,"dummy"
"78454",0,1,0,1,"dummy"
"78455",2,0,0,2,"dummy"
"78456",1,2,1,4,"dummy"
"78457",1,3,0,4,"dummy"
"78458",8,7,2,17,"dummy"
"78459",4,2,0,6,"dummy"
"78460",0,1,1,2,"dummy"
"78462",0,0,4,4,"dummy"
"78463",0,8,4,12,"dummy"
"78467",0,0,1,1,"dummy"
"78468",2,0,0,2,"dummy"
"78469",1,3,0,4,"dummy"
"78471",16,54,4,74,"dummy"
"78472",0,0,1,1,"dummy"
"78473",0,1,0,1,"dummy"
"78474",0,3,0,3,"dummy"
"78475",0,2,0,2,"dummy"
"78476",0,4,0,4,"dummy"
"78477",0,0,1,1,"dummy"
"78478",0,3,0,3,"dummy"
"78479",6,0,0,6,"dummy"
"78480",1,0,0,1,"dummy"
"78481",0,6,2,8,"dummy"
"78499",0,2,0,2,"dummy"
"78500",0,1,0,1,"dummy"
"78501",0,0,4,4,"dummy"
"78502",0,1,0,1,"dummy"
"78503",0,1,0,1,"dummy"
"78504",1,0,0,1,"dummy"
"78505",0,0,5,5,"dummy"
"78507",0,0,0,0,"dummy"
"78508",0,3,0,3,"dummy"
"78509",0,0,1,1,"dummy"
"78510",1,1,0,2,"dummy"
"78511",3,0,0,3,"dummy"
"78513",0,5,0,5,"dummy"
"78514",6,4,0,10,"dummy"
"78518",9,3,1,13,"dummy"
"78532",1,0,0,1,"dummy"
"78536",0,1,0,1,"dummy"
"78537",2,0,0,2,"dummy"
"78543",2,4,0,6,"dummy"
"78544",0,2,0,2,"dummy"
"78545",0,2,0,2,"dummy"
"78546",10,2,0,12,"dummy"
"78547",0,2,0,2,"dummy"
"78550",0,0,0,0,"dummy"
"78552",0,0,1,1,"dummy"
"78554",0,0,1,1,"dummy"
"78556",0,1,2,3,"dummy"
"78557",0,0,0,0,"dummy"
"78558",0,1,0,1,"dummy"
"78559",4,0,2,6,"dummy"
"78560",1,0,0,1,"dummy"
"78561",0,0,0,0,"dummy"
"78562",0,0,0,0,"dummy"
"78588",3,4,1,8,"dummy"
"78589",3,4,1,8,"dummy"
"78591",1,3,1,5,"dummy"
"78593",2,5,0,7,"dummy"
"78594",0,0,0,0,"dummy"
"78595",0,1,0,1,"dummy"
"78596",0,0,1,1,"dummy"
"78597",8,9,0,17,"dummy"
"78599",0,2,0,2,"dummy"
"78600",0,1,0,1,"dummy"
"78601",0,3,0,3,"dummy"
"78602",3,1,0,4,"dummy"
"78603",0,3,0,3,"dummy"
"78605",0,2,3,5,"dummy"
"78606",0,10,2,12,"dummy"
"78607",0,0,1,1,"dummy"
"78608",0,6,0,6,"dummy"
"78609",0,3,0,3,"dummy"
"78610",0,0,1,1,"dummy"
"78611",0,0,2,2,"dummy"
"78612",0,1,1,2,"dummy"
"78613",0,0,1,1,"dummy"
"78614",0,0,1,1,"dummy"
"78615",0,1,2,3,"dummy"
"78626",0,0,1,1,"dummy"
"78627",0,0,1,1,"dummy"
"78628",0,0,1,1,"dummy"
"78629",0,0,2,2,"dummy"
"78631",1,0,0,1,"dummy"
"78633",0,1,4,5,"dummy"
"78634",0,0,1,1,"dummy"
"78635",0,0,1,1,"dummy"
"78636",2,1,0,3,"dummy"
"78637",0,0,1,1,"dummy"
"78640",0,4,0,4,"dummy"
"78641",1,4,0,5,"dummy"
"78642",0,0,2,2,"dummy"
"78643",0,0,1,1,"dummy"
"78648",5,10,4,19,"dummy"
"78649",0,0,3,3,"dummy"
"78666",0,0,3,3,"dummy"
"78667",0,0,1,1,"dummy"
"78668",0,0,1,1,"dummy"
"78669",0,0,1,1,"dummy"
"78670",0,0,1,1,"dummy"
"78671",0,0,1,1,"dummy"
"78672",0,1,4,5,"dummy"
"78673",0,0,1,1,"dummy"
"78675",0,0,1,1,"dummy"
"78676",1,2,0,3,"dummy"
"78677",0,0,4,4,"dummy"
"78678",0,2,4,6,"dummy"
"78679",0,0,2,2,"dummy"
"78680",0,0,1,1,"dummy"
"78681",0,0,1,1,"dummy"
"78682",0,0,1,1,"dummy"
"78703",2,13,2,17,"dummy"
"78704",1,6,1,8,"dummy"
"78708",3,0,0,3,"dummy"
"78727",0,2,1,3,"dummy"
"78730",0,1,0,1,"dummy"
"78733",1,5,1,7,"dummy"
"78747",0,2,0,2,"dummy"
"78748",0,0,1,1,"dummy"
"78749",0,2,1,3,"dummy"
"78750",0,1,0,1,"dummy"
"78813",2,3,0,5,"dummy"
"78828",0,1,1,2,"dummy"
"78840",3,3,1,7,"dummy"
"78841",3,3,1,7,"dummy"
"78842",0,1,0,1,"dummy"
"78843",11,9,2,22,"dummy"
"78844",0,0,2,2,"dummy"
"78845",0,0,2,2,"dummy"
"78850",1,13,1,15,"dummy"
"78855",0,4,0,4,"dummy"
"78856",4,0,0,4,"dummy"
"78857",0,4,0,4,"dummy"
"78858",0,0,1,1,"dummy"
"78861",6,6,1,13,"dummy"
"78884",1,3,0,4,"dummy"
"78894",0,0,1,1,"dummy"
"78895",2,2,0,4,"dummy"
"78905",0,0,0,0,"dummy"
"78906",0,0,0,0,"dummy"
"78907",0,3,0,3,"dummy"
"78908",7,24,0,31,"dummy"
"78909",4,0,0,4,"dummy"
"78910",0,1,0,1,"dummy"
"78911",3,8,2,13,"dummy"
"78912",9,1,0,10,"dummy"
"78913",2,7,3,12,"dummy"
"78914",0,1,0,1,"dummy"
"78915",0,3,0,3,"dummy"
"78930",13,8,2,23,"dummy"
"78931",0,0,0,0,"dummy"
"78932",0,6,0,6,"dummy"
"78933",1,0,0,1,"dummy"
"78934",0,0,0,0,"dummy"
"78943",0,1,0,1,"dummy"
"78944",0,1,0,1,"dummy"
"78945",0,0,3,3,"dummy"
"78946",0,0,2,2,"dummy"
"78947",0,0,1,1,"dummy"
"78948",0,0,0,0,"dummy"
"78949",0,0,2,2,"dummy"
"78950",4,9,1,14,"dummy"
"78951",0,1,0,1,"dummy"
"78957",1,4,1,6,"dummy"
"78962",1,1,0,2,"dummy"
"78706",1,0,0,1,"dummy"
"78742",0,1,0,1,"dummy"
"78743",1,0,0,1,"dummy"
"78754",11,4,1,16,"dummy"
"78755",2,21,3,26,"dummy"
"78756",22,17,5,44,"dummy"
"78757",11,13,2,26,"dummy"
"78758",3,3,5,11,"dummy"
"78759",0,5,1,6,"dummy"
"78760",0,3,0,3,"dummy"
"78777",0,3,0,3,"dummy"
"78778",0,1,0,1,"dummy"
"78779",0,0,2,2,"dummy"
"78803",2,0,0,2,"dummy"
"78804",2,2,0,4,"dummy"
"78805",0,0,0,0,"dummy"
"78806",0,1,0,1,"dummy"
"78811",0,0,0,0,"dummy"
"78815",1,1,2,4,"dummy"
"78822",4,8,1,13,"dummy"
"78830",1,3,2,6,"dummy"
"78831",0,0,1,1,"dummy"
"78832",1,5,0,6,"dummy"
"78833",1,0,0,1,"dummy"
"78886",0,2,0,2,"dummy"
"78887",0,1,0,1,"dummy"
"78888",3,6,0,9,"dummy"
"78889",2,0,0,2,"dummy"
"78890",0,1,0,1,"dummy"
"78897",0,0,0,0,"dummy"
"78898",0,5,0,5,"dummy"
"78899",0,1,1,2,"dummy"
"78900",0,0,3,3,"dummy"
"78901",0,0,1,1,"dummy"
"78902",3,4,1,8,"dummy"
"78903",4,4,2,10,"dummy"
"78936",5,0,0,5,"dummy"
"78937",3,8,0,11,"dummy"
"78938",3,4,1,8,"dummy"
"78939",3,3,0,6,"dummy"
"78940",0,0,1,1,"dummy"
"78941",5,0,0,5,"dummy"
"78953",0,0,1,1,"dummy"
"78954",0,0,1,1,"dummy"
"78955",0,0,1,1,"dummy"
"78964",12,4,3,19,"dummy"
"78965",1,7,3,11,"dummy"
"78966",0,0,0,0,"dummy"
"78967",0,1,0,1,"dummy"
"78968",8,1,0,9,"dummy"
"78969",0,0,0,0,"dummy"
"78970",0,0,0,0,"dummy"
"78971",1,10,0,11,"dummy"
"78972",7,1,0,8,"dummy"
"78973",2,0,3,5,"dummy"
"79008",2,0,0,2,"dummy"
"79024",0,11,0,11,"dummy"
"79028",0,1,1,2,"dummy"
"79016",0,0,1,1,"dummy"
"79017",0,0,1,1,"dummy"
"79018",0,0,1,1,"dummy"
"79019",0,0,1,1,"dummy"
"79020",0,0,1,1,"dummy"
"79021",0,0,1,1,"dummy"
"79022",0,0,1,1,"dummy"
"79026",2,2,0,4,"dummy"
"79030",19,1,2,22,"dummy"
"79031",0,2,0,2,"dummy"
"79032",0,8,1,9,"dummy"
"79033",0,4,0,4,"dummy"
"79034",0,0,1,1,"dummy"
"79035",6,3,0,9,"dummy"
"79036",1,1,0,2,"dummy"
"79037",0,3,1,4,"dummy"
"79038",0,0,1,1,"dummy"
"79039",0,0,1,1,"dummy"
"79040",0,0,1,1,"dummy"
"79041",0,1,2,3,"dummy"
"79042",0,0,1,1,"dummy"
"79043",0,1,0,1,"dummy"
"79044",0,0,1,1,"dummy"
"79045",0,0,1,1,"dummy"
"79046",0,0,1,1,"dummy"
"79047",0,0,1,1,"dummy"
"79054",1,3,2,6,"dummy"
"79055",0,0,1,1,"dummy"
"79085",0,1,0,1,"dummy"
"79086",0,7,0,7,"dummy"
"79087",1,1,1,3,"dummy"
"79090",0,0,1,1,"dummy"
"79103",0,2,0,2,"dummy"
"79115",0,0,3,3,"dummy"
"79131",1,1,0,2,"dummy"
"79149",0,1,0,1,"dummy"
"79150",0,0,2,2,"dummy"
"79151",0,1,2,3,"dummy"
"79152",0,1,0,1,"dummy"
"79153",0,0,3,3,"dummy"
"79154",2,0,2,4,"dummy"
"79155",0,3,1,4,"dummy"
"79156",8,0,1,9,"dummy"
"79157",2,1,1,4,"dummy"
"79158",0,1,0,1,"dummy"
"79159",1,0,0,1,"dummy"
"79164",0,1,0,1,"dummy"
"79192",0,0,2,2,"dummy"
"79196",0,2,0,2,"dummy"
"79197",0,2,0,2,"dummy"
"79198",0,8,0,8,"dummy"
"79199",0,0,0,0,"dummy"
"79200",0,2,0,2,"dummy"
"79201",0,1,0,1,"dummy"
"79057",0,1,0,1,"dummy"
"79060",0,1,0,1,"dummy"
"79061",2,0,0,2,"dummy"
"79062",1,0,0,1,"dummy"
"79063",0,0,0,0,"dummy"
"79064",0,0,0,0,"dummy"
"79065",0,0,0,0,"dummy"
"79076",1,1,0,2,"dummy"
"79077",1,0,0,1,"dummy"
"79080",0,1,0,1,"dummy"
"79081",4,0,2,6,"dummy"
"79107",0,0,1,1,"dummy"
"79108",0,1,1,2,"dummy"
"79109",0,0,1,1,"dummy"
"79110",0,0,0,0,"dummy"
"79111",0,0,0,0,"dummy"
"79112",0,0,1,1,"dummy"
"79113",0,0,0,0,"dummy"
"79117",18,8,2,28,"dummy"
"79118",2,3,1,6,"dummy"
"79119",0,0,0,0,"dummy"
"79120",0,0,0,0,"dummy"
"79121",0,0,0,0,"dummy"
"79122",0,0,0,0,"dummy"
"79123",0,0,1,1,"dummy"
"79124",0,0,1,1,"dummy"
"79125",0,0,1,1,"dummy"
"79126",5,0,2,7,"dummy"
"79127",0,0,1,1,"dummy"
"79128",6,0,4,10,"dummy"
"79129",0,0,1,1,"dummy"
"79133",5,1,0,6,"dummy"
"79134",0,7,0,7,"dummy"
"79135",0,5,0,5,"dummy"
"79136",2,2,1,5,"dummy"
"79141",0,0,0,0,"dummy"
"79142",1,2,1,4,"dummy"
"79143",0,0,2,2,"dummy"
"79144",3,0,2,5,"dummy"
"79145",1,2,0,3,"dummy"
"79146",0,0,1,1,"dummy"
"79147",0,0,2,2,"dummy"
"79161",0,1,0,1,"dummy"
"79162",1,3,3,7,"dummy"
"79171",0,1,0,1,"dummy"
"79178",0,14,0,14,"dummy"
"79179",0,2,0,2,"dummy"
"79180",0,0,0,0,"dummy"
"79183",0,4,1,5,"dummy"
"79184",0,0,0,0,"dummy"
"79194",1,0,1,2,"dummy"
"79205",0,0,1,1,"dummy"
"79206",0,0,1,1,"dummy"
"79207",0,0,1,1,"dummy"
"79212",0,0,1,1,"dummy"
"79216",2,12,0,14,"dummy"
"79217",1,1,0,2,"dummy"
"79236",1,2,0,3,"dummy"
"79248",0,0,1,1,"dummy"
"79254",4,0,0,4,"dummy"
"79255",0,0,1,1,"dummy"
"79258",0,8,1,9,"dummy"
"79265",3,1,2,6,"dummy"
"79202",1,1,2,4,"dummy"
"79203",1,2,3,6,"dummy"
"79214",0,1,0,1,"dummy"
"79219",0,0,1,1,"dummy"
"79220",2,2,0,4,"dummy"
"79221",0,0,1,1,"dummy"
"79222",14,12,3,29,"dummy"
"79223",0,0,1,1,"dummy"
"79224",0,2,6,8,"dummy"
"79225",0,1,0,1,"dummy"
"79226",0,1,5,6,"dummy"
"79227",1,0,0,1,"dummy"
"79228",0,1,0,1,"dummy"
"79229",0,1,0,1,"dummy"
"79230",0,1,0,1,"dummy"
"79233",0,0,1,1,"dummy"
"79234",0,1,0,1,"dummy"
"79246",0,0,1,1,"dummy"
"79250",0,0,1,1,"dummy"
"79251",0,2,0,2,"dummy"
"79252",1,0,0,1,"dummy"
"79260",0,3,0,3,"dummy"
"79261",0,0,1,1,"dummy"
"79267",0,0,0,0,"dummy"
"79278",0,1,0,1,"dummy"
"79279",0,2,0,2,"dummy"
"79284",2,0,1,3,"dummy"
"79285",0,1,0,1,"dummy"
"79286",0,0,0,0,"dummy"
"79290",3,16,2,21,"dummy"
"79291",2,15,0,17,"dummy"
"79292",0,2,0,2,"dummy"
"79293",0,2,0,2,"dummy"
"79294",0,1,0,1,"dummy"
"79295",0,0,1,1,"dummy"
"79296",4,0,1,5,"dummy"
"79303",1,0,0,1,"dummy"
"79304",0,0,1,1,"dummy"
"79305",6,11,4,21,"dummy"
"79306",3,2,0,5,"dummy"
"79307",2,1,0,3,"dummy"
"79313",0,0,1,1,"dummy"
"79314",5,2,4,11,"dummy"
"79315",8,19,2,29,"dummy"
"79320",0,0,0,0,"dummy"
"79321",1,3,1,5,"dummy"
"79326",0,0,1,1,"dummy"
"79327",0,1,0,1,"dummy"
"79330",3,40,0,43,"dummy"
"79331",1,0,0,1,"dummy"
"79332",2,8,1,11,"dummy"
"79333",1,3,0,4,"dummy"
"79334",2,8,1,11,"dummy"
"79335",0,1,0,1,"dummy"
"79336",1,0,2,3,"dummy"
"79337",0,0,0,0,"dummy"
"79338",1,5,0,6,"dummy"
"79339",0,3,1,4,"dummy"
"79340",1,0,0,1,"dummy"
"79341",2,0,0,2,"dummy"
"79342",0,1,1,2,"dummy"
"79343",8,7,0,15,"dummy"
"79344",1,1,0,2,"dummy"
"79345",4,4,0,8,"dummy"
"79346",0,1,0,1,"dummy"
"79347",0,16,0,16,"dummy"
"79348",0,1,0,1,"dummy"
"79349",2,3,0,5,"dummy"
"79350",3,0,1,4,"dummy"
"79351",0,1,0,1,"dummy"
"79352",0,0,1,1,"dummy"
"79353",0,1,0,1,"dummy"
"79354",2,2,0,4,"dummy"
"79355",3,2,1,6,"dummy"
"79356",14,1,0,15,"dummy"
"79357",0,0,1,1,"dummy"
"79358",0,1,0,1,"dummy"
"79359",1,3,0,4,"dummy"
"79360",0,0,1,1,"dummy"
"79361",7,11,0,18,"dummy"
"79362",3,0,0,3,"dummy"
"79288",0,1,0,1,"dummy"
"79311",1,1,0,2,"dummy"
"79363",0,1,0,1,"dummy"
"79364",1,3,0,4,"dummy"
"79365",2,4,1,7,"dummy"
"79366",0,0,0,0,"dummy"
"79367",0,1,0,1,"dummy"
"79368",10,9,3,22,"dummy"
"79369",0,0,1,1,"dummy"
"79370",13,7,0,20,"dummy"
"79371",0,0,1,1,"dummy"
"79372",11,4,0,15,"dummy"
"79373",8,0,0,8,"dummy"
"79374",17,19,7,43,"dummy"
"79375",2,1,0,3,"dummy"
"79376",1,0,0,1,"dummy"
"79377",0,4,0,4,"dummy"
"79378",1,1,10,12,"dummy"
"79379",0,0,0,0,"dummy"
"79380",1,3,2,6,"dummy"
"79381",6,31,4,41,"dummy"
"79382",22,0,6,28,"dummy"
"79383",0,0,0,0,"dummy"
"79386",4,4,2,10,"dummy"
"79387",1,3,0,4,"dummy"
"79392",1,6,2,9,"dummy"
"79394",6,1,1,8,"dummy"
"79395",0,0,0,0,"dummy"
"79397",2,0,0,2,"dummy"
"79398",0,0,0,0,"dummy"
"79400",0,2,0,2,"dummy"
"79401",1,0,0,1,"dummy"
"79406",0,1,0,1,"dummy"
"79410",0,7,0,7,"dummy"
"79411",0,2,0,2,"dummy"
"79412",12,0,0,12,"dummy"
"79413",1,0,1,2,"dummy"
"79415",8,8,3,19,"dummy"
"79416",1,3,2,6,"dummy"
"79418",1,1,0,2,"dummy"
"79419",0,0,1,1,"dummy"
"79420",3,5,0,8,"dummy"
"79421",1,0,0,1,"dummy"
"79422",0,1,0,1,"dummy"
"79423",3,1,1,5,"dummy"
"79424",0,1,0,1,"dummy"
"79425",0,0,1,1,"dummy"
"79426",0,0,1,1,"dummy"
"79428",0,1,0,1,"dummy"
"79429",0,1,0,1,"dummy"
"79431",4,0,0,4,"dummy"
"79436",0,1,0,1,"dummy"
"79445",0,1,0,1,"dummy"
"79446",1,2,1,4,"dummy"
"79448",0,0,0,0,"dummy"
"79449",1,3,1,5,"dummy"
"79453",0,0,1,1,"dummy"
"79454",24,6,1,31,"dummy"
"79458",0,2,0,2,"dummy"
"79460",0,1,0,1,"dummy"
"79461",0,0,0,0,"dummy"
"79462",1,0,1,2,"dummy"
"79463",0,0,0,0,"dummy"
"79464",0,1,0,1,"dummy"
"79465",0,0,0,0,"dummy"
"79466",0,2,0,2,"dummy"
"79471",0,4,0,4,"dummy"
"79472",0,1,0,1,"dummy"
"79473",0,2,0,2,"dummy"
"79474",0,0,1,1,"dummy"
"79475",0,2,0,2,"dummy"
"79476",1,0,0,1,"dummy"
"79477",0,3,0,3,"dummy"
"79479",0,0,1,1,"dummy"
"79480",2,7,3,12,"dummy"
"79481",0,9,3,12,"dummy"
"79482",0,0,5,5,"dummy"
"79484",2,12,6,20,"dummy"
"79485",0,2,1,3,"dummy"
"79486",0,1,1,2,"dummy"
"79487",1,1,0,2,"dummy"
"79490",0,0,0,0,"dummy"
"79491",0,0,0,0,"dummy"
"79493",1,10,0,11,"dummy"
"79516",0,3,0,3,"dummy"
"79517",0,4,0,4,"dummy"
"79518",10,10,0,20,"dummy"
"79519",0,4,0,4,"dummy"
"79522",0,0,2,2,"dummy"
"79523",2,1,0,3,"dummy"
"79524",3,2,0,5,"dummy"
"79525",3,7,0,10,"dummy"
"79526",0,0,0,0,"dummy"
"79527",0,0,7,7,"dummy"
"79528",0,0,1,1,"dummy"
"79531",6,0,0,6,"dummy"
"79532",1,0,0,1,"dummy"
"79533",3,0,0,3,"dummy"
"79534",0,1,0,1,"dummy"
"79535",0,0,1,1,"dummy"
"79538",0,2,1,3,"dummy"
"79539",0,0,1,1,"dummy"
"79541",0,1,0,1,"dummy"
"79542",0,5,1,6,"dummy"
"79543",7,9,1,17,"dummy"
"79545",0,3,0,3,"dummy"
"79547",0,3,1,4,"dummy"
"79548",2,0,1,3,"dummy"
"79549",0,1,0,1,"dummy"
"79550",0,0,1,1,"dummy"
"79551",0,1,0,1,"dummy"
"79552",0,0,0,0,"dummy"
"79555",0,2,1,3,"dummy"
"79556",0,0,3,3,"dummy"
"79557",2,1,3,6,"dummy"
"79558",0,3,3,6,"dummy"
"79559",0,2,3,5,"dummy"
"79560",2,6,0,8,"dummy"
"79562",1,0,1,2,"dummy"
"79564",0,0,1,1,"dummy"
"79565",0,2,1,3,"dummy"
"79567",1,2,1,4,"dummy"
"79568",0,1,0,1,"dummy"
"79570",11,0,0,11,"dummy"
"79571",0,4,0,4,"dummy"
"79574",3,4,1,8,"dummy"
"79578",0,0,1,1,"dummy"
"79580",7,2,0,9,"dummy"
"79581",0,1,0,1,"dummy"
"79582",8,14,1,23,"dummy"
"79583",4,2,0,6,"dummy"
"79584",4,11,0,15,"dummy"
"79585",0,2,0,2,"dummy"
"79587",0,1,0,1,"dummy"
"79591",2,1,0,3,"dummy"
"79593",2,0,0,2,"dummy"
"79594",0,7,0,7,"dummy"
"79595",2,0,3,5,"dummy"
"79600",0,2,0,2,"dummy"
"79601",5,4,3,12,"dummy"
"79602",0,1,0,1,"dummy"
"79606",0,1,0,1,"dummy"
"79607",0,3,0,3,"dummy"
"79608",0,1,0,1,"dummy"
"79609",2,4,1,7,"dummy"
"79613",0,0,1,1,"dummy"
"79618",0,0,1,1,"dummy"
"79619",0,0,0,0,"dummy"
"79626",2,1,1,4,"dummy"
"79627",1,0,1,2,"dummy"
"79628",0,0,1,1,"dummy"
"79633",0,5,2,7,"dummy"
"79634",0,0,3,3,"dummy"
"79635",0,2,0,2,"dummy"
"79637",3,0,0,3,"dummy"
"79640",0,0,0,0,"dummy"
"79641",0,0,1,1,"dummy"
"79644",2,5,0,7,"dummy"
"79645",2,8,0,10,"dummy"
"79646",0,3,0,3,"dummy"
"79647",0,3,0,3,"dummy"
"79648",0,8,0,8,"dummy"
"79649",0,1,0,1,"dummy"
"79650",7,2,0,9,"dummy"
"79651",0,1,0,1,"dummy"
"79663",2,4,0,6,"dummy"
"79664",2,1,0,3,"dummy"
"79665",0,0,1,1,"dummy"
"79669",0,0,1,1,"dummy"
"79670",1,0,0,1,"dummy"
"79673",1,0,0,1,"dummy"
"79674",0,1,0,1,"dummy"
"79675",0,0,0,0,"dummy"
"79676",1,0,3,4,"dummy"
"79677",1,0,0,1,"dummy"
"79678",0,1,0,1,"dummy"
"79679",0,1,0,1,"dummy"
"79680",0,1,1,2,"dummy"
"79681",0,1,0,1,"dummy"
"79685",0,1,0,1,"dummy"
"79686",0,0,0,0,"dummy"
"79688",0,0,2,2,"dummy"
"79689",0,7,0,7,"dummy"
"79690",0,14,0,14,"dummy"
"79691",7,0,0,7,"dummy"
"79692",2,2,2,6,"dummy"
"79693",0,0,2,2,"dummy"
"79694",0,0,2,2,"dummy"
"79695",5,3,1,9,"dummy"
"79697",1,0,0,1,"dummy"
"79698",0,1,0,1,"dummy"
"79699",0,0,2,2,"dummy"
"79701",0,0,1,1,"dummy"
"79702",0,0,3,3,"dummy"
"79705",3,6,4,13,"dummy"
"79707",0,4,0,4,"dummy"
"79708",0,0,1,1,"dummy"
"79709",0,0,1,1,"dummy"
"79710",0,0,1,1,"dummy"
"79711",0,0,1,1,"dummy"
"79712",0,0,1,1,"dummy"
"79713",2,0,0,2,"dummy"
"79714",0,0,1,1,"dummy"
"79715",0,0,1,1,"dummy"
"79716",0,0,1,1,"dummy"
"79717",0,0,1,1,"dummy"
"79718",0,0,1,1,"dummy"
"79719",0,0,1,1,"dummy"
"79720",0,0,1,1,"dummy"
"79723",4,0,1,5,"dummy"
"79727",2,0,0,2,"dummy"
"79747",2,8,3,13,"dummy"
"79748",0,0,2,2,"dummy"
"79749",2,2,1,5,"dummy"
"79750",0,0,4,4,"dummy"
"79751",0,0,1,1,"dummy"
"79752",2,0,0,2,"dummy"
"79753",0,3,1,4,"dummy"
"79754",0,1,0,1,"dummy"
"79755",0,0,1,1,"dummy"
"79756",0,0,1,1,"dummy"
"79757",0,2,1,3,"dummy"
"79767",3,3,5,11,"dummy"
"79768",2,0,2,4,"dummy"
"79769",0,1,0,1,"dummy"
"79770",0,0,1,1,"dummy"
"79771",0,2,0,2,"dummy"
"79772",0,0,1,1,"dummy"
"79773",0,0,1,1,"dummy"
"79774",0,1,0,1,"dummy"
"79775",0,2,0,2,"dummy"
"79776",1,4,0,5,"dummy"
"79777",0,4,0,4,"dummy"
"79778",0,1,0,1,"dummy"
"79779",0,2,0,2,"dummy"
"79788",0,2,0,2,"dummy"
"79789",0,1,0,1,"dummy"
"79790",1,1,0,2,"dummy"
"79794",2,0,0,2,"dummy"
"79795",0,2,0,2,"dummy"
"79796",0,3,1,4,"dummy"
"79797",0,0,1,1,"dummy"
"79798",0,2,0,2,"dummy"
"79799",3,6,1,10,"dummy"
"79800",0,1,0,1,"dummy"
"79801",3,4,0,7,"dummy"
"79802",0,2,0,2,"dummy"
"79803",1,0,0,1,"dummy"
"79815",1,0,0,1,"dummy"
"79816",2,0,1,3,"dummy"
"79817",0,0,0,0,"dummy"
"79818",0,1,0,1,"dummy"
"79819",8,1,0,9,"dummy"
"79820",0,0,0,0,"dummy"
"79821",0,0,0,0,"dummy"
"79822",1,10,0,11,"dummy"
"79823",7,1,0,8,"dummy"
"79824",2,0,3,5,"dummy"
"79834",0,0,1,1,"dummy"
"79835",10,9,2,21,"dummy"
"79836",0,1,0,1,"dummy"
"79837",0,1,0,1,"dummy"
"79840",0,0,3,3,"dummy"
"79848",0,0,1,1,"dummy"
"79849",2,1,1,4,"dummy"
"79850",0,0,1,1,"dummy"
"79857",0,0,0,0,"dummy"
"79858",0,0,1,1,"dummy"
"79859",0,2,0,2,"dummy"
"79860",0,0,0,0,"dummy"
"79861",4,4,0,8,"dummy"
"79862",0,0,1,1,"dummy"
"79884",1,6,1,8,"dummy"
"79920",1,0,0,1,"dummy"
"79953",0,0,2,2,"dummy"
"79954",1,0,2,3,"dummy"
"79985",2,8,2,12,"dummy"
"79986",2,2,1,5,"dummy"
"79987",0,0,1,1,"dummy"
"79991",0,3,1,4,"dummy"
"79725",0,1,0,1,"dummy"
"79729",2,4,0,6,"dummy"
"79730",0,2,0,2,"dummy"
"79731",0,2,0,2,"dummy"
"79732",10,2,0,12,"dummy"
"79733",0,2,0,2,"dummy"
"79734",0,0,0,0,"dummy"
"79735",0,0,3,3,"dummy"
"79736",0,5,0,5,"dummy"
"79737",1,0,1,2,"dummy"
"79742",0,0,0,0,"dummy"
"79745",0,0,2,2,"dummy"
"79759",0,0,1,1,"dummy"
"79760",0,0,1,1,"dummy"
"79761",4,2,0,6,"dummy"
"79762",0,0,1,1,"dummy"
"79763",0,2,0,2,"dummy"
"79764",0,1,0,1,"dummy"
"79765",0,0,1,1,"dummy"
"79781",2,2,0,4,"dummy"
"79782",0,3,0,3,"dummy"
"79783",0,0,2,2,"dummy"
"79784",1,0,0,1,"dummy"
"79785",19,2,3,24,"dummy"
"79786",0,1,0,1,"dummy"
"79792",0,1,0,1,"dummy"
"79807",0,2,0,2,"dummy"
"79808",8,9,3,20,"dummy"
"79809",9,19,2,30,"dummy"
"79810",0,0,1,1,"dummy"
"79811",0,0,0,0,"dummy"
"79812",2,0,0,2,"dummy"
"79813",0,3,1,4,"dummy"
"79830",2,0,0,2,"dummy"
"79831",0,0,0,0,"dummy"
"79832",0,1,1,2,"dummy"
"79852",0,0,1,1,"dummy"
"79853",0,0,1,1,"dummy"
"79854",2,1,0,3,"dummy"
"79855",0,0,1,1,"dummy"
"79864",0,2,0,2,"dummy"
"79865",0,1,1,2,"dummy"
"79866",0,2,0,2,"dummy"
"79867",0,1,2,3,"dummy"
"79868",2,2,1,5,"dummy"
"79882",5,2,4,11,"dummy"
"79886",0,2,0,2,"dummy"
"79887",0,5,0,5,"dummy"
"79888",0,2,0,2,"dummy"
"79889",2,5,0,7,"dummy"
"79890",1,37,0,38,"dummy"
"79891",0,0,1,1,"dummy"
"79892",0,4,0,4,"dummy"
"79893",0,1,1,2,"dummy"
"79894",8,2,0,10,"dummy"
"79895",1,1,0,2,"dummy"
"79896",0,1,0,1,"dummy"
"79897",1,4,0,5,"dummy"
"79898",0,1,0,1,"dummy"
"79899",1,2,0,3,"dummy"
"79900",0,1,0,1,"dummy"
"79901",4,1,0,5,"dummy"
"79902",2,4,0,6,"dummy"
"79903",11,16,2,29,"dummy"
"79904",0,0,1,1,"dummy"
"79905",7,10,0,17,"dummy"
"79906",1,4,0,5,"dummy"
"79907",1,1,0,2,"dummy"
"79908",1,1,0,2,"dummy"
"79909",0,1,0,1,"dummy"
"79910",0,0,0,0,"dummy"
"79926",0,0,1,1,"dummy"
"79927",2,2,0,4,"dummy"
"79930",0,12,3,15,"dummy"
"79931",12,4,3,19,"dummy"
"79932",0,0,3,3,"dummy"
"79933",2,4,2,8,"dummy"
"79934",2,12,3,17,"dummy"
"79935",1,0,0,1,"dummy"
"79936",12,6,2,20,"dummy"
"79937",3,0,2,5,"dummy"
"79938",3,0,0,3,"dummy"
"79939",0,0,0,0,"dummy"
"79940",0,0,1,1,"dummy"
"79941",0,0,2,2,"dummy"
"79942",0,0,2,2,"dummy"
"79943",0,0,1,1,"dummy"
"79944",0,0,1,1,"dummy"
"79947",0,6,0,6,"dummy"
"79948",1,0,0,1,"dummy"
"79949",0,1,0,1,"dummy"
"79960",0,0,2,2,"dummy"
"79961",0,0,1,1,"dummy"
"79962",0,2,0,2,"dummy"
"79975",0,0,0,0,"dummy"
"79976",0,0,1,1,"dummy"
"79977",0,0,0,0,"dummy"
"79980",0,2,0,2,"dummy"
"79983",0,2,0,2,"dummy"
"79989",0,4,2,6,"dummy"
"80065",15,5,2,22,"dummy"
"80066",0,0,2,2,"dummy"
"80067",0,0,2,2,"dummy"
"80070",0,1,0,1,"dummy"
"80071",0,0,1,1,"dummy"
"80072",0,1,0,1,"dummy"
"80073",0,0,2,2,"dummy"
"80074",1,0,1,2,"dummy"
"80084",1,3,0,4,"dummy"
"80085",0,0,1,1,"dummy"
"80086",0,1,0,1,"dummy"
"80089",0,1,0,1,"dummy"
"80092",1,0,0,1,"dummy"
"80093",0,1,0,1,"dummy"
"80094",0,0,0,0,"dummy"
"80095",2,0,0,2,"dummy"
"80096",0,0,0,0,"dummy"
"80102",0,1,0,1,"dummy"
"80103",0,2,0,2,"dummy"
"80106",0,0,0,0,"dummy"
"80122",0,0,0,0,"dummy"
"80123",0,0,0,0,"dummy"
"80124",0,0,1,1,"dummy"
"80125",2,1,0,3,"dummy"
"80126",1,0,0,1,"dummy"
"80127",1,0,0,1,"dummy"
"80128",1,0,0,1,"dummy"
"80129",0,0,0,0,"dummy"
"80130",2,0,0,2,"dummy"
"80131",0,2,1,3,"dummy"
"80132",2,0,0,2,"dummy"
"80133",0,0,1,1,"dummy"
"80134",0,0,0,0,"dummy"
"80135",1,2,0,3,"dummy"
"80136",0,0,0,0,"dummy"
"80137",0,0,0,0,"dummy"
"80204",0,1,1,2,"dummy"
"80207",0,0,2,2,"dummy"
"80208",0,0,1,1,"dummy"
"80209",0,0,1,1,"dummy"
"80210",0,2,0,2,"dummy"
"80213",1,1,2,4,"dummy"
"80214",1,1,0,2,"dummy"
"80221",0,1,0,1,"dummy"
"80246",0,0,1,1,"dummy"
"79994",0,0,1,1,"dummy"
"79995",0,5,2,7,"dummy"
"79996",4,2,0,6,"dummy"
"79999",5,6,1,12,"dummy"
"80002",0,0,0,0,"dummy"
"80005",0,0,2,2,"dummy"
"80016",0,0,1,1,"dummy"
"80017",0,2,1,3,"dummy"
"80018",0,0,2,2,"dummy"
"80019",0,0,1,1,"dummy"
"80020",0,0,0,0,"dummy"
"80021",0,1,0,1,"dummy"
"80022",1,2,0,3,"dummy"
"80023",0,1,0,1,"dummy"
"80024",1,10,1,12,"dummy"
"80025",1,1,0,2,"dummy"
"80026",0,1,0,1,"dummy"
"80027",7,2,0,9,"dummy"
"80028",0,1,0,1,"dummy"
"80029",0,0,1,1,"dummy"
"80030",0,0,1,1,"dummy"
"80031",0,0,2,2,"dummy"
"80032",0,0,1,1,"dummy"
"80037",0,0,1,1,"dummy"
"80038",0,2,0,2,"dummy"
"80039",6,1,0,7,"dummy"
"80040",1,12,1,14,"dummy"
"80041",0,0,1,1,"dummy"
"80042",1,0,0,1,"dummy"
"80043",0,6,0,6,"dummy"
"80044",4,0,2,6,"dummy"
"80045",0,5,0,5,"dummy"
"80046",0,0,0,0,"dummy"
"80047",0,12,0,12,"dummy"
"80048",0,0,1,1,"dummy"
"80049",0,0,0,0,"dummy"
"80050",0,0,0,0,"dummy"
"80051",12,0,1,13,"dummy"
"80052",0,2,0,2,"dummy"
"80053",1,0,0,1,"dummy"
"80054",0,0,2,2,"dummy"
"80055",2,3,2,7,"dummy"
"80056",1,2,0,3,"dummy"
"80057",0,0,0,0,"dummy"
"80058",0,0,0,0,"dummy"
"80059",0,0,0,0,"dummy"
"80060",0,0,2,2,"dummy"
"80061",3,0,0,3,"dummy"
"80062",0,0,2,2,"dummy"
"80063",4,5,0,9,"dummy"
"80082",0,2,3,5,"dummy"
"80113",0,0,1,1,"dummy"
"80116",2,7,0,9,"dummy"
"80117",1,1,0,2,"dummy"
"80118",7,3,0,10,"dummy"
"80119",0,0,1,1,"dummy"
"80120",4,4,0,8,"dummy"
"80141",0,0,1,1,"dummy"
"80142",0,0,1,1,"dummy"
"80143",0,0,1,1,"dummy"
"80144",0,0,1,1,"dummy"
"80145",0,0,1,1,"dummy"
"80146",0,0,1,1,"dummy"
"80147",0,0,1,1,"dummy"
"80148",1,2,3,6,"dummy"
"80149",0,0,1,1,"dummy"
"80150",0,0,1,1,"dummy"
"80151",0,0,1,1,"dummy"
"80152",0,1,0,1,"dummy"
"80153",1,0,1,2,"dummy"
"80154",0,0,1,1,"dummy"
"80155",0,0,1,1,"dummy"
"80156",0,0,1,1,"dummy"
"80157",0,0,1,1,"dummy"
"80158",0,0,1,1,"dummy"
"80159",0,0,1,1,"dummy"
"80160",0,0,1,1,"dummy"
"80161",0,0,1,1,"dummy"
"80162",0,0,2,2,"dummy"
"80163",0,0,1,1,"dummy"
"80164",0,1,0,1,"dummy"
"80165",0,0,1,1,"dummy"
"80166",0,0,1,1,"dummy"
"80167",0,0,1,1,"dummy"
"80168",0,0,1,1,"dummy"
"80169",0,0,1,1,"dummy"
"80170",0,0,1,1,"dummy"
"80171",0,0,1,1,"dummy"
"80172",0,0,1,1,"dummy"
"80173",0,0,1,1,"dummy"
"80174",0,0,1,1,"dummy"
"80175",0,0,1,1,"dummy"
"80176",0,0,1,1,"dummy"
"80177",0,1,0,1,"dummy"
"80178",0,0,1,1,"dummy"
"80179",0,0,1,1,"dummy"
"80180",0,0,1,1,"dummy"
"80181",6,5,0,11,"dummy"
"80182",0,0,1,1,"dummy"
"80183",0,1,0,1,"dummy"
"80184",0,0,1,1,"dummy"
"80185",0,0,1,1,"dummy"
"80186",0,0,1,1,"dummy"
"80187",0,0,1,1,"dummy"
"80188",0,0,1,1,"dummy"
"80189",0,0,1,1,"dummy"
"80190",0,0,1,1,"dummy"
"80191",0,0,1,1,"dummy"
"80192",0,2,0,2,"dummy"
"80193",0,0,1,1,"dummy"
"80194",0,0,1,1,"dummy"
"80195",0,0,1,1,"dummy"
"80196",0,0,1,1,"dummy"
"80216",1,2,0,3,"dummy"
"80217",0,0,1,1,"dummy"
"80218",0,0,1,1,"dummy"
"80219",1,1,0,2,"dummy"
"80223",0,1,0,1,"dummy"
"80228",1,1,3,5,"dummy"
"80229",0,2,0,2,"dummy"
"80230",2,0,0,2,"dummy"
"80231",0,1,0,1,"dummy"
"80232",1,2,0,3,"dummy"
"80233",0,1,0,1,"dummy"
"80234",1,0,0,1,"dummy"
"80235",0,0,1,1,"dummy"
"80236",0,0,3,3,"dummy"
"80237",0,0,2,2,"dummy"
"80238",0,0,1,1,"dummy"
"80239",0,0,4,4,"dummy"
"80240",0,1,1,2,"dummy"
"80241",0,0,3,3,"dummy"
"80242",0,0,2,2,"dummy"
"80243",0,0,1,1,"dummy"
"80244",0,0,2,2,"dummy"
"80248",2,2,0,4,"dummy"
"80253",0,1,0,1,"dummy"
"80254",0,4,0,4,"dummy"
"80270",0,2,2,4,"dummy"
"80271",0,0,1,1,"dummy"
"80272",0,2,0,2,"dummy"
"80293",2,5,2,9,"dummy"
"80306",1,2,0,3,"dummy"
"80307",0,3,0,3,"dummy"
"80308",3,1,0,4,"dummy"
"80309",1,3,1,5,"dummy"
"80310",0,1,0,1,"dummy"
"80311",0,3,0,3,"dummy"
"80312",0,0,1,1,"dummy"
"80329",0,0,1,1,"dummy"
"80330",1,0,0,1,"dummy"
"80333",0,1,0,1,"dummy"
"80351",5,9,3,17,"dummy"
"80352",2,1,0,3,"dummy"
"80353",2,1,0,3,"dummy"
"80354",5,7,1,13,"dummy"
"80355",0,0,1,1,"dummy"
"80356",0,2,0,2,"dummy"
"80357",0,0,1,1,"dummy"
"80366",0,1,0,1,"dummy"
"80367",3,0,1,4,"dummy"
"80368",0,0,1,1,"dummy"
"80369",0,1,1,2,"dummy"
"80370",0,1,0,1,"dummy"
"80256",0,3,0,3,"dummy"
"80257",0,0,0,0,"dummy"
"80260",0,1,0,1,"dummy"
"80261",0,0,3,3,"dummy"
"80262",1,0,1,2,"dummy"
"80263",0,0,1,1,"dummy"
"80266",0,3,0,3,"dummy"
"80267",3,0,0,3,"dummy"
"80268",0,2,0,2,"dummy"
"80274",0,5,0,5,"dummy"
"80275",1,1,0,2,"dummy"
"80276",0,0,0,0,"dummy"
"80277",0,1,0,1,"dummy"
"80278",0,0,1,1,"dummy"
"80279",0,1,0,1,"dummy"
"80280",0,2,0,2,"dummy"
"80281",2,1,0,3,"dummy"
"80282",0,0,0,0,"dummy"
"80283",0,0,1,1,"dummy"
"80284",0,0,3,3,"dummy"
"80285",0,0,1,1,"dummy"
"80286",0,0,1,1,"dummy"
"80287",0,0,1,1,"dummy"
"80288",0,0,1,1,"dummy"
"80289",0,0,1,1,"dummy"
"80290",0,0,2,2,"dummy"
"80291",0,0,1,1,"dummy"
"80295",0,0,0,0,"dummy"
"80316",0,1,1,2,"dummy"
"80317",1,0,1,2,"dummy"
"80318",0,2,0,2,"dummy"
"80319",0,5,0,5,"dummy"
"80320",0,3,1,4,"dummy"
"80321",0,2,1,3,"dummy"
"80322",0,0,1,1,"dummy"
"80327",1,1,0,2,"dummy"
"80335",0,10,0,10,"dummy"
"80336",0,1,0,1,"dummy"
"80337",0,0,0,0,"dummy"
"80347",1,1,0,2,"dummy"
"80348",0,22,0,22,"dummy"
"80349",10,7,5,22,"dummy"
"80359",0,0,1,1,"dummy"
"80360",0,0,1,1,"dummy"
"80361",0,0,2,2,"dummy"
"80362",0,0,1,1,"dummy"
"80363",2,1,0,3,"dummy"
"80364",3,0,0,3,"dummy"
"80372",0,0,2,2,"dummy"
"80373",1,0,1,2,"dummy"
"80374",0,0,1,1,"dummy"
"80375",2,12,1,15,"dummy"
"80376",1,2,0,3,"dummy"
"80379",0,1,0,1,"dummy"
"80385",1,0,0,1,"dummy"
"80388",0,0,1,1,"dummy"
"80389",0,2,0,2,"dummy"
"80390",2,0,0,2,"dummy"
"80397",0,0,0,0,"dummy"
"80398",0,0,0,0,"dummy"
"80399",1,0,0,1,"dummy"
"80406",4,0,0,4,"dummy"
"80407",0,2,0,2,"dummy"
"80408",0,2,0,2,"dummy"
"80409",8,3,2,13,"dummy"
"80412",5,0,0,5,"dummy"
"80413",0,1,0,1,"dummy"
"80414",0,1,0,1,"dummy"
"80415",3,10,1,14,"dummy"
"80416",9,16,2,27,"dummy"
"80417",0,1,0,1,"dummy"
"80418",0,2,0,2,"dummy"
"80419",0,1,0,1,"dummy"
"80420",1,0,0,1,"dummy"
"80421",3,2,0,5,"dummy"
"80422",1,1,0,2,"dummy"
"80425",3,4,0,7,"dummy"
"80430",0,1,0,1,"dummy"
"80431",1,13,0,14,"dummy"
"80432",0,1,0,1,"dummy"
"80433",0,1,0,1,"dummy"
"80434",0,5,0,5,"dummy"
"80381",0,3,0,3,"dummy"
"80382",0,2,1,3,"dummy"
"80383",0,0,0,0,"dummy"
"80392",0,0,1,1,"dummy"
"80395",0,0,0,0,"dummy"
"80403",0,4,0,4,"dummy"
"80404",0,2,0,2,"dummy"
"80427",0,0,1,1,"dummy"
"80428",0,0,0,0,"dummy"
"80446",0,0,0,0,"dummy"
"80447",0,0,0,0,"dummy"
"80448",0,0,0,0,"dummy"
"80449",0,0,1,1,"dummy"
"80450",0,0,0,0,"dummy"
"80451",0,0,1,1,"dummy"
"80458",0,4,0,4,"dummy"
"80459",0,2,1,3,"dummy"
"80477",1,2,0,3,"dummy"
"80482",0,0,1,1,"dummy"
"80483",0,0,0,0,"dummy"
"80486",0,2,2,4,"dummy"
"80497",0,2,0,2,"dummy"
"80498",1,0,0,1,"dummy"
"80499",0,0,2,2,"dummy"
"80500",0,0,1,1,"dummy"
"80501",0,0,1,1,"dummy"
"80502",0,0,2,2,"dummy"
"80503",0,0,1,1,"dummy"
"80504",0,1,3,4,"dummy"
"80505",0,2,0,2,"dummy"
"80506",0,0,1,1,"dummy"
"80507",0,0,1,1,"dummy"
"80508",0,2,0,2,"dummy"
"80509",4,2,0,6,"dummy"
"80510",1,0,0,1,"dummy"
"80511",1,4,0,5,"dummy"
"80512",0,1,0,1,"dummy"
"80513",0,0,1,1,"dummy"
"80514",5,3,0,8,"dummy"
"80515",0,1,0,1,"dummy"
"80516",0,2,0,2,"dummy"
"80517",0,1,0,1,"dummy"
"80521",2,3,0,5,"dummy"
"80522",0,1,0,1,"dummy"
"80523",0,3,0,3,"dummy"
"80524",0,7,3,10,"dummy"
"80531",0,5,3,8,"dummy"
"80532",0,0,1,1,"dummy"
"80533",6,7,1,14,"dummy"
"80534",1,0,0,1,"dummy"
"80535",0,0,1,1,"dummy"
"80536",1,0,1,2,"dummy"
"80537",0,1,1,2,"dummy"
"80538",3,2,0,5,"dummy"
"80539",3,2,1,6,"dummy"
"80540",0,2,0,2,"dummy"
"80541",0,1,1,2,"dummy"
"80542",32,8,0,40,"dummy"
"80543",0,11,1,12,"dummy"
"80544",0,0,1,1,"dummy"
"80545",1,0,0,1,"dummy"
"80546",0,3,0,3,"dummy"
"80565",1,0,0,1,"dummy"
"80566",11,7,0,18,"dummy"
"80567",0,1,0,1,"dummy"
"80568",0,0,1,1,"dummy"
"80569",7,0,0,7,"dummy"
"80570",0,0,0,0,"dummy"
"80453",0,4,0,4,"dummy"
"80454",0,1,0,1,"dummy"
"80455",0,0,1,1,"dummy"
"80456",4,12,0,16,"dummy"
"80461",3,5,1,9,"dummy"
"80462",0,1,0,1,"dummy"
"80463",0,1,1,2,"dummy"
"80464",0,0,1,1,"dummy"
"80465",6,6,7,19,"dummy"
"80466",0,0,1,1,"dummy"
"80467",0,0,0,0,"dummy"
"80468",0,2,0,2,"dummy"
"80469",0,1,0,1,"dummy"
"80472",0,0,2,2,"dummy"
"80473",6,0,1,7,"dummy"
"80479",0,2,0,2,"dummy"
"80480",0,7,0,7,"dummy"
"80488",0,1,0,1,"dummy"
"80489",0,0,2,2,"dummy"
"80490",0,0,0,0,"dummy"
"80493",0,0,0,0,"dummy"
"80519",0,0,0,0,"dummy"
"80550",0,0,2,2,"dummy"
"80551",0,0,1,1,"dummy"
"80552",0,0,1,1,"dummy"
"80553",0,0,1,1,"dummy"
"80554",5,1,1,7,"dummy"
"80555",0,0,1,1,"dummy"
"80556",2,8,1,11,"dummy"
"80557",0,0,1,1,"dummy"
"80558",0,0,2,2,"dummy"
"80559",0,0,1,1,"dummy"
"80560",0,0,1,1,"dummy"
"80561",0,0,1,1,"dummy"
"80562",0,0,4,4,"dummy"
"80563",1,2,0,3,"dummy"
"80574",4,10,0,14,"dummy"
"80575",4,8,3,15,"dummy"
"80576",0,0,0,0,"dummy"
"80624",2,2,0,4,"dummy"
"80625",2,3,0,5,"dummy"
"80579",1,2,0,3,"dummy"
"80581",0,1,0,1,"dummy"
"80582",1,1,0,2,"dummy"
"80584",0,0,1,1,"dummy"
"80585",0,1,2,3,"dummy"
"80587",1,0,1,2,"dummy"
"80588",0,0,0,0,"dummy"
"80589",0,3,2,5,"dummy"
"80590",0,0,3,3,"dummy"
"80591",0,0,1,1,"dummy"
"80593",0,2,0,2,"dummy"
"80595",9,6,4,19,"dummy"
"80600",1,0,0,1,"dummy"
"80601",0,1,1,2,"dummy"
"80602",1,1,0,2,"dummy"
"80607",1,0,0,1,"dummy"
"80608",4,2,2,8,"dummy"
"80616",0,0,1,1,"dummy"
"80617",0,1,0,1,"dummy"
"80618",0,7,0,7,"dummy"
"80619",1,2,0,3,"dummy"
"80620",1,6,0,7,"dummy"
"80621",1,5,0,6,"dummy"
"80622",1,1,0,2,"dummy"
"80623",5,3,0,8,"dummy"
"80626",3,0,1,4,"dummy"
"80627",2,0,0,2,"dummy"
"80628",1,0,0,1,"dummy"
"80629",0,1,0,1,"dummy"
"80630",1,0,0,1,"dummy"
"80631",8,4,0,12,"dummy"
"80632",0,1,0,1,"dummy"
"80633",0,1,0,1,"dummy"
"80634",0,2,1,3,"dummy"
"80635",0,0,1,1,"dummy"
"80636",0,2,0,2,"dummy"
"80637",0,0,0,0,"dummy"
"80638",1,1,0,2,"dummy"
"80639",1,0,1,2,"dummy"
"80640",0,0,1,1,"dummy"
"80641",0,0,1,1,"dummy"
"80642",0,2,0,2,"dummy"
"80643",2,0,2,4,"dummy"
"80644",0,0,2,2,"dummy"
"80647",0,0,1,1,"dummy"
"80648",0,0,1,1,"dummy"
"80649",6,11,1,18,"dummy"
"80650",0,1,0,1,"dummy"
"80651",0,0,1,1,"dummy"
"80652",0,0,1,1,"dummy"
"80653",1,7,1,9,"dummy"
"80654",0,1,2,3,"dummy"
"80655",0,0,2,2,"dummy"
"80656",0,0,1,1,"dummy"
"80657",0,0,0,0,"dummy"
"80661",0,0,0,0,"dummy"
"80662",10,6,2,18,"dummy"
"80665",1,1,0,2,"dummy"
"80666",4,4,0,8,"dummy"
"80667",7,3,0,10,"dummy"
"80668",0,0,1,1,"dummy"
"80669",0,0,1,1,"dummy"
"80670",1,1,0,2,"dummy"
"80671",1,1,0,2,"dummy"
"80672",0,0,0,0,"dummy"
"80673",1,0,1,2,"dummy"
"80674",1,0,0,1,"dummy"
"80675",1,1,0,2,"dummy"
"80676",0,0,1,1,"dummy"
"80679",1,0,0,1,"dummy"
"80680",1,7,2,10,"dummy"
"80683",3,1,0,4,"dummy"
"80684",0,1,0,1,"dummy"
"80685",0,0,1,1,"dummy"
"80687",0,0,1,1,"dummy"
"80688",0,0,0,0,"dummy"
"80691",0,0,1,1,"dummy"
"80693",0,2,0,2,"dummy"
"80694",0,1,1,2,"dummy"
"80696",0,0,2,2,"dummy"
"80697",0,0,2,2,"dummy"
"80701",0,1,0,1,"dummy"
"80702",3,4,2,9,"dummy"
"80703",0,1,0,1,"dummy"
"80706",1,0,0,1,"dummy"
"80709",0,0,3,3,"dummy"
"80712",0,0,1,1,"dummy"
"80714",0,0,1,1,"dummy"
"80715",0,0,2,2,"dummy"
"80721",1,0,0,1,"dummy"
"80722",0,4,1,5,"dummy"
"80723",1,1,2,4,"dummy"
"80724",1,1,0,2,"dummy"
"80725",5,3,2,10,"dummy"
"80726",2,1,0,3,"dummy"
"80727",0,0,2,2,"dummy"
"80728",0,1,0,1,"dummy"
"80729",0,1,1,2,"dummy"
"80730",1,2,1,4,"dummy"
"80731",1,0,0,1,"dummy"
"80732",0,1,0,1,"dummy"
"80733",1,0,0,1,"dummy"
"80747",0,1,1,2,"dummy"
"80748",0,0,1,1,"dummy"
"80749",0,0,3,3,"dummy"
"80751",5,0,2,7,"dummy"
"80752",0,8,1,9,"dummy"
"80753",5,5,1,11,"dummy"
"80765",0,1,0,1,"dummy"
"80766",1,0,0,1,"dummy"
"80767",1,5,0,6,"dummy"
"80768",0,4,0,4,"dummy"
"80769",0,4,0,4,"dummy"
"80770",3,6,5,14,"dummy"
"80781",0,1,1,2,"dummy"
"80783",1,8,1,10,"dummy"
"80784",0,3,0,3,"dummy"
"80786",3,10,3,16,"dummy"
"80788",0,0,1,1,"dummy"
"80789",0,0,0,0,"dummy"
"80794",0,2,5,7,"dummy"
"80795",0,0,5,5,"dummy"
"80796",0,0,5,5,"dummy"
"80798",2,12,0,14,"dummy"
"80799",0,0,1,1,"dummy"
"80800",0,2,0,2,"dummy"
"80801",0,0,1,1,"dummy"
"80802",0,1,0,1,"dummy"
"80803",8,13,3,24,"dummy"
"80804",0,0,2,2,"dummy"
"80805",2,3,0,5,"dummy"
"80806",4,4,0,8,"dummy"
"80807",3,0,0,3,"dummy"
"80808",0,1,0,1,"dummy"
"80809",3,8,0,11,"dummy"
"80812",0,0,1,1,"dummy"
"80813",3,17,1,21,"dummy"
"80814",6,5,2,13,"dummy"
"80815",0,0,0,0,"dummy"
"80816",0,0,1,1,"dummy"
"80817",1,0,0,1,"dummy"
"80818",0,1,0,1,"dummy"
"80819",20,4,1,25,"dummy"
"80820",3,20,1,24,"dummy"
"80821",0,2,0,2,"dummy"
"80822",0,0,0,0,"dummy"
"80823",16,15,8,39,"dummy"
"80824",5,4,1,10,"dummy"
"80830",10,13,0,23,"dummy"
"80831",0,0,15,15,"dummy"
"80832",10,10,0,20,"dummy"
"80833",0,1,0,1,"dummy"
"80834",12,12,0,24,"dummy"
"80835",12,13,0,25,"dummy"
"80836",0,1,0,1,"dummy"
"80837",0,0,0,0,"dummy"
"80846",0,0,0,0,"dummy"
"80847",0,0,0,0,"dummy"
"80870",8,8,1,17,"dummy"
"80871",0,3,0,3,"dummy"
"80872",2,5,2,9,"dummy"
"80873",1,0,0,1,"dummy"
"80877",0,0,1,1,"dummy"
"80878",0,0,2,2,"dummy"
"80879",0,0,1,1,"dummy"
"80880",0,0,1,1,"dummy"
"80881",0,0,1,1,"dummy"
"80882",0,2,1,3,"dummy"
"80883",0,0,2,2,"dummy"
"80884",3,2,1,6,"dummy"
"80885",0,3,0,3,"dummy"
"80886",0,0,1,1,"dummy"
"80887",0,0,1,1,"dummy"
"80888",0,0,1,1,"dummy"
"80889",0,0,1,1,"dummy"
"80890",0,0,1,1,"dummy"
"80891",0,0,1,1,"dummy"
"80892",0,0,1,1,"dummy"
"80893",0,0,1,1,"dummy"
"80894",0,0,1,1,"dummy"
"80895",2,4,1,7,"dummy"
"80896",0,0,1,1,"dummy"
"80897",0,0,1,1,"dummy"
"80898",0,0,1,1,"dummy"
"80899",0,0,1,1,"dummy"
"80902",0,1,1,2,"dummy"
"80903",1,1,0,2,"dummy"
"80904",0,0,2,2,"dummy"
"80905",2,6,1,9,"dummy"
"80906",2,1,0,3,"dummy"
"80907",0,2,0,2,"dummy"
"80908",1,0,1,2,"dummy"
"80911",0,0,1,1,"dummy"
"80912",0,0,1,1,"dummy"
"80913",0,0,1,1,"dummy"
"80914",0,0,1,1,"dummy"
"80915",0,0,1,1,"dummy"
"80916",0,0,0,0,"dummy"
"80917",0,1,0,1,"dummy"
"80918",0,0,1,1,"dummy"
"80919",0,0,0,0,"dummy"
"80920",0,0,0,0,"dummy"
"80921",0,2,0,2,"dummy"
"80922",0,0,0,0,"dummy"
"80923",0,3,0,3,"dummy"
"80924",0,0,1,1,"dummy"
"80925",1,3,0,4,"dummy"
"80926",0,0,1,1,"dummy"
"80927",0,1,0,1,"dummy"
"80928",0,0,1,1,"dummy"
"80929",0,0,1,1,"dummy"
"80930",0,0,1,1,"dummy"
"80932",1,1,0,2,"dummy"
"80934",0,2,0,2,"dummy"
"80937",28,19,2,49,"dummy"
"80938",0,0,2,2,"dummy"
"80939",0,0,3,3,"dummy"
"80940",0,1,0,1,"dummy"
"80941",1,3,1,5,"dummy"
"80942",0,1,0,1,"dummy"
"80943",4,17,4,25,"dummy"
"80944",1,0,0,1,"dummy"
"80945",5,13,1,19,"dummy"
"80946",1,0,0,1,"dummy"
"80947",0,2,1,3,"dummy"
"80948",3,1,0,4,"dummy"
"80949",0,1,0,1,"dummy"
"80950",0,3,0,3,"dummy"
"80951",2,4,0,6,"dummy"
"80952",1,0,0,1,"dummy"
"80953",4,3,0,7,"dummy"
"80954",4,4,0,8,"dummy"
"80955",5,6,2,13,"dummy"
"80956",0,1,0,1,"dummy"
"80957",0,0,1,1,"dummy"
"80958",0,0,1,1,"dummy"
"80959",0,1,0,1,"dummy"
"80960",0,2,0,2,"dummy"
"80962",0,1,0,1,"dummy"
"80963",2,16,2,20,"dummy"
"80964",1,2,1,4,"dummy"
"80965",0,6,0,6,"dummy"
"80966",4,5,0,9,"dummy"
"80967",0,0,2,2,"dummy"
"80970",9,2,1,12,"dummy"
"80973",0,4,0,4,"dummy"
"80974",4,23,0,27,"dummy"
"80975",1,2,0,3,"dummy"
"80976",0,0,1,1,"dummy"
"80977",5,3,0,8,"dummy"
"80980",0,2,0,2,"dummy"
"80982",0,1,0,1,"dummy"
"80983",0,3,2,5,"dummy"
"80984",2,3,0,5,"dummy"
"80986",8,20,0,28,"dummy"
"80989",3,3,1,7,"dummy"
"80991",0,1,2,3,"dummy"
"80993",1,2,1,4,"dummy"
"80994",1,7,0,8,"dummy"
"80995",0,1,0,1,"dummy"
"80996",0,2,2,4,"dummy"
"80998",0,1,0,1,"dummy"
"81001",0,0,0,0,"dummy"
"81002",1,4,1,6,"dummy"
"81003",8,5,3,16,"dummy"
"81004",2,5,2,9,"dummy"
"81005",0,1,0,1,"dummy"
"81006",3,9,3,15,"dummy"
"81007",1,0,0,1,"dummy"
"81041",0,2,0,2,"dummy"
"81042",0,2,0,2,"dummy"
"81043",2,2,0,4,"dummy"
"81044",2,0,0,2,"dummy"
"81045",0,0,1,1,"dummy"
"81046",0,0,1,1,"dummy"
"81047",1,2,0,3,"dummy"
"81048",1,0,0,1,"dummy"
"81049",1,3,0,4,"dummy"
"81050",0,0,2,2,"dummy"
"81051",0,1,0,1,"dummy"
"81052",0,1,1,2,"dummy"
"81053",6,6,0,12,"dummy"
"81054",1,2,0,3,"dummy"
"81055",1,1,0,2,"dummy"
"81056",1,2,4,7,"dummy"
"81057",10,4,3,17,"dummy"
"81061",2,2,0,4,"dummy"
"81063",0,0,1,1,"dummy"
"81064",0,0,1,1,"dummy"
"81065",0,0,1,1,"dummy"
"81066",0,0,1,1,"dummy"
"81067",0,0,1,1,"dummy"
"81068",0,0,1,1,"dummy"
"81069",0,0,1,1,"dummy"
"81070",0,0,1,1,"dummy"
"81071",0,0,1,1,"dummy"
"81072",1,5,2,8,"dummy"
"81073",4,5,1,10,"dummy"
"81074",3,0,1,4,"dummy"
"81075",1,0,0,1,"dummy"
"81081",0,5,0,5,"dummy"
"81082",5,3,0,8,"dummy"
"81083",0,5,0,5,"dummy"
"81086",3,3,0,6,"dummy"
"81087",0,0,1,1,"dummy"
"81088",0,0,0,0,"dummy"
"81106",1,0,0,1,"dummy"
"81107",0,1,0,1,"dummy"
"81109",0,0,0,0,"dummy"
"81114",6,11,0,17,"dummy"
"81115",0,1,1,2,"dummy"
"81116",5,3,0,8,"dummy"
"81117",0,0,0,0,"dummy"
"81118",0,0,1,1,"dummy"
"81119",0,1,0,1,"dummy"
"81120",0,0,0,0,"dummy"
"81121",3,2,1,6,"dummy"
"81122",1,5,1,7,"dummy"
"81123",3,2,0,5,"dummy"
"81124",2,3,0,5,"dummy"
"81125",0,0,1,1,"dummy"
"81126",0,1,0,1,"dummy"
"81127",0,1,1,2,"dummy"
"81128",8,5,0,13,"dummy"
"81129",0,0,1,1,"dummy"
"81130",7,6,0,13,"dummy"
"81131",4,5,0,9,"dummy"
"81132",0,0,3,3,"dummy"
"81133",0,2,0,2,"dummy"
"81134",0,1,3,4,"dummy"
"81135",5,3,0,8,"dummy"
"81136",0,0,0,0,"dummy"
"81138",0,0,1,1,"dummy"
"81144",0,0,1,1,"dummy"
"81145",25,7,1,33,"dummy"
"81147",0,0,2,2,"dummy"
"81149",0,0,1,1,"dummy"
"81153",5,1,0,6,"dummy"
"81154",1,5,0,6,"dummy"
"81155",5,1,0,6,"dummy"
"81156",1,5,0,6,"dummy"
"81160",2,1,0,3,"dummy"
"81161",1,5,0,6,"dummy"
"81162",0,2,1,3,"dummy"
"81163",9,7,3,19,"dummy"
"81164",0,1,1,2,"dummy"
"81167",0,0,1,1,"dummy"
"81169",0,4,1,5,"dummy"
"81170",0,4,0,4,"dummy"
"81173",0,0,1,1,"dummy"
"81186",4,0,0,4,"dummy"
"81187",0,0,0,0,"dummy"
"81188",0,3,0,3,"dummy"
"81189",0,0,0,0,"dummy"
"81193",0,0,0,0,"dummy"
"81194",1,0,0,1,"dummy"
"81195",0,0,1,1,"dummy"
"81196",1,1,0,2,"dummy"
"81197",0,0,1,1,"dummy"
"81198",0,1,0,1,"dummy"
"81199",0,2,0,2,"dummy"
"81200",0,0,2,2,"dummy"
"81201",0,0,0,0,"dummy"
"81202",0,0,0,0,"dummy"
"81203",4,1,0,5,"dummy"
"81204",1,0,0,1,"dummy"
"81205",0,0,0,0,"dummy"
"81206",0,0,0,0,"dummy"
"81207",0,0,0,0,"dummy"
"81210",0,2,0,2,"dummy"
"81211",0,1,0,1,"dummy"
"81212",0,1,0,1,"dummy"
"81213",0,1,0,1,"dummy"
"81214",12,4,3,19,"dummy"
"81215",0,1,0,1,"dummy"
"81216",1,0,0,1,"dummy"
"81217",0,2,0,2,"dummy"
"81218",0,0,1,1,"dummy"
"81219",0,0,1,1,"dummy"
"81220",2,1,1,4,"dummy"
"81221",4,11,1,16,"dummy"
"81223",0,0,1,1,"dummy"
"81224",0,0,1,1,"dummy"
"81225",0,0,1,1,"dummy"
"81226",0,0,1,1,"dummy"
"81229",4,1,0,5,"dummy"
"81230",1,0,0,1,"dummy"
"81231",1,0,0,1,"dummy"
"81234",0,0,1,1,"dummy"
"81235",0,0,1,1,"dummy"
"81236",0,0,1,1,"dummy"
"81237",0,3,3,6,"dummy"
"81238",0,3,0,3,"dummy"
"81240",2,4,0,6,"dummy"
"81241",0,2,0,2,"dummy"
"81242",0,2,0,2,"dummy"
"81243",10,2,0,12,"dummy"
"81244",0,2,0,2,"dummy"
"81248",0,0,1,1,"dummy"
"81249",1,0,1,2,"dummy"
"81250",0,0,1,1,"dummy"
"81251",0,0,1,1,"dummy"
"81252",0,0,1,1,"dummy"
"81253",0,0,1,1,"dummy"
"81254",0,0,1,1,"dummy"
"81255",0,0,1,1,"dummy"
"81256",0,0,1,1,"dummy"
"81257",0,0,1,1,"dummy"
"81258",0,0,1,1,"dummy"
"81259",0,0,1,1,"dummy"
"81260",0,0,1,1,"dummy"
"81261",0,0,1,1,"dummy"
"81262",0,0,1,1,"dummy"
"81263",0,0,1,1,"dummy"
"81264",0,0,1,1,"dummy"
"81265",0,0,1,1,"dummy"
"81266",0,0,1,1,"dummy"
"81267",0,0,1,1,"dummy"
"81268",0,0,1,1,"dummy"
"81269",0,0,1,1,"dummy"
"81270",0,0,1,1,"dummy"
"81271",0,0,1,1,"dummy"
"81272",0,0,1,1,"dummy"
"81273",0,0,1,1,"dummy"
"81274",0,0,1,1,"dummy"
"81275",0,0,1,1,"dummy"
"81276",0,0,1,1,"dummy"
"81277",0,0,1,1,"dummy"
"81278",0,0,1,1,"dummy"
"81279",0,0,1,1,"dummy"
"81280",0,0,1,1,"dummy"
"81281",0,0,1,1,"dummy"
"81282",0,0,1,1,"dummy"
"81283",0,0,1,1,"dummy"
"81284",0,0,1,1,"dummy"
"81285",0,0,1,1,"dummy"
"81286",0,0,1,1,"dummy"
"81287",0,0,1,1,"dummy"
"81288",0,0,1,1,"dummy"
"81289",0,0,1,1,"dummy"
"81290",0,0,1,1,"dummy"
"81291",0,0,1,1,"dummy"
"81292",0,0,1,1,"dummy"
"81293",0,0,1,1,"dummy"
"81294",0,0,1,1,"dummy"
"81310",0,3,0,3,"dummy"
"81311",0,0,2,2,"dummy"
"81313",0,1,0,1,"dummy"
"81314",0,2,0,2,"dummy"
"81315",1,1,0,2,"dummy"
"81316",1,1,0,2,"dummy"
"81322",16,43,6,65,"dummy"
"81323",1,2,1,4,"dummy"
"81324",1,1,0,2,"dummy"
"81325",0,0,0,0,"dummy"
"81326",0,2,0,2,"dummy"
"81327",0,1,0,1,"dummy"
"81328",0,1,0,1,"dummy"
"81329",0,3,0,3,"dummy"
"81330",0,0,0,0,"dummy"
"81331",0,0,0,0,"dummy"
"81332",0,0,0,0,"dummy"
"81333",0,0,0,0,"dummy"
"81334",0,0,0,0,"dummy"
"81335",0,4,0,4,"dummy"
"81336",2,2,1,5,"dummy"
"81337",1,2,0,3,"dummy"
"81338",0,1,0,1,"dummy"
"81339",0,0,0,0,"dummy"
"81342",0,1,4,5,"dummy"
"81344",0,15,0,15,"dummy"
"81346",0,6,0,6,"dummy"
"81347",1,0,0,1,"dummy"
"81348",0,1,0,1,"dummy"
"81349",0,0,0,0,"dummy"
"81350",1,1,0,2,"dummy"
"81351",1,1,0,2,"dummy"
"81353",0,0,0,0,"dummy"
"81355",0,0,1,1,"dummy"
"81357",0,1,2,3,"dummy"
"81358",0,0,0,0,"dummy"
"81359",0,2,0,2,"dummy"
"81360",5,0,2,7,"dummy"
"81361",1,0,0,1,"dummy"
"81363",0,0,1,1,"dummy"
"81365",0,2,1,3,"dummy"
"81368",0,1,0,1,"dummy"
"81372",0,2,1,3,"dummy"
"81376",0,0,0,0,"dummy"
"81380",0,2,0,2,"dummy"
"81384",0,1,0,1,"dummy"
"81386",1,3,1,5,"dummy"
"81387",0,3,1,4,"dummy"
"81389",0,0,1,1,"dummy"
"81390",0,0,1,1,"dummy"
"81392",1,0,0,1,"dummy"
"81393",3,3,1,7,"dummy"
"81395",0,0,0,0,"dummy"
"81396",0,0,0,0,"dummy"
"81397",0,0,0,0,"dummy"
"81400",1,8,2,11,"dummy"
"81401",1,1,0,2,"dummy"
"81402",0,0,1,1,"dummy"
"81403",0,1,0,1,"dummy"
"81404",0,1,0,1,"dummy"
"81405",0,5,0,5,"dummy"
"81406",0,0,1,1,"dummy"
"81407",7,9,0,16,"dummy"
"81408",4,0,0,4,"dummy"
"81409",5,1,0,6,"dummy"
"81410",5,17,1,23,"dummy"
"81411",6,11,1,18,"dummy"
"81412",0,2,0,2,"dummy"
"81413",1,0,0,1,"dummy"
"81414",0,1,0,1,"dummy"
"81415",1,1,1,3,"dummy"
"81416",1,3,0,4,"dummy"
"81417",1,0,0,1,"dummy"
"81418",0,1,0,1,"dummy"
"81420",2,4,0,6,"dummy"
"81421",0,2,0,2,"dummy"
"81422",0,2,0,2,"dummy"
"81423",10,2,0,12,"dummy"
"81424",0,2,0,2,"dummy"
"81425",0,0,3,3,"dummy"
"81430",6,0,0,6,"dummy"
"81431",2,5,2,9,"dummy"
"81447",3,4,0,7,"dummy"
"81448",1,3,3,7,"dummy"
"81449",0,1,0,1,"dummy"
"81450",0,0,1,1,"dummy"
"81451",0,0,1,1,"dummy"
"81453",1,4,0,5,"dummy"
"81454",4,0,1,5,"dummy"
"81455",0,1,0,1,"dummy"
"81458",2,9,1,12,"dummy"
"81459",0,0,0,0,"dummy"
"81465",0,0,0,0,"dummy"
"81466",0,1,0,1,"dummy"
"81467",1,1,0,2,"dummy"
"81468",1,0,1,2,"dummy"
"81469",0,1,0,1,"dummy"
"81470",0,0,1,1,"dummy"
"81471",0,1,0,1,"dummy"
"81472",0,0,1,1,"dummy"
"81473",0,0,2,2,"dummy"
"81474",0,4,0,4,"dummy"
"81475",1,0,0,1,"dummy"
"81476",0,1,0,1,"dummy"
"81477",0,1,0,1,"dummy"
"81478",3,3,0,6,"dummy"
"81479",0,0,1,1,"dummy"
"81480",2,2,0,4,"dummy"
"81481",3,3,2,8,"dummy"
"81482",0,0,1,1,"dummy"
"81483",2,0,0,2,"dummy"
"81484",0,0,1,1,"dummy"
"81485",0,0,1,1,"dummy"
"81486",0,0,1,1,"dummy"
"81487",5,3,0,8,"dummy"
"81488",23,12,3,38,"dummy"
"81489",1,0,1,2,"dummy"
"81490",0,0,1,1,"dummy"
"81491",0,0,1,1,"dummy"
"81493",0,0,1,1,"dummy"
"81494",0,0,0,0,"dummy"
"81495",0,1,0,1,"dummy"
"81499",2,0,3,5,"dummy"
"81504",2,4,0,6,"dummy"
"81505",0,2,0,2,"dummy"
"81506",0,2,0,2,"dummy"
"81507",10,2,0,12,"dummy"
"81508",0,2,0,2,"dummy"
"81510",0,2,0,2,"dummy"
"81511",0,0,1,1,"dummy"
"81523",0,0,0,0,"dummy"
"81526",1,5,1,7,"dummy"
"81529",0,2,0,2,"dummy"
"81530",2,0,0,2,"dummy"
"81531",0,3,0,3,"dummy"
"81532",0,1,0,1,"dummy"
"81533",6,10,3,19,"dummy"
"81535",0,0,1,1,"dummy"
"81536",1,1,1,3,"dummy"
"81537",0,0,1,1,"dummy"
"81542",3,16,0,19,"dummy"
"81544",0,2,0,2,"dummy"
"81555",0,3,1,4,"dummy"
"81560",0,1,0,1,"dummy"
"81561",2,0,0,2,"dummy"
"81562",2,4,1,7,"dummy"
"81563",0,3,0,3,"dummy"
"81564",0,0,1,1,"dummy"
"81565",0,0,1,1,"dummy"
"81566",0,0,1,1,"dummy"
"81567",3,1,0,4,"dummy"
"81568",0,3,0,3,"dummy"
"81569",0,0,1,1,"dummy"
"81570",0,0,0,0,"dummy"
"81571",4,0,1,5,"dummy"
"81572",0,1,1,2,"dummy"
"81573",0,1,0,1,"dummy"
"81575",0,0,1,1,"dummy"
"81576",0,0,1,1,"dummy"
"81577",0,0,2,2,"dummy"
"81578",26,3,7,36,"dummy"
"81593",0,0,2,2,"dummy"
"81594",2,0,1,3,"dummy"
"81595",0,1,0,1,"dummy"
"81597",0,0,0,0,"dummy"
"81598",0,4,0,4,"dummy"
"81599",0,0,1,1,"dummy"
"81602",0,2,0,2,"dummy"
"81603",0,1,0,1,"dummy"
"81606",0,0,1,1,"dummy"
"81607",0,0,1,1,"dummy"
"81608",0,0,2,2,"dummy"
"81609",26,3,7,36,"dummy"
"81612",3,3,0,6,"dummy"
"81614",0,8,0,8,"dummy"
"81617",0,4,0,4,"dummy"
"81618",0,3,1,4,"dummy"
"81621",0,1,0,1,"dummy"
"81638",0,0,4,4,"dummy"
"81639",0,14,2,16,"dummy"
"81640",0,2,0,2,"dummy"
"81641",0,3,0,3,"dummy"
"81642",0,10,0,10,"dummy"
"81643",0,2,0,2,"dummy"
"81644",0,1,0,1,"dummy"
"81646",2,2,2,6,"dummy"
"81647",0,1,0,1,"dummy"
"81648",0,0,1,1,"dummy"
"81652",0,2,0,2,"dummy"
"81653",0,2,2,4,"dummy"
"81654",0,1,0,1,"dummy"
"81655",0,2,2,4,"dummy"
"81656",3,2,1,6,"dummy"
"81657",2,5,0,7,"dummy"
"81658",2,1,0,3,"dummy"
"81659",0,3,0,3,"dummy"
"81660",3,0,0,3,"dummy"
"81661",0,1,0,1,"dummy"
"81662",0,1,0,1,"dummy"
"81663",1,0,0,1,"dummy"
"81664",0,1,0,1,"dummy"
"81666",0,0,1,1,"dummy"
"81669",0,0,2,2,"dummy"
"81670",0,0,0,0,"dummy"
"81671",1,9,4,14,"dummy"
"81672",0,0,1,1,"dummy"
"81673",0,1,1,2,"dummy"
"81674",0,2,0,2,"dummy"
"81675",0,0,1,1,"dummy"
"81676",0,0,0,0,"dummy"
"81677",0,0,1,1,"dummy"
"81679",2,0,0,2,"dummy"
"81680",6,4,2,12,"dummy"
"81683",1,0,0,1,"dummy"
"81684",0,0,1,1,"dummy"
"81685",1,1,0,2,"dummy"
"81686",0,0,1,1,"dummy"
"81687",0,0,0,0,"dummy"
"81692",1,2,0,3,"dummy"
"81693",4,4,0,8,"dummy"
"81694",1,0,2,3,"dummy"
"81695",0,0,1,1,"dummy"
"81697",0,1,0,1,"dummy"
"81698",2,0,1,3,"dummy"
"81699",0,0,1,1,"dummy"
"81700",0,3,1,4,"dummy"
"81701",0,0,1,1,"dummy"
"81707",0,3,3,6,"dummy"
"81711",0,0,1,1,"dummy"
"81713",0,0,0,0,"dummy"
"81714",0,0,0,0,"dummy"
"81717",0,0,1,1,"dummy"
"81718",0,0,1,1,"dummy"
"81719",0,0,1,1,"dummy"
"81720",0,0,1,1,"dummy"
"81722",0,0,1,1,"dummy"
"81723",0,0,1,1,"dummy"
"81724",0,0,2,2,"dummy"
"81726",0,0,1,1,"dummy"
"81728",0,0,1,1,"dummy"
"81729",0,0,1,1,"dummy"
"81730",0,0,1,1,"dummy"
"81731",1,0,0,1,"dummy"
"81732",2,0,0,2,"dummy"
"81733",0,0,1,1,"dummy"
"81734",0,10,0,10,"dummy"
"81735",0,0,1,1,"dummy"
"81736",2,2,0,4,"dummy"
"81737",0,0,1,1,"dummy"
"81738",0,2,0,2,"dummy"
"81739",0,0,1,1,"dummy"
"81740",1,5,1,7,"dummy"
"81741",0,4,0,4,"dummy"
"81742",2,1,0,3,"dummy"
"81744",2,5,2,9,"dummy"
"81749",0,0,2,2,"dummy"
"81750",2,0,0,2,"dummy"
"81757",0,3,1,4,"dummy"
"81758",0,0,2,2,"dummy"
"81759",0,0,1,1,"dummy"
"81761",2,0,0,2,"dummy"
"81764",1,1,1,3,"dummy"
"81765",3,3,3,9,"dummy"
"81766",3,3,1,7,"dummy"
"81767",1,2,0,3,"dummy"
"81768",0,3,2,5,"dummy"
"81782",0,0,1,1,"dummy"
"81783",3,1,2,6,"dummy"
"81784",1,2,0,3,"dummy"
"81787",0,11,0,11,"dummy"
"81789",0,0,2,2,"dummy"
"81792",0,1,4,5,"dummy"
"81793",0,0,1,1,"dummy"
"81794",0,0,1,1,"dummy"
"81795",0,1,0,1,"dummy"
"81796",0,0,4,4,"dummy"
"81797",28,13,5,46,"dummy"
"81800",0,0,0,0,"dummy"
"81801",4,18,0,22,"dummy"
"81802",4,1,1,6,"dummy"
"81803",1,2,0,3,"dummy"
"81804",0,1,0,1,"dummy"
"81805",2,0,0,2,"dummy"
"81807",0,2,2,4,"dummy"
"81808",0,2,0,2,"dummy"
"81809",0,0,2,2,"dummy"
"81811",5,4,2,11,"dummy"
"81812",0,2,0,2,"dummy"
"81813",0,1,0,1,"dummy"
"81814",0,2,0,2,"dummy"
"81815",6,2,3,11,"dummy"
"81834",1,1,0,2,"dummy"
"81835",4,4,0,8,"dummy"
"81836",0,1,0,1,"dummy"
"81837",0,2,0,2,"dummy"
"81838",0,1,0,1,"dummy"
"81839",1,0,0,1,"dummy"
"81840",0,0,1,1,"dummy"
"81841",7,12,2,21,"dummy"
"81842",0,1,0,1,"dummy"
"81843",2,4,0,6,"dummy"
"81844",0,1,0,1,"dummy"
"81845",13,10,1,24,"dummy"
"81846",0,0,1,1,"dummy"
"81847",0,1,0,1,"dummy"
"81849",0,1,0,1,"dummy"
"81850",2,9,3,14,"dummy"
"81851",5,10,2,17,"dummy"
"81852",0,1,0,1,"dummy"
"81858",1,1,0,2,"dummy"
"81859",3,4,4,11,"dummy"
"81867",0,1,0,1,"dummy"
"81870",3,6,0,9,"dummy"
"81872",1,0,0,1,"dummy"
"81873",1,1,0,2,"dummy"
"81876",2,5,2,9,"dummy"
"81880",0,0,2,2,"dummy"
"81881",0,7,0,7,"dummy"
"81882",1,14,0,15,"dummy"
"81883",0,1,0,1,"dummy"
"81884",4,0,1,5,"dummy"
"81885",0,0,1,1,"dummy"
"81886",0,2,0,2,"dummy"
"81887",0,0,1,1,"dummy"
"81888",0,1,1,2,"dummy"
"81889",0,0,1,1,"dummy"
"81890",0,0,1,1,"dummy"
"81891",6,9,1,16,"dummy"
"81892",0,0,1,1,"dummy"
"81894",0,0,1,1,"dummy"
"81895",0,4,0,4,"dummy"
"81897",0,7,2,9,"dummy"
"81898",2,1,1,4,"dummy"
"81899",9,6,3,18,"dummy"
"81900",0,3,1,4,"dummy"
"81901",0,1,0,1,"dummy"
"81902",4,9,2,15,"dummy"
"81903",5,2,2,9,"dummy"
"81904",11,12,4,27,"dummy"
"81905",0,1,0,1,"dummy"
"81906",0,10,0,10,"dummy"
"81907",0,3,0,3,"dummy"
"81908",0,2,0,2,"dummy"
"81909",0,3,0,3,"dummy"
"81910",0,4,0,4,"dummy"
"81912",0,0,1,1,"dummy"
"81913",0,0,0,0,"dummy"
"81916",6,0,0,6,"dummy"
"81917",2,5,2,9,"dummy"
"81920",1,2,0,3,"dummy"
"81921",0,0,1,1,"dummy"
"81922",0,2,0,2,"dummy"
"81923",0,1,0,1,"dummy"
"81924",1,1,0,2,"dummy"
"81925",4,1,0,5,"dummy"
"81926",0,1,0,1,"dummy"
"81927",0,0,1,1,"dummy"
"81928",0,0,0,0,"dummy"
"81929",0,0,2,2,"dummy"
"81930",0,0,1,1,"dummy"
"81931",5,2,0,7,"dummy"
"81932",0,0,1,1,"dummy"
"81933",0,0,1,1,"dummy"
"81934",0,0,1,1,"dummy"
"81935",0,0,1,1,"dummy"
"81936",0,0,1,1,"dummy"
"81937",0,1,1,2,"dummy"
"81938",0,0,1,1,"dummy"
"81943",0,0,1,1,"dummy"
"81944",0,0,1,1,"dummy"
"81945",0,0,1,1,"dummy"
"81946",0,1,2,3,"dummy"
"81947",0,4,0,4,"dummy"
"81948",7,0,1,8,"dummy"
"81949",0,0,1,1,"dummy"
"81950",9,17,0,26,"dummy"
"81956",0,0,1,1,"dummy"
"81957",2,0,0,2,"dummy"
"81960",0,1,1,2,"dummy"
"81961",0,2,0,2,"dummy"
"81962",0,0,2,2,"dummy"
"81963",0,0,2,2,"dummy"
"81964",0,0,1,1,"dummy"
"81965",0,0,1,1,"dummy"
"81966",0,0,1,1,"dummy"
"81967",0,0,1,1,"dummy"
"81969",0,0,0,0,"dummy"
"81970",0,0,0,0,"dummy"
"81972",0,0,2,2,"dummy"
"81975",0,0,4,4,"dummy"
"81979",0,0,0,0,"dummy"
"81985",0,8,0,8,"dummy"
"81986",0,0,1,1,"dummy"
"81993",0,1,0,1,"dummy"
"81994",0,0,1,1,"dummy"
"81995",0,0,0,0,"dummy"
"81996",0,0,0,0,"dummy"
"81998",0,1,1,2,"dummy"
"82003",0,3,1,4,"dummy"
"82005",0,0,0,0,"dummy"
"82006",3,0,0,3,"dummy"
"82009",0,0,2,2,"dummy"
"82011",0,0,1,1,"dummy"
"82012",3,3,0,6,"dummy"
"82013",0,1,0,1,"dummy"
"82014",0,0,3,3,"dummy"
"82015",3,2,3,8,"dummy"
"82016",0,1,3,4,"dummy"
"82017",0,0,3,3,"dummy"
"82018",3,3,0,6,"dummy"
"82019",0,0,1,1,"dummy"
"82020",0,0,1,1,"dummy"
"82021",2,2,0,4,"dummy"
"82022",4,0,0,4,"dummy"
"82023",0,0,1,1,"dummy"
"82024",0,1,1,2,"dummy"
"82025",0,0,1,1,"dummy"
"82026",0,0,1,1,"dummy"
"82027",0,0,1,1,"dummy"
"82028",0,0,1,1,"dummy"
"82029",0,0,1,1,"dummy"
"82030",0,0,1,1,"dummy"
"82032",0,0,1,1,"dummy"
"82033",0,0,1,1,"dummy"
"82035",0,2,0,2,"dummy"
"82036",2,0,0,2,"dummy"
"82037",0,2,0,2,"dummy"
"82042",1,0,0,1,"dummy"
"82043",0,2,0,2,"dummy"
"82044",0,0,0,0,"dummy"
"82045",0,1,0,1,"dummy"
"82047",1,0,0,1,"dummy"
"82048",0,0,0,0,"dummy"
"82049",0,0,1,1,"dummy"
"82050",0,1,0,1,"dummy"
"82052",38,4,0,42,"dummy"
"82053",0,0,1,1,"dummy"
"82054",0,0,1,1,"dummy"
"82056",3,6,1,10,"dummy"
"82075",3,10,1,14,"dummy"
"82076",1,1,0,2,"dummy"
"82077",2,0,0,2,"dummy"
"82078",0,2,0,2,"dummy"
"82079",0,0,1,1,"dummy"
"82081",8,0,3,11,"dummy"
"82090",0,0,1,1,"dummy"
"82091",0,1,0,1,"dummy"
"82092",0,0,0,0,"dummy"
"82096",1,2,0,3,"dummy"
"82097",0,1,0,1,"dummy"
"82098",0,1,0,1,"dummy"
"82099",1,0,0,1,"dummy"
"82100",0,2,0,2,"dummy"
"82101",2,0,0,2,"dummy"
"82102",0,3,0,3,"dummy"
"82103",0,0,1,1,"dummy"
"82104",0,0,1,1,"dummy"
"82105",3,1,0,4,"dummy"
"82106",2,0,0,2,"dummy"
"82107",1,0,0,1,"dummy"
"82108",0,3,0,3,"dummy"
"82109",0,0,3,3,"dummy"
"82110",1,0,0,1,"dummy"
"82111",2,0,0,2,"dummy"
"82112",1,3,0,4,"dummy"
"82113",0,0,1,1,"dummy"
"82114",0,4,0,4,"dummy"
"82115",2,0,0,2,"dummy"
"82116",1,0,0,1,"dummy"
"82117",0,0,1,1,"dummy"
"82118",0,0,1,1,"dummy"
"82119",0,0,1,1,"dummy"
"82120",0,0,1,1,"dummy"
"82121",0,0,1,1,"dummy"
"82122",1,2,1,4,"dummy"
"82123",0,0,1,1,"dummy"
"82124",0,0,0,0,"dummy"
"82125",0,2,0,2,"dummy"
"82126",0,1,0,1,"dummy"
"82127",0,1,0,1,"dummy"
"82128",0,0,0,0,"dummy"
"82129",0,0,0,0,"dummy"
"82130",2,0,0,2,"dummy"
"82131",0,1,0,1,"dummy"
"82132",0,0,0,0,"dummy"
"82134",0,1,0,1,"dummy"
"82135",2,3,0,5,"dummy"
"82136",5,1,0,6,"dummy"
"82137",0,1,0,1,"dummy"
"82138",0,1,0,1,"dummy"
"82139",0,0,1,1,"dummy"
"82140",3,1,1,5,"dummy"
"82141",0,0,1,1,"dummy"
"82144",3,0,0,3,"dummy"
"82146",0,1,5,6,"dummy"
"82149",2,2,1,5,"dummy"
"82150",3,8,0,11,"dummy"
"82151",2,4,0,6,"dummy"
"82152",0,2,0,2,"dummy"
"82153",8,3,1,12,"dummy"
"82154",0,2,0,2,"dummy"
"82155",2,3,2,7,"dummy"
"82156",10,14,1,25,"dummy"
"82157",2,2,0,4,"dummy"
"82158",36,13,3,52,"dummy"
"82159",0,2,0,2,"dummy"
"82160",5,11,1,17,"dummy"
"82161",0,2,0,2,"dummy"
"82162",1,3,1,5,"dummy"
"82163",8,3,1,12,"dummy"
"82180",11,6,3,20,"dummy"
"82182",4,0,2,6,"dummy"
"82187",0,0,1,1,"dummy"
"82191",0,0,1,1,"dummy"
"82192",0,3,0,3,"dummy"
"82193",0,4,0,4,"dummy"
"82194",2,2,3,7,"dummy"
"82195",0,1,0,1,"dummy"
"82196",1,0,1,2,"dummy"
"82197",0,0,1,1,"dummy"
"82198",0,1,0,1,"dummy"
"82199",0,1,0,1,"dummy"
"82200",0,0,1,1,"dummy"
"82201",0,0,1,1,"dummy"
"82202",0,1,0,1,"dummy"
"82203",4,5,3,12,"dummy"
"82204",0,0,1,1,"dummy"
"82205",0,0,1,1,"dummy"
"82209",0,0,1,1,"dummy"
"82212",0,0,1,1,"dummy"
"82213",0,0,1,1,"dummy"
"82214",0,0,1,1,"dummy"
"82215",0,0,1,1,"dummy"
"82216",0,0,1,1,"dummy"
"82217",0,0,2,2,"dummy"
"82218",0,0,1,1,"dummy"
"82219",0,0,1,1,"dummy"
"82221",0,0,1,1,"dummy"
"82225",0,0,1,1,"dummy"
"82226",0,0,2,2,"dummy"
"82229",0,1,0,1,"dummy"
"82232",0,0,0,0,"dummy"
"82233",0,0,1,1,"dummy"
"82234",3,0,0,3,"dummy"
"82235",0,1,0,1,"dummy"
"82236",0,0,1,1,"dummy"
"82237",0,0,0,0,"dummy"
"82238",0,1,0,1,"dummy"
"82239",3,1,0,4,"dummy"
"82240",0,0,1,1,"dummy"
"82241",8,4,1,13,"dummy"
"82242",1,0,0,1,"dummy"
"82243",0,0,0,0,"dummy"
"82244",0,0,0,0,"dummy"
"82256",0,4,0,4,"dummy"
"82257",0,0,1,1,"dummy"
"82259",0,0,1,1,"dummy"
"82260",2,1,1,4,"dummy"
"82261",0,0,1,1,"dummy"
"82265",4,6,0,10,"dummy"
"82266",0,5,0,5,"dummy"
"82285",0,6,0,6,"dummy"
"82286",0,3,0,3,"dummy"
"82287",0,4,0,4,"dummy"
"82288",10,35,3,48,"dummy"
"82289",0,4,0,4,"dummy"
"82290",14,1,1,16,"dummy"
"82291",3,17,1,21,"dummy"
"82292",0,3,0,3,"dummy"
"82293",1,0,0,1,"dummy"
"82294",0,9,0,9,"dummy"
"82295",6,4,0,10,"dummy"
"82296",14,11,1,26,"dummy"
"82297",6,15,1,22,"dummy"
"82298",14,2,2,18,"dummy"
"82299",3,0,0,3,"dummy"
"82300",0,4,0,4,"dummy"
"82301",0,1,0,1,"dummy"
"82302",0,1,0,1,"dummy"
"82303",4,5,0,9,"dummy"
"82304",11,0,0,11,"dummy"
"82305",1,0,0,1,"dummy"
"82306",0,0,0,0,"dummy"
"82307",0,20,0,20,"dummy"
"82308",2,4,0,6,"dummy"
"82309",0,1,0,1,"dummy"
"82310",0,0,0,0,"dummy"
"82311",3,0,1,4,"dummy"
"82312",2,2,0,4,"dummy"
"82313",18,1,0,19,"dummy"
"82314",0,0,0,0,"dummy"
"82315",0,2,0,2,"dummy"
"82316",0,0,6,6,"dummy"
"82317",0,3,0,3,"dummy"
"82318",0,4,0,4,"dummy"
"82319",0,5,0,5,"dummy"
"82320",0,2,0,2,"dummy"
"82321",0,0,1,1,"dummy"
"82322",0,0,1,1,"dummy"
"82323",0,2,0,2,"dummy"
"82324",0,1,0,1,"dummy"
"82325",1,0,0,1,"dummy"
"82326",2,2,1,5,"dummy"
"82327",0,8,0,8,"dummy"
"82328",0,1,0,1,"dummy"
"82329",0,1,0,1,"dummy"
"82330",6,0,1,7,"dummy"
"82332",0,0,1,1,"dummy"
"82334",0,25,0,25,"dummy"
"82335",25,68,8,101,"dummy"
"82336",8,2,0,10,"dummy"
"82337",37,7,6,50,"dummy"
"82339",1,0,0,1,"dummy"
"82345",0,0,1,1,"dummy"
"82347",0,0,1,1,"dummy"
"82374",0,3,0,3,"dummy"
"82375",0,0,1,1,"dummy"
"82376",0,2,0,2,"dummy"
"82377",2,25,0,27,"dummy"
"82378",0,0,1,1,"dummy"
"82380",0,0,0,0,"dummy"
"82381",0,0,0,0,"dummy"
"82389",2,0,0,2,"dummy"
"82390",0,0,0,0,"dummy"
"82392",2,2,1,5,"dummy"
"82394",0,1,0,1,"dummy"
"82397",0,1,0,1,"dummy"
"82398",0,0,3,3,"dummy"
"82399",1,0,0,1,"dummy"
"82400",1,1,0,2,"dummy"
"82402",0,0,1,1,"dummy"
"82403",0,0,1,1,"dummy"
"82404",0,0,1,1,"dummy"
"82408",0,1,0,1,"dummy"
"82409",4,7,3,14,"dummy"
"82410",6,6,3,15,"dummy"
"82414",0,1,0,1,"dummy"
"82415",6,42,2,50,"dummy"
"82416",0,0,1,1,"dummy"
"82417",0,1,0,1,"dummy"
"82418",2,2,0,4,"dummy"
"82419",0,1,1,2,"dummy"
"82420",0,1,0,1,"dummy"
"82421",1,0,2,3,"dummy"
"82422",0,0,2,2,"dummy"
"82423",2,0,0,2,"dummy"
"82424",5,6,4,15,"dummy"
"82425",35,3,2,40,"dummy"
"82426",0,3,0,3,"dummy"
"82427",4,4,0,8,"dummy"
"82428",2,2,0,4,"dummy"
"82429",4,4,0,8,"dummy"
"82430",2,0,4,6,"dummy"
"82431",0,1,0,1,"dummy"
"82432",0,0,1,1,"dummy"
"82438",0,1,1,2,"dummy"
"82441",0,1,0,1,"dummy"
"82442",0,0,0,0,"dummy"
"82443",0,0,0,0,"dummy"
"82445",0,0,0,0,"dummy"
"82454",0,0,1,1,"dummy"
"82457",0,0,1,1,"dummy"
"82458",0,0,3,3,"dummy"
"82459",0,2,0,2,"dummy"
"82460",0,0,0,0,"dummy"
"82461",0,2,0,2,"dummy"
"82462",3,8,4,15,"dummy"
"82465",1,5,0,6,"dummy"
"82466",4,1,0,5,"dummy"
"82467",3,3,0,6,"dummy"
"82499",0,0,0,0,"dummy"
"82505",1,1,0,2,"dummy"
"82506",1,1,0,2,"dummy"
"82507",0,2,0,2,"dummy"
"82508",1,0,0,1,"dummy"
"82509",3,1,1,5,"dummy"
"82510",5,7,3,15,"dummy"
"82511",3,1,1,5,"dummy"
"82512",1,3,1,5,"dummy"
"82513",3,1,1,5,"dummy"
"82514",2,2,0,4,"dummy"
"82515",1,1,0,2,"dummy"
"82516",1,1,0,2,"dummy"
"82517",3,2,0,5,"dummy"
"82524",7,2,0,9,"dummy"
"82529",0,0,2,2,"dummy"
"82530",0,0,2,2,"dummy"
"82531",0,0,1,1,"dummy"
"82534",0,0,1,1,"dummy"
"82535",0,0,1,1,"dummy"
"82536",0,0,2,2,"dummy"
"82537",26,3,7,36,"dummy"
"82539",0,0,1,1,"dummy"
"82540",2,2,0,4,"dummy"
"82549",1,1,0,2,"dummy"
"82550",0,2,0,2,"dummy"
"82553",5,4,4,13,"dummy"
"82554",0,0,1,1,"dummy"
"82555",0,0,1,1,"dummy"
"82556",2,0,0,2,"dummy"
"82557",0,0,1,1,"dummy"
"82558",0,0,1,1,"dummy"
"82559",0,0,1,1,"dummy"
"82560",0,0,1,1,"dummy"
"82561",0,0,1,1,"dummy"
"82562",0,0,1,1,"dummy"
"82581",0,10,0,10,"dummy"
"82582",0,7,0,7,"dummy"
"82583",3,1,0,4,"dummy"
"82597",3,2,0,5,"dummy"
"82616",0,2,0,2,"dummy"
"82617",2,4,0,6,"dummy"
"82618",5,2,3,10,"dummy"
"82621",3,3,8,14,"dummy"
"82626",0,0,0,0,"dummy"
"82627",0,4,0,4,"dummy"
"82628",0,0,0,0,"dummy"
"82631",1,16,3,20,"dummy"
"82632",0,2,0,2,"dummy"
"82633",0,1,0,1,"dummy"
"82634",0,1,1,2,"dummy"
"82635",1,1,0,2,"dummy"
"82636",1,1,0,2,"dummy"
"82647",0,1,0,1,"dummy"
"82648",0,0,0,0,"dummy"
"82649",0,0,1,1,"dummy"
"82650",0,2,0,2,"dummy"
"82651",0,0,3,3,"dummy"
"82652",0,0,0,0,"dummy"
"82653",0,2,0,2,"dummy"
"82656",4,0,0,4,"dummy"
"82657",0,1,0,1,"dummy"
"82668",0,0,1,1,"dummy"
"82669",0,0,1,1,"dummy"
"82670",0,1,0,1,"dummy"
"82671",2,3,1,6,"dummy"
"82672",1,1,0,2,"dummy"
"82673",1,1,0,2,"dummy"
"82674",0,0,1,1,"dummy"
"82677",0,0,0,0,"dummy"
"82688",0,0,1,1,"dummy"
"82692",0,0,1,1,"dummy"
"82708",0,2,0,2,"dummy"
"82709",0,2,0,2,"dummy"
"82713",0,10,0,10,"dummy"
"82714",0,0,1,1,"dummy"
"82715",2,0,0,2,"dummy"
"82716",1,6,2,9,"dummy"
"82717",0,3,0,3,"dummy"
"82718",6,10,3,19,"dummy"
"82719",0,3,3,6,"dummy"
"82720",0,2,0,2,"dummy"
"82721",2,0,1,3,"dummy"
"82722",5,0,0,5,"dummy"
"82729",8,15,8,31,"dummy"
"82730",11,0,0,11,"dummy"
"82731",3,13,4,20,"dummy"
"82732",0,0,1,1,"dummy"
"82733",0,0,2,2,"dummy"
"82755",0,1,0,1,"dummy"
"82802",0,0,1,1,"dummy"
"82803",0,0,1,1,"dummy"
"82804",0,0,1,1,"dummy"
"82805",0,0,1,1,"dummy"
"82806",0,0,1,1,"dummy"
"82807",0,0,1,1,"dummy"
"82808",0,0,1,1,"dummy"
"82815",0,3,0,3,"dummy"
"82816",0,0,1,1,"dummy"
"82817",0,0,1,1,"dummy"
"82585",0,0,1,1,"dummy"
"82586",0,1,0,1,"dummy"
"82589",0,2,0,2,"dummy"
"82590",0,0,0,0,"dummy"
"82591",0,5,0,5,"dummy"
"82592",1,3,0,4,"dummy"
"82593",3,0,0,3,"dummy"
"82594",0,0,1,1,"dummy"
"82595",2,3,1,6,"dummy"
"82638",2,15,1,18,"dummy"
"82639",4,4,1,9,"dummy"
"82640",0,1,0,1,"dummy"
"82641",0,0,2,2,"dummy"
"82642",2,0,2,4,"dummy"
"82643",0,0,1,1,"dummy"
"82644",0,0,1,1,"dummy"
"82645",1,4,0,5,"dummy"
"82659",9,2,0,11,"dummy"
"82660",0,0,1,1,"dummy"
"82661",0,0,1,1,"dummy"
"82662",2,0,0,2,"dummy"
"82663",0,1,1,2,"dummy"
"82664",0,0,1,1,"dummy"
"82665",0,0,3,3,"dummy"
"82666",1,0,0,1,"dummy"
"82683",1,1,3,5,"dummy"
"82684",2,0,0,2,"dummy"
"82695",3,5,2,10,"dummy"
"82724",0,1,1,2,"dummy"
"82725",0,0,1,1,"dummy"
"82726",0,0,3,3,"dummy"
"82727",0,0,1,1,"dummy"
"82735",0,1,0,1,"dummy"
"82736",0,5,0,5,"dummy"
"82737",5,2,0,7,"dummy"
"82738",0,3,0,3,"dummy"
"82739",0,1,0,1,"dummy"
"82740",3,0,1,4,"dummy"
"82745",0,2,4,6,"dummy"
"82746",5,3,4,12,"dummy"
"82747",0,0,7,7,"dummy"
"82748",0,1,0,1,"dummy"
"82749",0,0,1,1,"dummy"
"82752",3,3,1,7,"dummy"
"82753",0,0,1,1,"dummy"
"82763",1,1,0,2,"dummy"
"82764",0,1,0,1,"dummy"
"82769",2,0,1,3,"dummy"
"82770",0,3,1,4,"dummy"
"82771",0,0,1,1,"dummy"
"82772",1,0,0,1,"dummy"
"82773",0,1,0,1,"dummy"
"82774",0,0,1,1,"dummy"
"82775",1,3,0,4,"dummy"
"82776",6,2,2,10,"dummy"
"82777",0,0,1,1,"dummy"
"82778",0,0,1,1,"dummy"
"82779",1,2,0,3,"dummy"
"82780",2,0,0,2,"dummy"
"82781",0,1,0,1,"dummy"
"82782",0,1,0,1,"dummy"
"82783",1,0,0,1,"dummy"
"82784",0,1,0,1,"dummy"
"82785",1,0,0,1,"dummy"
"82786",0,1,0,1,"dummy"
"82800",0,1,0,1,"dummy"
"82819",0,0,2,2,"dummy"
"82820",0,0,1,1,"dummy"
"82837",0,17,1,18,"dummy"
"82824",0,4,0,4,"dummy"
"82825",4,8,0,12,"dummy"
"82860",2,0,1,3,"dummy"
"82861",5,6,0,11,"dummy"
"82862",0,5,0,5,"dummy"
"82863",0,8,0,8,"dummy"
"82864",1,0,0,1,"dummy"
"82865",0,0,1,1,"dummy"
"82866",3,2,1,6,"dummy"
"82867",5,0,0,5,"dummy"
"82868",0,7,0,7,"dummy"
"82869",0,1,0,1,"dummy"
"82870",0,2,0,2,"dummy"
"82871",0,2,0,2,"dummy"
"82872",0,3,0,3,"dummy"
"82873",2,0,0,2,"dummy"
"82874",0,1,0,1,"dummy"
"82875",0,2,0,2,"dummy"
"82876",2,4,0,6,"dummy"
"82877",0,0,1,1,"dummy"
"82878",2,0,0,2,"dummy"
"82881",0,0,1,1,"dummy"
"82882",0,0,0,0,"dummy"
"82883",0,0,0,0,"dummy"
"82884",0,3,0,3,"dummy"
"82885",0,2,0,2,"dummy"
"82896",6,1,0,7,"dummy"
"82897",0,1,0,1,"dummy"
"82898",0,0,1,1,"dummy"
"82899",18,0,1,19,"dummy"
"82908",0,0,0,0,"dummy"
"82930",3,1,0,4,"dummy"
"82931",0,5,0,5,"dummy"
"83042",5,3,1,9,"dummy"
"83043",0,0,1,1,"dummy"
"83044",2,3,1,6,"dummy"
"83049",0,0,1,1,"dummy"
"83050",0,0,1,1,"dummy"
"83051",0,0,1,1,"dummy"
"82838",7,0,0,7,"dummy"
"82839",1,5,1,7,"dummy"
"82840",1,0,0,1,"dummy"
"82841",0,9,0,9,"dummy"
"82842",5,23,4,32,"dummy"
"82843",16,1,0,17,"dummy"
"82844",0,3,0,3,"dummy"
"82849",0,0,0,0,"dummy"
"82852",6,0,0,6,"dummy"
"82853",2,5,2,9,"dummy"
"82889",0,1,0,1,"dummy"
"82890",0,1,0,1,"dummy"
"82891",0,0,0,0,"dummy"
"82892",1,1,0,2,"dummy"
"82893",1,1,0,2,"dummy"
"82894",7,0,0,7,"dummy"
"82910",1,0,0,1,"dummy"
"82911",0,12,0,12,"dummy"
"82912",22,10,1,33,"dummy"
"82913",0,1,1,2,"dummy"
"82914",12,0,0,12,"dummy"
"82915",0,0,0,0,"dummy"
"82918",35,44,1,80,"dummy"
"82921",6,0,0,6,"dummy"
"82922",2,5,2,9,"dummy"
"82927",0,0,0,0,"dummy"
"82928",1,0,0,1,"dummy"
"82983",2,1,0,3,"dummy"
"82984",1,3,0,4,"dummy"
"82985",0,0,0,0,"dummy"
"82986",0,0,0,0,"dummy"
"82987",1,1,1,3,"dummy"
"82988",0,1,0,1,"dummy"
"82989",2,2,1,5,"dummy"
"82992",7,3,0,10,"dummy"
"82993",0,0,0,0,"dummy"
"82994",0,0,1,1,"dummy"
"82995",2,0,0,2,"dummy"
"82996",0,8,0,8,"dummy"
"82997",8,1,0,9,"dummy"
"82998",0,8,0,8,"dummy"
"83003",0,0,1,1,"dummy"
"83004",0,1,0,1,"dummy"
"83005",0,2,0,2,"dummy"
"83006",0,0,0,0,"dummy"
"83007",0,0,1,1,"dummy"
"83008",0,0,1,1,"dummy"
"83009",1,0,0,1,"dummy"
"83018",3,10,1,14,"dummy"
"83019",0,2,0,2,"dummy"
"83020",0,2,0,2,"dummy"
"83021",0,6,2,8,"dummy"
"83022",0,0,1,1,"dummy"
"83023",0,8,1,9,"dummy"
"83024",0,0,1,1,"dummy"
"83025",0,0,0,0,"dummy"
"83026",0,2,0,2,"dummy"
"83027",2,0,0,2,"dummy"
"83028",4,5,3,12,"dummy"
"83029",9,0,0,9,"dummy"
"83030",2,0,0,2,"dummy"
"83031",0,7,0,7,"dummy"
"83032",0,1,0,1,"dummy"
"83033",0,0,1,1,"dummy"
"83034",0,1,0,1,"dummy"
"83035",1,2,0,3,"dummy"
"83036",0,1,0,1,"dummy"
"83037",2,2,0,4,"dummy"
"83038",23,14,4,41,"dummy"
"83039",9,0,1,10,"dummy"
"83040",0,6,0,6,"dummy"
"83053",2,5,2,9,"dummy"
"83054",2,1,0,3,"dummy"
"83055",1,0,0,1,"dummy"
"83056",1,7,0,8,"dummy"
"83057",1,0,0,1,"dummy"
"83058",1,0,0,1,"dummy"
"83059",0,0,1,1,"dummy"
"83060",0,1,0,1,"dummy"
"83063",0,0,1,1,"dummy"
"83070",7,12,1,20,"dummy"
"83072",0,0,2,2,"dummy"
"83074",1,2,0,3,"dummy"
"83077",0,3,1,4,"dummy"
"83078",4,0,0,4,"dummy"
"83079",0,1,0,1,"dummy"
"83080",0,4,0,4,"dummy"
"83090",0,0,1,1,"dummy"
"83093",1,2,0,3,"dummy"
"83094",0,0,1,1,"dummy"
"83095",2,2,0,4,"dummy"
"83096",0,1,0,1,"dummy"
"83097",0,0,1,1,"dummy"
"83098",2,2,0,4,"dummy"
"83100",0,2,0,2,"dummy"
"83122",1,4,0,5,"dummy"
"83123",0,0,1,1,"dummy"
"83125",0,1,1,2,"dummy"
"83127",0,2,0,2,"dummy"
"83128",0,3,3,6,"dummy"
"83129",11,12,3,26,"dummy"
"83130",10,2,0,12,"dummy"
"83145",0,0,1,1,"dummy"
"83146",1,1,0,2,"dummy"
"83147",0,0,4,4,"dummy"
"83148",0,0,2,2,"dummy"
"83149",0,0,0,0,"dummy"
"83152",0,0,1,1,"dummy"
"83153",0,0,1,1,"dummy"
"83154",3,6,1,10,"dummy"
"83155",2,2,2,6,"dummy"
"83156",0,1,2,3,"dummy"
"83158",0,0,1,1,"dummy"
"83160",0,2,0,2,"dummy"
"83162",0,0,0,0,"dummy"
"83163",0,1,0,1,"dummy"
"83164",0,2,0,2,"dummy"
"83183",0,3,3,6,"dummy"
"83184",0,5,0,5,"dummy"
"83185",0,1,0,1,"dummy"
"83186",2,3,0,5,"dummy"
"83187",0,0,1,1,"dummy"
"83188",0,1,0,1,"dummy"
"83189",0,0,1,1,"dummy"
"83192",0,2,0,2,"dummy"
"83193",0,0,1,1,"dummy"
"83194",0,0,1,1,"dummy"
"83196",0,0,1,1,"dummy"
"83197",0,0,0,0,"dummy"
"83199",6,0,0,6,"dummy"
"83200",2,5,2,9,"dummy"
"83204",0,5,0,5,"dummy"
"83206",0,0,0,0,"dummy"
"83207",0,0,0,0,"dummy"
"83210",0,0,1,1,"dummy"
"83211",3,3,0,6,"dummy"
"83212",0,1,0,1,"dummy"
"83213",0,0,3,3,"dummy"
"83214",3,2,3,8,"dummy"
"83215",0,1,3,4,"dummy"
"83216",0,0,3,3,"dummy"
"83217",3,3,0,6,"dummy"
"83218",0,0,1,1,"dummy"
"83219",0,0,1,1,"dummy"
"83220",2,2,0,4,"dummy"
"83221",4,0,0,4,"dummy"
"83222",0,0,1,1,"dummy"
"83223",0,1,1,2,"dummy"
"83224",0,0,1,1,"dummy"
"83225",0,0,1,1,"dummy"
"83226",0,0,1,1,"dummy"
"83227",0,0,1,1,"dummy"
"83228",0,0,1,1,"dummy"
"83229",0,0,1,1,"dummy"
"83232",0,0,0,0,"dummy"
"83233",9,10,0,19,"dummy"
"83234",2,3,1,6,"dummy"
"83235",0,2,0,2,"dummy"
"83236",0,1,1,2,"dummy"
"83237",0,8,0,8,"dummy"
"83238",0,5,0,5,"dummy"
"83239",1,5,0,6,"dummy"
"83240",0,2,0,2,"dummy"
"83241",1,0,0,1,"dummy"
"83242",0,0,0,0,"dummy"
"83243",0,0,5,5,"dummy"
"83244",0,13,0,13,"dummy"
"83245",0,6,0,6,"dummy"
"83247",0,0,1,1,"dummy"
"83248",0,0,0,0,"dummy"
"83249",3,3,0,6,"dummy"
"83250",3,3,1,7,"dummy"
"83251",0,0,0,0,"dummy"
"83252",0,0,2,2,"dummy"
"83253",0,0,3,3,"dummy"
"83254",0,4,3,7,"dummy"
"83255",0,1,0,1,"dummy"
"83256",2,2,2,6,"dummy"
"83257",0,0,1,1,"dummy"
"83258",0,1,1,2,"dummy"
"83259",0,1,0,1,"dummy"
"83264",0,0,2,2,"dummy"
"83265",0,0,0,0,"dummy"
"83267",1,0,0,1,"dummy"
"83268",0,1,0,1,"dummy"
"83269",0,0,0,0,"dummy"
"83270",0,0,0,0,"dummy"
"83271",1,1,0,2,"dummy"
"83272",1,2,0,3,"dummy"
"83273",0,1,0,1,"dummy"
"83274",0,1,0,1,"dummy"
"83275",2,6,0,8,"dummy"
"83276",1,0,0,1,"dummy"
"83277",0,0,0,0,"dummy"
"83278",0,1,0,1,"dummy"
"83279",0,0,1,1,"dummy"
"83280",0,2,0,2,"dummy"
"83281",0,2,0,2,"dummy"
"83283",3,0,1,4,"dummy"
"83285",0,5,2,7,"dummy"
"83288",0,2,0,2,"dummy"
"83289",0,0,1,1,"dummy"
"83290",0,1,0,1,"dummy"
"83291",0,0,0,0,"dummy"
"83292",0,1,1,2,"dummy"
"83293",0,2,0,2,"dummy"
"83304",0,0,1,1,"dummy"
"83307",6,1,1,8,"dummy"
"83308",0,1,0,1,"dummy"
"83319",1,1,2,4,"dummy"
"83320",2,1,0,3,"dummy"
"83321",0,4,1,5,"dummy"
"83322",5,1,2,8,"dummy"
"83323",2,2,2,6,"dummy"
"83324",2,2,0,4,"dummy"
"83326",0,2,0,2,"dummy"
"83327",0,0,1,1,"dummy"
"83328",0,0,2,2,"dummy"
"83329",2,0,0,2,"dummy"
"83330",0,0,1,1,"dummy"
"83331",0,0,1,1,"dummy"
"83332",0,1,0,1,"dummy"
"83333",1,0,1,2,"dummy"
"83334",0,1,0,1,"dummy"
"83335",1,0,0,1,"dummy"
"83336",1,0,1,2,"dummy"
"83337",0,1,0,1,"dummy"
"83338",0,0,1,1,"dummy"
"83339",0,0,1,1,"dummy"
"83340",0,0,2,2,"dummy"
"83341",0,1,0,1,"dummy"
"83342",0,0,1,1,"dummy"
"83343",0,1,0,1,"dummy"
"83344",0,0,1,1,"dummy"
"83345",0,0,1,1,"dummy"
"83346",0,0,1,1,"dummy"
"83347",0,0,1,1,"dummy"
"83348",0,0,1,1,"dummy"
"83349",0,0,2,2,"dummy"
"83350",0,0,1,1,"dummy"
"83351",3,0,0,3,"dummy"
"83352",0,0,1,1,"dummy"
"83353",0,0,1,1,"dummy"
"83354",0,0,1,1,"dummy"
"83355",0,0,1,1,"dummy"
"83356",0,0,1,1,"dummy"
"83357",0,0,1,1,"dummy"
"83359",0,0,0,0,"dummy"
"83360",0,0,0,0,"dummy"
"83361",0,2,0,2,"dummy"
"83362",0,1,0,1,"dummy"
"83363",0,0,1,1,"dummy"
"83365",0,0,0,0,"dummy"
"83367",0,0,2,2,"dummy"
"83368",0,0,0,0,"dummy"
"83369",0,0,1,1,"dummy"
"83370",0,0,0,0,"dummy"
"83371",0,0,1,1,"dummy"
"83372",1,1,3,5,"dummy"
"83373",1,1,3,5,"dummy"
"83375",0,0,1,1,"dummy"
"83378",0,1,0,1,"dummy"
"83379",22,1,2,25,"dummy"
"83380",3,3,1,7,"dummy"
"83395",0,0,0,0,"dummy"
"83396",0,0,0,0,"dummy"
"83397",0,0,0,0,"dummy"
"83398",0,0,1,1,"dummy"
"83399",0,0,0,0,"dummy"
"83400",0,0,1,1,"dummy"
"83402",2,5,2,9,"dummy"
"83406",0,2,0,2,"dummy"
"83410",0,1,0,1,"dummy"
"83411",0,0,1,1,"dummy"
"83412",0,1,1,2,"dummy"
"83414",0,0,2,2,"dummy"
"83416",2,1,0,3,"dummy"
"83417",0,5,0,5,"dummy"
"83427",1,0,1,2,"dummy"
"83428",0,0,1,1,"dummy"
"83430",0,1,0,1,"dummy"
"83431",0,0,6,6,"dummy"
"83432",0,6,1,7,"dummy"
"83433",7,18,0,25,"dummy"
"83434",4,0,0,4,"dummy"
"83436",1,0,0,1,"dummy"
"83437",0,2,0,2,"dummy"
"83438",19,22,5,46,"dummy"
"83439",0,1,0,1,"dummy"
"83442",2,4,0,6,"dummy"
"83443",0,2,0,2,"dummy"
"83444",0,2,0,2,"dummy"
"83445",10,2,0,12,"dummy"
"83446",0,2,0,2,"dummy"
"83452",4,5,0,9,"dummy"
"83453",0,0,1,1,"dummy"
"83454",0,1,0,1,"dummy"
"83455",0,5,0,5,"dummy"
"83456",0,0,1,1,"dummy"
"83457",0,2,0,2,"dummy"
"83459",16,7,1,24,"dummy"
"83460",0,5,0,5,"dummy"
"83461",0,1,0,1,"dummy"
"83462",0,2,0,2,"dummy"
"83463",0,2,0,2,"dummy"
"83464",3,6,0,9,"dummy"
"83465",1,1,0,2,"dummy"
"83466",0,14,0,14,"dummy"
"83467",1,9,0,10,"dummy"
"83470",6,7,0,13,"dummy"
"83471",0,2,0,2,"dummy"
"83472",1,1,1,3,"dummy"
"83476",9,6,0,15,"dummy"
"83477",3,3,1,7,"dummy"
"83478",0,0,1,1,"dummy"
"83479",0,0,0,0,"dummy"
"83480",0,0,1,1,"dummy"
"83481",0,0,2,2,"dummy"
"83482",3,3,0,6,"dummy"
"83483",0,0,1,1,"dummy"
"83486",2,1,0,3,"dummy"
"83487",1,0,1,2,"dummy"
"83488",0,3,0,3,"dummy"
"83491",0,0,1,1,"dummy"
"83492",2,3,0,5,"dummy"
"83493",0,1,0,1,"dummy"
"83494",0,3,1,4,"dummy"
"83495",0,19,0,19,"dummy"
"83496",1,0,0,1,"dummy"
"83497",3,4,0,7,"dummy"
"83498",1,1,1,3,"dummy"
"83499",0,0,1,1,"dummy"
"83500",0,0,1,1,"dummy"
"83501",0,0,0,0,"dummy"
"83502",13,6,2,21,"dummy"
"83503",0,1,1,2,"dummy"
"83504",0,1,0,1,"dummy"
"83505",1,1,0,2,"dummy"
"83506",4,0,2,6,"dummy"
"83507",0,0,0,0,"dummy"
"83508",1,0,0,1,"dummy"
"83509",11,2,4,17,"dummy"
"83510",0,0,3,3,"dummy"
"83511",2,2,0,4,"dummy"
"83512",0,0,0,0,"dummy"
"83513",1,0,0,1,"dummy"
"83514",1,1,0,2,"dummy"
"83517",0,0,1,1,"dummy"
"83518",0,0,1,1,"dummy"
"83519",0,4,0,4,"dummy"
"83520",1,5,1,7,"dummy"
"83522",0,0,1,1,"dummy"
"83523",0,0,1,1,"dummy"
"83524",0,0,1,1,"dummy"
"83525",3,3,1,7,"dummy"
"83526",0,0,1,1,"dummy"
"83527",0,0,1,1,"dummy"
"83528",0,0,1,1,"dummy"
"83529",0,0,1,1,"dummy"
"83530",0,0,1,1,"dummy"
"83531",0,8,1,9,"dummy"
"83532",0,0,1,1,"dummy"
"83533",0,0,1,1,"dummy"
"83534",3,3,1,7,"dummy"
"83535",0,0,1,1,"dummy"
"83536",0,0,1,1,"dummy"
"83537",0,0,1,1,"dummy"
"83538",0,1,1,2,"dummy"
"83539",0,0,1,1,"dummy"
"83540",0,0,1,1,"dummy"
"83541",0,0,1,1,"dummy"
"83546",0,1,0,1,"dummy"
"83547",2,2,1,5,"dummy"
"83548",0,0,3,3,"dummy"
"83550",0,2,0,2,"dummy"
"83551",1,7,0,8,"dummy"
"83552",2,0,0,2,"dummy"
"83553",2,3,2,7,"dummy"
"83554",0,0,1,1,"dummy"
"83555",3,7,4,14,"dummy"
"83556",0,3,0,3,"dummy"
"83557",0,0,3,3,"dummy"
"83558",23,14,2,39,"dummy"
"83562",3,0,0,3,"dummy"
"83563",0,1,0,1,"dummy"
"83564",0,4,1,5,"dummy"
"83565",0,0,1,1,"dummy"
"83571",1,9,1,11,"dummy"
"83572",10,1,1,12,"dummy"
"83573",0,2,1,3,"dummy"
"83577",0,4,0,4,"dummy"
"83578",0,0,1,1,"dummy"
"83580",0,3,0,3,"dummy"
"83592",0,0,0,0,"dummy"
"83593",0,0,0,0,"dummy"
"83594",0,0,1,1,"dummy"
"83595",0,0,1,1,"dummy"
"83596",0,0,1,1,"dummy"
"83598",0,0,1,1,"dummy"
"83606",3,3,0,6,"dummy"
"83607",2,6,2,10,"dummy"
"83608",19,10,0,29,"dummy"
"83623",3,3,0,6,"dummy"
"83624",19,9,3,31,"dummy"
"83625",0,0,1,1,"dummy"
"83630",0,1,0,1,"dummy"
"83631",0,0,1,1,"dummy"
"83632",3,0,0,3,"dummy"
"83634",0,2,0,2,"dummy"
"83641",0,0,3,3,"dummy"
"83645",1,0,0,1,"dummy"
"83646",0,1,0,1,"dummy"
"83647",0,2,0,2,"dummy"
"83648",0,0,1,1,"dummy"
"83649",0,0,0,0,"dummy"
"83650",7,7,0,14,"dummy"
"83651",0,0,1,1,"dummy"
"83653",0,0,1,1,"dummy"
"83654",0,1,0,1,"dummy"
"83669",2,0,3,5,"dummy"
"83677",0,0,1,1,"dummy"
"83678",0,0,1,1,"dummy"
"83679",0,0,1,1,"dummy"
"83681",0,1,0,1,"dummy"
"83685",2,1,1,4,"dummy"
"83689",0,0,1,1,"dummy"
"83691",0,1,0,1,"dummy"
"83692",0,0,1,1,"dummy"
"83693",0,2,0,2,"dummy"
"83694",2,0,0,2,"dummy"
"83697",0,2,2,4,"dummy"
"83699",0,0,1,1,"dummy"
"83700",0,0,1,1,"dummy"
"83701",0,0,1,1,"dummy"
"83702",0,0,1,1,"dummy"
"83703",0,0,1,1,"dummy"
"83706",0,11,1,12,"dummy"
"83714",0,2,7,9,"dummy"
"83717",1,1,2,4,"dummy"
"83718",1,2,0,3,"dummy"
"83719",0,1,0,1,"dummy"
"83722",9,12,1,22,"dummy"
"83723",0,0,1,1,"dummy"
"83724",2,0,0,2,"dummy"
"83743",0,3,0,3,"dummy"
"83745",0,0,0,0,"dummy"
"83747",0,1,0,1,"dummy"
"83749",0,2,0,2,"dummy"
"83750",0,0,1,1,"dummy"
"83751",0,0,1,1,"dummy"
"83753",17,17,6,40,"dummy"
"83754",1,0,0,1,"dummy"
"83755",0,0,1,1,"dummy"
"83756",0,1,0,1,"dummy"
"83757",1,0,0,1,"dummy"
"83758",0,1,0,1,"dummy"
"83759",0,0,1,1,"dummy"
"83760",0,0,1,1,"dummy"
"83761",0,5,1,6,"dummy"
"83762",2,2,0,4,"dummy"
"83764",0,1,0,1,"dummy"
"83765",0,1,0,1,"dummy"
"83767",0,0,1,1,"dummy"
"83771",6,8,1,15,"dummy"
"83772",0,1,0,1,"dummy"
"83773",6,3,0,9,"dummy"
"83774",9,12,0,21,"dummy"
"83775",1,0,2,3,"dummy"
"83776",0,1,0,1,"dummy"
"83777",4,3,0,7,"dummy"
"83778",1,2,0,3,"dummy"
"83779",1,0,0,1,"dummy"
"83792",1,1,0,2,"dummy"
"83794",0,0,1,1,"dummy"
"83795",3,10,0,13,"dummy"
"83798",1,1,0,2,"dummy"
"83799",0,2,0,2,"dummy"
"83801",0,12,1,13,"dummy"
"83802",5,15,3,23,"dummy"
"83806",0,0,1,1,"dummy"
"83808",2,4,0,6,"dummy"
"83809",3,1,1,5,"dummy"
"83815",1,2,1,4,"dummy"
"83816",1,1,0,2,"dummy"
"83818",0,6,1,7,"dummy"
"83821",0,0,1,1,"dummy"
"83822",0,0,1,1,"dummy"
"83823",0,0,1,1,"dummy"
"83824",0,0,1,1,"dummy"
"83825",0,0,1,1,"dummy"
"83826",0,0,1,1,"dummy"
"83827",0,0,1,1,"dummy"
"83828",0,0,1,1,"dummy"
"83829",0,0,1,1,"dummy"
"83830",0,0,1,1,"dummy"
"83831",0,0,1,1,"dummy"
"83832",0,0,1,1,"dummy"
"83833",0,0,1,1,"dummy"
"83835",0,2,1,3,"dummy"
"83836",0,4,0,4,"dummy"
"83838",1,0,0,1,"dummy"
"83841",0,0,1,1,"dummy"
"83843",0,0,1,1,"dummy"
"83845",6,0,0,6,"dummy"
"83848",0,0,1,1,"dummy"
"83849",0,0,1,1,"dummy"
"83850",0,0,1,1,"dummy"
"83851",0,0,1,1,"dummy"
"83853",0,1,0,1,"dummy"
"83854",0,1,4,5,"dummy"
"83855",0,0,1,1,"dummy"
"83860",0,0,1,1,"dummy"
"83861",0,0,1,1,"dummy"
"83862",0,8,1,9,"dummy"
"83863",2,2,1,5,"dummy"
"83864",1,1,0,2,"dummy"
"83865",3,5,0,8,"dummy"
"83866",5,0,0,5,"dummy"
"83867",1,2,2,5,"dummy"
"83868",0,0,0,0,"dummy"
"83869",0,0,0,0,"dummy"
"83870",0,0,0,0,"dummy"
"83871",16,16,1,33,"dummy"
"83872",0,0,0,0,"dummy"
"83873",15,16,2,33,"dummy"
"83874",0,0,0,0,"dummy"
"83875",0,0,0,0,"dummy"
"83876",0,0,0,0,"dummy"
"83877",0,0,0,0,"dummy"
"83878",0,2,0,2,"dummy"
"83879",0,3,0,3,"dummy"
"83882",0,0,1,1,"dummy"
"83883",0,0,1,1,"dummy"
"83886",4,4,0,8,"dummy"
"83887",0,3,0,3,"dummy"
"83888",0,1,0,1,"dummy"
"83889",4,0,0,4,"dummy"
"83895",4,2,0,6,"dummy"
"83900",0,13,1,14,"dummy"
"83901",0,0,1,1,"dummy"
"83902",1,0,2,3,"dummy"
"83903",2,2,0,4,"dummy"
"83905",0,1,0,1,"dummy"
"83906",0,8,0,8,"dummy"
"83907",0,1,0,1,"dummy"
"83908",0,0,2,2,"dummy"
"83910",1,4,0,5,"dummy"
"83911",4,9,3,16,"dummy"
"83913",0,2,0,2,"dummy"
"83914",0,2,0,2,"dummy"
"83915",0,0,1,1,"dummy"
"83916",0,0,1,1,"dummy"
"83917",0,0,1,1,"dummy"
"83918",0,0,1,1,"dummy"
"83919",0,0,1,1,"dummy"
"83920",0,0,1,1,"dummy"
"83921",0,0,1,1,"dummy"
"83922",0,0,2,2,"dummy"
"83923",0,0,1,1,"dummy"
"83924",1,2,0,3,"dummy"
"83925",0,0,2,2,"dummy"
"83926",0,0,1,1,"dummy"
"83927",0,0,1,1,"dummy"
"83928",0,0,1,1,"dummy"
"83930",0,0,1,1,"dummy"
"83931",0,0,0,0,"dummy"
"83932",7,0,1,8,"dummy"
"83933",0,1,0,1,"dummy"
"83934",1,2,0,3,"dummy"
"83935",0,0,1,1,"dummy"
"83960",0,1,4,5,"dummy"
"83961",0,0,5,5,"dummy"
"83962",0,1,4,5,"dummy"
"83963",0,1,0,1,"dummy"
"83964",0,1,0,1,"dummy"
"83965",1,2,1,4,"dummy"
"83968",7,9,0,16,"dummy"
"83970",0,1,0,1,"dummy"
"83971",0,1,0,1,"dummy"
"83973",0,0,1,1,"dummy"
"83975",1,0,0,1,"dummy"
"83976",0,4,0,4,"dummy"
"83977",0,3,0,3,"dummy"
"83980",0,0,0,0,"dummy"
"83981",0,2,0,2,"dummy"
"83982",0,1,0,1,"dummy"
"83983",0,1,0,1,"dummy"
"83984",0,0,3,3,"dummy"
"83986",2,3,0,5,"dummy"
"83987",0,2,0,2,"dummy"
"83988",0,0,0,0,"dummy"
"83989",0,1,0,1,"dummy"
"83992",0,12,0,12,"dummy"
"83993",6,7,1,14,"dummy"
"83994",1,0,0,1,"dummy"
"83995",2,3,0,5,"dummy"
"83996",0,0,1,1,"dummy"
"83998",0,0,1,1,"dummy"
"83999",0,0,1,1,"dummy"
"84000",0,7,0,7,"dummy"
"84001",0,0,1,1,"dummy"
"84002",0,0,1,1,"dummy"
"84003",0,0,1,1,"dummy"
"84004",0,0,1,1,"dummy"
"84005",0,0,1,1,"dummy"
"84006",0,0,1,1,"dummy"
"84007",0,0,0,0,"dummy"
"84008",0,0,1,1,"dummy"
"84009",0,0,1,1,"dummy"
"84010",0,0,1,1,"dummy"
"84011",0,0,1,1,"dummy"
"84012",0,1,0,1,"dummy"
"84013",0,0,0,0,"dummy"
"84014",0,0,1,1,"dummy"
"84015",0,0,1,1,"dummy"
"84016",0,0,1,1,"dummy"
"84017",0,0,1,1,"dummy"
"84018",0,0,1,1,"dummy"
"84019",0,0,1,1,"dummy"
"84020",0,0,1,1,"dummy"
"84021",0,0,1,1,"dummy"
"84022",0,0,1,1,"dummy"
"84023",0,0,1,1,"dummy"
"84024",0,0,1,1,"dummy"
"84025",0,0,1,1,"dummy"
"84026",0,0,1,1,"dummy"
"84027",0,0,1,1,"dummy"
"84028",0,0,1,1,"dummy"
"84031",0,0,1,1,"dummy"
"84032",2,3,1,6,"dummy"
"84033",0,0,0,0,"dummy"
"84035",0,28,0,28,"dummy"
"84040",12,5,0,17,"dummy"
"84042",0,0,1,1,"dummy"
"84043",0,0,1,1,"dummy"
"84045",2,0,0,2,"dummy"
"84046",0,2,0,2,"dummy"
"84049",1,2,0,3,"dummy"
"84050",2,1,0,3,"dummy"
"84054",1,2,3,6,"dummy"
"84063",7,5,1,13,"dummy"
"84068",2,1,0,3,"dummy"
"84079",0,1,0,1,"dummy"
"84085",1,1,1,3,"dummy"
"84087",5,5,0,10,"dummy"
"84090",0,4,0,4,"dummy"
"84091",0,0,0,0,"dummy"
"84092",4,4,0,8,"dummy"
"84093",0,0,0,0,"dummy"
"84094",0,0,1,1,"dummy"
"84095",0,0,0,0,"dummy"
"84096",0,0,1,1,"dummy"
"84097",0,4,0,4,"dummy"
"84098",0,1,0,1,"dummy"
"84099",0,0,1,1,"dummy"
"84111",2,0,0,2,"dummy"
"84112",0,0,1,1,"dummy"
"84114",0,0,2,2,"dummy"
"84122",0,1,0,1,"dummy"
"84126",0,0,0,0,"dummy"
"84127",0,0,0,0,"dummy"
"84128",0,0,0,0,"dummy"
"84129",0,0,0,0,"dummy"
"84130",0,2,1,3,"dummy"
"84131",0,0,0,0,"dummy"
"84132",0,0,0,0,"dummy"
"84133",0,0,0,0,"dummy"
"84134",0,0,0,0,"dummy"
"84135",0,0,0,0,"dummy"
"84136",0,0,0,0,"dummy"
"84137",0,0,0,0,"dummy"
"84138",0,0,0,0,"dummy"
"84139",0,0,0,0,"dummy"
"84146",1,1,5,7,"dummy"
"84147",0,0,2,2,"dummy"
"84148",0,0,2,2,"dummy"
"84149",0,0,2,2,"dummy"
"84150",0,0,2,2,"dummy"
"84151",0,0,2,2,"dummy"
"84152",0,0,2,2,"dummy"
"84153",0,1,0,1,"dummy"
"84154",0,0,2,2,"dummy"
"84156",14,21,6,41,"dummy"
"84157",0,0,1,1,"dummy"
"84158",0,0,1,1,"dummy"
"84160",0,2,0,2,"dummy"
"84161",0,6,0,6,"dummy"
"84162",1,2,1,4,"dummy"
"84163",0,1,0,1,"dummy"
"84164",0,0,1,1,"dummy"
"84165",1,2,1,4,"dummy"
"84166",0,1,0,1,"dummy"
"84167",0,1,0,1,"dummy"
"84169",0,8,0,8,"dummy"
"84170",0,0,1,1,"dummy"
"84189",0,2,0,2,"dummy"
"84190",0,5,2,7,"dummy"
"84191",0,5,1,6,"dummy"
"84192",6,15,3,24,"dummy"
"84193",3,4,3,10,"dummy"
"84194",0,1,0,1,"dummy"
"84195",4,4,1,9,"dummy"
"84196",0,5,0,5,"dummy"
"84197",5,5,0,10,"dummy"
"84198",3,0,1,4,"dummy"
"84199",0,0,1,1,"dummy"
"84200",20,7,4,31,"dummy"
"84201",5,5,0,10,"dummy"
"84202",0,1,0,1,"dummy"
"84203",2,1,0,3,"dummy"
"84204",8,18,1,27,"dummy"
"84211",3,2,1,6,"dummy"
"84212",0,0,1,1,"dummy"
"84213",0,0,1,1,"dummy"
"84214",4,5,4,13,"dummy"
"84215",9,9,1,19,"dummy"
"84216",3,6,1,10,"dummy"
"84217",0,0,4,4,"dummy"
"84218",5,1,0,6,"dummy"
"84219",8,3,1,12,"dummy"
"84220",3,2,0,5,"dummy"
"84221",4,2,5,11,"dummy"
"84222",7,12,4,23,"dummy"
"84223",0,1,0,1,"dummy"
"84227",0,0,3,3,"dummy"
"84228",0,0,1,1,"dummy"
"84229",0,0,3,3,"dummy"
"84230",1,1,2,4,"dummy"
"84231",0,0,3,3,"dummy"
"84232",1,2,0,3,"dummy"
"84233",0,0,3,3,"dummy"
"84234",2,1,0,3,"dummy"
"84235",0,1,0,1,"dummy"
"84238",0,1,0,1,"dummy"
"84240",2,0,1,3,"dummy"
"84242",1,0,2,3,"dummy"
"84243",0,1,2,3,"dummy"
"84244",0,1,0,1,"dummy"
"84245",0,0,0,0,"dummy"
"84246",0,0,1,1,"dummy"
"84247",0,0,3,3,"dummy"
"84248",0,0,3,3,"dummy"
"84249",0,0,4,4,"dummy"
"84250",2,3,1,6,"dummy"
"84254",0,0,0,0,"dummy"
"84255",0,0,0,0,"dummy"
"84265",0,0,0,0,"dummy"
"84266",0,0,1,1,"dummy"
"84267",0,0,1,1,"dummy"
"84270",0,1,0,1,"dummy"
"84273",0,2,0,2,"dummy"
"84274",1,0,1,2,"dummy"
"84276",0,4,0,4,"dummy"
"84282",1,0,0,1,"dummy"
"84283",0,2,0,2,"dummy"
"84284",0,1,1,2,"dummy"
"84285",1,3,0,4,"dummy"
"84286",0,1,1,2,"dummy"
"84288",1,10,2,13,"dummy"
"84291",0,4,0,4,"dummy"
"84292",0,0,1,1,"dummy"
"84293",0,1,1,2,"dummy"
"84294",0,0,1,1,"dummy"
"84295",0,1,0,1,"dummy"
"84296",0,0,1,1,"dummy"
"84297",1,1,0,2,"dummy"
"84298",6,1,0,7,"dummy"
"84299",0,0,0,0,"dummy"
"84302",0,1,0,1,"dummy"
"84305",12,2,0,14,"dummy"
"84306",0,0,0,0,"dummy"
"84307",0,0,0,0,"dummy"
"84308",0,0,0,0,"dummy"
"84310",13,10,0,23,"dummy"
"84311",0,1,0,1,"dummy"
"84317",12,13,5,30,"dummy"
"84318",0,0,2,2,"dummy"
"84320",0,3,0,3,"dummy"
"84321",0,0,1,1,"dummy"
"84323",0,2,1,3,"dummy"
"84325",0,0,1,1,"dummy"
"84326",0,0,1,1,"dummy"
"84327",0,0,1,1,"dummy"
"84354",0,1,0,1,"dummy"
"84355",0,1,0,1,"dummy"
"84356",0,1,0,1,"dummy"
"84357",0,0,1,1,"dummy"
"84358",0,2,1,3,"dummy"
"84359",0,0,1,1,"dummy"
"84360",0,0,1,1,"dummy"
"84361",0,1,2,3,"dummy"
"84362",0,0,1,1,"dummy"
"84363",0,0,1,1,"dummy"
"84364",0,1,0,1,"dummy"
"84365",0,2,0,2,"dummy"
"84366",0,0,1,1,"dummy"
"84368",0,1,0,1,"dummy"
"84371",0,0,2,2,"dummy"
"84373",0,0,1,1,"dummy"
"84375",1,12,1,14,"dummy"
"84376",1,4,0,5,"dummy"
"84377",0,1,0,1,"dummy"
"84378",5,2,0,7,"dummy"
"84380",0,0,2,2,"dummy"
"84381",0,0,1,1,"dummy"
"84386",0,0,1,1,"dummy"
"84388",6,4,3,13,"dummy"
"84389",1,1,0,2,"dummy"
"84390",0,8,3,11,"dummy"
"84391",1,14,0,15,"dummy"
"84392",1,3,0,4,"dummy"
"84393",1,0,0,1,"dummy"
"84394",2,1,0,3,"dummy"
"84395",1,2,0,3,"dummy"
"84397",0,1,0,1,"dummy"
"84398",0,0,1,1,"dummy"
"84399",0,0,1,1,"dummy"
"84400",0,1,1,2,"dummy"
"84402",0,6,0,6,"dummy"
"84403",0,0,0,0,"dummy"
"84404",0,4,0,4,"dummy"
"84405",2,0,0,2,"dummy"
"84406",7,9,5,21,"dummy"
"84407",1,0,0,1,"dummy"
"84408",6,12,2,20,"dummy"
"84409",7,3,2,12,"dummy"
"84410",0,1,2,3,"dummy"
"84411",1,0,2,3,"dummy"
"84412",0,0,0,0,"dummy"
"84413",0,1,2,3,"dummy"
"84414",1,0,0,1,"dummy"
"84415",0,0,0,0,"dummy"
"84419",2,3,0,5,"dummy"
"84420",1,3,2,6,"dummy"
"84421",0,1,0,1,"dummy"
"84422",1,0,0,1,"dummy"
"84424",0,2,0,2,"dummy"
"84425",0,1,0,1,"dummy"
"84426",0,3,0,3,"dummy"
"84427",0,0,1,1,"dummy"
"84428",0,0,1,1,"dummy"
"84429",0,3,1,4,"dummy"
"84430",0,1,0,1,"dummy"
"84431",2,5,1,8,"dummy"
"84432",0,1,0,1,"dummy"
"84433",0,0,1,1,"dummy"
"84436",0,0,0,0,"dummy"
"84437",0,0,0,0,"dummy"
"84439",0,0,1,1,"dummy"
"84440",0,0,1,1,"dummy"
"84441",0,0,1,1,"dummy"
"84444",0,0,2,2,"dummy"
"84445",0,1,0,1,"dummy"
"84446",0,12,0,12,"dummy"
"84447",0,1,0,1,"dummy"
"84448",0,2,1,3,"dummy"
"84451",0,5,0,5,"dummy"
"84452",6,2,2,10,"dummy"
"84454",3,0,2,5,"dummy"
"84460",5,7,0,12,"dummy"
"84461",0,0,1,1,"dummy"
"84465",0,1,0,1,"dummy"
"84466",1,0,2,3,"dummy"
"84467",0,0,0,0,"dummy"
"84468",0,0,1,1,"dummy"
"84469",0,0,1,1,"dummy"
"84470",0,0,1,1,"dummy"
"84471",0,0,1,1,"dummy"
"84472",0,0,1,1,"dummy"
"84473",0,0,1,1,"dummy"
"84474",0,0,1,1,"dummy"
"84475",0,0,1,1,"dummy"
"84476",0,0,1,1,"dummy"
"84477",0,0,1,1,"dummy"
"84478",0,0,1,1,"dummy"
"84479",0,0,1,1,"dummy"
"84480",0,0,1,1,"dummy"
"84481",0,0,1,1,"dummy"
"84482",0,0,1,1,"dummy"
"84483",0,0,1,1,"dummy"
"84484",0,0,1,1,"dummy"
"84491",2,0,2,4,"dummy"
"84493",0,0,0,0,"dummy"
"84494",4,1,0,5,"dummy"
"84495",11,4,5,20,"dummy"
"84496",0,1,0,1,"dummy"
"84497",3,1,0,4,"dummy"
"84498",0,0,3,3,"dummy"
"84499",4,4,6,14,"dummy"
"84500",0,0,4,4,"dummy"
"84501",0,0,7,7,"dummy"
"84504",0,6,0,6,"dummy"
"84508",1,1,0,2,"dummy"
"84509",1,0,0,1,"dummy"
"84511",0,1,2,3,"dummy"
"84512",0,0,0,0,"dummy"
"84513",0,1,0,1,"dummy"
"84514",4,0,2,6,"dummy"
"84515",1,0,0,1,"dummy"
"84516",0,0,0,0,"dummy"
"84517",0,0,0,0,"dummy"
"84532",0,6,1,7,"dummy"
"84533",1,7,1,9,"dummy"
"84534",0,1,0,1,"dummy"
"84536",0,1,2,3,"dummy"
"84538",0,0,1,1,"dummy"
"84539",0,0,1,1,"dummy"
"84544",0,9,3,12,"dummy"
"84545",2,6,0,8,"dummy"
"84546",0,2,0,2,"dummy"
"84547",0,0,2,2,"dummy"
"84548",1,3,0,4,"dummy"
"84551",0,0,1,1,"dummy"
"84552",1,4,1,6,"dummy"
"84553",0,1,0,1,"dummy"
"84554",0,0,1,1,"dummy"
"84563",0,6,0,6,"dummy"
"84604",0,0,3,3,"dummy"
"84605",0,1,0,1,"dummy"
"84606",0,0,0,0,"dummy"
"84607",0,0,1,1,"dummy"
"84608",4,1,2,7,"dummy"
"84610",0,1,0,1,"dummy"
"84611",1,0,0,1,"dummy"
"84612",0,0,1,1,"dummy"
"84613",0,0,0,0,"dummy"
"84615",0,1,1,2,"dummy"
"84616",0,0,1,1,"dummy"
"84617",0,0,3,3,"dummy"
"84618",0,0,1,1,"dummy"
"84620",0,0,2,2,"dummy"
"84621",0,0,2,2,"dummy"
"84622",0,0,1,1,"dummy"
"84624",0,1,0,1,"dummy"
"84625",1,0,0,1,"dummy"
"84626",0,0,0,0,"dummy"
"84627",6,16,8,30,"dummy"
"84628",16,6,8,30,"dummy"
"84629",0,1,0,1,"dummy"
"84631",1,6,0,7,"dummy"
"84632",4,6,0,10,"dummy"
"84633",0,4,0,4,"dummy"
"84636",0,0,0,0,"dummy"
"84639",0,0,1,1,"dummy"
"84640",0,0,1,1,"dummy"
"84641",0,0,2,2,"dummy"
"84642",0,0,1,1,"dummy"
"84643",0,0,0,0,"dummy"
"84644",2,0,0,2,"dummy"
"84645",0,0,1,1,"dummy"
"84646",0,1,1,2,"dummy"
"84647",0,0,1,1,"dummy"
"84648",0,0,1,1,"dummy"
"84649",0,0,1,1,"dummy"
"84650",0,2,0,2,"dummy"
"84651",0,1,0,1,"dummy"
"84652",0,4,0,4,"dummy"
"84653",1,0,0,1,"dummy"
"84654",0,1,0,1,"dummy"
"84655",1,2,0,3,"dummy"
"84656",0,1,0,1,"dummy"
"84657",0,10,0,10,"dummy"
"84658",10,2,0,12,"dummy"
"84659",2,0,0,2,"dummy"
"84660",0,2,0,2,"dummy"
"84661",0,10,0,10,"dummy"
"84662",0,0,0,0,"dummy"
"84663",0,0,0,0,"dummy"
"84664",0,0,2,2,"dummy"
"84665",8,2,0,10,"dummy"
"84666",2,0,0,2,"dummy"
"84667",0,0,0,0,"dummy"
"84668",0,0,0,0,"dummy"
"84669",1,0,0,1,"dummy"
"84670",0,0,0,0,"dummy"
"84671",4,0,0,4,"dummy"
"84673",34,2,1,37,"dummy"
"84674",1,1,0,2,"dummy"
"84676",2,4,1,7,"dummy"
"84677",9,4,5,18,"dummy"
"84679",0,0,1,1,"dummy"
"84681",2,0,0,2,"dummy"
"84688",0,6,0,6,"dummy"
"84689",0,0,0,0,"dummy"
"84690",0,1,0,1,"dummy"
"84691",0,1,0,1,"dummy"
"84692",0,1,1,2,"dummy"
"84693",1,1,0,2,"dummy"
"84694",0,0,1,1,"dummy"
"84695",3,3,0,6,"dummy"
"84721",1,6,0,7,"dummy"
"84722",0,0,1,1,"dummy"
"84723",4,3,4,11,"dummy"
"84724",0,2,0,2,"dummy"
"84725",0,10,0,10,"dummy"
"84726",1,12,0,13,"dummy"
"84727",26,37,5,68,"dummy"
"84729",1,5,1,7,"dummy"
"84730",3,3,1,7,"dummy"
"84731",0,2,0,2,"dummy"
"84733",15,14,2,31,"dummy"
"84734",0,8,1,9,"dummy"
"84735",0,0,1,1,"dummy"
"84736",0,2,0,2,"dummy"
"84737",0,0,1,1,"dummy"
"84738",0,2,1,3,"dummy"
"84739",2,4,2,8,"dummy"
"84740",6,2,0,8,"dummy"
"84741",0,0,0,0,"dummy"
"84742",0,0,1,1,"dummy"
"84743",7,7,3,17,"dummy"
"84745",0,2,0,2,"dummy"
"84748",2,7,2,11,"dummy"
"84749",4,1,2,7,"dummy"
"84750",2,2,0,4,"dummy"
"84751",0,3,2,5,"dummy"
"84828",1,0,0,1,"dummy"
"84829",2,0,0,2,"dummy"
"84831",0,0,0,0,"dummy"
"84833",0,0,1,1,"dummy"
"84834",3,8,2,13,"dummy"
"84835",1,0,1,2,"dummy"
"84837",3,2,1,6,"dummy"
"84838",0,0,1,1,"dummy"
"84839",1,2,0,3,"dummy"
"84842",0,2,2,4,"dummy"
"84845",0,0,0,0,"dummy"
"84846",0,1,1,2,"dummy"
"84849",0,1,1,2,"dummy"
"84850",1,0,0,1,"dummy"
"84851",0,1,0,1,"dummy"
"84853",0,0,1,1,"dummy"
"84856",0,0,3,3,"dummy"
"84857",0,0,2,2,"dummy"
"84858",0,10,0,10,"dummy"
"84859",3,0,0,3,"dummy"
"84860",2,8,1,11,"dummy"
"84861",0,1,3,4,"dummy"
"84862",2,2,0,4,"dummy"
"84864",9,24,1,34,"dummy"
"84867",0,1,0,1,"dummy"
"84868",2,3,1,6,"dummy"
"84869",3,2,1,6,"dummy"
"84870",2,0,0,2,"dummy"
"84872",2,0,0,2,"dummy"
"84873",0,0,0,0,"dummy"
"84874",0,3,1,4,"dummy"
"84875",0,0,0,0,"dummy"
"84878",0,1,0,1,"dummy"
"84886",1,7,1,9,"dummy"
"84887",35,22,3,60,"dummy"
"84888",9,1,0,10,"dummy"
"84890",2,3,1,6,"dummy"
"84891",0,0,0,0,"dummy"
"84892",0,1,1,2,"dummy"
"84893",0,2,0,2,"dummy"
"84894",0,0,0,0,"dummy"
"84895",0,0,0,0,"dummy"
"84898",1,2,0,3,"dummy"
"84899",0,1,0,1,"dummy"
"84900",1,1,0,2,"dummy"
"84901",3,1,1,5,"dummy"
"84902",0,1,1,2,"dummy"
"84903",0,0,1,1,"dummy"
"84904",1,0,0,1,"dummy"
"84905",0,0,1,1,"dummy"
"84906",0,0,2,2,"dummy"
"84907",0,1,0,1,"dummy"
"84908",1,1,0,2,"dummy"
"84909",0,1,0,1,"dummy"
"84912",3,6,0,9,"dummy"
"84913",0,0,1,1,"dummy"
"84914",0,2,0,2,"dummy"
"84915",0,1,0,1,"dummy"
"84917",2,2,3,7,"dummy"
"84920",8,9,2,19,"dummy"
"84921",0,0,1,1,"dummy"
"84922",0,0,1,1,"dummy"
"84928",0,0,0,0,"dummy"
"84929",0,0,1,1,"dummy"
"84930",0,1,0,1,"dummy"
"84931",0,0,1,1,"dummy"
"84932",0,0,0,0,"dummy"
"84933",0,0,0,0,"dummy"
"84936",0,1,1,2,"dummy"
"84938",0,0,1,1,"dummy"
"84940",0,14,0,14,"dummy"
"84942",0,0,0,0,"dummy"
"84943",0,0,0,0,"dummy"
"84947",0,7,0,7,"dummy"
"84948",2,2,2,6,"dummy"
"84950",0,1,0,1,"dummy"
"84954",6,0,0,6,"dummy"
"84955",0,6,2,8,"dummy"
"84956",0,1,0,1,"dummy"
"84957",0,0,1,1,"dummy"
"84958",0,0,2,2,"dummy"
"84959",0,0,1,1,"dummy"
"84960",0,0,1,1,"dummy"
"84961",0,0,1,1,"dummy"
"84962",0,0,1,1,"dummy"
"84966",2,0,2,4,"dummy"
"84967",0,0,1,1,"dummy"
"84968",0,3,0,3,"dummy"
"84969",1,1,1,3,"dummy"
"84970",0,0,1,1,"dummy"
"84971",0,0,1,1,"dummy"
"84976",0,0,1,1,"dummy"
"84977",0,3,0,3,"dummy"
"84981",0,2,0,2,"dummy"
"84982",0,0,1,1,"dummy"
"84983",0,0,2,2,"dummy"
"84985",0,0,1,1,"dummy"
"84987",1,0,1,2,"dummy"
"84989",0,0,0,0,"dummy"
"84994",0,0,0,0,"dummy"
"84995",0,2,0,2,"dummy"
"84996",0,1,0,1,"dummy"
"84997",0,2,0,2,"dummy"
"84998",0,1,0,1,"dummy"
"84999",0,0,1,1,"dummy"
"85000",0,1,0,1,"dummy"
"85001",0,1,0,1,"dummy"
"85002",2,3,0,5,"dummy"
"85003",0,2,0,2,"dummy"
"85004",0,1,0,1,"dummy"
"85005",0,1,0,1,"dummy"
"85006",0,1,0,1,"dummy"
"85008",0,0,2,2,"dummy"
"85009",9,7,3,19,"dummy"
"85010",0,0,0,0,"dummy"
"85012",0,0,0,0,"dummy"
"85018",1,2,0,3,"dummy"
"85020",1,4,3,8,"dummy"
"85022",10,22,3,35,"dummy"
"85029",0,0,1,1,"dummy"
"85030",0,0,1,1,"dummy"
"85041",0,0,0,0,"dummy"
"85045",2,4,0,6,"dummy"
"85046",0,2,0,2,"dummy"
"85047",0,2,0,2,"dummy"
"85048",10,2,0,12,"dummy"
"85049",0,2,0,2,"dummy"
"85050",0,0,0,0,"dummy"
"85058",0,0,2,2,"dummy"
"85060",1,0,0,1,"dummy"
"85062",0,0,0,0,"dummy"
"85075",0,0,1,1,"dummy"
"85076",0,1,0,1,"dummy"
"85077",0,0,1,1,"dummy"
"85078",0,1,1,2,"dummy"
"85079",0,0,1,1,"dummy"
"85080",0,6,0,6,"dummy"
"85081",0,0,1,1,"dummy"
"85082",0,0,2,2,"dummy"
"85083",0,0,1,1,"dummy"
"85085",0,0,3,3,"dummy"
"85086",0,3,2,5,"dummy"
"85088",0,5,3,8,"dummy"
"85089",0,2,0,2,"dummy"
"85090",0,2,0,2,"dummy"
"85091",0,5,0,5,"dummy"
"85092",0,0,1,1,"dummy"
"85094",4,7,3,14,"dummy"
"85096",11,2,4,17,"dummy"
"85099",0,1,0,1,"dummy"
"85100",5,1,2,8,"dummy"
"85101",1,0,2,3,"dummy"
"85109",0,1,0,1,"dummy"
"85110",4,1,0,5,"dummy"
"85111",0,1,9,10,"dummy"
"85112",17,6,3,26,"dummy"
"85113",15,0,0,15,"dummy"
"85115",1,0,0,1,"dummy"
"85116",0,0,0,0,"dummy"
"85118",0,0,1,1,"dummy"
"85119",0,0,1,1,"dummy"
"85126",0,1,0,1,"dummy"
"85130",0,0,1,1,"dummy"
"85131",0,0,1,1,"dummy"
"85133",2,2,0,4,"dummy"
"85136",0,1,0,1,"dummy"
"85137",0,0,1,1,"dummy"
"85156",0,3,1,4,"dummy"
"85157",0,1,0,1,"dummy"
"85158",0,0,1,1,"dummy"
"85159",0,0,1,1,"dummy"
"85164",0,0,1,1,"dummy"
"85169",4,9,1,14,"dummy"
"85178",0,3,0,3,"dummy"
"85179",3,12,0,15,"dummy"
"85180",0,4,1,5,"dummy"
"85181",0,3,0,3,"dummy"
"85182",0,0,1,1,"dummy"
"85183",0,0,1,1,"dummy"
"85184",0,0,1,1,"dummy"
"85185",0,0,1,1,"dummy"
"85186",0,0,1,1,"dummy"
"85189",0,0,0,0,"dummy"
"85190",0,0,1,1,"dummy"
"85193",0,1,0,1,"dummy"
"85194",2,5,1,8,"dummy"
"85195",0,0,1,1,"dummy"
"85196",0,0,1,1,"dummy"
"85197",2,0,0,2,"dummy"
"85198",0,1,0,1,"dummy"
"85199",1,0,0,1,"dummy"
"85200",1,0,0,1,"dummy"
"85202",0,1,0,1,"dummy"
"85205",0,5,3,8,"dummy"
"85206",0,1,0,1,"dummy"
"85207",0,3,1,4,"dummy"
"85209",0,0,1,1,"dummy"
"85211",0,0,1,1,"dummy"
"85216",0,7,0,7,"dummy"
"85217",0,0,0,0,"dummy"
"85218",0,0,0,0,"dummy"
"85219",0,2,0,2,"dummy"
"85220",0,12,0,12,"dummy"
"85221",0,0,0,0,"dummy"
"85222",0,2,0,2,"dummy"
"85223",0,1,0,1,"dummy"
"85224",0,0,0,0,"dummy"
"85225",0,1,0,1,"dummy"
"85227",0,0,0,0,"dummy"
"85228",0,1,0,1,"dummy"
"85229",0,2,3,5,"dummy"
"85230",0,15,1,16,"dummy"
"85231",6,0,2,8,"dummy"
"85232",2,1,5,8,"dummy"
"85233",0,0,4,4,"dummy"
"85234",0,0,1,1,"dummy"
"85235",0,0,1,1,"dummy"
"85236",8,9,2,19,"dummy"
"85237",2,3,0,5,"dummy"
"85238",0,0,0,0,"dummy"
"85239",0,1,0,1,"dummy"
"85240",2,1,0,3,"dummy"
"85241",1,2,0,3,"dummy"
"85242",0,1,0,1,"dummy"
"85243",1,1,0,2,"dummy"
"85244",9,0,1,10,"dummy"
"85245",0,1,0,1,"dummy"
"85246",20,8,3,31,"dummy"
"85247",0,0,1,1,"dummy"
"85248",0,1,0,1,"dummy"
"85249",0,0,0,0,"dummy"
"85250",0,1,0,1,"dummy"
"85251",0,2,0,2,"dummy"
"85252",0,0,0,0,"dummy"
"85253",0,0,0,0,"dummy"
"85254",1,2,0,3,"dummy"
"85255",1,2,0,3,"dummy"
"85256",2,2,0,4,"dummy"
"85257",3,2,0,5,"dummy"
"85258",0,1,0,1,"dummy"
"85260",0,0,1,1,"dummy"
"85261",1,1,0,2,"dummy"
"85262",0,0,1,1,"dummy"
"85263",2,3,0,5,"dummy"
"85265",0,0,1,1,"dummy"
"85267",0,0,0,0,"dummy"
"85268",3,1,1,5,"dummy"
"85269",0,2,0,2,"dummy"
"85271",0,0,0,0,"dummy"
"85272",0,0,0,0,"dummy"
"85273",0,0,0,0,"dummy"
"85279",17,39,3,59,"dummy"
"85280",3,0,1,4,"dummy"
"85281",0,0,1,1,"dummy"
"85283",0,11,0,11,"dummy"
"85284",0,0,1,1,"dummy"
"85285",0,0,2,2,"dummy"
"85286",1,0,1,2,"dummy"
"85287",0,0,1,1,"dummy"
"85288",2,1,1,4,"dummy"
"85289",1,2,1,4,"dummy"
"85290",0,0,1,1,"dummy"
"85292",0,0,2,2,"dummy"
"85294",1,1,0,2,"dummy"
"85295",0,2,1,3,"dummy"
"85297",0,2,0,2,"dummy"
"85298",0,1,0,1,"dummy"
"85299",2,0,0,2,"dummy"
"85304",0,1,0,1,"dummy"
"85308",2,7,3,12,"dummy"
"85311",0,0,1,1,"dummy"
"85314",0,0,3,3,"dummy"
"85320",0,0,1,1,"dummy"
"85323",0,0,1,1,"dummy"
"85324",0,3,0,3,"dummy"
"85330",0,3,1,4,"dummy"
"85331",10,11,0,21,"dummy"
"85332",0,0,1,1,"dummy"
"85333",2,2,0,4,"dummy"
"85334",1,2,0,3,"dummy"
"85336",0,0,0,0,"dummy"
"85338",0,1,0,1,"dummy"
"85339",0,1,0,1,"dummy"
"85340",0,1,0,1,"dummy"
"85342",0,5,2,7,"dummy"
"85343",1,0,0,1,"dummy"
"85346",0,0,1,1,"dummy"
"85347",0,0,1,1,"dummy"
"85348",0,1,0,1,"dummy"
"85349",3,8,0,11,"dummy"
"85350",0,0,1,1,"dummy"
"85351",4,1,0,5,"dummy"
"85354",0,3,0,3,"dummy"
"85355",1,4,0,5,"dummy"
"85356",3,6,1,10,"dummy"
"85357",1,3,0,4,"dummy"
"85358",0,0,0,0,"dummy"
"85361",0,0,1,1,"dummy"
"85362",1,0,0,1,"dummy"
"85369",0,0,2,2,"dummy"
"85370",0,0,2,2,"dummy"
"85377",0,0,2,2,"dummy"
"85378",0,0,2,2,"dummy"
"85379",1,2,3,6,"dummy"
"85380",7,2,3,12,"dummy"
"85382",0,0,0,0,"dummy"
"85383",0,1,0,1,"dummy"
"85384",0,0,0,0,"dummy"
"85386",0,0,2,2,"dummy"
"85389",0,0,1,1,"dummy"
"85390",0,0,1,1,"dummy"
"85392",0,3,0,3,"dummy"
"85393",0,0,1,1,"dummy"
"85394",0,0,1,1,"dummy"
"85397",2,1,2,5,"dummy"
"85401",0,1,0,1,"dummy"
"85402",0,2,0,2,"dummy"
"85403",0,2,0,2,"dummy"
"85411",0,0,0,0,"dummy"
"85412",0,1,0,1,"dummy"
"85413",0,0,0,0,"dummy"
"85416",0,1,0,1,"dummy"
"85417",0,2,0,2,"dummy"
"85418",1,8,0,9,"dummy"
"85434",0,0,0,0,"dummy"
"85435",0,0,0,0,"dummy"
"85437",0,0,1,1,"dummy"
"85438",3,4,2,9,"dummy"
"85441",2,1,0,3,"dummy"
"85442",0,3,0,3,"dummy"
"85443",0,4,1,5,"dummy"
"85444",0,2,1,3,"dummy"
"85445",0,1,0,1,"dummy"
"85446",1,2,1,4,"dummy"
"85447",4,6,2,12,"dummy"
"85448",6,0,2,8,"dummy"
"85449",0,0,0,0,"dummy"
"85450",0,1,0,1,"dummy"
"85451",3,1,1,5,"dummy"
"85452",0,5,1,6,"dummy"
"85453",0,0,0,0,"dummy"
"85454",0,1,0,1,"dummy"
"85455",0,0,1,1,"dummy"
"85456",0,2,0,2,"dummy"
"85459",1,0,1,2,"dummy"
"85460",2,0,4,6,"dummy"
"85462",0,1,0,1,"dummy"
"85463",0,0,4,4,"dummy"
"85464",0,1,0,1,"dummy"
"85468",0,1,0,1,"dummy"
"85469",0,1,0,1,"dummy"
"85471",0,0,1,1,"dummy"
"85472",2,7,0,9,"dummy"
"85473",1,17,0,18,"dummy"
"85474",0,1,0,1,"dummy"
"85475",16,1,1,18,"dummy"
"85476",2,2,0,4,"dummy"
"85477",4,4,0,8,"dummy"
"85478",1,2,0,3,"dummy"
"85479",2,0,0,2,"dummy"
"85480",0,0,0,0,"dummy"
"85481",0,1,0,1,"dummy"
"85482",0,0,1,1,"dummy"
"85483",0,0,1,1,"dummy"
"85484",1,1,0,2,"dummy"
"85485",5,0,1,6,"dummy"
"85486",0,2,0,2,"dummy"
"85487",0,2,0,2,"dummy"
"85488",0,0,1,1,"dummy"
"85490",0,3,0,3,"dummy"
"85492",0,1,1,2,"dummy"
"85493",3,3,0,6,"dummy"
"85494",4,3,1,8,"dummy"
"85496",0,16,0,16,"dummy"
"85497",16,0,0,16,"dummy"
"85501",0,0,1,1,"dummy"
"85502",0,1,2,3,"dummy"
"85503",0,0,1,1,"dummy"
"85504",0,0,1,1,"dummy"
"85505",1,8,1,10,"dummy"
"85506",0,0,1,1,"dummy"
"85507",0,0,1,1,"dummy"
"85508",0,0,1,1,"dummy"
"85509",0,0,1,1,"dummy"
"85510",0,0,1,1,"dummy"
"85511",21,7,6,34,"dummy"
"85512",0,0,1,1,"dummy"
"85513",0,0,1,1,"dummy"
"85514",0,0,1,1,"dummy"
"85515",0,0,1,1,"dummy"
"85516",0,0,1,1,"dummy"
"85517",0,0,1,1,"dummy"
"85518",0,0,1,1,"dummy"
"85519",0,0,1,1,"dummy"
"85520",2,21,1,24,"dummy"
"85521",0,0,1,1,"dummy"
"85522",0,0,1,1,"dummy"
"85523",0,0,1,1,"dummy"
"85524",0,0,1,1,"dummy"
"85525",0,0,1,1,"dummy"
"85526",0,0,1,1,"dummy"
"85527",0,0,1,1,"dummy"
"85528",0,0,1,1,"dummy"
"85529",0,0,5,5,"dummy"
"85530",0,0,1,1,"dummy"
"85531",0,0,1,1,"dummy"
"85532",0,0,1,1,"dummy"
"85533",0,0,1,1,"dummy"
"85534",0,1,7,8,"dummy"
"85537",0,1,2,3,"dummy"
"85538",2,2,0,4,"dummy"
"85539",0,2,0,2,"dummy"
"85540",1,0,0,1,"dummy"
"85542",4,18,2,24,"dummy"
"85548",4,4,1,9,"dummy"
"85549",9,0,3,12,"dummy"
"85552",0,2,0,2,"dummy"
"85554",0,1,1,2,"dummy"
"85555",0,2,2,4,"dummy"
"85557",1,0,0,1,"dummy"
"85559",0,0,1,1,"dummy"
"85560",1,2,0,3,"dummy"
"85565",0,0,1,1,"dummy"
"85566",2,4,0,6,"dummy"
"85567",2,1,0,3,"dummy"
"85568",0,1,1,2,"dummy"
"85569",0,0,1,1,"dummy"
"85570",0,0,1,1,"dummy"
"85571",0,0,1,1,"dummy"
"85572",0,0,1,1,"dummy"
"85573",1,1,0,2,"dummy"
"85574",0,0,1,1,"dummy"
"85575",0,1,1,2,"dummy"
"85576",1,1,0,2,"dummy"
"85577",0,0,1,1,"dummy"
"85579",1,0,0,1,"dummy"
"85580",0,1,1,2,"dummy"
"85581",1,0,0,1,"dummy"
"85582",0,0,1,1,"dummy"
"85583",0,0,2,2,"dummy"
"85584",0,0,1,1,"dummy"
"85585",0,0,0,0,"dummy"
"85586",2,0,0,2,"dummy"
"85587",0,0,1,1,"dummy"
"85588",0,2,0,2,"dummy"
"85589",0,0,1,1,"dummy"
"85590",0,1,0,1,"dummy"
"85591",0,0,1,1,"dummy"
"85592",0,0,1,1,"dummy"
"85593",0,1,0,1,"dummy"
"85594",0,2,0,2,"dummy"
"85595",3,2,0,5,"dummy"
"85596",0,2,0,2,"dummy"
"85597",0,1,0,1,"dummy"
"85598",0,0,0,0,"dummy"
"85599",0,0,0,0,"dummy"
"85600",0,6,0,6,"dummy"
"85601",4,2,0,6,"dummy"
"85602",2,0,0,2,"dummy"
"85603",0,0,0,0,"dummy"
"85604",0,0,0,0,"dummy"
"85605",0,3,0,3,"dummy"
"85606",0,0,0,0,"dummy"
"85607",3,0,0,3,"dummy"
"85608",2,0,0,2,"dummy"
"85609",1,0,0,1,"dummy"
"85612",0,0,1,1,"dummy"
"85618",0,0,0,0,"dummy"
"85619",0,0,0,0,"dummy"
"85620",0,0,0,0,"dummy"
"85621",0,0,0,0,"dummy"
"85622",0,0,0,0,"dummy"
"85627",0,3,0,3,"dummy"
"85628",1,5,2,8,"dummy"
"85629",0,4,0,4,"dummy"
"85630",0,3,1,4,"dummy"
"85631",2,2,1,5,"dummy"
"85632",0,1,1,2,"dummy"
"85633",0,5,0,5,"dummy"
"85634",0,0,0,0,"dummy"
"85635",2,2,3,7,"dummy"
"85636",0,0,1,1,"dummy"
"85637",0,13,2,15,"dummy"
"85638",36,4,2,42,"dummy"
"85639",3,12,0,15,"dummy"
"85640",2,3,0,5,"dummy"
"85641",10,0,0,10,"dummy"
"85643",0,0,1,1,"dummy"
"85647",0,0,0,0,"dummy"
"85648",0,0,0,0,"dummy"
"85668",0,1,2,3,"dummy"
"85669",0,4,0,4,"dummy"
"85670",0,2,0,2,"dummy"
"85671",0,1,0,1,"dummy"
"85672",1,0,0,1,"dummy"
"85673",14,1,0,15,"dummy"
"85674",0,0,1,1,"dummy"
"85675",0,0,4,4,"dummy"
"85698",0,2,0,2,"dummy"
"85699",3,18,2,23,"dummy"
"85700",0,1,1,2,"dummy"
"85704",8,5,0,13,"dummy"
"85709",29,1,0,30,"dummy"
"85711",1,3,0,4,"dummy"
"85713",11,15,2,28,"dummy"
"85714",4,0,1,5,"dummy"
"85715",0,0,1,1,"dummy"
"85717",0,0,0,0,"dummy"
"85719",0,3,1,4,"dummy"
"85720",3,1,0,4,"dummy"
"85725",0,1,2,3,"dummy"
"85726",2,2,0,4,"dummy"
"85727",0,2,0,2,"dummy"
"85728",1,0,0,1,"dummy"
"85730",8,10,2,20,"dummy"
"85731",1,1,0,2,"dummy"
"85732",4,0,0,4,"dummy"
"85734",1,1,0,2,"dummy"
"85741",27,4,3,34,"dummy"
"85746",0,8,0,8,"dummy"
"85749",0,1,2,3,"dummy"
"85750",8,15,0,23,"dummy"
"85751",0,0,1,1,"dummy"
"85754",2,3,3,8,"dummy"
"85755",0,10,4,14,"dummy"
"85756",0,1,0,1,"dummy"
"85757",1,1,0,2,"dummy"
"85758",0,1,0,1,"dummy"
"85759",0,1,0,1,"dummy"
"85761",2,0,2,4,"dummy"
"85764",0,1,0,1,"dummy"
"85765",1,0,0,1,"dummy"
"85766",1,0,1,2,"dummy"
"85767",1,0,1,2,"dummy"
"85768",1,0,0,1,"dummy"
"85769",11,1,3,15,"dummy"
"85770",5,0,0,5,"dummy"
"85771",0,1,0,1,"dummy"
"85772",0,5,0,5,"dummy"
"85773",0,7,0,7,"dummy"
"85774",2,2,1,5,"dummy"
"85775",8,6,1,15,"dummy"
"85776",0,2,0,2,"dummy"
"85777",1,0,2,3,"dummy"
"85778",0,0,1,1,"dummy"
"85783",0,0,0,0,"dummy"
"85784",5,0,2,7,"dummy"
"85785",0,0,0,0,"dummy"
"85787",0,0,0,0,"dummy"
"85791",0,0,0,0,"dummy"
"85793",9,10,2,21,"dummy"
"85795",0,6,1,7,"dummy"
"85796",0,1,0,1,"dummy"
"85797",1,0,0,1,"dummy"
"85798",0,3,3,6,"dummy"
"85799",0,1,0,1,"dummy"
"85800",0,1,0,1,"dummy"
"85801",2,0,1,3,"dummy"
"85802",0,1,0,1,"dummy"
"85803",2,0,0,2,"dummy"
"85804",1,1,3,5,"dummy"
"85805",0,1,0,1,"dummy"
"85806",1,2,0,3,"dummy"
"85810",0,3,0,3,"dummy"
"85811",0,0,1,1,"dummy"
"85812",0,2,2,4,"dummy"
"85818",0,0,1,1,"dummy"
"85822",0,0,1,1,"dummy"
"85823",0,2,0,2,"dummy"
"85825",0,0,0,0,"dummy"
"85830",0,9,1,10,"dummy"
"85831",0,0,0,0,"dummy"
"85832",0,1,0,1,"dummy"
"85834",13,12,2,27,"dummy"
"85841",0,1,0,1,"dummy"
"85842",1,0,0,1,"dummy"
"85843",0,1,1,2,"dummy"
"85845",1,4,0,5,"dummy"
"85846",0,0,1,1,"dummy"
"85847",0,1,0,1,"dummy"
"85850",0,3,2,5,"dummy"
"85851",3,0,0,3,"dummy"
"85853",3,5,1,9,"dummy"
"85854",1,0,0,1,"dummy"
"85855",0,0,1,1,"dummy"
"85856",11,12,3,26,"dummy"
"85857",7,9,3,19,"dummy"
"85858",6,0,0,6,"dummy"
"85859",12,15,1,28,"dummy"
"85860",0,0,1,1,"dummy"
"85861",0,1,0,1,"dummy"
"85862",0,0,1,1,"dummy"
"85865",0,1,0,1,"dummy"
"85866",0,2,0,2,"dummy"
"85867",0,0,1,1,"dummy"
"85871",0,0,0,0,"dummy"
"85872",0,0,0,0,"dummy"
"85874",0,0,0,0,"dummy"
"85876",0,0,0,0,"dummy"
"85880",12,2,0,14,"dummy"
"85881",0,9,0,9,"dummy"
"85884",0,6,0,6,"dummy"
"85886",2,2,4,8,"dummy"
"85887",9,5,5,19,"dummy"
"85889",1,4,3,8,"dummy"
"85890",0,1,0,1,"dummy"
"85891",0,4,0,4,"dummy"
"85893",0,19,0,19,"dummy"
"85894",4,5,1,10,"dummy"
"85895",15,15,3,33,"dummy"
"85896",0,1,1,2,"dummy"
"85897",0,1,0,1,"dummy"
"85898",0,0,1,1,"dummy"
"85899",0,2,0,2,"dummy"
"85900",0,4,0,4,"dummy"
"85901",0,4,0,4,"dummy"
"85902",0,0,0,0,"dummy"
"85903",1,0,0,1,"dummy"
"85904",0,3,0,3,"dummy"
"85905",0,0,1,1,"dummy"
"85907",0,2,0,2,"dummy"
"85908",11,5,0,16,"dummy"
"85909",1,0,0,1,"dummy"
"85910",0,0,0,0,"dummy"
"85911",0,0,1,1,"dummy"
"85913",0,3,0,3,"dummy"
"85914",0,0,2,2,"dummy"
"85915",0,0,1,1,"dummy"
"85916",0,1,0,1,"dummy"
"85917",1,3,0,4,"dummy"
"85919",1,0,0,1,"dummy"
"85920",0,2,1,3,"dummy"
"85921",2,0,1,3,"dummy"
"85923",0,0,0,0,"dummy"
"85924",0,0,0,0,"dummy"
"85925",0,0,0,0,"dummy"
"85926",0,0,0,0,"dummy"
"85951",2,2,1,5,"dummy"
"85952",0,0,1,1,"dummy"
"85953",0,0,1,1,"dummy"
"85956",1,4,1,6,"dummy"
"85958",0,0,1,1,"dummy"
"85959",0,0,1,1,"dummy"
"85960",2,1,0,3,"dummy"
"85961",0,0,1,1,"dummy"
"85963",0,0,2,2,"dummy"
"85964",5,0,0,5,"dummy"
"85965",0,4,0,4,"dummy"
"85966",0,1,1,2,"dummy"
"85967",0,2,0,2,"dummy"
"85968",0,0,1,1,"dummy"
"85971",0,0,0,0,"dummy"
"85972",0,0,0,0,"dummy"
"85973",0,0,1,1,"dummy"
"85975",0,19,0,19,"dummy"
"85976",4,4,0,8,"dummy"
"85981",1,2,0,3,"dummy"
"85982",0,2,0,2,"dummy"
"85983",0,3,0,3,"dummy"
"85984",1,0,1,2,"dummy"
"85986",13,1,0,14,"dummy"
"85987",0,1,0,1,"dummy"
"86012",1,6,0,7,"dummy"
"86033",0,0,1,1,"dummy"
"86034",0,0,1,1,"dummy"
"86035",0,2,0,2,"dummy"
"86036",0,1,3,4,"dummy"
"86037",0,3,1,4,"dummy"
"86038",0,1,1,2,"dummy"
"86039",3,4,0,7,"dummy"
"86040",4,3,1,8,"dummy"
"86043",0,1,0,1,"dummy"
"86044",0,0,1,1,"dummy"
"86045",0,1,0,1,"dummy"
"86046",0,0,1,1,"dummy"
"86047",0,4,0,4,"dummy"
"86071",0,0,1,1,"dummy"
"86072",0,0,1,1,"dummy"
"86075",0,0,1,1,"dummy"
"86079",4,2,3,9,"dummy"
"86083",0,0,1,1,"dummy"
"86093",0,2,0,2,"dummy"
"86094",1,3,1,5,"dummy"
"86095",1,0,0,1,"dummy"
"86096",0,1,0,1,"dummy"
"86097",2,1,0,3,"dummy"
"86098",1,3,1,5,"dummy"
"86099",2,5,0,7,"dummy"
"86100",1,5,0,6,"dummy"
"86101",0,2,0,2,"dummy"
"86102",10,3,0,13,"dummy"
"86103",4,5,0,9,"dummy"
"86104",6,6,0,12,"dummy"
"86105",8,1,2,11,"dummy"
"86106",1,5,0,6,"dummy"
"86107",0,0,2,2,"dummy"
"86108",0,0,1,1,"dummy"
"86109",0,0,1,1,"dummy"
"86110",0,0,2,2,"dummy"
"86111",0,0,1,1,"dummy"
"86112",0,0,1,1,"dummy"
"86113",0,0,2,2,"dummy"
"86114",0,0,1,1,"dummy"
"86115",5,7,0,12,"dummy"
"86116",0,1,0,1,"dummy"
"86117",5,6,0,11,"dummy"
"86118",6,5,0,11,"dummy"
"86119",2,0,0,2,"dummy"
"86120",0,1,0,1,"dummy"
"86121",1,0,0,1,"dummy"
"86122",7,4,0,11,"dummy"
"86123",4,7,0,11,"dummy"
"86124",1,4,1,6,"dummy"
"86125",0,1,0,1,"dummy"
"86126",2,0,0,2,"dummy"
"86127",2,2,1,5,"dummy"
"86128",0,0,1,1,"dummy"
"86129",0,0,0,0,"dummy"
"86130",0,0,0,0,"dummy"
"86131",0,1,0,1,"dummy"
"86132",0,6,0,6,"dummy"
"86133",6,0,0,6,"dummy"
"86134",2,1,0,3,"dummy"
"86135",0,3,0,3,"dummy"
"86136",0,0,0,0,"dummy"
"86137",0,0,0,0,"dummy"
"86138",0,0,0,0,"dummy"
"86139",0,0,0,0,"dummy"
"86140",0,0,0,0,"dummy"
"86141",0,0,0,0,"dummy"
"86142",0,0,0,0,"dummy"
"86143",0,0,0,0,"dummy"
"86144",0,0,0,0,"dummy"
"86145",0,0,0,0,"dummy"
"86151",2,4,1,7,"dummy"
"86152",0,0,1,1,"dummy"
"86153",0,1,0,1,"dummy"
"86154",2,4,0,6,"dummy"
"86155",0,0,2,2,"dummy"
"86156",2,3,1,6,"dummy"
"86157",25,36,1,62,"dummy"
"86158",1,3,0,4,"dummy"
"86159",6,39,0,45,"dummy"
"86160",2,18,3,23,"dummy"
"86161",62,5,0,67,"dummy"
"86162",8,1,1,10,"dummy"
"86163",0,0,1,1,"dummy"
"86164",0,2,1,3,"dummy"
"86165",0,0,0,0,"dummy"
"86166",2,2,1,5,"dummy"
"86167",0,1,0,1,"dummy"
"86168",0,0,1,1,"dummy"
"86169",0,0,1,1,"dummy"
"86170",0,0,1,1,"dummy"
"86023",0,0,0,0,"dummy"
"86024",0,0,0,0,"dummy"
"86025",0,0,0,0,"dummy"
"86026",0,0,0,0,"dummy"
"86049",0,3,0,3,"dummy"
"86050",6,0,0,6,"dummy"
"86051",0,1,0,1,"dummy"
"86052",0,4,0,4,"dummy"
"86053",0,1,0,1,"dummy"
"86054",0,5,0,5,"dummy"
"86055",3,2,3,8,"dummy"
"86056",0,4,1,5,"dummy"
"86057",0,1,0,1,"dummy"
"86058",0,1,0,1,"dummy"
"86059",0,1,0,1,"dummy"
"86060",0,1,1,2,"dummy"
"86061",0,2,0,2,"dummy"
"86062",0,1,0,1,"dummy"
"86063",0,0,2,2,"dummy"
"86064",0,1,0,1,"dummy"
"86065",0,4,0,4,"dummy"
"86066",10,11,3,24,"dummy"
"86067",2,0,0,2,"dummy"
"86068",0,1,0,1,"dummy"
"86069",0,1,0,1,"dummy"
"86077",23,6,7,36,"dummy"
"86081",2,2,1,5,"dummy"
"86087",3,3,0,6,"dummy"
"86088",0,7,0,7,"dummy"
"86091",4,14,2,20,"dummy"
"86147",0,1,1,2,"dummy"
"86148",0,2,0,2,"dummy"
"86149",0,1,1,2,"dummy"
"86174",0,0,1,1,"dummy"
"86183",1,4,0,5,"dummy"
"86184",0,2,0,2,"dummy"
"86185",3,1,3,7,"dummy"
"86186",2,2,1,5,"dummy"
"86187",3,5,0,8,"dummy"
"86188",3,6,0,9,"dummy"
"86189",0,0,3,3,"dummy"
"86190",5,0,4,9,"dummy"
"86191",2,0,0,2,"dummy"
"86192",0,0,1,1,"dummy"
"86193",0,0,1,1,"dummy"
"86194",0,0,0,0,"dummy"
"86220",0,0,1,1,"dummy"
"86266",0,0,1,1,"dummy"
"86290",0,1,0,1,"dummy"
"86291",2,11,5,18,"dummy"
"86292",0,1,0,1,"dummy"
"86293",0,1,0,1,"dummy"
"86294",8,2,3,13,"dummy"
"86295",0,1,0,1,"dummy"
"86296",0,0,1,1,"dummy"
"86299",1,1,1,3,"dummy"
"86300",4,1,0,5,"dummy"
"86301",0,0,1,1,"dummy"
"86310",1,7,5,13,"dummy"
"86317",0,1,0,1,"dummy"
"86318",1,1,0,2,"dummy"
"86319",2,1,0,3,"dummy"
"86178",0,18,0,18,"dummy"
"86179",6,3,5,14,"dummy"
"86180",0,3,1,4,"dummy"
"86181",0,0,1,1,"dummy"
"86196",5,2,0,7,"dummy"
"86197",1,1,0,2,"dummy"
"86198",1,1,0,2,"dummy"
"86199",1,1,0,2,"dummy"
"86200",1,3,1,5,"dummy"
"86201",1,0,0,1,"dummy"
"86202",2,1,1,4,"dummy"
"86203",3,3,0,6,"dummy"
"86204",2,4,0,6,"dummy"
"86205",2,2,0,4,"dummy"
"86206",9,4,1,14,"dummy"
"86207",4,3,0,7,"dummy"
"86208",4,14,1,19,"dummy"
"86209",0,1,0,1,"dummy"
"86210",1,0,0,1,"dummy"
"86211",1,0,0,1,"dummy"
"86212",0,1,0,1,"dummy"
"86217",0,0,1,1,"dummy"
"86218",0,0,1,1,"dummy"
"86222",0,0,0,0,"dummy"
"86225",3,2,1,6,"dummy"
"86244",4,0,1,5,"dummy"
"86245",2,4,2,8,"dummy"
"86260",1,1,1,3,"dummy"
"86268",0,2,1,3,"dummy"
"86269",1,20,2,23,"dummy"
"86270",0,0,1,1,"dummy"
"86271",0,0,2,2,"dummy"
"86272",0,2,0,2,"dummy"
"86273",0,0,1,1,"dummy"
"86274",0,3,0,3,"dummy"
"86275",0,0,1,1,"dummy"
"86276",0,0,0,0,"dummy"
"86277",0,3,0,3,"dummy"
"86278",0,0,1,1,"dummy"
"86279",0,0,1,1,"dummy"
"86280",0,0,0,0,"dummy"
"86281",0,2,0,2,"dummy"
"86282",2,2,0,4,"dummy"
"86283",0,0,1,1,"dummy"
"86284",2,0,0,2,"dummy"
"86287",0,0,1,1,"dummy"
"86288",0,0,1,1,"dummy"
"86303",6,0,0,6,"dummy"
"86304",2,5,2,9,"dummy"
"86314",3,0,0,3,"dummy"
"86315",0,0,1,1,"dummy"
"86327",0,0,0,0,"dummy"
"86328",0,0,0,0,"dummy"
"86338",0,0,1,1,"dummy"
"86339",0,0,0,0,"dummy"
"86342",1,2,0,3,"dummy"
"86343",0,0,1,1,"dummy"
"86346",0,0,1,1,"dummy"
"86353",27,22,2,51,"dummy"
"86354",0,0,0,0,"dummy"
"86355",0,2,0,2,"dummy"
"86356",0,0,0,0,"dummy"
"86362",4,5,2,11,"dummy"
"86363",1,0,0,1,"dummy"
"86364",7,0,0,7,"dummy"
"86365",0,0,1,1,"dummy"
"86381",0,0,0,0,"dummy"
"86382",0,0,0,0,"dummy"
"86383",0,0,0,0,"dummy"
"86384",0,0,0,0,"dummy"
"86385",0,0,0,0,"dummy"
"86386",0,0,0,0,"dummy"
"86387",0,0,0,0,"dummy"
"86388",0,0,0,0,"dummy"
"86389",0,0,0,0,"dummy"
"86320",1,2,1,4,"dummy"
"86323",2,9,0,11,"dummy"
"86330",4,2,2,8,"dummy"
"86348",5,3,1,9,"dummy"
"86349",0,8,0,8,"dummy"
"86350",1,3,1,5,"dummy"
"86351",0,0,1,1,"dummy"
"86358",1,2,2,5,"dummy"
"86359",0,0,0,0,"dummy"
"86360",0,0,0,0,"dummy"
"86367",1,0,0,1,"dummy"
"86370",0,1,1,2,"dummy"
"86371",2,2,3,7,"dummy"
"86372",15,11,6,32,"dummy"
"86373",1,1,0,2,"dummy"
"86374",0,1,0,1,"dummy"
"86375",0,0,1,1,"dummy"
"86376",0,0,0,0,"dummy"
"86377",0,0,1,1,"dummy"
"86378",1,0,0,1,"dummy"
"86379",0,0,1,1,"dummy"
"86393",3,0,0,3,"dummy"
"86394",0,1,0,1,"dummy"
"86395",6,6,3,15,"dummy"
"86396",0,3,1,4,"dummy"
"86397",0,1,0,1,"dummy"
"86422",0,3,0,3,"dummy"
"86423",0,1,1,2,"dummy"
"86426",0,0,1,1,"dummy"
"86427",0,0,1,1,"dummy"
"86428",0,0,0,0,"dummy"
"86429",2,2,0,4,"dummy"
"86430",2,0,0,2,"dummy"
"86431",2,2,0,4,"dummy"
"86432",0,0,1,1,"dummy"
"86433",0,0,1,1,"dummy"
"86434",2,0,3,5,"dummy"
"86435",0,0,3,3,"dummy"
"86436",0,0,0,0,"dummy"
"86443",0,0,0,0,"dummy"
"86444",0,0,0,0,"dummy"
"86445",0,0,0,0,"dummy"
"86448",0,1,0,1,"dummy"
"86457",6,1,0,7,"dummy"
"86466",2,0,0,2,"dummy"
"86467",1,0,0,1,"dummy"
"86468",0,0,1,1,"dummy"
"86469",0,1,0,1,"dummy"
"86472",0,0,1,1,"dummy"
"86473",0,2,1,3,"dummy"
"86474",2,0,0,2,"dummy"
"86475",5,0,0,5,"dummy"
"86476",0,5,0,5,"dummy"
"86479",0,73,0,73,"dummy"
"86480",0,0,25,25,"dummy"
"86481",73,2,1,76,"dummy"
"86494",0,1,0,1,"dummy"
"86510",0,1,0,1,"dummy"
"86518",2,1,1,4,"dummy"
"86519",2,0,0,2,"dummy"
"86520",0,1,0,1,"dummy"
"86521",2,1,0,3,"dummy"
"86529",0,0,1,1,"dummy"
"86530",0,0,2,2,"dummy"
"86531",0,0,1,1,"dummy"
"86532",2,1,0,3,"dummy"
"86535",0,1,0,1,"dummy"
"86536",0,0,1,1,"dummy"
"86537",3,2,1,6,"dummy"
"86403",10,7,2,19,"dummy"
"86404",0,5,1,6,"dummy"
"86405",4,5,1,10,"dummy"
"86406",0,0,1,1,"dummy"
"86415",0,0,0,0,"dummy"
"86416",0,4,0,4,"dummy"
"86417",0,4,0,4,"dummy"
"86418",0,0,0,0,"dummy"
"86419",0,2,0,2,"dummy"
"86420",1,0,1,2,"dummy"
"86440",5,7,1,13,"dummy"
"86441",0,1,0,1,"dummy"
"86455",1,1,0,2,"dummy"
"86459",0,0,0,0,"dummy"
"86464",2,3,2,7,"dummy"
"86483",0,1,2,3,"dummy"
"86484",5,2,1,8,"dummy"
"86508",0,0,1,1,"dummy"
"86512",11,13,4,28,"dummy"
"86513",2,5,0,7,"dummy"
"86514",4,4,0,8,"dummy"
"86515",3,3,0,6,"dummy"
"86516",3,3,0,6,"dummy"
"86523",0,0,1,1,"dummy"
"86527",0,4,0,4,"dummy"
"86539",0,0,1,1,"dummy"
"86540",0,0,1,1,"dummy"
"86541",0,0,1,1,"dummy"
"86542",0,0,1,1,"dummy"
"86543",0,0,1,1,"dummy"
"86544",0,0,1,1,"dummy"
"86545",0,2,2,4,"dummy"
"86546",1,0,2,3,"dummy"
"86547",0,0,2,2,"dummy"
"86548",0,0,2,2,"dummy"
"86549",0,0,4,4,"dummy"
"86575",0,4,2,6,"dummy"
"86576",1,0,0,1,"dummy"
"86579",1,0,0,1,"dummy"
"86580",0,5,1,6,"dummy"
"86581",5,0,0,5,"dummy"
"86589",1,0,0,1,"dummy"
"86590",0,1,0,1,"dummy"
"86593",0,3,0,3,"dummy"
"86612",0,3,1,4,"dummy"
"86616",0,0,2,2,"dummy"
"86620",0,0,3,3,"dummy"
"86630",0,0,1,1,"dummy"
"86633",0,0,1,1,"dummy"
"86636",0,0,1,1,"dummy"
"86637",0,1,0,1,"dummy"
"86638",0,0,1,1,"dummy"
"86639",0,0,1,1,"dummy"
"86640",0,0,0,0,"dummy"
"86641",10,17,1,28,"dummy"
"86646",1,0,0,1,"dummy"
"86647",2,2,0,4,"dummy"
"86648",6,0,0,6,"dummy"
"86649",1,5,2,8,"dummy"
"86652",0,1,0,1,"dummy"
"86653",1,1,0,2,"dummy"
"86658",1,4,1,6,"dummy"
"86659",2,4,0,6,"dummy"
"86660",6,1,2,9,"dummy"
"86661",4,6,3,13,"dummy"
"86662",0,2,0,2,"dummy"
"86555",0,1,0,1,"dummy"
"86556",0,1,0,1,"dummy"
"86557",8,2,0,10,"dummy"
"86558",6,7,0,13,"dummy"
"86559",0,1,0,1,"dummy"
"86560",0,9,0,9,"dummy"
"86561",0,2,0,2,"dummy"
"86562",7,0,1,8,"dummy"
"86563",2,0,0,2,"dummy"
"86564",1,2,0,3,"dummy"
"86565",2,0,0,2,"dummy"
"86566",1,2,1,4,"dummy"
"86567",0,1,0,1,"dummy"
"86568",0,8,0,8,"dummy"
"86569",0,2,3,5,"dummy"
"86570",4,1,1,6,"dummy"
"86571",8,0,0,8,"dummy"
"86572",0,2,0,2,"dummy"
"86573",2,5,1,8,"dummy"
"86583",0,1,0,1,"dummy"
"86584",1,0,0,1,"dummy"
"86587",0,0,2,2,"dummy"
"86595",0,8,1,9,"dummy"
"86596",0,1,1,2,"dummy"
"86597",0,2,2,4,"dummy"
"86598",0,0,1,1,"dummy"
"86599",2,1,2,5,"dummy"
"86600",2,1,4,7,"dummy"
"86601",1,3,3,7,"dummy"
"86614",0,0,0,0,"dummy"
"86618",1,1,0,2,"dummy"
"86622",0,0,1,1,"dummy"
"86623",8,1,0,9,"dummy"
"86680",0,3,0,3,"dummy"
"86688",0,0,1,1,"dummy"
"86689",0,0,1,1,"dummy"
"86690",0,0,1,1,"dummy"
"86691",0,0,2,2,"dummy"
"86692",0,2,0,2,"dummy"
"86693",0,0,1,1,"dummy"
"86694",0,0,1,1,"dummy"
"86695",0,0,1,1,"dummy"
"86696",0,1,1,2,"dummy"
"86697",0,0,1,1,"dummy"
"86698",0,0,1,1,"dummy"
"86699",0,1,0,1,"dummy"
"86700",0,0,1,1,"dummy"
"86714",0,15,0,15,"dummy"
"86717",0,0,2,2,"dummy"
"86721",29,8,3,40,"dummy"
"86722",0,2,0,2,"dummy"
"86723",6,6,0,12,"dummy"
"86724",24,11,2,37,"dummy"
"86725",5,9,1,15,"dummy"
"86726",0,3,1,4,"dummy"
"86739",0,4,2,6,"dummy"
"86740",1,1,0,2,"dummy"
"86741",1,1,0,2,"dummy"
"86742",4,4,2,10,"dummy"
"86751",1,0,0,1,"dummy"
"86752",10,4,0,14,"dummy"
"86808",0,1,0,1,"dummy"
"86828",1,2,0,3,"dummy"
"86829",1,1,0,2,"dummy"
"86830",0,4,0,4,"dummy"
"86831",9,7,0,16,"dummy"
"86832",0,2,0,2,"dummy"
"86833",8,11,0,19,"dummy"
"86663",0,0,0,0,"dummy"
"86664",0,0,3,3,"dummy"
"86665",0,0,0,0,"dummy"
"86666",0,0,0,0,"dummy"
"86667",0,0,3,3,"dummy"
"86668",7,9,3,19,"dummy"
"86669",0,0,1,1,"dummy"
"86670",0,1,0,1,"dummy"
"86671",1,0,0,1,"dummy"
"86672",8,1,1,10,"dummy"
"86673",1,1,0,2,"dummy"
"86674",0,0,1,1,"dummy"
"86675",0,0,1,1,"dummy"
"86676",0,0,1,1,"dummy"
"86677",0,0,1,1,"dummy"
"86678",1,0,2,3,"dummy"
"86684",0,0,1,1,"dummy"
"86685",0,0,1,1,"dummy"
"86686",0,2,1,3,"dummy"
"86704",2,5,0,7,"dummy"
"86705",0,1,0,1,"dummy"
"86706",9,5,2,16,"dummy"
"86707",0,0,0,0,"dummy"
"86708",0,0,1,1,"dummy"
"86709",0,3,0,3,"dummy"
"86710",2,2,1,5,"dummy"
"86711",0,1,0,1,"dummy"
"86712",0,2,0,2,"dummy"
"86719",0,2,0,2,"dummy"
"86732",0,0,2,2,"dummy"
"86733",0,0,2,2,"dummy"
"86736",0,0,0,0,"dummy"
"86737",0,0,3,3,"dummy"
"86744",3,4,2,9,"dummy"
"86745",1,6,2,9,"dummy"
"86746",0,1,1,2,"dummy"
"86747",1,1,0,2,"dummy"
"86748",2,3,0,5,"dummy"
"86749",0,0,1,1,"dummy"
"86756",3,9,2,14,"dummy"
"86757",0,0,0,0,"dummy"
"86762",2,1,0,3,"dummy"
"86763",0,0,0,0,"dummy"
"86764",0,1,0,1,"dummy"
"86765",0,2,0,2,"dummy"
"86784",0,0,0,0,"dummy"
"86785",0,0,0,0,"dummy"
"86790",0,7,0,7,"dummy"
"86791",0,0,1,1,"dummy"
"86792",0,0,1,1,"dummy"
"86793",0,3,0,3,"dummy"
"86794",0,1,0,1,"dummy"
"86795",0,0,1,1,"dummy"
"86796",0,0,1,1,"dummy"
"86797",0,7,0,7,"dummy"
"86798",0,1,0,1,"dummy"
"86799",0,0,2,2,"dummy"
"86800",3,0,0,3,"dummy"
"86801",0,0,0,0,"dummy"
"86802",0,0,0,0,"dummy"
"86803",0,0,2,2,"dummy"
"86804",0,0,2,2,"dummy"
"86805",0,0,0,0,"dummy"
"86806",0,9,0,9,"dummy"
"86818",0,5,0,5,"dummy"
"86819",0,4,0,4,"dummy"
"86820",0,2,0,2,"dummy"
"86821",0,3,0,3,"dummy"
"86822",1,4,0,5,"dummy"
"86823",0,1,0,1,"dummy"
"86824",0,2,0,2,"dummy"
"86825",0,1,0,1,"dummy"
"86826",0,2,0,2,"dummy"
"86850",0,0,2,2,"dummy"
"86851",0,1,0,1,"dummy"
"86852",0,1,0,1,"dummy"
"86853",1,0,0,1,"dummy"
"86854",5,0,2,7,"dummy"
"86855",0,1,0,1,"dummy"
"86856",0,0,0,0,"dummy"
"86857",1,0,0,1,"dummy"
"86858",1,0,0,1,"dummy"
"86859",2,3,1,6,"dummy"
"86860",2,2,1,5,"dummy"
"86861",2,2,1,5,"dummy"
"86834",6,8,0,14,"dummy"
"86835",5,0,0,5,"dummy"
"86836",0,8,0,8,"dummy"
"86837",1,0,0,1,"dummy"
"86838",33,8,2,43,"dummy"
"86839",0,0,1,1,"dummy"
"86840",0,1,0,1,"dummy"
"86841",0,0,2,2,"dummy"
"86842",0,0,1,1,"dummy"
"86843",1,4,0,5,"dummy"
"86844",0,0,2,2,"dummy"
"86862",1,0,0,1,"dummy"
"86866",14,2,7,23,"dummy"
"86867",30,15,2,47,"dummy"
"86870",1,2,0,3,"dummy"
"86871",1,0,0,1,"dummy"
"86873",0,0,1,1,"dummy"
"86874",2,0,0,2,"dummy"
"86876",0,0,1,1,"dummy"
"86877",0,0,1,1,"dummy"
"86878",0,0,1,1,"dummy"
"86880",0,1,0,1,"dummy"
"86881",1,1,0,2,"dummy"
"86884",0,0,0,0,"dummy"
"86885",0,0,0,0,"dummy"
"86886",0,0,0,0,"dummy"
"86887",0,0,0,0,"dummy"
"86888",0,0,0,0,"dummy"
"86889",0,0,0,0,"dummy"
"86890",0,0,0,0,"dummy"
"86892",0,0,1,1,"dummy"
"86893",4,1,0,5,"dummy"
"86894",1,2,0,3,"dummy"
"86896",0,12,0,12,"dummy"
"86897",0,0,1,1,"dummy"
"86899",0,0,1,1,"dummy"
"86900",0,1,0,1,"dummy"
"86901",0,0,1,1,"dummy"
"86904",0,0,0,0,"dummy"
"86905",0,0,0,0,"dummy"
"86906",2,0,0,2,"dummy"
"86907",0,0,0,0,"dummy"
"86909",0,1,0,1,"dummy"
"86910",5,1,3,9,"dummy"
"86911",1,3,1,5,"dummy"
"86912",0,0,1,1,"dummy"
"86913",0,0,1,1,"dummy"
"86914",0,0,0,0,"dummy"
"86915",1,2,0,3,"dummy"
"86916",0,0,1,1,"dummy"
"86917",0,0,1,1,"dummy"
"86920",0,0,0,0,"dummy"
"86921",0,0,0,0,"dummy"
"86924",1,1,0,2,"dummy"
"86926",0,1,0,1,"dummy"
"86927",0,7,2,9,"dummy"
"86934",1,1,2,4,"dummy"
"86935",0,0,0,0,"dummy"
"86936",0,1,0,1,"dummy"
"86937",3,2,2,7,"dummy"
"86938",0,0,2,2,"dummy"
"86939",2,2,1,5,"dummy"
"86940",0,0,1,1,"dummy"
"86941",2,3,3,8,"dummy"
"86942",0,0,1,1,"dummy"
"86943",0,0,1,1,"dummy"
"86944",2,2,1,5,"dummy"
"86945",0,0,0,0,"dummy"
"86946",0,0,0,0,"dummy"
"86947",0,0,1,1,"dummy"
"86948",0,0,1,1,"dummy"
"86949",0,0,1,1,"dummy"
"86950",0,0,1,1,"dummy"
"86951",0,1,1,2,"dummy"
"86952",0,0,0,0,"dummy"
"86954",1,0,0,1,"dummy"
"86955",1,0,0,1,"dummy"
"86957",2,5,2,9,"dummy"
"86961",1,0,0,1,"dummy"
"86962",0,1,0,1,"dummy"
"86963",2,1,0,3,"dummy"
"86964",1,1,2,4,"dummy"
"86969",0,0,1,1,"dummy"
"86970",1,0,1,2,"dummy"
"86971",0,1,5,6,"dummy"
"86972",0,5,0,5,"dummy"
"86973",0,0,1,1,"dummy"
"86974",5,0,0,5,"dummy"
"86975",3,4,0,7,"dummy"
"86976",0,4,0,4,"dummy"
"86977",0,0,1,1,"dummy"
"86980",0,0,3,3,"dummy"
"86981",0,0,1,1,"dummy"
"86982",0,1,0,1,"dummy"
"86983",0,0,1,1,"dummy"
"86984",0,0,4,4,"dummy"
"86986",0,0,1,1,"dummy"
"86987",5,5,4,14,"dummy"
"87003",0,0,6,6,"dummy"
"87005",0,0,1,1,"dummy"
"87006",0,0,1,1,"dummy"
"87007",1,4,1,6,"dummy"
"87008",2,1,1,4,"dummy"
"87009",3,1,1,5,"dummy"
"87019",0,0,3,3,"dummy"
"87020",0,1,1,2,"dummy"
"87021",14,1,2,17,"dummy"
"87022",0,1,0,1,"dummy"
"87023",0,0,2,2,"dummy"
"87024",0,1,0,1,"dummy"
"87025",0,3,0,3,"dummy"
"87026",0,1,2,3,"dummy"
"87027",7,4,0,11,"dummy"
"87028",0,0,2,2,"dummy"
"87029",0,0,2,2,"dummy"
"87030",0,0,2,2,"dummy"
"87031",0,0,2,2,"dummy"
"87034",0,0,2,2,"dummy"
"87035",2,3,0,5,"dummy"
"87036",11,3,1,15,"dummy"
"87038",0,1,0,1,"dummy"
"87039",0,6,0,6,"dummy"
"87040",0,1,0,1,"dummy"
"87041",0,0,2,2,"dummy"
"87042",0,0,2,2,"dummy"
"87045",0,1,0,1,"dummy"
"87046",1,2,1,4,"dummy"
"87047",2,2,1,5,"dummy"
"87048",2,3,1,6,"dummy"
"87052",0,5,3,8,"dummy"
"87053",4,2,4,10,"dummy"
"87054",0,1,0,1,"dummy"
"87055",0,1,0,1,"dummy"
"87056",0,1,0,1,"dummy"
"87057",0,1,0,1,"dummy"
"87058",0,1,0,1,"dummy"
"87059",3,9,2,14,"dummy"
"87060",2,0,2,4,"dummy"
"87075",0,2,0,2,"dummy"
"87076",0,1,0,1,"dummy"
"87077",0,1,1,2,"dummy"
"87078",0,2,0,2,"dummy"
"87080",0,0,1,1,"dummy"
"87081",0,0,2,2,"dummy"
"87082",0,0,2,2,"dummy"
"87083",0,0,1,1,"dummy"
"87085",2,4,0,6,"dummy"
"87086",0,2,0,2,"dummy"
"87087",0,2,0,2,"dummy"
"87088",10,2,0,12,"dummy"
"87089",0,2,0,2,"dummy"
"87090",0,0,0,0,"dummy"
"87091",0,0,3,3,"dummy"
"87092",0,5,0,5,"dummy"
"87093",1,0,1,2,"dummy"
"87096",0,0,1,1,"dummy"
"87097",0,0,0,0,"dummy"
"87099",1,0,1,2,"dummy"
"87100",0,0,1,1,"dummy"
"87101",0,0,1,1,"dummy"
"87102",3,1,2,6,"dummy"
"87103",6,2,7,15,"dummy"
"87104",7,5,5,17,"dummy"
"87105",11,1,4,16,"dummy"
"87106",3,2,0,5,"dummy"
"87107",0,2,0,2,"dummy"
"87108",0,0,1,1,"dummy"
"87113",5,2,0,7,"dummy"
"87115",0,0,0,0,"dummy"
"87116",0,0,1,1,"dummy"
"87117",1,12,0,13,"dummy"
"87118",2,0,0,2,"dummy"
"87135",0,0,1,1,"dummy"
"87137",3,2,0,5,"dummy"
"87139",0,1,2,3,"dummy"
"87140",0,0,0,0,"dummy"
"87141",0,2,0,2,"dummy"
"87142",5,0,2,7,"dummy"
"87143",1,0,0,1,"dummy"
"87147",0,0,1,1,"dummy"
"87150",0,0,0,0,"dummy"
"87151",0,0,0,0,"dummy"
"87157",0,0,1,1,"dummy"
"87158",0,1,0,1,"dummy"
"87159",0,3,0,3,"dummy"
"87160",0,2,0,2,"dummy"
"87161",0,1,0,1,"dummy"
"87162",0,3,0,3,"dummy"
"87164",0,0,1,1,"dummy"
"87171",0,0,0,0,"dummy"
"87172",0,0,0,0,"dummy"
"87175",3,0,1,4,"dummy"
"87177",0,2,0,2,"dummy"
"87178",0,0,0,0,"dummy"
"87179",2,1,0,3,"dummy"
"87180",1,0,0,1,"dummy"
"87181",0,0,0,0,"dummy"
"87182",0,0,0,0,"dummy"
"87196",0,0,1,1,"dummy"
"87197",1,1,0,2,"dummy"
"87198",0,0,1,1,"dummy"
"87199",0,1,0,1,"dummy"
"87200",0,0,1,1,"dummy"
"87201",0,1,0,1,"dummy"
"87202",0,1,0,1,"dummy"
"87203",0,1,0,1,"dummy"
"87204",2,1,0,3,"dummy"
"87205",1,1,0,2,"dummy"
"87206",1,0,0,1,"dummy"
"87207",1,0,0,1,"dummy"
"87210",0,11,1,12,"dummy"
"87211",0,0,1,1,"dummy"
"87218",0,0,1,1,"dummy"
"87219",0,2,5,7,"dummy"
"87220",1,1,3,5,"dummy"
"87221",1,1,1,3,"dummy"
"87222",0,0,0,0,"dummy"
"87223",0,0,4,4,"dummy"
"87224",0,0,2,2,"dummy"
"87225",0,0,0,0,"dummy"
"87232",0,3,0,3,"dummy"
"87233",0,1,0,1,"dummy"
"87235",3,0,0,3,"dummy"
"87242",2,7,0,9,"dummy"
"87243",0,1,0,1,"dummy"
"87244",1,1,1,3,"dummy"
"87251",0,2,0,2,"dummy"
"87252",3,6,2,11,"dummy"
"87253",1,0,0,1,"dummy"
"87254",2,3,1,6,"dummy"
"87255",3,0,2,5,"dummy"
"87258",1,3,0,4,"dummy"
"87265",0,0,0,0,"dummy"
"87266",0,0,0,0,"dummy"
"87279",0,0,1,1,"dummy"
"87280",0,0,1,1,"dummy"
"87307",1,0,0,1,"dummy"
"87308",0,0,0,0,"dummy"
"87309",0,0,1,1,"dummy"
"87310",0,1,0,1,"dummy"
"87333",2,2,0,4,"dummy"
"87334",0,1,0,1,"dummy"
"87340",0,3,0,3,"dummy"
"87341",1,0,0,1,"dummy"
"87342",2,3,0,5,"dummy"
"87343",0,1,0,1,"dummy"
"87344",1,0,0,1,"dummy"
"87345",0,1,0,1,"dummy"
"87346",1,7,1,9,"dummy"
"87372",0,5,0,5,"dummy"
"87373",3,6,0,9,"dummy"
"87374",0,0,0,0,"dummy"
"87375",0,1,0,1,"dummy"
"87422",1,2,0,3,"dummy"
"87423",1,16,0,17,"dummy"
"87424",1,7,0,8,"dummy"
"87425",0,1,0,1,"dummy"
"87463",1,0,1,2,"dummy"
"87466",0,0,3,3,"dummy"
"87467",1,2,11,14,"dummy"
"87470",0,1,1,2,"dummy"
"87471",0,0,0,0,"dummy"
"87472",0,0,2,2,"dummy"
"87473",0,1,1,2,"dummy"
"87474",0,1,2,3,"dummy"
"87475",2,2,0,4,"dummy"
"87476",0,1,0,1,"dummy"
"87477",1,2,1,4,"dummy"
"87478",2,3,1,6,"dummy"
"87485",0,0,1,1,"dummy"
"87488",0,0,2,2,"dummy"
"87489",0,1,0,1,"dummy"
"87490",0,1,0,1,"dummy"
"87491",0,0,2,2,"dummy"
"87492",0,0,2,2,"dummy"
"87239",1,8,3,12,"dummy"
"87240",9,4,0,13,"dummy"
"87260",1,2,1,4,"dummy"
"87261",13,4,0,17,"dummy"
"87268",17,11,5,33,"dummy"
"87269",2,2,1,5,"dummy"
"87270",0,0,0,0,"dummy"
"87271",2,2,1,5,"dummy"
"87274",2,5,0,7,"dummy"
"87275",3,4,0,7,"dummy"
"87276",0,10,0,10,"dummy"
"87277",4,1,0,5,"dummy"
"87284",0,0,1,1,"dummy"
"87285",4,0,3,7,"dummy"
"87286",0,10,2,12,"dummy"
"87287",10,0,2,12,"dummy"
"87288",14,1,5,20,"dummy"
"87314",0,0,1,1,"dummy"
"87315",0,0,0,0,"dummy"
"87318",2,0,1,3,"dummy"
"87323",0,2,0,2,"dummy"
"87324",0,1,0,1,"dummy"
"87325",0,0,1,1,"dummy"
"87326",0,0,1,1,"dummy"
"87327",6,0,0,6,"dummy"
"87328",6,5,1,12,"dummy"
"87329",0,0,1,1,"dummy"
"87338",0,0,2,2,"dummy"
"87351",0,0,3,3,"dummy"
"87352",0,0,3,3,"dummy"
"87353",0,0,2,2,"dummy"
"87354",3,4,0,7,"dummy"
"87355",0,0,2,2,"dummy"
"87356",0,1,0,1,"dummy"
"87418",0,0,1,1,"dummy"
"87419",0,0,1,1,"dummy"
"87420",0,0,1,1,"dummy"
"87427",0,0,1,1,"dummy"
"87480",0,1,0,1,"dummy"
"87483",0,0,1,1,"dummy"
"87498",4,4,0,8,"dummy"
"87516",0,0,0,0,"dummy"
"87517",0,1,1,2,"dummy"
"87518",0,0,0,0,"dummy"
"87519",0,7,0,7,"dummy"
"87520",0,1,0,1,"dummy"
"87521",0,0,0,0,"dummy"
"87527",0,1,0,1,"dummy"
"87528",0,1,1,2,"dummy"
"87533",0,3,0,3,"dummy"
"87534",3,2,0,5,"dummy"
"87535",0,4,0,4,"dummy"
"87536",0,4,0,4,"dummy"
"87537",0,0,2,2,"dummy"
"87555",0,0,1,1,"dummy"
"87556",0,1,0,1,"dummy"
"87530",0,3,0,3,"dummy"
"87531",0,1,0,1,"dummy"
"87539",4,9,2,15,"dummy"
"87540",1,0,0,1,"dummy"
"87543",23,35,1,59,"dummy"
"87544",0,5,0,5,"dummy"
"87545",3,3,0,6,"dummy"
"87546",4,0,0,4,"dummy"
"87547",0,4,0,4,"dummy"
"87568",0,30,0,30,"dummy"
"87569",2,12,6,20,"dummy"
"87570",2,1,3,6,"dummy"
"87571",0,1,1,2,"dummy"
"87572",3,3,1,7,"dummy"
"87573",1,0,0,1,"dummy"
"87574",0,1,0,1,"dummy"
"87578",0,1,0,1,"dummy"
"87579",1,0,0,1,"dummy"
"87591",0,2,0,2,"dummy"
"87592",0,0,0,0,"dummy"
"87593",2,0,0,2,"dummy"
"87594",0,2,0,2,"dummy"
"87595",1,3,1,5,"dummy"
"87596",1,1,0,2,"dummy"
"87597",0,0,1,1,"dummy"
"87598",0,0,0,0,"dummy"
"87599",1,1,0,2,"dummy"
"87618",0,0,1,1,"dummy"
"87638",0,2,0,2,"dummy"
"87642",0,0,0,0,"dummy"
"87647",0,2,1,3,"dummy"
"87648",0,4,0,4,"dummy"
"87655",0,1,0,1,"dummy"
"87656",11,9,2,22,"dummy"
"87657",0,0,1,1,"dummy"
"87658",1,0,0,1,"dummy"
"87659",0,4,0,4,"dummy"
"87675",0,1,0,1,"dummy"
"87698",1,0,0,1,"dummy"
"87699",2,0,0,2,"dummy"
"87700",0,0,1,1,"dummy"
"87701",0,0,0,0,"dummy"
"87702",0,0,0,0,"dummy"
"87703",0,0,0,0,"dummy"
"87704",0,0,0,0,"dummy"
"87730",3,0,1,4,"dummy"
"87733",8,2,1,11,"dummy"
"87751",0,1,0,1,"dummy"
"87752",0,0,1,1,"dummy"
"87753",1,1,1,3,"dummy"
"87754",7,4,1,12,"dummy"
"87755",0,0,2,2,"dummy"
"87756",0,1,1,2,"dummy"
"87757",1,0,1,2,"dummy"
"87758",0,0,1,1,"dummy"
"87763",3,5,2,10,"dummy"
"87766",16,1,1,18,"dummy"
"87767",0,3,0,3,"dummy"
"87775",5,10,1,16,"dummy"
"87776",0,1,0,1,"dummy"
"87779",6,5,5,16,"dummy"
"87780",0,0,1,1,"dummy"
"87781",6,12,2,20,"dummy"
"87782",0,0,1,1,"dummy"
"87783",0,0,1,1,"dummy"
"87561",0,1,0,1,"dummy"
"87562",3,0,0,3,"dummy"
"87563",2,0,0,2,"dummy"
"87564",8,9,2,19,"dummy"
"87565",0,0,1,1,"dummy"
"87566",4,4,0,8,"dummy"
"87576",0,0,1,1,"dummy"
"87583",1,16,0,17,"dummy"
"87584",1,8,0,9,"dummy"
"87585",4,16,3,23,"dummy"
"87586",0,1,0,1,"dummy"
"87587",2,0,1,3,"dummy"
"87603",3,11,1,15,"dummy"
"87604",10,8,5,23,"dummy"
"87607",0,0,1,1,"dummy"
"87608",0,0,3,3,"dummy"
"87609",0,0,2,2,"dummy"
"87610",0,0,1,1,"dummy"
"87615",1,0,2,3,"dummy"
"87616",6,1,5,12,"dummy"
"87633",0,1,3,4,"dummy"
"87634",7,0,0,7,"dummy"
"87635",0,0,4,4,"dummy"
"87636",0,0,2,2,"dummy"
"87640",0,3,0,3,"dummy"
"87644",0,1,0,1,"dummy"
"87645",1,3,1,5,"dummy"
"87650",4,0,1,5,"dummy"
"87651",3,0,2,5,"dummy"
"87652",4,3,0,7,"dummy"
"87653",0,1,0,1,"dummy"
"87661",0,3,0,3,"dummy"
"87662",13,16,4,33,"dummy"
"87663",0,2,0,2,"dummy"
"87664",0,7,0,7,"dummy"
"87667",0,0,1,1,"dummy"
"87668",0,18,0,18,"dummy"
"87669",1,2,0,3,"dummy"
"87670",0,0,1,1,"dummy"
"87671",0,10,0,10,"dummy"
"87677",0,0,0,0,"dummy"
"87678",0,0,0,0,"dummy"
"87679",0,3,0,3,"dummy"
"87680",7,24,0,31,"dummy"
"87681",4,0,0,4,"dummy"
"87682",0,1,0,1,"dummy"
"87683",3,8,2,13,"dummy"
"87684",9,1,0,10,"dummy"
"87687",0,1,0,1,"dummy"
"87688",0,0,0,0,"dummy"
"87691",24,3,1,28,"dummy"
"87694",1,0,0,1,"dummy"
"87706",2,7,0,9,"dummy"
"87707",0,1,0,1,"dummy"
"87708",0,1,0,1,"dummy"
"87709",0,0,1,1,"dummy"
"87710",1,1,4,6,"dummy"
"87711",2,2,1,5,"dummy"
"87712",0,2,0,2,"dummy"
"87713",2,3,2,7,"dummy"
"87714",0,0,1,1,"dummy"
"87715",1,0,0,1,"dummy"
"87716",0,0,1,1,"dummy"
"87717",0,1,0,1,"dummy"
"87718",2,3,0,5,"dummy"
"87719",0,0,1,1,"dummy"
"87720",0,0,1,1,"dummy"
"87723",0,1,0,1,"dummy"
"87724",0,5,0,5,"dummy"
"87725",1,2,0,3,"dummy"
"87726",0,3,0,3,"dummy"
"87727",1,0,0,1,"dummy"
"87728",1,3,1,5,"dummy"
"87735",0,1,0,1,"dummy"
"87736",0,2,5,7,"dummy"
"87739",0,2,0,2,"dummy"
"87740",4,3,0,7,"dummy"
"87741",0,2,0,2,"dummy"
"87742",2,0,0,2,"dummy"
"87743",11,0,1,12,"dummy"
"87744",0,0,1,1,"dummy"
"87745",0,5,1,6,"dummy"
"87746",5,7,0,12,"dummy"
"87747",1,8,1,10,"dummy"
"87748",0,0,1,1,"dummy"
"87749",2,2,0,4,"dummy"
"87769",0,4,0,4,"dummy"
"87789",0,1,0,1,"dummy"
"87790",1,3,1,5,"dummy"
"87791",1,0,1,2,"dummy"
"87799",0,0,0,0,"dummy"
"87800",0,0,0,0,"dummy"
"87801",2,3,0,5,"dummy"
"87802",0,0,0,0,"dummy"
"87803",0,0,5,5,"dummy"
"87804",0,0,0,0,"dummy"
"87805",0,0,0,0,"dummy"
"87806",2,0,0,2,"dummy"
"87807",2,0,0,2,"dummy"
"87810",0,0,0,0,"dummy"
"87811",0,0,0,0,"dummy"
"87812",0,1,0,1,"dummy"
"87813",2,0,0,2,"dummy"
"87814",0,0,2,2,"dummy"
"87815",0,0,1,1,"dummy"
"87816",20,0,0,20,"dummy"
"87817",0,2,0,2,"dummy"
"87818",8,22,3,33,"dummy"
"87819",1,0,0,1,"dummy"
"87824",8,14,0,22,"dummy"
"87825",2,2,0,4,"dummy"
"87826",0,0,1,1,"dummy"
"87827",10,3,2,15,"dummy"
"87830",0,1,2,3,"dummy"
"87831",1,0,2,3,"dummy"
"87834",1,3,0,4,"dummy"
"87835",0,1,0,1,"dummy"
"87836",12,4,2,18,"dummy"
"87837",2,0,0,2,"dummy"
"87838",0,0,1,1,"dummy"
"87857",0,0,0,0,"dummy"
"87863",0,0,1,1,"dummy"
"87864",0,0,1,1,"dummy"
"87865",0,0,1,1,"dummy"
"87866",0,0,2,2,"dummy"
"87867",0,0,1,1,"dummy"
"87868",0,0,1,1,"dummy"
"87869",6,2,0,8,"dummy"
"87870",0,0,1,1,"dummy"
"87871",0,0,1,1,"dummy"
"87872",0,0,1,1,"dummy"
"87873",0,0,1,1,"dummy"
"87874",0,0,1,1,"dummy"
"87875",0,0,0,0,"dummy"
"87876",0,0,1,1,"dummy"
"87877",0,0,1,1,"dummy"
"87878",0,0,1,1,"dummy"
"87881",0,0,1,1,"dummy"
"87882",1,2,0,3,"dummy"
"87886",0,23,0,23,"dummy"
"87893",2,2,0,4,"dummy"
"87896",0,2,0,2,"dummy"
"87922",9,10,6,25,"dummy"
"87930",0,5,1,6,"dummy"
"87931",10,26,0,36,"dummy"
"87932",0,0,1,1,"dummy"
"87933",0,0,1,1,"dummy"
"87934",0,0,2,2,"dummy"
"87935",26,3,7,36,"dummy"
"87959",2,2,2,6,"dummy"
"87960",3,3,2,8,"dummy"
"87963",0,0,2,2,"dummy"
"87964",0,0,1,1,"dummy"
"87997",0,0,0,0,"dummy"
"87786",0,1,0,1,"dummy"
"87787",10,3,2,15,"dummy"
"87793",2,2,1,5,"dummy"
"87794",4,5,0,9,"dummy"
"87795",0,0,0,0,"dummy"
"87796",0,1,0,1,"dummy"
"87797",0,0,0,0,"dummy"
"87840",2,2,0,4,"dummy"
"87841",0,1,0,1,"dummy"
"87842",1,0,0,1,"dummy"
"87843",0,1,0,1,"dummy"
"87844",0,0,1,1,"dummy"
"87845",0,2,0,2,"dummy"
"87846",0,0,1,1,"dummy"
"87847",0,1,0,1,"dummy"
"87848",0,0,0,0,"dummy"
"87849",0,3,0,3,"dummy"
"87850",3,0,1,4,"dummy"
"87851",0,3,0,3,"dummy"
"87852",3,0,0,3,"dummy"
"87853",0,0,1,1,"dummy"
"87859",2,2,2,6,"dummy"
"87860",0,0,2,2,"dummy"
"87861",1,0,1,2,"dummy"
"87884",1,3,1,5,"dummy"
"87898",0,1,0,1,"dummy"
"87899",1,0,3,4,"dummy"
"87900",0,1,0,1,"dummy"
"87901",0,1,0,1,"dummy"
"87902",0,0,2,2,"dummy"
"87903",0,1,1,2,"dummy"
"87906",0,0,1,1,"dummy"
"87907",4,0,0,4,"dummy"
"87908",4,4,2,10,"dummy"
"87909",0,1,0,1,"dummy"
"87910",1,0,0,1,"dummy"
"87911",6,6,2,14,"dummy"
"87912",6,6,2,14,"dummy"
"87913",6,9,2,17,"dummy"
"87914",3,0,0,3,"dummy"
"87915",0,2,0,2,"dummy"
"87916",0,3,0,3,"dummy"
"87917",0,0,1,1,"dummy"
"87918",0,0,1,1,"dummy"
"87926",0,0,2,2,"dummy"
"87944",0,0,4,4,"dummy"
"87945",1,1,1,3,"dummy"
"87946",0,1,0,1,"dummy"
"87947",0,1,0,1,"dummy"
"87948",0,1,0,1,"dummy"
"87949",0,1,0,1,"dummy"
"87950",0,0,1,1,"dummy"
"87951",0,4,0,4,"dummy"
"87952",11,0,0,11,"dummy"
"87953",0,2,0,2,"dummy"
"87954",0,1,1,2,"dummy"
"87955",0,1,0,1,"dummy"
"87956",0,2,0,2,"dummy"
"87957",0,0,1,1,"dummy"
"87966",0,0,0,0,"dummy"
"87967",0,2,1,3,"dummy"
"87968",0,2,0,2,"dummy"
"87969",0,3,0,3,"dummy"
"87970",3,1,0,4,"dummy"
"87973",0,0,1,1,"dummy"
"87974",0,6,0,6,"dummy"
"87975",3,2,2,7,"dummy"
"87976",1,0,1,2,"dummy"
"87977",0,3,0,3,"dummy"
"87978",7,4,0,11,"dummy"
"87979",0,0,1,1,"dummy"
"87980",1,3,1,5,"dummy"
"87981",8,10,1,19,"dummy"
"87982",10,3,1,14,"dummy"
"87983",1,4,0,5,"dummy"
"87984",0,0,0,0,"dummy"
"87985",1,0,0,1,"dummy"
"87986",0,0,0,0,"dummy"
"87987",0,1,1,2,"dummy"
"87988",0,0,1,1,"dummy"
"87995",0,0,0,0,"dummy"
"88002",0,2,0,2,"dummy"
"88003",4,1,3,8,"dummy"
"88009",0,1,0,1,"dummy"
"88010",1,0,0,1,"dummy"
"88015",1,9,0,10,"dummy"
"88016",8,10,0,18,"dummy"
"88017",0,2,0,2,"dummy"
"88018",0,2,0,2,"dummy"
"88019",0,3,0,3,"dummy"
"88020",1,3,0,4,"dummy"
"88021",0,2,0,2,"dummy"
"88026",1,0,0,1,"dummy"
"88029",0,0,1,1,"dummy"
"88030",0,0,1,1,"dummy"
"88033",1,3,1,5,"dummy"
"88042",17,46,5,68,"dummy"
"88061",0,0,1,1,"dummy"
"88062",0,0,1,1,"dummy"
"88063",0,0,1,1,"dummy"
"88068",6,0,0,6,"dummy"
"88069",2,5,2,9,"dummy"
"88075",1,0,0,1,"dummy"
"88076",3,10,1,14,"dummy"
"88086",3,1,0,4,"dummy"
"88087",5,7,4,16,"dummy"
"88088",0,0,1,1,"dummy"
"88089",0,0,2,2,"dummy"
"88090",4,1,0,5,"dummy"
"87998",1,0,0,1,"dummy"
"88005",2,10,4,16,"dummy"
"88012",1,0,0,1,"dummy"
"88013",0,0,1,1,"dummy"
"88023",0,1,0,1,"dummy"
"88024",0,1,0,1,"dummy"
"88065",1,1,0,2,"dummy"
"88066",0,0,0,0,"dummy"
"88073",10,2,3,15,"dummy"
"88080",0,1,0,1,"dummy"
"88081",0,2,0,2,"dummy"
"88084",15,17,1,33,"dummy"
"88184",0,0,0,0,"dummy"
"88185",0,0,0,0,"dummy"
"88186",0,0,0,0,"dummy"
"88187",5,13,1,19,"dummy"
"88192",0,2,0,2,"dummy"
"88195",0,0,1,1,"dummy"
"88198",0,7,3,10,"dummy"
"88199",0,0,1,1,"dummy"
"88201",0,0,1,1,"dummy"
"88202",0,1,0,1,"dummy"
"88203",0,0,1,1,"dummy"
"88206",0,1,2,3,"dummy"
"88207",0,0,1,1,"dummy"
"88214",0,0,3,3,"dummy"
"88215",0,1,0,1,"dummy"
"88216",0,2,0,2,"dummy"
"88217",3,0,0,3,"dummy"
"88218",1,3,0,4,"dummy"
"88219",0,1,0,1,"dummy"
"88221",0,3,0,3,"dummy"
"88223",0,1,0,1,"dummy"
"88226",5,8,1,14,"dummy"
"88227",2,4,3,9,"dummy"
"88228",0,0,0,0,"dummy"
"88229",1,2,2,5,"dummy"
"88230",2,3,1,6,"dummy"
"88231",0,0,1,1,"dummy"
"88232",5,4,7,16,"dummy"
"88233",17,34,5,56,"dummy"
"88234",2,0,0,2,"dummy"
"88237",0,0,1,1,"dummy"
"88238",2,1,0,3,"dummy"
"88239",0,0,0,0,"dummy"
"88240",0,0,0,0,"dummy"
"88241",0,0,0,0,"dummy"
"88254",2,2,0,4,"dummy"
"88255",0,3,0,3,"dummy"
"88256",0,2,0,2,"dummy"
"88257",0,0,2,2,"dummy"
"88259",0,0,1,1,"dummy"
"88264",0,1,0,1,"dummy"
"88265",0,0,1,1,"dummy"
"88266",1,0,1,2,"dummy"
"88289",9,9,0,18,"dummy"
"88290",7,3,0,10,"dummy"
"88291",3,7,0,10,"dummy"
"88292",7,3,0,10,"dummy"
"88293",1,0,0,1,"dummy"
"88294",1,0,0,1,"dummy"
"88295",0,0,1,1,"dummy"
"88296",0,1,0,1,"dummy"
"88297",0,0,1,1,"dummy"
"88298",2,6,0,8,"dummy"
"88300",4,0,0,4,"dummy"
"88301",3,0,2,5,"dummy"
"88302",1,0,0,1,"dummy"
"88308",6,9,6,21,"dummy"
"88309",0,0,6,6,"dummy"
"88310",0,0,6,6,"dummy"
"88311",0,0,6,6,"dummy"
"88312",0,0,6,6,"dummy"
"88313",0,0,6,6,"dummy"
"88314",0,0,2,2,"dummy"
"88315",0,0,2,2,"dummy"
"88287",0,1,0,1,"dummy"
"88286",48,1,2,51,"dummy"
"88285",0,1,0,1,"dummy"
"88284",3,2,0,5,"dummy"
"88283",0,1,0,1,"dummy"
"88282",1,1,0,2,"dummy"
"88281",4,4,4,12,"dummy"
"88280",0,41,0,41,"dummy"
"88279",1,0,1,2,"dummy"
"88278",0,2,0,2,"dummy"
"88277",3,3,3,9,"dummy"
"88276",2,3,0,5,"dummy"
"88275",1,1,4,6,"dummy"
"88274",0,0,1,1,"dummy"
"88273",0,0,1,1,"dummy"
"88272",0,3,2,5,"dummy"
"88271",0,3,0,3,"dummy"
"88270",1,1,0,2,"dummy"
"88269",0,0,1,1,"dummy"
"88268",0,0,2,2,"dummy"
"88317",16,0,1,17,"dummy"
"88320",0,0,1,1,"dummy"
"88321",1,11,2,14,"dummy"
"88322",0,0,1,1,"dummy"
"88326",0,0,0,0,"dummy"
"88327",3,2,0,5,"dummy"
"88331",4,2,1,7,"dummy"
"88334",29,18,3,50,"dummy"
"88336",4,0,0,4,"dummy"
"88339",2,0,0,2,"dummy"
"88340",0,4,0,4,"dummy"
"88341",2,0,1,3,"dummy"
"88342",0,2,1,3,"dummy"
"88343",0,2,0,2,"dummy"
"88344",26,1,2,29,"dummy"
"88345",0,1,0,1,"dummy"
"88346",4,3,0,7,"dummy"
"88347",0,1,0,1,"dummy"
"88350",0,0,6,6,"dummy"
"88352",2,1,1,4,"dummy"
"88353",0,0,0,0,"dummy"
"88354",0,0,4,4,"dummy"
"88355",0,0,1,1,"dummy"
"88356",8,7,0,15,"dummy"
"88357",0,0,2,2,"dummy"
"88358",0,0,3,3,"dummy"
"88359",0,0,0,0,"dummy"
"88360",0,0,0,0,"dummy"
"88361",0,0,0,0,"dummy"
"88362",0,0,0,0,"dummy"
"88363",0,0,0,0,"dummy"
"88366",11,0,3,14,"dummy"
"88367",2,1,0,3,"dummy"
"88381",0,0,0,0,"dummy"
"88382",0,0,1,1,"dummy"
"88383",3,0,0,3,"dummy"
"88384",0,0,1,1,"dummy"
"88385",0,1,0,1,"dummy"
"88386",0,2,0,2,"dummy"
"88393",0,0,2,2,"dummy"
"88414",3,2,0,5,"dummy"
"88416",2,24,0,26,"dummy"
"88417",11,2,1,14,"dummy"
"88418",0,3,0,3,"dummy"
"88419",2,1,0,3,"dummy"
"88420",0,0,2,2,"dummy"
"88421",0,6,0,6,"dummy"
"88422",2,7,3,12,"dummy"
"88423",0,2,0,2,"dummy"
"88424",6,3,1,10,"dummy"
"88425",0,0,0,0,"dummy"
"88426",0,0,0,0,"dummy"
"88464",1,2,1,4,"dummy"
"88465",0,3,0,3,"dummy"
"88466",0,1,0,1,"dummy"
"88467",1,3,0,4,"dummy"
"88468",0,0,1,1,"dummy"
"88469",0,0,1,1,"dummy"
"88470",3,4,0,7,"dummy"
"88471",0,0,1,1,"dummy"
"88473",2,14,1,17,"dummy"
"88474",0,6,0,6,"dummy"
"88475",0,1,3,4,"dummy"
"88476",0,0,4,4,"dummy"
"88477",0,0,1,1,"dummy"
"88478",1,0,0,1,"dummy"
"88479",6,8,3,17,"dummy"
"88480",8,0,0,8,"dummy"
"88481",0,0,1,1,"dummy"
"88482",0,1,0,1,"dummy"
"88483",0,2,2,4,"dummy"
"88487",0,0,2,2,"dummy"
"88488",0,0,0,0,"dummy"
"88489",0,0,0,0,"dummy"
"88491",2,2,0,4,"dummy"
"88495",0,1,0,1,"dummy"
"88496",1,0,0,1,"dummy"
"88497",0,1,0,1,"dummy"
"88498",0,1,0,1,"dummy"
"88500",0,3,1,4,"dummy"
"88503",0,1,0,1,"dummy"
"88504",1,0,0,1,"dummy"
"88515",1,0,0,1,"dummy"
"88516",2,0,1,3,"dummy"
"88517",0,0,0,0,"dummy"
"88518",0,1,0,1,"dummy"
"88519",8,1,0,9,"dummy"
"88520",0,0,0,0,"dummy"
"88521",0,0,0,0,"dummy"
"88522",1,10,0,11,"dummy"
"88523",7,1,0,8,"dummy"
"88524",0,0,1,1,"dummy"
"88525",2,0,3,5,"dummy"
"88528",0,2,0,2,"dummy"
"88529",1,1,0,2,"dummy"
"88542",0,0,1,1,"dummy"
"88544",0,0,1,1,"dummy"
"88545",0,0,1,1,"dummy"
"88546",0,0,1,1,"dummy"
"88547",0,0,1,1,"dummy"
"88548",0,0,1,1,"dummy"
"88549",0,0,1,1,"dummy"
"88550",0,0,1,1,"dummy"
"88552",11,0,1,12,"dummy"
"88553",0,4,2,6,"dummy"
"88560",0,12,0,12,"dummy"
"88561",1,0,0,1,"dummy"
"88562",5,4,1,10,"dummy"
"88593",0,0,0,0,"dummy"
"88594",2,0,0,2,"dummy"
"88601",2,15,1,18,"dummy"
"88602",4,4,1,9,"dummy"
"88603",0,1,0,1,"dummy"
"88604",0,0,2,2,"dummy"
"88605",2,0,2,4,"dummy"
"88625",0,0,1,1,"dummy"
"88626",1,2,3,6,"dummy"
"88691",0,0,0,0,"dummy"
"88692",0,1,0,1,"dummy"
"88693",0,1,0,1,"dummy"
"88697",0,1,0,1,"dummy"
"88700",0,2,0,2,"dummy"
"88701",0,3,0,3,"dummy"
"88702",0,11,0,11,"dummy"
"88703",0,8,0,8,"dummy"
"88704",0,0,0,0,"dummy"
"88705",0,0,1,1,"dummy"
"88706",0,3,0,3,"dummy"
"88707",0,1,0,1,"dummy"
"88708",0,0,2,2,"dummy"
"88709",9,2,0,11,"dummy"
"88710",0,0,1,1,"dummy"
"88711",5,0,0,5,"dummy"
"88712",0,0,0,0,"dummy"
"88713",0,0,0,0,"dummy"
"88725",0,0,1,1,"dummy"
"88736",1,0,0,1,"dummy"
"88737",0,0,1,1,"dummy"
"88768",0,0,1,1,"dummy"
"88769",1,0,0,1,"dummy"
"88772",0,0,1,1,"dummy"
"88851",0,1,0,1,"dummy"
"88854",2,17,2,21,"dummy"
"88855",0,0,1,1,"dummy"
"88856",0,1,0,1,"dummy"
"88861",2,2,0,4,"dummy"
"88864",1,0,1,2,"dummy"
"88865",2,1,1,4,"dummy"
"88885",0,0,0,0,"dummy"
"88898",0,0,0,0,"dummy"
"88899",0,0,1,1,"dummy"
"88900",0,0,0,0,"dummy"
"88901",24,12,3,39,"dummy"
"88902",0,0,0,0,"dummy"
"88903",10,22,2,34,"dummy"
"88921",0,0,1,1,"dummy"
"88950",1,1,0,2,"dummy"
"88951",1,2,0,3,"dummy"
"88952",0,0,1,1,"dummy"
"88968",0,0,1,1,"dummy"
"88971",2,4,1,7,"dummy"
"88972",0,1,0,1,"dummy"
"88977",1,1,0,2,"dummy"
"88978",0,0,0,0,"dummy"
"88979",0,0,1,1,"dummy"
"88564",0,2,0,2,"dummy"
"88572",1,4,1,6,"dummy"
"88573",0,0,3,3,"dummy"
"88574",0,0,3,3,"dummy"
"88575",0,1,1,2,"dummy"
"88576",0,0,1,1,"dummy"
"88577",0,0,1,1,"dummy"
"88578",0,0,1,1,"dummy"
"88579",0,0,4,4,"dummy"
"88580",0,1,1,2,"dummy"
"88581",0,0,1,1,"dummy"
"88584",1,2,1,4,"dummy"
"88585",0,1,0,1,"dummy"
"88586",1,0,1,2,"dummy"
"88587",0,0,1,1,"dummy"
"88588",0,1,0,1,"dummy"
"88589",0,1,0,1,"dummy"
"88590",2,2,0,4,"dummy"
"88591",0,1,0,1,"dummy"
"88618",1,11,0,12,"dummy"
"88619",1,0,0,1,"dummy"
"88620",0,0,1,1,"dummy"
"88621",0,2,0,2,"dummy"
"88622",0,0,1,1,"dummy"
"88623",4,1,0,5,"dummy"
"88649",0,0,1,1,"dummy"
"88650",1,0,1,2,"dummy"
"88653",18,3,0,21,"dummy"
"88654",0,0,1,1,"dummy"
"88659",0,0,1,1,"dummy"
"88662",4,4,0,8,"dummy"
"88663",6,0,0,6,"dummy"
"88664",0,3,0,3,"dummy"
"88665",3,12,0,15,"dummy"
"88666",0,0,0,0,"dummy"
"88667",1,1,2,4,"dummy"
"88668",0,2,0,2,"dummy"
"88669",0,1,0,1,"dummy"
"88695",0,1,0,1,"dummy"
"88715",0,4,1,5,"dummy"
"88716",3,3,1,7,"dummy"
"88719",7,0,0,7,"dummy"
"88729",0,1,2,3,"dummy"
"88730",0,1,0,1,"dummy"
"88731",0,1,0,1,"dummy"
"88732",0,1,1,2,"dummy"
"88733",0,1,0,1,"dummy"
"88734",5,4,1,10,"dummy"
"88739",3,2,1,6,"dummy"
"88740",4,11,3,18,"dummy"
"88760",2,5,0,7,"dummy"
"88761",0,3,0,3,"dummy"
"88774",1,1,1,3,"dummy"
"88775",0,1,0,1,"dummy"
"88776",0,1,0,1,"dummy"
"88777",0,1,0,1,"dummy"
"88809",4,0,0,4,"dummy"
"88858",2,3,1,6,"dummy"
"88859",0,1,2,3,"dummy"
"88867",0,0,1,1,"dummy"
"88870",0,2,0,2,"dummy"
"88871",0,4,0,4,"dummy"
"88872",0,0,1,1,"dummy"
"88873",0,5,1,6,"dummy"
"88874",1,1,0,2,"dummy"
"88875",0,4,0,4,"dummy"
"88876",12,3,4,19,"dummy"
"88877",1,2,1,4,"dummy"
"88878",0,0,1,1,"dummy"
"88879",39,2,0,41,"dummy"
"88880",0,0,1,1,"dummy"
"88881",0,0,1,1,"dummy"
"88887",0,0,1,1,"dummy"
"88888",0,0,1,1,"dummy"
"88889",0,1,0,1,"dummy"
"88890",0,0,1,1,"dummy"
"88891",0,0,1,1,"dummy"
"88892",0,0,1,1,"dummy"
"88893",0,0,1,1,"dummy"
"88894",0,0,1,1,"dummy"
"88895",0,0,1,1,"dummy"
"88896",0,0,1,1,"dummy"
"88923",0,17,0,17,"dummy"
"88924",0,1,3,4,"dummy"
"88925",0,1,0,1,"dummy"
"88926",1,4,1,6,"dummy"
"88927",1,4,0,5,"dummy"
"88928",1,0,0,1,"dummy"
"88929",2,2,0,4,"dummy"
"88930",0,7,0,7,"dummy"
"88931",11,18,0,29,"dummy"
"88932",0,1,0,1,"dummy"
"88938",0,0,1,1,"dummy"
"88941",2,3,0,5,"dummy"
"88942",0,5,1,6,"dummy"
"88943",5,0,1,6,"dummy"
"88944",0,4,0,4,"dummy"
"88945",4,4,0,8,"dummy"
"88946",1,1,0,2,"dummy"
"88947",5,4,2,11,"dummy"
"88948",0,1,0,1,"dummy"
"88954",1,0,0,1,"dummy"
"88955",2,1,1,4,"dummy"
"88956",0,0,1,1,"dummy"
"88957",0,0,1,1,"dummy"
"88958",0,0,1,1,"dummy"
"88959",0,0,2,2,"dummy"
"88960",0,0,1,1,"dummy"
"88961",0,0,1,1,"dummy"
"88962",0,0,1,1,"dummy"
"88963",0,1,0,1,"dummy"
"88964",0,1,0,1,"dummy"
"88990",0,1,0,1,"dummy"
"88998",1,0,0,1,"dummy"
"89003",0,5,0,5,"dummy"
"89004",6,1,2,9,"dummy"
"89041",2,2,0,4,"dummy"
"89077",1,1,0,2,"dummy"
"89078",0,1,1,2,"dummy"
"88980",1,0,1,2,"dummy"
"88981",0,1,0,1,"dummy"
"88982",0,0,1,1,"dummy"
"88983",4,3,1,8,"dummy"
"88984",0,0,0,0,"dummy"
"88992",7,4,2,13,"dummy"
"88993",0,0,2,2,"dummy"
"88996",0,2,2,4,"dummy"
"89008",0,4,0,4,"dummy"
"89009",0,0,0,0,"dummy"
"89010",1,1,0,2,"dummy"
"89011",0,0,1,1,"dummy"
"89012",1,1,1,3,"dummy"
"89013",0,11,0,11,"dummy"
"89014",0,6,0,6,"dummy"
"89015",0,2,0,2,"dummy"
"89016",56,15,0,71,"dummy"
"89017",3,1,0,4,"dummy"
"89018",0,1,0,1,"dummy"
"89019",1,0,0,1,"dummy"
"89020",0,2,0,2,"dummy"
"89021",5,4,1,10,"dummy"
"89022",0,6,0,6,"dummy"
"89023",4,5,2,11,"dummy"
"89024",0,2,0,2,"dummy"
"89025",0,0,0,0,"dummy"
"89026",0,2,0,2,"dummy"
"89027",0,0,0,0,"dummy"
"89028",0,0,0,0,"dummy"
"89029",0,0,0,0,"dummy"
"89030",0,0,0,0,"dummy"
"89031",0,0,0,0,"dummy"
"89032",0,3,0,3,"dummy"
"89033",1,2,0,3,"dummy"
"89036",0,4,0,4,"dummy"
"89037",4,0,0,4,"dummy"
"89038",1,1,0,2,"dummy"
"89039",0,0,1,1,"dummy"
"89043",0,0,2,2,"dummy"
"89046",0,1,0,1,"dummy"
"89051",0,0,1,1,"dummy"
"89052",0,0,1,1,"dummy"
"89067",0,0,1,1,"dummy"
"89068",0,0,1,1,"dummy"
"89069",0,4,1,5,"dummy"
"89070",0,0,1,1,"dummy"
"89071",2,2,2,6,"dummy"
"89072",0,2,0,2,"dummy"
"89073",0,1,0,1,"dummy"
"89080",0,1,0,1,"dummy"
"89081",0,1,0,1,"dummy"
"89082",0,0,2,2,"dummy"
"89083",0,1,0,1,"dummy"
"89150",0,1,0,1,"dummy"
"89153",0,1,1,2,"dummy"
"89154",0,0,1,1,"dummy"
"89155",1,0,0,1,"dummy"
"89158",0,0,2,2,"dummy"
"89159",0,0,2,2,"dummy"
"89160",0,1,1,2,"dummy"
"89161",0,0,1,1,"dummy"
"89162",0,3,0,3,"dummy"
"89163",0,0,1,1,"dummy"
"89164",0,0,1,1,"dummy"
"89165",0,0,1,1,"dummy"
"89195",0,0,1,1,"dummy"
"89196",0,0,2,2,"dummy"
"89197",0,1,0,1,"dummy"
"89198",0,2,0,2,"dummy"
"89202",0,2,0,2,"dummy"
"89203",0,1,2,3,"dummy"
"89204",1,2,0,3,"dummy"
"89273",0,0,0,0,"dummy"
"89274",0,0,0,0,"dummy"
"89176",0,2,2,4,"dummy"
"89177",0,0,0,0,"dummy"
"89215",1,0,1,2,"dummy"
"89216",0,0,1,1,"dummy"
"89217",0,2,0,2,"dummy"
"89218",0,1,0,1,"dummy"
"89221",0,0,1,1,"dummy"
"89222",0,1,0,1,"dummy"
"89270",0,1,0,1,"dummy"
"89271",1,5,0,6,"dummy"
"89292",1,2,0,3,"dummy"
"89299",0,0,0,0,"dummy"
"89300",5,0,2,7,"dummy"
"89301",0,0,0,0,"dummy"
"89310",7,3,3,13,"dummy"
"89313",0,0,1,1,"dummy"
"89314",1,2,1,4,"dummy"
"89315",2,0,1,3,"dummy"
"89335",0,1,0,1,"dummy"
"89336",0,11,0,11,"dummy"
"89337",1,0,1,2,"dummy"
"89338",4,16,0,20,"dummy"
"89339",41,6,1,48,"dummy"
"89340",0,0,0,0,"dummy"
"89345",3,1,0,4,"dummy"
"89346",2,3,0,5,"dummy"
"89347",0,1,0,1,"dummy"
"89353",0,2,1,3,"dummy"
"89362",0,0,0,0,"dummy"
"89363",0,0,0,0,"dummy"
"89370",0,2,0,2,"dummy"
"89371",3,1,1,5,"dummy"
"89372",0,1,0,1,"dummy"
"89373",0,0,2,2,"dummy"
"89374",2,0,2,4,"dummy"
"89375",0,2,0,2,"dummy"
"89376",2,0,0,2,"dummy"
"89377",0,1,0,1,"dummy"
"89378",0,2,0,2,"dummy"
"89379",0,1,0,1,"dummy"
"89380",0,2,0,2,"dummy"
"89381",3,0,0,3,"dummy"
"89382",0,0,1,1,"dummy"
"89383",3,0,0,3,"dummy"
"89384",0,1,0,1,"dummy"
"89389",0,2,0,2,"dummy"
"89453",0,1,0,1,"dummy"
"89454",0,1,0,1,"dummy"
"89455",18,0,3,21,"dummy"
"89456",0,0,1,1,"dummy"
"89457",0,2,0,2,"dummy"
"89458",2,0,0,2,"dummy"
"89467",0,3,3,6,"dummy"
"89468",0,3,0,3,"dummy"
"89469",1,0,0,1,"dummy"
"89470",0,0,2,2,"dummy"
"89471",0,0,0,0,"dummy"
"89288",2,2,1,5,"dummy"
"89294",0,1,0,1,"dummy"
"89295",7,25,0,32,"dummy"
"89296",41,0,2,43,"dummy"
"89297",1,1,0,2,"dummy"
"89303",3,13,1,17,"dummy"
"89304",11,3,0,14,"dummy"
"89305",0,4,0,4,"dummy"
"89306",4,0,0,4,"dummy"
"89319",0,0,1,1,"dummy"
"89322",1,3,0,4,"dummy"
"89323",1,0,1,2,"dummy"
"89324",1,6,0,7,"dummy"
"89325",5,8,0,13,"dummy"
"89328",0,0,2,2,"dummy"
"89329",0,0,2,2,"dummy"
"89330",0,0,1,1,"dummy"
"89331",0,0,1,1,"dummy"
"89332",0,0,2,2,"dummy"
"89333",0,0,2,2,"dummy"
"89355",0,5,0,5,"dummy"
"89356",0,3,0,3,"dummy"
"89359",0,0,2,2,"dummy"
"89360",1,0,0,1,"dummy"
"89386",2,0,1,3,"dummy"
"89387",0,7,1,8,"dummy"
"89391",0,0,2,2,"dummy"
"89392",0,0,2,2,"dummy"
"89393",2,0,2,4,"dummy"
"89394",0,3,0,3,"dummy"
"89395",1,0,1,2,"dummy"
"89396",0,7,0,7,"dummy"
"89397",2,4,1,7,"dummy"
"89398",0,0,1,1,"dummy"
"89399",0,3,0,3,"dummy"
"89400",0,2,0,2,"dummy"
"89401",0,0,1,1,"dummy"
"89402",0,1,0,1,"dummy"
"89403",1,0,0,1,"dummy"
"89404",0,1,0,1,"dummy"
"89405",3,24,2,29,"dummy"
"89406",0,0,0,0,"dummy"
"89407",1,0,0,1,"dummy"
"89408",0,2,0,2,"dummy"
"89409",0,1,0,1,"dummy"
"89410",2,2,0,4,"dummy"
"89440",0,3,0,3,"dummy"
"89449",7,0,2,9,"dummy"
"89450",8,2,0,10,"dummy"
"89451",0,4,0,4,"dummy"
"89460",0,1,0,1,"dummy"
"89461",12,0,0,12,"dummy"
"89464",0,1,0,1,"dummy"
"89465",1,0,0,1,"dummy"
"89503",0,3,0,3,"dummy"
"89504",0,0,1,1,"dummy"
"89505",0,14,1,15,"dummy"
"89506",1,0,0,1,"dummy"
"89516",1,1,0,2,"dummy"
"89519",1,1,0,2,"dummy"
"89520",3,4,4,11,"dummy"
"89523",0,0,1,1,"dummy"
"89526",0,1,1,2,"dummy"
"89527",1,8,0,9,"dummy"
"89528",0,1,0,1,"dummy"
"89529",0,0,2,2,"dummy"
"89530",0,0,2,2,"dummy"
"89535",2,2,0,4,"dummy"
"89536",2,0,0,2,"dummy"
"89472",0,0,0,0,"dummy"
"89475",3,14,2,19,"dummy"
"89476",0,0,0,0,"dummy"
"89477",0,0,2,2,"dummy"
"89478",0,0,2,2,"dummy"
"89479",0,0,2,2,"dummy"
"89480",0,0,2,2,"dummy"
"89481",0,2,0,2,"dummy"
"89482",0,0,2,2,"dummy"
"89483",0,0,0,0,"dummy"
"89484",5,10,1,16,"dummy"
"89485",7,28,2,37,"dummy"
"89486",0,0,4,4,"dummy"
"89487",11,4,1,16,"dummy"
"89488",4,3,3,10,"dummy"
"89489",0,0,1,1,"dummy"
"89490",1,2,0,3,"dummy"
"89491",0,0,1,1,"dummy"
"89492",0,0,1,1,"dummy"
"89495",0,3,13,16,"dummy"
"89500",1,3,5,9,"dummy"
"89501",0,0,1,1,"dummy"
"89508",0,0,0,0,"dummy"
"89511",0,0,1,1,"dummy"
"89512",0,0,2,2,"dummy"
"89513",0,0,1,1,"dummy"
"89514",0,0,1,1,"dummy"
"89532",0,0,0,0,"dummy"
"89533",0,0,0,0,"dummy"
"89537",5,4,1,10,"dummy"
"89538",1,1,0,2,"dummy"
"89541",1,7,0,8,"dummy"
"89542",0,1,0,1,"dummy"
"89543",0,0,1,1,"dummy"
"89544",0,0,1,1,"dummy"
"89545",10,4,3,17,"dummy"
"89546",0,0,1,1,"dummy"
"89547",0,0,1,1,"dummy"
"89548",0,0,1,1,"dummy"
"89549",0,0,1,1,"dummy"
"89550",0,0,1,1,"dummy"
"89551",0,0,1,1,"dummy"
"89552",0,0,1,1,"dummy"
"89553",0,0,1,1,"dummy"
"89554",0,0,1,1,"dummy"
"89555",0,0,1,1,"dummy"
"89556",0,0,1,1,"dummy"
"89557",0,0,1,1,"dummy"
"89558",0,0,1,1,"dummy"
"89559",0,0,1,1,"dummy"
"89560",0,0,1,1,"dummy"
"89561",0,0,1,1,"dummy"
"89562",0,0,1,1,"dummy"
"89563",0,0,1,1,"dummy"
"89564",0,0,1,1,"dummy"
"89565",0,4,3,7,"dummy"
"89566",0,0,1,1,"dummy"
"89567",0,0,1,1,"dummy"
"89568",0,0,1,1,"dummy"
"89569",0,0,1,1,"dummy"
"89570",0,0,1,1,"dummy"
"89571",0,0,1,1,"dummy"
"89572",0,0,1,1,"dummy"
"89573",0,0,1,1,"dummy"
"89574",0,0,1,1,"dummy"
"89575",0,0,1,1,"dummy"
"89576",0,0,1,1,"dummy"
"89577",0,0,1,1,"dummy"
"89578",0,0,1,1,"dummy"
"89579",0,0,1,1,"dummy"
"89580",0,0,1,1,"dummy"
"89581",0,0,1,1,"dummy"
"89582",0,0,1,1,"dummy"
"89583",0,0,1,1,"dummy"
"89584",0,0,1,1,"dummy"
"89585",0,0,1,1,"dummy"
"89586",0,0,1,1,"dummy"
"89587",0,0,1,1,"dummy"
"89588",0,0,1,1,"dummy"
"89589",0,0,1,1,"dummy"
"89590",0,0,1,1,"dummy"
"89591",0,1,0,1,"dummy"
"89592",0,0,1,1,"dummy"
"89593",0,0,1,1,"dummy"
"89594",0,0,1,1,"dummy"
"89595",0,0,1,1,"dummy"
"89596",0,0,1,1,"dummy"
"89597",0,0,1,1,"dummy"
"89598",0,0,1,1,"dummy"
"89599",0,0,1,1,"dummy"
"89600",0,0,1,1,"dummy"
"89601",0,0,1,1,"dummy"
"89602",0,1,0,1,"dummy"
"89603",0,0,0,0,"dummy"
"89604",0,0,1,1,"dummy"
"89605",0,0,1,1,"dummy"
"89606",0,0,1,1,"dummy"
"89607",0,0,1,1,"dummy"
"89608",0,0,1,1,"dummy"
"89609",0,0,1,1,"dummy"
"89610",0,0,1,1,"dummy"
"89611",0,0,1,1,"dummy"
"89612",0,0,1,1,"dummy"
"89613",0,1,0,1,"dummy"
"89614",0,0,1,1,"dummy"
"89615",0,0,1,1,"dummy"
"89616",0,0,1,1,"dummy"
"89617",0,0,1,1,"dummy"
"89618",0,0,1,1,"dummy"
"89619",0,0,1,1,"dummy"
"89620",1,3,0,4,"dummy"
"89621",2,1,0,3,"dummy"
"89622",0,0,1,1,"dummy"
"89627",0,0,0,0,"dummy"
"89629",0,0,1,1,"dummy"
"89631",0,0,1,1,"dummy"
"89633",2,1,0,3,"dummy"
"89635",0,1,1,2,"dummy"
"89636",1,8,0,9,"dummy"
"89637",0,1,0,1,"dummy"
"89638",0,0,2,2,"dummy"
"89639",0,0,2,2,"dummy"
"89641",1,22,4,27,"dummy"
"89642",0,0,1,1,"dummy"
"89647",0,0,2,2,"dummy"
"89648",1,0,0,1,"dummy"
"89651",0,1,0,1,"dummy"
"89652",0,6,0,6,"dummy"
"89653",0,0,1,1,"dummy"
"89654",0,0,1,1,"dummy"
"89655",0,0,1,1,"dummy"
"89657",0,1,0,1,"dummy"
"89661",0,0,1,1,"dummy"
"89662",0,0,0,0,"dummy"
"89663",0,7,2,9,"dummy"
"89664",0,8,3,11,"dummy"
"89667",0,1,0,1,"dummy"
"89668",0,2,0,2,"dummy"
"89669",0,1,0,1,"dummy"
"89670",0,1,0,1,"dummy"
"89671",0,1,0,1,"dummy"
"89672",0,1,0,1,"dummy"
"89673",0,1,0,1,"dummy"
"89674",0,2,0,2,"dummy"
"89675",0,1,0,1,"dummy"
"89676",0,3,0,3,"dummy"
"89677",0,1,0,1,"dummy"
"89679",9,1,0,10,"dummy"
"89683",0,9,2,11,"dummy"
"89684",1,2,0,3,"dummy"
"89686",2,4,0,6,"dummy"
"89687",0,2,0,2,"dummy"
"89688",0,2,0,2,"dummy"
"89689",10,2,0,12,"dummy"
"89690",0,2,0,2,"dummy"
"89692",2,2,3,7,"dummy"
"89693",0,1,0,1,"dummy"
"89694",0,4,0,4,"dummy"
"89695",0,2,0,2,"dummy"
"89698",2,11,2,15,"dummy"
"89699",1,2,0,3,"dummy"
"89700",2,3,0,5,"dummy"
"89702",0,2,0,2,"dummy"
"89704",0,0,1,1,"dummy"
"89705",0,0,1,1,"dummy"
"89706",0,0,1,1,"dummy"
"89707",0,0,1,1,"dummy"
"89708",0,0,1,1,"dummy"
"89709",0,0,1,1,"dummy"
"89710",0,1,1,2,"dummy"
"89711",0,0,1,1,"dummy"
"89712",0,0,1,1,"dummy"
"89713",0,0,1,1,"dummy"
"89714",0,0,1,1,"dummy"
"89715",0,0,1,1,"dummy"
"89716",0,0,1,1,"dummy"
"89717",0,0,1,1,"dummy"
"89718",0,0,1,1,"dummy"
"89719",0,0,1,1,"dummy"
"89720",0,0,1,1,"dummy"
"89721",0,0,1,1,"dummy"
"89722",0,0,1,1,"dummy"
"89724",6,2,1,9,"dummy"
"89725",34,0,1,35,"dummy"
"89726",0,0,1,1,"dummy"
"89750",1,0,0,1,"dummy"
"89752",0,2,2,4,"dummy"
"89753",1,0,0,1,"dummy"
"89755",0,3,0,3,"dummy"
"89756",6,2,0,8,"dummy"
"89758",1,1,0,2,"dummy"
"89760",1,2,0,3,"dummy"
"89761",1,1,0,2,"dummy"
"89766",1,0,0,1,"dummy"
"89768",9,0,3,12,"dummy"
"89770",7,3,1,11,"dummy"
"89771",2,0,0,2,"dummy"
"89772",0,1,0,1,"dummy"
"89773",0,1,0,1,"dummy"
"89775",0,0,1,1,"dummy"
"89786",0,1,1,2,"dummy"
"89788",3,0,0,3,"dummy"
"89789",0,1,0,1,"dummy"
"89791",1,0,0,1,"dummy"
"89802",0,0,2,2,"dummy"
"89803",0,0,1,1,"dummy"
"89804",1,1,0,2,"dummy"
"89805",0,3,0,3,"dummy"
"89806",0,3,2,5,"dummy"
"89807",0,0,1,1,"dummy"
"89808",0,0,1,1,"dummy"
"89809",1,1,4,6,"dummy"
"89810",2,3,0,5,"dummy"
"89811",3,3,3,9,"dummy"
"89812",0,2,0,2,"dummy"
"89813",1,0,1,2,"dummy"
"89814",0,41,0,41,"dummy"
"89815",4,4,4,12,"dummy"
"89816",1,1,0,2,"dummy"
"89817",0,1,0,1,"dummy"
"89818",3,2,0,5,"dummy"
"89819",0,1,0,1,"dummy"
"89820",48,1,2,51,"dummy"
"89821",0,1,0,1,"dummy"
"89823",0,0,2,2,"dummy"
"89824",1,14,3,18,"dummy"
"89825",0,1,7,8,"dummy"
"89826",0,0,2,2,"dummy"
"89827",0,1,0,1,"dummy"
"89828",6,2,2,10,"dummy"
"89829",2,8,0,10,"dummy"
"89849",0,2,0,2,"dummy"
"89850",2,3,1,6,"dummy"
"89851",3,2,1,6,"dummy"
"89852",0,2,1,3,"dummy"
"89853",2,0,0,2,"dummy"
"89854",0,1,0,1,"dummy"
"89855",1,1,0,2,"dummy"
"89856",3,0,1,4,"dummy"
"89857",0,3,1,4,"dummy"
"89859",0,0,1,1,"dummy"
"89860",3,1,1,5,"dummy"
"89861",1,5,1,7,"dummy"
"89866",0,1,0,1,"dummy"
"89867",0,2,0,2,"dummy"
"89868",0,1,0,1,"dummy"
"89869",0,0,0,0,"dummy"
"89870",1,4,0,5,"dummy"
"89873",0,1,1,2,"dummy"
"89874",0,0,1,1,"dummy"
"89875",1,1,0,2,"dummy"
"89876",0,1,0,1,"dummy"
"89877",1,2,1,4,"dummy"
"89878",0,2,1,3,"dummy"
"89879",2,4,0,6,"dummy"
"89880",2,3,2,7,"dummy"
"89881",4,1,0,5,"dummy"
"89882",1,0,0,1,"dummy"
"89883",4,0,2,6,"dummy"
"89884",1,2,0,3,"dummy"
"89885",4,2,2,8,"dummy"
"89886",1,0,0,1,"dummy"
"89887",0,0,1,1,"dummy"
"89888",0,1,0,1,"dummy"
"89890",0,1,0,1,"dummy"
"89892",0,1,0,1,"dummy"
"89897",0,0,1,1,"dummy"
"89898",1,1,0,2,"dummy"
"89899",1,0,0,1,"dummy"
"89906",0,0,0,0,"dummy"
"89907",0,0,0,0,"dummy"
"89909",0,1,0,1,"dummy"
"89911",0,9,1,10,"dummy"
"89914",1,0,0,1,"dummy"
"89915",0,3,0,3,"dummy"
"89916",0,9,0,9,"dummy"
"89917",0,1,0,1,"dummy"
"89918",0,0,1,1,"dummy"
"89919",0,0,1,1,"dummy"
"89920",0,1,0,1,"dummy"
"89921",0,3,0,3,"dummy"
"89922",0,2,0,2,"dummy"
"89923",1,0,0,1,"dummy"
"89924",0,0,0,0,"dummy"
"89925",0,0,3,3,"dummy"
"89926",0,1,0,1,"dummy"
"89927",0,1,0,1,"dummy"
"89928",0,0,2,2,"dummy"
"89929",7,1,0,8,"dummy"
"89930",1,0,0,1,"dummy"
"89931",1,7,0,8,"dummy"
"89932",0,1,0,1,"dummy"
"89933",0,1,0,1,"dummy"
"89934",0,1,2,3,"dummy"
"89935",0,0,1,1,"dummy"
"89938",2,0,0,2,"dummy"
"89939",1,0,0,1,"dummy"
"89940",0,1,0,1,"dummy"
"89942",2,2,0,4,"dummy"
"89943",3,1,0,4,"dummy"
"89944",3,6,0,9,"dummy"
"89945",1,2,0,3,"dummy"
"89948",1,2,2,5,"dummy"
"89950",0,2,1,3,"dummy"
"89952",0,2,0,2,"dummy"
"89953",2,0,1,3,"dummy"
"89954",0,2,0,2,"dummy"
"89955",0,0,1,1,"dummy"
"89956",0,0,3,3,"dummy"
"89957",0,0,1,1,"dummy"
"89958",0,0,1,1,"dummy"
"89959",0,0,3,3,"dummy"
"89960",2,1,0,3,"dummy"
"89961",5,3,0,8,"dummy"
"89962",0,1,0,1,"dummy"
"89963",0,0,1,1,"dummy"
"89967",0,2,0,2,"dummy"
"89968",0,0,0,0,"dummy"
"89969",0,0,1,1,"dummy"
"89970",0,0,0,0,"dummy"
"89971",0,2,0,2,"dummy"
"89972",0,0,1,1,"dummy"
"89973",0,0,1,1,"dummy"
"89974",0,0,1,1,"dummy"
"89975",0,0,0,0,"dummy"
"89976",0,0,1,1,"dummy"
"89977",0,0,1,1,"dummy"
"89978",0,0,1,1,"dummy"
"89979",0,0,0,0,"dummy"
"89980",1,10,0,11,"dummy"
"89981",0,0,1,1,"dummy"
"89982",9,1,0,10,"dummy"
"89983",0,0,1,1,"dummy"
"89984",0,0,1,1,"dummy"
"89985",0,0,1,1,"dummy"
"89986",0,0,0,0,"dummy"
"89987",0,0,0,0,"dummy"
"89988",0,0,1,1,"dummy"
"89989",0,0,0,0,"dummy"
"89990",0,0,0,0,"dummy"
"89991",0,0,0,0,"dummy"
"89992",0,0,0,0,"dummy"
"89993",0,0,0,0,"dummy"
"89994",1,0,0,1,"dummy"
"89995",0,1,0,1,"dummy"
"89996",0,0,0,0,"dummy"
"89997",7,11,1,19,"dummy"
"89998",0,0,1,1,"dummy"
"89999",0,0,1,1,"dummy"
"90002",0,3,1,4,"dummy"
"90003",2,0,2,4,"dummy"
"90004",0,5,0,5,"dummy"
"90005",5,4,0,9,"dummy"
"90006",5,1,0,6,"dummy"
"90007",3,3,0,6,"dummy"
"90008",0,0,1,1,"dummy"
"90009",0,1,0,1,"dummy"
"90010",1,0,1,2,"dummy"
"90011",0,1,1,2,"dummy"
"90012",1,0,0,1,"dummy"
"90013",0,0,1,1,"dummy"
"90014",4,3,1,8,"dummy"
"90015",0,1,0,1,"dummy"
"90016",2,1,2,5,"dummy"
"90017",16,20,4,40,"dummy"
"90018",0,0,1,1,"dummy"
"90019",1,3,1,5,"dummy"
"90020",3,1,1,5,"dummy"
"90021",0,2,0,2,"dummy"
"90022",1,0,0,1,"dummy"
"90023",0,0,0,0,"dummy"
"90024",0,1,0,1,"dummy"
"90025",1,1,0,2,"dummy"
"90026",0,0,1,1,"dummy"
"90027",0,0,1,1,"dummy"
"90028",0,6,0,6,"dummy"
"90029",0,0,0,0,"dummy"
"90030",0,1,0,1,"dummy"
"90031",1,1,0,2,"dummy"
"90041",1,6,0,7,"dummy"
"90042",1,0,0,1,"dummy"
"90046",0,1,0,1,"dummy"
"90051",0,0,0,0,"dummy"
"90053",6,2,2,10,"dummy"
"90056",0,1,0,1,"dummy"
"90057",15,4,6,25,"dummy"
"90058",0,0,1,1,"dummy"
"90059",6,2,0,8,"dummy"
"90060",4,0,0,4,"dummy"
"90061",0,0,0,0,"dummy"
"90062",0,0,2,2,"dummy"
"90063",0,0,1,1,"dummy"
"90064",0,4,0,4,"dummy"
"90073",1,0,0,1,"dummy"
"90074",1,1,1,3,"dummy"
"90075",0,0,1,1,"dummy"
"90079",0,2,0,2,"dummy"
"90080",3,2,0,5,"dummy"
"90081",1,0,0,1,"dummy"
"90082",0,8,0,8,"dummy"
"90083",1,4,1,6,"dummy"
"90084",0,1,0,1,"dummy"
"90085",0,1,1,2,"dummy"
"90086",0,4,0,4,"dummy"
"90087",0,1,0,1,"dummy"
"90088",1,4,0,5,"dummy"
"90089",0,0,1,1,"dummy"
"90090",0,4,0,4,"dummy"
"90092",0,8,1,9,"dummy"
"90093",0,1,0,1,"dummy"
"90099",0,0,2,2,"dummy"
"90101",2,12,1,15,"dummy"
"90102",0,2,0,2,"dummy"
"90103",0,0,1,1,"dummy"
"90111",0,0,0,0,"dummy"
"90112",0,0,0,0,"dummy"
"90115",1,0,0,1,"dummy"
"90136",0,1,0,1,"dummy"
"90137",1,0,0,1,"dummy"
"90139",0,8,0,8,"dummy"
"90140",7,1,1,9,"dummy"
"90141",0,0,1,1,"dummy"
"90142",0,0,0,0,"dummy"
"90143",0,2,0,2,"dummy"
"90144",0,1,0,1,"dummy"
"90145",0,0,1,1,"dummy"
"90146",0,0,1,1,"dummy"
"90150",0,0,3,3,"dummy"
"90151",0,0,1,1,"dummy"
"90154",1,4,1,6,"dummy"
"90156",8,5,3,16,"dummy"
"90157",0,0,1,1,"dummy"
"90158",4,9,1,14,"dummy"
"90159",6,0,2,8,"dummy"
"90160",0,5,2,7,"dummy"
"90161",0,0,0,0,"dummy"
"90162",0,2,0,2,"dummy"
"90163",0,0,1,1,"dummy"
"90164",0,0,1,1,"dummy"
"90165",2,1,0,3,"dummy"
"90168",0,1,0,1,"dummy"
"90169",0,1,0,1,"dummy"
"90170",2,1,0,3,"dummy"
"90193",0,1,0,1,"dummy"
"90194",0,1,0,1,"dummy"
"90195",0,2,0,2,"dummy"
"90196",0,2,0,2,"dummy"
"90197",0,0,1,1,"dummy"
"90198",0,0,1,1,"dummy"
"90199",2,4,1,7,"dummy"
"90201",0,1,0,1,"dummy"
"90210",0,0,0,0,"dummy"
"90213",1,0,0,1,"dummy"
"90214",3,0,0,3,"dummy"
"90215",0,0,1,1,"dummy"
"90216",0,0,1,1,"dummy"
"90217",0,1,0,1,"dummy"
"90218",0,1,0,1,"dummy"
"90219",0,0,1,1,"dummy"
"90220",1,3,0,4,"dummy"
"90221",0,1,0,1,"dummy"
"90224",5,0,0,5,"dummy"
"90225",0,0,1,1,"dummy"
"90226",0,1,0,1,"dummy"
"90227",1,0,0,1,"dummy"
"90229",9,5,2,16,"dummy"
"90230",0,0,1,1,"dummy"
"90237",2,0,1,3,"dummy"
"90238",0,6,0,6,"dummy"
"90242",0,1,0,1,"dummy"
"90243",0,0,1,1,"dummy"
"90250",0,0,1,1,"dummy"
"90252",0,0,1,1,"dummy"
"90253",0,4,0,4,"dummy"
"90254",1,0,1,2,"dummy"
"90255",0,7,0,7,"dummy"
"90256",2,0,4,6,"dummy"
"90257",0,1,0,1,"dummy"
"90258",0,1,0,1,"dummy"
"90259",1,10,0,11,"dummy"
"90260",0,4,0,4,"dummy"
"90261",0,7,0,7,"dummy"
"90262",7,3,0,10,"dummy"
"90265",1,14,2,17,"dummy"
"90267",0,3,0,3,"dummy"
"90268",0,1,0,1,"dummy"
"90270",0,1,0,1,"dummy"
"90271",0,0,1,1,"dummy"
"90272",7,1,1,9,"dummy"
"90273",0,0,0,0,"dummy"
"90274",0,0,1,1,"dummy"
"90275",0,0,1,1,"dummy"
"90276",0,0,1,1,"dummy"
"90277",0,0,1,1,"dummy"
"90278",0,0,1,1,"dummy"
"90279",0,0,1,1,"dummy"
"90280",0,0,1,1,"dummy"
"90281",0,0,1,1,"dummy"
"90282",0,0,1,1,"dummy"
"90283",0,0,1,1,"dummy"
"90284",0,0,1,1,"dummy"
"90285",0,0,1,1,"dummy"
"90286",0,0,2,2,"dummy"
"90287",0,0,1,1,"dummy"
"90297",0,1,0,1,"dummy"
"90298",1,2,0,3,"dummy"
"90300",1,2,3,6,"dummy"
"90302",0,0,1,1,"dummy"
"90304",0,0,0,0,"dummy"
"90305",0,2,0,2,"dummy"
"90306",5,0,0,5,"dummy"
"90309",5,2,4,11,"dummy"
"90312",0,0,1,1,"dummy"
"90313",1,0,0,1,"dummy"
"90314",0,0,1,1,"dummy"
"90315",0,0,1,1,"dummy"
"90316",0,0,1,1,"dummy"
"90317",0,3,0,3,"dummy"
"90318",0,3,0,3,"dummy"
"90319",0,0,1,1,"dummy"
"90320",0,0,1,1,"dummy"
"90323",1,0,0,1,"dummy"
"90324",0,0,1,1,"dummy"
"90326",1,0,1,2,"dummy"
"90327",1,0,0,1,"dummy"
"90328",0,0,1,1,"dummy"
"90329",0,0,1,1,"dummy"
"90330",0,0,2,2,"dummy"
"90333",5,4,2,11,"dummy"
"90335",0,0,3,3,"dummy"
"90340",0,0,1,1,"dummy"
"90341",3,3,0,6,"dummy"
"90342",0,0,1,1,"dummy"
"90343",0,0,1,1,"dummy"
"90344",0,0,1,1,"dummy"
"90345",3,0,0,3,"dummy"
"90346",0,0,1,1,"dummy"
"90347",0,0,0,0,"dummy"
"90348",0,0,1,1,"dummy"
"90349",0,0,1,1,"dummy"
"90350",0,0,1,1,"dummy"
"90351",0,0,1,1,"dummy"
"90352",0,0,0,0,"dummy"
"90353",0,0,1,1,"dummy"
"90354",0,0,1,1,"dummy"
"90355",0,1,0,1,"dummy"
"90356",2,2,5,9,"dummy"
"90357",0,7,1,8,"dummy"
"90358",0,0,1,1,"dummy"
"90359",0,0,1,1,"dummy"
"90360",0,0,1,1,"dummy"
"90361",0,0,1,1,"dummy"
"90362",0,0,1,1,"dummy"
"90363",0,2,1,3,"dummy"
"90364",0,0,1,1,"dummy"
"90365",0,0,1,1,"dummy"
"90366",0,0,1,1,"dummy"
"90367",0,0,1,1,"dummy"
"90368",0,0,1,1,"dummy"
"90369",0,0,1,1,"dummy"
"90370",0,0,1,1,"dummy"
"90371",0,1,3,4,"dummy"
"90372",0,0,1,1,"dummy"
"90373",0,0,1,1,"dummy"
"90374",0,0,1,1,"dummy"
"90375",0,0,1,1,"dummy"
"90376",0,0,2,2,"dummy"
"90377",0,0,1,1,"dummy"
"90378",0,0,1,1,"dummy"
"90379",0,0,1,1,"dummy"
"90380",0,0,1,1,"dummy"
"90381",0,0,1,1,"dummy"
"90382",0,1,0,1,"dummy"
"90383",0,0,0,0,"dummy"
"90384",0,0,1,1,"dummy"
"90385",0,0,1,1,"dummy"
"90386",0,0,1,1,"dummy"
"90387",0,0,1,1,"dummy"
"90388",0,0,1,1,"dummy"
"90389",0,0,1,1,"dummy"
"90390",1,4,0,5,"dummy"
"90391",2,2,0,4,"dummy"
"90392",0,1,0,1,"dummy"
"90393",0,0,1,1,"dummy"
"90394",2,8,0,10,"dummy"
"90396",0,0,0,0,"dummy"
"90398",1,0,0,1,"dummy"
"90399",1,2,1,4,"dummy"
"90400",1,0,0,1,"dummy"
"90401",3,0,1,4,"dummy"
"90402",3,3,1,7,"dummy"
"90406",0,1,0,1,"dummy"
"90408",1,2,0,3,"dummy"
"90410",0,0,1,1,"dummy"
"90411",0,0,1,1,"dummy"
"90415",0,0,1,1,"dummy"
"90417",0,0,1,1,"dummy"
"90418",0,0,1,1,"dummy"
"90419",0,1,0,1,"dummy"
"90423",1,0,0,1,"dummy"
"90424",2,16,0,18,"dummy"
"90426",0,0,0,0,"dummy"
"90427",0,4,0,4,"dummy"
"90428",0,0,2,2,"dummy"
"90429",2,0,0,2,"dummy"
"90430",0,0,0,0,"dummy"
"90431",0,22,0,22,"dummy"
"90433",2,4,4,10,"dummy"
"90436",0,0,2,2,"dummy"
"90437",0,0,2,2,"dummy"
"90441",0,0,2,2,"dummy"
"90442",0,0,0,0,"dummy"
"90444",0,2,0,2,"dummy"
"90445",0,0,0,0,"dummy"
"90446",0,0,1,1,"dummy"
"90447",0,0,5,5,"dummy"
"90448",0,0,1,1,"dummy"
"90449",7,2,0,9,"dummy"
"90450",0,2,0,2,"dummy"
"90451",0,0,3,3,"dummy"
"90452",0,0,3,3,"dummy"
"90457",0,0,1,1,"dummy"
"90458",0,1,0,1,"dummy"
"90459",0,1,0,1,"dummy"
"90460",1,1,0,2,"dummy"
"90461",0,4,0,4,"dummy"
"90462",4,0,0,4,"dummy"
"90463",1,1,1,3,"dummy"
"90464",0,1,0,1,"dummy"
"90465",0,0,0,0,"dummy"
"90466",1,9,3,13,"dummy"
"90468",0,0,0,0,"dummy"
"90469",2,2,1,5,"dummy"
"90470",4,3,3,10,"dummy"
"90475",1,2,0,3,"dummy"
"90476",0,7,4,11,"dummy"
"90477",0,2,0,2,"dummy"
"90479",0,2,1,3,"dummy"
"90480",0,0,1,1,"dummy"
"90486",0,0,0,0,"dummy"
"90487",1,1,0,2,"dummy"
"90490",0,0,1,1,"dummy"
"90491",4,1,0,5,"dummy"
"90492",16,23,2,41,"dummy"
"90493",0,0,2,2,"dummy"
"90529",0,1,0,1,"dummy"
"90530",0,0,0,0,"dummy"
"90531",0,1,1,2,"dummy"
"90532",0,1,0,1,"dummy"
"90533",18,3,1,22,"dummy"
"90534",0,0,0,0,"dummy"
"90536",1,0,0,1,"dummy"
"90538",0,1,0,1,"dummy"
"90555",0,0,1,1,"dummy"
"90558",0,0,1,1,"dummy"
"90560",0,0,1,1,"dummy"
"90561",0,0,1,1,"dummy"
"90562",0,0,1,1,"dummy"
"90565",0,0,0,0,"dummy"
"90566",0,2,1,3,"dummy"
"90567",0,0,1,1,"dummy"
"90568",0,1,0,1,"dummy"
"90569",1,0,0,1,"dummy"
"90573",0,0,1,1,"dummy"
"90575",1,4,1,6,"dummy"
"90576",0,3,1,4,"dummy"
"90577",0,0,1,1,"dummy"
"90578",4,10,3,17,"dummy"
"90579",0,1,1,2,"dummy"
"90580",0,1,0,1,"dummy"
"90581",1,0,0,1,"dummy"
"90585",6,0,0,6,"dummy"
"90586",2,5,2,9,"dummy"
"90588",0,0,1,1,"dummy"
"90591",1,1,5,7,"dummy"
"90592",0,10,0,10,"dummy"
"90593",0,7,0,7,"dummy"
"90594",1,4,3,8,"dummy"
"90595",1,1,4,6,"dummy"
"90596",4,4,3,11,"dummy"
"90597",1,1,4,6,"dummy"
"90598",3,0,0,3,"dummy"
"90599",4,4,3,11,"dummy"
"90600",1,1,4,6,"dummy"
"90601",1,1,4,6,"dummy"
"90602",1,1,4,6,"dummy"
"90603",0,0,0,0,"dummy"
"90604",1,1,4,6,"dummy"
"90605",4,4,3,11,"dummy"
"90606",1,0,0,1,"dummy"
"90607",0,1,0,1,"dummy"
"90609",3,0,1,4,"dummy"
"90612",0,1,0,1,"dummy"
"90613",1,1,0,2,"dummy"
"90614",0,1,0,1,"dummy"
"90615",1,2,0,3,"dummy"
"90616",0,1,1,2,"dummy"
"90617",0,0,1,1,"dummy"
"90618",2,1,1,4,"dummy"
"90619",0,1,0,1,"dummy"
"90620",0,0,1,1,"dummy"
"90621",2,15,0,17,"dummy"
"90622",0,0,1,1,"dummy"
"90623",2,3,1,6,"dummy"
"90624",0,1,0,1,"dummy"
"90626",0,1,0,1,"dummy"
"90627",0,1,0,1,"dummy"
"90628",3,0,0,3,"dummy"
"90629",0,0,1,1,"dummy"
"90632",1,1,0,2,"dummy"
"90633",0,0,1,1,"dummy"
"90634",1,0,0,1,"dummy"
"90635",0,0,2,2,"dummy"
"90636",0,0,1,1,"dummy"
"90637",0,2,1,3,"dummy"
"90639",1,0,0,1,"dummy"
"90641",0,15,0,15,"dummy"
"90642",5,12,4,21,"dummy"
"90646",0,0,1,1,"dummy"
"90647",1,0,0,1,"dummy"
"90648",1,1,0,2,"dummy"
"90649",0,1,0,1,"dummy"
"90652",0,0,2,2,"dummy"
"90653",0,0,0,0,"dummy"
"90654",0,1,0,1,"dummy"
"90655",0,0,1,1,"dummy"
"90667",0,0,0,0,"dummy"
"90670",0,0,2,2,"dummy"
"90672",0,0,1,1,"dummy"
"90675",1,0,0,1,"dummy"
"90676",0,1,0,1,"dummy"
"90677",16,7,2,25,"dummy"
"90679",0,0,0,0,"dummy"
"90680",7,1,3,11,"dummy"
"90681",0,0,0,0,"dummy"
"90683",0,1,0,1,"dummy"
"90686",0,12,0,12,"dummy"
"90687",0,1,0,1,"dummy"
"90688",0,2,0,2,"dummy"
"90689",0,0,1,1,"dummy"
"90694",1,9,3,13,"dummy"
"90715",0,16,0,16,"dummy"
"90717",0,2,0,2,"dummy"
"90718",0,1,2,3,"dummy"
"90719",0,8,1,9,"dummy"
"90720",0,2,0,2,"dummy"
"90721",2,0,0,2,"dummy"
"90722",0,2,0,2,"dummy"
"90723",0,2,0,2,"dummy"
"90724",0,1,0,1,"dummy"
"90725",1,0,0,1,"dummy"
"90726",12,4,1,17,"dummy"
"90727",0,0,4,4,"dummy"
"90728",2,8,2,12,"dummy"
"90729",1,0,0,1,"dummy"
"90730",0,0,0,0,"dummy"
"90731",1,1,0,2,"dummy"
"90732",1,0,0,1,"dummy"
"90733",0,0,4,4,"dummy"
"90734",0,0,4,4,"dummy"
"90735",0,0,4,4,"dummy"
"90736",0,0,4,4,"dummy"
"90737",0,2,0,2,"dummy"
"90738",0,0,4,4,"dummy"
"90739",0,0,1,1,"dummy"
"90740",0,1,5,6,"dummy"
"90741",0,0,1,1,"dummy"
"90742",0,0,1,1,"dummy"
"90743",0,0,2,2,"dummy"
"90744",0,0,1,1,"dummy"
"90745",0,0,2,2,"dummy"
"90746",0,0,1,1,"dummy"
"90747",0,0,1,1,"dummy"
"90748",0,0,1,1,"dummy"
"90749",0,0,1,1,"dummy"
"90751",0,2,0,2,"dummy"
"90753",0,4,0,4,"dummy"
"90754",0,10,0,10,"dummy"
"90755",0,0,1,1,"dummy"
"90756",5,9,0,14,"dummy"
"90757",2,3,0,5,"dummy"
"90758",1,0,0,1,"dummy"
"90759",0,0,0,0,"dummy"
"90760",0,1,0,1,"dummy"
"90761",0,0,1,1,"dummy"
"90762",0,0,1,1,"dummy"
"90764",2,1,2,5,"dummy"
"90765",1,2,2,5,"dummy"
"90767",0,0,0,0,"dummy"
"90768",0,2,0,2,"dummy"
"90769",0,0,1,1,"dummy"
"90770",0,0,1,1,"dummy"
"90771",0,0,1,1,"dummy"
"90772",0,0,1,1,"dummy"
"90774",0,0,0,0,"dummy"
"90775",0,0,0,0,"dummy"
"90783",0,2,0,2,"dummy"
"90784",0,3,0,3,"dummy"
"90785",0,1,1,2,"dummy"
"90786",0,13,2,15,"dummy"
"90787",0,0,0,0,"dummy"
"90788",6,12,0,18,"dummy"
"90789",4,5,2,11,"dummy"
"90790",3,4,0,7,"dummy"
"90791",0,2,0,2,"dummy"
"90792",0,0,1,1,"dummy"
"90797",0,3,0,3,"dummy"
"90799",0,1,0,1,"dummy"
"90800",0,1,0,1,"dummy"
"90801",2,12,0,14,"dummy"
"90803",11,14,3,28,"dummy"
"90817",1,0,0,1,"dummy"
"90818",0,0,1,1,"dummy"
"90819",3,1,0,4,"dummy"
"90820",0,1,0,1,"dummy"
"90822",0,2,0,2,"dummy"
"90823",0,4,0,4,"dummy"
"90824",0,1,0,1,"dummy"
"90825",0,0,1,1,"dummy"
"90826",0,2,0,2,"dummy"
"90827",1,1,0,2,"dummy"
"90828",0,2,0,2,"dummy"
"90831",2,2,2,6,"dummy"
"90833",0,1,0,1,"dummy"
"90834",7,17,2,26,"dummy"
"90835",0,1,1,2,"dummy"
"90836",0,3,0,3,"dummy"
"90837",0,1,0,1,"dummy"
"90838",1,1,3,5,"dummy"
"90839",0,0,2,2,"dummy"
"90840",0,0,1,1,"dummy"
"90841",2,0,0,2,"dummy"
"90842",0,0,1,1,"dummy"
"90843",1,1,2,4,"dummy"
"90844",0,1,0,1,"dummy"
"90845",0,0,1,1,"dummy"
"90846",0,3,0,3,"dummy"
"90847",4,4,0,8,"dummy"
"90849",0,1,0,1,"dummy"
"90850",1,1,1,3,"dummy"
"90853",0,2,0,2,"dummy"
"90854",2,0,1,3,"dummy"
"90855",0,2,0,2,"dummy"
"90857",2,6,0,8,"dummy"
"90858",6,2,0,8,"dummy"
"90859",2,6,0,8,"dummy"
"90861",0,0,0,0,"dummy"
"90864",0,4,0,4,"dummy"
"90867",0,0,1,1,"dummy"
"90872",3,7,1,11,"dummy"
"90873",0,0,5,5,"dummy"
"90874",0,0,1,1,"dummy"
"90875",0,0,1,1,"dummy"
"90876",0,1,0,1,"dummy"
"90877",1,0,0,1,"dummy"
"90878",0,1,0,1,"dummy"
"90879",0,0,0,0,"dummy"
"90880",0,0,0,0,"dummy"
"90881",9,9,1,19,"dummy"
"90882",0,6,0,6,"dummy"
"90883",0,2,0,2,"dummy"
"90884",0,1,0,1,"dummy"
"90885",0,1,0,1,"dummy"
"90886",1,0,0,1,"dummy"
"90887",1,0,0,1,"dummy"
"90888",2,0,0,2,"dummy"
"90889",3,0,0,3,"dummy"
"90890",0,0,0,0,"dummy"
"90891",0,0,0,0,"dummy"
"90892",0,0,0,0,"dummy"
"90893",0,0,0,0,"dummy"
"90906",0,1,0,1,"dummy"
"90910",0,0,0,0,"dummy"
"90920",0,0,1,1,"dummy"
"90921",0,2,0,2,"dummy"
"90955",0,1,0,1,"dummy"
"91127",1,2,0,3,"dummy"
"91128",0,1,0,1,"dummy"
"91131",0,0,1,1,"dummy"
"91140",0,1,0,1,"dummy"
"91147",1,1,1,3,"dummy"
"91148",0,1,0,1,"dummy"
"90895",0,1,0,1,"dummy"
"90898",0,1,0,1,"dummy"
"90899",1,4,0,5,"dummy"
"90900",0,4,0,4,"dummy"
"90901",0,1,0,1,"dummy"
"90902",3,4,0,7,"dummy"
"90903",0,0,1,1,"dummy"
"90904",2,10,1,13,"dummy"
"90908",0,2,1,3,"dummy"
"90912",0,9,0,9,"dummy"
"90913",0,16,0,16,"dummy"
"90914",0,2,1,3,"dummy"
"90915",2,2,0,4,"dummy"
"90916",14,3,5,22,"dummy"
"90917",0,0,1,1,"dummy"
"90918",0,0,1,1,"dummy"
"90925",0,1,0,1,"dummy"
"90926",2,4,1,7,"dummy"
"90927",0,1,0,1,"dummy"
"90928",0,1,0,1,"dummy"
"90929",0,2,0,2,"dummy"
"90930",0,0,1,1,"dummy"
"90931",1,6,1,8,"dummy"
"90932",0,2,0,2,"dummy"
"90933",0,1,0,1,"dummy"
"90934",0,2,0,2,"dummy"
"90935",0,0,1,1,"dummy"
"90936",0,2,1,3,"dummy"
"90937",0,1,0,1,"dummy"
"90938",0,1,0,1,"dummy"
"90939",0,0,0,0,"dummy"
"90940",0,1,0,1,"dummy"
"90943",0,1,0,1,"dummy"
"90944",0,1,0,1,"dummy"
"90945",0,1,2,3,"dummy"
"90946",0,1,0,1,"dummy"
"90947",0,0,3,3,"dummy"
"90948",1,0,2,3,"dummy"
"90949",0,1,1,2,"dummy"
"90950",0,0,2,2,"dummy"
"90951",2,1,1,4,"dummy"
"90952",0,1,0,1,"dummy"
"90953",1,0,0,1,"dummy"
"90957",0,0,0,0,"dummy"
"90958",0,2,0,2,"dummy"
"90959",1,0,3,4,"dummy"
"90960",0,1,0,1,"dummy"
"90961",0,1,0,1,"dummy"
"90962",0,1,0,1,"dummy"
"90963",12,3,0,15,"dummy"
"90964",0,2,0,2,"dummy"
"90965",0,3,0,3,"dummy"
"90966",4,1,0,5,"dummy"
"90967",1,3,0,4,"dummy"
"91133",0,0,1,1,"dummy"
"91136",0,1,1,2,"dummy"
"91137",0,0,0,0,"dummy"
"91138",1,2,0,3,"dummy"
"91142",0,0,1,1,"dummy"
"91145",0,0,1,1,"dummy"
"91150",0,11,0,11,"dummy"
"91151",3,4,1,8,"dummy"
"91152",0,1,1,2,"dummy"
"91153",0,1,0,1,"dummy"
"91154",5,1,8,14,"dummy"
"91155",2,7,0,9,"dummy"
"91156",0,0,1,1,"dummy"
"91157",0,2,0,2,"dummy"
"91158",0,5,0,5,"dummy"
"91160",0,0,1,1,"dummy"
"91184",0,1,1,2,"dummy"
"91185",0,0,1,1,"dummy"
"91187",0,10,0,10,"dummy"
"91188",0,0,2,2,"dummy"
"91190",0,0,1,1,"dummy"
"91191",0,1,0,1,"dummy"
"91193",0,1,0,1,"dummy"
"91194",0,1,0,1,"dummy"
"91196",1,2,0,3,"dummy"
"91197",1,1,0,2,"dummy"
"91198",0,1,0,1,"dummy"
"91199",0,1,0,1,"dummy"
"91201",0,0,0,0,"dummy"
"91202",0,2,0,2,"dummy"
"91203",1,0,3,4,"dummy"
"91204",0,1,0,1,"dummy"
"91205",0,1,0,1,"dummy"
"91206",0,1,0,1,"dummy"
"91207",12,3,0,15,"dummy"
"91208",0,2,0,2,"dummy"
"91209",0,3,0,3,"dummy"
"91210",4,1,0,5,"dummy"
"91211",1,3,0,4,"dummy"
"91213",0,1,0,1,"dummy"
"91214",0,2,0,2,"dummy"
"91215",0,1,0,1,"dummy"
"91216",0,0,0,0,"dummy"
"91217",0,0,0,0,"dummy"
"91218",0,0,0,0,"dummy"
"91219",0,0,0,0,"dummy"
"91220",1,1,1,3,"dummy"
"91221",0,0,0,0,"dummy"
"91222",7,0,4,11,"dummy"
"91223",0,0,0,0,"dummy"
"91224",1,0,0,1,"dummy"
"91225",0,0,0,0,"dummy"
"91226",0,0,1,1,"dummy"
"91227",0,0,1,1,"dummy"
"91228",5,6,2,13,"dummy"
"91229",2,2,0,4,"dummy"
"91230",2,2,0,4,"dummy"
"91231",0,0,0,0,"dummy"
"91232",0,0,1,1,"dummy"
"91233",0,1,0,1,"dummy"
"91234",0,0,0,0,"dummy"
"91235",0,0,1,1,"dummy"
"91236",0,0,0,0,"dummy"
"91237",0,1,0,1,"dummy"
"91238",0,0,1,1,"dummy"
"91239",1,7,0,8,"dummy"
"91240",0,0,0,0,"dummy"
"91241",0,0,0,0,"dummy"
"91242",0,2,0,2,"dummy"
"91243",0,2,0,2,"dummy"
"91244",0,3,1,4,"dummy"
"91245",0,1,0,1,"dummy"
"91246",0,0,0,0,"dummy"
"91247",0,1,0,1,"dummy"
"91248",0,0,1,1,"dummy"
"91249",0,0,0,0,"dummy"
"91250",0,0,1,1,"dummy"
"91251",0,1,0,1,"dummy"
"91252",0,3,0,3,"dummy"
"91253",0,1,0,1,"dummy"
"91254",0,0,0,0,"dummy"
"91255",0,0,0,0,"dummy"
"91256",0,0,0,0,"dummy"
"91257",0,0,1,1,"dummy"
"91258",1,0,0,1,"dummy"
"91259",3,0,0,3,"dummy"
"91260",0,0,1,1,"dummy"
"91261",1,2,0,3,"dummy"
"91262",0,0,0,0,"dummy"
"91263",0,0,1,1,"dummy"
"91264",0,0,1,1,"dummy"
"91265",0,0,0,0,"dummy"
"91266",0,0,1,1,"dummy"
"91267",0,0,1,1,"dummy"
"91268",0,3,0,3,"dummy"
"91269",0,0,1,1,"dummy"
"91270",0,0,1,1,"dummy"
"91271",0,0,1,1,"dummy"
"91272",0,0,0,0,"dummy"
"91273",0,0,0,0,"dummy"
"91274",0,5,0,5,"dummy"
"91275",0,0,1,1,"dummy"
"91276",5,0,0,5,"dummy"
"91277",0,0,1,1,"dummy"
"91278",0,0,1,1,"dummy"
"91279",0,0,1,1,"dummy"
"91280",0,0,1,1,"dummy"
"91281",0,0,1,1,"dummy"
"91282",0,0,1,1,"dummy"
"91283",0,0,1,1,"dummy"
"91284",0,0,1,1,"dummy"
"91285",0,0,1,1,"dummy"
"91286",0,2,0,2,"dummy"
"91287",0,0,1,1,"dummy"
"91288",0,0,1,1,"dummy"
"91290",0,1,0,1,"dummy"
"91293",1,6,0,7,"dummy"
"91294",1,13,2,16,"dummy"
"91295",9,2,1,12,"dummy"
"91296",0,0,2,2,"dummy"
"91298",8,10,1,19,"dummy"
"91299",0,2,0,2,"dummy"
"91302",5,0,0,5,"dummy"
"91303",11,1,0,12,"dummy"
"91306",0,0,2,2,"dummy"
"91307",0,2,0,2,"dummy"
"91309",3,0,0,3,"dummy"
"91312",0,0,1,1,"dummy"
"91314",0,2,0,2,"dummy"
"91315",0,1,0,1,"dummy"
"91316",1,1,0,2,"dummy"
"91317",1,1,0,2,"dummy"
"91318",0,1,0,1,"dummy"
"91319",1,0,0,1,"dummy"
"91321",1,6,0,7,"dummy"
"91322",1,0,2,3,"dummy"
"91326",0,0,1,1,"dummy"
"91327",0,0,1,1,"dummy"
"91328",0,0,1,1,"dummy"
"91329",0,0,1,1,"dummy"
"91330",0,0,1,1,"dummy"
"91332",7,2,3,12,"dummy"
"91333",0,0,3,3,"dummy"
"91334",0,0,0,0,"dummy"
"91336",2,2,3,7,"dummy"
"91344",0,7,0,7,"dummy"
"91345",5,4,0,9,"dummy"
"91346",0,1,0,1,"dummy"
"91347",0,1,0,1,"dummy"
"91348",0,0,0,0,"dummy"
"91349",0,0,1,1,"dummy"
"91350",0,0,1,1,"dummy"
"91351",0,1,0,1,"dummy"
"91354",0,0,1,1,"dummy"
"91355",2,2,1,5,"dummy"
"91358",0,1,1,2,"dummy"
"91359",9,8,0,17,"dummy"
"91360",0,0,8,8,"dummy"
"91363",2,3,1,6,"dummy"
"91366",1,2,0,3,"dummy"
"91367",0,1,0,1,"dummy"
"91368",0,1,0,1,"dummy"
"91369",0,0,2,2,"dummy"
"91370",0,3,0,3,"dummy"
"91371",2,2,1,5,"dummy"
"91372",12,6,1,19,"dummy"
"91373",0,3,0,3,"dummy"
"91374",0,1,0,1,"dummy"
"91375",2,6,0,8,"dummy"
"91376",2,1,2,5,"dummy"
"91377",6,10,3,19,"dummy"
"91378",2,0,0,2,"dummy"
"91379",6,3,2,11,"dummy"
"91380",1,1,0,2,"dummy"
"91381",6,1,0,7,"dummy"
"91382",0,0,1,1,"dummy"
"91383",2,0,1,3,"dummy"
"91384",13,4,0,17,"dummy"
"91385",0,2,0,2,"dummy"
"91386",1,7,0,8,"dummy"
"91387",0,0,1,1,"dummy"
"91388",0,5,1,6,"dummy"
"91389",0,0,1,1,"dummy"
"91409",0,0,1,1,"dummy"
"91410",0,0,1,1,"dummy"
"91414",0,3,0,3,"dummy"
"91422",0,6,0,6,"dummy"
"91423",1,0,2,3,"dummy"
"91424",0,1,0,1,"dummy"
"91425",1,0,0,1,"dummy"
"91426",0,1,0,1,"dummy"
"91427",1,0,0,1,"dummy"
"91428",0,1,0,1,"dummy"
"91432",0,0,0,0,"dummy"
"91434",0,5,0,5,"dummy"
"91444",0,5,2,7,"dummy"
"91445",1,0,3,4,"dummy"
"91446",3,5,1,9,"dummy"
"91447",0,3,0,3,"dummy"
"91454",0,0,2,2,"dummy"
"91455",0,0,1,1,"dummy"
"91456",0,1,0,1,"dummy"
"91457",0,0,1,1,"dummy"
"91458",0,0,1,1,"dummy"
"91463",0,0,1,1,"dummy"
"91464",0,0,1,1,"dummy"
"91465",0,0,1,1,"dummy"
"91466",0,0,1,1,"dummy"
"91467",0,0,1,1,"dummy"
"91468",0,0,1,1,"dummy"
"91469",0,0,1,1,"dummy"
"91470",0,0,1,1,"dummy"
"91471",2,1,2,5,"dummy"
"91472",0,0,1,1,"dummy"
"91473",0,0,1,1,"dummy"
"91474",0,0,1,1,"dummy"
"91477",2,1,2,5,"dummy"
"91478",1,0,1,2,"dummy"
"91479",2,3,1,6,"dummy"
"91485",0,0,0,0,"dummy"
"91486",0,2,0,2,"dummy"
"91487",0,2,0,2,"dummy"
"91488",4,0,1,5,"dummy"
"91489",0,4,0,4,"dummy"
"91491",2,0,3,5,"dummy"
"91492",1,0,0,1,"dummy"
"91493",0,1,0,1,"dummy"
"91494",0,1,1,2,"dummy"
"91497",2,0,3,5,"dummy"
"91499",0,1,0,1,"dummy"
"91500",1,0,0,1,"dummy"
"91501",1,0,0,1,"dummy"
"91502",0,2,2,4,"dummy"
"91504",2,4,1,7,"dummy"
"91505",0,1,0,1,"dummy"
"91506",0,2,0,2,"dummy"
"91507",0,1,1,2,"dummy"
"91508",11,5,3,19,"dummy"
"91509",0,4,3,7,"dummy"
"91510",6,7,0,13,"dummy"
"91511",8,2,0,10,"dummy"
"91514",1,5,0,6,"dummy"
"91515",0,4,1,5,"dummy"
"91516",0,0,2,2,"dummy"
"91519",1,2,0,3,"dummy"
"91520",0,7,1,8,"dummy"
"91522",0,1,0,1,"dummy"
"91528",0,0,0,0,"dummy"
"91529",2,0,0,2,"dummy"
"91530",0,2,0,2,"dummy"
"91531",0,1,0,1,"dummy"
"91532",0,0,1,1,"dummy"
"91534",0,1,0,1,"dummy"
"91535",0,0,1,1,"dummy"
"91536",2,0,1,3,"dummy"
"91537",0,2,0,2,"dummy"
"91538",0,0,1,1,"dummy"
"91539",2,5,1,8,"dummy"
"91540",2,4,0,6,"dummy"
"91541",0,1,0,1,"dummy"
"91542",0,0,0,0,"dummy"
"91543",1,5,0,6,"dummy"
"91544",0,2,0,2,"dummy"
"91545",0,2,0,2,"dummy"
"91546",1,3,0,4,"dummy"
"91547",0,3,0,3,"dummy"
"91548",3,10,1,14,"dummy"
"91549",0,3,0,3,"dummy"
"91550",0,0,1,1,"dummy"
"91551",0,1,1,2,"dummy"
"91552",0,1,1,2,"dummy"
"91553",0,1,1,2,"dummy"
"91554",1,3,0,4,"dummy"
"91555",0,0,1,1,"dummy"
"91556",0,1,0,1,"dummy"
"91557",0,12,0,12,"dummy"
"91558",1,1,1,3,"dummy"
"91559",0,0,2,2,"dummy"
"91560",0,2,0,2,"dummy"
"91563",0,0,0,0,"dummy"
"91564",0,0,0,0,"dummy"
"91566",1,1,0,2,"dummy"
"91568",1,1,0,2,"dummy"
"91571",0,3,2,5,"dummy"
"91573",0,0,1,1,"dummy"
"91574",0,0,1,1,"dummy"
"91575",1,0,0,1,"dummy"
"91576",0,0,1,1,"dummy"
"91577",0,0,3,3,"dummy"
"91578",5,5,0,10,"dummy"
"91579",7,4,0,11,"dummy"
"91580",1,3,0,4,"dummy"
"91581",0,0,1,1,"dummy"
"91582",7,1,0,8,"dummy"
"91583",0,0,0,0,"dummy"
"91584",6,8,2,16,"dummy"
"91585",0,0,0,0,"dummy"
"91586",0,0,1,1,"dummy"
"91587",0,0,0,0,"dummy"
"91588",0,0,1,1,"dummy"
"91589",8,6,0,14,"dummy"
"91590",12,12,0,24,"dummy"
"91591",0,0,0,0,"dummy"
"91592",0,1,0,1,"dummy"
"91593",17,17,0,34,"dummy"
"91594",0,0,0,0,"dummy"
"91595",0,0,0,0,"dummy"
"91596",0,0,0,0,"dummy"
"91597",0,3,1,4,"dummy"
"91599",1,2,0,3,"dummy"
"91603",0,0,1,1,"dummy"
"91604",0,0,1,1,"dummy"
"91606",1,3,1,5,"dummy"
"91607",0,3,0,3,"dummy"
"91608",2,3,1,6,"dummy"
"91609",0,0,1,1,"dummy"
"91610",0,0,1,1,"dummy"
"91611",0,0,1,1,"dummy"
"91612",0,0,0,0,"dummy"
"91613",0,1,0,1,"dummy"
"91614",2,3,1,6,"dummy"
"91615",0,1,0,1,"dummy"
"91616",0,0,1,1,"dummy"
"91617",0,0,1,1,"dummy"
"91618",2,0,0,2,"dummy"
"91622",0,0,1,1,"dummy"
"91623",0,0,1,1,"dummy"
"91624",0,0,2,2,"dummy"
"91630",0,2,0,2,"dummy"
"91633",1,1,0,2,"dummy"
"91634",5,4,5,14,"dummy"
"91635",0,1,0,1,"dummy"
"91636",0,0,1,1,"dummy"
"91640",0,0,1,1,"dummy"
"91689",0,0,0,0,"dummy"
"91690",0,0,0,0,"dummy"
"91691",0,0,0,0,"dummy"
"91692",0,0,0,0,"dummy"
"91693",0,0,0,0,"dummy"
"91712",4,6,1,11,"dummy"
"91713",1,2,0,3,"dummy"
"91714",0,2,0,2,"dummy"
"91715",0,1,0,1,"dummy"
"91716",0,1,0,1,"dummy"
"91717",0,0,0,0,"dummy"
"91718",0,1,0,1,"dummy"
"91719",0,0,0,0,"dummy"
"91720",0,0,1,1,"dummy"
"91724",0,2,0,2,"dummy"
"91725",0,1,0,1,"dummy"
"91726",0,0,0,0,"dummy"
"91727",0,1,0,1,"dummy"
"91728",0,1,0,1,"dummy"
"91744",0,1,0,1,"dummy"
"91745",1,0,1,2,"dummy"
"91746",1,2,0,3,"dummy"
"91747",1,0,0,1,"dummy"
"91751",0,2,0,2,"dummy"
"91752",1,2,0,3,"dummy"
"91753",0,1,0,1,"dummy"
"91760",1,9,3,13,"dummy"
"91763",9,8,1,18,"dummy"
"91764",0,1,0,1,"dummy"
"91768",0,2,0,2,"dummy"
"91769",0,0,1,1,"dummy"
"91770",0,0,1,1,"dummy"
"91771",0,0,1,1,"dummy"
"91784",0,1,1,2,"dummy"
"91785",0,1,0,1,"dummy"
"91786",0,1,1,2,"dummy"
"91787",2,0,1,3,"dummy"
"91788",1,12,1,14,"dummy"
"91789",2,6,1,9,"dummy"
"91790",6,0,1,7,"dummy"
"91794",0,7,0,7,"dummy"
"91795",1,1,0,2,"dummy"
"91796",2,4,1,7,"dummy"
"91797",1,3,0,4,"dummy"
"91798",1,2,0,3,"dummy"
"91799",0,1,1,2,"dummy"
"91800",0,1,1,2,"dummy"
"91801",2,7,1,10,"dummy"
"91802",0,0,1,1,"dummy"
"91805",0,0,1,1,"dummy"
"91806",2,0,2,4,"dummy"
"91807",0,3,1,4,"dummy"
"91808",0,0,1,1,"dummy"
"91811",0,0,4,4,"dummy"
"91814",3,9,0,12,"dummy"
"91822",0,0,1,1,"dummy"
"91841",2,0,3,5,"dummy"
"91842",1,0,0,1,"dummy"
"91843",0,1,0,1,"dummy"
"91844",0,1,1,2,"dummy"
"91858",7,1,3,11,"dummy"
"91861",2,3,6,11,"dummy"
"91862",0,1,2,3,"dummy"
"91638",0,1,0,1,"dummy"
"91646",0,1,0,1,"dummy"
"91651",0,0,0,0,"dummy"
"91652",0,6,0,6,"dummy"
"91653",3,2,1,6,"dummy"
"91654",1,0,0,1,"dummy"
"91655",0,0,1,1,"dummy"
"91656",0,5,0,5,"dummy"
"91657",0,2,0,2,"dummy"
"91658",0,2,3,5,"dummy"
"91659",0,3,0,3,"dummy"
"91660",0,0,0,0,"dummy"
"91661",0,1,2,3,"dummy"
"91662",2,12,1,15,"dummy"
"91663",0,0,1,1,"dummy"
"91664",6,0,0,6,"dummy"
"91665",5,1,2,8,"dummy"
"91672",0,0,1,1,"dummy"
"91673",14,0,3,17,"dummy"
"91674",0,0,1,1,"dummy"
"91675",0,0,1,1,"dummy"
"91676",0,0,2,2,"dummy"
"91679",2,0,0,2,"dummy"
"91680",0,1,0,1,"dummy"
"91681",0,0,1,1,"dummy"
"91682",0,1,1,2,"dummy"
"91683",0,1,0,1,"dummy"
"91684",0,0,0,0,"dummy"
"91695",0,2,1,3,"dummy"
"91696",1,0,1,2,"dummy"
"91703",4,3,0,7,"dummy"
"91704",0,0,1,1,"dummy"
"91705",0,0,2,2,"dummy"
"91706",2,5,3,10,"dummy"
"91707",1,0,1,2,"dummy"
"91708",0,0,1,1,"dummy"
"91722",0,2,0,2,"dummy"
"91736",0,2,0,2,"dummy"
"91737",0,1,0,1,"dummy"
"91740",5,32,0,37,"dummy"
"91741",8,2,4,14,"dummy"
"91742",0,1,2,3,"dummy"
"91749",2,3,0,5,"dummy"
"91766",0,0,1,1,"dummy"
"91777",1,3,0,4,"dummy"
"91778",0,1,0,1,"dummy"
"91779",1,0,0,1,"dummy"
"91780",1,0,0,1,"dummy"
"91781",0,1,0,1,"dummy"
"91782",0,1,0,1,"dummy"
"91792",6,1,1,8,"dummy"
"91816",10,0,0,10,"dummy"
"91819",0,1,0,1,"dummy"
"91820",0,0,1,1,"dummy"
"91837",1,1,0,2,"dummy"
"91838",1,1,5,7,"dummy"
"91839",1,0,5,6,"dummy"
"91865",1,0,0,1,"dummy"
"91868",1,13,5,19,"dummy"
"91869",8,2,3,13,"dummy"
"91870",1,0,2,3,"dummy"
"91871",0,1,0,1,"dummy"
"91872",1,1,0,2,"dummy"
"91873",0,0,0,0,"dummy"
"91874",8,2,5,15,"dummy"
"91875",0,0,1,1,"dummy"
"91876",2,5,1,8,"dummy"
"91863",0,0,1,1,"dummy"
"91899",0,4,0,4,"dummy"
"91900",1,0,0,1,"dummy"
"91903",0,0,0,0,"dummy"
"91904",9,26,5,40,"dummy"
"91905",29,9,3,41,"dummy"
"91906",0,0,0,0,"dummy"
"91907",0,0,0,0,"dummy"
"91908",0,2,0,2,"dummy"
"91909",2,2,0,4,"dummy"
"91910",0,1,0,1,"dummy"
"91911",0,1,0,1,"dummy"
"91912",0,1,0,1,"dummy"
"91913",0,1,0,1,"dummy"
"91914",1,0,0,1,"dummy"
"91915",0,0,0,0,"dummy"
"91916",1,3,0,4,"dummy"
"91917",7,12,2,21,"dummy"
"91918",3,4,1,8,"dummy"
"91919",0,2,0,2,"dummy"
"91920",1,0,0,1,"dummy"
"91921",0,0,2,2,"dummy"
"91922",0,0,1,1,"dummy"
"91923",2,1,1,4,"dummy"
"91924",6,6,3,15,"dummy"
"91925",2,5,0,7,"dummy"
"91926",1,0,0,1,"dummy"
"91927",0,0,0,0,"dummy"
"91928",0,0,1,1,"dummy"
"91929",0,0,1,1,"dummy"
"91930",10,0,2,12,"dummy"
"91931",1,0,1,2,"dummy"
"91932",0,1,0,1,"dummy"
"91933",2,2,0,4,"dummy"
"91934",6,20,2,28,"dummy"
"91935",0,0,3,3,"dummy"
"91936",20,6,2,28,"dummy"
"91937",0,0,1,1,"dummy"
"91938",0,1,0,1,"dummy"
"91939",2,3,0,5,"dummy"
"91940",13,39,3,55,"dummy"
"91941",0,1,0,1,"dummy"
"91942",2,4,1,7,"dummy"
"91943",27,11,2,40,"dummy"
"91944",0,3,0,3,"dummy"
"91945",1,0,0,1,"dummy"
"91946",0,1,0,1,"dummy"
"91949",0,8,0,8,"dummy"
"91950",0,13,0,13,"dummy"
"91951",0,4,0,4,"dummy"
"91952",5,1,1,7,"dummy"
"91953",1,4,1,6,"dummy"
"91954",0,1,0,1,"dummy"
"91955",0,8,0,8,"dummy"
"91956",0,0,1,1,"dummy"
"91959",0,0,0,0,"dummy"
"91960",0,0,0,0,"dummy"
"91961",0,0,0,0,"dummy"
"91962",0,0,0,0,"dummy"
"91963",0,0,0,0,"dummy"
"91964",0,0,0,0,"dummy"
"91965",0,0,0,0,"dummy"
"91966",0,0,0,0,"dummy"
"91967",0,0,0,0,"dummy"
"91968",0,0,0,0,"dummy"
"91969",0,0,0,0,"dummy"
"91970",0,0,0,0,"dummy"
"91971",0,0,0,0,"dummy"
"91972",0,0,0,0,"dummy"
"91973",0,0,0,0,"dummy"
"91974",0,0,0,0,"dummy"
"91975",0,0,0,0,"dummy"
"91976",0,0,0,0,"dummy"
"91977",0,0,0,0,"dummy"
"91978",0,0,0,0,"dummy"
"91979",1,0,0,1,"dummy"
"91980",2,2,0,4,"dummy"
"91981",0,5,0,5,"dummy"
"91982",0,0,0,0,"dummy"
"91983",0,0,0,0,"dummy"
"91984",0,0,0,0,"dummy"
"91985",0,0,0,0,"dummy"
"91986",0,0,0,0,"dummy"
"91987",0,0,0,0,"dummy"
"91988",0,0,0,0,"dummy"
"91989",0,0,0,0,"dummy"
"91990",0,0,0,0,"dummy"
"92026",0,0,2,2,"dummy"
"92034",0,1,0,1,"dummy"
"92040",0,8,0,8,"dummy"
"92041",0,0,0,0,"dummy"
"92042",0,0,0,0,"dummy"
"92043",2,2,0,4,"dummy"
"92044",0,0,0,0,"dummy"
"91877",0,0,1,1,"dummy"
"91878",0,0,1,1,"dummy"
"91879",0,1,0,1,"dummy"
"91880",0,0,1,1,"dummy"
"91881",0,0,1,1,"dummy"
"91882",5,0,1,6,"dummy"
"91883",0,4,0,4,"dummy"
"91884",0,1,0,1,"dummy"
"91885",0,4,0,4,"dummy"
"91886",1,12,5,18,"dummy"
"91887",0,2,0,2,"dummy"
"91888",2,5,0,7,"dummy"
"91889",2,2,0,4,"dummy"
"91890",1,2,0,3,"dummy"
"91891",0,0,4,4,"dummy"
"91892",1,0,0,1,"dummy"
"91893",2,1,2,5,"dummy"
"91894",1,2,1,4,"dummy"
"91895",0,0,1,1,"dummy"
"91896",0,2,0,2,"dummy"
"91897",0,1,0,1,"dummy"
"91992",0,2,0,2,"dummy"
"91993",2,0,0,2,"dummy"
"91994",0,2,0,2,"dummy"
"91995",1,2,0,3,"dummy"
"91998",1,1,3,5,"dummy"
"91999",1,2,1,4,"dummy"
"92000",1,0,1,2,"dummy"
"92001",0,0,1,1,"dummy"
"92002",1,2,0,3,"dummy"
"92003",3,3,0,6,"dummy"
"92010",1,1,0,2,"dummy"
"92011",1,1,0,2,"dummy"
"92012",0,0,0,0,"dummy"
"92013",0,4,0,4,"dummy"
"92014",0,0,0,0,"dummy"
"92015",3,0,0,3,"dummy"
"92018",0,2,0,2,"dummy"
"92019",0,4,0,4,"dummy"
"92020",0,0,0,0,"dummy"
"92021",2,1,0,3,"dummy"
"92022",0,7,0,7,"dummy"
"92023",6,8,1,15,"dummy"
"92024",0,1,0,1,"dummy"
"92028",0,0,1,1,"dummy"
"92029",0,0,2,2,"dummy"
"92030",33,48,4,85,"dummy"
"92036",0,0,0,0,"dummy"
"92058",0,1,0,1,"dummy"
"92059",0,1,0,1,"dummy"
"92067",0,0,0,0,"dummy"
"92068",0,0,0,0,"dummy"
"92171",0,0,1,1,"dummy"
"92172",0,0,1,1,"dummy"
"92173",2,3,0,5,"dummy"
"92174",0,0,1,1,"dummy"
"92175",0,0,2,2,"dummy"
"92176",0,0,2,2,"dummy"
"92177",0,0,2,2,"dummy"
"92180",1,3,3,7,"dummy"
"92181",0,1,0,1,"dummy"
"92182",1,1,0,2,"dummy"
"92183",21,14,1,36,"dummy"
"92184",0,4,0,4,"dummy"
"92185",1,0,0,1,"dummy"
"92186",3,0,0,3,"dummy"
"92187",2,1,0,3,"dummy"
"92188",0,0,3,3,"dummy"
"92189",14,0,2,16,"dummy"
"92190",0,14,3,17,"dummy"
"92191",0,0,3,3,"dummy"
"92192",0,1,0,1,"dummy"
"92193",0,4,0,4,"dummy"
"92194",2,1,0,3,"dummy"
"92195",6,4,0,10,"dummy"
"92196",0,4,0,4,"dummy"
"92197",0,2,1,3,"dummy"
"92198",2,1,0,3,"dummy"
"92199",3,3,0,6,"dummy"
"92200",6,5,0,11,"dummy"
"92201",0,2,0,2,"dummy"
"92202",0,1,0,1,"dummy"
"92207",0,2,0,2,"dummy"
"92208",0,1,0,1,"dummy"
"92209",2,2,0,4,"dummy"
"92045",2,0,0,2,"dummy"
"92046",0,1,0,1,"dummy"
"92047",0,2,1,3,"dummy"
"92048",3,3,1,7,"dummy"
"92049",2,2,1,5,"dummy"
"92050",2,0,0,2,"dummy"
"92051",2,4,1,7,"dummy"
"92052",3,2,0,5,"dummy"
"92055",4,4,1,9,"dummy"
"92056",1,2,0,3,"dummy"
"92061",0,1,0,1,"dummy"
"92062",0,0,3,3,"dummy"
"92065",0,6,1,7,"dummy"
"92070",2,19,1,22,"dummy"
"92071",0,1,0,1,"dummy"
"92072",0,0,1,1,"dummy"
"92073",0,0,1,1,"dummy"
"92074",1,0,0,1,"dummy"
"92079",4,0,0,4,"dummy"
"92082",0,0,1,1,"dummy"
"92083",0,1,0,1,"dummy"
"92084",0,2,0,2,"dummy"
"92085",0,2,0,2,"dummy"
"92086",0,0,0,0,"dummy"
"92087",0,0,1,1,"dummy"
"92088",0,1,0,1,"dummy"
"92089",0,0,1,1,"dummy"
"92094",0,9,2,11,"dummy"
"92095",0,2,0,2,"dummy"
"92096",0,4,0,4,"dummy"
"92097",0,1,0,1,"dummy"
"92098",0,0,0,0,"dummy"
"92099",0,19,0,19,"dummy"
"92100",1,0,0,1,"dummy"
"92101",1,14,2,17,"dummy"
"92102",0,1,0,1,"dummy"
"92103",0,2,0,2,"dummy"
"92104",0,3,0,3,"dummy"
"92105",0,1,0,1,"dummy"
"92106",0,0,0,0,"dummy"
"92107",0,4,0,4,"dummy"
"92108",0,1,0,1,"dummy"
"92109",0,9,2,11,"dummy"
"92110",1,4,1,6,"dummy"
"92111",0,1,0,1,"dummy"
"92112",3,3,6,12,"dummy"
"92113",0,6,0,6,"dummy"
"92114",0,0,1,1,"dummy"
"92115",0,1,2,3,"dummy"
"92116",0,1,0,1,"dummy"
"92117",1,2,3,6,"dummy"
"92118",0,0,1,1,"dummy"
"92119",0,0,1,1,"dummy"
"92120",0,0,1,1,"dummy"
"92121",0,0,1,1,"dummy"
"92122",0,1,1,2,"dummy"
"92123",0,0,1,1,"dummy"
"92124",0,0,0,0,"dummy"
"92125",0,0,1,1,"dummy"
"92126",0,2,1,3,"dummy"
"92127",0,0,0,0,"dummy"
"92128",0,0,1,1,"dummy"
"92129",0,0,0,0,"dummy"
"92130",0,0,1,1,"dummy"
"92131",0,0,2,2,"dummy"
"92132",0,2,1,3,"dummy"
"92133",0,0,1,1,"dummy"
"92134",0,0,1,1,"dummy"
"92135",0,0,1,1,"dummy"
"92136",5,6,8,19,"dummy"
"92137",0,0,1,1,"dummy"
"92138",2,2,0,4,"dummy"
"92139",0,0,1,1,"dummy"
"92140",2,2,1,5,"dummy"
"92141",0,0,1,1,"dummy"
"92142",0,0,0,0,"dummy"
"92143",3,3,4,10,"dummy"
"92144",0,5,0,5,"dummy"
"92145",0,3,0,3,"dummy"
"92146",0,0,1,1,"dummy"
"92147",0,0,1,1,"dummy"
"92148",0,3,1,4,"dummy"
"92149",0,0,1,1,"dummy"
"92150",0,0,1,1,"dummy"
"92151",5,4,1,10,"dummy"
"92152",0,0,2,2,"dummy"
"92153",0,0,2,2,"dummy"
"92154",0,0,1,1,"dummy"
"92155",2,2,1,5,"dummy"
"92156",0,0,1,1,"dummy"
"92157",0,0,1,1,"dummy"
"92158",0,0,2,2,"dummy"
"92159",0,0,1,1,"dummy"
"92160",0,0,1,1,"dummy"
"92161",0,0,1,1,"dummy"
"92162",3,3,3,9,"dummy"
"92163",0,0,1,1,"dummy"
"92164",0,0,0,0,"dummy"
"92165",0,0,1,1,"dummy"
"92166",0,0,0,0,"dummy"
"92167",0,0,1,1,"dummy"
"92168",0,0,1,1,"dummy"
"92169",0,0,2,2,"dummy"
"92204",0,0,0,0,"dummy"
"92205",0,0,0,0,"dummy"
"92219",0,0,0,0,"dummy"
"92220",0,0,2,2,"dummy"
"92221",0,1,0,1,"dummy"
"92239",0,1,1,2,"dummy"
"92245",0,1,0,1,"dummy"
"92246",0,3,0,3,"dummy"
"92247",3,1,0,4,"dummy"
"92252",1,5,1,7,"dummy"
"92253",4,5,0,9,"dummy"
"92254",0,1,3,4,"dummy"
"92255",0,0,3,3,"dummy"
"92256",0,0,1,1,"dummy"
"92264",0,6,0,6,"dummy"
"92267",0,1,0,1,"dummy"
"92268",0,0,1,1,"dummy"
"92269",0,1,0,1,"dummy"
"92270",0,6,1,7,"dummy"
"92281",2,0,0,2,"dummy"
"92282",6,0,0,6,"dummy"
"92291",5,0,1,6,"dummy"
"92292",0,0,1,1,"dummy"
"92293",4,7,4,15,"dummy"
"92294",0,0,0,0,"dummy"
"92323",2,1,0,3,"dummy"
"92331",3,6,4,13,"dummy"
"92332",3,0,4,7,"dummy"
"92342",0,0,2,2,"dummy"
"92343",1,16,3,20,"dummy"
"92347",0,1,0,1,"dummy"
"92359",0,0,1,1,"dummy"
"92414",1,0,0,1,"dummy"
"92426",1,9,0,10,"dummy"
"92477",0,1,0,1,"dummy"
"92478",0,0,1,1,"dummy"
"92479",3,5,0,8,"dummy"
"92480",0,0,1,1,"dummy"
"92481",0,7,0,7,"dummy"
"92482",0,2,0,2,"dummy"
"92483",0,1,0,1,"dummy"
"92484",1,1,0,2,"dummy"
"92485",24,3,4,31,"dummy"
"92486",0,3,13,16,"dummy"
"92487",1,0,1,2,"dummy"
"92488",2,0,0,2,"dummy"
"92489",0,1,0,1,"dummy"
"92490",0,0,1,1,"dummy"
"92491",19,36,17,72,"dummy"
"92492",26,9,18,53,"dummy"
"92493",0,0,1,1,"dummy"
"92494",0,0,1,1,"dummy"
"92527",0,0,1,1,"dummy"
"92528",0,3,0,3,"dummy"
"92529",3,0,0,3,"dummy"
"92210",25,12,3,40,"dummy"
"92211",4,4,3,11,"dummy"
"92212",0,4,0,4,"dummy"
"92213",0,0,1,1,"dummy"
"92214",0,2,0,2,"dummy"
"92215",3,0,1,4,"dummy"
"92216",1,0,0,1,"dummy"
"92217",2,0,1,3,"dummy"
"92225",2,21,0,23,"dummy"
"92226",1,10,2,13,"dummy"
"92227",18,20,0,38,"dummy"
"92228",6,5,3,14,"dummy"
"92229",4,5,3,12,"dummy"
"92230",11,18,2,31,"dummy"
"92231",0,1,1,2,"dummy"
"92232",0,0,0,0,"dummy"
"92233",2,3,0,5,"dummy"
"92234",1,20,0,21,"dummy"
"92235",0,1,0,1,"dummy"
"92236",42,0,0,42,"dummy"
"92237",3,25,1,29,"dummy"
"92243",1,1,0,2,"dummy"
"92286",1,2,0,3,"dummy"
"92287",0,0,0,0,"dummy"
"92296",3,1,1,5,"dummy"
"92299",0,0,2,2,"dummy"
"92300",2,1,0,3,"dummy"
"92301",0,0,1,1,"dummy"
"92302",7,8,3,18,"dummy"
"92303",0,0,0,0,"dummy"
"92304",0,0,3,3,"dummy"
"92305",0,0,3,3,"dummy"
"92306",0,0,0,0,"dummy"
"92307",12,0,0,12,"dummy"
"92308",0,1,0,1,"dummy"
"92309",1,0,3,4,"dummy"
"92310",0,1,0,1,"dummy"
"92311",0,0,1,1,"dummy"
"92312",0,0,3,3,"dummy"
"92313",0,0,1,1,"dummy"
"92314",0,0,3,3,"dummy"
"92315",0,5,0,5,"dummy"
"92316",5,4,0,9,"dummy"
"92327",0,3,0,3,"dummy"
"92328",2,0,0,2,"dummy"
"92329",0,1,0,1,"dummy"
"92334",1,1,1,3,"dummy"
"92335",0,1,2,3,"dummy"
"92336",0,0,1,1,"dummy"
"92337",5,6,2,13,"dummy"
"92338",0,0,0,0,"dummy"
"92339",2,1,1,4,"dummy"
"92340",1,2,0,3,"dummy"
"92345",0,0,0,0,"dummy"
"92353",0,0,1,1,"dummy"
"92354",0,0,1,1,"dummy"
"92355",10,2,1,13,"dummy"
"92356",1,1,1,3,"dummy"
"92357",0,0,0,0,"dummy"
"92365",1,0,0,1,"dummy"
"92366",0,0,1,1,"dummy"
"92367",1,1,0,2,"dummy"
"92368",0,0,1,1,"dummy"
"92369",0,0,0,0,"dummy"
"92370",0,0,0,0,"dummy"
"92371",0,0,0,0,"dummy"
"92374",2,4,0,6,"dummy"
"92375",2,2,0,4,"dummy"
"92376",0,0,1,1,"dummy"
"92377",0,0,1,1,"dummy"
"92378",0,0,1,1,"dummy"
"92379",4,2,3,9,"dummy"
"92380",2,1,1,4,"dummy"
"92381",0,0,2,2,"dummy"
"92382",0,0,1,1,"dummy"
"92383",0,0,1,1,"dummy"
"92384",0,0,1,1,"dummy"
"92385",0,0,1,1,"dummy"
"92386",0,0,1,1,"dummy"
"92387",0,0,1,1,"dummy"
"92388",0,0,1,1,"dummy"
"92391",0,2,0,2,"dummy"
"92392",1,3,4,8,"dummy"
"92395",0,0,0,0,"dummy"
"92416",0,0,2,2,"dummy"
"92417",2,0,0,2,"dummy"
"92418",0,4,0,4,"dummy"
"92421",0,0,1,1,"dummy"
"92422",0,0,1,1,"dummy"
"92423",0,1,0,1,"dummy"
"92424",0,0,1,1,"dummy"
"92428",11,0,2,13,"dummy"
"92433",0,1,0,1,"dummy"
"92434",0,0,0,0,"dummy"
"92435",0,3,3,6,"dummy"
"92436",7,0,1,8,"dummy"
"92437",0,0,1,1,"dummy"
"92438",0,1,1,2,"dummy"
"92439",1,0,1,2,"dummy"
"92457",0,0,1,1,"dummy"
"92462",0,1,1,2,"dummy"
"92463",0,0,1,1,"dummy"
"92464",1,1,0,2,"dummy"
"92465",0,1,0,1,"dummy"
"92466",1,2,1,4,"dummy"
"92467",0,2,1,3,"dummy"
"92468",2,4,0,6,"dummy"
"92469",2,3,2,7,"dummy"
"92470",4,1,0,5,"dummy"
"92471",1,0,0,1,"dummy"
"92472",4,0,2,6,"dummy"
"92473",1,2,0,3,"dummy"
"92474",4,2,2,8,"dummy"
"92475",1,0,0,1,"dummy"
"92498",16,7,7,30,"dummy"
"92499",0,0,1,1,"dummy"
"92500",0,0,1,1,"dummy"
"92509",0,2,3,5,"dummy"
"92514",1,0,1,2,"dummy"
"92515",0,1,1,2,"dummy"
"92516",0,1,0,1,"dummy"
"92517",1,0,0,1,"dummy"
"92518",0,1,0,1,"dummy"
"92519",0,0,1,1,"dummy"
"92520",3,0,0,3,"dummy"
"92521",0,3,0,3,"dummy"
"92522",0,0,1,1,"dummy"
"92523",1,0,0,1,"dummy"
"92524",0,2,0,2,"dummy"
"92525",2,0,0,2,"dummy"
"92533",0,3,0,3,"dummy"
"92534",3,6,0,9,"dummy"
"92535",0,1,0,1,"dummy"
"92536",0,3,0,3,"dummy"
"92537",0,2,0,2,"dummy"
"92538",0,1,0,1,"dummy"
"92539",0,1,0,1,"dummy"
"92540",0,2,0,2,"dummy"
"92541",0,0,1,1,"dummy"
"92542",0,0,1,1,"dummy"
"92543",0,0,3,3,"dummy"
"92551",0,1,1,2,"dummy"
"92552",0,0,1,1,"dummy"
"92553",1,1,0,2,"dummy"
"92556",0,3,0,3,"dummy"
"92557",0,2,0,2,"dummy"
"92578",0,2,0,2,"dummy"
"92582",0,0,2,2,"dummy"
"92583",0,0,2,2,"dummy"
"92584",0,0,2,2,"dummy"
"92585",0,0,2,2,"dummy"
"92586",0,0,2,2,"dummy"
"92587",0,5,0,5,"dummy"
"92592",6,0,0,6,"dummy"
"92593",2,5,2,9,"dummy"
"92596",0,0,1,1,"dummy"
"92599",0,0,1,1,"dummy"
"92600",0,0,2,2,"dummy"
"92563",2,4,0,6,"dummy"
"92564",0,2,0,2,"dummy"
"92565",0,2,0,2,"dummy"
"92566",10,2,0,12,"dummy"
"92567",0,2,0,2,"dummy"
"92570",0,1,0,1,"dummy"
"92571",0,1,0,1,"dummy"
"92572",1,3,0,4,"dummy"
"92573",0,0,3,3,"dummy"
"92574",0,0,3,3,"dummy"
"92580",0,2,0,2,"dummy"
"92618",0,0,1,1,"dummy"
"92626",0,0,1,1,"dummy"
"92627",0,0,1,1,"dummy"
"92628",0,0,1,1,"dummy"
"92629",0,0,1,1,"dummy"
"92630",0,0,1,1,"dummy"
"92631",0,0,1,1,"dummy"
"92632",0,0,1,1,"dummy"
"92633",0,0,1,1,"dummy"
"92634",0,0,1,1,"dummy"
"92635",0,0,1,1,"dummy"
"92636",0,0,1,1,"dummy"
"92637",0,0,1,1,"dummy"
"92638",0,0,1,1,"dummy"
"92639",0,0,1,1,"dummy"
"92640",0,0,1,1,"dummy"
"92641",0,0,1,1,"dummy"
"92642",0,0,1,1,"dummy"
"92647",1,0,0,1,"dummy"
"92601",1,0,3,4,"dummy"
"92602",0,0,2,2,"dummy"
"92603",1,1,0,2,"dummy"
"92604",0,3,0,3,"dummy"
"92605",0,0,1,1,"dummy"
"92606",0,0,1,1,"dummy"
"92607",0,1,0,1,"dummy"
"92608",1,0,0,1,"dummy"
"92609",0,2,0,2,"dummy"
"92612",1,3,0,4,"dummy"
"92620",0,0,1,1,"dummy"
"92621",1,1,0,2,"dummy"
"92622",0,0,1,1,"dummy"
"92623",0,0,1,1,"dummy"
"92624",0,1,0,1,"dummy"
"92665",0,1,0,1,"dummy"
"92666",2,0,1,3,"dummy"
"92667",0,3,1,4,"dummy"
"92668",0,0,1,1,"dummy"
"92669",0,0,1,1,"dummy"
"92674",0,0,1,1,"dummy"
"92676",0,2,0,2,"dummy"
"92679",4,2,0,6,"dummy"
"92680",1,1,0,2,"dummy"
"92681",0,0,1,1,"dummy"
"92684",1,3,1,5,"dummy"
"92687",0,3,0,3,"dummy"
"92688",2,2,0,4,"dummy"
"92689",0,1,0,1,"dummy"
"92691",0,0,1,1,"dummy"
"92692",0,0,1,1,"dummy"
"92694",1,1,0,2,"dummy"
"92695",0,0,1,1,"dummy"
"92696",0,0,1,1,"dummy"
"92697",1,2,0,3,"dummy"
"92700",8,17,1,26,"dummy"
"92701",1,1,1,3,"dummy"
"92702",1,0,0,1,"dummy"
"92703",0,1,1,2,"dummy"
"92704",0,0,0,0,"dummy"
"92707",0,1,0,1,"dummy"
"92709",0,0,1,1,"dummy"
"92710",0,0,1,1,"dummy"
"92711",0,0,2,2,"dummy"
"92712",0,0,1,1,"dummy"
"92715",4,11,1,16,"dummy"
"92749",0,2,0,2,"dummy"
"92750",1,0,0,1,"dummy"
"92751",0,0,1,1,"dummy"
"92752",0,1,0,1,"dummy"
"92754",0,1,0,1,"dummy"
"92756",0,0,3,3,"dummy"
"92757",0,2,1,3,"dummy"
"92776",0,0,0,0,"dummy"
"92778",0,0,1,1,"dummy"
"92780",0,0,3,3,"dummy"
"92781",0,0,3,3,"dummy"
"92782",0,0,3,3,"dummy"
"92783",2,1,2,5,"dummy"
"92784",0,0,3,3,"dummy"
"92785",0,0,3,3,"dummy"
"92786",0,0,3,3,"dummy"
"92787",0,0,3,3,"dummy"
"92788",0,0,3,3,"dummy"
"92789",0,0,1,1,"dummy"
"92790",0,1,3,4,"dummy"
"92791",0,0,3,3,"dummy"
"92792",1,0,3,4,"dummy"
"92793",0,0,3,3,"dummy"
"92794",8,7,1,16,"dummy"
"92795",1,0,0,1,"dummy"
"92796",0,0,0,0,"dummy"
"92797",0,0,0,0,"dummy"
"92798",0,0,0,0,"dummy"
"92799",0,0,0,0,"dummy"
"92800",0,0,2,2,"dummy"
"92801",0,4,0,4,"dummy"
"92802",0,0,2,2,"dummy"
"92803",0,0,2,2,"dummy"
"92806",0,1,0,1,"dummy"
"92807",0,2,0,2,"dummy"
"92808",0,0,3,3,"dummy"
"92810",0,0,1,1,"dummy"
"92811",0,4,0,4,"dummy"
"92827",0,0,0,0,"dummy"
"92828",0,1,0,1,"dummy"
"92829",0,1,0,1,"dummy"
"92830",0,2,0,2,"dummy"
"92831",0,0,0,0,"dummy"
"92832",1,0,0,1,"dummy"
"92833",2,1,0,3,"dummy"
"92837",0,1,0,1,"dummy"
"92838",0,2,0,2,"dummy"
"92840",0,1,0,1,"dummy"
"92845",0,1,0,1,"dummy"
"92849",1,8,0,9,"dummy"
"92851",0,1,0,1,"dummy"
"92852",4,1,1,6,"dummy"
"92853",1,4,1,6,"dummy"
"92854",5,0,2,7,"dummy"
"92858",0,0,1,1,"dummy"
"92860",0,0,1,1,"dummy"
"92861",2,2,2,6,"dummy"
"92862",4,10,1,15,"dummy"
"92863",0,0,1,1,"dummy"
"92864",0,0,1,1,"dummy"
"92865",0,0,1,1,"dummy"
"92866",0,0,1,1,"dummy"
"92867",0,0,1,1,"dummy"
"92868",0,0,1,1,"dummy"
"92869",0,0,1,1,"dummy"
"92870",0,0,1,1,"dummy"
"92871",0,0,1,1,"dummy"
"92872",0,0,1,1,"dummy"
"92873",0,0,1,1,"dummy"
"92874",0,0,1,1,"dummy"
"92877",0,1,0,1,"dummy"
"92878",0,1,0,1,"dummy"
"92881",1,1,0,2,"dummy"
"92882",1,1,0,2,"dummy"
"92884",0,15,0,15,"dummy"
"92888",0,0,2,2,"dummy"
"92889",1,0,0,1,"dummy"
"92890",0,0,0,0,"dummy"
"92891",0,2,0,2,"dummy"
"92892",1,0,0,1,"dummy"
"92893",12,0,0,12,"dummy"
"92894",0,0,0,0,"dummy"
"92895",0,0,0,0,"dummy"
"92896",0,11,0,11,"dummy"
"92905",0,0,1,1,"dummy"
"92908",0,0,1,1,"dummy"
"92909",0,1,0,1,"dummy"
"92910",0,0,1,1,"dummy"
"92911",0,0,1,1,"dummy"
"92912",0,1,0,1,"dummy"
"92913",1,3,3,7,"dummy"
"92914",0,0,1,1,"dummy"
"92915",0,0,0,0,"dummy"
"92916",0,0,0,0,"dummy"
"92917",0,0,0,0,"dummy"
"92918",1,0,0,1,"dummy"
"92920",0,0,1,1,"dummy"
"92921",1,1,0,2,"dummy"
"92922",0,2,0,2,"dummy"
"92923",0,4,0,4,"dummy"
"92925",7,4,0,11,"dummy"
"92927",0,0,1,1,"dummy"
"92929",0,15,0,15,"dummy"
"92930",0,1,0,1,"dummy"
"92931",0,0,2,2,"dummy"
"92933",2,4,0,6,"dummy"
"92934",0,2,0,2,"dummy"
"92935",0,2,0,2,"dummy"
"92936",10,2,0,12,"dummy"
"92937",0,2,0,2,"dummy"
"92939",0,1,0,1,"dummy"
"92940",0,1,0,1,"dummy"
"92942",2,0,0,2,"dummy"
"92949",0,1,1,2,"dummy"
"92951",0,0,0,0,"dummy"
"92952",1,1,0,2,"dummy"
"92954",0,2,0,2,"dummy"
"92955",0,2,1,3,"dummy"
"92956",0,0,2,2,"dummy"
"92958",1,4,3,8,"dummy"
"92959",0,1,0,1,"dummy"
"92960",0,0,1,1,"dummy"
"92961",0,0,5,5,"dummy"
"92962",0,0,1,1,"dummy"
"92963",0,0,3,3,"dummy"
"92964",1,0,1,2,"dummy"
"92965",0,0,1,1,"dummy"
"92966",0,1,4,5,"dummy"
"92967",0,0,3,3,"dummy"
"92968",0,1,2,3,"dummy"
"92969",0,0,4,4,"dummy"
"92970",0,0,1,1,"dummy"
"92971",0,0,1,1,"dummy"
"92972",0,0,5,5,"dummy"
"92973",0,0,3,3,"dummy"
"92974",0,0,1,1,"dummy"
"92975",0,0,1,1,"dummy"
"92976",0,0,1,1,"dummy"
"92977",0,0,1,1,"dummy"
"92978",0,0,1,1,"dummy"
"92979",0,0,1,1,"dummy"
"92980",0,0,1,1,"dummy"
"92981",0,0,4,4,"dummy"
"92982",0,0,1,1,"dummy"
"92983",0,0,1,1,"dummy"
"92984",0,0,1,1,"dummy"
"92985",0,0,1,1,"dummy"
"92986",0,0,2,2,"dummy"
"92987",0,0,1,1,"dummy"
"92988",0,0,1,1,"dummy"
"92989",0,0,1,1,"dummy"
"92990",0,0,1,1,"dummy"
"92991",0,0,1,1,"dummy"
"92992",0,0,1,1,"dummy"
"92993",0,0,3,3,"dummy"
"92994",0,0,1,1,"dummy"
"92995",0,0,1,1,"dummy"
"92996",0,0,1,1,"dummy"
"92997",0,0,1,1,"dummy"
"92998",0,0,2,2,"dummy"
"92999",0,0,1,1,"dummy"
"93000",0,0,1,1,"dummy"
"93001",0,0,1,1,"dummy"
"93002",0,0,1,1,"dummy"
"93003",0,0,1,1,"dummy"
"93004",0,0,1,1,"dummy"
"93005",0,0,3,3,"dummy"
"93006",0,0,1,1,"dummy"
"93007",0,0,1,1,"dummy"
"93008",0,0,1,1,"dummy"
"93009",0,0,1,1,"dummy"
"93010",0,0,1,1,"dummy"
"93011",0,0,1,1,"dummy"
"93012",0,0,1,1,"dummy"
"93013",0,1,0,1,"dummy"
"93014",0,0,1,1,"dummy"
"93015",0,0,2,2,"dummy"
"93016",0,0,2,2,"dummy"
"93017",3,2,0,5,"dummy"
"93018",0,0,1,1,"dummy"
"93019",0,0,1,1,"dummy"
"93020",0,0,1,1,"dummy"
"93021",0,0,2,2,"dummy"
"93022",0,0,2,2,"dummy"
"93023",0,0,1,1,"dummy"
"93024",0,0,1,1,"dummy"
"93025",0,0,1,1,"dummy"
"93026",0,0,1,1,"dummy"
"93027",0,0,2,2,"dummy"
"93028",0,0,2,2,"dummy"
"93029",0,0,1,1,"dummy"
"93030",0,0,1,1,"dummy"
"93031",0,0,2,2,"dummy"
"93032",0,0,1,1,"dummy"
"93033",0,0,1,1,"dummy"
"93035",0,2,0,2,"dummy"
"93036",0,5,0,5,"dummy"
"93037",0,2,0,2,"dummy"
"93038",0,1,0,1,"dummy"
"93039",0,1,1,2,"dummy"
"93040",0,1,0,1,"dummy"
"93041",0,1,0,1,"dummy"
"93042",1,5,0,6,"dummy"
"93043",0,1,0,1,"dummy"
"93044",0,1,0,1,"dummy"
"93045",0,7,0,7,"dummy"
"93046",0,0,0,0,"dummy"
"93047",0,3,0,3,"dummy"
"93049",0,1,0,1,"dummy"
"93050",9,2,1,12,"dummy"
"93052",8,5,0,13,"dummy"
"93053",8,16,0,24,"dummy"
"93058",0,0,2,2,"dummy"
"93059",0,5,0,5,"dummy"
"93060",0,4,1,5,"dummy"
"93061",0,5,0,5,"dummy"
"93076",0,0,2,2,"dummy"
"93077",0,0,2,2,"dummy"
"93078",0,0,1,1,"dummy"
"93080",1,0,0,1,"dummy"
"93083",0,0,0,0,"dummy"
"93085",1,0,1,2,"dummy"
"93087",0,0,2,2,"dummy"
"93088",0,0,1,1,"dummy"
"93089",0,0,0,0,"dummy"
"93090",0,1,0,1,"dummy"
"93091",1,1,0,2,"dummy"
"93092",0,0,1,1,"dummy"
"93093",2,0,0,2,"dummy"
"93094",6,0,1,7,"dummy"
"93095",0,2,0,2,"dummy"
"93109",0,0,1,1,"dummy"
"93110",0,0,0,0,"dummy"
"93111",3,2,1,6,"dummy"
"93112",3,0,1,4,"dummy"
"93113",5,1,0,6,"dummy"
"93114",4,2,1,7,"dummy"
"93115",1,2,0,3,"dummy"
"93116",2,1,0,3,"dummy"
"93118",0,0,2,2,"dummy"
"93120",4,1,0,5,"dummy"
"93121",0,0,4,4,"dummy"
"93123",0,1,0,1,"dummy"
"93124",0,0,1,1,"dummy"
"93125",0,2,0,2,"dummy"
"93126",0,0,1,1,"dummy"
"93129",0,2,0,2,"dummy"
"93130",0,0,2,2,"dummy"
"93131",0,0,1,1,"dummy"
"93132",0,0,1,1,"dummy"
"93133",0,0,2,2,"dummy"
"93134",0,0,2,2,"dummy"
"93135",0,11,5,16,"dummy"
"93136",2,0,0,2,"dummy"
"93137",0,1,1,2,"dummy"
"93138",0,1,1,2,"dummy"
"93139",0,0,2,2,"dummy"
"93140",6,0,1,7,"dummy"
"93141",5,0,1,6,"dummy"
"93142",0,0,1,1,"dummy"
"93143",0,0,1,1,"dummy"
"93144",0,0,1,1,"dummy"
"93145",0,0,1,1,"dummy"
"93146",0,0,1,1,"dummy"
"93147",0,1,1,2,"dummy"
"93148",0,4,1,5,"dummy"
"93149",0,0,1,1,"dummy"
"93150",0,0,1,1,"dummy"
"93151",0,0,0,0,"dummy"
"93152",0,0,1,1,"dummy"
"93153",0,0,0,0,"dummy"
"93154",0,2,0,2,"dummy"
"93155",0,0,1,1,"dummy"
"93156",0,0,1,1,"dummy"
"93158",1,4,0,5,"dummy"
"93161",0,2,0,2,"dummy"
"93163",1,0,1,2,"dummy"
"93164",0,0,1,1,"dummy"
"93165",0,1,1,2,"dummy"
"93166",6,6,4,16,"dummy"
"93167",0,0,2,2,"dummy"
"93170",0,0,1,1,"dummy"
"93171",0,3,0,3,"dummy"
"93172",3,1,0,4,"dummy"
"93175",0,1,1,2,"dummy"
"93178",2,4,0,6,"dummy"
"93179",0,2,0,2,"dummy"
"93180",0,2,0,2,"dummy"
"93181",10,2,0,12,"dummy"
"93182",0,2,0,2,"dummy"
"93183",0,0,0,0,"dummy"
"93184",0,0,3,3,"dummy"
"93185",0,5,0,5,"dummy"
"93186",1,0,1,2,"dummy"
"93189",2,0,1,3,"dummy"
"93190",0,2,0,2,"dummy"
"93191",1,0,0,1,"dummy"
"93194",4,0,0,4,"dummy"
"93197",0,0,1,1,"dummy"
"93198",2,0,2,4,"dummy"
"93199",4,0,0,4,"dummy"
"93200",0,2,0,2,"dummy"
"93201",0,0,1,1,"dummy"
"93202",12,11,0,23,"dummy"
"93203",2,0,1,3,"dummy"
"93204",0,3,0,3,"dummy"
"93205",0,0,1,1,"dummy"
"93206",0,0,1,1,"dummy"
"93208",0,5,0,5,"dummy"
"93209",7,3,0,10,"dummy"
"93210",0,5,0,5,"dummy"
"93211",0,0,3,3,"dummy"
"93212",3,1,0,4,"dummy"
"93213",0,4,0,4,"dummy"
"93214",0,0,1,1,"dummy"
"93215",0,6,3,9,"dummy"
"93216",0,0,1,1,"dummy"
"93217",0,0,1,1,"dummy"
"93218",11,1,0,12,"dummy"
"93231",0,11,2,13,"dummy"
"93232",0,0,1,1,"dummy"
"93233",0,4,1,5,"dummy"
"93234",0,0,0,0,"dummy"
"93235",4,1,0,5,"dummy"
"93236",1,4,0,5,"dummy"
"93238",0,2,0,2,"dummy"
"93239",3,5,2,10,"dummy"
"93240",0,0,1,1,"dummy"
"93243",0,1,1,2,"dummy"
"93244",2,1,0,3,"dummy"
"93245",0,2,0,2,"dummy"
"93246",0,4,2,6,"dummy"
"93247",0,2,0,2,"dummy"
"93248",0,3,0,3,"dummy"
"93249",2,0,0,2,"dummy"
"93250",1,0,0,1,"dummy"
"93251",4,3,2,9,"dummy"
"93252",0,4,0,4,"dummy"
"93253",3,3,0,6,"dummy"
"93256",1,3,0,4,"dummy"
"93257",0,0,0,0,"dummy"
"93259",0,0,0,0,"dummy"
"93260",0,0,1,1,"dummy"
"93262",23,8,4,35,"dummy"
"93263",0,0,2,2,"dummy"
"93268",0,1,1,2,"dummy"
"93269",5,0,0,5,"dummy"
"93270",0,5,0,5,"dummy"
"93271",1,1,0,2,"dummy"
"93274",0,0,0,0,"dummy"
"93276",0,0,1,1,"dummy"
"93279",0,0,1,1,"dummy"
"93281",0,0,1,1,"dummy"
"93282",0,8,0,8,"dummy"
"93283",1,0,0,1,"dummy"
"93284",1,0,0,1,"dummy"
"93285",0,0,0,0,"dummy"
"93286",0,1,0,1,"dummy"
"93288",0,5,0,5,"dummy"
"93289",2,4,0,6,"dummy"
"93291",0,0,1,1,"dummy"
"93292",1,0,1,2,"dummy"
"93294",0,0,2,2,"dummy"
"93299",0,0,0,0,"dummy"
"93300",0,0,0,0,"dummy"
"93301",0,0,0,0,"dummy"
"93302",0,0,0,0,"dummy"
"93303",0,0,0,0,"dummy"
"93312",0,1,0,1,"dummy"
"93318",1,0,0,1,"dummy"
"93319",0,0,0,0,"dummy"
"93322",0,2,0,2,"dummy"
"93323",0,1,0,1,"dummy"
"93324",3,3,1,7,"dummy"
"93328",10,6,1,17,"dummy"
"93329",1,6,0,7,"dummy"
"93330",0,0,0,0,"dummy"
"93331",0,3,0,3,"dummy"
"93332",0,0,0,0,"dummy"
"93333",0,0,0,0,"dummy"
"93334",0,3,1,4,"dummy"
"93335",0,0,0,0,"dummy"
"93336",0,0,0,0,"dummy"
"93337",0,0,0,0,"dummy"
"93340",0,0,0,0,"dummy"
"93341",0,2,0,2,"dummy"
"93342",0,1,0,1,"dummy"
"93343",0,0,2,2,"dummy"
"93346",0,0,0,0,"dummy"
"93347",0,0,1,1,"dummy"
"93348",3,0,0,3,"dummy"
"93349",0,0,1,1,"dummy"
"93350",0,1,0,1,"dummy"
"93351",1,2,0,3,"dummy"
"93352",0,5,0,5,"dummy"
"93353",5,0,0,5,"dummy"
"93354",0,5,0,5,"dummy"
"93355",0,0,0,0,"dummy"
"93356",0,0,0,0,"dummy"
"93357",1,1,0,2,"dummy"
"93358",4,1,0,5,"dummy"
"93359",1,0,0,1,"dummy"
"93360",0,0,0,0,"dummy"
"93361",0,0,0,0,"dummy"
"93362",0,0,0,0,"dummy"
"93367",1,3,1,5,"dummy"
"93369",0,6,0,6,"dummy"
"93370",2,1,0,3,"dummy"
"93371",0,1,0,1,"dummy"
"93372",0,1,0,1,"dummy"
"93373",1,0,0,1,"dummy"
"93374",0,1,0,1,"dummy"
"93375",1,0,0,1,"dummy"
"93386",0,1,0,1,"dummy"
"93387",0,4,0,4,"dummy"
"93388",0,1,0,1,"dummy"
"93389",0,3,0,3,"dummy"
"93390",1,0,0,1,"dummy"
"93391",1,3,0,4,"dummy"
"93392",0,2,0,2,"dummy"
"93393",0,1,0,1,"dummy"
"93394",2,0,0,2,"dummy"
"93395",0,0,0,0,"dummy"
"93396",13,13,0,26,"dummy"
"93397",0,0,0,0,"dummy"
"93398",0,1,0,1,"dummy"
"93399",1,0,0,1,"dummy"
"93401",0,1,0,1,"dummy"
"93403",1,15,0,16,"dummy"
"93404",1,0,0,1,"dummy"
"93405",2,1,0,3,"dummy"
"93406",0,2,0,2,"dummy"
"93407",0,1,1,2,"dummy"
"93408",3,3,2,8,"dummy"
"93409",0,1,1,2,"dummy"
"93410",0,0,1,1,"dummy"
"93411",0,0,1,1,"dummy"
"93416",0,2,1,3,"dummy"
"93418",1,2,0,3,"dummy"
"93419",0,2,0,2,"dummy"
"93420",0,1,0,1,"dummy"
"93423",1,1,0,2,"dummy"
"93424",4,5,0,9,"dummy"
"93425",0,0,1,1,"dummy"
"93426",0,1,0,1,"dummy"
"93427",5,4,0,9,"dummy"
"93428",2,2,0,4,"dummy"
"93429",1,0,0,1,"dummy"
"93430",0,1,1,2,"dummy"
"93431",4,4,0,8,"dummy"
"93432",1,0,1,2,"dummy"
"93433",1,1,0,2,"dummy"
"93434",1,2,0,3,"dummy"
"93445",3,0,0,3,"dummy"
"93446",2,5,1,8,"dummy"
"93447",0,0,0,0,"dummy"
"93448",0,1,0,1,"dummy"
"93449",5,0,0,5,"dummy"
"93458",0,0,3,3,"dummy"
"93459",0,0,1,1,"dummy"
"93460",0,1,0,1,"dummy"
"93461",0,0,1,1,"dummy"
"93462",0,0,4,4,"dummy"
"93467",0,0,1,1,"dummy"
"93468",0,3,1,4,"dummy"
"93469",20,10,0,30,"dummy"
"93470",0,1,0,1,"dummy"
"93478",10,0,1,11,"dummy"
"93479",0,0,1,1,"dummy"
"93480",0,0,1,1,"dummy"
"93481",0,10,1,11,"dummy"
"93485",0,0,0,0,"dummy"
"93489",0,2,0,2,"dummy"
"93490",0,1,0,1,"dummy"
"93491",2,1,0,3,"dummy"
"93492",3,2,0,5,"dummy"
"93493",2,1,0,3,"dummy"
"93494",1,1,0,2,"dummy"
"93496",0,1,0,1,"dummy"
"93498",20,55,10,85,"dummy"
"93500",1,0,0,1,"dummy"
"93501",0,1,0,1,"dummy"
"93502",7,6,2,15,"dummy"
"93505",2,0,3,5,"dummy"
"93507",2,3,0,5,"dummy"
"93508",0,2,0,2,"dummy"
"93509",0,0,0,0,"dummy"
"93510",0,1,0,1,"dummy"
"93512",1,1,1,3,"dummy"
"93514",0,0,3,3,"dummy"
"93515",12,34,3,49,"dummy"
"93516",0,6,2,8,"dummy"
"93517",3,1,5,9,"dummy"
"93518",0,0,1,1,"dummy"
"93519",0,1,3,4,"dummy"
"93520",0,3,0,3,"dummy"
"93521",0,0,1,1,"dummy"
"93523",0,1,0,1,"dummy"
"93524",0,0,0,0,"dummy"
"93525",0,1,0,1,"dummy"
"93527",0,5,1,6,"dummy"
"93528",0,1,0,1,"dummy"
"93529",0,1,0,1,"dummy"
"93530",36,15,3,54,"dummy"
"93531",0,1,0,1,"dummy"
"93532",0,0,0,0,"dummy"
"93533",0,0,1,1,"dummy"
"93537",0,1,1,2,"dummy"
"93539",0,1,0,1,"dummy"
"93540",2,7,2,11,"dummy"
"93541",0,2,0,2,"dummy"
"93543",1,0,8,9,"dummy"
"93544",1,2,1,4,"dummy"
"93546",12,0,1,13,"dummy"
"93547",0,1,0,1,"dummy"
"93549",3,3,0,6,"dummy"
"93550",28,9,7,44,"dummy"
"93551",0,0,0,0,"dummy"
"93552",1,2,1,4,"dummy"
"93553",0,2,0,2,"dummy"
"93554",0,0,1,1,"dummy"
"93555",1,8,0,9,"dummy"
"93556",7,6,0,13,"dummy"
"93557",2,3,0,5,"dummy"
"93558",0,1,0,1,"dummy"
"93560",0,0,0,0,"dummy"
"93561",0,0,1,1,"dummy"
"93562",0,0,2,2,"dummy"
"93563",1,2,1,4,"dummy"
"93564",0,0,2,2,"dummy"
"93565",0,0,2,2,"dummy"
"93566",0,0,1,1,"dummy"
"93567",0,0,2,2,"dummy"
"93568",0,0,2,2,"dummy"
"93569",0,2,4,6,"dummy"
"93570",0,0,1,1,"dummy"
"93571",0,0,2,2,"dummy"
"93572",0,0,2,2,"dummy"
"93573",0,0,2,2,"dummy"
"93574",0,0,2,2,"dummy"
"93575",0,0,2,2,"dummy"
"93576",0,0,2,2,"dummy"
"93577",0,0,2,2,"dummy"
"93578",0,0,2,2,"dummy"
"93581",1,0,0,1,"dummy"
"93584",1,12,1,14,"dummy"
"93595",0,4,1,5,"dummy"
"93596",0,5,0,5,"dummy"
"93597",0,1,0,1,"dummy"
"93598",0,0,1,1,"dummy"
"93599",0,1,0,1,"dummy"
"93601",0,9,2,11,"dummy"
"93602",1,2,0,3,"dummy"
"93604",0,0,2,2,"dummy"
"93605",0,8,2,10,"dummy"
"93606",3,2,4,9,"dummy"
"93607",4,2,1,7,"dummy"
"93609",0,1,0,1,"dummy"
"93610",0,0,2,2,"dummy"
"93611",0,0,1,1,"dummy"
"93612",0,0,3,3,"dummy"
"93613",1,2,0,3,"dummy"
"93624",1,4,6,11,"dummy"
"93638",0,0,1,1,"dummy"
"93639",1,10,1,12,"dummy"
"93640",0,0,1,1,"dummy"
"93641",3,0,1,4,"dummy"
"93642",0,1,0,1,"dummy"
"93643",0,2,0,2,"dummy"
"93644",0,4,1,5,"dummy"
"93645",1,0,0,1,"dummy"
"93646",0,1,0,1,"dummy"
"93649",0,0,1,1,"dummy"
"93650",4,3,1,8,"dummy"
"93651",1,0,0,1,"dummy"
"93652",0,3,0,3,"dummy"
"93653",0,0,2,2,"dummy"
"93664",1,3,0,4,"dummy"
"93665",0,2,0,2,"dummy"
"93668",1,3,0,4,"dummy"
"93724",0,4,0,4,"dummy"
"93734",0,1,1,2,"dummy"
"93735",4,6,5,15,"dummy"
"93741",2,7,3,12,"dummy"
"93747",2,2,0,4,"dummy"
"93748",1,1,0,2,"dummy"
"93749",1,1,0,2,"dummy"
"93750",0,1,0,1,"dummy"
"93751",0,3,0,3,"dummy"
"93752",2,0,0,2,"dummy"
"93753",0,2,0,2,"dummy"
"93754",0,1,0,1,"dummy"
"93755",0,2,0,2,"dummy"
"93760",2,3,0,5,"dummy"
"93761",0,2,0,2,"dummy"
"93762",0,0,0,0,"dummy"
"93813",0,0,1,1,"dummy"
"93814",0,0,0,0,"dummy"
"93815",0,0,1,1,"dummy"
"93816",0,0,0,0,"dummy"
"93840",0,0,1,1,"dummy"
"93841",7,3,0,10,"dummy"
"93842",0,1,0,1,"dummy"
"93615",0,2,0,2,"dummy"
"93616",2,0,0,2,"dummy"
"93617",0,0,0,0,"dummy"
"93620",0,2,0,2,"dummy"
"93626",0,32,0,32,"dummy"
"93627",0,1,0,1,"dummy"
"93628",0,1,0,1,"dummy"
"93629",3,2,0,5,"dummy"
"93630",1,0,0,1,"dummy"
"93631",0,1,0,1,"dummy"
"93632",0,2,0,2,"dummy"
"93633",0,1,0,1,"dummy"
"93634",0,1,0,1,"dummy"
"93655",1,0,0,1,"dummy"
"93656",0,1,0,1,"dummy"
"93659",0,0,0,0,"dummy"
"93660",0,0,0,0,"dummy"
"93661",0,0,0,0,"dummy"
"93662",0,0,0,0,"dummy"
"93670",0,4,0,4,"dummy"
"93671",1,0,0,1,"dummy"
"93672",2,2,1,5,"dummy"
"93677",0,1,0,1,"dummy"
"93680",0,0,1,1,"dummy"
"93681",0,0,1,1,"dummy"
"93682",0,0,2,2,"dummy"
"93722",5,0,0,5,"dummy"
"93730",0,0,0,0,"dummy"
"93731",0,3,1,4,"dummy"
"93732",0,1,0,1,"dummy"
"93770",0,1,0,1,"dummy"
"93792",0,0,1,1,"dummy"
"93793",0,0,0,0,"dummy"
"93794",0,1,0,1,"dummy"
"93795",1,2,0,3,"dummy"
"93796",0,1,0,1,"dummy"
"93797",1,10,1,12,"dummy"
"93798",1,1,0,2,"dummy"
"93799",0,0,1,1,"dummy"
"93800",0,0,1,1,"dummy"
"93801",0,1,0,1,"dummy"
"93802",7,2,0,9,"dummy"
"93803",0,1,0,1,"dummy"
"93804",0,0,1,1,"dummy"
"93805",0,0,1,1,"dummy"
"93806",0,0,1,1,"dummy"
"93807",0,0,2,2,"dummy"
"93808",0,0,1,1,"dummy"
"93811",0,1,0,1,"dummy"
"93818",0,0,0,0,"dummy"
"93844",0,0,1,1,"dummy"
"93845",1,20,0,21,"dummy"
"93846",0,0,0,0,"dummy"
"93847",0,0,1,1,"dummy"
"93848",1,0,0,1,"dummy"
"93849",0,1,0,1,"dummy"
"93850",21,2,0,23,"dummy"
"93851",1,21,0,22,"dummy"
"93852",0,2,0,2,"dummy"
"93853",0,0,0,0,"dummy"
"93854",0,4,0,4,"dummy"
"93855",0,0,0,0,"dummy"
"93908",4,1,0,5,"dummy"
"93909",2,10,2,14,"dummy"
"93911",0,0,1,1,"dummy"
"93912",0,0,1,1,"dummy"
"93913",0,0,1,1,"dummy"
"93914",0,0,1,1,"dummy"
"93915",0,0,1,1,"dummy"
"93916",0,0,1,1,"dummy"
"93917",0,0,1,1,"dummy"
"93918",0,2,2,4,"dummy"
"93919",0,0,1,1,"dummy"
"93920",0,0,0,0,"dummy"
"93925",0,1,0,1,"dummy"
"93926",0,1,0,1,"dummy"
"93928",6,0,0,6,"dummy"
"93929",2,5,2,9,"dummy"
"93933",1,5,0,6,"dummy"
"93936",6,3,1,10,"dummy"
"93937",0,0,1,1,"dummy"
"93938",3,2,0,5,"dummy"
"93939",2,1,5,8,"dummy"
"93940",5,2,0,7,"dummy"
"93941",0,19,0,19,"dummy"
"93942",8,2,1,11,"dummy"
"93943",0,1,0,1,"dummy"
"93944",2,5,0,7,"dummy"
"93945",0,1,0,1,"dummy"
"93946",0,0,1,1,"dummy"
"93948",1,2,0,3,"dummy"
"93949",1,2,0,3,"dummy"
"93954",0,0,2,2,"dummy"
"93973",0,1,5,6,"dummy"
"93975",0,1,0,1,"dummy"
"93976",1,2,0,3,"dummy"
"94002",1,1,0,2,"dummy"
"94003",0,5,2,7,"dummy"
"94004",10,4,1,15,"dummy"
"94005",3,0,3,6,"dummy"
"94007",0,2,0,2,"dummy"
"94008",0,0,0,0,"dummy"
"94009",2,1,0,3,"dummy"
"94010",1,0,0,1,"dummy"
"94011",0,0,0,0,"dummy"
"94014",8,0,0,8,"dummy"
"94015",0,0,2,2,"dummy"
"94016",0,41,0,41,"dummy"
"94017",1,11,0,12,"dummy"
"94018",2,4,0,6,"dummy"
"94019",22,24,4,50,"dummy"
"94020",0,8,0,8,"dummy"
"94021",0,22,0,22,"dummy"
"94022",13,1,0,14,"dummy"
"94023",1,3,0,4,"dummy"
"94024",5,1,2,8,"dummy"
"94025",3,0,0,3,"dummy"
"94026",7,13,6,26,"dummy"
"94027",0,0,1,1,"dummy"
"94028",1,4,1,6,"dummy"
"94029",0,1,0,1,"dummy"
"94030",6,8,3,17,"dummy"
"94031",0,5,0,5,"dummy"
"94040",2,2,0,4,"dummy"
"94041",0,8,0,8,"dummy"
"94042",1,2,0,3,"dummy"
"94086",1,8,0,9,"dummy"
"94094",0,0,1,1,"dummy"
"94095",0,0,2,2,"dummy"
"94096",6,3,3,12,"dummy"
"94097",1,2,0,3,"dummy"
"94098",0,0,0,0,"dummy"
"94099",1,2,0,3,"dummy"
"94100",0,0,0,0,"dummy"
"94101",0,3,0,3,"dummy"
"94102",1,6,3,10,"dummy"
"94103",0,1,0,1,"dummy"
"94104",0,0,1,1,"dummy"
"94105",0,0,0,0,"dummy"
"94110",2,4,0,6,"dummy"
"94111",2,2,0,4,"dummy"
"94033",0,7,0,7,"dummy"
"94034",0,0,1,1,"dummy"
"94035",0,1,1,2,"dummy"
"94036",0,0,0,0,"dummy"
"94037",5,0,0,5,"dummy"
"94038",1,0,0,1,"dummy"
"94044",0,2,0,2,"dummy"
"94045",0,0,0,0,"dummy"
"94046",0,0,0,0,"dummy"
"94047",4,1,0,5,"dummy"
"94048",1,0,0,1,"dummy"
"94049",0,0,0,0,"dummy"
"94050",0,0,0,0,"dummy"
"94079",0,2,0,2,"dummy"
"94080",2,0,0,2,"dummy"
"94081",0,2,0,2,"dummy"
"94082",1,2,0,3,"dummy"
"94088",2,0,3,5,"dummy"
"94107",1,0,1,2,"dummy"
"94108",1,6,1,8,"dummy"
"94115",1,3,2,6,"dummy"
"94116",2,1,1,4,"dummy"
"94117",2,0,0,2,"dummy"
"94125",2,0,3,5,"dummy"
"94126",1,0,0,1,"dummy"
"94127",0,1,0,1,"dummy"
"94128",0,1,1,2,"dummy"
"94134",0,0,1,1,"dummy"
"94135",0,1,0,1,"dummy"
"94136",0,5,0,5,"dummy"
"94138",0,1,0,1,"dummy"
"94139",0,0,0,0,"dummy"
"94140",25,9,1,35,"dummy"
"94141",1,2,0,3,"dummy"
"94142",0,3,0,3,"dummy"
"94143",0,1,0,1,"dummy"
"94144",0,0,1,1,"dummy"
"94145",0,0,1,1,"dummy"
"94147",2,6,0,8,"dummy"
"94148",0,1,0,1,"dummy"
"94149",0,0,1,1,"dummy"
"94150",0,1,0,1,"dummy"
"94151",7,4,0,11,"dummy"
"94153",0,0,1,1,"dummy"
"94154",0,0,1,1,"dummy"
"94157",0,0,0,0,"dummy"
"94160",2,9,3,14,"dummy"
"94161",10,0,1,11,"dummy"
"94163",1,1,0,2,"dummy"
"94164",0,1,0,1,"dummy"
"94165",2,2,0,4,"dummy"
"94166",0,0,4,4,"dummy"
"94167",1,5,1,7,"dummy"
"94170",0,0,3,3,"dummy"
"94171",0,1,0,1,"dummy"
"94172",0,0,1,1,"dummy"
"94173",0,2,0,2,"dummy"
"94174",1,0,0,1,"dummy"
"94175",1,10,1,12,"dummy"
"94185",2,0,0,2,"dummy"
"94186",0,0,0,0,"dummy"
"94187",0,2,0,2,"dummy"
"94188",6,0,4,10,"dummy"
"94190",0,1,0,1,"dummy"
"94193",0,2,0,2,"dummy"
"94194",0,0,1,1,"dummy"
"94195",0,0,2,2,"dummy"
"94196",0,0,1,1,"dummy"
"94197",1,0,0,1,"dummy"
"94198",0,0,1,1,"dummy"
"94199",0,0,1,1,"dummy"
"94200",0,1,0,1,"dummy"
"94201",0,0,1,1,"dummy"
"94202",0,3,0,3,"dummy"
"94203",0,0,0,0,"dummy"
"94204",0,0,0,0,"dummy"
"94205",0,2,0,2,"dummy"
"94206",0,0,1,1,"dummy"
"94208",0,1,0,1,"dummy"
"94245",0,0,0,0,"dummy"
"94249",0,0,1,1,"dummy"
"94252",1,0,0,1,"dummy"
"94253",4,0,0,4,"dummy"
"94255",0,0,1,1,"dummy"
"94256",0,0,1,1,"dummy"
"94257",0,0,1,1,"dummy"
"94259",1,0,0,1,"dummy"
"94260",2,0,0,2,"dummy"
"94268",0,1,0,1,"dummy"
"94269",11,1,3,15,"dummy"
"94275",0,3,1,4,"dummy"
"94276",0,1,0,1,"dummy"
"94277",0,0,1,1,"dummy"
"94278",1,2,1,4,"dummy"
"94279",5,7,0,12,"dummy"
"94280",2,0,0,2,"dummy"
"94283",5,3,2,10,"dummy"
"94284",1,0,0,1,"dummy"
"94285",0,4,0,4,"dummy"
"94286",0,0,4,4,"dummy"
"94287",0,2,0,2,"dummy"
"94288",2,0,0,2,"dummy"
"94289",0,0,3,3,"dummy"
"94290",1,0,0,1,"dummy"
"94294",0,0,0,0,"dummy"
"94296",0,0,1,1,"dummy"
"94297",0,2,0,2,"dummy"
"94298",11,1,1,13,"dummy"
"94300",0,0,1,1,"dummy"
"94301",0,0,0,0,"dummy"
"94302",2,0,0,2,"dummy"
"94303",0,1,0,1,"dummy"
"94304",0,0,0,0,"dummy"
"94305",0,0,0,0,"dummy"
"94306",3,0,0,3,"dummy"
"94307",0,0,0,0,"dummy"
"94308",0,0,1,1,"dummy"
"94309",0,0,1,1,"dummy"
"94310",1,0,0,1,"dummy"
"94312",3,4,0,7,"dummy"
"94313",0,0,0,0,"dummy"
"94314",0,0,1,1,"dummy"
"94318",2,0,0,2,"dummy"
"94319",2,1,2,5,"dummy"
"94327",0,0,1,1,"dummy"
"94328",0,0,0,0,"dummy"
"94330",0,0,0,0,"dummy"
"94331",0,0,1,1,"dummy"
"94332",0,0,1,1,"dummy"
"94333",1,0,0,1,"dummy"
"94334",0,3,0,3,"dummy"
"94338",0,0,4,4,"dummy"
"94340",0,0,1,1,"dummy"
"94343",0,5,0,5,"dummy"
"94344",7,6,0,13,"dummy"
"94347",0,2,0,2,"dummy"
"94348",10,2,1,13,"dummy"
"94352",0,0,1,1,"dummy"
"94363",0,1,0,1,"dummy"
"94371",0,7,0,7,"dummy"
"94372",0,1,0,1,"dummy"
"94373",0,1,0,1,"dummy"
"94375",0,0,1,1,"dummy"
"94376",0,2,0,2,"dummy"
"94377",2,1,2,5,"dummy"
"94402",0,0,1,1,"dummy"
"94403",0,2,0,2,"dummy"
"94404",0,0,1,1,"dummy"
"94405",1,2,0,3,"dummy"
"94406",0,1,0,1,"dummy"
"94408",6,8,1,15,"dummy"
"94409",0,0,1,1,"dummy"
"94410",0,0,0,0,"dummy"
"94411",0,0,0,0,"dummy"
"94412",0,0,1,1,"dummy"
"94438",0,3,2,5,"dummy"
"94439",0,2,0,2,"dummy"
"94440",0,0,1,1,"dummy"
"94441",0,0,1,1,"dummy"
"94442",0,4,0,4,"dummy"
"94443",0,0,2,2,"dummy"
"94444",0,1,0,1,"dummy"
"94445",0,0,1,1,"dummy"
"94446",0,0,1,1,"dummy"
"94447",0,0,1,1,"dummy"
"94448",1,2,0,3,"dummy"
"94449",0,1,0,1,"dummy"
"94450",1,2,0,3,"dummy"
"94451",0,0,2,2,"dummy"
"94452",0,0,1,1,"dummy"
"94453",0,0,1,1,"dummy"
"94454",1,0,4,5,"dummy"
"94459",1,0,1,2,"dummy"
"94462",0,1,0,1,"dummy"
"94463",1,0,1,2,"dummy"
"94466",0,1,0,1,"dummy"
"94467",0,0,0,0,"dummy"
"94468",5,1,1,7,"dummy"
"94469",7,0,0,7,"dummy"
"94471",1,15,0,16,"dummy"
"94473",2,6,0,8,"dummy"
"94477",0,0,2,2,"dummy"
"94478",6,5,1,12,"dummy"
"94479",0,0,3,3,"dummy"
"94480",0,0,1,1,"dummy"
"94481",0,0,2,2,"dummy"
"94482",0,0,3,3,"dummy"
"94483",0,0,1,1,"dummy"
"94484",0,1,1,2,"dummy"
"94487",0,10,0,10,"dummy"
"94488",0,1,0,1,"dummy"
"94490",0,1,0,1,"dummy"
"94492",1,1,1,3,"dummy"
"94493",0,0,2,2,"dummy"
"94494",9,4,3,16,"dummy"
"94495",0,1,0,1,"dummy"
"94496",0,2,0,2,"dummy"
"94498",0,0,1,1,"dummy"
"94499",0,0,1,1,"dummy"
"94500",0,0,1,1,"dummy"
"94501",0,0,1,1,"dummy"
"94502",1,0,0,1,"dummy"
"94503",0,0,2,2,"dummy"
"94505",0,0,2,2,"dummy"
"94506",0,0,1,1,"dummy"
"94507",0,0,1,1,"dummy"
"94508",2,1,1,4,"dummy"
"94510",2,2,1,5,"dummy"
"94511",0,1,0,1,"dummy"
"94513",0,0,1,1,"dummy"
"94517",1,7,0,8,"dummy"
"94518",0,1,0,1,"dummy"
"94529",1,2,0,3,"dummy"
"94530",0,0,3,3,"dummy"
"94531",0,1,0,1,"dummy"
"94532",0,4,0,4,"dummy"
"94533",3,1,1,5,"dummy"
"94534",0,0,3,3,"dummy"
"94564",0,0,1,1,"dummy"
"94565",1,1,0,2,"dummy"
"94567",0,1,0,1,"dummy"
"94582",0,0,0,0,"dummy"
"94585",0,3,0,3,"dummy"
"94586",2,3,0,5,"dummy"
"94587",0,0,0,0,"dummy"
"94588",0,1,0,1,"dummy"
"94589",8,2,0,10,"dummy"
"94592",0,1,0,1,"dummy"
"94601",0,1,0,1,"dummy"
"94620",11,31,3,45,"dummy"
"94621",0,2,0,2,"dummy"
"94622",1,4,0,5,"dummy"
"94623",0,3,0,3,"dummy"
"94624",0,1,0,1,"dummy"
"94625",1,2,1,4,"dummy"
"94632",2,0,3,5,"dummy"
"94661",2,0,0,2,"dummy"
"94666",5,27,8,40,"dummy"
"94667",1,7,5,13,"dummy"
"94668",0,1,0,1,"dummy"
"94669",0,5,3,8,"dummy"
"94670",0,1,0,1,"dummy"
"94671",1,0,0,1,"dummy"
"94672",0,0,0,0,"dummy"
"94673",0,0,1,1,"dummy"
"94674",1,2,0,3,"dummy"
"94675",1,1,0,2,"dummy"
"94676",0,4,2,6,"dummy"
"94677",1,11,4,16,"dummy"
"94678",0,8,2,10,"dummy"
"94679",0,3,0,3,"dummy"
"94680",19,0,0,19,"dummy"
"94685",0,1,0,1,"dummy"
"94686",0,1,0,1,"dummy"
"94692",0,2,0,2,"dummy"
"94693",1,4,0,5,"dummy"
"94694",0,3,0,3,"dummy"
"94695",0,0,1,1,"dummy"
"94703",0,1,0,1,"dummy"
"94704",0,1,0,1,"dummy"
"94714",0,6,0,6,"dummy"
"94715",0,0,1,1,"dummy"
"94716",0,8,0,8,"dummy"
"94719",0,0,2,2,"dummy"
"94720",0,2,0,2,"dummy"
"94721",0,0,1,1,"dummy"
"94722",0,1,1,2,"dummy"
"94723",0,0,2,2,"dummy"
"94724",0,1,0,1,"dummy"
"94725",0,1,0,1,"dummy"
"94726",0,8,0,8,"dummy"
"94727",0,1,0,1,"dummy"
"94728",0,1,0,1,"dummy"
"94729",0,1,0,1,"dummy"
"94730",1,10,0,11,"dummy"
"94731",12,10,4,26,"dummy"
"94732",0,0,0,0,"dummy"
"94754",0,1,0,1,"dummy"
"94765",0,4,0,4,"dummy"
"94771",2,0,1,3,"dummy"
"94772",1,2,0,3,"dummy"
"94773",0,0,1,1,"dummy"
"94780",2,4,0,6,"dummy"
"94781",0,2,0,2,"dummy"
"94782",0,2,0,2,"dummy"
"94783",10,2,0,12,"dummy"
"94784",0,2,0,2,"dummy"
"94785",0,0,0,0,"dummy"
"94786",0,0,3,3,"dummy"
"94787",0,5,0,5,"dummy"
"94802",0,4,0,4,"dummy"
"94803",1,0,0,1,"dummy"
"94804",0,1,2,3,"dummy"
"94805",1,0,1,2,"dummy"
"94812",0,1,1,2,"dummy"
"94813",0,0,0,0,"dummy"
"94594",0,0,1,1,"dummy"
"94595",0,0,1,1,"dummy"
"94596",0,0,1,1,"dummy"
"94599",0,0,0,0,"dummy"
"94603",0,0,0,0,"dummy"
"94604",0,0,3,3,"dummy"
"94605",0,0,1,1,"dummy"
"94606",9,0,0,9,"dummy"
"94607",36,0,0,36,"dummy"
"94608",0,0,0,0,"dummy"
"94609",1,0,0,1,"dummy"
"94610",0,0,3,3,"dummy"
"94611",0,0,1,1,"dummy"
"94612",0,0,0,0,"dummy"
"94613",0,0,0,0,"dummy"
"94614",0,0,0,0,"dummy"
"94615",0,0,1,1,"dummy"
"94616",0,0,1,1,"dummy"
"94617",0,0,0,0,"dummy"
"94618",71,17,9,97,"dummy"
"94638",0,1,0,1,"dummy"
"94688",0,1,0,1,"dummy"
"94689",0,7,0,7,"dummy"
"94690",0,0,1,1,"dummy"
"94699",0,2,0,2,"dummy"
"94700",0,0,0,0,"dummy"
"94701",1,1,0,2,"dummy"
"94708",0,1,0,1,"dummy"
"94709",0,0,1,1,"dummy"
"94712",0,2,0,2,"dummy"
"94736",0,1,0,1,"dummy"
"94737",0,0,1,1,"dummy"
"94738",1,0,0,1,"dummy"
"94741",0,3,1,4,"dummy"
"94744",6,5,1,12,"dummy"
"94745",0,1,1,2,"dummy"
"94746",0,0,1,1,"dummy"
"94747",1,0,1,2,"dummy"
"94748",4,4,0,8,"dummy"
"94749",1,0,0,1,"dummy"
"94750",2,2,0,4,"dummy"
"94751",2,1,0,3,"dummy"
"94752",2,2,0,4,"dummy"
"94760",1,2,0,3,"dummy"
"94761",0,0,1,1,"dummy"
"94789",0,1,1,2,"dummy"
"94790",0,0,2,2,"dummy"
"94791",0,0,2,2,"dummy"
"94794",1,0,1,2,"dummy"
"94795",0,0,2,2,"dummy"
"94796",1,0,0,1,"dummy"
"94797",0,3,4,7,"dummy"
"94798",0,2,0,2,"dummy"
"94838",3,1,0,4,"dummy"
"94839",4,4,0,8,"dummy"
"94840",0,1,0,1,"dummy"
"94841",0,1,0,1,"dummy"
"94842",18,17,1,36,"dummy"
"94843",4,21,2,27,"dummy"
"94844",4,4,1,9,"dummy"
"94845",5,1,0,6,"dummy"
"94846",2,3,0,5,"dummy"
"94847",0,3,0,3,"dummy"
"94848",3,1,0,4,"dummy"
"94849",0,0,0,0,"dummy"
"94850",0,1,0,1,"dummy"
"94851",0,1,0,1,"dummy"
"94852",1,10,0,11,"dummy"
"94855",0,1,1,2,"dummy"
"94814",1,1,1,3,"dummy"
"94817",0,12,0,12,"dummy"
"94818",0,1,0,1,"dummy"
"94819",2,2,0,4,"dummy"
"94820",0,3,0,3,"dummy"
"94821",0,0,1,1,"dummy"
"94822",0,2,0,2,"dummy"
"94823",2,0,0,2,"dummy"
"94824",0,1,0,1,"dummy"
"94825",0,0,1,1,"dummy"
"94826",3,1,0,4,"dummy"
"94827",0,0,1,1,"dummy"
"94828",27,0,1,28,"dummy"
"94829",0,0,0,0,"dummy"
"94830",0,0,0,0,"dummy"
"94831",0,0,0,0,"dummy"
"94832",0,5,0,5,"dummy"
"94833",0,1,0,1,"dummy"
"94834",0,1,0,1,"dummy"
"94835",0,0,1,1,"dummy"
"94836",0,5,0,5,"dummy"
"94863",0,0,0,0,"dummy"
"94864",0,0,0,0,"dummy"
"94868",2,2,1,5,"dummy"
"94869",10,3,2,15,"dummy"
"94870",0,1,0,1,"dummy"
"94871",0,1,0,1,"dummy"
"94872",0,2,0,2,"dummy"
"94873",0,2,0,2,"dummy"
"94874",0,1,0,1,"dummy"
"94875",0,3,0,3,"dummy"
"94876",2,1,0,3,"dummy"
"94877",0,1,0,1,"dummy"
"94878",0,1,0,1,"dummy"
"94879",1,0,0,1,"dummy"
"94880",0,1,0,1,"dummy"
"94881",0,1,0,1,"dummy"
"94882",0,1,1,2,"dummy"
"94883",2,2,0,4,"dummy"
"94884",2,2,0,4,"dummy"
"94885",0,3,0,3,"dummy"
"94890",0,2,0,2,"dummy"
"94891",0,0,1,1,"dummy"
"94892",0,1,0,1,"dummy"
"94893",0,0,1,1,"dummy"
"94894",0,0,0,0,"dummy"
"94895",0,0,0,0,"dummy"
"94898",1,0,0,1,"dummy"
"94911",1,2,2,5,"dummy"
"94912",1,0,0,1,"dummy"
"94913",3,0,2,5,"dummy"
"94917",24,3,4,31,"dummy"
"94931",1,2,0,3,"dummy"
"94932",3,0,1,4,"dummy"
"94936",0,0,1,1,"dummy"
"94937",1,0,0,1,"dummy"
"94938",0,0,1,1,"dummy"
"94939",0,1,0,1,"dummy"
"94940",1,0,0,1,"dummy"
"94941",0,2,0,2,"dummy"
"94942",0,0,1,1,"dummy"
"94943",1,0,0,1,"dummy"
"94944",0,1,2,3,"dummy"
"94945",0,0,1,1,"dummy"
"94946",1,0,0,1,"dummy"
"94947",0,1,0,1,"dummy"
"94948",0,1,0,1,"dummy"
"94949",0,1,0,1,"dummy"
"94950",0,1,0,1,"dummy"
"94951",20,5,0,25,"dummy"
"94952",0,1,0,1,"dummy"
"94953",0,1,0,1,"dummy"
"94966",1,0,0,1,"dummy"
"94967",0,1,0,1,"dummy"
"95001",2,2,0,4,"dummy"
"95006",1,5,3,9,"dummy"
"95007",1,1,0,2,"dummy"
"95014",0,1,0,1,"dummy"
"94856",5,0,1,6,"dummy"
"94857",0,1,2,3,"dummy"
"94866",0,2,3,5,"dummy"
"94887",1,2,0,3,"dummy"
"94888",1,3,0,4,"dummy"
"94915",0,0,1,1,"dummy"
"94921",0,1,1,2,"dummy"
"94922",0,1,0,1,"dummy"
"94923",0,0,0,0,"dummy"
"94924",10,12,3,25,"dummy"
"94925",0,0,0,0,"dummy"
"94928",1,8,4,13,"dummy"
"94929",0,2,0,2,"dummy"
"94934",0,1,0,1,"dummy"
"94955",9,2,3,14,"dummy"
"94961",2,0,3,5,"dummy"
"94962",1,0,0,1,"dummy"
"94963",0,1,0,1,"dummy"
"94964",0,1,1,2,"dummy"
"94969",0,1,0,1,"dummy"
"94970",1,0,0,1,"dummy"
"95003",0,1,0,1,"dummy"
"95004",0,0,0,0,"dummy"
"95016",1,0,1,2,"dummy"
"95019",0,0,0,0,"dummy"
"95020",0,1,2,3,"dummy"
"95021",0,0,0,0,"dummy"
"95022",0,1,0,1,"dummy"
"95023",4,0,2,6,"dummy"
"95024",1,0,0,1,"dummy"
"95025",0,0,0,0,"dummy"
"95030",0,16,0,16,"dummy"
"95031",14,21,9,44,"dummy"
"95032",10,1,4,15,"dummy"
"95033",3,16,5,24,"dummy"
"95034",32,9,10,51,"dummy"
"95035",0,0,0,0,"dummy"
"95058",1,0,0,1,"dummy"
"95075",0,6,0,6,"dummy"
"95076",5,2,4,11,"dummy"
"95080",6,3,2,11,"dummy"
"95083",6,10,4,20,"dummy"
"95084",18,12,4,34,"dummy"
"95085",23,15,3,41,"dummy"
"95086",0,1,0,1,"dummy"
"95087",34,15,8,57,"dummy"
"95121",0,0,0,0,"dummy"
"95122",0,0,0,0,"dummy"
"95123",2,0,1,3,"dummy"
"95133",0,2,1,3,"dummy"
"95134",0,0,0,0,"dummy"
"95135",6,0,1,7,"dummy"
"95136",0,1,0,1,"dummy"
"95137",0,0,1,1,"dummy"
"95138",0,0,1,1,"dummy"
"95139",0,0,1,1,"dummy"
"95140",0,0,1,1,"dummy"
"95141",0,0,1,1,"dummy"
"95142",0,0,1,1,"dummy"
"95143",0,0,1,1,"dummy"
"95144",0,0,1,1,"dummy"
"95145",0,0,1,1,"dummy"
"95146",0,0,1,1,"dummy"
"95147",0,0,1,1,"dummy"
"95148",2,0,0,2,"dummy"
"95149",0,0,1,1,"dummy"
"95150",0,0,1,1,"dummy"
"95151",0,0,1,1,"dummy"
"95152",0,1,0,1,"dummy"
"95153",0,0,1,1,"dummy"
"95154",0,0,1,1,"dummy"
"95155",0,0,1,1,"dummy"
"95156",0,0,1,1,"dummy"
"95157",0,0,1,1,"dummy"
"95078",0,1,0,1,"dummy"
"95089",0,0,1,1,"dummy"
"95104",3,2,3,8,"dummy"
"95105",10,4,3,17,"dummy"
"95106",0,1,0,1,"dummy"
"95107",0,0,1,1,"dummy"
"95108",0,0,1,1,"dummy"
"95109",2,0,2,4,"dummy"
"95110",0,0,0,0,"dummy"
"95111",0,2,0,2,"dummy"
"95112",2,0,0,2,"dummy"
"95113",1,0,0,1,"dummy"
"95116",1,2,0,3,"dummy"
"95117",0,1,0,1,"dummy"
"95118",0,0,0,0,"dummy"
"95119",0,0,1,1,"dummy"
"95125",0,0,1,1,"dummy"
"95126",2,0,0,2,"dummy"
"95127",2,5,2,9,"dummy"
"95128",6,0,1,7,"dummy"
"95129",0,1,1,2,"dummy"
"95205",3,0,6,9,"dummy"
"95214",1,1,0,2,"dummy"
"95228",0,0,1,1,"dummy"
"95229",0,0,1,1,"dummy"
"95230",0,0,1,1,"dummy"
"95234",4,3,0,7,"dummy"
"95310",9,4,0,13,"dummy"
"95311",6,2,1,9,"dummy"
"95312",2,7,1,10,"dummy"
"95313",0,2,0,2,"dummy"
"95314",8,16,0,24,"dummy"
"95317",5,6,0,11,"dummy"
"95318",0,2,1,3,"dummy"
"95319",4,10,2,16,"dummy"
"95320",4,4,0,8,"dummy"
"95348",0,0,0,0,"dummy"
"95351",1,1,0,2,"dummy"
"95352",0,0,0,0,"dummy"
"95353",1,0,0,1,"dummy"
"95365",0,1,1,2,"dummy"
"95366",10,11,2,23,"dummy"
"95371",0,5,3,8,"dummy"
"95377",0,1,2,3,"dummy"
"95378",0,0,0,0,"dummy"
"95379",0,1,0,1,"dummy"
"95380",4,0,2,6,"dummy"
"95381",1,0,0,1,"dummy"
"95382",0,0,0,0,"dummy"
"95383",0,0,0,0,"dummy"
"95409",8,17,4,29,"dummy"
"95410",4,2,0,6,"dummy"
"95411",2,3,0,5,"dummy"
"95412",3,2,0,5,"dummy"
"95413",0,0,1,1,"dummy"
"95414",0,0,2,2,"dummy"
"95415",0,0,2,2,"dummy"
"95416",0,0,1,1,"dummy"
"95417",0,0,3,3,"dummy"
"95418",0,0,1,1,"dummy"
"95419",2,4,0,6,"dummy"
"95420",0,4,0,4,"dummy"
"95421",0,0,0,0,"dummy"
"95422",0,0,2,2,"dummy"
"95423",0,0,0,0,"dummy"
"95424",0,0,0,0,"dummy"
"95425",0,0,0,0,"dummy"
"95426",6,9,1,16,"dummy"
"95427",0,2,0,2,"dummy"
"95428",2,0,0,2,"dummy"
"95429",0,0,2,2,"dummy"
"95430",1,0,0,1,"dummy"
"95431",0,1,2,3,"dummy"
"95158",0,0,1,1,"dummy"
"95159",0,0,1,1,"dummy"
"95160",0,0,1,1,"dummy"
"95161",0,0,1,1,"dummy"
"95162",0,0,1,1,"dummy"
"95163",0,0,1,1,"dummy"
"95164",0,0,1,1,"dummy"
"95165",0,0,1,1,"dummy"
"95166",0,0,1,1,"dummy"
"95167",0,0,1,1,"dummy"
"95168",0,0,1,1,"dummy"
"95169",0,0,1,1,"dummy"
"95170",0,0,1,1,"dummy"
"95171",0,0,1,1,"dummy"
"95172",0,0,1,1,"dummy"
"95173",0,0,1,1,"dummy"
"95174",0,0,1,1,"dummy"
"95175",0,0,1,1,"dummy"
"95176",0,0,1,1,"dummy"
"95177",0,0,1,1,"dummy"
"95178",0,0,1,1,"dummy"
"95179",0,0,1,1,"dummy"
"95180",0,0,1,1,"dummy"
"95181",0,0,1,1,"dummy"
"95182",0,0,1,1,"dummy"
"95183",0,0,1,1,"dummy"
"95184",0,0,1,1,"dummy"
"95185",0,0,1,1,"dummy"
"95186",0,0,1,1,"dummy"
"95187",0,0,1,1,"dummy"
"95188",0,0,1,1,"dummy"
"95189",0,0,1,1,"dummy"
"95190",0,0,1,1,"dummy"
"95191",0,0,1,1,"dummy"
"95192",0,0,1,1,"dummy"
"95193",0,0,1,1,"dummy"
"95194",0,0,1,1,"dummy"
"95197",0,0,0,0,"dummy"
"95198",0,0,0,0,"dummy"
"95199",0,0,0,0,"dummy"
"95202",0,0,1,1,"dummy"
"95203",0,0,1,1,"dummy"
"95207",0,0,1,1,"dummy"
"95208",0,3,0,3,"dummy"
"95209",0,3,0,3,"dummy"
"95210",0,0,1,1,"dummy"
"95211",11,1,0,12,"dummy"
"95212",6,28,4,38,"dummy"
"95216",0,2,1,3,"dummy"
"95217",3,4,1,8,"dummy"
"95218",0,0,1,1,"dummy"
"95224",29,1,2,32,"dummy"
"95225",0,0,2,2,"dummy"
"95226",0,0,1,1,"dummy"
"95236",0,3,1,4,"dummy"
"95237",5,0,2,7,"dummy"
"95238",0,0,0,0,"dummy"
"95256",0,1,0,1,"dummy"
"95257",0,1,0,1,"dummy"
"95258",0,0,4,4,"dummy"
"95259",1,0,1,2,"dummy"
"95301",2,1,1,4,"dummy"
"95302",1,0,1,2,"dummy"
"95329",10,4,0,14,"dummy"
"95330",0,2,0,2,"dummy"
"95331",2,0,0,2,"dummy"
"95332",0,0,3,3,"dummy"
"95335",0,1,0,1,"dummy"
"95355",0,3,1,4,"dummy"
"95356",0,1,0,1,"dummy"
"95357",0,0,1,1,"dummy"
"95358",0,0,1,1,"dummy"
"95359",32,25,0,57,"dummy"
"95360",24,25,0,49,"dummy"
"95363",0,0,2,2,"dummy"
"95368",18,5,0,23,"dummy"
"95369",0,2,1,3,"dummy"
"95373",0,3,0,3,"dummy"
"95385",0,2,0,2,"dummy"
"95386",0,1,0,1,"dummy"
"95387",1,0,0,1,"dummy"
"95404",26,2,2,30,"dummy"
"95405",0,0,1,1,"dummy"
"95406",0,0,1,1,"dummy"
"95407",0,1,0,1,"dummy"
"95463",1,2,0,3,"dummy"
"95464",1,2,0,3,"dummy"
"95472",0,0,1,1,"dummy"
"95432",1,0,2,3,"dummy"
"95433",0,0,1,1,"dummy"
"95434",0,0,1,1,"dummy"
"95435",0,2,1,3,"dummy"
"95436",0,0,0,0,"dummy"
"95437",2,2,1,5,"dummy"
"95438",0,0,1,1,"dummy"
"95439",5,0,0,5,"dummy"
"95440",0,0,1,1,"dummy"
"95441",2,2,2,6,"dummy"
"95442",17,18,2,37,"dummy"
"95443",2,2,0,4,"dummy"
"95444",21,28,2,51,"dummy"
"95445",28,21,2,51,"dummy"
"95446",10,9,2,21,"dummy"
"95447",7,10,2,19,"dummy"
"95448",0,1,0,1,"dummy"
"95449",1,0,0,1,"dummy"
"95450",0,0,0,0,"dummy"
"95451",1,0,1,2,"dummy"
"95452",8,0,3,11,"dummy"
"95453",0,1,1,2,"dummy"
"95454",0,0,1,1,"dummy"
"95455",1,0,1,2,"dummy"
"95456",0,0,0,0,"dummy"
"95457",1,8,1,10,"dummy"
"95458",0,1,0,1,"dummy"
"95459",1,0,0,1,"dummy"
"95460",0,1,0,1,"dummy"
"95461",9,1,2,12,"dummy"
"95466",0,3,4,7,"dummy"
"95467",0,8,0,8,"dummy"
"95468",6,7,0,13,"dummy"
"95469",0,2,2,4,"dummy"
"95470",0,1,0,1,"dummy"
"95476",0,0,1,1,"dummy"
"95477",2,0,1,3,"dummy"
"95480",1,0,0,1,"dummy"
"95481",0,2,0,2,"dummy"
"95482",2,0,1,3,"dummy"
"95483",0,2,0,2,"dummy"
"95484",1,3,0,4,"dummy"
"95485",1,1,0,2,"dummy"
"95486",1,1,1,3,"dummy"
"95487",1,1,0,2,"dummy"
"95490",0,0,4,4,"dummy"
"95491",0,0,4,4,"dummy"
"95492",1,1,0,2,"dummy"
"95493",0,0,3,3,"dummy"
"95494",0,0,1,1,"dummy"
"95495",0,0,2,2,"dummy"
"95497",2,0,0,2,"dummy"
"95499",0,1,0,1,"dummy"
"95501",1,2,0,3,"dummy"
"95502",1,2,0,3,"dummy"
"95505",0,3,0,3,"dummy"
"95506",1,2,0,3,"dummy"
"95507",1,0,0,1,"dummy"
"95514",0,0,1,1,"dummy"
"95528",0,1,2,3,"dummy"
"95529",0,0,0,0,"dummy"
"95530",0,1,0,1,"dummy"
"95531",4,0,2,6,"dummy"
"95532",1,0,0,1,"dummy"
"95533",0,0,0,0,"dummy"
"95534",0,0,0,0,"dummy"
"95537",0,4,0,4,"dummy"
"95538",4,4,2,10,"dummy"
"95539",1,0,0,1,"dummy"
"95540",0,2,0,2,"dummy"
"95541",0,1,0,1,"dummy"
"95544",0,5,0,5,"dummy"
"95545",0,0,1,1,"dummy"
"95546",0,1,0,1,"dummy"
"95554",0,1,0,1,"dummy"
"95555",4,5,3,12,"dummy"
"95556",0,0,0,0,"dummy"
"95557",0,0,2,2,"dummy"
"95558",1,1,0,2,"dummy"
"95559",1,3,0,4,"dummy"
"95560",3,0,3,6,"dummy"
"95561",5,1,1,7,"dummy"
"95563",0,3,0,3,"dummy"
"95564",1,0,0,1,"dummy"
"95565",0,0,0,0,"dummy"
"95567",2,0,1,3,"dummy"
"95568",2,2,0,4,"dummy"
"95569",4,3,1,8,"dummy"
"95570",0,1,0,1,"dummy"
"95571",2,2,0,4,"dummy"
"95575",0,0,1,1,"dummy"
"95576",0,0,0,0,"dummy"
"95577",0,0,1,1,"dummy"
"95578",0,0,1,1,"dummy"
"95580",0,0,1,1,"dummy"
"95581",1,0,1,2,"dummy"
"95582",4,0,0,4,"dummy"
"95583",1,2,2,5,"dummy"
"95584",2,0,1,3,"dummy"
"95585",0,2,1,3,"dummy"
"95586",2,4,4,10,"dummy"
"95587",0,4,0,4,"dummy"
"95588",1,1,0,2,"dummy"
"95589",0,1,1,2,"dummy"
"95599",1,0,0,1,"dummy"
"95601",4,1,2,7,"dummy"
"95602",0,0,1,1,"dummy"
"95603",0,0,0,0,"dummy"
"95607",1,3,0,4,"dummy"
"95608",5,3,0,8,"dummy"
"95610",0,11,0,11,"dummy"
"95611",0,0,2,2,"dummy"
"95613",0,1,0,1,"dummy"
"95614",0,2,0,2,"dummy"
"95615",1,2,1,4,"dummy"
"95616",0,0,1,1,"dummy"
"95618",0,15,0,15,"dummy"
"95620",0,2,0,2,"dummy"
"95627",4,2,2,8,"dummy"
"95628",0,0,2,2,"dummy"
"95633",0,0,2,2,"dummy"
"95634",0,0,2,2,"dummy"
"95635",0,0,1,1,"dummy"
"95636",0,0,2,2,"dummy"
"95637",0,0,1,1,"dummy"
"95638",0,0,1,1,"dummy"
"95639",0,0,1,1,"dummy"
"95643",0,0,0,0,"dummy"
"95644",0,0,1,1,"dummy"
"95646",1,1,1,3,"dummy"
"95647",0,0,0,0,"dummy"
"95649",0,5,0,5,"dummy"
"95650",0,0,1,1,"dummy"
"95651",0,1,0,1,"dummy"
"95652",0,1,0,1,"dummy"
"95653",1,0,2,3,"dummy"
"95654",0,2,1,3,"dummy"
"95655",0,1,0,1,"dummy"
"95656",0,5,1,6,"dummy"
"95657",0,1,1,2,"dummy"
"95658",0,4,0,4,"dummy"
"95659",0,5,0,5,"dummy"
"95660",3,0,0,3,"dummy"
"95661",0,8,0,8,"dummy"
"95662",3,3,0,6,"dummy"
"95663",5,4,0,9,"dummy"
"95664",4,4,0,8,"dummy"
"95665",5,6,0,11,"dummy"
"95666",2,2,0,4,"dummy"
"95667",3,3,0,6,"dummy"
"95668",5,5,0,10,"dummy"
"95669",0,1,0,1,"dummy"
"95670",4,4,0,8,"dummy"
"95671",8,5,0,13,"dummy"
"95672",2,0,0,2,"dummy"
"95673",0,0,1,1,"dummy"
"95674",28,18,3,49,"dummy"
"95675",0,0,1,1,"dummy"
"95676",1,1,1,3,"dummy"
"95677",0,1,1,2,"dummy"
"95678",0,0,1,1,"dummy"
"95679",0,1,0,1,"dummy"
"95680",0,1,0,1,"dummy"
"95681",2,0,1,3,"dummy"
"95682",1,0,0,1,"dummy"
"95683",0,1,0,1,"dummy"
"95684",0,0,3,3,"dummy"
"95686",1,4,0,5,"dummy"
"95687",1,3,2,6,"dummy"
"95688",1,0,1,2,"dummy"
"95689",4,2,3,9,"dummy"
"95690",5,4,5,14,"dummy"
"95691",0,0,3,3,"dummy"
"95692",0,0,3,3,"dummy"
"95694",0,0,1,1,"dummy"
"95695",1,1,0,2,"dummy"
"95696",1,1,0,2,"dummy"
"95697",0,0,1,1,"dummy"
"95698",0,1,0,1,"dummy"
"95701",0,14,0,14,"dummy"
"95702",4,13,5,22,"dummy"
"95703",0,3,1,4,"dummy"
"95704",7,17,1,25,"dummy"
"95705",3,0,1,4,"dummy"
"95706",0,4,2,6,"dummy"
"95707",0,4,1,5,"dummy"
"95712",0,1,0,1,"dummy"
"95713",0,4,1,5,"dummy"
"95714",1,1,1,3,"dummy"
"95722",0,0,1,1,"dummy"
"95724",0,0,0,0,"dummy"
"95725",0,0,0,0,"dummy"
"95726",0,0,0,0,"dummy"
"95727",0,0,0,0,"dummy"
"95728",0,0,0,0,"dummy"
"95729",0,0,0,0,"dummy"
"95730",1,2,0,3,"dummy"
"95731",2,1,1,4,"dummy"
"95732",0,0,1,1,"dummy"
"95733",0,0,0,0,"dummy"
"95734",0,0,1,1,"dummy"
"95735",0,0,0,0,"dummy"
"95736",0,0,1,1,"dummy"
"95737",0,0,0,0,"dummy"
"95741",0,2,0,2,"dummy"
"95742",0,1,3,4,"dummy"
"95743",1,6,3,10,"dummy"
"95744",0,0,1,1,"dummy"
"95745",3,1,1,5,"dummy"
"95748",2,4,0,6,"dummy"
"95749",0,1,0,1,"dummy"
"95750",0,0,0,0,"dummy"
"95751",0,0,0,0,"dummy"
"95752",0,1,0,1,"dummy"
"95753",0,1,0,1,"dummy"
"95757",2,1,0,3,"dummy"
"95758",1,1,2,4,"dummy"
"95759",0,0,2,2,"dummy"
"95760",0,1,0,1,"dummy"
"95761",1,0,2,3,"dummy"
"95762",0,0,0,0,"dummy"
"95766",1,0,0,1,"dummy"
"95773",0,4,0,4,"dummy"
"95774",1,2,0,3,"dummy"
"95775",0,0,0,0,"dummy"
"95777",1,0,1,2,"dummy"
"95778",2,1,1,4,"dummy"
"95779",0,1,0,1,"dummy"
"95792",0,3,0,3,"dummy"
"95793",0,1,0,1,"dummy"
"95794",1,1,0,2,"dummy"
"95795",0,1,0,1,"dummy"
"95796",0,1,0,1,"dummy"
"95797",0,0,2,2,"dummy"
"95799",1,1,0,2,"dummy"
"95800",3,3,0,6,"dummy"
"95801",0,0,1,1,"dummy"
"95816",0,0,1,1,"dummy"
"95818",3,2,2,7,"dummy"
"95819",2,3,2,7,"dummy"
"95820",0,0,1,1,"dummy"
"95821",1,2,2,5,"dummy"
"95824",0,0,3,3,"dummy"
"95825",0,0,0,0,"dummy"
"95826",8,2,0,10,"dummy"
"95827",0,0,0,0,"dummy"
"95828",2,8,0,10,"dummy"
"95829",8,4,0,12,"dummy"
"95830",0,1,0,1,"dummy"
"95831",3,4,0,7,"dummy"
"95832",0,0,0,0,"dummy"
"95833",0,2,0,2,"dummy"
"95834",4,2,1,7,"dummy"
"95835",0,0,2,2,"dummy"
"95836",0,0,2,2,"dummy"
"95837",0,2,0,2,"dummy"
"95838",6,3,11,20,"dummy"
"95839",2,5,1,8,"dummy"
"95842",0,0,1,1,"dummy"
"95843",0,1,0,1,"dummy"
"95844",9,9,0,18,"dummy"
"95845",2,0,0,2,"dummy"
"95847",0,0,0,0,"dummy"
"95849",0,2,0,2,"dummy"
"95850",0,2,0,2,"dummy"
"95851",0,3,0,3,"dummy"
"95852",0,2,2,4,"dummy"
"95853",0,1,0,1,"dummy"
"95854",2,4,1,7,"dummy"
"95861",0,3,0,3,"dummy"
"95862",0,4,0,4,"dummy"
"95863",0,8,0,8,"dummy"
"95864",0,0,1,1,"dummy"
"95865",8,0,2,10,"dummy"
"95866",0,4,0,4,"dummy"
"95867",0,0,2,2,"dummy"
"95873",0,1,0,1,"dummy"
"95874",0,0,0,0,"dummy"
"95875",0,0,0,0,"dummy"
"95876",0,0,0,0,"dummy"
"95877",0,0,0,0,"dummy"
"95878",0,0,0,0,"dummy"
"95879",0,0,0,0,"dummy"
"95882",0,0,0,0,"dummy"
"95883",0,0,0,0,"dummy"
"95885",0,1,0,1,"dummy"
"95886",0,1,0,1,"dummy"
"95887",0,2,1,3,"dummy"
"95888",0,3,0,3,"dummy"
"95889",0,0,1,1,"dummy"
"95890",0,2,0,2,"dummy"
"95891",3,12,0,15,"dummy"
"95894",0,1,1,2,"dummy"
"95895",0,1,0,1,"dummy"
"95896",0,2,1,3,"dummy"
"95897",0,0,0,0,"dummy"
"95898",2,0,2,4,"dummy"
"95899",0,0,1,1,"dummy"
"95900",0,1,0,1,"dummy"
"95907",0,0,1,1,"dummy"
"95909",2,0,0,2,"dummy"
"95917",3,3,0,6,"dummy"
"95923",6,0,0,6,"dummy"
"95924",0,0,2,2,"dummy"
"95925",1,0,0,1,"dummy"
"95926",0,0,1,1,"dummy"
"95929",0,4,1,5,"dummy"
"95933",2,0,0,2,"dummy"
"95936",0,0,3,3,"dummy"
"95937",8,13,0,21,"dummy"
"95938",0,1,0,1,"dummy"
"95939",1,1,0,2,"dummy"
"95940",0,0,1,1,"dummy"
"95941",0,2,0,2,"dummy"
"95942",0,0,1,1,"dummy"
"95943",0,5,0,5,"dummy"
"95950",0,1,0,1,"dummy"
"95952",0,0,2,2,"dummy"
"95953",0,0,1,1,"dummy"
"95967",1,2,2,5,"dummy"
"95968",0,0,1,1,"dummy"
"95969",0,0,1,1,"dummy"
"95972",0,3,0,3,"dummy"
"95973",0,0,1,1,"dummy"
"95974",0,0,1,1,"dummy"
"95976",0,1,0,1,"dummy"
"95977",0,0,1,1,"dummy"
"95978",0,0,0,0,"dummy"
"95979",0,0,0,0,"dummy"
"95981",4,1,0,5,"dummy"
"95988",0,0,1,1,"dummy"
"95992",0,1,0,1,"dummy"
"95993",3,2,2,7,"dummy"
"95994",0,0,1,1,"dummy"
"95995",0,0,0,0,"dummy"
"95996",0,0,0,0,"dummy"
"95997",0,0,0,0,"dummy"
"95998",0,0,1,1,"dummy"
"96000",6,14,2,22,"dummy"
"96001",4,3,0,7,"dummy"
"96002",0,0,3,3,"dummy"
"96003",2,2,0,4,"dummy"
"96004",2,0,0,2,"dummy"
"96009",0,0,0,0,"dummy"
"96010",0,0,0,0,"dummy"
"96013",3,3,0,6,"dummy"
"96015",6,2,2,10,"dummy"
"96016",0,2,1,3,"dummy"
"96017",1,4,0,5,"dummy"
"96018",4,2,0,6,"dummy"
"96021",0,1,0,1,"dummy"
"96025",1,0,0,1,"dummy"
"96026",0,2,0,2,"dummy"
"96027",1,0,0,1,"dummy"
"96028",0,0,1,1,"dummy"
"96030",0,1,1,2,"dummy"
"96037",0,1,0,1,"dummy"
"96038",4,3,0,7,"dummy"
"96039",1,0,0,1,"dummy"
"96040",0,1,0,1,"dummy"
"96042",1,0,0,1,"dummy"
"96044",2,1,0,3,"dummy"
"96045",0,1,0,1,"dummy"
"96046",0,1,0,1,"dummy"
"96047",1,2,0,3,"dummy"
"96049",0,2,2,4,"dummy"
"96050",6,5,1,12,"dummy"
"96051",0,1,2,3,"dummy"
"96052",1,4,1,6,"dummy"
"96053",0,2,0,2,"dummy"
"96054",16,0,3,19,"dummy"
"96055",4,3,0,7,"dummy"
"96056",0,2,3,5,"dummy"
"96057",4,0,0,4,"dummy"
"96058",0,6,0,6,"dummy"
"96059",0,0,1,1,"dummy"
"96060",0,0,1,1,"dummy"
"96061",0,1,0,1,"dummy"
"96062",0,0,1,1,"dummy"
"96063",0,0,0,0,"dummy"
"96066",0,0,1,1,"dummy"
"96067",3,4,5,12,"dummy"
"96068",1,0,0,1,"dummy"
"96069",1,0,0,1,"dummy"
"96070",0,1,0,1,"dummy"
"96073",0,2,0,2,"dummy"
"96074",0,0,2,2,"dummy"
"96076",0,0,0,0,"dummy"
"96077",0,0,1,1,"dummy"
"96079",2,1,0,3,"dummy"
"96080",2,2,0,4,"dummy"
"96083",0,14,0,14,"dummy"
"96084",0,1,0,1,"dummy"
"96085",1,1,0,2,"dummy"
"96086",6,1,0,7,"dummy"
"96087",1,1,0,2,"dummy"
"96088",4,0,0,4,"dummy"
"96089",0,0,0,0,"dummy"
"96090",0,1,0,1,"dummy"
"96101",4,14,1,19,"dummy"
"96102",1,1,1,3,"dummy"
"96103",0,0,0,0,"dummy"
"96104",0,0,2,2,"dummy"
"96105",0,0,2,2,"dummy"
"96106",0,0,2,2,"dummy"
"96107",0,2,0,2,"dummy"
"96108",0,0,2,2,"dummy"
"96109",0,0,2,2,"dummy"
"96110",0,0,1,1,"dummy"
"96111",3,1,0,4,"dummy"
"96112",0,1,0,1,"dummy"
"96113",1,1,0,2,"dummy"
"96114",0,0,2,2,"dummy"
"96115",0,0,2,2,"dummy"
"96116",0,2,2,4,"dummy"
"96117",0,0,2,2,"dummy"
"96118",0,0,1,1,"dummy"
"96119",0,0,1,1,"dummy"
"96121",0,0,1,1,"dummy"
"96122",0,2,0,2,"dummy"
"96123",0,3,0,3,"dummy"
"96126",0,0,1,1,"dummy"
"96127",0,0,0,0,"dummy"
"96129",1,0,0,1,"dummy"
"96130",1,2,1,4,"dummy"
"96135",5,4,0,9,"dummy"
"96136",0,0,4,4,"dummy"
"96137",0,10,0,10,"dummy"
"96138",30,35,0,65,"dummy"
"96139",0,4,0,4,"dummy"
"96140",0,1,0,1,"dummy"
"96141",0,0,0,0,"dummy"
"96144",3,2,0,5,"dummy"
"96148",3,5,0,8,"dummy"
"96154",0,0,0,0,"dummy"
"96162",0,23,0,23,"dummy"
"96163",2,2,1,5,"dummy"
"96209",0,0,0,0,"dummy"
"96210",0,0,0,0,"dummy"
"96211",0,0,0,0,"dummy"
"96212",0,0,0,0,"dummy"
"96216",1,0,0,1,"dummy"
"96217",2,0,1,3,"dummy"
"96218",0,0,0,0,"dummy"
"96219",0,1,0,1,"dummy"
"96220",8,1,0,9,"dummy"
"96221",0,0,0,0,"dummy"
"96222",0,0,0,0,"dummy"
"96223",1,10,0,11,"dummy"
"96224",7,1,0,8,"dummy"
"96225",2,0,3,5,"dummy"
"96228",0,1,0,1,"dummy"
"96229",0,1,0,1,"dummy"
"96230",0,1,0,1,"dummy"
"96231",0,1,0,1,"dummy"
"96232",2,1,0,3,"dummy"
"96233",2,2,0,4,"dummy"
"96234",0,1,1,2,"dummy"
"96235",2,4,3,9,"dummy"
"96236",0,1,0,1,"dummy"
"96237",0,1,0,1,"dummy"
"96238",0,1,0,1,"dummy"
"96239",0,1,0,1,"dummy"
"96240",0,1,0,1,"dummy"
"96241",0,0,3,3,"dummy"
"96242",0,1,0,1,"dummy"
"96243",0,2,0,2,"dummy"
"96244",0,1,0,1,"dummy"
"96245",0,1,0,1,"dummy"
"96246",0,1,0,1,"dummy"
"96247",1,5,0,6,"dummy"
"96251",0,1,0,1,"dummy"
"96254",0,1,4,5,"dummy"
"96255",0,0,5,5,"dummy"
"96256",0,0,1,1,"dummy"
"96257",0,0,5,5,"dummy"
"96258",0,0,1,1,"dummy"
"96259",0,0,1,1,"dummy"
"96260",2,1,0,3,"dummy"
"96261",0,0,1,1,"dummy"
"96291",0,0,0,0,"dummy"
"96292",0,0,0,0,"dummy"
"96293",0,0,0,0,"dummy"
"96294",0,1,0,1,"dummy"
"96302",0,8,0,8,"dummy"
"96305",0,1,0,1,"dummy"
"96306",0,2,0,2,"dummy"
"96307",6,6,0,12,"dummy"
"96308",0,1,0,1,"dummy"
"96309",1,0,0,1,"dummy"
"96310",6,8,1,15,"dummy"
"96311",0,0,1,1,"dummy"
"96312",0,2,0,2,"dummy"
"96315",0,0,2,2,"dummy"
"96325",0,0,0,0,"dummy"
"96328",0,0,0,0,"dummy"
"96348",3,0,0,3,"dummy"
"96382",0,3,0,3,"dummy"
"96383",0,1,0,1,"dummy"
"96384",0,1,0,1,"dummy"
"96385",0,4,1,5,"dummy"
"96386",0,1,0,1,"dummy"
"96389",3,3,0,6,"dummy"
"96405",3,3,0,6,"dummy"
"96406",18,9,3,30,"dummy"
"96407",0,0,1,1,"dummy"
"96415",2,2,1,5,"dummy"
"96146",0,0,0,0,"dummy"
"96150",9,12,0,21,"dummy"
"96151",0,1,1,2,"dummy"
"96152",0,0,1,1,"dummy"
"96156",0,1,0,1,"dummy"
"96157",0,1,0,1,"dummy"
"96158",0,1,5,6,"dummy"
"96159",0,0,5,5,"dummy"
"96160",0,0,5,5,"dummy"
"96214",0,4,0,4,"dummy"
"96249",0,4,0,4,"dummy"
"96263",32,17,4,53,"dummy"
"96264",0,1,0,1,"dummy"
"96265",17,15,7,39,"dummy"
"96266",1,0,0,1,"dummy"
"96267",0,0,2,2,"dummy"
"96268",0,0,1,1,"dummy"
"96269",0,6,1,7,"dummy"
"96270",0,0,2,2,"dummy"
"96271",0,2,2,4,"dummy"
"96272",0,1,0,1,"dummy"
"96273",4,4,1,9,"dummy"
"96274",0,0,1,1,"dummy"
"96275",0,0,1,1,"dummy"
"96276",0,0,0,0,"dummy"
"96277",0,1,1,2,"dummy"
"96278",0,0,0,0,"dummy"
"96279",0,0,1,1,"dummy"
"96280",11,6,4,21,"dummy"
"96281",0,1,0,1,"dummy"
"96282",0,3,2,5,"dummy"
"96283",0,1,1,2,"dummy"
"96284",16,2,3,21,"dummy"
"96285",0,1,1,2,"dummy"
"96286",0,1,2,3,"dummy"
"96289",0,0,1,1,"dummy"
"96296",1,1,2,4,"dummy"
"96297",6,2,3,11,"dummy"
"96298",3,6,0,9,"dummy"
"96299",0,1,0,1,"dummy"
"96300",0,0,1,1,"dummy"
"96317",3,7,3,13,"dummy"
"96318",2,0,1,3,"dummy"
"96319",0,2,0,2,"dummy"
"96320",0,0,1,1,"dummy"
"96321",0,0,2,2,"dummy"
"96330",1,4,0,5,"dummy"
"96331",0,3,0,3,"dummy"
"96344",0,0,1,1,"dummy"
"96345",0,0,1,1,"dummy"
"96346",0,0,1,1,"dummy"
"96369",0,2,0,2,"dummy"
"96370",0,1,4,5,"dummy"
"96377",2,0,0,2,"dummy"
"96380",0,4,0,4,"dummy"
"96393",0,0,0,0,"dummy"
"96394",0,0,0,0,"dummy"
"96395",0,3,0,3,"dummy"
"96396",0,1,0,1,"dummy"
"96397",0,1,1,2,"dummy"
"96398",0,0,1,1,"dummy"
"96399",0,0,1,1,"dummy"
"96400",0,0,1,1,"dummy"
"96401",0,0,1,1,"dummy"
"96402",0,0,1,1,"dummy"
"96403",0,0,1,1,"dummy"
"96409",0,0,1,1,"dummy"
"96410",0,0,1,1,"dummy"
"96413",0,0,0,0,"dummy"
"96417",0,1,0,1,"dummy"
"96441",0,1,0,1,"dummy"
"96448",0,0,0,0,"dummy"
"96449",0,0,0,0,"dummy"
"96450",0,0,0,0,"dummy"
"96451",0,1,0,1,"dummy"
"96460",2,1,1,4,"dummy"
"96461",0,0,2,2,"dummy"
"96483",0,0,1,1,"dummy"
"96489",0,1,0,1,"dummy"
"96490",1,0,2,3,"dummy"
"96491",0,0,0,0,"dummy"
"96492",0,2,2,4,"dummy"
"96493",0,0,1,1,"dummy"
"96502",4,12,4,20,"dummy"
"96503",0,2,0,2,"dummy"
"96504",0,0,1,1,"dummy"
"96505",0,2,0,2,"dummy"
"96532",0,0,1,1,"dummy"
"96560",2,0,0,2,"dummy"
"96561",10,2,1,13,"dummy"
"96565",2,1,1,4,"dummy"
"96581",0,0,1,1,"dummy"
"96595",0,0,0,0,"dummy"
"96617",1,0,1,2,"dummy"
"96630",14,16,2,32,"dummy"
"96634",0,3,1,4,"dummy"
"96639",2,0,0,2,"dummy"
"96640",2,3,2,7,"dummy"
"96645",0,8,1,9,"dummy"
"96648",0,1,0,1,"dummy"
"96664",1,4,0,5,"dummy"
"96694",2,1,1,4,"dummy"
"96712",0,0,0,0,"dummy"
"96720",1,1,1,3,"dummy"
"96721",0,0,1,1,"dummy"
"96722",1,0,1,2,"dummy"
"96729",0,5,0,5,"dummy"
"96434",0,0,1,1,"dummy"
"96435",0,0,0,0,"dummy"
"96455",1,4,1,6,"dummy"
"96458",0,0,1,1,"dummy"
"96463",0,0,1,1,"dummy"
"96464",0,1,3,4,"dummy"
"96465",0,2,0,2,"dummy"
"96466",0,0,3,3,"dummy"
"96469",1,4,3,8,"dummy"
"96470",1,1,0,2,"dummy"
"96485",0,0,1,1,"dummy"
"96495",0,0,1,1,"dummy"
"96496",0,0,1,1,"dummy"
"96497",0,0,1,1,"dummy"
"96498",1,0,1,2,"dummy"
"96499",5,4,1,10,"dummy"
"96500",4,2,1,7,"dummy"
"96507",0,2,0,2,"dummy"
"96508",0,3,0,3,"dummy"
"96509",4,9,0,13,"dummy"
"96510",0,2,0,2,"dummy"
"96511",0,6,0,6,"dummy"
"96512",0,0,3,3,"dummy"
"96513",0,0,2,2,"dummy"
"96514",3,7,1,11,"dummy"
"96534",5,3,1,9,"dummy"
"96535",0,10,1,11,"dummy"
"96536",2,1,2,5,"dummy"
"96541",5,23,5,33,"dummy"
"96542",0,0,1,1,"dummy"
"96543",0,1,0,1,"dummy"
"96544",0,2,0,2,"dummy"
"96545",0,0,0,0,"dummy"
"96546",11,0,0,11,"dummy"
"96547",0,8,0,8,"dummy"
"96548",9,2,2,13,"dummy"
"96549",0,0,3,3,"dummy"
"96550",2,10,3,15,"dummy"
"96551",2,2,1,5,"dummy"
"96552",12,4,2,18,"dummy"
"96553",2,0,0,2,"dummy"
"96556",0,0,1,1,"dummy"
"96557",0,0,1,1,"dummy"
"96558",0,1,0,1,"dummy"
"96563",0,0,3,3,"dummy"
"96567",0,0,2,2,"dummy"
"96568",0,0,1,1,"dummy"
"96569",0,0,1,1,"dummy"
"96570",0,0,1,1,"dummy"
"96571",3,5,3,11,"dummy"
"96574",0,1,2,3,"dummy"
"96575",0,0,0,0,"dummy"
"96576",0,1,0,1,"dummy"
"96577",4,0,2,6,"dummy"
"96578",1,0,0,1,"dummy"
"96579",0,0,0,0,"dummy"
"96583",3,15,5,23,"dummy"
"96586",1,0,1,2,"dummy"
"96587",0,6,0,6,"dummy"
"96588",0,0,2,2,"dummy"
"96589",1,3,2,6,"dummy"
"96597",0,1,0,1,"dummy"
"96598",5,2,0,7,"dummy"
"96599",2,3,0,5,"dummy"
"96600",0,0,1,1,"dummy"
"96601",0,1,0,1,"dummy"
"96602",0,4,0,4,"dummy"
"96603",10,5,3,18,"dummy"
"96604",0,0,1,1,"dummy"
"96605",0,1,0,1,"dummy"
"96606",0,0,1,1,"dummy"
"96607",0,0,1,1,"dummy"
"96608",0,1,0,1,"dummy"
"96609",0,1,0,1,"dummy"
"96610",0,0,1,1,"dummy"
"96611",1,0,1,2,"dummy"
"96612",0,0,1,1,"dummy"
"96613",0,0,1,1,"dummy"
"96614",2,0,0,2,"dummy"
"96615",0,2,1,3,"dummy"
"96621",0,0,1,1,"dummy"
"96632",0,0,0,0,"dummy"
"96650",4,2,0,6,"dummy"
"96651",0,0,1,1,"dummy"
"96652",1,2,1,4,"dummy"
"96653",2,3,1,6,"dummy"
"96654",3,2,1,6,"dummy"
"96655",0,0,1,1,"dummy"
"96656",0,1,0,1,"dummy"
"96657",0,0,0,0,"dummy"
"96658",1,1,1,3,"dummy"
"96659",2,2,0,4,"dummy"
"96670",0,0,1,1,"dummy"
"96682",0,0,1,1,"dummy"
"96683",0,0,1,1,"dummy"
"96684",0,0,2,2,"dummy"
"96685",0,0,1,1,"dummy"
"96690",0,0,1,1,"dummy"
"96691",2,1,0,3,"dummy"
"96692",5,2,0,7,"dummy"
"96696",0,4,0,4,"dummy"
"96697",4,10,0,14,"dummy"
"96698",10,0,1,11,"dummy"
"96699",0,0,0,0,"dummy"
"96700",0,0,2,2,"dummy"
"96701",2,3,0,5,"dummy"
"96702",2,3,2,7,"dummy"
"96703",0,1,1,2,"dummy"
"96714",0,0,0,0,"dummy"
"96715",4,3,0,7,"dummy"
"96716",0,8,0,8,"dummy"
"96717",2,0,1,3,"dummy"
"96718",2,0,0,2,"dummy"
"96731",0,0,2,2,"dummy"
"96732",0,0,1,1,"dummy"
"96735",1,1,1,3,"dummy"
"96736",1,0,0,1,"dummy"
"96737",0,0,1,1,"dummy"
"96767",0,0,1,1,"dummy"
"96740",0,2,0,2,"dummy"
"96746",4,6,1,11,"dummy"
"96747",0,0,1,1,"dummy"
"96749",1,2,2,5,"dummy"
"96751",0,0,1,1,"dummy"
"96752",0,3,0,3,"dummy"
"96753",3,1,0,4,"dummy"
"96755",0,0,2,2,"dummy"
"96756",0,0,1,1,"dummy"
"96757",2,2,0,4,"dummy"
"96758",2,2,0,4,"dummy"
"96759",0,0,1,1,"dummy"
"96760",1,1,0,2,"dummy"
"96762",0,0,3,3,"dummy"
"96763",1,0,1,2,"dummy"
"96764",0,0,0,0,"dummy"
"96766",0,0,1,1,"dummy"
"96768",0,0,1,1,"dummy"
"96769",0,3,0,3,"dummy"
"96770",0,0,1,1,"dummy"
"96771",0,0,1,1,"dummy"
"96772",0,0,1,1,"dummy"
"96773",4,0,4,8,"dummy"
"96774",0,0,1,1,"dummy"
"96775",0,0,1,1,"dummy"
"96778",0,0,0,0,"dummy"
"96780",0,0,3,3,"dummy"
"96783",0,1,0,1,"dummy"
"96784",0,2,0,2,"dummy"
"96789",4,2,1,7,"dummy"
"96797",0,0,5,5,"dummy"
"96799",0,0,1,1,"dummy"
"96805",0,0,0,0,"dummy"
"96806",0,0,0,0,"dummy"
"96808",1,0,2,3,"dummy"
"96810",0,0,1,1,"dummy"
"96816",0,2,1,3,"dummy"
"96817",0,0,0,0,"dummy"
"96818",2,3,0,5,"dummy"
"96819",0,1,0,1,"dummy"
"96820",0,0,0,0,"dummy"
"96821",0,0,1,1,"dummy"
"96823",4,4,0,8,"dummy"
"96824",0,12,0,12,"dummy"
"96831",0,0,1,1,"dummy"
"96832",0,0,3,3,"dummy"
"96833",6,8,2,16,"dummy"
"96834",3,3,2,8,"dummy"
"96835",4,1,1,6,"dummy"
"96836",0,4,0,4,"dummy"
"96837",0,0,0,0,"dummy"
"96838",0,1,0,1,"dummy"
"96839",0,0,1,1,"dummy"
"96840",0,1,0,1,"dummy"
"96841",2,0,0,2,"dummy"
"96842",0,2,0,2,"dummy"
"96843",0,0,1,1,"dummy"
"96844",0,1,1,2,"dummy"
"96845",0,0,1,1,"dummy"
"96846",0,0,2,2,"dummy"
"96847",0,0,0,0,"dummy"
"96848",0,0,0,0,"dummy"
"96860",23,3,1,27,"dummy"
"96861",0,2,0,2,"dummy"
"96862",4,4,1,9,"dummy"
"96865",0,5,2,7,"dummy"
"96866",0,3,3,6,"dummy"
"96868",0,1,0,1,"dummy"
"96872",1,4,1,6,"dummy"
"96890",6,4,1,11,"dummy"
"96891",2,4,0,6,"dummy"
"96892",1,1,1,3,"dummy"
"96893",1,1,1,3,"dummy"
"96894",3,7,0,10,"dummy"
"96895",1,14,0,15,"dummy"
"96896",0,1,0,1,"dummy"
"96897",0,1,0,1,"dummy"
"96898",0,1,0,1,"dummy"
"96900",1,2,2,5,"dummy"
"96904",0,0,0,0,"dummy"
"96906",0,1,0,1,"dummy"
"96917",6,1,1,8,"dummy"
"96918",0,0,0,0,"dummy"
"96924",0,0,1,1,"dummy"
"96926",0,1,1,2,"dummy"
"96927",0,1,1,2,"dummy"
"96928",0,0,1,1,"dummy"
"96929",0,0,1,1,"dummy"
"96931",2,3,0,5,"dummy"
"96932",3,4,0,7,"dummy"
"96933",0,0,1,1,"dummy"
"96934",0,1,0,1,"dummy"
"96957",0,1,0,1,"dummy"
"96958",0,0,1,1,"dummy"
"96959",0,0,1,1,"dummy"
"96961",0,0,1,1,"dummy"
"96962",5,1,1,7,"dummy"
"96963",0,7,0,7,"dummy"
"96964",0,2,0,2,"dummy"
"96965",0,0,1,1,"dummy"
"96966",0,0,1,1,"dummy"
"96967",0,2,0,2,"dummy"
"96969",0,4,0,4,"dummy"
"96970",0,5,0,5,"dummy"
"96971",0,0,1,1,"dummy"
"96972",0,3,0,3,"dummy"
"96973",0,0,0,0,"dummy"
"96974",0,1,0,1,"dummy"
"96975",6,0,0,6,"dummy"
"96977",0,1,1,2,"dummy"
"96986",1,8,0,9,"dummy"
"96987",1,0,0,1,"dummy"
"96988",3,4,2,9,"dummy"
"96989",6,1,0,7,"dummy"
"96993",0,1,0,1,"dummy"
"96994",0,1,0,1,"dummy"
"96995",0,1,0,1,"dummy"
"96996",0,0,1,1,"dummy"
"96997",0,3,0,3,"dummy"
"96998",0,18,0,18,"dummy"
"96999",6,1,0,7,"dummy"
"97000",0,1,0,1,"dummy"
"97001",0,1,0,1,"dummy"
"97002",0,0,0,0,"dummy"
"97003",1,12,0,13,"dummy"
"97004",0,8,0,8,"dummy"
"97005",4,2,2,8,"dummy"
"97006",3,2,1,6,"dummy"
"97007",2,3,0,5,"dummy"
"97008",0,3,0,3,"dummy"
"97009",6,0,4,10,"dummy"
"97010",0,10,0,10,"dummy"
"97011",0,1,0,1,"dummy"
"97012",1,2,0,3,"dummy"
"97013",0,0,0,0,"dummy"
"97014",0,3,1,4,"dummy"
"97015",38,49,2,89,"dummy"
"97016",8,0,0,8,"dummy"
"97017",0,0,1,1,"dummy"
"97018",0,0,1,1,"dummy"
"97019",0,3,0,3,"dummy"
"97020",0,2,0,2,"dummy"
"97021",3,5,1,9,"dummy"
"97022",0,1,0,1,"dummy"
"97023",8,14,2,24,"dummy"
"97024",0,3,0,3,"dummy"
"97025",3,0,0,3,"dummy"
"97026",1,2,1,4,"dummy"
"97027",0,0,0,0,"dummy"
"97069",1,14,0,15,"dummy"
"97070",7,8,0,15,"dummy"
"97071",0,3,0,3,"dummy"
"97072",1,1,0,2,"dummy"
"97073",4,9,1,14,"dummy"
"97074",14,10,7,31,"dummy"
"97076",0,0,1,1,"dummy"
"97077",0,1,0,1,"dummy"
"97082",1,1,0,2,"dummy"
"97085",0,2,0,2,"dummy"
"97086",19,7,2,28,"dummy"
"97089",0,0,1,1,"dummy"
"97091",0,0,0,0,"dummy"
"97092",0,0,1,1,"dummy"
"97093",3,2,0,5,"dummy"
"97094",0,0,1,1,"dummy"
"97095",0,1,0,1,"dummy"
"97096",0,0,0,0,"dummy"
"97097",0,0,1,1,"dummy"
"97098",0,2,0,2,"dummy"
"97101",0,0,1,1,"dummy"
"97103",0,0,2,2,"dummy"
"97104",0,0,1,1,"dummy"
"97105",0,0,1,1,"dummy"
"97106",0,2,2,4,"dummy"
"97107",0,0,1,1,"dummy"
"97108",0,0,1,1,"dummy"
"97110",6,11,0,17,"dummy"
"97111",0,0,1,1,"dummy"
"97112",0,2,0,2,"dummy"
"97114",1,0,0,1,"dummy"
"97115",0,2,0,2,"dummy"
"97116",0,0,1,1,"dummy"
"97117",0,0,1,1,"dummy"
"97118",1,0,0,1,"dummy"
"97119",0,2,1,3,"dummy"
"97138",0,1,1,2,"dummy"
"97139",0,0,1,1,"dummy"
"97141",0,0,1,1,"dummy"
"97142",0,0,1,1,"dummy"
"97143",0,0,2,2,"dummy"
"97144",26,3,7,36,"dummy"
"97146",4,6,1,11,"dummy"
"97147",1,2,0,3,"dummy"
"97148",0,2,0,2,"dummy"
"97149",0,2,0,2,"dummy"
"97150",7,0,5,12,"dummy"
"97151",0,1,0,1,"dummy"
"97152",0,1,0,1,"dummy"
"97153",3,0,0,3,"dummy"
"97154",1,5,0,6,"dummy"
"97155",0,0,0,0,"dummy"
"97156",0,1,0,1,"dummy"
"97157",0,2,0,2,"dummy"
"97158",2,0,0,2,"dummy"
"97159",5,1,0,6,"dummy"
"97160",2,2,0,4,"dummy"
"97161",0,2,0,2,"dummy"
"97162",0,0,1,1,"dummy"
"97163",18,1,1,20,"dummy"
"97164",0,0,1,1,"dummy"
"97165",0,0,1,1,"dummy"
"97166",0,1,3,4,"dummy"
"97168",3,4,1,8,"dummy"
"97169",2,0,0,2,"dummy"
"97170",14,15,3,32,"dummy"
"97171",0,0,0,0,"dummy"
"97172",10,3,1,14,"dummy"
"97173",0,0,1,1,"dummy"
"97174",6,1,0,7,"dummy"
"97175",0,0,0,0,"dummy"
"97176",0,0,1,1,"dummy"
"97177",0,0,0,0,"dummy"
"97179",0,0,1,1,"dummy"
"97180",1,1,0,2,"dummy"
"97181",0,0,1,1,"dummy"
"97182",0,1,0,1,"dummy"
"97184",2,1,1,4,"dummy"
"97186",0,0,0,0,"dummy"
"97187",0,1,0,1,"dummy"
"97189",0,0,0,0,"dummy"
"97190",0,0,0,0,"dummy"
"97191",0,0,0,0,"dummy"
"97193",0,0,1,1,"dummy"
"97197",0,1,0,1,"dummy"
"97198",0,0,3,3,"dummy"
"97199",0,4,4,8,"dummy"
"97203",0,2,0,2,"dummy"
"97207",0,0,1,1,"dummy"
"97208",0,0,4,4,"dummy"
"97212",0,1,0,1,"dummy"
"97213",0,1,0,1,"dummy"
"97214",0,3,0,3,"dummy"
"97215",0,1,2,3,"dummy"
"97219",0,2,0,2,"dummy"
"97220",0,1,0,1,"dummy"
"97221",0,1,0,1,"dummy"
"97222",0,0,1,1,"dummy"
"97223",7,8,1,16,"dummy"
"97224",0,1,0,1,"dummy"
"97225",5,9,3,17,"dummy"
"97226",5,0,1,6,"dummy"
"97227",5,19,0,24,"dummy"
"97228",13,6,2,21,"dummy"
"97229",3,7,2,12,"dummy"
"97230",7,3,2,12,"dummy"
"97231",0,0,0,0,"dummy"
"97232",4,7,1,12,"dummy"
"97233",0,1,0,1,"dummy"
"97234",1,4,3,8,"dummy"
"97235",0,0,1,1,"dummy"
"97236",4,1,0,5,"dummy"
"97239",0,3,2,5,"dummy"
"97240",2,1,2,5,"dummy"
"97241",3,0,2,5,"dummy"
"97244",0,0,1,1,"dummy"
"97249",0,0,0,0,"dummy"
"97250",0,3,1,4,"dummy"
"97251",0,1,0,1,"dummy"
"97254",0,2,0,2,"dummy"
"97255",0,3,0,3,"dummy"
"97256",0,0,5,5,"dummy"
"97257",0,0,0,0,"dummy"
"97258",0,1,0,1,"dummy"
"97259",0,1,0,1,"dummy"
"97260",0,1,0,1,"dummy"
"97261",0,2,0,2,"dummy"
"97263",0,3,5,8,"dummy"
"97264",0,1,0,1,"dummy"
"97265",3,2,0,5,"dummy"
"97268",0,6,0,6,"dummy"
"97269",0,0,1,1,"dummy"
"97271",0,1,0,1,"dummy"
"97272",0,0,1,1,"dummy"
"97285",5,0,0,5,"dummy"
"97288",2,0,0,2,"dummy"
"97289",0,3,1,4,"dummy"
"97290",0,0,1,1,"dummy"
"97291",9,24,6,39,"dummy"
"97292",0,1,0,1,"dummy"
"97293",0,0,1,1,"dummy"
"97296",1,9,0,10,"dummy"
"97297",0,1,0,1,"dummy"
"97298",0,3,0,3,"dummy"
"97299",13,14,4,31,"dummy"
"97301",3,1,0,4,"dummy"
"97302",0,0,1,1,"dummy"
"97303",0,1,0,1,"dummy"
"97304",2,2,0,4,"dummy"
"97305",2,2,0,4,"dummy"
"97306",0,1,0,1,"dummy"
"97307",4,0,1,5,"dummy"
"97308",0,0,1,1,"dummy"
"97309",0,4,1,5,"dummy"
"97310",1,0,0,1,"dummy"
"97311",1,0,0,1,"dummy"
"97316",0,0,2,2,"dummy"
"97317",0,7,1,8,"dummy"
"97318",0,0,4,4,"dummy"
"97320",4,3,1,8,"dummy"
"97322",0,1,0,1,"dummy"
"97323",0,0,1,1,"dummy"
"97329",0,3,0,3,"dummy"
"97332",0,1,0,1,"dummy"
"97333",0,0,1,1,"dummy"
"97334",0,1,2,3,"dummy"
"97335",0,0,1,1,"dummy"
"97336",1,1,1,3,"dummy"
"97337",1,1,3,5,"dummy"
"97338",0,0,1,1,"dummy"
"97339",2,2,1,5,"dummy"
"97340",0,1,0,1,"dummy"
"97341",0,0,1,1,"dummy"
"97342",0,4,0,4,"dummy"
"97343",1,2,1,4,"dummy"
"97344",1,0,1,2,"dummy"
"97345",0,0,1,1,"dummy"
"97346",0,0,1,1,"dummy"
"97347",0,1,1,2,"dummy"
"97348",0,0,1,1,"dummy"
"97349",1,0,0,1,"dummy"
"97350",0,0,2,2,"dummy"
"97351",1,2,0,3,"dummy"
"97352",1,1,0,2,"dummy"
"97353",0,0,1,1,"dummy"
"97354",0,1,1,2,"dummy"
"97355",2,5,2,9,"dummy"
"97356",0,0,1,1,"dummy"
"97357",0,0,1,1,"dummy"
"97358",3,1,2,6,"dummy"
"97361",0,1,0,1,"dummy"
"97363",1,0,0,1,"dummy"
"97364",6,1,0,7,"dummy"
"97365",1,7,1,9,"dummy"
"97366",0,5,2,7,"dummy"
"97367",0,0,2,2,"dummy"
"97372",1,0,1,2,"dummy"
"97373",0,0,1,1,"dummy"
"97377",0,0,1,1,"dummy"
"97378",0,0,1,1,"dummy"
"97379",0,0,1,1,"dummy"
"97380",6,0,2,8,"dummy"
"97381",0,0,1,1,"dummy"
"97382",0,0,1,1,"dummy"
"97383",0,2,0,2,"dummy"
"97388",4,9,0,13,"dummy"
"97389",0,0,0,0,"dummy"
"97390",2,1,4,7,"dummy"
"97392",0,0,1,1,"dummy"
"97393",2,2,2,6,"dummy"
"97409",0,5,0,5,"dummy"
"97420",0,1,0,1,"dummy"
"97421",0,0,1,1,"dummy"
"97423",1,0,0,1,"dummy"
"97424",0,0,1,1,"dummy"
"97425",2,0,0,2,"dummy"
"97426",0,1,0,1,"dummy"
"97430",0,1,0,1,"dummy"
"97432",1,7,1,9,"dummy"
"97433",0,0,0,0,"dummy"
"97436",0,5,2,7,"dummy"
"97437",0,0,2,2,"dummy"
"97440",0,0,0,0,"dummy"
"97441",2,0,0,2,"dummy"
"97442",0,0,1,1,"dummy"
"97443",0,0,1,1,"dummy"
"97444",0,0,0,0,"dummy"
"97450",0,0,0,0,"dummy"
"97451",0,0,0,0,"dummy"
"97452",0,0,0,0,"dummy"
"97453",0,0,0,0,"dummy"
"97458",0,0,1,1,"dummy"
"97459",1,0,0,1,"dummy"
"97460",0,1,0,1,"dummy"
"97461",0,2,0,2,"dummy"
"97462",0,1,0,1,"dummy"
"97463",1,1,0,2,"dummy"
"97485",4,1,0,5,"dummy"
"97489",0,0,3,3,"dummy"
"97490",0,6,0,6,"dummy"
"97491",5,1,0,6,"dummy"
"97492",4,0,0,4,"dummy"
"97494",0,1,2,3,"dummy"
"97495",0,0,0,0,"dummy"
"97496",0,0,0,0,"dummy"
"97497",0,0,3,3,"dummy"
"97499",0,1,0,1,"dummy"
"97501",4,0,3,7,"dummy"
"97502",4,1,0,5,"dummy"
"97503",1,4,0,5,"dummy"
"97504",0,1,0,1,"dummy"
"97505",0,0,1,1,"dummy"
"97507",0,0,1,1,"dummy"
"97508",0,6,1,7,"dummy"
"97509",0,0,1,1,"dummy"
"97510",0,0,1,1,"dummy"
"97511",2,2,1,5,"dummy"
"97513",3,0,0,3,"dummy"
"97514",0,0,4,4,"dummy"
"97515",0,2,0,2,"dummy"
"97516",1,4,0,5,"dummy"
"97518",2,2,0,4,"dummy"
"97519",2,2,0,4,"dummy"
"97522",8,2,0,10,"dummy"
"97523",1,1,0,2,"dummy"
"97524",0,0,1,1,"dummy"
"97525",0,0,1,1,"dummy"
"97526",0,0,0,0,"dummy"
"97527",0,0,0,0,"dummy"
"97528",0,0,1,1,"dummy"
"97529",0,0,1,1,"dummy"
"97533",0,0,1,1,"dummy"
"97535",2,3,0,5,"dummy"
"97536",11,0,1,12,"dummy"
"97537",0,1,0,1,"dummy"
"97538",1,0,0,1,"dummy"
"97539",0,2,0,2,"dummy"
"97540",0,1,2,3,"dummy"
"97541",0,2,0,2,"dummy"
"97543",1,1,4,6,"dummy"
"97544",0,0,1,1,"dummy"
"97546",1,0,1,2,"dummy"
"97551",0,0,0,0,"dummy"
"97556",3,8,0,11,"dummy"
"97558",0,1,0,1,"dummy"
"97560",1,0,1,2,"dummy"
"97563",5,2,0,7,"dummy"
"97564",1,0,1,2,"dummy"
"97565",0,1,0,1,"dummy"
"97566",0,0,0,0,"dummy"
"97569",0,3,0,3,"dummy"
"97570",2,0,0,2,"dummy"
"97571",0,2,2,4,"dummy"
"97576",1,2,0,3,"dummy"
"97577",8,24,1,33,"dummy"
"97578",0,2,0,2,"dummy"
"97579",0,0,1,1,"dummy"
"97580",4,0,0,4,"dummy"
"97581",0,0,0,0,"dummy"
"97582",0,0,0,0,"dummy"
"97583",0,0,0,0,"dummy"
"97584",9,9,0,18,"dummy"
"97585",1,1,1,3,"dummy"
"97586",0,2,0,2,"dummy"
"97587",0,1,0,1,"dummy"
"97600",0,2,0,2,"dummy"
"97601",0,1,0,1,"dummy"
"97602",0,0,0,0,"dummy"
"97603",0,0,0,0,"dummy"
"97604",0,0,0,0,"dummy"
"97605",0,1,0,1,"dummy"
"97606",0,1,0,1,"dummy"
"97607",0,0,0,0,"dummy"
"97608",0,0,0,0,"dummy"
"97614",0,1,0,1,"dummy"
"97615",4,4,1,9,"dummy"
"97616",0,0,0,0,"dummy"
"97626",0,1,0,1,"dummy"
"97634",0,0,1,1,"dummy"
"97636",0,0,3,3,"dummy"
"97639",0,1,0,1,"dummy"
"97642",1,4,0,5,"dummy"
"97645",1,3,2,6,"dummy"
"97646",3,1,0,4,"dummy"
"97647",0,0,3,3,"dummy"
"97648",0,0,2,2,"dummy"
"97649",0,0,0,0,"dummy"
"97652",0,0,0,0,"dummy"
"97653",0,0,1,1,"dummy"
"97656",2,18,0,20,"dummy"
"97658",6,10,2,18,"dummy"
"97659",0,0,1,1,"dummy"
"97661",0,0,1,1,"dummy"
"97662",10,15,0,25,"dummy"
"97663",0,0,0,0,"dummy"
"97669",1,3,2,6,"dummy"
"97673",0,0,1,1,"dummy"
"97674",0,0,1,1,"dummy"
"97675",0,0,1,1,"dummy"
"97680",0,1,0,1,"dummy"
"97681",0,0,1,1,"dummy"
"97682",0,1,0,1,"dummy"
"97683",0,4,0,4,"dummy"
"97693",0,0,0,0,"dummy"
"97709",4,7,3,14,"dummy"
"97710",2,2,3,7,"dummy"
"97722",3,0,0,3,"dummy"
"97726",2,2,1,5,"dummy"
"97727",0,0,1,1,"dummy"
"97764",0,1,0,1,"dummy"
"97765",0,1,0,1,"dummy"
"97766",0,1,0,1,"dummy"
"97767",0,2,0,2,"dummy"
"97768",1,1,0,2,"dummy"
"97769",1,1,0,2,"dummy"
"97770",0,0,1,1,"dummy"
"97776",1,3,0,4,"dummy"
"97790",0,0,1,1,"dummy"
"97791",11,7,2,20,"dummy"
"97796",0,0,1,1,"dummy"
"97803",0,0,2,2,"dummy"
"97807",5,5,2,12,"dummy"
"97811",1,0,0,1,"dummy"
"97859",0,0,0,0,"dummy"
"97860",0,0,1,1,"dummy"
"97861",0,0,0,0,"dummy"
"97862",0,0,0,0,"dummy"
"97863",0,0,0,0,"dummy"
"97864",1,2,0,3,"dummy"
"97865",2,1,1,4,"dummy"
"97866",0,0,1,1,"dummy"
"97867",0,0,0,0,"dummy"
"97868",0,0,1,1,"dummy"
"97869",0,0,0,0,"dummy"
"97870",0,0,1,1,"dummy"
"97871",0,0,0,0,"dummy"
"97899",14,2,2,18,"dummy"
"97902",0,16,0,16,"dummy"
"97903",2,8,1,11,"dummy"
"97909",0,5,0,5,"dummy"
"97910",0,0,1,1,"dummy"
"97911",1,0,0,1,"dummy"
"97912",0,2,0,2,"dummy"
"97913",0,1,0,1,"dummy"
"97914",0,2,0,2,"dummy"
"97915",21,0,0,21,"dummy"
"97916",4,4,0,8,"dummy"
"97922",0,1,3,4,"dummy"
"97923",10,15,1,26,"dummy"
"97932",0,12,0,12,"dummy"
"97933",2,1,0,3,"dummy"
"97934",0,3,0,3,"dummy"
"97935",0,3,0,3,"dummy"
"97936",0,0,2,2,"dummy"
"97939",0,0,0,0,"dummy"
"97940",0,0,0,0,"dummy"
"97712",4,10,4,18,"dummy"
"97715",2,4,1,7,"dummy"
"97720",0,1,0,1,"dummy"
"97724",0,1,0,1,"dummy"
"97729",1,15,0,16,"dummy"
"97732",0,0,1,1,"dummy"
"97733",5,24,0,29,"dummy"
"97734",0,1,0,1,"dummy"
"97735",1,0,0,1,"dummy"
"97736",1,0,0,1,"dummy"
"97737",0,0,1,1,"dummy"
"97738",0,0,1,1,"dummy"
"97739",0,0,1,1,"dummy"
"97762",0,0,1,1,"dummy"
"97772",0,1,0,1,"dummy"
"97773",2,2,0,4,"dummy"
"97774",0,3,0,3,"dummy"
"97780",0,1,0,1,"dummy"
"97783",6,0,0,6,"dummy"
"97784",2,5,2,9,"dummy"
"97787",0,0,0,0,"dummy"
"97788",17,0,1,18,"dummy"
"97798",5,0,0,5,"dummy"
"97801",1,0,1,2,"dummy"
"97805",0,1,0,1,"dummy"
"97809",0,0,2,2,"dummy"
"97815",6,0,1,7,"dummy"
"97816",0,0,1,1,"dummy"
"97817",0,2,0,2,"dummy"
"97818",2,1,1,4,"dummy"
"97819",0,0,1,1,"dummy"
"97820",0,1,0,1,"dummy"
"97821",0,1,0,1,"dummy"
"97822",0,1,0,1,"dummy"
"97823",3,1,0,4,"dummy"
"97824",0,1,0,1,"dummy"
"97825",1,2,0,3,"dummy"
"97826",0,1,0,1,"dummy"
"97827",2,0,1,3,"dummy"
"97828",6,12,3,21,"dummy"
"97829",5,7,0,12,"dummy"
"97830",0,1,0,1,"dummy"
"97831",0,1,0,1,"dummy"
"97832",0,0,1,1,"dummy"
"97833",0,1,0,1,"dummy"
"97834",0,0,1,1,"dummy"
"97835",1,0,0,1,"dummy"
"97836",0,0,1,1,"dummy"
"97837",13,13,0,26,"dummy"
"97838",3,0,1,4,"dummy"
"97839",2,0,0,2,"dummy"
"97840",0,1,0,1,"dummy"
"97841",1,0,0,1,"dummy"
"97842",2,2,0,4,"dummy"
"97843",0,2,0,2,"dummy"
"97844",0,2,0,2,"dummy"
"97845",0,1,0,1,"dummy"
"97846",1,1,0,2,"dummy"
"97847",0,1,0,1,"dummy"
"97848",2,0,0,2,"dummy"
"97849",0,3,0,3,"dummy"
"97850",0,1,0,1,"dummy"
"97853",8,11,4,23,"dummy"
"97854",0,0,1,1,"dummy"
"97855",0,1,0,1,"dummy"
"97856",0,1,0,1,"dummy"
"97857",0,1,0,1,"dummy"
"97873",0,0,1,1,"dummy"
"97876",0,1,1,2,"dummy"
"97877",0,3,0,3,"dummy"
"97878",5,4,0,9,"dummy"
"97879",0,5,0,5,"dummy"
"97880",0,2,0,2,"dummy"
"97881",0,1,1,2,"dummy"
"97882",0,4,0,4,"dummy"
"97883",0,1,0,1,"dummy"
"97884",0,0,0,0,"dummy"
"97885",1,0,0,1,"dummy"
"97886",9,1,0,10,"dummy"
"97887",4,3,0,7,"dummy"
"97888",3,5,0,8,"dummy"
"97889",29,15,3,47,"dummy"
"97890",2,1,1,4,"dummy"
"97891",0,0,1,1,"dummy"
"97892",0,0,1,1,"dummy"
"97893",0,0,4,4,"dummy"
"97896",0,0,1,1,"dummy"
"97897",0,1,0,1,"dummy"
"97905",0,0,1,1,"dummy"
"97906",0,0,1,1,"dummy"
"97907",0,0,1,1,"dummy"
"97918",3,3,0,6,"dummy"
"97942",0,0,1,1,"dummy"
"97943",3,3,3,9,"dummy"
"97944",0,2,0,2,"dummy"
"97996",2,2,0,4,"dummy"
"97997",0,1,0,1,"dummy"
"97998",1,0,0,1,"dummy"
"98001",0,0,1,1,"dummy"
"98003",0,1,0,1,"dummy"
"98004",0,0,1,1,"dummy"
"98005",0,1,0,1,"dummy"
"98006",2,1,0,3,"dummy"
"98007",0,0,1,1,"dummy"
"98008",12,4,1,17,"dummy"
"98009",0,0,0,0,"dummy"
"98010",7,0,0,7,"dummy"
"98011",1,1,1,3,"dummy"
"98014",0,5,0,5,"dummy"
"98016",0,3,0,3,"dummy"
"98017",0,0,1,1,"dummy"
"98019",7,1,0,8,"dummy"
"98022",1,0,0,1,"dummy"
"98023",0,0,1,1,"dummy"
"98029",0,0,1,1,"dummy"
"98031",0,1,0,1,"dummy"
"98032",0,1,0,1,"dummy"
"98033",0,0,2,2,"dummy"
"98035",4,6,2,12,"dummy"
"98036",0,1,0,1,"dummy"
"98037",0,0,1,1,"dummy"
"98038",5,3,1,9,"dummy"
"98039",0,0,0,0,"dummy"
"98041",5,4,1,10,"dummy"
"98042",6,8,2,16,"dummy"
"98043",2,1,0,3,"dummy"
"98044",0,0,0,0,"dummy"
"98046",0,0,0,0,"dummy"
"98048",4,6,4,14,"dummy"
"98049",0,3,0,3,"dummy"
"98050",0,2,0,2,"dummy"
"98051",0,2,0,2,"dummy"
"98052",0,2,0,2,"dummy"
"98056",2,2,0,4,"dummy"
"98058",0,5,0,5,"dummy"
"98059",7,3,0,10,"dummy"
"98060",0,5,0,5,"dummy"
"98061",0,0,3,3,"dummy"
"98062",3,1,0,4,"dummy"
"98063",0,4,0,4,"dummy"
"98064",0,0,1,1,"dummy"
"98065",0,6,2,8,"dummy"
"98066",0,0,1,1,"dummy"
"98067",0,0,2,2,"dummy"
"98068",0,0,1,1,"dummy"
"98069",11,1,0,12,"dummy"
"98070",8,6,2,16,"dummy"
"98071",0,0,1,1,"dummy"
"98074",0,0,0,0,"dummy"
"98075",1,7,0,8,"dummy"
"98076",7,1,0,8,"dummy"
"98078",0,1,0,1,"dummy"
"98079",0,0,0,0,"dummy"
"98080",0,0,0,0,"dummy"
"98083",2,4,0,6,"dummy"
"98084",0,2,0,2,"dummy"
"98085",0,2,0,2,"dummy"
"98086",10,2,0,12,"dummy"
"98087",0,2,0,2,"dummy"
"98088",0,0,0,0,"dummy"
"98089",0,0,3,3,"dummy"
"98090",0,5,0,5,"dummy"
"98091",1,0,1,2,"dummy"
"98094",0,1,1,2,"dummy"
"98095",1,0,1,2,"dummy"
"98096",0,0,0,0,"dummy"
"98125",0,0,1,1,"dummy"
"98128",0,0,1,1,"dummy"
"98129",1,0,1,2,"dummy"
"98130",0,3,3,6,"dummy"
"98131",0,1,1,2,"dummy"
"98132",0,1,0,1,"dummy"
"98133",0,0,0,0,"dummy"
"98134",1,2,1,4,"dummy"
"98135",2,0,0,2,"dummy"
"98136",0,4,0,4,"dummy"
"98137",0,1,0,1,"dummy"
"98138",9,26,1,36,"dummy"
"98139",27,2,1,30,"dummy"
"98140",0,2,1,3,"dummy"
"98141",2,11,0,13,"dummy"
"98142",6,0,1,7,"dummy"
"98145",1,3,0,4,"dummy"
"98146",4,1,2,7,"dummy"
"98147",0,1,1,2,"dummy"
"98148",0,1,1,2,"dummy"
"98149",0,3,0,3,"dummy"
"98153",0,0,1,1,"dummy"
"98154",0,1,1,2,"dummy"
"98156",0,2,1,3,"dummy"
"98160",0,0,2,2,"dummy"
"98161",0,1,0,1,"dummy"
"98162",2,2,0,4,"dummy"
"98163",3,5,1,9,"dummy"
"98164",6,0,3,9,"dummy"
"98167",0,0,1,1,"dummy"
"98168",1,3,1,5,"dummy"
"98169",7,10,4,21,"dummy"
"98170",0,1,0,1,"dummy"
"98171",0,4,0,4,"dummy"
"98172",0,1,0,1,"dummy"
"98173",0,5,0,5,"dummy"
"98174",0,1,0,1,"dummy"
"98175",1,3,1,5,"dummy"
"98178",0,0,1,1,"dummy"
"98179",0,0,1,1,"dummy"
"98180",0,0,1,1,"dummy"
"98181",0,0,1,1,"dummy"
"98182",0,0,1,1,"dummy"
"98225",0,2,0,2,"dummy"
"98226",0,1,0,1,"dummy"
"98227",0,1,0,1,"dummy"
"98228",0,1,1,2,"dummy"
"98229",1,5,0,6,"dummy"
"98230",0,1,0,1,"dummy"
"98231",6,18,0,24,"dummy"
"98232",0,1,0,1,"dummy"
"98237",0,0,2,2,"dummy"
"98244",1,0,0,1,"dummy"
"98245",10,8,0,18,"dummy"
"98250",0,0,0,0,"dummy"
"98251",8,6,2,16,"dummy"
"98269",6,5,2,13,"dummy"
"98271",0,3,0,3,"dummy"
"98272",0,3,0,3,"dummy"
"98273",9,3,1,13,"dummy"
"98274",0,1,2,3,"dummy"
"98275",6,4,3,13,"dummy"
"98276",0,1,0,1,"dummy"
"98277",0,0,0,0,"dummy"
"98280",6,4,0,10,"dummy"
"98281",1,24,4,29,"dummy"
"98282",20,0,0,20,"dummy"
"98284",4,31,1,36,"dummy"
"98285",0,6,0,6,"dummy"
"98286",0,0,1,1,"dummy"
"98287",0,0,1,1,"dummy"
"98289",16,19,4,39,"dummy"
"98291",22,7,5,34,"dummy"
"98292",2,2,1,5,"dummy"
"98293",2,23,5,30,"dummy"
"98294",4,3,1,8,"dummy"
"98295",1,0,0,1,"dummy"
"98296",24,15,4,43,"dummy"
"98297",1,1,0,2,"dummy"
"98298",15,10,2,27,"dummy"
"98299",2,1,0,3,"dummy"
"98300",1,0,0,1,"dummy"
"98301",0,0,0,0,"dummy"
"98302",6,8,3,17,"dummy"
"98303",0,0,0,0,"dummy"
"98309",3,9,1,13,"dummy"
"98310",0,1,0,1,"dummy"
"98311",0,1,1,2,"dummy"
"98312",0,1,0,1,"dummy"
"98314",0,1,0,1,"dummy"
"98315",0,3,0,3,"dummy"
"98316",2,5,1,8,"dummy"
"98317",0,0,5,5,"dummy"
"98318",0,0,1,1,"dummy"
"98321",0,1,0,1,"dummy"
"98322",8,21,1,30,"dummy"
"98323",0,1,0,1,"dummy"
"98327",2,0,0,2,"dummy"
"98329",0,2,0,2,"dummy"
"98330",0,1,0,1,"dummy"
"98331",1,1,0,2,"dummy"
"98332",3,4,0,7,"dummy"
"98333",0,0,2,2,"dummy"
"98334",0,2,0,2,"dummy"
"98335",0,1,0,1,"dummy"
"98336",0,3,0,3,"dummy"
"98338",0,2,0,2,"dummy"
"98348",0,1,0,1,"dummy"
"98349",0,2,0,2,"dummy"
"98351",4,15,0,19,"dummy"
"98352",1,0,0,1,"dummy"
"98354",0,4,0,4,"dummy"
"98355",0,0,2,2,"dummy"
"98356",0,1,0,1,"dummy"
"98357",1,0,0,1,"dummy"
"98361",1,6,0,7,"dummy"
"98366",10,10,0,20,"dummy"
"98367",11,4,2,17,"dummy"
"98369",0,0,1,1,"dummy"
"98370",0,2,0,2,"dummy"
"98371",0,0,1,1,"dummy"
"98374",0,0,1,1,"dummy"
"98375",0,1,2,3,"dummy"
"98377",0,2,0,2,"dummy"
"98378",1,4,0,5,"dummy"
"98379",2,2,0,4,"dummy"
"98380",2,0,0,2,"dummy"
"98381",2,0,0,2,"dummy"
"98382",2,0,0,2,"dummy"
"98383",0,1,0,1,"dummy"
"98384",3,2,0,5,"dummy"
"98391",0,0,0,0,"dummy"
"98392",0,0,0,0,"dummy"
"98394",0,0,1,1,"dummy"
"98396",2,2,0,4,"dummy"
"98398",0,1,0,1,"dummy"
"98399",0,3,0,3,"dummy"
"98400",0,3,0,3,"dummy"
"98401",7,3,0,10,"dummy"
"98402",0,0,1,1,"dummy"
"98403",0,0,1,1,"dummy"
"98417",0,1,0,1,"dummy"
"98420",0,5,0,5,"dummy"
"98421",3,6,2,11,"dummy"
"98422",1,5,2,8,"dummy"
"98423",0,0,1,1,"dummy"
"98424",0,1,0,1,"dummy"
"98425",0,1,0,1,"dummy"
"98426",6,0,0,6,"dummy"
"98428",1,2,1,4,"dummy"
"98429",0,1,1,2,"dummy"
"98430",0,0,1,1,"dummy"
"98431",0,5,3,8,"dummy"
"98436",11,14,3,28,"dummy"
"98438",0,0,1,1,"dummy"
"98439",0,0,2,2,"dummy"
"98441",1,3,1,5,"dummy"
"98442",0,1,0,1,"dummy"
"98443",0,0,1,1,"dummy"
"98444",0,0,0,0,"dummy"
"98449",1,0,0,1,"dummy"
"98450",0,0,1,1,"dummy"
"98453",0,2,0,2,"dummy"
"98454",0,1,0,1,"dummy"
"98455",0,3,0,3,"dummy"
"98456",0,3,0,3,"dummy"
"98457",3,1,0,4,"dummy"
"98458",0,1,0,1,"dummy"
"98459",0,6,0,6,"dummy"
"98461",0,6,1,7,"dummy"
"98462",5,0,0,5,"dummy"
"98464",0,0,0,0,"dummy"
"98465",0,0,1,1,"dummy"
"98466",0,0,1,1,"dummy"
"98482",0,0,1,1,"dummy"
"98483",0,0,1,1,"dummy"
"98484",0,0,1,1,"dummy"
"98485",0,0,1,1,"dummy"
"98491",11,3,2,16,"dummy"
"98492",2,13,4,19,"dummy"
"98493",0,2,0,2,"dummy"
"98494",0,1,0,1,"dummy"
"98495",1,0,0,1,"dummy"
"98496",0,2,0,2,"dummy"
"98497",13,2,0,15,"dummy"
"98498",13,1,2,16,"dummy"
"98499",0,1,0,1,"dummy"
"98500",0,1,0,1,"dummy"
"98501",1,0,1,2,"dummy"
"98502",1,0,1,2,"dummy"
"98503",2,0,2,4,"dummy"
"98504",1,0,0,1,"dummy"
"98505",0,0,1,1,"dummy"
"98506",0,0,1,1,"dummy"
"98507",0,0,1,1,"dummy"
"98508",0,0,1,1,"dummy"
"98509",0,0,1,1,"dummy"
"98510",0,0,1,1,"dummy"
"98511",0,0,1,1,"dummy"
"98512",0,0,1,1,"dummy"
"98513",0,0,1,1,"dummy"
"98514",0,0,1,1,"dummy"
"98515",0,0,1,1,"dummy"
"98516",0,0,1,1,"dummy"
"98517",0,0,1,1,"dummy"
"98518",0,0,1,1,"dummy"
"98519",0,0,1,1,"dummy"
"98520",0,0,1,1,"dummy"
"98522",1,0,0,1,"dummy"
"98523",1,2,0,3,"dummy"
"98525",0,2,0,2,"dummy"
"98526",0,0,0,0,"dummy"
"98527",0,2,0,2,"dummy"
"98528",0,3,0,3,"dummy"
"98529",0,2,0,2,"dummy"
"98530",0,2,0,2,"dummy"
"98531",0,0,0,0,"dummy"
"98532",0,0,1,1,"dummy"
"98533",0,3,0,3,"dummy"
"98534",0,0,1,1,"dummy"
"98536",2,4,0,6,"dummy"
"98537",0,2,0,2,"dummy"
"98538",0,2,0,2,"dummy"
"98539",10,2,0,12,"dummy"
"98540",0,2,0,2,"dummy"
"98545",0,1,0,1,"dummy"
"98546",2,3,4,9,"dummy"
"98547",3,1,3,7,"dummy"
"98548",0,3,0,3,"dummy"
"98549",0,1,0,1,"dummy"
"98550",0,2,0,2,"dummy"
"98551",1,0,0,1,"dummy"
"98552",1,1,3,5,"dummy"
"98553",9,3,1,13,"dummy"
"98554",0,1,0,1,"dummy"
"98555",1,0,0,1,"dummy"
"98561",0,0,2,2,"dummy"
"98562",0,0,1,1,"dummy"
"98563",0,3,0,3,"dummy"
"98564",1,1,1,3,"dummy"
"98565",0,0,1,1,"dummy"
"98566",0,0,1,1,"dummy"
"98569",2,0,0,2,"dummy"
"98570",0,3,0,3,"dummy"
"98571",0,0,1,1,"dummy"
"98579",0,0,0,0,"dummy"
"98580",0,0,0,0,"dummy"
"98588",1,0,0,1,"dummy"
"98590",2,1,0,3,"dummy"
"98591",3,0,0,3,"dummy"
"98593",1,0,0,1,"dummy"
"98594",0,1,0,1,"dummy"
"98595",0,0,1,1,"dummy"
"98596",9,4,2,15,"dummy"
"98597",0,0,2,2,"dummy"
"98598",0,0,1,1,"dummy"
"98599",1,0,1,2,"dummy"
"98600",1,4,2,7,"dummy"
"98603",8,6,1,15,"dummy"
"98607",19,16,2,37,"dummy"
"98611",0,0,2,2,"dummy"
"98613",4,2,1,7,"dummy"
"98614",1,0,2,3,"dummy"
"98615",0,0,2,2,"dummy"
"98616",2,1,0,3,"dummy"
"98617",4,4,1,9,"dummy"
"98620",0,1,0,1,"dummy"
"98624",2,4,3,9,"dummy"
"98657",3,1,1,5,"dummy"
"98658",0,1,0,1,"dummy"
"98659",0,1,0,1,"dummy"
"98661",1,1,2,4,"dummy"
"98662",0,0,2,2,"dummy"
"98663",0,3,1,4,"dummy"
"98664",0,0,2,2,"dummy"
"98666",0,0,0,0,"dummy"
"98667",0,1,0,1,"dummy"
"98668",0,2,0,2,"dummy"
"98669",0,0,1,1,"dummy"
"98670",1,2,0,3,"dummy"
"98671",0,0,0,0,"dummy"
"98672",0,9,0,9,"dummy"
"98673",1,2,0,3,"dummy"
"98674",0,4,0,4,"dummy"
"98675",0,1,1,2,"dummy"
"98679",12,14,2,28,"dummy"
"98681",3,16,0,19,"dummy"
"98692",2,1,0,3,"dummy"
"98693",0,1,0,1,"dummy"
"98696",0,3,0,3,"dummy"
"98699",0,0,1,1,"dummy"
"98700",0,1,0,1,"dummy"
"98722",3,1,1,5,"dummy"
"98723",0,0,0,0,"dummy"
"98724",7,5,1,13,"dummy"
"98725",2,1,1,4,"dummy"
"98726",0,1,0,1,"dummy"
"98727",0,0,1,1,"dummy"
"98728",0,0,0,0,"dummy"
"98729",0,2,0,2,"dummy"
"98730",0,0,0,0,"dummy"
"98731",6,1,0,7,"dummy"
"98732",1,13,1,15,"dummy"
"98733",0,0,1,1,"dummy"
"98734",0,0,0,0,"dummy"
"98735",0,5,0,5,"dummy"
"98736",5,0,0,5,"dummy"
"98737",0,5,0,5,"dummy"
"98738",0,13,0,13,"dummy"
"98739",13,0,1,14,"dummy"
"98740",0,0,1,1,"dummy"
"98741",0,2,0,2,"dummy"
"98742",1,0,1,2,"dummy"
"98743",0,0,1,1,"dummy"
"98744",0,0,2,2,"dummy"
"98745",2,7,2,11,"dummy"
"98746",2,8,0,10,"dummy"
"98747",0,0,2,2,"dummy"
"98748",6,3,0,9,"dummy"
"98749",0,2,0,2,"dummy"
"98750",0,0,1,1,"dummy"
"98751",5,0,1,6,"dummy"
"98752",0,0,2,2,"dummy"
"98753",0,2,0,2,"dummy"
"98757",3,2,0,5,"dummy"
"98758",0,1,0,1,"dummy"
"98759",0,0,0,0,"dummy"
"98760",9,0,0,9,"dummy"
"98761",0,1,0,1,"dummy"
"98764",5,13,0,18,"dummy"
"98775",2,7,0,9,"dummy"
"98776",0,0,1,1,"dummy"
"98777",0,0,1,1,"dummy"
"98778",0,1,0,1,"dummy"
"98798",2,3,2,7,"dummy"
"98799",4,5,5,14,"dummy"
"98800",0,0,1,1,"dummy"
"98802",1,0,0,1,"dummy"
"98804",0,1,0,1,"dummy"
"98807",0,0,1,1,"dummy"
"98808",0,11,0,11,"dummy"
"98809",0,0,1,1,"dummy"
"98810",0,0,2,2,"dummy"
"98811",0,4,1,5,"dummy"
"98812",0,0,1,1,"dummy"
"98813",0,0,2,2,"dummy"
"98814",4,3,2,9,"dummy"
"98818",0,0,1,1,"dummy"
"98820",0,1,0,1,"dummy"
"98821",8,9,2,19,"dummy"
"98822",0,1,0,1,"dummy"
"98823",0,1,0,1,"dummy"
"98824",0,2,0,2,"dummy"
"98825",0,1,1,2,"dummy"
"98826",0,0,1,1,"dummy"
"98829",0,0,3,3,"dummy"
"98830",0,5,0,5,"dummy"
"98870",0,0,1,1,"dummy"
"98871",1,0,0,1,"dummy"
"98872",0,0,1,1,"dummy"
"98873",0,1,0,1,"dummy"
"98874",1,0,0,1,"dummy"
"98875",0,2,0,2,"dummy"
"98876",0,0,1,1,"dummy"
"98877",1,0,0,1,"dummy"
"98878",0,1,2,3,"dummy"
"98879",0,0,1,1,"dummy"
"98880",1,0,0,1,"dummy"
"98881",0,1,0,1,"dummy"
"98882",0,1,0,1,"dummy"
"98883",0,1,0,1,"dummy"
"98884",0,1,0,1,"dummy"
"98885",0,0,1,1,"dummy"
"98886",0,0,1,1,"dummy"
"98887",0,0,1,1,"dummy"
"98888",0,0,1,1,"dummy"
"98890",2,2,0,4,"dummy"
"98891",1,2,0,3,"dummy"
"98893",6,6,1,13,"dummy"
"98894",0,11,0,11,"dummy"
"98896",0,4,1,5,"dummy"
"98902",6,0,0,6,"dummy"
"98903",2,5,2,9,"dummy"
"98905",0,11,0,11,"dummy"
"98907",2,5,2,9,"dummy"
"98923",9,13,4,26,"dummy"
"98924",2,7,1,10,"dummy"
"98925",2,2,1,5,"dummy"
"98926",0,1,0,1,"dummy"
"98927",0,0,0,0,"dummy"
"98928",24,11,0,35,"dummy"
"98929",1,5,2,8,"dummy"
"98930",8,1,0,9,"dummy"
"98931",1,3,1,5,"dummy"
"98933",2,0,0,2,"dummy"
"98934",0,0,1,1,"dummy"
"98936",0,0,0,0,"dummy"
"98937",0,0,0,0,"dummy"
"98940",2,4,1,7,"dummy"
"98941",0,0,1,1,"dummy"
"98942",0,1,0,1,"dummy"
"98943",2,4,0,6,"dummy"
"98944",0,0,2,2,"dummy"
"98945",2,3,1,6,"dummy"
"98946",25,36,1,62,"dummy"
"98947",1,3,0,4,"dummy"
"98948",6,39,0,45,"dummy"
"98949",2,18,3,23,"dummy"
"98950",62,5,0,67,"dummy"
"98951",8,1,1,10,"dummy"
"98952",0,0,1,1,"dummy"
"98953",0,2,1,3,"dummy"
"98954",0,0,0,0,"dummy"
"98955",5,2,1,8,"dummy"
"98956",1,0,0,1,"dummy"
"98957",0,1,0,1,"dummy"
"98958",0,0,0,0,"dummy"
"98963",0,1,0,1,"dummy"
"98964",0,0,0,0,"dummy"
"99019",7,1,1,9,"dummy"
"99020",0,1,0,1,"dummy"
"99021",2,4,0,6,"dummy"
"99022",0,0,0,0,"dummy"
"99025",1,0,1,2,"dummy"
"99026",0,1,0,1,"dummy"
"99059",0,1,0,1,"dummy"
"99060",7,18,0,25,"dummy"
"99061",0,1,0,1,"dummy"
"99062",4,1,0,5,"dummy"
"99063",0,1,0,1,"dummy"
"99142",0,1,0,1,"dummy"
"99158",8,8,1,17,"dummy"
"99159",0,1,0,1,"dummy"
"99160",1,0,0,1,"dummy"
"99161",8,8,1,17,"dummy"
"99166",0,0,1,1,"dummy"
"99167",0,0,1,1,"dummy"
"99168",0,0,2,2,"dummy"
"99171",0,0,1,1,"dummy"
"99172",0,2,0,2,"dummy"
"99173",0,0,1,1,"dummy"
"99174",0,4,0,4,"dummy"
"99175",0,1,0,1,"dummy"
"99176",1,1,0,2,"dummy"
"99177",4,0,1,5,"dummy"
"99198",5,4,1,10,"dummy"
"99199",0,0,2,2,"dummy"
"99200",0,0,1,1,"dummy"
"99201",0,1,0,1,"dummy"
"99210",0,11,0,11,"dummy"
"99216",5,8,2,15,"dummy"
"99217",0,1,0,1,"dummy"
"99218",1,0,0,1,"dummy"
"99219",0,1,0,1,"dummy"
"99256",1,0,0,1,"dummy"
"99259",0,1,0,1,"dummy"
"99263",0,1,1,2,"dummy"
"99264",0,1,0,1,"dummy"
"99265",1,1,4,6,"dummy"
"99266",0,5,1,6,"dummy"
"98960",9,5,2,16,"dummy"
"98961",0,2,0,2,"dummy"
"98968",0,0,0,0,"dummy"
"98969",0,0,0,0,"dummy"
"98970",0,0,0,0,"dummy"
"98971",0,11,0,11,"dummy"
"98972",0,1,0,1,"dummy"
"98973",0,0,0,0,"dummy"
"98974",0,0,0,0,"dummy"
"98975",1,1,0,2,"dummy"
"98976",0,3,1,4,"dummy"
"98977",0,1,0,1,"dummy"
"98978",0,1,0,1,"dummy"
"98979",11,15,0,26,"dummy"
"98980",1,2,0,3,"dummy"
"98981",0,6,0,6,"dummy"
"98982",0,2,0,2,"dummy"
"98985",0,1,0,1,"dummy"
"98986",0,0,1,1,"dummy"
"98987",0,0,1,1,"dummy"
"98988",0,4,3,7,"dummy"
"98989",4,5,0,9,"dummy"
"98990",0,6,1,7,"dummy"
"98991",0,1,0,1,"dummy"
"98992",0,0,1,1,"dummy"
"98993",1,7,0,8,"dummy"
"98994",0,0,1,1,"dummy"
"98995",0,1,0,1,"dummy"
"99052",0,0,1,1,"dummy"
"99055",0,1,0,1,"dummy"
"99056",0,1,0,1,"dummy"
"99057",0,1,0,1,"dummy"
"99065",1,2,2,5,"dummy"
"99066",4,2,1,7,"dummy"
"99067",0,1,0,1,"dummy"
"99068",0,7,0,7,"dummy"
"99069",0,0,1,1,"dummy"
"99070",4,7,3,14,"dummy"
"99071",0,1,0,1,"dummy"
"99099",8,1,2,11,"dummy"
"99137",7,2,4,13,"dummy"
"99138",0,0,0,0,"dummy"
"99179",0,1,1,2,"dummy"
"99180",2,2,2,6,"dummy"
"99183",0,1,0,1,"dummy"
"99188",0,0,1,1,"dummy"
"99189",0,0,1,1,"dummy"
"99203",2,2,2,6,"dummy"
"99212",1,1,0,2,"dummy"
"99223",10,13,3,26,"dummy"
"99224",2,0,0,2,"dummy"
"99225",0,4,0,4,"dummy"
"99226",0,2,0,2,"dummy"
"99227",0,0,0,0,"dummy"
"99228",8,5,1,14,"dummy"
"99229",0,3,0,3,"dummy"
"99230",0,1,0,1,"dummy"
"99231",2,1,0,3,"dummy"
"99232",0,0,0,0,"dummy"
"99233",0,1,0,1,"dummy"
"99234",0,3,0,3,"dummy"
"99235",0,0,0,0,"dummy"
"99236",1,1,0,2,"dummy"
"99237",0,2,1,3,"dummy"
"99238",0,1,0,1,"dummy"
"99239",10,13,2,25,"dummy"
"99240",0,0,2,2,"dummy"
"99241",12,1,0,13,"dummy"
"99242",0,0,0,0,"dummy"
"99243",0,0,1,1,"dummy"
"99244",0,0,0,0,"dummy"
"99247",0,1,0,1,"dummy"
"99248",3,1,0,4,"dummy"
"99249",5,3,0,8,"dummy"
"99250",1,1,3,5,"dummy"
"99251",0,0,5,5,"dummy"
"99254",27,33,1,61,"dummy"
"99261",0,5,0,5,"dummy"
"99276",6,0,0,6,"dummy"
"99277",2,5,2,9,"dummy"
"99294",1,0,3,4,"dummy"
"99295",1,0,0,1,"dummy"
"99311",0,1,0,1,"dummy"
"99312",0,1,1,2,"dummy"
"99313",2,1,0,3,"dummy"
"99314",1,7,0,8,"dummy"
"99315",0,9,3,12,"dummy"
"99316",1,0,0,1,"dummy"
"99317",0,6,1,7,"dummy"
"99318",0,0,2,2,"dummy"
"99267",1,1,0,2,"dummy"
"99268",4,4,0,8,"dummy"
"99269",12,8,2,22,"dummy"
"99270",1,2,0,3,"dummy"
"99271",3,2,0,5,"dummy"
"99272",0,2,0,2,"dummy"
"99273",7,2,1,10,"dummy"
"99274",0,0,1,1,"dummy"
"99285",0,0,0,0,"dummy"
"99286",0,1,0,1,"dummy"
"99287",0,1,0,1,"dummy"
"99288",1,0,0,1,"dummy"
"99289",0,1,0,1,"dummy"
"99290",1,0,0,1,"dummy"
"99297",0,1,0,1,"dummy"
"99298",1,2,0,3,"dummy"
"99301",0,1,0,1,"dummy"
"99304",3,2,0,5,"dummy"
"99305",0,2,0,2,"dummy"
"99306",0,0,1,1,"dummy"
"99307",1,3,2,6,"dummy"
"99308",0,0,1,1,"dummy"
"99309",4,1,1,6,"dummy"
"99328",3,3,1,7,"dummy"
"99333",0,3,1,4,"dummy"
"99335",2,0,0,2,"dummy"
"99339",0,1,0,1,"dummy"
"99341",0,1,0,1,"dummy"
"99342",0,0,2,2,"dummy"
"99343",0,6,1,7,"dummy"
"99344",5,1,1,7,"dummy"
"99346",2,1,0,3,"dummy"
"99348",1,5,3,9,"dummy"
"99349",0,3,1,4,"dummy"
"99350",0,0,1,1,"dummy"
"99351",0,0,1,1,"dummy"
"99352",0,0,2,2,"dummy"
"99353",4,0,1,5,"dummy"
"99354",2,0,0,2,"dummy"
"99355",0,1,1,2,"dummy"
"99356",0,1,0,1,"dummy"
"99359",0,0,1,1,"dummy"
"99360",0,0,1,1,"dummy"
"99361",0,0,1,1,"dummy"
"99362",0,0,1,1,"dummy"
"99363",0,0,1,1,"dummy"
"99364",0,0,1,1,"dummy"
"99365",0,0,1,1,"dummy"
"99366",0,2,2,4,"dummy"
"99367",0,0,1,1,"dummy"
"99368",0,0,0,0,"dummy"
"99370",0,0,3,3,"dummy"
"99384",0,0,1,1,"dummy"
"99397",0,0,1,1,"dummy"
"99399",0,1,0,1,"dummy"
"99400",1,0,0,1,"dummy"
"99401",0,1,0,1,"dummy"
"99404",0,1,2,3,"dummy"
"99406",1,4,0,5,"dummy"
"99409",1,0,0,1,"dummy"
"99412",0,0,3,3,"dummy"
"99414",0,1,0,1,"dummy"
"99415",0,3,1,4,"dummy"
"99416",0,4,0,4,"dummy"
"99417",1,4,0,5,"dummy"
"99418",0,1,0,1,"dummy"
"99426",2,0,2,4,"dummy"
"99431",3,4,2,9,"dummy"
"99433",0,1,0,1,"dummy"
"99434",2,1,0,3,"dummy"
"99435",0,0,1,1,"dummy"
"99436",0,2,0,2,"dummy"
"99437",0,1,0,1,"dummy"
"99438",3,3,1,7,"dummy"
"99439",2,0,0,2,"dummy"
"99440",1,4,1,6,"dummy"
"99441",1,4,0,5,"dummy"
"99442",0,1,0,1,"dummy"
"99443",1,0,0,1,"dummy"
"99448",0,4,0,4,"dummy"
"99449",0,1,0,1,"dummy"
"99450",0,1,0,1,"dummy"
"99451",0,3,0,3,"dummy"
"99452",0,1,2,3,"dummy"
"99455",0,1,0,1,"dummy"
"99456",0,1,0,1,"dummy"
"99457",0,0,1,1,"dummy"
"99458",0,0,0,0,"dummy"
"99465",0,0,1,1,"dummy"
"99502",2,0,0,2,"dummy"
"99503",0,1,0,1,"dummy"
"99507",7,12,1,20,"dummy"
"99508",2,0,0,2,"dummy"
"99509",0,0,0,0,"dummy"
"99510",0,1,0,1,"dummy"
"99511",3,1,0,4,"dummy"
"99512",0,0,0,0,"dummy"
"99513",0,0,2,2,"dummy"
"99514",0,0,0,0,"dummy"
"99515",0,0,0,0,"dummy"
"99516",0,0,0,0,"dummy"
"99517",0,0,0,0,"dummy"
"99518",0,0,2,2,"dummy"
"99519",2,0,0,2,"dummy"
"99520",11,12,7,30,"dummy"
"99521",4,3,3,10,"dummy"
"99523",0,2,0,2,"dummy"
"99524",0,0,1,1,"dummy"
"99525",0,0,1,1,"dummy"
"99526",2,2,3,7,"dummy"
"99527",4,1,1,6,"dummy"
"99528",0,1,0,1,"dummy"
"99529",0,0,1,1,"dummy"
"99530",1,0,1,2,"dummy"
"99534",4,3,1,8,"dummy"
"99535",0,2,0,2,"dummy"
"99536",0,12,1,13,"dummy"
"99537",0,3,0,3,"dummy"
"99539",0,0,2,2,"dummy"
"99540",0,1,1,2,"dummy"
"99541",1,1,1,3,"dummy"
"99542",1,1,2,4,"dummy"
"99543",0,0,1,1,"dummy"
"99544",0,0,1,1,"dummy"
"99545",0,0,2,2,"dummy"
"99546",0,0,2,2,"dummy"
"99547",0,0,2,2,"dummy"
"99548",0,0,2,2,"dummy"
"99549",0,0,2,2,"dummy"
"99550",0,0,2,2,"dummy"
"99551",0,0,2,2,"dummy"
"99552",2,0,1,3,"dummy"
"99553",0,0,2,2,"dummy"
"99554",0,0,0,0,"dummy"
"99555",0,0,0,0,"dummy"
"99556",1,1,1,3,"dummy"
"99557",2,1,0,3,"dummy"
"99558",0,1,0,1,"dummy"
"99559",0,0,2,2,"dummy"
"99560",0,0,1,1,"dummy"
"99561",0,0,1,1,"dummy"
"99562",1,0,0,1,"dummy"
"99563",1,0,0,1,"dummy"
"99564",0,0,1,1,"dummy"
"99565",0,0,1,1,"dummy"
"99566",0,1,0,1,"dummy"
"99567",0,1,1,2,"dummy"
"99568",0,0,1,1,"dummy"
"99569",0,0,1,1,"dummy"
"99570",0,0,1,1,"dummy"
"99571",0,0,1,1,"dummy"
"99572",0,0,1,1,"dummy"
"99573",0,0,1,1,"dummy"
"99574",0,0,1,1,"dummy"
"99575",0,0,1,1,"dummy"
"99576",0,2,1,3,"dummy"
"99577",3,1,1,5,"dummy"
"99578",0,0,1,1,"dummy"
"99579",0,0,1,1,"dummy"
"99580",0,0,1,1,"dummy"
"99581",0,0,1,1,"dummy"
"99582",0,0,1,1,"dummy"
"99583",0,0,1,1,"dummy"
"99584",0,0,1,1,"dummy"
"99585",0,0,1,1,"dummy"
"99586",0,0,1,1,"dummy"
"99587",0,0,1,1,"dummy"
"99588",0,0,1,1,"dummy"
"99589",0,0,1,1,"dummy"
"99590",0,0,1,1,"dummy"
"99591",0,0,1,1,"dummy"
"99592",0,0,1,1,"dummy"
"99601",11,6,1,18,"dummy"
"99606",0,2,0,2,"dummy"
"99609",1,0,1,2,"dummy"
"99617",0,1,1,2,"dummy"
"99618",0,0,1,1,"dummy"
"99619",2,0,0,2,"dummy"
"99620",0,0,2,2,"dummy"
"99621",0,0,1,1,"dummy"
"99622",12,0,0,12,"dummy"
"99623",0,2,0,2,"dummy"
"99624",0,1,1,2,"dummy"
"99625",5,5,0,10,"dummy"
"99626",0,0,1,1,"dummy"
"99629",0,0,0,0,"dummy"
"99651",0,3,0,3,"dummy"
"99652",0,1,0,1,"dummy"
"99657",1,1,1,3,"dummy"
"99663",0,1,0,1,"dummy"
"99664",2,9,3,14,"dummy"
"99665",5,10,2,17,"dummy"
"99666",0,1,0,1,"dummy"
"99684",2,0,1,3,"dummy"
"99685",0,0,0,0,"dummy"
"99694",0,0,0,0,"dummy"
"99695",0,0,0,0,"dummy"
"99704",0,0,0,0,"dummy"
"99705",1,1,1,3,"dummy"
"99706",0,0,1,1,"dummy"
"99707",0,1,0,1,"dummy"
"99715",0,0,0,0,"dummy"
"99716",0,0,0,0,"dummy"
"99770",6,0,0,6,"dummy"
"99771",2,5,2,9,"dummy"
"99778",1,0,0,1,"dummy"
"99779",0,0,1,1,"dummy"
"99825",0,1,0,1,"dummy"
"99594",0,0,3,3,"dummy"
"99595",1,0,3,4,"dummy"
"99596",0,0,1,1,"dummy"
"99597",0,0,3,3,"dummy"
"99598",3,12,4,19,"dummy"
"99599",12,3,4,19,"dummy"
"99611",5,5,0,10,"dummy"
"99612",0,1,0,1,"dummy"
"99613",1,2,2,5,"dummy"
"99631",0,7,3,10,"dummy"
"99632",0,1,0,1,"dummy"
"99633",0,0,1,1,"dummy"
"99634",1,2,0,3,"dummy"
"99635",1,4,3,8,"dummy"
"99636",5,13,1,19,"dummy"
"99637",0,0,3,3,"dummy"
"99638",0,6,0,6,"dummy"
"99641",0,0,1,1,"dummy"
"99642",0,0,2,2,"dummy"
"99643",0,1,0,1,"dummy"
"99644",0,3,0,3,"dummy"
"99645",0,0,1,1,"dummy"
"99646",1,1,3,5,"dummy"
"99647",0,1,0,1,"dummy"
"99659",0,0,1,1,"dummy"
"99660",0,0,1,1,"dummy"
"99661",0,0,1,1,"dummy"
"99668",1,1,1,3,"dummy"
"99669",5,3,2,10,"dummy"
"99670",0,2,0,2,"dummy"
"99671",0,3,0,3,"dummy"
"99672",0,3,0,3,"dummy"
"99673",0,2,0,2,"dummy"
"99674",0,2,0,2,"dummy"
"99675",0,1,0,1,"dummy"
"99676",7,4,6,17,"dummy"
"99677",0,2,0,2,"dummy"
"99678",0,0,1,1,"dummy"
"99679",0,0,1,1,"dummy"
"99680",0,2,0,2,"dummy"
"99687",1,1,0,2,"dummy"
"99688",0,0,0,0,"dummy"
"99697",0,3,0,3,"dummy"
"99698",2,5,1,8,"dummy"
"99699",1,2,0,3,"dummy"
"99700",0,3,0,3,"dummy"
"99709",2,15,0,17,"dummy"
"99710",0,2,0,2,"dummy"
"99711",0,1,0,1,"dummy"
"99763",0,7,0,7,"dummy"
"99764",3,8,0,11,"dummy"
"99765",0,1,0,1,"dummy"
"99766",0,2,1,3,"dummy"
"99767",1,3,3,7,"dummy"
"99768",5,1,1,7,"dummy"
"99775",17,4,3,24,"dummy"
"99776",5,24,3,32,"dummy"
"99781",0,0,0,0,"dummy"
"99782",0,0,0,0,"dummy"
"99783",0,0,0,0,"dummy"
"99784",0,0,0,0,"dummy"
"99785",1,0,0,1,"dummy"
"99786",0,0,0,0,"dummy"
"99787",4,5,1,10,"dummy"
"99788",5,5,2,12,"dummy"
"99789",2,2,0,4,"dummy"
"99790",2,2,0,4,"dummy"
"99791",0,0,0,0,"dummy"
"99792",0,1,0,1,"dummy"
"99793",3,12,1,16,"dummy"
"99794",14,5,1,20,"dummy"
"99795",3,12,1,16,"dummy"
"99796",3,13,5,21,"dummy"
"99797",2,2,0,4,"dummy"
"99798",2,2,0,4,"dummy"
"99799",2,2,0,4,"dummy"
"99800",5,5,0,10,"dummy"
"99801",4,4,0,8,"dummy"
"99802",2,2,0,4,"dummy"
"99803",0,0,1,1,"dummy"
"99804",2,2,0,4,"dummy"
"99805",4,4,0,8,"dummy"
"99806",0,2,0,2,"dummy"
"99807",2,0,0,2,"dummy"
"99808",0,2,0,2,"dummy"
"99809",0,0,1,1,"dummy"
"99810",0,0,1,1,"dummy"
"99811",0,0,0,0,"dummy"
"99812",0,0,0,0,"dummy"
"99828",0,0,1,1,"dummy"
"99837",0,0,0,0,"dummy"
"99838",5,0,2,7,"dummy"
"99839",0,0,0,0,"dummy"
"99844",0,1,0,1,"dummy"
"99845",0,10,0,10,"dummy"
"99846",0,1,0,1,"dummy"
"99847",0,0,0,0,"dummy"
"99856",0,0,2,2,"dummy"
"99857",0,0,0,0,"dummy"
"99858",1,0,0,1,"dummy"
"99867",0,5,3,8,"dummy"
"99876",8,4,1,13,"dummy"
"99877",0,1,0,1,"dummy"
"99884",0,1,0,1,"dummy"
"99885",0,0,1,1,"dummy"
"99886",1,1,0,2,"dummy"
"99887",0,0,1,1,"dummy"
"99888",0,2,0,2,"dummy"
"99891",0,0,0,0,"dummy"
"99892",0,0,1,1,"dummy"
"99893",0,0,1,1,"dummy"
"99894",0,0,0,0,"dummy"
"99895",0,9,0,9,"dummy"
"99896",0,0,1,1,"dummy"
"99897",17,9,2,28,"dummy"
"99898",8,13,3,24,"dummy"
"99899",3,4,0,7,"dummy"
"99900",0,0,0,0,"dummy"
"99901",0,0,2,2,"dummy"
"99904",1,0,4,5,"dummy"
"99905",0,0,1,1,"dummy"
"99906",0,2,0,2,"dummy"
"99907",0,7,1,8,"dummy"
"99911",1,1,0,2,"dummy"
"99826",0,0,1,1,"dummy"
"99832",0,0,0,0,"dummy"
"99849",0,0,1,1,"dummy"
"99852",8,9,2,19,"dummy"
"99860",0,1,1,2,"dummy"
"99863",0,0,1,1,"dummy"
"99871",2,0,3,5,"dummy"
"99872",1,0,0,1,"dummy"
"99873",0,1,0,1,"dummy"
"99874",0,1,1,2,"dummy"
"99909",0,0,1,1,"dummy"
"99917",0,0,1,1,"dummy"
"99918",2,2,1,5,"dummy"
"99919",0,0,0,0,"dummy"
"99920",0,0,2,2,"dummy"
"99921",0,1,0,1,"dummy"
"99924",0,1,0,1,"dummy"
"99925",0,0,0,0,"dummy"
"99926",0,2,0,2,"dummy"
"99927",0,1,3,4,"dummy"
"99928",2,4,0,6,"dummy"
"99929",5,4,2,11,"dummy"
"99930",0,0,2,2,"dummy"
"99931",1,1,0,2,"dummy"
"99932",5,3,0,8,"dummy"
"99933",0,5,0,5,"dummy"
"99934",4,0,0,4,"dummy"
"99935",0,2,1,3,"dummy"
"99936",0,2,1,3,"dummy"
"99937",1,1,0,2,"dummy"
"99938",2,3,1,6,"dummy"
"99939",4,3,1,8,"dummy"
"99940",0,1,1,2,"dummy"
"99941",0,0,2,2,"dummy"
"99942",0,0,1,1,"dummy"
"99943",0,0,1,1,"dummy"
"99944",0,2,0,2,"dummy"
"99945",0,4,0,4,"dummy"
"99946",3,2,0,5,"dummy"
"99947",1,3,0,4,"dummy"
"99948",1,1,0,2,"dummy"
"99949",3,1,1,5,"dummy"
"99950",1,0,0,1,"dummy"
"99951",0,1,0,1,"dummy"
"99964",0,3,0,3,"dummy"
"99965",0,0,1,1,"dummy"
"99966",0,6,5,11,"dummy"
"99967",0,0,1,1,"dummy"
"99968",0,0,1,1,"dummy"
"99969",0,1,0,1,"dummy"
"100001",8,7,11,26,"dummy"
"100002",12,3,5,20,"dummy"
"100010",0,0,0,0,"dummy"
"100011",0,0,0,0,"dummy"
"100012",0,0,0,0,"dummy"
"100013",0,0,0,0,"dummy"
"100053",0,2,0,2,"dummy"
"100054",0,0,1,1,"dummy"
"100055",0,0,0,0,"dummy"
"100056",2,2,3,7,"dummy"
"100057",0,1,1,2,"dummy"
"100058",0,0,2,2,"dummy"
"100059",1,0,0,1,"dummy"
"100060",2,0,0,2,"dummy"
"100061",0,1,1,2,"dummy"
"100062",0,2,0,2,"dummy"
"100063",0,1,1,2,"dummy"
"100073",5,8,0,13,"dummy"
"100074",3,2,0,5,"dummy"
"100075",2,6,0,8,"dummy"
"100076",6,2,0,8,"dummy"
"100077",0,1,0,1,"dummy"
"100078",4,9,0,13,"dummy"
"99955",0,0,0,0,"dummy"
"99956",0,2,0,2,"dummy"
"99957",0,1,0,1,"dummy"
"99958",0,0,0,0,"dummy"
"99959",0,1,0,1,"dummy"
"99962",0,0,1,1,"dummy"
"100047",3,9,2,14,"dummy"
"100048",3,6,0,9,"dummy"
"100049",0,2,0,2,"dummy"
"100065",0,1,1,2,"dummy"
"100066",0,2,0,2,"dummy"
"100067",0,2,0,2,"dummy"
"100068",0,0,0,0,"dummy"
"100071",0,1,0,1,"dummy"
"100082",0,3,0,3,"dummy"
"100083",1,3,0,4,"dummy"
"100084",0,0,2,2,"dummy"
"100122",3,0,2,5,"dummy"
"100123",0,2,0,2,"dummy"
"100124",2,2,0,4,"dummy"
"100125",2,2,1,5,"dummy"
"100128",0,0,1,1,"dummy"
"100136",1,2,2,5,"dummy"
"100166",0,4,0,4,"dummy"
"100167",3,4,1,8,"dummy"
"100168",0,0,1,1,"dummy"
"100169",0,0,1,1,"dummy"
"100170",0,1,0,1,"dummy"
"100171",0,1,0,1,"dummy"
"100172",0,1,0,1,"dummy"
"100173",1,3,0,4,"dummy"
"100174",0,0,1,1,"dummy"
"100175",0,0,0,0,"dummy"
"100176",0,1,0,1,"dummy"
"100177",0,0,0,0,"dummy"
"100178",0,0,0,0,"dummy"
"100199",3,0,0,3,"dummy"
"100217",2,4,0,6,"dummy"
"100218",0,2,0,2,"dummy"
"100219",0,2,0,2,"dummy"
"100220",10,2,0,12,"dummy"
"100221",0,2,0,2,"dummy"
"100222",0,0,0,0,"dummy"
"100223",0,0,3,3,"dummy"
"100224",0,5,0,5,"dummy"
"100225",1,0,1,2,"dummy"
"100252",0,0,1,1,"dummy"
"100253",0,0,1,1,"dummy"
"100254",0,0,2,2,"dummy"
"100255",0,1,1,2,"dummy"
"100256",1,6,3,10,"dummy"
"100279",0,0,1,1,"dummy"
"100280",0,0,1,1,"dummy"
"100284",0,1,0,1,"dummy"
"100285",2,0,0,2,"dummy"
"100297",0,1,0,1,"dummy"
"100298",0,0,1,1,"dummy"
"100299",0,0,0,0,"dummy"
"100300",0,1,0,1,"dummy"
"100301",0,0,0,0,"dummy"
"100302",0,0,0,0,"dummy"
"100305",0,0,2,2,"dummy"
"100079",6,2,0,8,"dummy"
"100080",0,0,1,1,"dummy"
"100088",0,5,0,5,"dummy"
"100089",1,2,0,3,"dummy"
"100090",0,18,0,18,"dummy"
"100091",0,2,1,3,"dummy"
"100092",0,3,0,3,"dummy"
"100093",1,1,1,3,"dummy"
"100094",11,1,0,12,"dummy"
"100095",0,3,0,3,"dummy"
"100096",0,2,0,2,"dummy"
"100097",11,11,4,26,"dummy"
"100098",0,3,0,3,"dummy"
"100099",0,2,0,2,"dummy"
"100100",0,2,0,2,"dummy"
"100101",0,2,1,3,"dummy"
"100102",0,2,0,2,"dummy"
"100103",0,0,1,1,"dummy"
"100104",0,2,0,2,"dummy"
"100105",0,1,1,2,"dummy"
"100106",0,0,1,1,"dummy"
"100107",1,0,0,1,"dummy"
"100108",0,1,0,1,"dummy"
"100109",7,5,0,12,"dummy"
"100110",2,0,0,2,"dummy"
"100111",0,1,0,1,"dummy"
"100112",0,0,1,1,"dummy"
"100113",4,0,0,4,"dummy"
"100114",0,1,0,1,"dummy"
"100115",8,0,0,8,"dummy"
"100116",0,0,1,1,"dummy"
"100130",1,1,0,2,"dummy"
"100138",0,1,0,1,"dummy"
"100139",3,3,0,6,"dummy"
"100157",0,0,1,1,"dummy"
"100164",2,6,0,8,"dummy"
"100182",5,35,1,41,"dummy"
"100183",0,1,0,1,"dummy"
"100184",14,18,2,34,"dummy"
"100185",4,5,2,11,"dummy"
"100186",1,3,0,4,"dummy"
"100187",0,1,0,1,"dummy"
"100188",0,1,0,1,"dummy"
"100191",2,1,1,4,"dummy"
"100192",0,0,1,1,"dummy"
"100193",0,4,0,4,"dummy"
"100194",6,0,3,9,"dummy"
"100195",1,0,1,2,"dummy"
"100196",3,1,0,4,"dummy"
"100197",0,0,1,1,"dummy"
"100203",0,0,0,0,"dummy"
"100204",0,3,0,3,"dummy"
"100205",2,1,1,4,"dummy"
"100206",0,1,0,1,"dummy"
"100207",0,1,0,1,"dummy"
"100208",0,0,0,0,"dummy"
"100209",0,1,0,1,"dummy"
"100210",0,1,0,1,"dummy"
"100211",1,0,0,1,"dummy"
"100212",0,1,0,1,"dummy"
"100213",8,5,2,15,"dummy"
"100214",0,1,0,1,"dummy"
"100215",2,2,0,4,"dummy"
"100227",2,5,0,7,"dummy"
"100228",2,5,0,7,"dummy"
"100229",6,11,0,17,"dummy"
"100244",0,0,1,1,"dummy"
"100271",2,0,1,3,"dummy"
"100272",1,1,0,2,"dummy"
"100273",2,0,0,2,"dummy"
"100274",0,0,0,0,"dummy"
"100275",0,0,0,0,"dummy"
"100276",0,0,1,1,"dummy"
"100277",0,2,0,2,"dummy"
"100282",1,1,0,2,"dummy"
"100287",0,5,0,5,"dummy"
"100288",1,6,1,8,"dummy"
"100289",0,1,0,1,"dummy"
"100290",2,3,0,5,"dummy"
"100291",2,2,0,4,"dummy"
"100292",0,11,0,11,"dummy"
"100293",0,0,0,0,"dummy"
"100294",0,0,0,0,"dummy"
"100295",14,14,0,28,"dummy"
"100309",0,0,0,0,"dummy"
"100310",1,0,0,1,"dummy"
"100311",0,0,1,1,"dummy"
"100312",1,1,0,2,"dummy"
"100313",0,0,1,1,"dummy"
"100314",0,0,1,1,"dummy"
"100315",2,0,0,2,"dummy"
"100316",0,2,0,2,"dummy"
"100317",0,1,0,1,"dummy"
"100335",2,4,0,6,"dummy"
"100336",0,2,0,2,"dummy"
"100337",0,2,0,2,"dummy"
"100338",10,2,0,12,"dummy"
"100339",0,2,0,2,"dummy"
"100340",0,0,0,0,"dummy"
"100341",0,0,3,3,"dummy"
"100342",0,5,0,5,"dummy"
"100349",0,2,0,2,"dummy"
"100350",15,9,4,28,"dummy"
"100351",0,1,0,1,"dummy"
"100364",0,0,0,0,"dummy"
"100365",0,0,1,1,"dummy"
"100366",3,2,0,5,"dummy"
"100367",0,1,0,1,"dummy"
"100368",0,0,1,1,"dummy"
"100369",0,0,2,2,"dummy"
"100370",0,0,0,0,"dummy"
"100371",0,1,0,1,"dummy"
"100372",3,1,0,4,"dummy"
"100373",1,0,0,1,"dummy"
"100374",0,0,0,0,"dummy"
"100375",0,0,0,0,"dummy"
"100378",0,0,1,1,"dummy"
"100379",0,0,1,1,"dummy"
"100388",2,0,0,2,"dummy"
"100389",0,0,3,3,"dummy"
"100390",0,1,0,1,"dummy"
"100394",3,1,0,4,"dummy"
"100395",1,3,0,4,"dummy"
"100401",0,2,2,4,"dummy"
"100406",0,0,1,1,"dummy"
"100409",0,5,0,5,"dummy"
"100412",0,1,0,1,"dummy"
"100413",3,2,2,7,"dummy"
"100414",0,1,0,1,"dummy"
"100415",0,1,0,1,"dummy"
"100416",0,2,0,2,"dummy"
"100417",0,0,2,2,"dummy"
"100418",0,1,0,1,"dummy"
"100419",0,2,11,13,"dummy"
"100420",0,2,1,3,"dummy"
"100442",0,38,1,39,"dummy"
"100443",0,1,0,1,"dummy"
"100467",0,0,0,0,"dummy"
"100468",0,0,1,1,"dummy"
"100469",0,0,1,1,"dummy"
"100482",2,0,0,2,"dummy"
"100485",9,2,1,12,"dummy"
"100486",0,1,0,1,"dummy"
"100487",0,1,1,2,"dummy"
"100488",0,4,0,4,"dummy"
"100499",0,0,1,1,"dummy"
"100306",2,3,4,9,"dummy"
"100307",0,0,0,0,"dummy"
"100319",0,0,1,1,"dummy"
"100320",0,1,0,1,"dummy"
"100321",0,0,1,1,"dummy"
"100324",2,0,0,2,"dummy"
"100329",10,10,2,22,"dummy"
"100330",1,2,2,5,"dummy"
"100331",0,0,1,1,"dummy"
"100347",0,2,0,2,"dummy"
"100355",0,20,0,20,"dummy"
"100381",0,0,1,1,"dummy"
"100384",18,22,1,41,"dummy"
"100385",13,11,2,26,"dummy"
"100386",1,11,5,17,"dummy"
"100392",0,1,0,1,"dummy"
"100397",0,1,1,2,"dummy"
"100403",1,0,1,2,"dummy"
"100404",0,0,0,0,"dummy"
"100428",0,0,1,1,"dummy"
"100431",0,1,0,1,"dummy"
"100432",0,1,0,1,"dummy"
"100433",1,0,0,1,"dummy"
"100434",0,2,0,2,"dummy"
"100435",0,1,0,1,"dummy"
"100436",0,0,1,1,"dummy"
"100437",0,0,1,1,"dummy"
"100438",0,0,1,1,"dummy"
"100439",0,0,1,1,"dummy"
"100440",0,1,0,1,"dummy"
"100455",0,0,2,2,"dummy"
"100456",9,6,0,15,"dummy"
"100457",0,0,2,2,"dummy"
"100458",2,2,0,4,"dummy"
"100459",3,3,0,6,"dummy"
"100460",0,1,1,2,"dummy"
"100461",0,2,1,3,"dummy"
"100462",1,1,0,2,"dummy"
"100463",0,0,0,0,"dummy"
"100464",0,0,1,1,"dummy"
"100465",2,0,0,2,"dummy"
"100473",1,7,2,10,"dummy"
"100474",0,1,0,1,"dummy"
"100503",0,0,1,1,"dummy"
"100524",0,0,0,0,"dummy"
"100525",5,0,2,7,"dummy"
"100526",0,0,0,0,"dummy"
"100561",1,14,0,15,"dummy"
"100562",0,0,0,0,"dummy"
"100563",3,4,0,7,"dummy"
"100564",0,2,0,2,"dummy"
"100565",0,2,0,2,"dummy"
"100566",3,4,1,8,"dummy"
"100567",1,4,1,6,"dummy"
"100568",18,17,2,37,"dummy"
"100569",6,0,0,6,"dummy"
"100570",0,2,0,2,"dummy"
"100579",1,0,0,1,"dummy"
"100580",2,0,1,3,"dummy"
"100581",0,0,0,0,"dummy"
"100582",0,1,0,1,"dummy"
"100583",8,1,0,9,"dummy"
"100584",0,0,0,0,"dummy"
"100585",0,0,0,0,"dummy"
"100586",1,10,0,11,"dummy"
"100587",7,1,0,8,"dummy"
"100588",0,0,1,1,"dummy"
"100589",2,0,3,5,"dummy"
"100510",0,0,0,0,"dummy"
"100511",0,0,0,0,"dummy"
"100512",0,0,0,0,"dummy"
"100513",0,0,0,0,"dummy"
"100514",0,0,0,0,"dummy"
"100515",0,0,0,0,"dummy"
"100516",0,0,0,0,"dummy"
"100517",0,1,0,1,"dummy"
"100518",0,0,0,0,"dummy"
"100519",0,0,0,0,"dummy"
"100520",0,0,0,0,"dummy"
"100521",0,0,0,0,"dummy"
"100522",0,1,0,1,"dummy"
"100528",0,1,0,1,"dummy"
"100529",7,17,2,26,"dummy"
"100530",0,1,1,2,"dummy"
"100531",0,3,0,3,"dummy"
"100532",0,1,0,1,"dummy"
"100533",1,1,3,5,"dummy"
"100534",0,0,2,2,"dummy"
"100535",0,0,1,1,"dummy"
"100536",2,0,0,2,"dummy"
"100537",0,0,1,1,"dummy"
"100538",1,1,2,4,"dummy"
"100539",0,1,0,1,"dummy"
"100540",0,0,1,1,"dummy"
"100541",0,3,0,3,"dummy"
"100542",4,4,0,8,"dummy"
"100543",2,0,0,2,"dummy"
"100544",0,0,1,1,"dummy"
"100545",0,0,2,2,"dummy"
"100546",0,0,1,1,"dummy"
"100547",1,0,0,1,"dummy"
"100591",0,1,0,1,"dummy"
"100592",0,0,0,0,"dummy"
"100600",0,2,0,2,"dummy"
"100601",5,5,0,10,"dummy"
"100603",0,2,0,2,"dummy"
"100606",0,0,1,1,"dummy"
"100605",4,1,0,5,"dummy"
"100608",1,0,2,3,"dummy"
"100609",0,1,4,5,"dummy"
"100612",0,1,0,1,"dummy"
"100620",0,1,0,1,"dummy"
"100621",0,0,1,1,"dummy"
"100622",0,1,0,1,"dummy"
"100624",7,3,1,11,"dummy"
"100625",2,2,3,7,"dummy"
"100626",0,10,1,11,"dummy"
"100628",0,0,1,1,"dummy"
"100629",0,0,0,0,"dummy"
"100630",0,0,0,0,"dummy"
"100631",0,0,2,2,"dummy"
"100632",0,0,2,2,"dummy"
"100635",0,0,3,3,"dummy"
"100636",0,0,3,3,"dummy"
"100637",0,0,1,1,"dummy"
"100638",0,0,1,1,"dummy"
"100647",1,1,1,3,"dummy"
"100648",0,0,0,0,"dummy"
"100649",0,0,1,1,"dummy"
"100650",0,1,0,1,"dummy"
"100651",0,0,2,2,"dummy"
"100652",0,0,2,2,"dummy"
"100653",0,2,0,2,"dummy"
"100654",0,0,1,1,"dummy"
"100655",0,0,2,2,"dummy"
"100656",0,1,0,1,"dummy"
"100660",0,1,0,1,"dummy"
"100664",0,1,0,1,"dummy"
"100667",0,0,3,3,"dummy"
"100668",0,1,1,2,"dummy"
"100669",1,1,0,2,"dummy"
"100691",4,3,1,8,"dummy"
"100693",1,0,0,1,"dummy"
"100694",0,3,1,4,"dummy"
"100697",0,0,1,1,"dummy"
"100698",6,4,0,10,"dummy"
"100699",0,0,1,1,"dummy"
"100701",4,10,1,15,"dummy"
"100702",0,2,4,6,"dummy"
"100706",0,0,3,3,"dummy"
"100716",0,2,0,2,"dummy"
"100717",0,2,0,2,"dummy"
"100718",0,1,0,1,"dummy"
"100719",0,0,0,0,"dummy"
"100720",0,0,3,3,"dummy"
"100721",2,3,4,9,"dummy"
"100722",0,0,0,0,"dummy"
"100724",3,3,0,6,"dummy"
"100725",0,0,3,3,"dummy"
"100726",0,0,2,2,"dummy"
"100727",0,6,1,7,"dummy"
"100728",0,0,5,5,"dummy"
"100730",0,1,0,1,"dummy"
"100731",3,3,1,7,"dummy"
"100732",3,9,1,13,"dummy"
"100733",0,0,0,0,"dummy"
"100736",0,0,2,2,"dummy"
"100737",0,1,2,3,"dummy"
"100738",0,1,0,1,"dummy"
"100739",0,0,0,0,"dummy"
"100740",0,1,0,1,"dummy"
"100741",0,1,0,1,"dummy"
"100742",0,1,0,1,"dummy"
"100743",0,1,1,2,"dummy"
"100744",1,1,0,2,"dummy"
"100745",0,0,1,1,"dummy"
"100755",0,3,1,4,"dummy"
"100756",1,2,0,3,"dummy"
"100759",2,2,2,6,"dummy"
"100760",0,3,0,3,"dummy"
"100762",0,1,1,2,"dummy"
"100763",0,1,0,1,"dummy"
"100764",6,2,0,8,"dummy"
"100765",2,0,0,2,"dummy"
"100766",0,1,0,1,"dummy"
"100767",3,1,1,5,"dummy"
"100773",0,1,0,1,"dummy"
"100774",0,4,0,4,"dummy"
"100775",0,6,0,6,"dummy"
"100779",0,2,1,3,"dummy"
"100782",1,0,0,1,"dummy"
"100784",0,2,1,3,"dummy"
"100785",0,0,1,1,"dummy"
"100786",0,1,0,1,"dummy"
"100787",0,1,0,1,"dummy"
"100788",0,1,0,1,"dummy"
"100789",0,2,0,2,"dummy"
"100790",2,0,0,2,"dummy"
"100791",0,1,0,1,"dummy"
"100792",0,0,1,1,"dummy"
"100793",0,1,0,1,"dummy"
"100794",0,1,0,1,"dummy"
"100795",1,0,0,1,"dummy"
"100796",0,1,0,1,"dummy"
"100797",1,2,0,3,"dummy"
"100803",0,2,0,2,"dummy"
"100804",0,0,1,1,"dummy"
"100805",0,0,1,1,"dummy"
"100860",0,4,0,4,"dummy"
"100861",0,1,1,2,"dummy"
"100862",0,0,1,1,"dummy"
"100863",0,7,0,7,"dummy"
"100864",0,2,1,3,"dummy"
"100868",3,1,4,8,"dummy"
"100874",2,2,0,4,"dummy"
"100875",0,0,1,1,"dummy"
"100876",0,0,1,1,"dummy"
"100878",0,1,0,1,"dummy"
"100880",1,0,0,1,"dummy"
"100931",0,1,0,1,"dummy"
"100932",2,2,0,4,"dummy"
"100933",0,1,1,2,"dummy"
"100934",0,5,0,5,"dummy"
"100935",1,3,1,5,"dummy"
"100936",0,0,1,1,"dummy"
"100937",0,0,1,1,"dummy"
"100938",0,0,1,1,"dummy"
"100939",1,4,1,6,"dummy"
"100940",0,0,1,1,"dummy"
"100941",0,0,1,1,"dummy"
"100942",0,0,1,1,"dummy"
"100943",0,0,1,1,"dummy"
"100944",0,0,1,1,"dummy"
"100945",0,0,1,1,"dummy"
"100946",1,1,0,2,"dummy"
"100947",0,0,1,1,"dummy"
"100948",0,0,1,1,"dummy"
"100949",0,0,1,1,"dummy"
"100950",0,0,1,1,"dummy"
"100951",0,0,1,1,"dummy"
"100952",0,0,1,1,"dummy"
"100953",0,0,1,1,"dummy"
"100954",0,1,0,1,"dummy"
"100955",0,0,1,1,"dummy"
"100956",0,0,1,1,"dummy"
"100957",0,0,1,1,"dummy"
"100958",0,0,1,1,"dummy"
"100959",0,0,1,1,"dummy"
"100960",0,0,1,1,"dummy"
"100961",0,0,1,1,"dummy"
"100962",2,0,0,2,"dummy"
"100963",2,0,0,2,"dummy"
"100964",2,0,0,2,"dummy"
"100965",4,12,1,17,"dummy"
"100968",0,0,0,0,"dummy"
"100971",0,0,4,4,"dummy"
"100972",7,15,3,25,"dummy"
"100973",0,1,0,1,"dummy"
"100974",0,2,0,2,"dummy"
"100975",0,1,1,2,"dummy"
"100977",0,0,1,1,"dummy"
"100978",0,1,0,1,"dummy"
"100979",6,3,1,10,"dummy"
"100981",0,4,0,4,"dummy"
"100982",2,0,1,3,"dummy"
"101000",0,2,0,2,"dummy"
"101003",4,2,0,6,"dummy"
"101004",1,4,1,6,"dummy"
"101005",0,0,1,1,"dummy"
"101006",0,0,1,1,"dummy"
"101007",0,2,0,2,"dummy"
"101010",0,0,1,1,"dummy"
"101011",0,0,1,1,"dummy"
"101012",0,0,1,1,"dummy"
"101014",2,0,3,5,"dummy"
"101017",0,0,0,0,"dummy"
"101021",0,0,3,3,"dummy"
"101022",0,0,3,3,"dummy"
"101023",0,0,3,3,"dummy"
"101031",0,0,1,1,"dummy"
"101033",2,0,0,2,"dummy"
"101034",0,0,1,1,"dummy"
"101036",0,0,0,0,"dummy"
"101037",0,0,1,1,"dummy"
"101038",0,0,0,0,"dummy"
"101039",1,1,0,2,"dummy"
"101040",0,1,4,5,"dummy"
"101041",0,0,2,2,"dummy"
"101042",0,0,1,1,"dummy"
"101043",1,0,2,3,"dummy"
"101044",0,0,1,1,"dummy"
"101045",0,0,1,1,"dummy"
"101046",0,0,1,1,"dummy"
"101047",0,0,1,1,"dummy"
"101048",4,0,0,4,"dummy"
"101058",0,4,0,4,"dummy"
"101059",4,23,0,27,"dummy"
"101060",1,2,0,3,"dummy"
"101061",0,0,1,1,"dummy"
"101062",5,3,0,8,"dummy"
"101065",0,2,1,3,"dummy"
"101066",0,0,0,0,"dummy"
"101067",0,0,1,1,"dummy"
"101068",0,1,0,1,"dummy"
"101070",0,0,1,1,"dummy"
"101071",0,0,1,1,"dummy"
"101072",0,0,1,1,"dummy"
"101078",0,2,0,2,"dummy"
"101079",0,1,0,1,"dummy"
"101080",1,0,0,1,"dummy"
"101081",0,1,0,1,"dummy"
"101082",0,0,0,0,"dummy"
"101083",4,1,0,5,"dummy"
"101084",1,0,0,1,"dummy"
"101085",0,0,0,0,"dummy"
"101086",0,0,0,0,"dummy"
"101091",0,0,0,0,"dummy"
"101092",2,0,0,2,"dummy"
"101093",6,12,0,18,"dummy"
"101094",0,7,0,7,"dummy"
"101095",0,0,0,0,"dummy"
"101097",1,1,0,2,"dummy"
"101099",0,0,1,1,"dummy"
"101101",0,1,0,1,"dummy"
"101102",3,3,1,7,"dummy"
"101109",4,4,5,13,"dummy"
"101110",0,1,0,1,"dummy"
"101112",0,2,0,2,"dummy"
"101135",0,0,1,1,"dummy"
"101136",0,1,0,1,"dummy"
"101140",0,1,0,1,"dummy"
"101141",0,0,0,0,"dummy"
"101142",0,1,0,1,"dummy"
"101145",3,0,0,3,"dummy"
"101146",4,0,0,4,"dummy"
"101149",2,0,0,2,"dummy"
"101153",0,0,1,1,"dummy"
"101155",0,1,0,1,"dummy"
"101156",0,1,0,1,"dummy"
"101157",0,1,0,1,"dummy"
"101158",0,2,0,2,"dummy"
"101159",0,1,0,1,"dummy"
"101160",0,1,0,1,"dummy"
"101161",1,5,0,6,"dummy"
"101162",0,2,0,2,"dummy"
"101199",1,1,0,2,"dummy"
"101201",0,0,1,1,"dummy"
"101202",0,0,0,0,"dummy"
"101219",0,1,1,2,"dummy"
"101220",5,8,3,16,"dummy"
"101221",0,0,1,1,"dummy"
"101223",0,0,1,1,"dummy"
"101224",0,0,1,1,"dummy"
"101225",33,19,1,53,"dummy"
"101226",0,0,1,1,"dummy"
"101227",1,0,0,1,"dummy"
"101228",0,1,1,2,"dummy"
"101229",1,0,0,1,"dummy"
"101230",0,1,0,1,"dummy"
"101231",0,0,1,1,"dummy"
"101232",0,0,1,1,"dummy"
"101233",0,0,1,1,"dummy"
"101236",1,3,0,4,"dummy"
"101237",3,4,0,7,"dummy"
"101239",0,0,1,1,"dummy"
"101240",0,7,0,7,"dummy"
"101241",0,1,0,1,"dummy"
"101242",0,1,0,1,"dummy"
"101243",1,1,2,4,"dummy"
"101245",0,0,0,0,"dummy"
"101246",0,0,0,0,"dummy"
"101258",0,0,0,0,"dummy"
"101259",0,1,0,1,"dummy"
"101260",9,14,1,24,"dummy"
"101261",0,1,1,2,"dummy"
"101263",0,1,0,1,"dummy"
"101264",0,1,0,1,"dummy"
"101265",0,1,0,1,"dummy"
"101267",0,2,1,3,"dummy"
"101278",0,5,3,8,"dummy"
"101279",0,0,2,2,"dummy"
"101280",0,0,2,2,"dummy"
"101283",4,7,2,13,"dummy"
"101284",2,6,2,10,"dummy"
"101285",0,0,1,1,"dummy"
"101286",8,5,1,14,"dummy"
"101287",4,2,3,9,"dummy"
"101288",0,5,0,5,"dummy"
"101293",0,0,1,1,"dummy"
"101295",0,0,1,1,"dummy"
"101299",1,4,1,6,"dummy"
"101300",0,3,0,3,"dummy"
"101301",0,2,0,2,"dummy"
"101302",2,1,0,3,"dummy"
"101303",3,6,0,9,"dummy"
"101304",17,10,0,27,"dummy"
"101306",0,1,0,1,"dummy"
"101307",13,0,0,13,"dummy"
"101308",0,0,3,3,"dummy"
"101309",1,31,2,34,"dummy"
"101310",0,1,0,1,"dummy"
"101311",1,0,0,1,"dummy"
"101312",0,4,0,4,"dummy"
"101313",4,1,0,5,"dummy"
"101314",7,2,0,9,"dummy"
"101315",5,4,1,10,"dummy"
"101316",0,2,1,3,"dummy"
"101317",1,0,0,1,"dummy"
"101318",1,5,0,6,"dummy"
"101319",1,0,0,1,"dummy"
"101320",1,0,0,1,"dummy"
"101321",1,3,1,5,"dummy"
"101322",3,0,0,3,"dummy"
"101323",0,5,0,5,"dummy"
"101324",0,1,0,1,"dummy"
"101325",3,9,0,12,"dummy"
"101326",2,0,0,2,"dummy"
"101327",1,0,0,1,"dummy"
"101328",0,1,0,1,"dummy"
"101329",0,0,0,0,"dummy"
"101330",0,1,0,1,"dummy"
"101331",0,0,0,0,"dummy"
"101332",0,0,1,1,"dummy"
"101333",1,0,1,2,"dummy"
"101334",32,14,4,50,"dummy"
"101335",5,0,0,5,"dummy"
"101338",0,4,0,4,"dummy"
"101339",0,2,3,5,"dummy"
"101340",2,0,0,2,"dummy"
"101341",0,0,1,1,"dummy"
"101342",0,1,0,1,"dummy"
"101343",0,1,0,1,"dummy"
"101363",0,0,1,1,"dummy"
"101364",0,2,0,2,"dummy"
"101365",1,3,0,4,"dummy"
"101366",1,2,0,3,"dummy"
"101367",1,2,0,3,"dummy"
"101368",1,2,0,3,"dummy"
"101369",0,6,0,6,"dummy"
"101370",0,1,0,1,"dummy"
"101371",0,0,1,1,"dummy"
"101372",0,0,1,1,"dummy"
"101373",0,1,0,1,"dummy"
"101377",0,0,1,1,"dummy"
"101378",0,0,2,2,"dummy"
"101379",0,0,1,1,"dummy"
"101381",3,2,0,5,"dummy"
"101382",15,9,2,26,"dummy"
"101383",1,0,0,1,"dummy"
"101384",1,0,1,2,"dummy"
"101385",2,0,0,2,"dummy"
"101418",0,4,0,4,"dummy"
"101419",0,1,0,1,"dummy"
"101442",0,4,0,4,"dummy"
"101443",0,1,0,1,"dummy"
"101452",0,1,0,1,"dummy"
"101651",8,1,2,11,"dummy"
"101652",3,4,4,11,"dummy"
"101653",8,8,8,24,"dummy"
"101654",0,1,1,2,"dummy"
"101683",0,0,1,1,"dummy"
"101684",0,1,0,1,"dummy"
"101685",0,0,1,1,"dummy"
"101691",6,3,7,16,"dummy"
"101695",0,3,4,7,"dummy"
"101696",0,0,1,1,"dummy"
"101697",3,1,0,4,"dummy"
"101698",0,1,0,1,"dummy"
"101699",0,0,0,0,"dummy"
"101700",0,1,0,1,"dummy"
"101701",0,0,1,1,"dummy"
"101702",0,1,0,1,"dummy"
"101713",0,1,0,1,"dummy"
"101739",7,8,0,15,"dummy"
"101740",2,4,0,6,"dummy"
"101741",0,0,0,0,"dummy"
"101749",0,1,1,2,"dummy"
"101750",2,0,1,3,"dummy"
"101751",0,1,0,1,"dummy"
"101760",0,1,2,3,"dummy"
"101761",0,0,0,0,"dummy"
"101762",0,2,0,2,"dummy"
"101763",5,0,2,7,"dummy"
"101764",1,0,0,1,"dummy"
"101765",0,0,0,0,"dummy"
"101768",2,3,2,7,"dummy"
"101786",4,2,0,6,"dummy"
"101787",0,0,1,1,"dummy"
"101788",0,0,0,0,"dummy"
"101806",0,1,0,1,"dummy"
"101809",0,1,0,1,"dummy"
"101812",0,2,0,2,"dummy"
"101813",0,0,1,1,"dummy"
"101814",1,1,0,2,"dummy"
"101815",0,0,1,1,"dummy"
"101835",0,0,1,1,"dummy"
"101851",0,2,0,2,"dummy"
"101852",3,11,2,16,"dummy"
"101853",1,0,0,1,"dummy"
"101854",0,2,0,2,"dummy"
"101857",0,1,0,1,"dummy"
"101858",0,1,0,1,"dummy"
"101873",0,0,1,1,"dummy"
"101406",0,1,2,3,"dummy"
"101407",0,0,1,1,"dummy"
"101427",0,0,3,3,"dummy"
"101428",0,1,0,1,"dummy"
"101429",0,2,0,2,"dummy"
"101430",0,1,0,1,"dummy"
"101436",0,1,0,1,"dummy"
"101437",0,1,0,1,"dummy"
"101438",0,0,1,1,"dummy"
"101445",2,3,1,6,"dummy"
"101446",0,0,1,1,"dummy"
"101447",0,5,1,6,"dummy"
"101448",0,0,0,0,"dummy"
"101449",0,0,1,1,"dummy"
"101450",6,0,1,7,"dummy"
"101454",1,16,4,21,"dummy"
"101678",0,2,0,2,"dummy"
"101679",5,15,0,20,"dummy"
"101680",9,2,2,13,"dummy"
"101681",0,6,2,8,"dummy"
"101687",2,9,1,12,"dummy"
"101688",0,1,0,1,"dummy"
"101689",0,2,0,2,"dummy"
"101693",0,0,2,2,"dummy"
"101704",3,0,0,3,"dummy"
"101705",0,0,1,1,"dummy"
"101706",0,0,1,1,"dummy"
"101711",0,0,1,1,"dummy"
"101715",0,0,0,0,"dummy"
"101720",2,0,0,2,"dummy"
"101721",0,2,0,2,"dummy"
"101743",0,4,0,4,"dummy"
"101744",3,0,0,3,"dummy"
"101745",0,4,0,4,"dummy"
"101746",4,0,0,4,"dummy"
"101747",0,0,1,1,"dummy"
"101753",0,1,0,1,"dummy"
"101758",0,1,0,1,"dummy"
"101774",0,2,0,2,"dummy"
"101775",0,0,0,0,"dummy"
"101778",0,0,0,0,"dummy"
"101783",0,2,0,2,"dummy"
"101784",0,0,0,0,"dummy"
"101790",2,0,0,2,"dummy"
"101791",0,0,1,1,"dummy"
"101792",0,1,0,1,"dummy"
"101795",1,2,3,6,"dummy"
"101796",1,0,0,1,"dummy"
"101799",0,3,0,3,"dummy"
"101800",0,4,0,4,"dummy"
"101801",0,2,0,2,"dummy"
"101802",9,1,0,10,"dummy"
"101817",0,0,0,0,"dummy"
"101818",3,0,0,3,"dummy"
"101819",0,0,1,1,"dummy"
"101820",3,2,0,5,"dummy"
"101821",0,2,0,2,"dummy"
"101822",0,5,0,5,"dummy"
"101823",0,0,0,0,"dummy"
"101824",0,0,1,1,"dummy"
"101825",0,1,0,1,"dummy"
"101826",0,0,2,2,"dummy"
"101829",3,1,1,5,"dummy"
"101830",0,1,0,1,"dummy"
"101831",0,1,0,1,"dummy"
"101832",0,1,0,1,"dummy"
"101833",1,0,0,1,"dummy"
"101842",1,1,0,2,"dummy"
"101845",0,1,0,1,"dummy"
"101846",0,3,0,3,"dummy"
"101847",1,0,0,1,"dummy"
"101848",0,1,0,1,"dummy"
"101849",0,0,1,1,"dummy"
"101870",8,2,0,10,"dummy"
"101871",0,0,0,0,"dummy"
"101876",0,0,1,1,"dummy"
"101877",0,0,3,3,"dummy"
"101878",0,0,3,3,"dummy"
"101879",0,0,4,4,"dummy"
"101880",2,3,1,6,"dummy"
"101889",0,0,0,0,"dummy"
"101890",0,0,0,0,"dummy"
"101891",0,0,0,0,"dummy"
"101899",0,0,3,3,"dummy"
"101900",0,1,0,1,"dummy"
"101901",2,0,0,2,"dummy"
"101902",0,2,0,2,"dummy"
"101903",0,0,1,1,"dummy"
"101904",1,3,4,8,"dummy"
"101957",0,0,1,1,"dummy"
"101967",0,0,1,1,"dummy"
"101970",1,0,1,2,"dummy"
"101971",0,1,0,1,"dummy"
"101974",0,1,0,1,"dummy"
"101981",0,2,0,2,"dummy"
"101982",9,6,3,18,"dummy"
"102003",0,0,1,1,"dummy"
"102004",2,0,1,3,"dummy"
"102020",0,0,1,1,"dummy"
"102031",1,7,0,8,"dummy"
"102034",2,3,1,6,"dummy"
"102035",0,0,1,1,"dummy"
"102048",3,4,2,9,"dummy"
"102049",0,3,1,4,"dummy"
"102050",0,1,2,3,"dummy"
"102051",0,1,0,1,"dummy"
"102059",2,2,1,5,"dummy"
"102060",8,29,5,42,"dummy"
"101874",7,5,0,12,"dummy"
"101895",0,1,0,1,"dummy"
"101896",1,8,0,9,"dummy"
"101897",1,1,0,2,"dummy"
"101955",0,14,0,14,"dummy"
"101959",0,1,0,1,"dummy"
"101960",0,10,0,10,"dummy"
"101961",9,2,2,13,"dummy"
"101962",0,1,0,1,"dummy"
"101963",0,1,0,1,"dummy"
"101976",2,0,3,5,"dummy"
"101979",0,1,0,1,"dummy"
"101984",1,7,0,8,"dummy"
"101985",0,3,0,3,"dummy"
"101986",1,3,0,4,"dummy"
"101989",4,3,0,7,"dummy"
"101990",0,1,0,1,"dummy"
"101991",0,1,0,1,"dummy"
"101992",0,3,0,3,"dummy"
"101993",1,4,1,6,"dummy"
"101994",0,8,0,8,"dummy"
"101995",0,1,0,1,"dummy"
"101996",2,4,0,6,"dummy"
"101997",3,4,0,7,"dummy"
"101998",3,3,0,6,"dummy"
"101999",0,1,0,1,"dummy"
"102000",2,1,0,3,"dummy"
"102001",7,3,1,11,"dummy"
"102006",0,1,4,5,"dummy"
"102007",0,0,1,1,"dummy"
"102008",0,0,1,1,"dummy"
"102009",2,1,0,3,"dummy"
"102010",0,0,1,1,"dummy"
"102037",0,2,0,2,"dummy"
"102038",0,0,1,1,"dummy"
"102039",0,0,1,1,"dummy"
"102040",1,0,0,1,"dummy"
"102044",0,1,0,1,"dummy"
"102045",0,3,1,4,"dummy"
"102046",3,0,3,6,"dummy"
"102055",0,4,0,4,"dummy"
"102056",0,4,0,4,"dummy"
"102057",0,2,1,3,"dummy"
"102062",0,0,1,1,"dummy"
"102069",6,7,2,15,"dummy"
"102070",0,1,0,1,"dummy"
"102071",1,0,0,1,"dummy"
"102072",0,0,1,1,"dummy"
"102073",0,0,1,1,"dummy"
"102074",0,0,1,1,"dummy"
"102075",3,0,1,4,"dummy"
"102076",0,2,0,2,"dummy"
"102077",0,2,0,2,"dummy"
"102078",2,0,0,2,"dummy"
"102081",1,7,0,8,"dummy"
"102082",0,0,0,0,"dummy"
"102085",0,0,1,1,"dummy"
"102086",0,2,0,2,"dummy"
"102087",0,0,1,1,"dummy"
"102088",0,1,1,2,"dummy"
"102089",1,1,0,2,"dummy"
"102090",0,1,0,1,"dummy"
"102091",10,1,4,15,"dummy"
"102104",3,0,3,6,"dummy"
"102066",0,1,0,1,"dummy"
"102067",0,0,2,2,"dummy"
"102106",0,0,1,1,"dummy"
"102107",0,1,0,1,"dummy"
"102108",0,0,1,1,"dummy"
"102109",0,2,0,2,"dummy"
"102114",0,1,0,1,"dummy"
"102202",6,0,0,6,"dummy"
"102127",3,0,0,3,"dummy"
"102130",3,3,1,7,"dummy"
"102135",1,3,0,4,"dummy"
"102136",4,1,0,5,"dummy"
"102139",2,4,0,6,"dummy"
"102140",0,2,0,2,"dummy"
"102141",0,2,0,2,"dummy"
"102142",10,2,0,12,"dummy"
"102143",0,2,0,2,"dummy"
"102146",0,0,0,0,"dummy"
"102147",1,1,0,2,"dummy"
"102149",0,0,0,0,"dummy"
"102150",1,4,1,6,"dummy"
"102151",8,5,3,16,"dummy"
"102152",2,5,2,9,"dummy"
"102153",0,1,0,1,"dummy"
"102154",3,9,3,15,"dummy"
"102155",1,0,0,1,"dummy"
"102162",0,1,1,2,"dummy"
"102163",1,0,1,2,"dummy"
"102164",0,0,1,1,"dummy"
"102167",2,9,1,12,"dummy"
"102169",5,2,2,9,"dummy"
"102172",0,0,1,1,"dummy"
"102173",1,13,1,15,"dummy"
"102174",0,0,2,2,"dummy"
"102175",13,1,0,14,"dummy"
"102176",1,9,1,11,"dummy"
"102177",0,2,0,2,"dummy"
"102178",0,1,0,1,"dummy"
"102179",0,0,1,1,"dummy"
"102180",0,1,0,1,"dummy"
"102186",0,1,1,2,"dummy"
"102187",0,0,1,1,"dummy"
"102188",0,0,1,1,"dummy"
"102189",0,0,5,5,"dummy"
"102190",0,1,5,6,"dummy"
"102191",1,0,5,6,"dummy"
"102192",0,1,0,1,"dummy"
"102194",3,3,0,6,"dummy"
"102195",3,2,0,5,"dummy"
"102198",0,1,1,2,"dummy"
"102199",17,0,0,17,"dummy"
"102200",0,1,0,1,"dummy"
"102203",2,5,2,9,"dummy"
"102206",0,2,1,3,"dummy"
"102207",0,0,3,3,"dummy"
"102208",0,1,0,1,"dummy"
"102211",3,4,3,10,"dummy"
"102213",0,1,0,1,"dummy"
"102214",0,1,1,2,"dummy"
"102215",13,17,1,31,"dummy"
"102216",0,2,1,3,"dummy"
"102217",1,8,0,9,"dummy"
"102218",0,2,0,2,"dummy"
"102219",0,7,0,7,"dummy"
"102220",0,2,1,3,"dummy"
"102221",1,0,4,5,"dummy"
"102222",21,4,5,30,"dummy"
"102223",1,1,3,5,"dummy"
"102224",1,0,0,1,"dummy"
"102226",16,16,4,36,"dummy"
"102232",0,0,0,0,"dummy"
"102233",0,1,0,1,"dummy"
"102239",0,2,0,2,"dummy"
"102240",0,1,0,1,"dummy"
"102241",0,1,0,1,"dummy"
"102242",0,0,1,1,"dummy"
"102243",0,0,1,1,"dummy"
"102244",0,0,1,1,"dummy"
"102245",0,0,1,1,"dummy"
"102247",3,5,5,13,"dummy"
"102248",6,2,0,8,"dummy"
"102249",0,2,0,2,"dummy"
"102250",3,1,0,4,"dummy"
"102254",0,0,3,3,"dummy"
"102256",0,0,1,1,"dummy"
"102258",0,8,0,8,"dummy"
"102260",0,4,0,4,"dummy"
"102261",0,1,0,1,"dummy"
"102263",0,0,3,3,"dummy"
"102264",0,0,0,0,"dummy"
"102268",0,0,0,0,"dummy"
"102269",0,0,0,0,"dummy"
"102270",0,0,0,0,"dummy"
"102271",3,0,0,3,"dummy"
"102273",10,5,1,16,"dummy"
"102274",1,1,0,2,"dummy"
"102275",7,57,3,67,"dummy"
"102276",7,6,1,14,"dummy"
"102277",0,1,0,1,"dummy"
"102278",0,4,0,4,"dummy"
"102279",0,0,1,1,"dummy"
"102283",1,0,0,1,"dummy"
"102284",0,0,0,0,"dummy"
"102285",0,0,3,3,"dummy"
"102286",0,0,0,0,"dummy"
"102292",0,0,0,0,"dummy"
"102293",0,0,0,0,"dummy"
"102294",0,0,0,0,"dummy"
"102295",0,6,0,6,"dummy"
"102297",2,1,1,4,"dummy"
"102300",53,31,0,84,"dummy"
"102301",1,3,2,6,"dummy"
"102302",4,18,6,28,"dummy"
"102303",2,6,0,8,"dummy"
"102304",2,72,1,75,"dummy"
"102305",3,11,14,28,"dummy"
"102306",8,5,0,13,"dummy"
"102307",5,4,0,9,"dummy"
"102308",16,25,9,50,"dummy"
"102310",1,0,1,2,"dummy"
"102320",0,0,1,1,"dummy"
"102321",0,0,1,1,"dummy"
"102323",0,0,1,1,"dummy"
"102324",0,0,1,1,"dummy"
"102325",0,0,1,1,"dummy"
"102326",0,0,1,1,"dummy"
"102327",2,2,0,4,"dummy"
"102328",2,2,0,4,"dummy"
"102329",0,1,0,1,"dummy"
"102330",0,1,1,2,"dummy"
"102331",0,1,4,5,"dummy"
"102332",0,1,0,1,"dummy"
"102335",0,0,1,1,"dummy"
"102336",0,0,1,1,"dummy"
"102337",0,0,1,1,"dummy"
"102338",0,0,1,1,"dummy"
"102339",0,1,0,1,"dummy"
"102340",0,2,0,2,"dummy"
"102341",0,0,1,1,"dummy"
"102342",1,3,1,5,"dummy"
"102343",4,0,0,4,"dummy"
"102344",3,0,2,5,"dummy"
"102345",0,25,1,26,"dummy"
"102346",0,2,1,3,"dummy"
"102347",0,2,1,3,"dummy"
"102348",1,0,0,1,"dummy"
"102350",0,1,0,1,"dummy"
"102352",0,0,1,1,"dummy"
"102353",0,0,0,0,"dummy"
"102366",0,0,0,0,"dummy"
"102367",1,2,3,6,"dummy"
"102368",1,2,2,5,"dummy"
"102369",0,0,1,1,"dummy"
"102371",0,0,1,1,"dummy"
"102374",0,1,0,1,"dummy"
"102375",0,1,0,1,"dummy"
"102376",1,1,0,2,"dummy"
"102377",1,1,0,2,"dummy"
"102379",0,1,0,1,"dummy"
"102381",0,2,0,2,"dummy"
"102382",0,1,0,1,"dummy"
"102383",0,0,1,1,"dummy"
"102384",6,7,0,13,"dummy"
"102385",0,1,0,1,"dummy"
"102400",0,1,0,1,"dummy"
"102401",8,7,1,16,"dummy"
"102403",0,0,2,2,"dummy"
"102404",0,0,2,2,"dummy"
"102405",0,0,2,2,"dummy"
"102406",0,0,2,2,"dummy"
"102408",0,2,0,2,"dummy"
"102410",1,8,1,10,"dummy"
"102412",0,1,1,2,"dummy"
"102413",1,0,1,2,"dummy"
"102416",0,0,1,1,"dummy"
"102417",0,0,1,1,"dummy"
"102418",0,1,1,2,"dummy"
"102419",0,0,1,1,"dummy"
"102420",0,1,0,1,"dummy"
"102421",0,0,0,0,"dummy"
"102422",9,4,0,13,"dummy"
"102426",0,2,0,2,"dummy"
"102427",0,0,0,0,"dummy"
"102449",0,0,1,1,"dummy"
"102450",0,0,1,1,"dummy"
"102452",0,1,2,3,"dummy"
"102453",0,0,0,0,"dummy"
"102454",0,1,0,1,"dummy"
"102455",4,0,2,6,"dummy"
"102456",1,0,0,1,"dummy"
"102457",0,0,0,0,"dummy"
"102458",0,0,0,0,"dummy"
"102478",10,0,4,14,"dummy"
"102479",0,2,0,2,"dummy"
"102480",0,2,0,2,"dummy"
"102481",1,0,0,1,"dummy"
"102482",1,1,0,2,"dummy"
"102487",0,0,1,1,"dummy"
"102488",2,2,1,5,"dummy"
"102489",0,0,1,1,"dummy"
"102490",4,0,0,4,"dummy"
"102492",0,0,1,1,"dummy"
"102493",0,5,0,5,"dummy"
"102494",2,2,0,4,"dummy"
"102495",0,1,0,1,"dummy"
"102496",0,0,1,1,"dummy"
"102497",11,10,0,21,"dummy"
"102498",1,7,1,9,"dummy"
"102499",0,1,0,1,"dummy"
"102500",0,1,0,1,"dummy"
"102501",0,1,0,1,"dummy"
"102502",34,8,0,42,"dummy"
"102503",0,1,0,1,"dummy"
"102504",0,1,0,1,"dummy"
"102507",8,10,1,19,"dummy"
"102508",10,4,1,15,"dummy"
"102513",2,4,0,6,"dummy"
"102514",0,2,0,2,"dummy"
"102515",0,2,0,2,"dummy"
"102516",10,2,0,12,"dummy"
"102517",0,2,0,2,"dummy"
"102518",0,0,0,0,"dummy"
"102520",1,1,0,2,"dummy"
"102522",4,4,0,8,"dummy"
"102523",4,4,0,8,"dummy"
"102524",0,2,0,2,"dummy"
"102525",0,1,0,1,"dummy"
"102526",3,0,0,3,"dummy"
"102527",2,2,0,4,"dummy"
"102529",0,14,0,14,"dummy"
"102533",0,2,2,4,"dummy"
"102534",0,0,0,0,"dummy"
"102535",0,1,0,1,"dummy"
"102536",0,0,0,0,"dummy"
"102537",0,0,0,0,"dummy"
"102538",0,0,0,0,"dummy"
"102543",0,2,2,4,"dummy"
"102544",0,0,1,1,"dummy"
"102545",8,2,1,11,"dummy"
"102546",0,1,0,1,"dummy"
"102547",1,1,1,3,"dummy"
"102548",0,1,1,2,"dummy"
"102549",1,0,1,2,"dummy"
"102550",0,0,1,1,"dummy"
"102551",0,2,1,3,"dummy"
"102552",0,1,0,1,"dummy"
"102554",0,3,0,3,"dummy"
"102555",0,1,0,1,"dummy"
"102558",0,1,0,1,"dummy"
"102559",2,4,0,6,"dummy"
"102562",1,4,1,6,"dummy"
"102563",4,1,0,5,"dummy"
"102566",18,32,1,51,"dummy"
"102567",9,4,0,13,"dummy"
"102568",3,12,0,15,"dummy"
"102569",41,25,5,71,"dummy"
"102578",0,0,0,0,"dummy"
"102579",1,0,0,1,"dummy"
"102580",7,3,2,12,"dummy"
"102581",0,0,2,2,"dummy"
"102582",0,1,0,1,"dummy"
"102583",0,2,0,2,"dummy"
"102584",0,1,0,1,"dummy"
"102585",1,0,0,1,"dummy"
"102587",5,3,0,8,"dummy"
"102588",3,8,0,11,"dummy"
"102589",0,0,2,2,"dummy"
"102590",0,0,1,1,"dummy"
"102593",0,1,0,1,"dummy"
"102602",0,1,0,1,"dummy"
"102603",0,0,1,1,"dummy"
"102604",3,5,3,11,"dummy"
"102605",1,0,0,1,"dummy"
"102609",0,0,1,1,"dummy"
"102611",0,2,3,5,"dummy"
"102612",0,1,0,1,"dummy"
"102616",17,10,3,30,"dummy"
"102617",0,1,0,1,"dummy"
"102618",0,0,2,2,"dummy"
"102641",1,1,1,3,"dummy"
"102642",0,0,0,0,"dummy"
"102643",30,1,0,31,"dummy"
"102644",0,0,1,1,"dummy"
"102649",6,8,2,16,"dummy"
"102650",6,5,0,11,"dummy"
"102651",1,1,0,2,"dummy"
"102652",0,1,0,1,"dummy"
"102659",3,6,1,10,"dummy"
"102660",4,0,5,9,"dummy"
"102661",1,0,0,1,"dummy"
"102662",0,0,2,2,"dummy"
"102663",22,0,0,22,"dummy"
"102665",0,0,2,2,"dummy"
"102667",0,0,0,0,"dummy"
"102668",5,5,7,17,"dummy"
"102671",3,22,0,25,"dummy"
"102672",0,3,1,4,"dummy"
"102673",0,2,0,2,"dummy"
"102674",0,0,1,1,"dummy"
"102680",0,0,1,1,"dummy"
"102681",0,0,1,1,"dummy"
"102684",1,3,2,6,"dummy"
"102690",6,0,0,6,"dummy"
"102691",2,5,2,9,"dummy"
"102733",0,1,0,1,"dummy"
"102736",2,2,0,4,"dummy"
"102738",1,5,2,8,"dummy"
"102739",3,1,0,4,"dummy"
"102762",0,0,1,1,"dummy"
"102763",0,0,1,1,"dummy"
"102764",0,0,0,0,"dummy"
"102765",0,0,1,1,"dummy"
"102766",0,0,1,1,"dummy"
"102768",0,0,4,4,"dummy"
"102769",0,0,2,2,"dummy"
"102772",0,1,0,1,"dummy"
"102776",0,0,0,0,"dummy"
"102777",0,0,0,0,"dummy"
"102778",0,0,0,0,"dummy"
"102779",0,0,0,0,"dummy"
"102780",0,1,2,3,"dummy"
"102783",0,0,1,1,"dummy"
"102785",0,0,1,1,"dummy"
"102788",0,1,0,1,"dummy"
"102789",1,0,0,1,"dummy"
"102790",5,5,7,17,"dummy"
"102791",6,6,1,13,"dummy"
"102792",0,1,2,3,"dummy"
"102793",0,0,1,1,"dummy"
"102795",0,0,1,1,"dummy"
"102797",2,3,0,5,"dummy"
"102798",2,0,0,2,"dummy"
"102799",0,0,0,0,"dummy"
"102804",0,0,1,1,"dummy"
"102808",1,2,0,3,"dummy"
"102809",0,2,0,2,"dummy"
"102811",2,13,3,18,"dummy"
"102812",0,4,0,4,"dummy"
"102813",1,1,0,2,"dummy"
"102814",1,1,1,3,"dummy"
"102815",7,2,0,9,"dummy"
"102816",0,1,0,1,"dummy"
"102817",2,3,0,5,"dummy"
"102818",0,0,3,3,"dummy"
"102819",0,1,3,4,"dummy"
"102820",1,0,3,4,"dummy"
"102821",0,1,3,4,"dummy"
"102822",0,1,3,4,"dummy"
"102823",1,3,3,7,"dummy"
"102824",6,1,0,7,"dummy"
"102825",1,3,1,5,"dummy"
"102826",0,2,0,2,"dummy"
"102827",9,6,1,16,"dummy"
"102829",0,0,0,0,"dummy"
"102830",1,8,1,10,"dummy"
"102838",6,2,1,9,"dummy"
"102839",2,0,0,2,"dummy"
"102840",0,2,0,2,"dummy"
"102842",0,0,1,1,"dummy"
"102843",2,2,0,4,"dummy"
"102844",0,0,1,1,"dummy"
"102845",0,0,1,1,"dummy"
"102846",0,0,2,2,"dummy"
"102849",0,1,0,1,"dummy"
"102852",0,1,0,1,"dummy"
"102854",0,2,0,2,"dummy"
"102856",1,3,2,6,"dummy"
"102857",0,1,0,1,"dummy"
"102858",1,0,0,1,"dummy"
"102860",0,0,5,5,"dummy"
"102862",0,0,1,1,"dummy"
"102863",0,1,0,1,"dummy"
"102872",0,0,1,1,"dummy"
"102873",0,1,0,1,"dummy"
"102874",0,0,0,0,"dummy"
"102875",0,0,0,0,"dummy"
"102876",0,0,0,0,"dummy"
"102886",5,2,4,11,"dummy"
"102888",0,1,0,1,"dummy"
"102889",0,3,0,3,"dummy"
"102890",9,9,0,18,"dummy"
"102891",2,2,0,4,"dummy"
"102892",9,9,0,18,"dummy"
"102893",0,5,0,5,"dummy"
"102894",0,0,1,1,"dummy"
"102895",4,1,5,10,"dummy"
"102896",0,2,1,3,"dummy"
"102897",0,0,1,1,"dummy"
"102898",0,4,0,4,"dummy"
"102899",1,0,1,2,"dummy"
"102900",0,1,0,1,"dummy"
"102901",7,7,0,14,"dummy"
"102903",3,1,1,5,"dummy"
"102904",4,31,3,38,"dummy"
"102905",0,1,0,1,"dummy"
"102908",0,4,0,4,"dummy"
"102909",4,3,0,7,"dummy"
"102911",0,0,0,0,"dummy"
"102912",1,2,0,3,"dummy"
"102913",9,21,3,33,"dummy"
"102914",0,0,1,1,"dummy"
"102915",0,0,2,2,"dummy"
"102916",0,1,0,1,"dummy"
"102917",0,0,1,1,"dummy"
"102920",0,0,0,0,"dummy"
"102921",0,0,0,0,"dummy"
"102924",3,9,0,12,"dummy"
"102928",0,0,1,1,"dummy"
"102929",1,2,1,4,"dummy"
"102940",0,0,0,0,"dummy"
"102941",1,0,0,1,"dummy"
"102951",0,2,0,2,"dummy"
"102952",0,1,0,1,"dummy"
"102953",0,0,1,1,"dummy"
"102954",2,0,0,2,"dummy"
"102956",0,1,0,1,"dummy"
"102957",1,1,0,2,"dummy"
"102958",0,1,0,1,"dummy"
"102959",0,0,1,1,"dummy"
"102960",1,2,0,3,"dummy"
"102961",1,2,0,3,"dummy"
"102965",2,9,2,13,"dummy"
"102967",0,3,0,3,"dummy"
"102968",1,2,0,3,"dummy"
"102969",0,0,1,1,"dummy"
"102976",0,1,0,1,"dummy"
"102978",0,1,0,1,"dummy"
"102981",0,2,0,2,"dummy"
"102982",0,0,2,2,"dummy"
"102983",0,8,0,8,"dummy"
"102985",0,1,0,1,"dummy"
"102986",0,8,0,8,"dummy"
"102987",4,16,0,20,"dummy"
"102988",1,2,0,3,"dummy"
"102989",2,1,0,3,"dummy"
"102990",0,1,0,1,"dummy"
"102991",0,1,0,1,"dummy"
"102992",0,1,0,1,"dummy"
"102993",0,2,0,2,"dummy"
"102994",0,1,0,1,"dummy"
"102997",0,0,1,1,"dummy"
"102998",0,0,1,1,"dummy"
"103013",0,0,0,0,"dummy"
"103015",0,1,0,1,"dummy"
"103016",5,31,5,41,"dummy"
"103017",2,3,0,5,"dummy"
"103018",1,2,0,3,"dummy"
"103019",0,3,0,3,"dummy"
"103020",0,1,0,1,"dummy"
"103021",3,1,0,4,"dummy"
"103022",0,0,0,0,"dummy"
"103023",1,1,0,2,"dummy"
"103024",0,0,2,2,"dummy"
"103025",3,0,0,3,"dummy"
"103054",0,0,2,2,"dummy"
"103055",0,1,0,1,"dummy"
"103056",2,0,0,2,"dummy"
"103057",0,1,0,1,"dummy"
"103058",1,0,0,1,"dummy"
"103060",0,0,1,1,"dummy"
"103061",0,0,1,1,"dummy"
"103062",5,2,0,7,"dummy"
"103063",0,0,1,1,"dummy"
"103064",0,0,1,1,"dummy"
"103065",0,0,1,1,"dummy"
"103066",0,0,1,1,"dummy"
"103070",0,0,2,2,"dummy"
"103071",0,0,1,1,"dummy"
"103072",0,2,0,2,"dummy"
"103075",0,2,0,2,"dummy"
"103078",1,9,5,15,"dummy"
"103079",1,4,1,6,"dummy"
"103080",1,14,1,16,"dummy"
"103081",1,0,0,1,"dummy"
"103082",0,2,0,2,"dummy"
"103085",0,0,0,0,"dummy"
"103090",0,1,0,1,"dummy"
"103091",0,0,1,1,"dummy"
"103092",0,1,0,1,"dummy"
"103093",0,0,1,1,"dummy"
"103094",1,0,0,1,"dummy"
"103097",0,31,0,31,"dummy"
"103103",2,0,3,5,"dummy"
"103104",1,0,0,1,"dummy"
"103105",0,1,0,1,"dummy"
"103106",0,1,1,2,"dummy"
"103116",1,12,0,13,"dummy"
"103119",3,0,4,7,"dummy"
"103120",0,0,1,1,"dummy"
"103121",0,0,1,1,"dummy"
"103122",0,2,1,3,"dummy"
"103123",1,3,0,4,"dummy"
"103124",2,0,0,2,"dummy"
"103125",0,3,0,3,"dummy"
"103126",0,0,1,1,"dummy"
"103127",0,2,0,2,"dummy"
"103128",1,1,0,2,"dummy"
"103129",1,1,0,2,"dummy"
"103130",2,0,0,2,"dummy"
"103131",0,1,0,1,"dummy"
"103149",0,0,3,3,"dummy"
"103150",22,3,4,29,"dummy"
"103151",1,0,2,3,"dummy"
"103152",0,0,1,1,"dummy"
"103210",0,0,2,2,"dummy"
"103211",0,11,2,13,"dummy"
"103212",0,0,0,0,"dummy"
"103213",0,11,0,11,"dummy"
"103216",2,4,2,8,"dummy"
"103217",0,2,0,2,"dummy"
"103222",0,1,2,3,"dummy"
"103225",0,9,1,10,"dummy"
"103226",1,0,0,1,"dummy"
"103227",4,3,0,7,"dummy"
"103228",3,12,0,15,"dummy"
"103229",2,1,1,4,"dummy"
"103230",0,1,0,1,"dummy"
"103231",0,2,0,2,"dummy"
"103232",0,1,0,1,"dummy"
"103233",0,1,0,1,"dummy"
"103234",3,4,0,7,"dummy"
"103235",1,0,0,1,"dummy"
"103236",3,0,0,3,"dummy"
"103237",0,0,1,1,"dummy"
"103238",0,0,1,1,"dummy"
"103239",0,0,1,1,"dummy"
"103313",0,0,1,1,"dummy"
"103314",0,4,1,5,"dummy"
"103315",0,0,1,1,"dummy"
"103135",0,0,1,1,"dummy"
"103136",0,2,2,4,"dummy"
"103137",1,0,1,2,"dummy"
"103138",0,1,4,5,"dummy"
"103139",0,2,0,2,"dummy"
"103142",1,4,1,6,"dummy"
"103143",0,0,1,1,"dummy"
"103144",4,0,1,5,"dummy"
"103145",1,0,1,2,"dummy"
"103146",0,1,0,1,"dummy"
"103147",0,0,1,1,"dummy"
"103162",3,3,0,6,"dummy"
"103163",0,0,1,1,"dummy"
"103164",0,0,0,0,"dummy"
"103206",12,0,0,12,"dummy"
"103241",0,0,1,1,"dummy"
"103242",1,18,0,19,"dummy"
"103243",0,0,0,0,"dummy"
"103244",0,1,0,1,"dummy"
"103245",0,0,1,1,"dummy"
"103246",1,0,0,1,"dummy"
"103247",0,1,0,1,"dummy"
"103248",0,2,0,2,"dummy"
"103249",21,1,0,22,"dummy"
"103250",1,22,0,23,"dummy"
"103251",0,2,0,2,"dummy"
"103252",0,0,0,0,"dummy"
"103253",19,14,8,41,"dummy"
"103254",6,15,7,28,"dummy"
"103255",0,1,3,4,"dummy"
"103289",0,2,0,2,"dummy"
"103290",2,0,0,2,"dummy"
"103291",0,7,0,7,"dummy"
"103292",0,1,0,1,"dummy"
"103293",0,1,0,1,"dummy"
"103294",0,1,0,1,"dummy"
"103295",1,0,0,1,"dummy"
"103296",0,1,0,1,"dummy"
"103297",1,0,0,1,"dummy"
"103298",0,1,0,1,"dummy"
"103299",1,0,0,1,"dummy"
"103300",0,1,0,1,"dummy"
"103301",1,0,0,1,"dummy"
"103302",1,3,0,4,"dummy"
"103303",7,1,0,8,"dummy"
"103304",0,0,3,3,"dummy"
"103305",0,1,0,1,"dummy"
"103306",1,2,0,3,"dummy"
"103307",1,0,0,1,"dummy"
"103308",0,0,0,0,"dummy"
"103309",2,2,1,5,"dummy"
"103310",0,0,2,2,"dummy"
"103311",0,0,1,1,"dummy"
"103317",0,1,0,1,"dummy"
"103318",0,1,0,1,"dummy"
"103319",3,11,2,16,"dummy"
"103320",0,2,1,3,"dummy"
"103321",5,10,1,16,"dummy"
"103322",4,4,1,9,"dummy"
"103323",3,1,1,5,"dummy"
"103326",6,1,2,9,"dummy"
"103327",6,3,3,12,"dummy"
"103328",6,0,0,6,"dummy"
"103329",0,2,0,2,"dummy"
"103330",2,1,1,4,"dummy"
"103331",0,0,1,1,"dummy"
"103332",2,2,0,4,"dummy"
"103333",2,0,0,2,"dummy"
"103334",0,1,0,1,"dummy"
"103335",1,0,0,1,"dummy"
"103336",2,0,0,2,"dummy"
"103337",0,2,0,2,"dummy"
"103361",2,4,2,8,"dummy"
"103362",0,2,0,2,"dummy"
"103364",2,2,2,6,"dummy"
"103365",1,14,2,17,"dummy"
"103366",0,0,1,1,"dummy"
"103367",0,0,1,1,"dummy"
"103369",0,1,0,1,"dummy"
"103370",0,1,0,1,"dummy"
"103372",0,2,0,2,"dummy"
"103374",0,5,1,6,"dummy"
"103375",0,0,1,1,"dummy"
"103376",1,3,1,5,"dummy"
"103378",0,0,0,0,"dummy"
"103380",0,3,1,4,"dummy"
"103381",0,3,1,4,"dummy"
"103383",0,0,0,0,"dummy"
"103384",0,0,1,1,"dummy"
"103393",3,10,4,17,"dummy"
"103395",0,1,0,1,"dummy"
"103396",0,1,0,1,"dummy"
"103398",4,6,1,11,"dummy"
"103399",2,0,0,2,"dummy"
"103407",0,5,0,5,"dummy"
"103411",0,1,0,1,"dummy"
"103412",0,1,0,1,"dummy"
"103413",0,1,0,1,"dummy"
"103416",0,0,3,3,"dummy"
"103418",2,0,0,2,"dummy"
"103421",0,0,0,0,"dummy"
"103422",0,0,0,0,"dummy"
"103423",0,0,0,0,"dummy"
"103424",0,0,0,0,"dummy"
"103425",0,0,0,0,"dummy"
"103426",0,0,0,0,"dummy"
"103427",0,0,0,0,"dummy"
"103429",0,3,1,4,"dummy"
"103430",3,8,1,12,"dummy"
"103431",0,0,1,1,"dummy"
"103433",4,7,1,12,"dummy"
"103435",0,0,1,1,"dummy"
"103436",0,2,0,2,"dummy"
"103437",1,0,0,1,"dummy"
"103438",0,0,0,0,"dummy"
"103439",0,0,0,0,"dummy"
"103440",0,0,0,0,"dummy"
"103441",2,2,1,5,"dummy"
"103444",12,1,3,16,"dummy"
"103445",0,0,1,1,"dummy"
"103446",0,1,0,1,"dummy"
"103447",0,1,0,1,"dummy"
"103448",1,0,0,1,"dummy"
"103450",1,6,0,7,"dummy"
"103451",0,1,0,1,"dummy"
"103452",0,1,0,1,"dummy"
"103454",0,2,0,2,"dummy"
"103455",3,3,0,6,"dummy"
"103456",0,1,0,1,"dummy"
"103458",3,3,0,6,"dummy"
"103459",1,2,0,3,"dummy"
"103460",0,1,1,2,"dummy"
"103461",0,1,0,1,"dummy"
"103462",0,0,1,1,"dummy"
"103463",0,2,1,3,"dummy"
"103464",1,2,0,3,"dummy"
"103465",0,1,0,1,"dummy"
"103466",0,1,0,1,"dummy"
"103467",0,3,0,3,"dummy"
"103468",2,0,0,2,"dummy"
"103469",0,1,0,1,"dummy"
"103470",0,0,1,1,"dummy"
"103471",5,0,1,6,"dummy"
"103472",4,1,0,5,"dummy"
"103503",0,0,1,1,"dummy"
"103504",2,0,0,2,"dummy"
"103505",1,0,0,1,"dummy"
"103506",0,0,0,0,"dummy"
"103507",0,2,0,2,"dummy"
"103508",0,0,0,0,"dummy"
"103509",0,0,0,0,"dummy"
"103511",12,13,1,26,"dummy"
"103512",1,1,0,2,"dummy"
"103513",0,7,1,8,"dummy"
"103516",12,3,1,16,"dummy"
"103517",2,0,1,3,"dummy"
"103521",0,0,2,2,"dummy"
"103522",14,16,2,32,"dummy"
"103523",3,2,4,9,"dummy"
"103524",0,0,4,4,"dummy"
"103525",2,1,1,4,"dummy"
"103526",0,2,0,2,"dummy"
"103532",0,0,1,1,"dummy"
"103533",0,0,1,1,"dummy"
"103535",0,0,0,0,"dummy"
"103538",11,2,2,15,"dummy"
"103539",0,0,2,2,"dummy"
"103540",0,0,2,2,"dummy"
"103541",0,0,2,2,"dummy"
"103542",4,25,3,32,"dummy"
"103543",0,2,0,2,"dummy"
"103544",0,0,1,1,"dummy"
"103545",0,0,4,4,"dummy"
"103546",0,0,1,1,"dummy"
"103547",6,0,1,7,"dummy"
"103548",0,0,1,1,"dummy"
"103549",0,0,1,1,"dummy"
"103550",0,0,1,1,"dummy"
"103551",0,0,1,1,"dummy"
"103552",0,0,1,1,"dummy"
"103553",0,0,1,1,"dummy"
"103554",0,0,1,1,"dummy"
"103555",0,0,1,1,"dummy"
"103556",0,0,1,1,"dummy"
"103557",0,0,1,1,"dummy"
"103558",0,0,1,1,"dummy"
"103559",0,1,0,1,"dummy"
"103560",0,0,1,1,"dummy"
"103561",0,1,0,1,"dummy"
"103562",2,1,4,7,"dummy"
"103563",0,2,0,2,"dummy"
"103564",2,2,0,4,"dummy"
"103565",2,2,0,4,"dummy"
"103566",0,0,1,1,"dummy"
"103567",0,0,1,1,"dummy"
"103568",0,2,0,2,"dummy"
"103569",2,7,0,9,"dummy"
"103570",0,0,1,1,"dummy"
"103571",0,0,1,1,"dummy"
"103572",0,0,1,1,"dummy"
"103579",0,3,1,4,"dummy"
"103580",0,0,1,1,"dummy"
"103581",0,0,1,1,"dummy"
"103582",0,0,1,1,"dummy"
"103584",0,0,0,0,"dummy"
"103585",0,1,1,2,"dummy"
"103586",0,1,1,2,"dummy"
"103587",0,1,0,1,"dummy"
"103590",0,8,2,10,"dummy"
"103592",0,0,1,1,"dummy"
"103593",0,0,1,1,"dummy"
"103594",0,2,3,5,"dummy"
"103600",1,1,1,3,"dummy"
"103601",0,1,0,1,"dummy"
"103607",0,3,0,3,"dummy"
"103608",2,4,0,6,"dummy"
"103609",0,3,0,3,"dummy"
"103610",0,1,0,1,"dummy"
"103611",6,8,0,14,"dummy"
"103612",0,6,0,6,"dummy"
"103613",0,3,0,3,"dummy"
"103614",0,1,1,2,"dummy"
"103615",0,2,0,2,"dummy"
"103616",0,1,0,1,"dummy"
"103617",0,0,1,1,"dummy"
"103618",0,1,3,4,"dummy"
"103619",0,1,0,1,"dummy"
"103620",0,0,3,3,"dummy"
"103621",0,1,0,1,"dummy"
"103622",0,0,3,3,"dummy"
"103625",0,0,1,1,"dummy"
"103626",0,0,2,2,"dummy"
"103627",0,0,1,1,"dummy"
"103629",1,0,1,2,"dummy"
"103631",0,1,0,1,"dummy"
"103636",1,9,0,10,"dummy"
"103637",3,8,1,12,"dummy"
"103638",11,0,1,12,"dummy"
"103641",0,0,1,1,"dummy"
"103642",0,0,0,0,"dummy"
"103644",0,0,1,1,"dummy"
"103645",0,1,0,1,"dummy"
"103648",7,5,0,12,"dummy"
"103649",10,6,3,19,"dummy"
"103650",0,0,1,1,"dummy"
"103658",0,3,0,3,"dummy"
"103659",0,1,0,1,"dummy"
"103660",0,1,0,1,"dummy"
"103661",3,5,1,9,"dummy"
"103663",0,0,0,0,"dummy"
"103664",0,0,0,0,"dummy"
"103665",0,0,0,0,"dummy"
"103666",0,0,1,1,"dummy"
"103667",0,0,1,1,"dummy"
"103668",0,0,1,1,"dummy"
"103675",0,0,1,1,"dummy"
"103680",0,2,0,2,"dummy"
"103681",0,1,0,1,"dummy"
"103682",0,1,0,1,"dummy"
"103683",0,1,0,1,"dummy"
"103684",0,0,1,1,"dummy"
"103685",0,1,0,1,"dummy"
"103687",0,0,3,3,"dummy"
"103689",3,4,0,7,"dummy"
"103690",8,7,3,18,"dummy"
"103691",0,2,0,2,"dummy"
"103692",0,1,1,2,"dummy"
"103693",0,0,1,1,"dummy"
"103694",0,0,2,2,"dummy"
"103695",1,0,0,1,"dummy"
"103701",7,28,4,39,"dummy"
"103704",2,0,0,2,"dummy"
"103705",3,4,1,8,"dummy"
"103706",3,3,0,6,"dummy"
"103707",1,7,0,8,"dummy"
"103708",3,3,0,6,"dummy"
"103709",0,1,0,1,"dummy"
"103710",0,0,1,1,"dummy"
"103712",0,1,1,2,"dummy"
"103713",0,3,0,3,"dummy"
"103715",1,0,0,1,"dummy"
"103717",1,3,2,6,"dummy"
"103721",0,0,2,2,"dummy"
"103725",0,0,1,1,"dummy"
"103730",3,25,1,29,"dummy"
"103731",0,2,0,2,"dummy"
"103732",2,5,3,10,"dummy"
"103733",0,2,0,2,"dummy"
"103734",2,36,0,38,"dummy"
"103735",0,0,1,1,"dummy"
"103749",0,1,0,1,"dummy"
"103750",1,0,0,1,"dummy"
"103751",0,0,1,1,"dummy"
"103753",0,1,0,1,"dummy"
"103754",0,1,0,1,"dummy"
"103755",0,3,0,3,"dummy"
"103756",3,0,2,5,"dummy"
"103757",0,0,1,1,"dummy"
"103759",0,0,0,0,"dummy"
"103760",0,8,1,9,"dummy"
"103761",0,1,0,1,"dummy"
"103762",0,1,0,1,"dummy"
"103763",1,0,0,1,"dummy"
"103765",6,1,2,9,"dummy"
"103766",0,9,0,9,"dummy"
"103768",0,1,2,3,"dummy"
"103769",4,5,2,11,"dummy"
"103772",0,0,1,1,"dummy"
"103773",0,0,0,0,"dummy"
"103776",1,4,0,5,"dummy"
"103777",1,13,1,15,"dummy"
"103778",2,1,1,4,"dummy"
"103779",0,0,1,1,"dummy"
"103780",0,0,2,2,"dummy"
"103781",12,6,0,18,"dummy"
"103782",0,1,1,2,"dummy"
"103783",2,3,1,6,"dummy"
"103784",0,0,2,2,"dummy"
"103785",6,2,0,8,"dummy"
"103786",0,1,0,1,"dummy"
"103787",0,1,1,2,"dummy"
"103788",0,0,2,2,"dummy"
"103816",1,6,0,7,"dummy"
"103819",0,0,1,1,"dummy"
"103820",0,5,0,5,"dummy"
"103821",2,1,0,3,"dummy"
"103822",1,2,0,3,"dummy"
"103823",2,1,0,3,"dummy"
"103824",16,3,2,21,"dummy"
"103825",1,3,4,8,"dummy"
"103826",0,0,2,2,"dummy"
"103835",0,0,1,1,"dummy"
"103836",9,20,4,33,"dummy"
"103837",0,0,1,1,"dummy"
"103838",11,9,3,23,"dummy"
"103839",0,0,1,1,"dummy"
"103840",0,2,0,2,"dummy"
"103841",0,0,1,1,"dummy"
"103850",4,0,0,4,"dummy"
"103851",1,0,0,1,"dummy"
"103852",0,0,2,2,"dummy"
"103853",0,1,1,2,"dummy"
"103854",3,1,0,4,"dummy"
"103857",3,6,1,10,"dummy"
"103858",0,1,2,3,"dummy"
"103859",0,1,2,3,"dummy"
"103860",1,1,2,4,"dummy"
"103861",4,10,1,15,"dummy"
"103862",29,16,7,52,"dummy"
"103863",0,6,0,6,"dummy"
"103864",0,1,0,1,"dummy"
"103865",1,13,0,14,"dummy"
"103866",0,3,0,3,"dummy"
"103867",6,1,1,8,"dummy"
"103868",10,2,1,13,"dummy"
"103869",1,5,1,7,"dummy"
"103870",9,2,1,12,"dummy"
"103871",2,9,2,13,"dummy"
"103872",3,1,0,4,"dummy"
"103873",9,2,1,12,"dummy"
"103874",0,2,0,2,"dummy"
"103875",0,3,0,3,"dummy"
"103876",2,3,1,6,"dummy"
"103877",0,1,0,1,"dummy"
"103878",0,2,0,2,"dummy"
"103879",0,0,2,2,"dummy"
"103880",0,1,0,1,"dummy"
"103881",1,0,0,1,"dummy"
"103882",8,9,0,17,"dummy"
"103907",1,0,1,2,"dummy"
"103908",0,1,1,2,"dummy"
"103909",3,0,0,3,"dummy"
"103910",0,4,1,5,"dummy"
"103911",0,0,1,1,"dummy"
"103912",0,1,3,4,"dummy"
"103913",0,0,1,1,"dummy"
"103915",0,0,1,1,"dummy"
"103916",0,0,2,2,"dummy"
"103917",0,0,0,0,"dummy"
"103918",0,0,0,0,"dummy"
"103919",0,0,0,0,"dummy"
"103920",0,0,0,0,"dummy"
"103921",0,0,0,0,"dummy"
"103922",0,0,1,1,"dummy"
"103923",0,0,0,0,"dummy"
"103927",0,0,0,0,"dummy"
"103929",0,1,0,1,"dummy"
"103930",0,1,0,1,"dummy"
"103972",0,1,0,1,"dummy"
"103973",0,3,0,3,"dummy"
"103974",4,0,0,4,"dummy"
"103975",0,1,0,1,"dummy"
"103976",0,4,0,4,"dummy"
"103977",0,2,0,2,"dummy"
"103978",0,0,1,1,"dummy"
"103979",0,4,0,4,"dummy"
"103980",1,4,2,7,"dummy"
"103981",0,0,1,1,"dummy"
"103982",0,1,0,1,"dummy"
"103983",1,0,0,1,"dummy"
"103984",0,1,0,1,"dummy"
"103985",2,0,0,2,"dummy"
"103986",2,0,0,2,"dummy"
"103987",0,1,0,1,"dummy"
"103988",1,2,1,4,"dummy"
"103990",0,0,0,0,"dummy"
"103991",0,0,0,0,"dummy"
"103993",0,0,2,2,"dummy"
"103994",0,3,0,3,"dummy"
"103995",2,0,3,5,"dummy"
"103996",0,0,4,4,"dummy"
"103997",0,0,4,4,"dummy"
"103998",0,0,4,4,"dummy"
"103999",0,0,2,2,"dummy"
"104000",0,3,2,5,"dummy"
"104002",0,4,0,4,"dummy"
"104010",0,2,0,2,"dummy"
"104011",11,0,0,11,"dummy"
"104013",0,0,3,3,"dummy"
"104018",0,3,0,3,"dummy"
"104019",0,1,0,1,"dummy"
"104020",0,0,1,1,"dummy"
"104023",3,15,2,20,"dummy"
"104024",0,0,1,1,"dummy"
"104025",1,3,2,6,"dummy"
"104026",6,2,0,8,"dummy"
"104027",0,0,2,2,"dummy"
"104028",0,0,3,3,"dummy"
"104029",0,0,2,2,"dummy"
"104030",0,0,2,2,"dummy"
"104031",3,3,3,9,"dummy"
"104032",0,0,1,1,"dummy"
"104033",0,0,1,1,"dummy"
"104034",0,0,1,1,"dummy"
"104035",0,0,1,1,"dummy"
"104036",0,0,2,2,"dummy"
"104038",3,0,0,3,"dummy"
"104039",2,1,1,4,"dummy"
"104040",5,12,0,17,"dummy"
"104041",5,3,2,10,"dummy"
"104042",3,3,0,6,"dummy"
"104045",2,8,0,10,"dummy"
"104046",1,3,0,4,"dummy"
"104047",0,1,0,1,"dummy"
"104048",0,0,2,2,"dummy"
"104049",0,3,0,3,"dummy"
"104050",0,0,1,1,"dummy"
"104053",0,0,1,1,"dummy"
"104054",0,7,1,8,"dummy"
"104067",0,0,1,1,"dummy"
"104068",0,13,1,14,"dummy"
"104069",0,0,1,1,"dummy"
"104070",0,2,0,2,"dummy"
"104073",0,0,1,1,"dummy"
"104074",0,7,0,7,"dummy"
"104075",0,3,0,3,"dummy"
"104076",0,1,0,1,"dummy"
"104077",0,1,0,1,"dummy"
"104078",0,2,0,2,"dummy"
"104079",0,0,1,1,"dummy"
"104081",1,0,0,1,"dummy"
"104082",1,1,1,3,"dummy"
"104083",0,2,0,2,"dummy"
"104094",1,0,0,1,"dummy"
"104095",1,2,0,3,"dummy"
"104096",0,0,2,2,"dummy"
"104098",0,0,0,0,"dummy"
"104099",0,0,0,0,"dummy"
"104100",0,0,0,0,"dummy"
"104131",0,2,0,2,"dummy"
"104132",0,1,0,1,"dummy"
"104133",1,0,0,1,"dummy"
"104134",1,1,0,2,"dummy"
"104135",0,1,0,1,"dummy"
"104136",0,0,0,0,"dummy"
"104137",0,2,0,2,"dummy"
"104138",0,2,0,2,"dummy"
"104139",0,3,0,3,"dummy"
"104140",0,13,0,13,"dummy"
"104141",2,2,0,4,"dummy"
"104142",0,2,0,2,"dummy"
"104147",0,2,0,2,"dummy"
"104148",0,2,1,3,"dummy"
"104149",0,1,0,1,"dummy"
"104150",0,0,0,0,"dummy"
"104155",0,0,0,0,"dummy"
"104186",0,2,0,2,"dummy"
"104187",0,3,3,6,"dummy"
"104188",0,0,0,0,"dummy"
"104191",0,0,0,0,"dummy"
"104194",0,0,1,1,"dummy"
"104195",2,2,0,4,"dummy"
"104198",0,0,0,0,"dummy"
"104199",0,0,1,1,"dummy"
"104200",0,0,0,0,"dummy"
"104203",0,4,0,4,"dummy"
"104206",0,0,2,2,"dummy"
"104207",0,30,2,32,"dummy"
"104208",28,2,4,34,"dummy"
"104217",0,4,2,6,"dummy"
"104218",0,0,2,2,"dummy"
"104219",0,0,1,1,"dummy"
"104269",1,0,0,1,"dummy"
"104270",2,0,1,3,"dummy"
"104271",0,0,0,0,"dummy"
"104272",0,1,0,1,"dummy"
"104273",8,1,0,9,"dummy"
"104274",0,0,0,0,"dummy"
"104275",0,0,0,0,"dummy"
"104276",1,10,0,11,"dummy"
"104277",7,1,0,8,"dummy"
"104278",2,0,3,5,"dummy"
"104285",0,2,0,2,"dummy"
"104286",3,0,0,3,"dummy"
"104289",0,1,0,1,"dummy"
"104290",0,0,1,1,"dummy"
"104291",1,7,1,9,"dummy"
"104292",0,4,0,4,"dummy"
"104293",1,1,2,4,"dummy"
"104324",0,2,0,2,"dummy"
"104325",0,3,0,3,"dummy"
"104326",0,1,0,1,"dummy"
"104327",0,1,0,1,"dummy"
"104328",0,3,0,3,"dummy"
"104329",0,2,0,2,"dummy"
"104336",0,0,2,2,"dummy"
"104337",3,10,2,15,"dummy"
"104338",3,2,1,6,"dummy"
"104339",1,2,2,5,"dummy"
"104363",0,1,0,1,"dummy"
"104385",0,0,1,1,"dummy"
"104389",0,0,1,1,"dummy"
"104438",0,4,0,4,"dummy"
"104439",0,1,0,1,"dummy"
"104152",1,0,0,1,"dummy"
"104153",0,0,1,1,"dummy"
"104210",0,0,1,1,"dummy"
"104211",0,6,0,6,"dummy"
"104212",0,6,0,6,"dummy"
"104260",0,0,1,1,"dummy"
"104261",0,0,4,4,"dummy"
"104262",0,0,1,1,"dummy"
"104263",0,0,1,1,"dummy"
"104264",0,2,1,3,"dummy"
"104265",0,2,0,2,"dummy"
"104280",6,9,3,18,"dummy"
"104281",0,2,0,2,"dummy"
"104282",0,0,0,0,"dummy"
"104283",15,7,2,24,"dummy"
"104322",2,0,3,5,"dummy"
"104341",0,5,0,5,"dummy"
"104342",1,0,0,1,"dummy"
"104343",2,0,2,4,"dummy"
"104344",0,2,0,2,"dummy"
"104349",0,0,1,1,"dummy"
"104352",0,2,1,3,"dummy"
"104353",1,12,2,15,"dummy"
"104365",3,11,0,14,"dummy"
"104372",1,1,1,3,"dummy"
"104373",1,0,1,2,"dummy"
"104374",4,5,1,10,"dummy"
"104375",1,0,1,2,"dummy"
"104376",0,0,1,1,"dummy"
"104379",0,0,1,1,"dummy"
"104380",1,1,1,3,"dummy"
"104381",1,1,0,2,"dummy"
"104387",0,0,1,1,"dummy"
"104391",0,1,0,1,"dummy"
"104392",0,1,0,1,"dummy"
"104393",0,2,0,2,"dummy"
"104394",1,1,0,2,"dummy"
"104405",0,6,0,6,"dummy"
"104406",0,0,1,1,"dummy"
"104407",1,1,3,5,"dummy"
"104408",0,1,0,1,"dummy"
"104409",0,1,0,1,"dummy"
"104410",0,2,0,2,"dummy"
"104411",0,13,0,13,"dummy"
"104412",0,0,0,0,"dummy"
"104413",12,0,0,12,"dummy"
"104414",1,20,0,21,"dummy"
"104415",0,0,0,0,"dummy"
"104416",0,3,0,3,"dummy"
"104417",0,2,0,2,"dummy"
"104418",2,2,0,4,"dummy"
"104419",0,0,0,0,"dummy"
"104420",2,2,0,4,"dummy"
"104421",0,0,0,0,"dummy"
"104422",0,0,0,0,"dummy"
"104423",0,0,0,0,"dummy"
"104424",0,2,0,2,"dummy"
"104425",2,0,0,2,"dummy"
"104426",0,0,0,0,"dummy"
"104427",0,0,0,0,"dummy"
"104428",0,2,0,2,"dummy"
"104429",2,0,0,2,"dummy"
"104436",0,1,0,1,"dummy"
"104446",0,0,1,1,"dummy"
"104447",0,0,0,0,"dummy"
"104448",0,12,0,12,"dummy"
"104449",0,1,0,1,"dummy"
"104450",1,2,2,5,"dummy"
"104451",3,0,0,3,"dummy"
"104452",2,0,0,2,"dummy"
"104453",0,1,0,1,"dummy"
"104456",0,1,0,1,"dummy"
"104457",1,1,0,2,"dummy"
"104458",0,0,0,0,"dummy"
"104459",1,0,0,1,"dummy"
"104460",0,4,0,4,"dummy"
"104461",0,0,1,1,"dummy"
"104462",4,0,0,4,"dummy"
"104463",0,2,0,2,"dummy"
"104464",2,2,1,5,"dummy"
"104465",6,1,0,7,"dummy"
"104472",4,1,0,5,"dummy"
"104511",1,1,0,2,"dummy"
"104512",1,1,0,2,"dummy"
"104440",0,5,0,5,"dummy"
"104467",6,0,0,6,"dummy"
"104468",0,0,1,1,"dummy"
"104509",0,0,1,1,"dummy"
"104514",0,2,0,2,"dummy"
"104519",0,0,1,1,"dummy"
"104520",0,1,0,1,"dummy"
"104521",0,0,1,1,"dummy"
"104523",3,0,0,3,"dummy"
"104528",0,0,0,0,"dummy"
"104535",0,4,0,4,"dummy"
"104536",0,0,1,1,"dummy"
"104537",3,3,1,7,"dummy"
"104538",5,1,0,6,"dummy"
"104539",0,0,1,1,"dummy"
"104540",1,6,1,8,"dummy"
"104541",0,0,1,1,"dummy"
"104543",0,0,0,0,"dummy"
"104544",0,2,0,2,"dummy"
"104545",0,1,0,1,"dummy"
"104567",1,0,0,1,"dummy"
"104581",0,1,0,1,"dummy"
"104590",3,1,1,5,"dummy"
"104591",3,1,0,4,"dummy"
"104592",0,3,0,3,"dummy"
"104593",0,0,0,0,"dummy"
"104594",0,0,2,2,"dummy"
"104595",0,0,1,1,"dummy"
"104596",3,5,1,9,"dummy"
"104597",0,0,1,1,"dummy"
"104598",0,7,0,7,"dummy"
"104599",11,0,5,16,"dummy"
"104601",0,0,1,1,"dummy"
"104603",0,0,2,2,"dummy"
"104605",10,3,1,14,"dummy"
"104606",0,6,3,9,"dummy"
"104607",0,1,0,1,"dummy"
"104608",0,1,0,1,"dummy"
"104609",0,1,0,1,"dummy"
"104610",1,1,0,2,"dummy"
"104611",1,2,0,3,"dummy"
"104612",0,1,0,1,"dummy"
"104613",0,3,0,3,"dummy"
"104614",0,1,0,1,"dummy"
"104617",4,1,1,6,"dummy"
"104624",0,0,1,1,"dummy"
"104625",2,2,0,4,"dummy"
"104626",2,2,2,6,"dummy"
"104627",2,4,1,7,"dummy"
"104628",4,2,2,8,"dummy"
"104629",2,4,2,8,"dummy"
"104630",0,0,1,1,"dummy"
"104631",0,0,0,0,"dummy"
"104634",2,0,0,2,"dummy"
"104635",2,2,1,5,"dummy"
"104664",0,0,1,1,"dummy"
"104665",0,0,1,1,"dummy"
"104666",0,0,1,1,"dummy"
"104667",0,0,1,1,"dummy"
"104668",0,0,1,1,"dummy"
"104669",0,0,1,1,"dummy"
"104670",0,0,1,1,"dummy"
"104671",0,0,1,1,"dummy"
"104672",0,0,1,1,"dummy"
"104673",0,0,1,1,"dummy"
"104675",2,2,0,4,"dummy"
"104679",0,4,0,4,"dummy"
"104680",1,0,0,1,"dummy"
"104681",0,10,0,10,"dummy"
"104682",0,0,5,5,"dummy"
"104683",0,0,0,0,"dummy"
"104684",0,2,0,2,"dummy"
"104685",2,1,0,3,"dummy"
"104697",0,2,0,2,"dummy"
"104698",1,0,0,1,"dummy"
"104699",5,2,1,8,"dummy"
"104700",2,1,0,3,"dummy"
"104701",1,0,0,1,"dummy"
"104702",0,3,0,3,"dummy"
"104708",0,3,0,3,"dummy"
"104709",0,0,2,2,"dummy"
"104710",0,1,0,1,"dummy"
"104711",0,0,0,0,"dummy"
"104712",0,0,1,1,"dummy"
"104713",22,20,9,51,"dummy"
"104714",0,2,0,2,"dummy"
"104715",2,0,0,2,"dummy"
"104716",1,0,0,1,"dummy"
"104720",0,0,0,0,"dummy"
"104721",0,0,0,0,"dummy"
"104722",0,0,0,0,"dummy"
"104723",0,0,0,0,"dummy"
"104725",1,0,0,1,"dummy"
"104726",0,0,1,1,"dummy"
"104727",2,0,0,2,"dummy"
"104729",0,1,0,1,"dummy"
"104730",0,1,0,1,"dummy"
"104731",0,1,0,1,"dummy"
"104747",2,2,0,4,"dummy"
"104748",2,0,0,2,"dummy"
"104763",2,0,2,4,"dummy"
"104791",7,23,2,32,"dummy"
"104793",0,0,1,1,"dummy"
"104797",0,0,0,0,"dummy"
"104798",0,1,0,1,"dummy"
"104799",0,1,0,1,"dummy"
"104800",1,1,0,2,"dummy"
"104801",0,1,0,1,"dummy"
"104802",1,1,1,3,"dummy"
"104803",0,0,0,0,"dummy"
"104804",4,0,0,4,"dummy"
"104805",0,0,1,1,"dummy"
"104806",3,8,0,11,"dummy"
"104807",0,1,0,1,"dummy"
"104808",0,6,0,6,"dummy"
"104809",1,1,0,2,"dummy"
"104810",2,0,0,2,"dummy"
"104811",0,0,0,0,"dummy"
"104813",0,0,1,1,"dummy"
"104814",0,2,0,2,"dummy"
"104815",0,1,0,1,"dummy"
"104816",0,1,0,1,"dummy"
"104817",0,0,5,5,"dummy"
"104824",0,0,2,2,"dummy"
"104825",0,0,1,1,"dummy"
"104826",1,27,2,30,"dummy"
"104827",6,11,0,17,"dummy"
"104828",0,1,0,1,"dummy"
"104829",0,3,0,3,"dummy"
"104830",7,25,0,32,"dummy"
"104831",3,6,0,9,"dummy"
"104832",28,5,1,34,"dummy"
"104833",1,1,0,2,"dummy"
"104834",0,1,0,1,"dummy"
"104835",0,0,1,1,"dummy"
"104836",1,1,0,2,"dummy"
"104837",0,0,1,1,"dummy"
"104838",1,4,1,6,"dummy"
"104840",1,2,2,5,"dummy"
"104841",0,0,1,1,"dummy"
"104842",0,0,1,1,"dummy"
"104844",3,0,0,3,"dummy"
"104846",0,1,0,1,"dummy"
"104847",1,0,0,1,"dummy"
"104850",1,0,0,1,"dummy"
"104865",1,3,0,4,"dummy"
"104867",1,0,0,1,"dummy"
"104870",0,4,0,4,"dummy"
"104871",0,0,1,1,"dummy"
"104872",0,2,0,2,"dummy"
"104873",0,0,0,0,"dummy"
"104874",0,0,0,0,"dummy"
"104875",0,0,1,1,"dummy"
"104876",0,0,0,0,"dummy"
"104877",0,2,0,2,"dummy"
"104878",0,0,1,1,"dummy"
"104879",0,0,1,1,"dummy"
"104880",0,0,1,1,"dummy"
"104881",0,0,0,0,"dummy"
"104882",0,0,0,0,"dummy"
"104883",0,0,0,0,"dummy"
"104884",0,0,0,0,"dummy"
"104885",0,0,0,0,"dummy"
"104886",0,0,1,1,"dummy"
"104887",0,0,1,1,"dummy"
"104888",0,0,1,1,"dummy"
"104889",0,0,0,0,"dummy"
"104890",1,14,0,15,"dummy"
"104891",0,0,0,0,"dummy"
"104892",0,0,1,1,"dummy"
"104893",13,1,0,14,"dummy"
"104894",0,0,1,1,"dummy"
"104895",0,0,1,1,"dummy"
"104896",0,0,1,1,"dummy"
"104897",0,0,0,0,"dummy"
"104898",0,0,0,0,"dummy"
"104899",0,0,0,0,"dummy"
"104900",0,0,1,1,"dummy"
"104901",0,0,0,0,"dummy"
"104902",0,0,0,0,"dummy"
"104903",0,0,0,0,"dummy"
"104904",0,0,0,0,"dummy"
"104905",0,0,0,0,"dummy"
"104906",2,0,0,2,"dummy"
"104907",0,2,0,2,"dummy"
"104908",0,0,0,0,"dummy"
"104909",7,8,1,16,"dummy"
"104910",0,0,1,1,"dummy"
"104911",0,1,0,1,"dummy"
"104912",0,1,0,1,"dummy"
"104913",0,0,1,1,"dummy"
"104919",3,1,3,7,"dummy"
"104920",1,7,0,8,"dummy"
"104921",0,4,2,6,"dummy"
"104922",0,4,1,5,"dummy"
"104923",1,1,0,2,"dummy"
"104924",2,1,0,3,"dummy"
"104925",0,3,0,3,"dummy"
"104926",0,0,0,0,"dummy"
"104927",0,2,1,3,"dummy"
"104928",0,1,0,1,"dummy"
"104929",0,1,0,1,"dummy"
"104931",0,2,1,3,"dummy"
"104932",0,1,0,1,"dummy"
"104933",0,1,0,1,"dummy"
"104934",0,2,0,2,"dummy"
"104935",2,0,1,3,"dummy"
"104936",0,1,0,1,"dummy"
"104937",2,2,0,4,"dummy"
"104938",2,2,0,4,"dummy"
"104939",1,1,2,4,"dummy"
"104940",0,2,0,2,"dummy"
"104941",0,0,3,3,"dummy"
"104942",4,10,1,15,"dummy"
"104943",0,0,2,2,"dummy"
"104954",1,0,0,1,"dummy"
"104955",0,0,2,2,"dummy"
"104956",4,5,0,9,"dummy"
"104957",2,3,2,7,"dummy"
"104958",1,2,0,3,"dummy"
"104959",0,0,0,0,"dummy"
"104960",0,0,0,0,"dummy"
"104961",0,0,0,0,"dummy"
"104962",0,0,2,2,"dummy"
"104963",0,0,1,1,"dummy"
"104964",3,0,0,3,"dummy"
"104965",0,0,2,2,"dummy"
"104966",5,5,0,10,"dummy"
"104971",0,1,0,1,"dummy"
"104972",1,0,1,2,"dummy"
"104974",0,2,0,2,"dummy"
"104975",18,2,3,23,"dummy"
"104976",2,15,3,20,"dummy"
"104977",1,1,0,2,"dummy"
"104981",0,0,1,1,"dummy"
"104982",0,0,1,1,"dummy"
"104983",0,3,0,3,"dummy"
"104987",0,0,1,1,"dummy"
"104988",0,1,0,1,"dummy"
"104991",0,0,1,1,"dummy"
"104993",0,0,0,0,"dummy"
"104994",0,0,0,0,"dummy"
"104998",1,0,0,1,"dummy"
"104999",2,0,1,3,"dummy"
"105000",0,0,0,0,"dummy"
"105001",0,1,0,1,"dummy"
"105002",8,1,0,9,"dummy"
"105003",0,0,0,0,"dummy"
"105004",0,0,0,0,"dummy"
"105005",1,10,0,11,"dummy"
"105006",7,1,0,8,"dummy"
"105007",2,0,3,5,"dummy"
"105009",0,0,1,1,"dummy"
"105010",0,0,3,3,"dummy"
"105011",0,0,3,3,"dummy"
"105012",0,0,4,4,"dummy"
"105013",2,3,1,6,"dummy"
"105022",0,3,0,3,"dummy"
"105023",0,2,0,2,"dummy"
"105024",0,1,1,2,"dummy"
"105056",0,0,1,1,"dummy"
"105057",0,0,1,1,"dummy"
"105058",0,1,0,1,"dummy"
"105059",1,10,3,14,"dummy"
"105060",1,1,0,2,"dummy"
"105061",3,6,5,14,"dummy"
"105062",3,3,4,10,"dummy"
"105063",0,0,1,1,"dummy"
"105070",13,0,0,13,"dummy"
"105071",0,0,1,1,"dummy"
"105101",0,0,1,1,"dummy"
"105102",0,0,1,1,"dummy"
"105103",1,1,0,2,"dummy"
"105104",0,0,2,2,"dummy"
"105105",0,0,1,1,"dummy"
"105106",0,1,0,1,"dummy"
"105107",0,2,0,2,"dummy"
"105108",7,1,3,11,"dummy"
"105124",2,8,1,11,"dummy"
"105125",0,1,0,1,"dummy"
"105126",7,3,0,10,"dummy"
"105127",2,5,0,7,"dummy"
"105130",0,1,0,1,"dummy"
"105131",0,0,0,0,"dummy"
"105135",1,5,0,6,"dummy"
"105136",0,2,0,2,"dummy"
"105137",1,9,1,11,"dummy"
"105146",1,0,0,1,"dummy"
"105147",1,2,0,3,"dummy"
"105148",0,1,0,1,"dummy"
"105149",8,7,0,15,"dummy"
"105150",0,1,0,1,"dummy"
"105151",1,2,0,3,"dummy"
"105152",0,1,0,1,"dummy"
"105153",0,1,0,1,"dummy"
"105154",0,1,0,1,"dummy"
"105155",1,1,1,3,"dummy"
"105202",0,0,1,1,"dummy"
"105203",0,0,1,1,"dummy"
"105204",0,0,1,1,"dummy"
"105205",0,0,1,1,"dummy"
"105246",7,2,1,10,"dummy"
"105247",0,1,0,1,"dummy"
"105248",0,5,1,6,"dummy"
"105249",2,0,0,2,"dummy"
"105250",0,4,0,4,"dummy"
"105251",0,2,0,2,"dummy"
"105252",1,0,0,1,"dummy"
"105253",0,0,1,1,"dummy"
"105254",4,0,0,4,"dummy"
"105255",1,2,2,5,"dummy"
"105256",0,0,0,0,"dummy"
"105257",9,10,2,21,"dummy"
"105258",0,1,3,4,"dummy"
"105263",0,0,0,0,"dummy"
"105264",0,0,0,0,"dummy"
"105265",0,1,0,1,"dummy"
"105279",1,1,0,2,"dummy"
"105015",0,3,3,6,"dummy"
"105016",0,17,1,18,"dummy"
"105026",1,5,1,7,"dummy"
"105027",0,0,0,0,"dummy"
"105028",0,0,0,0,"dummy"
"105029",0,0,0,0,"dummy"
"105030",0,0,0,0,"dummy"
"105035",15,0,1,16,"dummy"
"105038",8,14,1,23,"dummy"
"105041",0,0,1,1,"dummy"
"105042",0,0,1,1,"dummy"
"105043",0,0,1,1,"dummy"
"105044",2,1,0,3,"dummy"
"105045",0,0,1,1,"dummy"
"105048",0,2,0,2,"dummy"
"105049",2,0,0,2,"dummy"
"105050",0,4,0,4,"dummy"
"105051",3,0,0,3,"dummy"
"105052",0,0,1,1,"dummy"
"105065",3,5,0,8,"dummy"
"105068",0,0,1,1,"dummy"
"105073",1,0,2,3,"dummy"
"105074",1,1,0,2,"dummy"
"105075",2,3,1,6,"dummy"
"105099",0,4,0,4,"dummy"
"105110",5,3,1,9,"dummy"
"105111",3,5,0,8,"dummy"
"105112",5,3,0,8,"dummy"
"105119",0,0,0,0,"dummy"
"105120",0,0,1,1,"dummy"
"105121",0,1,0,1,"dummy"
"105122",1,2,0,3,"dummy"
"105133",5,2,7,14,"dummy"
"105141",0,0,0,0,"dummy"
"105144",0,0,2,2,"dummy"
"105175",0,1,0,1,"dummy"
"105176",0,0,1,1,"dummy"
"105177",4,7,4,15,"dummy"
"105178",6,4,4,14,"dummy"
"105179",4,6,4,14,"dummy"
"105180",6,8,4,18,"dummy"
"105181",0,1,1,2,"dummy"
"105184",4,4,1,9,"dummy"
"105185",6,0,2,8,"dummy"
"105260",0,1,0,1,"dummy"
"105261",0,0,1,1,"dummy"
"105267",2,6,1,9,"dummy"
"105268",0,1,0,1,"dummy"
"105271",0,1,0,1,"dummy"
"105272",0,0,1,1,"dummy"
"105273",0,0,0,0,"dummy"
"105274",0,0,1,1,"dummy"
"105275",1,0,0,1,"dummy"
"105283",0,0,0,0,"dummy"
"105286",0,0,1,1,"dummy"
"105287",2,1,0,3,"dummy"
"105288",1,2,0,3,"dummy"
"105289",0,0,1,1,"dummy"
"105319",1,1,1,3,"dummy"
"105341",4,2,0,6,"dummy"
"105342",4,4,2,10,"dummy"
"105343",0,2,0,2,"dummy"
"105344",0,1,0,1,"dummy"
"105347",2,3,0,5,"dummy"
"105353",0,1,0,1,"dummy"
"105354",0,1,0,1,"dummy"
"105355",0,0,1,1,"dummy"
"105356",0,1,0,1,"dummy"
"105357",0,1,0,1,"dummy"
"105321",1,1,0,2,"dummy"
"105322",0,1,1,2,"dummy"
"105323",0,6,0,6,"dummy"
"105324",0,0,0,0,"dummy"
"105325",0,1,0,1,"dummy"
"105326",0,1,0,1,"dummy"
"105327",0,0,0,0,"dummy"
"105328",1,0,0,1,"dummy"
"105329",0,1,0,1,"dummy"
"105330",3,3,8,14,"dummy"
"105331",1,0,0,1,"dummy"
"105332",0,0,1,1,"dummy"
"105333",0,2,7,9,"dummy"
"105336",0,1,0,1,"dummy"
"105337",3,3,1,7,"dummy"
"105338",2,2,3,7,"dummy"
"105339",4,20,4,28,"dummy"
"105349",0,0,0,0,"dummy"
"105381",0,0,0,0,"dummy"
"105382",0,0,1,1,"dummy"
"105383",0,0,0,0,"dummy"
"105398",0,0,1,1,"dummy"
"105399",0,0,1,1,"dummy"
"105400",0,1,1,2,"dummy"
"105401",0,0,1,1,"dummy"
"105402",0,1,0,1,"dummy"
"105438",0,2,0,2,"dummy"
"105439",0,0,1,1,"dummy"
"105440",10,4,2,16,"dummy"
"105441",8,20,8,36,"dummy"
"105442",1,1,0,2,"dummy"
"105452",3,11,1,15,"dummy"
"105453",0,0,1,1,"dummy"
"105464",1,4,1,6,"dummy"
"105465",0,0,0,0,"dummy"
"105466",0,0,0,0,"dummy"
"105467",0,0,0,0,"dummy"
"105468",0,0,0,0,"dummy"
"105469",0,3,1,4,"dummy"
"105470",0,0,0,0,"dummy"
"105471",0,0,0,0,"dummy"
"105472",0,0,0,0,"dummy"
"105473",0,0,1,1,"dummy"
"105474",3,1,0,4,"dummy"
"105475",0,0,0,0,"dummy"
"105476",0,0,0,0,"dummy"
"105477",0,0,0,0,"dummy"
"105478",0,0,0,0,"dummy"
"105482",10,2,1,13,"dummy"
"105483",0,2,1,3,"dummy"
"105484",0,1,0,1,"dummy"
"105487",0,0,1,1,"dummy"
"105488",2,0,2,4,"dummy"
"105489",2,0,2,4,"dummy"
"105492",0,0,0,0,"dummy"
"105493",0,2,0,2,"dummy"
"105538",0,0,2,2,"dummy"
"105543",0,0,1,1,"dummy"
"105544",0,1,0,1,"dummy"
"105545",0,0,1,1,"dummy"
"105548",2,1,3,6,"dummy"
"105549",2,3,1,6,"dummy"
"105550",0,0,0,0,"dummy"
"105551",0,0,3,3,"dummy"
"105552",17,6,2,25,"dummy"
"105553",0,0,1,1,"dummy"
"105581",0,0,2,2,"dummy"
"105358",0,1,1,2,"dummy"
"105359",0,8,0,8,"dummy"
"105360",7,9,0,16,"dummy"
"105361",1,3,0,4,"dummy"
"105362",0,5,0,5,"dummy"
"105363",2,2,0,4,"dummy"
"105364",5,1,1,7,"dummy"
"105365",0,0,0,0,"dummy"
"105366",0,0,0,0,"dummy"
"105367",0,0,1,1,"dummy"
"105368",0,0,1,1,"dummy"
"105369",0,1,0,1,"dummy"
"105370",3,8,2,13,"dummy"
"105371",0,2,1,3,"dummy"
"105372",0,0,1,1,"dummy"
"105373",4,0,0,4,"dummy"
"105374",0,1,1,2,"dummy"
"105377",0,0,0,0,"dummy"
"105385",0,2,0,2,"dummy"
"105386",0,1,0,1,"dummy"
"105389",0,0,0,0,"dummy"
"105390",0,0,3,3,"dummy"
"105391",0,0,3,3,"dummy"
"105392",0,0,5,5,"dummy"
"105393",0,0,3,3,"dummy"
"105396",3,3,2,8,"dummy"
"105436",15,10,0,25,"dummy"
"105448",0,1,0,1,"dummy"
"105480",0,5,0,5,"dummy"
"105536",0,6,2,8,"dummy"
"105555",0,1,0,1,"dummy"
"105556",1,1,0,2,"dummy"
"105557",0,0,0,0,"dummy"
"105558",1,0,0,1,"dummy"
"105559",0,4,0,4,"dummy"
"105560",0,0,1,1,"dummy"
"105561",4,0,0,4,"dummy"
"105562",0,2,0,2,"dummy"
"105563",2,2,1,5,"dummy"
"105564",6,1,0,7,"dummy"
"105567",2,7,0,9,"dummy"
"105568",0,0,1,1,"dummy"
"105569",2,1,0,3,"dummy"
"105570",0,0,1,1,"dummy"
"105571",1,5,4,10,"dummy"
"105572",2,2,0,4,"dummy"
"105573",0,0,1,1,"dummy"
"105574",0,0,1,1,"dummy"
"105575",0,0,0,0,"dummy"
"105576",0,1,0,1,"dummy"
"105577",0,0,0,0,"dummy"
"105578",1,1,0,2,"dummy"
"105579",0,0,0,0,"dummy"
"105586",0,0,1,1,"dummy"
"105597",0,3,2,5,"dummy"
"105598",0,2,0,2,"dummy"
"105601",0,4,0,4,"dummy"
"105602",4,2,0,6,"dummy"
"105603",3,4,7,14,"dummy"
"105604",18,0,0,18,"dummy"
"105605",0,1,0,1,"dummy"
"105614",0,1,0,1,"dummy"
"105615",0,1,0,1,"dummy"
"105616",0,0,0,0,"dummy"
"105619",0,4,0,4,"dummy"
"105620",3,0,0,3,"dummy"
"105621",0,4,0,4,"dummy"
"105622",4,0,0,4,"dummy"
"105582",0,0,2,2,"dummy"
"105588",0,1,1,2,"dummy"
"105589",1,0,1,2,"dummy"
"105590",0,0,1,1,"dummy"
"105591",0,1,0,1,"dummy"
"105592",12,1,1,14,"dummy"
"105593",0,0,1,1,"dummy"
"105594",0,0,1,1,"dummy"
"105595",0,0,1,1,"dummy"
"105609",0,3,0,3,"dummy"
"105610",1,0,0,1,"dummy"
"105625",0,11,0,11,"dummy"
"105637",1,0,0,1,"dummy"
"105638",2,2,0,4,"dummy"
"105623",0,0,1,1,"dummy"
"105627",0,0,1,1,"dummy"
"105630",0,0,1,1,"dummy"
"105633",2,8,2,12,"dummy"
"105634",2,2,1,5,"dummy"
"105635",0,0,1,1,"dummy"
"105670",0,2,0,2,"dummy"
"105672",7,6,0,13,"dummy"
"105673",0,2,0,2,"dummy"
"105767",0,0,1,1,"dummy"
"105678",0,0,2,2,"dummy"
"105681",0,1,0,1,"dummy"
"105682",0,2,0,2,"dummy"
"105683",0,0,2,2,"dummy"
"105684",5,0,0,5,"dummy"
"105686",0,0,1,1,"dummy"
"105689",0,0,0,0,"dummy"
"105691",12,6,2,20,"dummy"
"105692",0,1,0,1,"dummy"
"105694",0,0,1,1,"dummy"
"105695",0,0,2,2,"dummy"
"105712",0,0,1,1,"dummy"
"105715",0,9,1,10,"dummy"
"105719",0,0,1,1,"dummy"
"105725",1,3,1,5,"dummy"
"105726",0,0,1,1,"dummy"
"105727",3,1,1,5,"dummy"
"105735",11,3,4,18,"dummy"
"105736",5,12,4,21,"dummy"
"105737",9,3,4,16,"dummy"
"105738",0,2,0,2,"dummy"
"105739",0,1,0,1,"dummy"
"105740",1,2,1,4,"dummy"
"105742",0,0,0,0,"dummy"
"105743",0,0,0,0,"dummy"
"105744",0,0,0,0,"dummy"
"105745",0,0,0,0,"dummy"
"105746",0,0,0,0,"dummy"
"105747",2,3,0,5,"dummy"
"105748",3,2,7,12,"dummy"
"105749",0,2,0,2,"dummy"
"105750",2,0,0,2,"dummy"
"105751",0,0,1,1,"dummy"
"105752",0,1,0,1,"dummy"
"105753",0,0,1,1,"dummy"
"105754",0,6,0,6,"dummy"
"105755",0,20,0,20,"dummy"
"105756",0,2,0,2,"dummy"
"105757",23,0,2,25,"dummy"
"105758",0,0,0,0,"dummy"
"105760",0,0,1,1,"dummy"
"105761",7,2,1,10,"dummy"
"105762",1,2,0,3,"dummy"
"105763",4,8,1,13,"dummy"
"105764",12,0,0,12,"dummy"
"105768",0,1,0,1,"dummy"
"105770",0,2,0,2,"dummy"
"105776",4,0,0,4,"dummy"
"105781",0,2,0,2,"dummy"
"105783",1,1,1,3,"dummy"
"105784",0,1,0,1,"dummy"
"105786",0,0,0,0,"dummy"
"105787",0,0,0,0,"dummy"
"105788",0,0,0,0,"dummy"
"105789",0,0,1,1,"dummy"
"105790",0,4,1,5,"dummy"
"105792",2,1,0,3,"dummy"
"105793",0,3,0,3,"dummy"
"105794",0,1,0,1,"dummy"
"105795",2,3,0,5,"dummy"
"105808",0,0,0,0,"dummy"
"105809",0,0,0,0,"dummy"
"105810",0,0,0,0,"dummy"
"105811",0,0,0,0,"dummy"
"105812",0,0,0,0,"dummy"
"105813",0,0,0,0,"dummy"
"105814",0,0,0,0,"dummy"
"105815",0,4,0,4,"dummy"
"105816",0,0,0,0,"dummy"
"105817",0,1,0,1,"dummy"
"105821",0,1,0,1,"dummy"
"105822",3,0,1,4,"dummy"
"105824",2,5,0,7,"dummy"
"105825",3,4,0,7,"dummy"
"105826",0,4,0,4,"dummy"
"105827",2,3,0,5,"dummy"
"105828",5,0,0,5,"dummy"
"105829",0,15,0,15,"dummy"
"105830",0,0,1,1,"dummy"
"105831",1,0,0,1,"dummy"
"105832",0,0,1,1,"dummy"
"105833",0,5,1,6,"dummy"
"105834",0,0,1,1,"dummy"
"105835",0,2,0,2,"dummy"
"105836",2,18,1,21,"dummy"
"105837",0,0,1,1,"dummy"
"105838",0,0,5,5,"dummy"
"105839",4,5,5,14,"dummy"
"105840",0,0,5,5,"dummy"
"105841",2,1,0,3,"dummy"
"105842",15,2,1,18,"dummy"
"105843",2,1,0,3,"dummy"
"105844",0,0,2,2,"dummy"
"105845",0,0,1,1,"dummy"
"105846",1,0,0,1,"dummy"
"105847",0,0,3,3,"dummy"
"105848",4,3,0,7,"dummy"
"105849",0,1,0,1,"dummy"
"105850",0,1,1,2,"dummy"
"105851",5,5,0,10,"dummy"
"105854",0,0,1,1,"dummy"
"105857",0,0,1,1,"dummy"
"105859",0,1,0,1,"dummy"
"105864",6,0,0,6,"dummy"
"105865",2,5,2,9,"dummy"
"105868",2,3,0,5,"dummy"
"105869",1,0,0,1,"dummy"
"105870",1,0,0,1,"dummy"
"105874",0,0,0,0,"dummy"
"105875",0,0,0,0,"dummy"
"105877",0,16,0,16,"dummy"
"105878",16,0,0,16,"dummy"
"105879",0,16,0,16,"dummy"
"105880",0,2,0,2,"dummy"
"105882",2,0,1,3,"dummy"
"105884",2,6,1,9,"dummy"
"105885",1,5,2,8,"dummy"
"105887",0,0,1,1,"dummy"
"105896",1,0,0,1,"dummy"
"105897",0,1,1,2,"dummy"
"105898",1,0,0,1,"dummy"
"105899",0,0,1,1,"dummy"
"105900",0,0,2,2,"dummy"
"105901",0,0,1,1,"dummy"
"105902",0,0,0,0,"dummy"
"105903",2,0,0,2,"dummy"
"105904",0,0,1,1,"dummy"
"105905",0,2,0,2,"dummy"
"105906",0,0,1,1,"dummy"
"105907",0,1,0,1,"dummy"
"105908",0,0,1,1,"dummy"
"105909",0,0,1,1,"dummy"
"105910",0,1,0,1,"dummy"
"105911",0,2,0,2,"dummy"
"105912",3,2,0,5,"dummy"
"105913",0,2,0,2,"dummy"
"105914",0,1,0,1,"dummy"
"105915",0,0,0,0,"dummy"
"105916",0,0,0,0,"dummy"
"105917",0,6,0,6,"dummy"
"105918",4,2,0,6,"dummy"
"105919",2,0,0,2,"dummy"
"105920",0,0,0,0,"dummy"
"105921",0,0,0,0,"dummy"
"105922",0,3,0,3,"dummy"
"105923",0,0,0,0,"dummy"
"105924",3,0,0,3,"dummy"
"105925",2,0,0,2,"dummy"
"105926",1,0,0,1,"dummy"
"105929",0,2,0,2,"dummy"
"105930",0,3,0,3,"dummy"
"105932",0,0,2,2,"dummy"
"105933",0,0,1,1,"dummy"
"105934",0,0,1,1,"dummy"
"105935",0,0,1,1,"dummy"
"105936",5,1,1,7,"dummy"
"105937",0,0,1,1,"dummy"
"105938",2,8,1,11,"dummy"
"105939",0,0,1,1,"dummy"
"105940",0,0,2,2,"dummy"
"105941",3,2,1,6,"dummy"
"105942",0,0,1,1,"dummy"
"105943",0,0,2,2,"dummy"
"105944",0,0,2,2,"dummy"
"105945",0,0,1,1,"dummy"
"105946",0,0,2,2,"dummy"
"105948",0,0,3,3,"dummy"
"105950",2,1,1,4,"dummy"
"105951",0,0,1,1,"dummy"
"105955",0,7,0,7,"dummy"
"105956",3,2,0,5,"dummy"
"105957",1,0,0,1,"dummy"
"105958",0,1,0,1,"dummy"
"105959",2,0,0,2,"dummy"
"105960",4,0,0,4,"dummy"
"105961",3,1,0,4,"dummy"
"105964",0,0,1,1,"dummy"
"105965",0,0,0,0,"dummy"
"105966",2,2,0,4,"dummy"
"105967",2,2,0,4,"dummy"
"105968",2,1,1,4,"dummy"
"105969",2,2,0,4,"dummy"
"105970",0,0,0,0,"dummy"
"105971",2,2,0,4,"dummy"
"105972",2,2,0,4,"dummy"
"105973",1,0,2,3,"dummy"
"105974",0,0,0,0,"dummy"
"105975",0,3,0,3,"dummy"
"105980",2,15,1,18,"dummy"
"105981",4,4,1,9,"dummy"
"105982",0,1,0,1,"dummy"
"105983",0,0,2,2,"dummy"
"105984",2,0,2,4,"dummy"
"105985",0,0,1,1,"dummy"
"105986",0,0,1,1,"dummy"
"105988",0,0,0,0,"dummy"
"105996",10,0,2,12,"dummy"
"105998",0,0,1,1,"dummy"
"105999",0,0,1,1,"dummy"
"106000",0,0,1,1,"dummy"
"106001",0,4,0,4,"dummy"
"106002",3,5,0,8,"dummy"
"106003",0,2,0,2,"dummy"
"106004",0,1,0,1,"dummy"
"106007",0,0,0,0,"dummy"
"106008",0,1,0,1,"dummy"
"106009",1,0,0,1,"dummy"
"106010",1,0,0,1,"dummy"
"106011",0,1,1,2,"dummy"
"106013",1,1,0,2,"dummy"
"106014",0,1,0,1,"dummy"
"106017",0,1,1,2,"dummy"
"106018",0,0,1,1,"dummy"
"106019",0,0,1,1,"dummy"
"106022",0,1,1,2,"dummy"
"106024",0,16,0,16,"dummy"
"106025",1,3,0,4,"dummy"
"106051",2,0,0,2,"dummy"
"106052",2,2,0,4,"dummy"
"106053",0,2,0,2,"dummy"
"106056",0,5,1,6,"dummy"
"106057",0,1,0,1,"dummy"
"106072",0,6,0,6,"dummy"
"106073",0,2,0,2,"dummy"
"106087",0,0,0,0,"dummy"
"106105",0,5,0,5,"dummy"
"106106",1,2,0,3,"dummy"
"106107",5,9,4,18,"dummy"
"106108",2,2,5,9,"dummy"
"106109",2,4,9,15,"dummy"
"106110",0,0,1,1,"dummy"
"106111",0,5,0,5,"dummy"
"106114",0,0,3,3,"dummy"
"106115",1,1,1,3,"dummy"
"106116",0,0,1,1,"dummy"
"106117",12,3,2,17,"dummy"
"106118",0,0,1,1,"dummy"
"106119",0,1,0,1,"dummy"
"106120",0,0,1,1,"dummy"
"106125",2,3,4,9,"dummy"
"106146",0,2,0,2,"dummy"
"106147",4,0,0,4,"dummy"
"106148",6,0,2,8,"dummy"
"106149",0,1,0,1,"dummy"
"106150",2,3,1,6,"dummy"
"106151",1,5,0,6,"dummy"
"106162",7,7,1,15,"dummy"
"106163",0,2,1,3,"dummy"
"106164",36,20,0,56,"dummy"
"106165",0,2,0,2,"dummy"
"106178",2,2,1,5,"dummy"
"106179",0,2,0,2,"dummy"
"106187",0,1,0,1,"dummy"
"106188",0,0,0,0,"dummy"
"106195",2,0,1,3,"dummy"
"106196",0,1,1,2,"dummy"
"106197",0,0,1,1,"dummy"
"106198",0,0,0,0,"dummy"
"106199",0,0,0,0,"dummy"
"106200",0,0,0,0,"dummy"
"106251",0,0,1,1,"dummy"
"106252",0,0,2,2,"dummy"
"106253",0,5,0,5,"dummy"
"106274",0,0,0,0,"dummy"
"106275",0,0,0,0,"dummy"
"106289",0,0,1,1,"dummy"
"106294",2,2,4,8,"dummy"
"106297",0,0,0,0,"dummy"
"106298",4,6,3,13,"dummy"
"106307",0,0,2,2,"dummy"
"106061",1,1,0,2,"dummy"
"106062",1,4,4,9,"dummy"
"106063",0,0,1,1,"dummy"
"106064",1,5,0,6,"dummy"
"106065",0,1,0,1,"dummy"
"106066",3,5,0,8,"dummy"
"106067",8,10,3,21,"dummy"
"106068",4,2,1,7,"dummy"
"106094",0,0,3,3,"dummy"
"106103",0,1,0,1,"dummy"
"106127",0,0,1,1,"dummy"
"106128",0,2,0,2,"dummy"
"106129",0,2,0,2,"dummy"
"106130",2,0,0,2,"dummy"
"106138",0,0,1,1,"dummy"
"106139",0,0,0,0,"dummy"
"106142",0,0,1,1,"dummy"
"106143",1,3,1,5,"dummy"
"106144",0,1,0,1,"dummy"
"106153",0,10,1,11,"dummy"
"106160",0,1,0,1,"dummy"
"106169",0,0,1,1,"dummy"
"106170",0,0,1,1,"dummy"
"106171",0,0,2,2,"dummy"
"106172",26,3,7,36,"dummy"
"106202",2,2,0,4,"dummy"
"106203",0,2,0,2,"dummy"
"106204",0,1,0,1,"dummy"
"106205",0,2,0,2,"dummy"
"106206",0,3,0,3,"dummy"
"106207",2,3,0,5,"dummy"
"106208",0,7,0,7,"dummy"
"106209",0,1,0,1,"dummy"
"106210",0,0,0,0,"dummy"
"106211",0,0,2,2,"dummy"
"106212",8,2,0,10,"dummy"
"106213",2,0,0,2,"dummy"
"106214",0,0,0,0,"dummy"
"106215",0,0,0,0,"dummy"
"106216",0,0,0,0,"dummy"
"106217",6,0,0,6,"dummy"
"106218",0,0,0,0,"dummy"
"106234",0,0,0,0,"dummy"
"106235",0,0,0,0,"dummy"
"106236",0,0,1,1,"dummy"
"106237",0,0,1,1,"dummy"
"106238",1,0,0,1,"dummy"
"106246",0,1,0,1,"dummy"
"106247",3,1,0,4,"dummy"
"106248",0,3,0,3,"dummy"
"106249",0,0,2,2,"dummy"
"106277",0,2,0,2,"dummy"
"106278",0,1,0,1,"dummy"
"106279",0,0,1,1,"dummy"
"106287",1,0,0,1,"dummy"
"106300",1,1,1,3,"dummy"
"106301",23,0,3,26,"dummy"
"106302",3,3,0,6,"dummy"
"106303",0,1,0,1,"dummy"
"106304",0,3,0,3,"dummy"
"106305",0,1,0,1,"dummy"
"106309",0,1,0,1,"dummy"
"106310",1,1,0,2,"dummy"
"106311",0,1,0,1,"dummy"
"106312",0,1,0,1,"dummy"
"106317",0,0,1,1,"dummy"
"106318",0,0,1,1,"dummy"
"106328",2,1,0,3,"dummy"
"106338",19,2,0,21,"dummy"
"106339",0,0,2,2,"dummy"
"106340",0,4,0,4,"dummy"
"106341",0,2,0,2,"dummy"
"106342",0,9,0,9,"dummy"
"106343",0,2,4,6,"dummy"
"106344",0,0,0,0,"dummy"
"106345",5,9,1,15,"dummy"
"106346",0,2,0,2,"dummy"
"106347",0,2,0,2,"dummy"
"106352",1,0,0,1,"dummy"
"106353",0,1,0,1,"dummy"
"106354",0,2,2,4,"dummy"
"106355",4,0,4,8,"dummy"
"106356",0,0,2,2,"dummy"
"106357",0,0,1,1,"dummy"
"106358",1,4,4,9,"dummy"
"106359",0,0,3,3,"dummy"
"106360",0,0,0,0,"dummy"
"106361",0,0,3,3,"dummy"
"106371",1,1,0,2,"dummy"
"106372",0,0,1,1,"dummy"
"106373",0,0,2,2,"dummy"
"106374",0,0,1,1,"dummy"
"106375",0,0,1,1,"dummy"
"106376",0,0,1,1,"dummy"
"106377",0,0,1,1,"dummy"
"106378",0,0,1,1,"dummy"
"106379",0,0,1,1,"dummy"
"106380",0,0,1,1,"dummy"
"106381",0,3,2,5,"dummy"
"106382",2,1,0,3,"dummy"
"106400",8,4,0,12,"dummy"
"106403",0,0,1,1,"dummy"
"106404",0,1,2,3,"dummy"
"106413",0,1,0,1,"dummy"
"106414",1,0,1,2,"dummy"
"106415",3,4,2,9,"dummy"
"106419",1,2,1,4,"dummy"
"106420",1,2,0,3,"dummy"
"106421",3,0,0,3,"dummy"
"106422",1,1,0,2,"dummy"
"106423",0,0,1,1,"dummy"
"106431",1,4,1,6,"dummy"
"106432",0,0,0,0,"dummy"
"106448",0,0,1,1,"dummy"
"106449",0,15,1,16,"dummy"
"106450",0,0,2,2,"dummy"
"106453",0,2,1,3,"dummy"
"106454",0,1,1,2,"dummy"
"106455",0,1,1,2,"dummy"
"106456",0,0,0,0,"dummy"
"106457",2,2,0,4,"dummy"
"106458",3,2,7,12,"dummy"
"106459",1,2,10,13,"dummy"
"106460",0,0,5,5,"dummy"
"106479",1,0,1,2,"dummy"
"106480",2,0,1,3,"dummy"
"106481",6,10,0,16,"dummy"
"106482",0,2,1,3,"dummy"
"106483",0,1,0,1,"dummy"
"106484",1,2,0,3,"dummy"
"106485",8,12,1,21,"dummy"
"106486",0,0,1,1,"dummy"
"106487",5,2,1,8,"dummy"
"106488",2,1,0,3,"dummy"
"106489",0,1,0,1,"dummy"
"106330",0,1,0,1,"dummy"
"106331",2,2,1,5,"dummy"
"106332",6,3,0,9,"dummy"
"106333",0,2,1,3,"dummy"
"106334",1,1,0,2,"dummy"
"106335",0,1,0,1,"dummy"
"106336",0,0,1,1,"dummy"
"106367",1,1,0,2,"dummy"
"106368",0,2,0,2,"dummy"
"106369",0,2,0,2,"dummy"
"106388",0,0,0,0,"dummy"
"106389",0,0,1,1,"dummy"
"106390",0,1,1,2,"dummy"
"106391",13,3,4,20,"dummy"
"106392",0,0,0,0,"dummy"
"106393",0,0,0,0,"dummy"
"106394",0,0,0,0,"dummy"
"106395",0,0,0,0,"dummy"
"106396",0,0,0,0,"dummy"
"106397",0,0,0,0,"dummy"
"106398",0,0,0,0,"dummy"
"106406",0,0,1,1,"dummy"
"106407",0,0,1,1,"dummy"
"106408",0,0,1,1,"dummy"
"106409",0,0,1,1,"dummy"
"106410",0,0,1,1,"dummy"
"106411",0,0,1,1,"dummy"
"106417",0,0,2,2,"dummy"
"106429",0,0,1,1,"dummy"
"106436",1,21,0,22,"dummy"
"106437",0,3,1,4,"dummy"
"106438",0,1,0,1,"dummy"
"106439",0,1,0,1,"dummy"
"106440",0,2,0,2,"dummy"
"106441",6,8,0,14,"dummy"
"106442",8,0,0,8,"dummy"
"106443",0,7,0,7,"dummy"
"106444",17,5,0,22,"dummy"
"106445",0,0,0,0,"dummy"
"106446",2,4,2,8,"dummy"
"106462",1,0,0,1,"dummy"
"106463",0,1,0,1,"dummy"
"106464",0,2,0,2,"dummy"
"106465",0,0,1,1,"dummy"
"106466",0,0,0,0,"dummy"
"106467",7,7,0,14,"dummy"
"106468",0,0,1,1,"dummy"
"106471",0,0,0,0,"dummy"
"106472",0,5,0,5,"dummy"
"106473",1,1,0,2,"dummy"
"106474",7,3,0,10,"dummy"
"106475",0,0,1,1,"dummy"
"106476",2,2,1,5,"dummy"
"106477",4,4,0,8,"dummy"
"106491",0,0,0,0,"dummy"
"106494",8,9,1,18,"dummy"
"106499",0,0,2,2,"dummy"
"106502",0,0,1,1,"dummy"
"106503",0,0,1,1,"dummy"
"106504",0,1,0,1,"dummy"
"106520",0,2,0,2,"dummy"
"106533",4,0,1,5,"dummy"
"106534",0,1,0,1,"dummy"
"106538",0,4,0,4,"dummy"
"106553",0,1,0,1,"dummy"
"106554",3,0,1,4,"dummy"
"106555",0,1,0,1,"dummy"
"106556",1,0,0,1,"dummy"
"106561",0,0,0,0,"dummy"
"106562",0,1,0,1,"dummy"
"106563",1,0,0,1,"dummy"
"106564",0,1,0,1,"dummy"
"106565",1,0,0,1,"dummy"
"106566",0,0,0,0,"dummy"
"106567",0,0,1,1,"dummy"
"106568",0,0,0,0,"dummy"
"106569",0,0,1,1,"dummy"
"106506",0,1,0,1,"dummy"
"106507",3,2,0,5,"dummy"
"106508",2,0,0,2,"dummy"
"106509",0,2,0,2,"dummy"
"106510",0,2,0,2,"dummy"
"106511",0,3,0,3,"dummy"
"106512",0,0,0,0,"dummy"
"106513",0,0,1,1,"dummy"
"106514",1,0,1,2,"dummy"
"106515",0,1,0,1,"dummy"
"106518",0,0,1,1,"dummy"
"106522",0,0,2,2,"dummy"
"106523",3,6,7,16,"dummy"
"106524",2,2,1,5,"dummy"
"106527",0,2,0,2,"dummy"
"106528",0,1,0,1,"dummy"
"106529",0,1,0,1,"dummy"
"106530",0,5,1,6,"dummy"
"106531",0,3,1,4,"dummy"
"106536",0,3,0,3,"dummy"
"106540",0,6,0,6,"dummy"
"106541",0,1,0,1,"dummy"
"106544",0,1,0,1,"dummy"
"106547",0,1,0,1,"dummy"
"106548",6,6,0,12,"dummy"
"106549",0,0,1,1,"dummy"
"106550",0,1,2,3,"dummy"
"106551",0,0,0,0,"dummy"
"106558",0,1,0,1,"dummy"
"106559",0,1,0,1,"dummy"
"106576",1,2,1,4,"dummy"
"106577",2,3,2,7,"dummy"
"106578",1,0,0,1,"dummy"
"106585",0,1,0,1,"dummy"
"106592",0,0,0,0,"dummy"
"106593",2,3,0,5,"dummy"
"106594",0,0,1,1,"dummy"
"106595",1,0,2,3,"dummy"
"106596",0,0,1,1,"dummy"
"106597",0,0,1,1,"dummy"
"106598",0,1,0,1,"dummy"
"106599",2,1,0,3,"dummy"
"106600",0,1,0,1,"dummy"
"106614",0,0,2,2,"dummy"
"106615",0,5,0,5,"dummy"
"106616",0,0,0,0,"dummy"
"106617",4,4,0,8,"dummy"
"106618",0,1,0,1,"dummy"
"106619",0,1,1,2,"dummy"
"106620",3,3,3,9,"dummy"
"106621",0,3,0,3,"dummy"
"106622",4,4,0,8,"dummy"
"106623",0,3,0,3,"dummy"
"106624",0,0,5,5,"dummy"
"106625",0,1,1,2,"dummy"
"106626",0,0,2,2,"dummy"
"106627",0,1,1,2,"dummy"
"106628",0,5,0,5,"dummy"
"106629",1,0,0,1,"dummy"
"106630",2,3,1,6,"dummy"
"106631",2,4,0,6,"dummy"
"106632",1,9,0,10,"dummy"
"106633",0,1,1,2,"dummy"
"106634",1,3,0,4,"dummy"
"106635",2,1,1,4,"dummy"
"106636",7,3,2,12,"dummy"
"106637",1,1,1,3,"dummy"
"106638",1,1,0,2,"dummy"
"106639",2,3,0,5,"dummy"
"106640",1,1,0,2,"dummy"
"106641",5,8,0,13,"dummy"
"106642",0,1,0,1,"dummy"
"106643",0,0,1,1,"dummy"
"106644",6,6,2,14,"dummy"
"106645",1,2,1,4,"dummy"
"106646",1,1,0,2,"dummy"
"106647",1,0,0,1,"dummy"
"106648",0,0,1,1,"dummy"
"106649",3,19,6,28,"dummy"
"106650",4,5,1,10,"dummy"
"106651",1,1,0,2,"dummy"
"106652",0,2,0,2,"dummy"
"106653",0,13,4,17,"dummy"
"106667",0,0,1,1,"dummy"
"106729",0,1,0,1,"dummy"
"106730",0,4,0,4,"dummy"
"106731",4,0,0,4,"dummy"
"106570",0,0,1,1,"dummy"
"106573",1,2,0,3,"dummy"
"106574",0,5,0,5,"dummy"
"106580",0,0,1,1,"dummy"
"106581",0,0,1,1,"dummy"
"106582",0,0,1,1,"dummy"
"106583",0,0,1,1,"dummy"
"106602",0,0,1,1,"dummy"
"106603",0,0,1,1,"dummy"
"106604",0,0,1,1,"dummy"
"106605",0,0,1,1,"dummy"
"106606",0,0,1,1,"dummy"
"106609",0,7,0,7,"dummy"
"106612",0,0,0,0,"dummy"
"106659",0,1,1,2,"dummy"
"106660",0,1,0,1,"dummy"
"106669",0,0,1,1,"dummy"
"106670",0,0,1,1,"dummy"
"106671",0,0,1,1,"dummy"
"106672",0,0,1,1,"dummy"
"106673",0,0,1,1,"dummy"
"106674",0,0,1,1,"dummy"
"106675",0,0,1,1,"dummy"
"106676",0,0,1,1,"dummy"
"106677",0,0,1,1,"dummy"
"106678",0,0,1,1,"dummy"
"106679",0,0,1,1,"dummy"
"106680",0,0,1,1,"dummy"
"106681",0,0,1,1,"dummy"
"106682",0,0,1,1,"dummy"
"106683",0,0,1,1,"dummy"
"106684",0,0,1,1,"dummy"
"106685",0,0,1,1,"dummy"
"106686",0,0,1,1,"dummy"
"106687",0,0,1,1,"dummy"
"106688",0,0,1,1,"dummy"
"106689",0,0,1,1,"dummy"
"106690",0,0,1,1,"dummy"
"106691",0,0,1,1,"dummy"
"106692",0,0,1,1,"dummy"
"106693",0,0,1,1,"dummy"
"106694",0,0,1,1,"dummy"
"106695",0,0,1,1,"dummy"
"106696",0,0,1,1,"dummy"
"106697",0,0,1,1,"dummy"
"106698",0,0,1,1,"dummy"
"106699",0,0,1,1,"dummy"
"106700",0,0,1,1,"dummy"
"106701",0,0,1,1,"dummy"
"106702",0,0,1,1,"dummy"
"106703",0,0,1,1,"dummy"
"106704",0,0,1,1,"dummy"
"106705",0,0,1,1,"dummy"
"106706",0,0,1,1,"dummy"
"106707",0,0,1,1,"dummy"
"106708",0,0,1,1,"dummy"
"106709",0,0,1,1,"dummy"
"106710",0,0,1,1,"dummy"
"106711",0,0,1,1,"dummy"
"106712",0,0,1,1,"dummy"
"106713",0,0,1,1,"dummy"
"106714",0,0,1,1,"dummy"
"106715",0,0,1,1,"dummy"
"106716",0,0,1,1,"dummy"
"106717",0,0,1,1,"dummy"
"106718",0,0,1,1,"dummy"
"106719",0,0,1,1,"dummy"
"106720",0,0,1,1,"dummy"
"106721",0,0,1,1,"dummy"
"106722",0,0,1,1,"dummy"
"106723",0,0,1,1,"dummy"
"106724",0,0,1,1,"dummy"
"106725",0,1,1,2,"dummy"
"106726",0,0,1,1,"dummy"
"106727",0,0,1,1,"dummy"
"106740",0,1,0,1,"dummy"
"106741",2,9,3,14,"dummy"
"106742",5,10,2,17,"dummy"
"106745",0,12,0,12,"dummy"
"106746",0,0,1,1,"dummy"
"106762",1,0,0,1,"dummy"
"106732",0,4,0,4,"dummy"
"106733",0,0,1,1,"dummy"
"106734",0,1,0,1,"dummy"
"106735",0,1,3,4,"dummy"
"106736",1,0,0,1,"dummy"
"106737",0,1,0,1,"dummy"
"106738",0,1,6,7,"dummy"
"106748",0,0,1,1,"dummy"
"106749",4,15,1,20,"dummy"
"106750",3,0,0,3,"dummy"
"106751",0,3,0,3,"dummy"
"106752",0,1,0,1,"dummy"
"106753",1,1,0,2,"dummy"
"106754",0,7,1,8,"dummy"
"106755",1,1,1,3,"dummy"
"106760",0,0,0,0,"dummy"
"106766",0,1,0,1,"dummy"
"106767",0,0,1,1,"dummy"
"106769",2,2,0,4,"dummy"
"106775",0,1,0,1,"dummy"
"106776",0,1,0,1,"dummy"
"106777",0,3,0,3,"dummy"
"106778",0,1,0,1,"dummy"
"106793",1,0,1,2,"dummy"
"106794",0,0,1,1,"dummy"
"106795",1,5,2,8,"dummy"
"106796",0,0,2,2,"dummy"
"106797",1,0,1,2,"dummy"
"106798",1,1,0,2,"dummy"
"106799",1,2,0,3,"dummy"
"106800",0,0,1,1,"dummy"
"106801",1,0,0,1,"dummy"
"106802",0,2,0,2,"dummy"
"106803",0,1,0,1,"dummy"
"106804",2,2,0,4,"dummy"
"106805",0,0,1,1,"dummy"
"106806",0,1,0,1,"dummy"
"106807",1,5,0,6,"dummy"
"106808",6,1,0,7,"dummy"
"106810",0,0,1,1,"dummy"
"106811",0,0,1,1,"dummy"
"106812",0,0,1,1,"dummy"
"106814",0,3,0,3,"dummy"
"106815",0,0,1,1,"dummy"
"106816",0,0,1,1,"dummy"
"106817",0,0,1,1,"dummy"
"106818",0,0,1,1,"dummy"
"106819",0,0,1,1,"dummy"
"106820",0,0,1,1,"dummy"
"106821",0,0,1,1,"dummy"
"106822",0,0,1,1,"dummy"
"106823",0,0,2,2,"dummy"
"106824",1,1,1,3,"dummy"
"106825",2,2,0,4,"dummy"
"106826",1,1,1,3,"dummy"
"106827",0,4,0,4,"dummy"
"106828",2,6,0,8,"dummy"
"106829",0,0,2,2,"dummy"
"106830",0,0,1,1,"dummy"
"106831",0,0,1,1,"dummy"
"106836",2,0,3,5,"dummy"
"106848",0,1,1,2,"dummy"
"106849",0,1,0,1,"dummy"
"106850",0,0,1,1,"dummy"
"106867",6,13,0,19,"dummy"
"106868",1,1,2,4,"dummy"
"106869",1,15,0,16,"dummy"
"106870",0,1,0,1,"dummy"
"106871",1,0,0,1,"dummy"
"106872",0,12,0,12,"dummy"
"106873",2,1,0,3,"dummy"
"106874",5,0,0,5,"dummy"
"106875",0,1,0,1,"dummy"
"106880",0,0,0,0,"dummy"
"106881",0,0,1,1,"dummy"
"106884",0,1,1,2,"dummy"
"106886",0,0,1,1,"dummy"
"106887",0,0,1,1,"dummy"
"106888",0,0,1,1,"dummy"
"106889",0,0,1,1,"dummy"
"106890",0,0,1,1,"dummy"
"106891",0,0,1,1,"dummy"
"106892",0,0,1,1,"dummy"
"106893",0,0,1,1,"dummy"
"106895",0,1,0,1,"dummy"
"106897",0,0,0,0,"dummy"
"106898",0,0,0,0,"dummy"
"106901",0,1,0,1,"dummy"
"106902",0,1,0,1,"dummy"
"106903",0,1,0,1,"dummy"
"106904",0,1,0,1,"dummy"
"106905",0,2,0,2,"dummy"
"106907",0,1,0,1,"dummy"
"106908",0,3,3,6,"dummy"
"106909",0,0,1,1,"dummy"
"106910",3,3,2,8,"dummy"
"106911",0,0,2,2,"dummy"
"106912",0,0,1,1,"dummy"
"106913",0,1,0,1,"dummy"
"106914",0,2,0,2,"dummy"
"106915",0,0,0,0,"dummy"
"106916",0,0,1,1,"dummy"
"106918",5,0,0,5,"dummy"
"106919",0,0,4,4,"dummy"
"106926",0,0,0,0,"dummy"
"106927",0,0,0,0,"dummy"
"106928",0,7,0,7,"dummy"
"106929",5,1,0,6,"dummy"
"106930",3,0,2,5,"dummy"
"106931",6,2,3,11,"dummy"
"106932",3,3,2,8,"dummy"
"106933",7,4,4,15,"dummy"
"106934",0,0,1,1,"dummy"
"106935",0,0,1,1,"dummy"
"106936",0,0,1,1,"dummy"
"106937",0,0,1,1,"dummy"
"106938",0,0,1,1,"dummy"
"106939",0,0,1,1,"dummy"
"106940",1,4,1,6,"dummy"
"106941",0,0,0,0,"dummy"
"106943",1,0,4,5,"dummy"
"106944",0,0,1,1,"dummy"
"106945",0,2,0,2,"dummy"
"106946",0,5,1,6,"dummy"
"106948",0,0,2,2,"dummy"
"106949",0,2,0,2,"dummy"
"106950",0,6,2,8,"dummy"
"106951",7,17,0,24,"dummy"
"106952",2,6,1,9,"dummy"
"106954",5,0,5,10,"dummy"
"106955",1,4,1,6,"dummy"
"106958",0,0,1,1,"dummy"
"106959",0,1,0,1,"dummy"
"106977",0,0,1,1,"dummy"
"106986",0,0,0,0,"dummy"
"106987",0,1,0,1,"dummy"
"106988",0,0,1,1,"dummy"
"106989",0,0,1,1,"dummy"
"106998",0,1,0,1,"dummy"
"107005",0,0,2,2,"dummy"
"107006",2,2,0,4,"dummy"
"107007",0,0,1,1,"dummy"
"107016",0,1,0,1,"dummy"
"107094",0,1,0,1,"dummy"
"107095",0,2,0,2,"dummy"
"107096",0,0,1,1,"dummy"
"107097",7,0,2,9,"dummy"
"107118",2,0,0,2,"dummy"
"107119",2,0,0,2,"dummy"
"107120",2,0,0,2,"dummy"
"107121",0,0,0,0,"dummy"
"107122",3,1,0,4,"dummy"
"107123",2,2,1,5,"dummy"
"107124",0,0,0,0,"dummy"
"107129",1,3,0,4,"dummy"
"107130",0,0,1,1,"dummy"
"107137",0,0,2,2,"dummy"
"107138",0,7,1,8,"dummy"
"107139",7,0,1,8,"dummy"
"107140",2,3,0,5,"dummy"
"107141",0,0,2,2,"dummy"
"107142",0,7,1,8,"dummy"
"107143",3,3,1,7,"dummy"
"107149",0,2,0,2,"dummy"
"107150",3,0,0,3,"dummy"
"107151",1,3,0,4,"dummy"
"107152",0,1,0,1,"dummy"
"107155",0,0,3,3,"dummy"
"107156",0,0,4,4,"dummy"
"107160",0,2,2,4,"dummy"
"107161",0,1,0,1,"dummy"
"107169",3,1,3,7,"dummy"
"107170",0,0,2,2,"dummy"
"107171",0,0,1,1,"dummy"
"107172",0,1,0,1,"dummy"
"107173",0,0,0,0,"dummy"
"107174",0,0,1,1,"dummy"
"107177",11,1,1,13,"dummy"
"107260",4,0,0,4,"dummy"
"107268",0,0,1,1,"dummy"
"107269",0,0,1,1,"dummy"
"107270",0,0,1,1,"dummy"
"107291",0,2,0,2,"dummy"
"107292",0,1,0,1,"dummy"
"107293",2,4,2,8,"dummy"
"107294",0,1,0,1,"dummy"
"107295",8,3,2,13,"dummy"
"107296",1,0,1,2,"dummy"
"107297",0,0,1,1,"dummy"
"107298",0,0,1,1,"dummy"
"107299",2,6,3,11,"dummy"
"107300",0,0,1,1,"dummy"
"107317",6,0,0,6,"dummy"
"107318",2,5,2,9,"dummy"
"107322",0,5,0,5,"dummy"
"107338",0,0,3,3,"dummy"
"106996",0,1,0,1,"dummy"
"107000",5,8,4,17,"dummy"
"107001",5,7,2,14,"dummy"
"107002",0,2,0,2,"dummy"
"107003",0,1,0,1,"dummy"
"107013",0,2,0,2,"dummy"
"107014",0,0,1,1,"dummy"
"107018",0,0,1,1,"dummy"
"107019",0,0,1,1,"dummy"
"107020",0,0,2,2,"dummy"
"107021",5,6,0,11,"dummy"
"107022",0,0,0,0,"dummy"
"107023",13,15,1,29,"dummy"
"107024",3,1,1,5,"dummy"
"107025",0,0,0,0,"dummy"
"107026",0,0,1,1,"dummy"
"107027",0,0,0,0,"dummy"
"107032",6,0,0,6,"dummy"
"107033",2,5,2,9,"dummy"
"107036",0,0,1,1,"dummy"
"107040",1,0,0,1,"dummy"
"107041",0,1,0,1,"dummy"
"107048",0,8,2,10,"dummy"
"107049",3,2,2,7,"dummy"
"107092",0,0,1,1,"dummy"
"107132",0,16,0,16,"dummy"
"107133",4,1,2,7,"dummy"
"107134",0,0,1,1,"dummy"
"107135",0,0,1,1,"dummy"
"107145",6,1,2,9,"dummy"
"107158",0,0,1,1,"dummy"
"107163",0,29,0,29,"dummy"
"107179",0,3,2,5,"dummy"
"107180",1,1,0,2,"dummy"
"107221",0,0,1,1,"dummy"
"107222",0,0,0,0,"dummy"
"107223",0,0,1,1,"dummy"
"107224",0,0,1,1,"dummy"
"107225",0,1,0,1,"dummy"
"107226",1,1,0,2,"dummy"
"107229",0,0,1,1,"dummy"
"107230",1,0,0,1,"dummy"
"107231",0,0,0,0,"dummy"
"107232",0,0,0,0,"dummy"
"107235",0,0,1,1,"dummy"
"107236",2,7,0,9,"dummy"
"107237",1,1,0,2,"dummy"
"107238",7,3,0,10,"dummy"
"107239",0,1,0,1,"dummy"
"107240",11,10,2,23,"dummy"
"107241",0,0,1,1,"dummy"
"107242",0,0,4,4,"dummy"
"107243",4,11,3,18,"dummy"
"107251",2,4,0,6,"dummy"
"107252",0,2,0,2,"dummy"
"107253",0,2,0,2,"dummy"
"107254",10,2,0,12,"dummy"
"107255",0,2,0,2,"dummy"
"107256",0,0,0,0,"dummy"
"107262",1,4,0,5,"dummy"
"107265",0,0,1,1,"dummy"
"107266",0,0,1,1,"dummy"
"107272",0,25,0,25,"dummy"
"107279",1,9,0,10,"dummy"
"107280",1,1,0,2,"dummy"
"107281",3,1,1,5,"dummy"
"107282",7,9,0,16,"dummy"
"107283",0,2,0,2,"dummy"
"107284",6,13,2,21,"dummy"
"107289",1,5,0,6,"dummy"
"107308",0,0,0,0,"dummy"
"107309",0,0,0,0,"dummy"
"107365",2,3,0,5,"dummy"
"107366",59,4,0,63,"dummy"
"107367",4,4,1,9,"dummy"
"107368",0,3,0,3,"dummy"
"107369",2,2,0,4,"dummy"
"107378",1,0,0,1,"dummy"
"107382",0,0,2,2,"dummy"
"107383",3,0,0,3,"dummy"
"107407",0,0,2,2,"dummy"
"107408",0,1,2,3,"dummy"
"107409",0,0,2,2,"dummy"
"107410",0,0,2,2,"dummy"
"107411",1,2,1,4,"dummy"
"107412",0,0,2,2,"dummy"
"107413",0,0,2,2,"dummy"
"107414",0,0,2,2,"dummy"
"107415",0,0,2,2,"dummy"
"107416",0,1,2,3,"dummy"
"107417",0,0,2,2,"dummy"
"107433",1,1,0,2,"dummy"
"107434",0,1,0,1,"dummy"
"107435",0,2,0,2,"dummy"
"107436",10,9,3,22,"dummy"
"107437",6,9,2,17,"dummy"
"107438",0,6,0,6,"dummy"
"107439",0,0,0,0,"dummy"
"107440",1,0,0,1,"dummy"
"107441",0,2,0,2,"dummy"
"107442",1,0,0,1,"dummy"
"107443",0,2,0,2,"dummy"
"107446",0,0,0,0,"dummy"
"107447",0,0,0,0,"dummy"
"107448",2,1,0,3,"dummy"
"107449",0,0,1,1,"dummy"
"107450",1,9,3,13,"dummy"
"107464",1,0,0,1,"dummy"
"107478",4,8,0,12,"dummy"
"107481",0,1,0,1,"dummy"
"107482",0,0,2,2,"dummy"
"107483",0,1,0,1,"dummy"
"107523",3,0,1,4,"dummy"
"107528",0,0,1,1,"dummy"
"107531",0,0,3,3,"dummy"
"107532",1,2,3,6,"dummy"
"107533",0,5,0,5,"dummy"
"107534",3,4,1,8,"dummy"
"107545",0,1,0,1,"dummy"
"107546",0,9,0,9,"dummy"
"107547",3,17,2,22,"dummy"
"107548",1,2,0,3,"dummy"
"107549",2,1,0,3,"dummy"
"107550",1,2,0,3,"dummy"
"107551",0,1,0,1,"dummy"
"107552",0,1,0,1,"dummy"
"107553",0,1,0,1,"dummy"
"107554",0,2,0,2,"dummy"
"107555",0,1,0,1,"dummy"
"107566",0,0,1,1,"dummy"
"107567",0,0,1,1,"dummy"
"107573",1,0,0,1,"dummy"
"107574",10,1,1,12,"dummy"
"107575",0,0,2,2,"dummy"
"107380",0,6,1,7,"dummy"
"107405",0,1,0,1,"dummy"
"107422",0,1,0,1,"dummy"
"107423",0,5,1,6,"dummy"
"107424",0,1,0,1,"dummy"
"107425",0,1,0,1,"dummy"
"107426",0,0,0,0,"dummy"
"107427",0,2,0,2,"dummy"
"107428",0,0,4,4,"dummy"
"107429",0,1,0,1,"dummy"
"107452",1,2,0,3,"dummy"
"107466",0,0,1,1,"dummy"
"107469",0,0,1,1,"dummy"
"107474",0,0,0,0,"dummy"
"107491",0,2,0,2,"dummy"
"107492",0,0,1,1,"dummy"
"107495",0,0,1,1,"dummy"
"107496",0,0,1,1,"dummy"
"107497",8,8,1,17,"dummy"
"107498",0,0,1,1,"dummy"
"107499",0,0,2,2,"dummy"
"107500",0,0,2,2,"dummy"
"107501",0,0,1,1,"dummy"
"107502",0,0,1,1,"dummy"
"107503",0,0,1,1,"dummy"
"107504",0,0,1,1,"dummy"
"107505",0,0,1,1,"dummy"
"107508",0,0,2,2,"dummy"
"107511",1,1,0,2,"dummy"
"107512",0,1,0,1,"dummy"
"107513",0,5,2,7,"dummy"
"107514",0,0,4,4,"dummy"
"107515",9,2,1,12,"dummy"
"107516",1,0,0,1,"dummy"
"107517",0,1,0,1,"dummy"
"107518",1,0,0,1,"dummy"
"107521",4,6,2,12,"dummy"
"107538",0,0,1,1,"dummy"
"107539",0,1,4,5,"dummy"
"107540",0,1,1,2,"dummy"
"107541",0,0,1,1,"dummy"
"107542",0,0,1,1,"dummy"
"107543",0,0,1,1,"dummy"
"107559",0,0,0,0,"dummy"
"107560",0,0,0,0,"dummy"
"107563",8,9,5,22,"dummy"
"107564",1,2,1,4,"dummy"
"107578",0,0,0,0,"dummy"
"107579",0,1,0,1,"dummy"
"107580",0,1,0,1,"dummy"
"107581",0,5,0,5,"dummy"
"107585",0,1,0,1,"dummy"
"107586",1,0,0,1,"dummy"
"107591",0,0,1,1,"dummy"
"107612",1,6,0,7,"dummy"
"107613",1,0,0,1,"dummy"
"107614",1,1,0,2,"dummy"
"107576",0,0,1,1,"dummy"
"107583",0,1,0,1,"dummy"
"107588",2,2,0,4,"dummy"
"107589",0,0,1,1,"dummy"
"107597",1,1,1,3,"dummy"
"107598",0,0,1,1,"dummy"
"107599",1,1,3,5,"dummy"
"107609",0,0,1,1,"dummy"
"107610",0,0,0,0,"dummy"
"107618",16,20,4,40,"dummy"
"107619",0,0,3,3,"dummy"
"107620",0,0,3,3,"dummy"
"107623",6,0,2,8,"dummy"
"107629",1,0,0,1,"dummy"
"107639",0,1,0,1,"dummy"
"107640",2,1,1,4,"dummy"
"107641",2,0,1,3,"dummy"
"107642",1,2,0,3,"dummy"
"107643",0,2,0,2,"dummy"
"107644",0,2,1,3,"dummy"
"107645",1,0,4,5,"dummy"
"107646",0,1,0,1,"dummy"
"107647",0,3,0,3,"dummy"
"107648",0,1,0,1,"dummy"
"107671",0,1,0,1,"dummy"
"107675",0,0,1,1,"dummy"
"107676",0,1,0,1,"dummy"
"107690",1,0,0,1,"dummy"
"107691",0,0,3,3,"dummy"
"107731",0,1,0,1,"dummy"
"107734",0,1,0,1,"dummy"
"107735",0,1,0,1,"dummy"
"107736",2,1,1,4,"dummy"
"107739",2,1,0,3,"dummy"
"107740",1,1,1,3,"dummy"
"107750",1,0,1,2,"dummy"
"107751",0,3,1,4,"dummy"
"107752",3,0,0,3,"dummy"
"107753",2,3,2,7,"dummy"
"107754",3,1,1,5,"dummy"
"107755",0,3,0,3,"dummy"
"107756",0,2,0,2,"dummy"
"107757",1,4,1,6,"dummy"
"107758",1,0,0,1,"dummy"
"107759",0,0,1,1,"dummy"
"107625",0,0,0,0,"dummy"
"107626",0,0,0,0,"dummy"
"107627",0,0,0,0,"dummy"
"107650",6,2,0,8,"dummy"
"107653",0,2,0,2,"dummy"
"107656",0,8,1,9,"dummy"
"107657",0,1,0,1,"dummy"
"107658",14,3,2,19,"dummy"
"107659",11,3,0,14,"dummy"
"107660",0,1,0,1,"dummy"
"107663",0,0,1,1,"dummy"
"107664",0,0,1,1,"dummy"
"107665",0,4,0,4,"dummy"
"107666",0,0,1,1,"dummy"
"107667",0,0,1,1,"dummy"
"107668",0,0,1,1,"dummy"
"107669",1,4,0,5,"dummy"
"107673",0,2,0,2,"dummy"
"107680",0,0,1,1,"dummy"
"107681",0,0,1,1,"dummy"
"107684",0,1,0,1,"dummy"
"107685",0,0,3,3,"dummy"
"107686",2,0,0,2,"dummy"
"107695",5,0,0,5,"dummy"
"107696",0,1,0,1,"dummy"
"107697",0,1,0,1,"dummy"
"107698",3,10,1,14,"dummy"
"107699",9,16,2,27,"dummy"
"107700",0,1,0,1,"dummy"
"107701",0,2,0,2,"dummy"
"107702",0,1,0,1,"dummy"
"107703",1,0,0,1,"dummy"
"107704",3,2,0,5,"dummy"
"107705",1,1,0,2,"dummy"
"107778",0,1,0,1,"dummy"
"107779",0,0,1,1,"dummy"
"107791",1,1,0,2,"dummy"
"107793",2,1,1,4,"dummy"
"107794",0,3,0,3,"dummy"
"107796",2,0,0,2,"dummy"
"107797",1,6,2,9,"dummy"
"107798",0,1,0,1,"dummy"
"107799",0,1,0,1,"dummy"
"107800",0,0,1,1,"dummy"
"107805",0,18,0,18,"dummy"
"107806",7,15,0,22,"dummy"
"107807",0,1,0,1,"dummy"
"107808",7,5,0,12,"dummy"
"107809",4,1,0,5,"dummy"
"107810",7,4,0,11,"dummy"
"107811",4,7,0,11,"dummy"
"107812",9,0,0,9,"dummy"
"107813",10,14,0,24,"dummy"
"107827",0,0,1,1,"dummy"
"107828",0,0,0,0,"dummy"
"107829",0,0,1,1,"dummy"
"107831",1,1,0,2,"dummy"
"107832",2,4,0,6,"dummy"
"107833",0,0,1,1,"dummy"
"107852",4,4,1,9,"dummy"
"107853",0,0,0,0,"dummy"
"107854",5,0,1,6,"dummy"
"107857",0,0,3,3,"dummy"
"107858",0,1,0,1,"dummy"
"107859",1,0,0,1,"dummy"
"107860",0,2,0,2,"dummy"
"107861",0,0,1,1,"dummy"
"107862",3,2,3,8,"dummy"
"107863",0,1,0,1,"dummy"
"107865",4,1,0,5,"dummy"
"107866",0,0,0,0,"dummy"
"107867",0,0,3,3,"dummy"
"107868",0,1,0,1,"dummy"
"107876",0,1,1,2,"dummy"
"107877",0,2,1,3,"dummy"
"107878",2,2,0,4,"dummy"
"107879",1,1,0,2,"dummy"
"107880",0,0,0,0,"dummy"
"107882",0,0,1,1,"dummy"
"107885",0,1,0,1,"dummy"
"107888",0,0,0,0,"dummy"
"107889",0,1,1,2,"dummy"
"107891",0,2,0,2,"dummy"
"107892",0,1,1,2,"dummy"
"107895",0,0,1,1,"dummy"
"107896",1,2,1,4,"dummy"
"107897",0,0,1,1,"dummy"
"107898",0,1,0,1,"dummy"
"107899",0,2,0,2,"dummy"
"107900",0,0,1,1,"dummy"
"107901",6,0,1,7,"dummy"
"107904",1,19,4,24,"dummy"
"107907",0,0,2,2,"dummy"
"107910",0,0,1,1,"dummy"
"107911",1,1,1,3,"dummy"
"107912",0,0,1,1,"dummy"
"107913",2,1,3,6,"dummy"
"107914",0,0,2,2,"dummy"
"107915",0,5,1,6,"dummy"
"107916",6,17,0,23,"dummy"
"107917",0,0,0,0,"dummy"
"107918",0,1,0,1,"dummy"
"107919",0,0,14,14,"dummy"
"107920",0,1,0,1,"dummy"
"107922",0,0,1,1,"dummy"
"107923",0,0,1,1,"dummy"
"107926",0,3,1,4,"dummy"
"107927",0,2,0,2,"dummy"
"107928",0,0,3,3,"dummy"
"107929",1,0,0,1,"dummy"
"107930",0,0,2,2,"dummy"
"107931",0,0,1,1,"dummy"
"107932",0,1,0,1,"dummy"
"107933",0,6,1,7,"dummy"
"107934",0,0,1,1,"dummy"
"107941",0,0,0,0,"dummy"
"107942",0,2,0,2,"dummy"
"107943",1,1,0,2,"dummy"
"107944",0,0,1,1,"dummy"
"107945",0,0,1,1,"dummy"
"107946",3,1,2,6,"dummy"
"107950",0,7,0,7,"dummy"
"107951",0,1,0,1,"dummy"
"107952",4,0,0,4,"dummy"
"107953",0,3,0,3,"dummy"
"107954",4,6,1,11,"dummy"
"107957",0,0,0,0,"dummy"
"107967",1,1,0,2,"dummy"
"107968",1,1,0,2,"dummy"
"107970",1,4,0,5,"dummy"
"107971",1,1,0,2,"dummy"
"107972",1,1,0,2,"dummy"
"107974",0,0,1,1,"dummy"
"107977",3,4,0,7,"dummy"
"107978",1,1,0,2,"dummy"
"107979",4,2,1,7,"dummy"
"107981",0,2,0,2,"dummy"
"107982",0,2,0,2,"dummy"
"107983",0,1,0,1,"dummy"
"107984",0,0,1,1,"dummy"
"107986",1,0,0,1,"dummy"
"107987",0,0,1,1,"dummy"
"107988",0,1,1,2,"dummy"
"107989",0,0,1,1,"dummy"
"107991",3,5,1,9,"dummy"
"107992",0,0,1,1,"dummy"
"107993",1,0,0,1,"dummy"
"107994",0,0,1,1,"dummy"
"107995",2,2,0,4,"dummy"
"107996",0,0,1,1,"dummy"
"107997",2,2,0,4,"dummy"
"107998",0,1,0,1,"dummy"
"107999",1,0,0,1,"dummy"
"108000",0,1,0,1,"dummy"
"108001",3,3,0,6,"dummy"
"108002",2,0,0,2,"dummy"
"108003",0,0,0,0,"dummy"
"108004",0,1,1,2,"dummy"
"108005",3,3,3,9,"dummy"
"108007",0,0,0,0,"dummy"
"108008",1,0,0,1,"dummy"
"108009",0,0,1,1,"dummy"
"108010",1,1,0,2,"dummy"
"108011",6,0,0,6,"dummy"
"108012",2,0,0,2,"dummy"
"108013",0,0,1,1,"dummy"
"108014",0,0,1,1,"dummy"
"108015",2,2,1,5,"dummy"
"108016",0,0,0,0,"dummy"
"108017",0,0,0,0,"dummy"
"108018",0,1,0,1,"dummy"
"108019",0,0,1,1,"dummy"
"108021",0,1,0,1,"dummy"
"108023",2,2,0,4,"dummy"
"108024",0,1,0,1,"dummy"
"108026",0,0,1,1,"dummy"
"108027",0,1,0,1,"dummy"
"108028",0,1,0,1,"dummy"
"108029",0,0,1,1,"dummy"
"108030",9,7,2,18,"dummy"
"108031",0,3,0,3,"dummy"
"108032",0,0,0,0,"dummy"
"108033",0,0,0,0,"dummy"
"108034",0,0,0,0,"dummy"
"108037",1,7,4,12,"dummy"
"108038",0,1,1,2,"dummy"
"108040",0,1,0,1,"dummy"
"108041",0,0,1,1,"dummy"
"108043",0,0,0,0,"dummy"
"108044",0,3,0,3,"dummy"
"108045",0,0,0,0,"dummy"
"108046",0,5,0,5,"dummy"
"108047",0,2,0,2,"dummy"
"108048",0,0,1,1,"dummy"
"108049",4,0,0,4,"dummy"
"108050",0,9,2,11,"dummy"
"108051",8,0,0,8,"dummy"
"108052",4,0,1,5,"dummy"
"108053",0,3,0,3,"dummy"
"108054",0,0,1,1,"dummy"
"108056",0,1,0,1,"dummy"
"108057",0,3,0,3,"dummy"
"108058",9,0,0,9,"dummy"
"108059",0,0,0,0,"dummy"
"108060",0,7,0,7,"dummy"
"108061",0,1,1,2,"dummy"
"108062",0,2,3,5,"dummy"
"108063",9,5,0,14,"dummy"
"108065",0,0,0,0,"dummy"
"108067",0,1,0,1,"dummy"
"108069",0,4,0,4,"dummy"
"108070",0,0,2,2,"dummy"
"108071",0,0,1,1,"dummy"
"108078",2,3,0,5,"dummy"
"108079",0,0,1,1,"dummy"
"108080",0,1,0,1,"dummy"
"108081",0,0,2,2,"dummy"
"108083",0,0,1,1,"dummy"
"108085",2,0,0,2,"dummy"
"108086",0,1,0,1,"dummy"
"108087",0,1,0,1,"dummy"
"108089",0,0,0,0,"dummy"
"108090",0,0,0,0,"dummy"
"108092",0,0,1,1,"dummy"
"108093",0,1,0,1,"dummy"
"108094",0,0,1,1,"dummy"
"108095",0,0,1,1,"dummy"
"108096",0,0,1,1,"dummy"
"108097",6,3,1,10,"dummy"
"108098",0,0,1,1,"dummy"
"108099",1,2,2,5,"dummy"
"108100",0,0,1,1,"dummy"
"108101",17,2,4,23,"dummy"
"108102",0,0,3,3,"dummy"
"108103",0,0,1,1,"dummy"
"108104",1,0,1,2,"dummy"
"108105",0,1,0,1,"dummy"
"108106",0,0,1,1,"dummy"
"108108",0,0,2,2,"dummy"
"108109",0,4,3,7,"dummy"
"108110",0,0,3,3,"dummy"
"108111",0,1,3,4,"dummy"
"108112",0,2,0,2,"dummy"
"108113",0,3,0,3,"dummy"
"108121",0,1,0,1,"dummy"
"108122",0,0,1,1,"dummy"
"108123",0,18,1,19,"dummy"
"108124",0,16,2,18,"dummy"
"108125",0,20,1,21,"dummy"
"108126",0,2,1,3,"dummy"
"108130",10,7,4,21,"dummy"
"108131",2,0,1,3,"dummy"
"108132",0,1,2,3,"dummy"
"108133",0,0,5,5,"dummy"
"108134",0,2,0,2,"dummy"
"108135",0,0,1,1,"dummy"
"108136",0,0,1,1,"dummy"
"108137",0,1,0,1,"dummy"
"108138",0,0,1,1,"dummy"
"108139",0,4,0,4,"dummy"
"108141",8,10,3,21,"dummy"
"108142",0,0,1,1,"dummy"
"108143",0,0,1,1,"dummy"
"108144",0,0,1,1,"dummy"
"108145",0,0,1,1,"dummy"
"108146",0,0,1,1,"dummy"
"108147",0,0,1,1,"dummy"
"108148",0,0,1,1,"dummy"
"108149",0,0,1,1,"dummy"
"108150",0,0,1,1,"dummy"
"108151",0,0,1,1,"dummy"
"108154",0,0,1,1,"dummy"
"108155",3,5,0,8,"dummy"
"108161",0,2,0,2,"dummy"
"108162",0,7,0,7,"dummy"
"108164",0,0,1,1,"dummy"
"108165",0,2,0,2,"dummy"
"108166",1,3,0,4,"dummy"
"108167",13,4,0,17,"dummy"
"108168",3,1,0,4,"dummy"
"108169",0,1,0,1,"dummy"
"108170",4,16,1,21,"dummy"
"108171",0,1,0,1,"dummy"
"108172",1,2,0,3,"dummy"
"108174",0,0,0,0,"dummy"
"108175",0,0,0,0,"dummy"
"108176",0,0,0,0,"dummy"
"108177",0,0,0,0,"dummy"
"108180",0,2,1,3,"dummy"
"108182",0,1,0,1,"dummy"
"108184",1,0,0,1,"dummy"
"108185",0,0,0,0,"dummy"
"108186",0,0,0,0,"dummy"
"108187",0,0,0,0,"dummy"
"108191",0,3,0,3,"dummy"
"108192",0,0,1,1,"dummy"
"108193",1,0,0,1,"dummy"
"108194",0,3,0,3,"dummy"
"108195",0,1,0,1,"dummy"
"108196",0,1,0,1,"dummy"
"108197",0,1,0,1,"dummy"
"108198",1,7,0,8,"dummy"
"108199",2,0,0,2,"dummy"
"108203",0,1,0,1,"dummy"
"108204",0,0,1,1,"dummy"
"108205",0,0,3,3,"dummy"
"108206",1,0,0,1,"dummy"
"108207",0,0,1,1,"dummy"
"108208",5,18,0,23,"dummy"
"108209",0,2,0,2,"dummy"
"108210",0,1,0,1,"dummy"
"108211",1,0,0,1,"dummy"
"108212",1,0,0,1,"dummy"
"108213",0,1,0,1,"dummy"
"108214",5,2,2,9,"dummy"
"108215",0,0,2,2,"dummy"
"108216",0,0,1,1,"dummy"
"108219",0,0,0,0,"dummy"
"108220",0,2,0,2,"dummy"
"108221",0,0,1,1,"dummy"
"108222",0,0,1,1,"dummy"
"108227",0,0,0,0,"dummy"
"108228",1,0,0,1,"dummy"
"108229",0,0,1,1,"dummy"
"108235",0,0,0,0,"dummy"
"108236",0,0,0,0,"dummy"
"108237",0,11,0,11,"dummy"
"108242",0,0,2,2,"dummy"
"108243",0,1,0,1,"dummy"
"108245",1,0,0,1,"dummy"
"108247",3,14,4,21,"dummy"
"108248",0,2,0,2,"dummy"
"108250",0,0,1,1,"dummy"
"108251",0,3,0,3,"dummy"
"108256",2,5,2,9,"dummy"
"108257",0,1,0,1,"dummy"
"108258",0,1,0,1,"dummy"
"108259",0,3,0,3,"dummy"
"108260",0,1,0,1,"dummy"
"108262",1,0,0,1,"dummy"
"108263",0,0,1,1,"dummy"
"108265",0,0,2,2,"dummy"
"108266",0,0,2,2,"dummy"
"108267",1,1,2,4,"dummy"
"108271",0,0,0,0,"dummy"
"108274",1,4,0,5,"dummy"
"108275",0,1,0,1,"dummy"
"108276",0,0,1,1,"dummy"
"108277",0,0,0,0,"dummy"
"108278",4,0,2,6,"dummy"
"108279",2,0,2,4,"dummy"
"108280",0,2,2,4,"dummy"
"108281",4,2,1,7,"dummy"
"108282",2,4,1,7,"dummy"
"108285",1,0,0,1,"dummy"
"108293",0,20,0,20,"dummy"
"108300",0,0,0,0,"dummy"
"108301",0,0,0,0,"dummy"
"108303",1,0,1,2,"dummy"
"108304",0,1,1,2,"dummy"
"108313",0,0,0,0,"dummy"
"108314",8,7,5,20,"dummy"
"108315",0,1,3,4,"dummy"
"108316",1,2,0,3,"dummy"
"108318",0,2,1,3,"dummy"
"108323",1,6,1,8,"dummy"
"108325",0,5,1,6,"dummy"
"108326",1,3,1,5,"dummy"
"108327",1,10,0,11,"dummy"
"108331",0,0,0,0,"dummy"
"108334",0,0,3,3,"dummy"
"108335",0,5,0,5,"dummy"
"108337",0,0,0,0,"dummy"
"108338",0,0,0,0,"dummy"
"108339",0,0,1,1,"dummy"
"108357",0,1,0,1,"dummy"
"108358",0,5,0,5,"dummy"
"108359",0,1,0,1,"dummy"
"108360",1,2,1,4,"dummy"
"108361",2,3,0,5,"dummy"
"108362",1,0,0,1,"dummy"
"108363",1,0,0,1,"dummy"
"108364",10,4,0,14,"dummy"
"108365",2,2,0,4,"dummy"
"108366",0,5,0,5,"dummy"
"108367",0,3,0,3,"dummy"
"108368",0,1,0,1,"dummy"
"108369",0,1,0,1,"dummy"
"108370",1,0,0,1,"dummy"
"108371",0,5,0,5,"dummy"
"108372",0,0,1,1,"dummy"
"108373",0,0,0,0,"dummy"
"108374",3,2,1,6,"dummy"
"108375",0,1,0,1,"dummy"
"108376",0,8,0,8,"dummy"
"108377",0,2,0,2,"dummy"
"108378",2,1,0,3,"dummy"
"108379",2,1,0,3,"dummy"
"108381",0,4,0,4,"dummy"
"108382",1,0,0,1,"dummy"
"108383",2,0,0,2,"dummy"
"108385",0,1,0,1,"dummy"
"108386",3,2,3,8,"dummy"
"108387",0,1,0,1,"dummy"
"108389",0,1,0,1,"dummy"
"108392",0,0,0,0,"dummy"
"108393",0,0,0,0,"dummy"
"108394",0,0,0,0,"dummy"
"108395",0,0,0,0,"dummy"
"108399",0,0,3,3,"dummy"
"108400",0,1,0,1,"dummy"
"108401",1,0,0,1,"dummy"
"108423",0,2,0,2,"dummy"
"108424",1,0,0,1,"dummy"
"108427",0,0,1,1,"dummy"
"108428",0,0,0,0,"dummy"
"108429",0,0,0,0,"dummy"
"108430",0,1,0,1,"dummy"
"108432",6,1,0,7,"dummy"
"108433",0,6,0,6,"dummy"
"108434",2,10,3,15,"dummy"
"108435",1,0,0,1,"dummy"
"108436",0,1,0,1,"dummy"
"108437",0,0,1,1,"dummy"
"108438",0,3,0,3,"dummy"
"108439",0,1,0,1,"dummy"
"108440",0,0,1,1,"dummy"
"108441",0,0,1,1,"dummy"
"108444",1,5,4,10,"dummy"
"108446",4,1,1,6,"dummy"
"108447",8,8,1,17,"dummy"
"108449",7,8,0,15,"dummy"
"108450",0,2,0,2,"dummy"
"108452",6,0,0,6,"dummy"
"108453",0,1,0,1,"dummy"
"108454",1,2,0,3,"dummy"
"108457",1,2,0,3,"dummy"
"108464",0,1,0,1,"dummy"
"108465",0,1,0,1,"dummy"
"108601",4,10,1,15,"dummy"
"108605",0,0,0,0,"dummy"
"108608",0,0,2,2,"dummy"
"108614",0,0,1,1,"dummy"
"108617",0,0,1,1,"dummy"
"108623",0,0,1,1,"dummy"
"108628",2,2,0,4,"dummy"
"108629",0,8,0,8,"dummy"
"108630",4,3,2,9,"dummy"
"108631",1,0,0,1,"dummy"
"108632",0,0,0,0,"dummy"
"108633",0,0,1,1,"dummy"
"108634",0,1,1,2,"dummy"
"108635",0,2,1,3,"dummy"
"108636",0,1,0,1,"dummy"
"108637",0,6,0,6,"dummy"
"108640",0,1,0,1,"dummy"
"108642",0,0,1,1,"dummy"
"108645",0,0,1,1,"dummy"
"108646",1,0,0,1,"dummy"
"108647",0,0,1,1,"dummy"
"108649",2,4,0,6,"dummy"
"108650",0,2,0,2,"dummy"
"108651",0,2,0,2,"dummy"
"108652",10,2,0,12,"dummy"
"108653",0,2,0,2,"dummy"
"108654",0,0,0,0,"dummy"
"108655",0,0,3,3,"dummy"
"108657",0,0,1,1,"dummy"
"108658",1,0,0,1,"dummy"
"108659",0,0,1,1,"dummy"
"108660",0,0,1,1,"dummy"
"108661",0,0,1,1,"dummy"
"108662",1,3,0,4,"dummy"
"108663",0,0,2,2,"dummy"
"108664",0,0,1,1,"dummy"
"108665",0,0,1,1,"dummy"
"108667",3,3,1,7,"dummy"
"108678",0,1,0,1,"dummy"
"108679",0,0,1,1,"dummy"
"108681",0,1,2,3,"dummy"
"108682",3,2,1,6,"dummy"
"108683",0,0,1,1,"dummy"
"108685",0,2,0,2,"dummy"
"108686",4,3,0,7,"dummy"
"108687",0,1,0,1,"dummy"
"108693",0,1,4,5,"dummy"
"108694",0,2,0,2,"dummy"
"108696",4,6,2,12,"dummy"
"108697",2,3,1,6,"dummy"
"108699",0,1,1,2,"dummy"
"108700",0,0,0,0,"dummy"
"108701",0,0,0,0,"dummy"
"108702",0,0,0,0,"dummy"
"108703",0,0,1,1,"dummy"
"108704",0,0,0,0,"dummy"
"108707",8,6,0,14,"dummy"
"108708",1,0,0,1,"dummy"
"108709",1,2,1,4,"dummy"
"108710",2,2,1,5,"dummy"
"108713",0,0,1,1,"dummy"
"108717",0,0,1,1,"dummy"
"108742",2,4,0,6,"dummy"
"108743",0,2,0,2,"dummy"
"108744",0,2,0,2,"dummy"
"108745",10,2,0,12,"dummy"
"108746",0,2,0,2,"dummy"
"108747",0,0,0,0,"dummy"
"108748",0,0,3,3,"dummy"
"108749",0,5,0,5,"dummy"
"108750",1,0,1,2,"dummy"
"108752",5,3,0,8,"dummy"
"108754",1,0,0,1,"dummy"
"108755",0,2,0,2,"dummy"
"108756",1,0,0,1,"dummy"
"108757",3,11,1,15,"dummy"
"108758",0,0,1,1,"dummy"
"108759",0,1,0,1,"dummy"
"108762",0,1,0,1,"dummy"
"108763",0,1,0,1,"dummy"
"108764",0,0,2,2,"dummy"
"108765",2,2,2,6,"dummy"
"108766",0,0,1,1,"dummy"
"108767",0,1,0,1,"dummy"
"108768",0,2,0,2,"dummy"
"108769",1,0,0,1,"dummy"
"108770",0,0,0,0,"dummy"
"108771",0,0,0,0,"dummy"
"108772",0,1,0,1,"dummy"
"108773",0,1,0,1,"dummy"
"108774",0,0,2,2,"dummy"
"108775",0,2,0,2,"dummy"
"108776",2,3,0,5,"dummy"
"108777",0,10,0,10,"dummy"
"108778",0,1,0,1,"dummy"
"108780",2,15,1,18,"dummy"
"108781",7,26,0,33,"dummy"
"108782",0,0,1,1,"dummy"
"108783",0,2,0,2,"dummy"
"108784",0,9,0,9,"dummy"
"108785",0,0,0,0,"dummy"
"108786",0,0,1,1,"dummy"
"108789",0,1,0,1,"dummy"
"108792",0,0,1,1,"dummy"
"108795",0,3,0,3,"dummy"
"108799",0,4,1,5,"dummy"
"108800",0,1,0,1,"dummy"
"108801",0,1,0,1,"dummy"
"108802",0,2,0,2,"dummy"
"108803",0,0,1,1,"dummy"
"108804",0,0,1,1,"dummy"
"108805",33,3,2,38,"dummy"
"108809",0,5,0,5,"dummy"
"108810",0,1,0,1,"dummy"
"108811",0,0,0,0,"dummy"
"108813",0,1,0,1,"dummy"
"108814",0,1,0,1,"dummy"
"108815",0,0,2,2,"dummy"
"108820",3,3,0,6,"dummy"
"108822",0,12,0,12,"dummy"
"108823",0,2,0,2,"dummy"
"108824",0,1,0,1,"dummy"
"108825",2,2,0,4,"dummy"
"108826",1,0,0,1,"dummy"
"108827",0,2,0,2,"dummy"
"108828",1,5,1,7,"dummy"
"108829",7,7,2,16,"dummy"
"108830",0,0,0,0,"dummy"
"108831",0,0,1,1,"dummy"
"108832",0,0,1,1,"dummy"
"108833",0,0,1,1,"dummy"
"108834",2,2,1,5,"dummy"
"108835",0,0,0,0,"dummy"
"108836",0,1,0,1,"dummy"
"108837",0,0,1,1,"dummy"
"108838",0,0,0,0,"dummy"
"108839",0,0,1,1,"dummy"
"108847",0,0,4,4,"dummy"
"108848",0,2,0,2,"dummy"
"108849",0,0,0,0,"dummy"
"108852",5,3,0,8,"dummy"
"108853",1,0,1,2,"dummy"
"108865",1,1,1,3,"dummy"
"108866",0,1,0,1,"dummy"
"108880",0,1,0,1,"dummy"
"108881",0,1,1,2,"dummy"
"108882",4,0,0,4,"dummy"
"108883",1,3,0,4,"dummy"
"108884",0,3,0,3,"dummy"
"108885",0,1,0,1,"dummy"
"108886",0,2,0,2,"dummy"
"108887",0,0,2,2,"dummy"
"108888",3,4,2,9,"dummy"
"108889",3,3,0,6,"dummy"
"108890",1,1,0,2,"dummy"
"108891",2,1,0,3,"dummy"
"108892",0,0,1,1,"dummy"
"108898",0,0,1,1,"dummy"
"108901",0,1,0,1,"dummy"
"108902",0,2,1,3,"dummy"
"108903",2,5,3,10,"dummy"
"108904",0,2,0,2,"dummy"
"108905",1,0,0,1,"dummy"
"108908",0,2,0,2,"dummy"
"108911",0,2,0,2,"dummy"
"108912",0,0,0,0,"dummy"
"108913",0,0,0,0,"dummy"
"108914",11,0,1,12,"dummy"
"108915",0,0,1,1,"dummy"
"108841",2,4,1,7,"dummy"
"108842",7,1,0,8,"dummy"
"108843",0,0,2,2,"dummy"
"108857",3,1,0,4,"dummy"
"108858",1,12,0,13,"dummy"
"108863",0,0,1,1,"dummy"
"108869",1,0,0,1,"dummy"
"108870",0,0,0,0,"dummy"
"108871",1,0,0,1,"dummy"
"108872",2,0,0,2,"dummy"
"108873",0,0,1,1,"dummy"
"108874",2,0,0,2,"dummy"
"108875",0,1,0,1,"dummy"
"108876",0,0,0,0,"dummy"
"108877",0,0,1,1,"dummy"
"108878",0,2,0,2,"dummy"
"108894",2,0,0,2,"dummy"
"108940",4,4,1,9,"dummy"
"108941",1,4,1,6,"dummy"
"108942",0,0,2,2,"dummy"
"108956",0,2,0,2,"dummy"
"108958",0,6,0,6,"dummy"
"108959",2,1,0,3,"dummy"
"108961",0,1,0,1,"dummy"
"108969",3,1,2,6,"dummy"
"108971",5,12,2,19,"dummy"
"108977",0,0,4,4,"dummy"
"108978",0,0,1,1,"dummy"
"108979",0,0,0,0,"dummy"
"108980",0,0,1,1,"dummy"
"108981",0,0,0,0,"dummy"
"108983",0,0,1,1,"dummy"
"108984",0,0,1,1,"dummy"
"108986",0,3,0,3,"dummy"
"108991",0,1,1,2,"dummy"
"108992",0,1,1,2,"dummy"
"108993",0,7,3,10,"dummy"
"108995",10,0,1,11,"dummy"
"108998",0,1,0,1,"dummy"
"108999",0,0,1,1,"dummy"
"109000",0,2,0,2,"dummy"
"109001",3,0,0,3,"dummy"
"109002",0,3,1,4,"dummy"
"109003",0,3,0,3,"dummy"
"109004",0,0,2,2,"dummy"
"109005",0,1,0,1,"dummy"
"109006",3,7,0,10,"dummy"
"109009",0,3,0,3,"dummy"
"109010",2,3,1,6,"dummy"
"109013",0,1,1,2,"dummy"
"109014",1,1,1,3,"dummy"
"109015",0,0,1,1,"dummy"
"109017",0,0,1,1,"dummy"
"109018",0,0,0,0,"dummy"
"109020",0,2,2,4,"dummy"
"109021",1,0,0,1,"dummy"
"109025",0,1,0,1,"dummy"
"109028",0,0,0,0,"dummy"
"109029",0,0,0,0,"dummy"
"109035",4,6,3,13,"dummy"
"109036",7,18,5,30,"dummy"
"109037",0,0,1,1,"dummy"
"109038",2,3,4,9,"dummy"
"109039",4,0,0,4,"dummy"
"109040",1,5,0,6,"dummy"
"109041",0,0,0,0,"dummy"
"109042",0,0,0,0,"dummy"
"109043",0,1,0,1,"dummy"
"109044",1,3,1,5,"dummy"
"109045",0,0,2,2,"dummy"
"109046",0,0,1,1,"dummy"
"109047",22,8,3,33,"dummy"
"109048",0,0,1,1,"dummy"
"109049",0,0,0,0,"dummy"
"109050",0,2,0,2,"dummy"
"109051",0,0,0,0,"dummy"
"109052",0,0,2,2,"dummy"
"109053",0,0,1,1,"dummy"
"109054",0,0,1,1,"dummy"
"109055",0,0,1,1,"dummy"
"109056",0,0,1,1,"dummy"
"109057",0,0,0,0,"dummy"
"109058",3,3,2,8,"dummy"
"109059",0,0,1,1,"dummy"
"109060",0,0,1,1,"dummy"
"109061",0,0,2,2,"dummy"
"109062",0,0,2,2,"dummy"
"109063",1,1,0,2,"dummy"
"109064",1,1,0,2,"dummy"
"109065",0,0,1,1,"dummy"
"109066",0,0,1,1,"dummy"
"109067",0,1,0,1,"dummy"
"109068",0,0,1,1,"dummy"
"109069",0,0,2,2,"dummy"
"109070",0,0,0,0,"dummy"
"109071",0,0,2,2,"dummy"
"109072",0,0,2,2,"dummy"
"109073",0,0,1,1,"dummy"
"109076",2,2,0,4,"dummy"
"109079",0,4,1,5,"dummy"
"109080",0,0,1,1,"dummy"
"109081",0,1,0,1,"dummy"
"109084",0,2,1,3,"dummy"
"109086",0,1,0,1,"dummy"
"109100",0,1,2,3,"dummy"
"109104",1,0,0,1,"dummy"
"109105",0,0,0,0,"dummy"
"109106",8,2,0,10,"dummy"
"109108",0,1,0,1,"dummy"
"109111",0,0,1,1,"dummy"
"109112",0,0,1,1,"dummy"
"109113",0,1,0,1,"dummy"
"109114",17,21,2,40,"dummy"
"109115",0,0,0,0,"dummy"
"109116",2,6,0,8,"dummy"
"109117",2,2,2,6,"dummy"
"109118",28,12,5,45,"dummy"
"109119",1,7,0,8,"dummy"
"109120",0,0,2,2,"dummy"
"109121",0,1,1,2,"dummy"
"109122",5,3,1,9,"dummy"
"109123",0,1,1,2,"dummy"
"109124",2,1,1,4,"dummy"
"109125",0,2,1,3,"dummy"
"109126",3,4,0,7,"dummy"
"109127",0,0,0,0,"dummy"
"109130",0,0,2,2,"dummy"
"109131",2,0,4,6,"dummy"
"109132",0,0,4,4,"dummy"
"109133",0,0,1,1,"dummy"
"109166",2,2,1,5,"dummy"
"109169",0,1,0,1,"dummy"
"109170",0,5,0,5,"dummy"
"109171",1,0,0,1,"dummy"
"109174",0,7,2,9,"dummy"
"109177",0,1,1,2,"dummy"
"109179",0,3,1,4,"dummy"
"109180",3,0,1,4,"dummy"
"109181",0,1,1,2,"dummy"
"109182",1,0,1,2,"dummy"
"109183",0,1,1,2,"dummy"
"109184",0,1,1,2,"dummy"
"109185",0,1,1,2,"dummy"
"109186",0,0,2,2,"dummy"
"109187",2,0,0,2,"dummy"
"109188",0,3,0,3,"dummy"
"109189",0,1,0,1,"dummy"
"109191",0,4,0,4,"dummy"
"109192",0,1,1,2,"dummy"
"109193",0,1,0,1,"dummy"
"109194",0,0,1,1,"dummy"
"109195",2,1,4,7,"dummy"
"109198",0,0,1,1,"dummy"
"109199",0,0,1,1,"dummy"
"109200",0,0,1,1,"dummy"
"109201",0,0,1,1,"dummy"
"109205",0,0,2,2,"dummy"
"109215",0,0,1,1,"dummy"
"109216",3,4,1,8,"dummy"
"109217",0,1,0,1,"dummy"
"109218",0,2,0,2,"dummy"
"109219",0,0,1,1,"dummy"
"109225",0,1,0,1,"dummy"
"109226",0,5,4,9,"dummy"
"109227",0,2,0,2,"dummy"
"109229",0,2,1,3,"dummy"
"109230",0,0,1,1,"dummy"
"109231",0,1,1,2,"dummy"
"109233",1,2,0,3,"dummy"
"109235",11,0,0,11,"dummy"
"109246",19,32,0,51,"dummy"
"109247",1,1,0,2,"dummy"
"109248",0,2,1,3,"dummy"
"109249",26,9,2,37,"dummy"
"109250",0,3,0,3,"dummy"
"109251",0,1,0,1,"dummy"
"109252",0,1,0,1,"dummy"
"109253",0,1,1,2,"dummy"
"109254",1,0,1,2,"dummy"
"109255",0,0,1,1,"dummy"
"109256",0,0,1,1,"dummy"
"109257",16,3,0,19,"dummy"
"109258",0,0,0,0,"dummy"
"109260",0,3,1,4,"dummy"
"109261",0,1,0,1,"dummy"
"109262",0,0,1,1,"dummy"
"109263",0,0,1,1,"dummy"
"109266",0,0,0,0,"dummy"
"109268",0,1,0,1,"dummy"
"109269",0,1,0,1,"dummy"
"109270",1,1,0,2,"dummy"
"109271",0,1,1,2,"dummy"
"109272",0,0,1,1,"dummy"
"109273",1,2,0,3,"dummy"
"109274",0,1,0,1,"dummy"
"109275",0,0,1,1,"dummy"
"109276",0,1,0,1,"dummy"
"109279",1,0,0,1,"dummy"
"109280",0,1,0,1,"dummy"
"109281",1,0,1,2,"dummy"
"109282",5,6,0,11,"dummy"
"109284",2,15,1,18,"dummy"
"109285",4,4,1,9,"dummy"
"109286",0,1,0,1,"dummy"
"109287",0,0,2,2,"dummy"
"109288",2,0,2,4,"dummy"
"109289",0,0,1,1,"dummy"
"109290",0,0,1,1,"dummy"
"109313",0,0,0,0,"dummy"
"109314",0,0,0,0,"dummy"
"109344",0,0,1,1,"dummy"
"109345",0,0,1,1,"dummy"
"109352",0,11,0,11,"dummy"
"109353",0,4,1,5,"dummy"
"109354",0,1,0,1,"dummy"
"109355",0,3,0,3,"dummy"
"109356",4,3,2,9,"dummy"
"109376",0,0,1,1,"dummy"
"109379",6,0,0,6,"dummy"
"109380",1,0,0,1,"dummy"
"109383",0,1,0,1,"dummy"
"109384",1,0,0,1,"dummy"
"109385",0,1,0,1,"dummy"
"109386",0,4,0,4,"dummy"
"109387",0,0,2,2,"dummy"
"109388",10,5,2,17,"dummy"
"109389",1,3,0,4,"dummy"
"109390",3,4,2,9,"dummy"
"109391",0,2,0,2,"dummy"
"109424",0,1,1,2,"dummy"
"109425",0,0,0,0,"dummy"
"109426",0,0,1,1,"dummy"
"109435",4,0,1,5,"dummy"
"109439",0,1,0,1,"dummy"
"109440",1,2,1,4,"dummy"
"109441",2,0,1,3,"dummy"
"109442",0,1,0,1,"dummy"
"109443",0,1,0,1,"dummy"
"109463",0,3,0,3,"dummy"
"109464",1,1,0,2,"dummy"
"109465",0,1,0,1,"dummy"
"109466",3,7,2,12,"dummy"
"109479",0,0,1,1,"dummy"
"109482",0,2,1,3,"dummy"
"109483",0,1,1,2,"dummy"
"109484",1,2,2,5,"dummy"
"109485",0,1,0,1,"dummy"
"109486",0,0,2,2,"dummy"
"109487",9,0,3,12,"dummy"
"109492",0,1,0,1,"dummy"
"109493",0,0,0,0,"dummy"
"109494",0,1,0,1,"dummy"
"109495",0,3,0,3,"dummy"
"109496",0,0,1,1,"dummy"
"109497",0,4,0,4,"dummy"
"109498",0,1,0,1,"dummy"
"109499",1,1,0,2,"dummy"
"109500",2,0,1,3,"dummy"
"109501",2,0,0,2,"dummy"
"109502",0,1,0,1,"dummy"
"109503",1,0,0,1,"dummy"
"109507",8,1,0,9,"dummy"
"109508",0,1,0,1,"dummy"
"109577",1,0,2,3,"dummy"
"109292",2,5,5,12,"dummy"
"109293",5,6,1,12,"dummy"
"109294",2,1,1,4,"dummy"
"109297",0,1,1,2,"dummy"
"109302",1,0,0,1,"dummy"
"109316",2,1,0,3,"dummy"
"109317",0,4,0,4,"dummy"
"109318",0,0,1,1,"dummy"
"109319",4,5,0,9,"dummy"
"109320",0,1,0,1,"dummy"
"109323",2,0,2,4,"dummy"
"109326",0,1,0,1,"dummy"
"109327",0,0,1,1,"dummy"
"109347",0,0,1,1,"dummy"
"109348",0,0,0,0,"dummy"
"109358",0,1,0,1,"dummy"
"109359",0,1,0,1,"dummy"
"109371",1,0,0,1,"dummy"
"109372",8,8,2,18,"dummy"
"109373",0,1,0,1,"dummy"
"109374",0,1,0,1,"dummy"
"109395",3,0,0,3,"dummy"
"109396",0,0,0,0,"dummy"
"109397",0,1,1,2,"dummy"
"109398",1,0,0,1,"dummy"
"109399",5,0,1,6,"dummy"
"109400",1,3,0,4,"dummy"
"109401",0,1,0,1,"dummy"
"109402",0,0,1,1,"dummy"
"109403",0,2,3,5,"dummy"
"109410",0,19,0,19,"dummy"
"109411",0,2,0,2,"dummy"
"109412",0,3,0,3,"dummy"
"109413",3,8,5,16,"dummy"
"109414",8,5,9,22,"dummy"
"109415",5,0,1,6,"dummy"
"109416",0,1,1,2,"dummy"
"109417",4,4,0,8,"dummy"
"109418",5,7,1,13,"dummy"
"109419",3,0,0,3,"dummy"
"109420",0,1,0,1,"dummy"
"109428",3,8,2,13,"dummy"
"109431",0,1,0,1,"dummy"
"109437",0,0,2,2,"dummy"
"109455",0,2,0,2,"dummy"
"109470",0,0,1,1,"dummy"
"109471",0,1,0,1,"dummy"
"109472",0,0,0,0,"dummy"
"109473",0,0,0,0,"dummy"
"109476",0,0,1,1,"dummy"
"109477",2,2,0,4,"dummy"
"109489",0,0,1,1,"dummy"
"109490",0,0,2,2,"dummy"
"109505",0,0,0,0,"dummy"
"109510",0,1,0,1,"dummy"
"109511",2,0,2,4,"dummy"
"109512",0,1,0,1,"dummy"
"109517",0,5,0,5,"dummy"
"109518",5,0,0,5,"dummy"
"109521",0,0,1,1,"dummy"
"109522",1,0,0,1,"dummy"
"109534",0,0,0,0,"dummy"
"109535",0,0,0,0,"dummy"
"109536",0,0,0,0,"dummy"
"109537",0,0,1,1,"dummy"
"109538",0,0,1,1,"dummy"
"109539",0,0,1,1,"dummy"
"109540",0,0,0,0,"dummy"
"109541",0,0,0,0,"dummy"
"109542",0,0,0,0,"dummy"
"109543",0,0,0,0,"dummy"
"109544",0,0,1,1,"dummy"
"109545",0,0,0,0,"dummy"
"109546",0,0,0,0,"dummy"
"109547",0,0,0,0,"dummy"
"109548",0,0,0,0,"dummy"
"109549",0,0,0,0,"dummy"
"109550",0,0,0,0,"dummy"
"109551",0,0,1,1,"dummy"
"109552",0,0,0,0,"dummy"
"109553",0,0,0,0,"dummy"
"109554",0,0,0,0,"dummy"
"109555",0,0,0,0,"dummy"
"109556",0,0,0,0,"dummy"
"109557",0,0,0,0,"dummy"
"109558",0,0,0,0,"dummy"
"109559",0,0,1,1,"dummy"
"109560",0,0,0,0,"dummy"
"109561",0,0,0,0,"dummy"
"109562",0,1,0,1,"dummy"
"109563",0,0,0,0,"dummy"
"109564",0,0,0,0,"dummy"
"109565",0,0,0,0,"dummy"
"109566",0,0,0,0,"dummy"
"109567",0,0,0,0,"dummy"
"109568",0,0,0,0,"dummy"
"109569",0,0,0,0,"dummy"
"109570",0,0,0,0,"dummy"
"109571",0,0,0,0,"dummy"
"109572",0,0,0,0,"dummy"
"109573",0,0,0,0,"dummy"
"109574",0,0,0,0,"dummy"
"109575",0,1,0,1,"dummy"
"109581",0,0,0,0,"dummy"
"109584",0,1,1,2,"dummy"
"109587",0,3,0,3,"dummy"
"109588",0,2,0,2,"dummy"
"109589",1,3,0,4,"dummy"
"109590",6,5,0,11,"dummy"
"109599",0,1,0,1,"dummy"
"109600",0,1,0,1,"dummy"
"109601",0,0,0,0,"dummy"
"109602",0,0,1,1,"dummy"
"109619",1,0,0,1,"dummy"
"109622",0,1,0,1,"dummy"
"109625",2,5,3,10,"dummy"
"109670",2,0,0,2,"dummy"
"109696",0,0,1,1,"dummy"
"109699",0,0,1,1,"dummy"
"109700",0,0,1,1,"dummy"
"109701",1,0,0,1,"dummy"
"109707",2,0,0,2,"dummy"
"109710",0,0,2,2,"dummy"
"109711",0,1,0,1,"dummy"
"109712",2,2,4,8,"dummy"
"109713",0,0,1,1,"dummy"
"109726",1,0,0,1,"dummy"
"109727",0,0,1,1,"dummy"
"109728",0,2,0,2,"dummy"
"109729",3,9,1,13,"dummy"
"109730",1,16,0,17,"dummy"
"109731",0,0,1,1,"dummy"
"109732",1,1,0,2,"dummy"
"109733",0,0,1,1,"dummy"
"109734",3,1,1,5,"dummy"
"109735",2,2,1,5,"dummy"
"109736",0,1,0,1,"dummy"
"109740",0,0,1,1,"dummy"
"109741",0,1,0,1,"dummy"
"109742",0,4,0,4,"dummy"
"109743",4,3,0,7,"dummy"
"109744",0,4,0,4,"dummy"
"109751",2,2,0,4,"dummy"
"109752",2,6,2,10,"dummy"
"109753",0,0,1,1,"dummy"
"109754",0,0,2,2,"dummy"
"109757",2,2,0,4,"dummy"
"109762",0,0,1,1,"dummy"
"109596",1,1,0,2,"dummy"
"109597",0,0,2,2,"dummy"
"109604",2,8,2,12,"dummy"
"109605",3,2,0,5,"dummy"
"109606",0,2,0,2,"dummy"
"109609",0,0,2,2,"dummy"
"109610",0,0,1,1,"dummy"
"109613",0,1,0,1,"dummy"
"109614",0,8,0,8,"dummy"
"109615",0,2,0,2,"dummy"
"109616",0,2,0,2,"dummy"
"109617",8,12,1,21,"dummy"
"109668",0,3,0,3,"dummy"
"109672",0,0,4,4,"dummy"
"109673",0,0,0,0,"dummy"
"109674",0,0,1,1,"dummy"
"109675",0,2,1,3,"dummy"
"109676",2,0,2,4,"dummy"
"109677",0,2,1,3,"dummy"
"109678",0,0,1,1,"dummy"
"109679",0,0,1,1,"dummy"
"109680",0,0,1,1,"dummy"
"109681",0,0,2,2,"dummy"
"109682",0,0,1,1,"dummy"
"109683",0,0,1,1,"dummy"
"109684",0,2,0,2,"dummy"
"109685",4,2,0,6,"dummy"
"109686",0,2,0,2,"dummy"
"109687",0,0,1,1,"dummy"
"109688",0,0,1,1,"dummy"
"109689",0,0,1,1,"dummy"
"109690",0,0,1,1,"dummy"
"109691",0,0,1,1,"dummy"
"109692",5,2,1,8,"dummy"
"109693",0,4,1,5,"dummy"
"109694",3,1,0,4,"dummy"
"109703",0,1,0,1,"dummy"
"109704",0,0,1,1,"dummy"
"109705",0,1,0,1,"dummy"
"109717",1,5,2,8,"dummy"
"109718",1,0,2,3,"dummy"
"109719",0,2,1,3,"dummy"
"109720",1,4,0,5,"dummy"
"109721",0,3,0,3,"dummy"
"109722",4,4,0,8,"dummy"
"109723",5,4,0,9,"dummy"
"109724",0,0,3,3,"dummy"
"109738",1,0,0,1,"dummy"
"109759",0,1,0,1,"dummy"
"109760",0,0,0,0,"dummy"
"109766",1,2,0,3,"dummy"
"109853",2,2,0,4,"dummy"
"109858",0,0,0,0,"dummy"
"109859",3,0,1,4,"dummy"
"109860",3,2,0,5,"dummy"
"109861",0,0,1,1,"dummy"
"109862",0,0,0,0,"dummy"
"109863",0,8,0,8,"dummy"
"109864",0,0,0,0,"dummy"
"109865",0,3,0,3,"dummy"
"109866",0,0,0,0,"dummy"
"109867",2,0,0,2,"dummy"
"109868",0,0,0,0,"dummy"
"109869",0,0,0,0,"dummy"
"109870",0,0,0,0,"dummy"
"109763",3,0,0,3,"dummy"
"109764",0,1,1,2,"dummy"
"109768",0,0,0,0,"dummy"
"109791",0,1,0,1,"dummy"
"109792",0,0,2,2,"dummy"
"109805",0,0,1,1,"dummy"
"109806",0,1,0,1,"dummy"
"109807",0,2,1,3,"dummy"
"109808",1,0,1,2,"dummy"
"109809",0,1,5,6,"dummy"
"109810",0,0,5,5,"dummy"
"109811",1,0,2,3,"dummy"
"109812",2,2,0,4,"dummy"
"109813",2,3,2,7,"dummy"
"109814",1,1,0,2,"dummy"
"109815",0,2,1,3,"dummy"
"109816",1,1,0,2,"dummy"
"109817",0,0,1,1,"dummy"
"109818",0,6,0,6,"dummy"
"109819",4,0,0,4,"dummy"
"109844",2,2,2,6,"dummy"
"109845",0,4,0,4,"dummy"
"109846",1,5,0,6,"dummy"
"109847",1,2,0,3,"dummy"
"109851",0,0,1,1,"dummy"
"109879",0,0,1,1,"dummy"
"109880",0,0,1,1,"dummy"
"109881",0,2,1,3,"dummy"
"109882",2,0,0,2,"dummy"
"109886",0,0,1,1,"dummy"
"109894",1,0,2,3,"dummy"
"109895",0,3,0,3,"dummy"
"109896",0,2,0,2,"dummy"
"109897",0,0,1,1,"dummy"
"109898",0,3,1,4,"dummy"
"109903",1,0,0,1,"dummy"
"109924",0,0,0,0,"dummy"
"109925",0,5,0,5,"dummy"
"109932",0,0,1,1,"dummy"
"109933",2,1,0,3,"dummy"
"109941",4,0,2,6,"dummy"
"109945",4,3,3,10,"dummy"
"109951",0,2,0,2,"dummy"
"109970",0,1,1,2,"dummy"
"109971",0,2,1,3,"dummy"
"109972",1,2,0,3,"dummy"
"109973",1,2,0,3,"dummy"
"109974",0,0,1,1,"dummy"
"109975",0,0,2,2,"dummy"
"109978",1,3,0,4,"dummy"
"109979",4,7,0,11,"dummy"
"109980",0,0,0,0,"dummy"
"109981",0,0,1,1,"dummy"
"110007",0,0,1,1,"dummy"
"110010",0,8,0,8,"dummy"
"110011",0,8,1,9,"dummy"
"110012",0,1,0,1,"dummy"
"110022",0,4,0,4,"dummy"
"110023",0,2,0,2,"dummy"
"110024",0,1,0,1,"dummy"
"110025",1,0,0,1,"dummy"
"110026",3,13,3,19,"dummy"
"110027",0,1,0,1,"dummy"
"110028",0,1,1,2,"dummy"
"110029",0,0,1,1,"dummy"
"110030",5,5,0,10,"dummy"
"110031",1,0,1,2,"dummy"
"110032",7,1,1,9,"dummy"
"110033",1,0,1,2,"dummy"
"110034",0,4,0,4,"dummy"
"110035",0,0,1,1,"dummy"
"109871",2,1,0,3,"dummy"
"109872",0,0,0,0,"dummy"
"109873",1,0,0,1,"dummy"
"109874",0,1,0,1,"dummy"
"109875",8,0,0,8,"dummy"
"109884",1,3,0,4,"dummy"
"109905",0,1,1,2,"dummy"
"109906",0,0,2,2,"dummy"
"109935",0,0,3,3,"dummy"
"109936",0,0,4,4,"dummy"
"109937",0,0,3,3,"dummy"
"109943",0,0,2,2,"dummy"
"109947",0,1,1,2,"dummy"
"109948",0,0,0,0,"dummy"
"109949",0,3,1,4,"dummy"
"109962",0,1,1,2,"dummy"
"109963",2,0,0,2,"dummy"
"109966",0,0,1,1,"dummy"
"109967",0,0,1,1,"dummy"
"109968",2,0,1,3,"dummy"
"110014",2,1,5,8,"dummy"
"110015",2,0,0,2,"dummy"
"110016",0,0,1,1,"dummy"
"110017",0,0,2,2,"dummy"
"110020",3,3,0,6,"dummy"
"110047",0,0,1,1,"dummy"
"110048",0,0,0,0,"dummy"
"110051",0,0,1,1,"dummy"
"110052",0,1,0,1,"dummy"
"110062",0,2,0,2,"dummy"
"110082",0,0,0,0,"dummy"
"110093",0,2,1,3,"dummy"
"110094",0,0,1,1,"dummy"
"110095",2,0,1,3,"dummy"
"110096",2,0,1,3,"dummy"
"110099",1,3,3,7,"dummy"
"110100",0,0,2,2,"dummy"
"110101",2,3,1,6,"dummy"
"110102",0,1,0,1,"dummy"
"110103",1,0,0,1,"dummy"
"110106",1,0,0,1,"dummy"
"110107",2,0,1,3,"dummy"
"110108",0,0,0,0,"dummy"
"110109",0,1,0,1,"dummy"
"110110",8,1,0,9,"dummy"
"110111",0,0,0,0,"dummy"
"110112",0,0,0,0,"dummy"
"110113",1,10,0,11,"dummy"
"110036",0,0,1,1,"dummy"
"110037",0,0,1,1,"dummy"
"110038",0,1,0,1,"dummy"
"110039",0,0,1,1,"dummy"
"110040",0,0,2,2,"dummy"
"110041",0,0,1,1,"dummy"
"110060",5,1,0,6,"dummy"
"110064",0,1,0,1,"dummy"
"110065",4,5,1,10,"dummy"
"110066",1,2,0,3,"dummy"
"110067",0,1,0,1,"dummy"
"110070",2,0,0,2,"dummy"
"110071",0,0,1,1,"dummy"
"110072",0,1,0,1,"dummy"
"110073",2,0,0,2,"dummy"
"110074",1,6,0,7,"dummy"
"110075",0,0,4,4,"dummy"
"110078",0,1,0,1,"dummy"
"110079",0,0,1,1,"dummy"
"110080",0,0,0,0,"dummy"
"110084",0,1,0,1,"dummy"
"110087",0,0,0,0,"dummy"
"110088",0,1,0,1,"dummy"
"110091",0,1,0,1,"dummy"
"110117",0,0,2,2,"dummy"
"110118",0,0,1,1,"dummy"
"110119",1,2,2,5,"dummy"
"110120",0,0,1,1,"dummy"
"110121",2,1,3,6,"dummy"
"110122",0,0,1,1,"dummy"
"110123",1,2,1,4,"dummy"
"110114",7,1,0,8,"dummy"
"110115",2,0,3,5,"dummy"
"110134",11,8,3,22,"dummy"
"110135",1,0,0,1,"dummy"
"110139",0,19,0,19,"dummy"
"110140",12,3,1,16,"dummy"
"110141",9,8,0,17,"dummy"
"110149",0,0,1,1,"dummy"
"110150",0,0,1,1,"dummy"
"110151",0,0,2,2,"dummy"
"110152",0,0,1,1,"dummy"
"110153",0,0,0,0,"dummy"
"110166",0,0,1,1,"dummy"
"110167",0,1,0,1,"dummy"
"110168",0,2,0,2,"dummy"
"110169",0,0,0,0,"dummy"
"110170",1,0,0,1,"dummy"
"110171",0,1,0,1,"dummy"
"110173",0,0,0,0,"dummy"
"110174",0,12,0,12,"dummy"
"110175",0,17,0,17,"dummy"
"110176",0,2,0,2,"dummy"
"110177",0,1,0,1,"dummy"
"110178",16,7,1,24,"dummy"
"110179",2,0,0,2,"dummy"
"110183",3,2,1,6,"dummy"
"110184",0,0,2,2,"dummy"
"110185",6,4,0,10,"dummy"
"110186",4,6,0,10,"dummy"
"110187",6,7,0,13,"dummy"
"110188",0,0,3,3,"dummy"
"110189",0,2,0,2,"dummy"
"110190",0,2,0,2,"dummy"
"110191",0,0,3,3,"dummy"
"110193",0,12,0,12,"dummy"
"110194",2,15,4,21,"dummy"
"110196",0,2,0,2,"dummy"
"110197",0,0,1,1,"dummy"
"110198",0,0,1,1,"dummy"
"110199",8,10,3,21,"dummy"
"110200",2,2,0,4,"dummy"
"110201",3,3,1,7,"dummy"
"110204",0,2,0,2,"dummy"
"110205",2,7,0,9,"dummy"
"110207",0,0,1,1,"dummy"
"110208",0,0,1,1,"dummy"
"110209",0,0,2,2,"dummy"
"110210",26,3,7,36,"dummy"
"110235",2,2,0,4,"dummy"
"110236",0,2,0,2,"dummy"
"110237",0,1,0,1,"dummy"
"110238",0,2,0,2,"dummy"
"110239",0,3,0,3,"dummy"
"110240",2,3,0,5,"dummy"
"110241",0,7,0,7,"dummy"
"110242",0,1,0,1,"dummy"
"110243",0,0,2,2,"dummy"
"110264",0,1,0,1,"dummy"
"110266",0,1,0,1,"dummy"
"110267",0,1,0,1,"dummy"
"110268",0,0,1,1,"dummy"
"110269",0,0,2,2,"dummy"
"110270",1,1,0,2,"dummy"
"110271",2,4,1,7,"dummy"
"110272",1,1,0,2,"dummy"
"110273",0,3,0,3,"dummy"
"110274",0,0,0,0,"dummy"
"110275",0,3,0,3,"dummy"
"110276",0,1,2,3,"dummy"
"110277",2,2,3,7,"dummy"
"110278",0,0,1,1,"dummy"
"110279",0,0,0,0,"dummy"
"110280",9,14,2,25,"dummy"
"110281",17,9,1,27,"dummy"
"110282",0,0,1,1,"dummy"
"110291",1,8,0,9,"dummy"
"110293",1,3,0,4,"dummy"
"110295",0,0,4,4,"dummy"
"110296",8,0,0,8,"dummy"
"110298",1,14,1,16,"dummy"
"110300",0,0,1,1,"dummy"
"110301",0,5,0,5,"dummy"
"110302",5,1,0,6,"dummy"
"110303",1,0,0,1,"dummy"
"110304",0,0,1,1,"dummy"
"110307",4,4,0,8,"dummy"
"110308",8,10,2,20,"dummy"
"110309",0,0,0,0,"dummy"
"110311",0,0,1,1,"dummy"
"110312",0,0,1,1,"dummy"
"110313",0,0,1,1,"dummy"
"110316",0,0,1,1,"dummy"
"110317",0,0,1,1,"dummy"
"110320",1,0,3,4,"dummy"
"110321",4,7,4,15,"dummy"
"110322",0,0,1,1,"dummy"
"110323",0,0,1,1,"dummy"
"110324",0,0,1,1,"dummy"
"110325",0,1,2,3,"dummy"
"110326",0,2,0,2,"dummy"
"110327",2,8,1,11,"dummy"
"110328",1,4,0,5,"dummy"
"110329",0,1,0,1,"dummy"
"110330",3,4,2,9,"dummy"
"110331",1,0,0,1,"dummy"
"110332",0,0,0,0,"dummy"
"110333",0,0,1,1,"dummy"
"110334",5,0,4,9,"dummy"
"110335",0,0,0,0,"dummy"
"110336",1,7,1,9,"dummy"
"110337",2,10,3,15,"dummy"
"110338",1,3,1,5,"dummy"
"110341",0,7,0,7,"dummy"
"110342",1,0,1,2,"dummy"
"110344",1,1,2,4,"dummy"
"110345",0,0,0,0,"dummy"
"110346",9,7,0,16,"dummy"
"110347",0,0,1,1,"dummy"
"110348",2,3,0,5,"dummy"
"110349",2,2,0,4,"dummy"
"110350",0,0,0,0,"dummy"
"110351",0,0,1,1,"dummy"
"110352",1,2,0,3,"dummy"
"110353",0,3,0,3,"dummy"
"110354",3,0,0,3,"dummy"
"110356",0,2,2,4,"dummy"
"110357",0,1,0,1,"dummy"
"110358",0,0,1,1,"dummy"
"110359",0,1,0,1,"dummy"
"110361",3,5,0,8,"dummy"
"110364",0,0,1,1,"dummy"
"110365",0,1,0,1,"dummy"
"110367",0,2,4,6,"dummy"
"110368",0,0,1,1,"dummy"
"110369",0,0,2,2,"dummy"
"110370",0,2,0,2,"dummy"
"110371",6,4,3,13,"dummy"
"110375",1,1,0,2,"dummy"
"110376",4,4,1,9,"dummy"
"110377",2,2,0,4,"dummy"
"110378",1,1,0,2,"dummy"
"110379",0,1,0,1,"dummy"
"110380",0,1,0,1,"dummy"
"110381",2,0,0,2,"dummy"
"110382",0,3,0,3,"dummy"
"110383",0,0,0,0,"dummy"
"110384",0,0,0,0,"dummy"
"110385",0,0,0,0,"dummy"
"110386",6,1,0,7,"dummy"
"110387",0,0,0,0,"dummy"
"110388",1,1,0,2,"dummy"
"110389",5,0,0,5,"dummy"
"110391",0,3,0,3,"dummy"
"110392",0,0,1,1,"dummy"
"110393",4,2,0,6,"dummy"
"110394",3,0,2,5,"dummy"
"110395",1,9,2,12,"dummy"
"110396",4,0,2,6,"dummy"
"110399",1,3,0,4,"dummy"
"110400",0,2,0,2,"dummy"
"110403",0,0,3,3,"dummy"
"110404",0,12,0,12,"dummy"
"110405",0,0,0,0,"dummy"
"110406",0,0,0,0,"dummy"
"110407",0,0,1,1,"dummy"
"110408",1,6,0,7,"dummy"
"110409",0,0,0,0,"dummy"
"110410",4,4,1,9,"dummy"
"110411",1,0,0,1,"dummy"
"110412",0,0,5,5,"dummy"
"110413",0,1,0,1,"dummy"
"110414",44,4,0,48,"dummy"
"110415",4,44,0,48,"dummy"
"110416",31,4,0,35,"dummy"
"110417",1,11,1,13,"dummy"
"110418",0,9,1,10,"dummy"
"110419",20,2,1,23,"dummy"
"110420",10,27,3,40,"dummy"
"110421",20,3,0,23,"dummy"
"110422",9,5,3,17,"dummy"
"110423",4,30,0,34,"dummy"
"110424",0,2,0,2,"dummy"
"110425",0,7,0,7,"dummy"
"110426",1,0,0,1,"dummy"
"110427",4,3,2,9,"dummy"
"110428",0,9,0,9,"dummy"
"110430",0,0,0,0,"dummy"
"110432",3,7,0,10,"dummy"
"110434",0,1,0,1,"dummy"
"110437",4,4,0,8,"dummy"
"110440",0,0,1,1,"dummy"
"110441",0,0,1,1,"dummy"
"110444",0,0,0,0,"dummy"
"110445",0,0,1,1,"dummy"
"110449",4,9,3,16,"dummy"
"110454",0,0,0,0,"dummy"
"110455",0,2,0,2,"dummy"
"110456",0,1,0,1,"dummy"
"110457",0,9,0,9,"dummy"
"110471",2,0,0,2,"dummy"
"110472",0,0,1,1,"dummy"
"110473",0,0,1,1,"dummy"
"110474",0,0,1,1,"dummy"
"110476",21,0,1,22,"dummy"
"110477",0,5,0,5,"dummy"
"110478",0,7,0,7,"dummy"
"110480",0,1,0,1,"dummy"
"110484",0,0,0,0,"dummy"
"110485",0,0,3,3,"dummy"
"110486",0,0,4,4,"dummy"
"110487",0,0,4,4,"dummy"
"110488",2,9,0,11,"dummy"
"110489",1,6,0,7,"dummy"
"110490",0,2,2,4,"dummy"
"110493",0,3,2,5,"dummy"
"110494",0,4,3,7,"dummy"
"110495",0,0,0,0,"dummy"
"110496",0,0,0,0,"dummy"
"110499",0,2,0,2,"dummy"
"110500",0,1,0,1,"dummy"
"110501",7,5,4,16,"dummy"
"110502",0,2,0,2,"dummy"
"110503",0,7,0,7,"dummy"
"110519",0,0,4,4,"dummy"
"110520",2,0,0,2,"dummy"
"110521",0,0,1,1,"dummy"
"110522",0,0,1,1,"dummy"
"110523",0,0,1,1,"dummy"
"110524",0,0,2,2,"dummy"
"110525",0,0,1,1,"dummy"
"110526",0,0,1,1,"dummy"
"110527",0,0,1,1,"dummy"
"110528",0,0,1,1,"dummy"
"110529",1,0,0,1,"dummy"
"110530",2,0,0,2,"dummy"
"110531",0,0,1,1,"dummy"
"110532",0,10,0,10,"dummy"
"110533",0,0,1,1,"dummy"
"110534",2,2,0,4,"dummy"
"110535",0,0,1,1,"dummy"
"110536",0,2,0,2,"dummy"
"110537",0,0,1,1,"dummy"
"110538",1,5,0,6,"dummy"
"110539",0,0,1,1,"dummy"
"110540",0,4,0,4,"dummy"
"110541",2,1,0,3,"dummy"
"110544",1,2,0,3,"dummy"
"110545",1,0,0,1,"dummy"
"110546",10,16,2,28,"dummy"
"110547",0,8,0,8,"dummy"
"110548",0,2,0,2,"dummy"
"110553",2,1,0,3,"dummy"
"110565",0,0,1,1,"dummy"
"110566",0,0,1,1,"dummy"
"110567",0,0,1,1,"dummy"
"110568",0,0,1,1,"dummy"
"110569",1,4,1,6,"dummy"
"110570",5,5,1,11,"dummy"
"110572",0,0,1,1,"dummy"
"110573",0,0,1,1,"dummy"
"110575",0,7,1,8,"dummy"
"110576",0,1,0,1,"dummy"
"110577",0,2,1,3,"dummy"
"110578",0,0,1,1,"dummy"
"110579",0,0,1,1,"dummy"
"110580",0,1,0,1,"dummy"
"110581",0,0,1,1,"dummy"
"110582",0,1,0,1,"dummy"
"110584",0,0,0,0,"dummy"
"110586",0,1,0,1,"dummy"
"110587",0,4,1,5,"dummy"
"110589",0,0,1,1,"dummy"
"110590",0,0,1,1,"dummy"
"110595",0,9,1,10,"dummy"
"110596",0,5,0,5,"dummy"
"110597",0,1,0,1,"dummy"
"110599",3,3,2,8,"dummy"
"110600",0,0,1,1,"dummy"
"110601",1,2,0,3,"dummy"
"110602",0,1,0,1,"dummy"
"110603",0,0,3,3,"dummy"
"110604",0,0,1,1,"dummy"
"110605",0,1,0,1,"dummy"
"110606",0,1,4,5,"dummy"
"110607",0,0,2,2,"dummy"
"110608",0,0,1,1,"dummy"
"110609",0,0,1,1,"dummy"
"110610",0,0,1,1,"dummy"
"110621",0,0,2,2,"dummy"
"110622",5,1,1,7,"dummy"
"110624",1,1,3,5,"dummy"
"110625",0,0,1,1,"dummy"
"110626",0,4,0,4,"dummy"
"110627",0,0,1,1,"dummy"
"110628",3,1,1,5,"dummy"
"110629",0,0,1,1,"dummy"
"110630",0,0,1,1,"dummy"
"110631",0,1,0,1,"dummy"
"110632",0,1,0,1,"dummy"
"110633",1,1,0,2,"dummy"
"110634",4,4,1,9,"dummy"
"110635",4,1,0,5,"dummy"
"110636",1,0,1,2,"dummy"
"110637",0,0,1,1,"dummy"
"110638",0,0,0,0,"dummy"
"110639",0,0,1,1,"dummy"
"110640",1,1,3,5,"dummy"
"110641",0,0,1,1,"dummy"
"110642",0,2,1,3,"dummy"
"110643",0,1,0,1,"dummy"
"110644",1,1,0,2,"dummy"
"110645",4,1,0,5,"dummy"
"110646",0,0,1,1,"dummy"
"110647",1,1,1,3,"dummy"
"110648",0,0,1,1,"dummy"
"110649",0,0,2,2,"dummy"
"110650",0,0,1,1,"dummy"
"110651",0,1,1,2,"dummy"
"110652",0,0,1,1,"dummy"
"110653",1,1,1,3,"dummy"
"110654",0,0,1,1,"dummy"
"110655",0,0,2,2,"dummy"
"110656",0,0,1,1,"dummy"
"110657",0,0,1,1,"dummy"
"110658",0,0,1,1,"dummy"
"110659",7,2,2,11,"dummy"
"110660",0,0,1,1,"dummy"
"110661",0,0,3,3,"dummy"
"110662",0,0,1,1,"dummy"
"110663",0,0,2,2,"dummy"
"110664",0,0,1,1,"dummy"
"110665",2,1,0,3,"dummy"
"110666",0,0,1,1,"dummy"
"110667",0,0,1,1,"dummy"
"110668",0,0,1,1,"dummy"
"110669",0,0,1,1,"dummy"
"110670",0,0,1,1,"dummy"
"110671",0,1,1,2,"dummy"
"110672",0,0,1,1,"dummy"
"110673",0,0,1,1,"dummy"
"110676",0,1,0,1,"dummy"
"110677",11,6,1,18,"dummy"
"110679",0,4,0,4,"dummy"
"110682",0,0,1,1,"dummy"
"110683",4,4,1,9,"dummy"
"110684",0,1,0,1,"dummy"
"110685",5,4,1,10,"dummy"
"110686",1,7,1,9,"dummy"
"110687",0,2,0,2,"dummy"
"110688",0,0,1,1,"dummy"
"110689",3,2,1,6,"dummy"
"110691",7,9,1,17,"dummy"
"110692",0,0,1,1,"dummy"
"110693",0,2,1,3,"dummy"
"110694",0,0,1,1,"dummy"
"110695",0,1,0,1,"dummy"
"110696",0,0,2,2,"dummy"
"110698",0,0,1,1,"dummy"
"110699",0,0,1,1,"dummy"
"110700",0,0,1,1,"dummy"
"110701",0,0,3,3,"dummy"
"110702",0,0,1,1,"dummy"
"110703",0,0,1,1,"dummy"
"110704",10,10,2,22,"dummy"
"110705",0,9,0,9,"dummy"
"110706",4,0,0,4,"dummy"
"110707",0,0,1,1,"dummy"
"110708",0,1,0,1,"dummy"
"110709",0,0,1,1,"dummy"
"110710",0,0,2,2,"dummy"
"110712",0,12,0,12,"dummy"
"110713",0,3,1,4,"dummy"
"110719",4,4,2,10,"dummy"
"110723",2,1,0,3,"dummy"
"110724",0,2,0,2,"dummy"
"110727",0,0,1,1,"dummy"
"110730",0,0,2,2,"dummy"
"110731",1,0,0,1,"dummy"
"110739",0,3,0,3,"dummy"
"110740",0,1,0,1,"dummy"
"110743",0,2,0,2,"dummy"
"110744",0,0,1,1,"dummy"
"110745",0,0,0,0,"dummy"
"110748",5,0,0,5,"dummy"
"110749",6,14,1,21,"dummy"
"110750",1,2,0,3,"dummy"
"110751",2,1,0,3,"dummy"
"110752",3,3,0,6,"dummy"
"110753",1,10,2,13,"dummy"
"110754",9,0,2,11,"dummy"
"110755",0,6,0,6,"dummy"
"110756",13,1,4,18,"dummy"
"110757",1,6,0,7,"dummy"
"110758",0,0,2,2,"dummy"
"110759",0,1,0,1,"dummy"
"110760",0,0,1,1,"dummy"
"110761",0,1,0,1,"dummy"
"110762",2,1,0,3,"dummy"
"110763",0,0,1,1,"dummy"
"110764",10,2,1,13,"dummy"
"110765",0,2,0,2,"dummy"
"110768",0,0,3,3,"dummy"
"110769",0,0,1,1,"dummy"
"110772",0,5,3,8,"dummy"
"110773",0,0,1,1,"dummy"
"110774",0,0,2,2,"dummy"
"110775",0,0,2,2,"dummy"
"110779",0,0,0,0,"dummy"
"110780",0,0,0,0,"dummy"
"110781",0,0,0,0,"dummy"
"110782",0,0,0,0,"dummy"
"110783",0,0,0,0,"dummy"
"110784",1,2,0,3,"dummy"
"110785",2,1,0,3,"dummy"
"110786",0,0,0,0,"dummy"
"110787",0,0,0,0,"dummy"
"110788",0,0,0,0,"dummy"
"110789",0,0,0,0,"dummy"
"110790",0,0,1,1,"dummy"
"110791",0,0,0,0,"dummy"
"110794",0,5,1,6,"dummy"
"110796",0,1,1,2,"dummy"
"110797",0,0,2,2,"dummy"
"110798",0,1,0,1,"dummy"
"110801",0,0,1,1,"dummy"
"110804",0,1,0,1,"dummy"
"110805",1,2,0,3,"dummy"
"110806",0,2,0,2,"dummy"
"110807",0,1,0,1,"dummy"
"110809",3,0,0,3,"dummy"
"110811",0,0,1,1,"dummy"
"110812",0,1,0,1,"dummy"
"110814",0,0,1,1,"dummy"
"110815",0,1,0,1,"dummy"
"110816",0,1,0,1,"dummy"
"110817",0,0,2,2,"dummy"
"110818",0,1,0,1,"dummy"
"110819",0,0,1,1,"dummy"
"110820",0,2,0,2,"dummy"
"110821",0,1,0,1,"dummy"
"110822",0,0,1,1,"dummy"
"110823",0,0,1,1,"dummy"
"110825",0,0,1,1,"dummy"
"110838",0,0,1,1,"dummy"
"110840",3,9,4,16,"dummy"
"110841",11,0,1,12,"dummy"
"110842",0,1,0,1,"dummy"
"110843",0,1,0,1,"dummy"
"110844",0,1,0,1,"dummy"
"110845",0,1,0,1,"dummy"
"110846",0,0,1,1,"dummy"
"110848",3,0,1,4,"dummy"
"110849",2,2,1,5,"dummy"
"110850",1,2,1,4,"dummy"
"110851",0,1,1,2,"dummy"
"110855",0,1,1,2,"dummy"
"110858",0,0,1,1,"dummy"
"110859",1,1,0,2,"dummy"
"110860",0,0,4,4,"dummy"
"110861",0,0,2,2,"dummy"
"110862",0,0,0,0,"dummy"
"110866",0,2,4,6,"dummy"
"110867",0,2,2,4,"dummy"
"110873",5,8,4,17,"dummy"
"110875",0,1,0,1,"dummy"
"110878",0,9,3,12,"dummy"
"110879",1,1,0,2,"dummy"
"110881",0,0,1,1,"dummy"
"110882",0,0,1,1,"dummy"
"110883",0,0,1,1,"dummy"
"110884",0,0,1,1,"dummy"
"110885",12,8,1,21,"dummy"
"110886",2,2,0,4,"dummy"
"110887",1,2,1,4,"dummy"
"110889",0,1,0,1,"dummy"
"110890",0,0,1,1,"dummy"
"110892",0,3,0,3,"dummy"
"110900",1,0,0,1,"dummy"
"110901",2,0,0,2,"dummy"
"110902",2,0,2,4,"dummy"
"110903",0,0,0,0,"dummy"
"110904",1,0,0,1,"dummy"
"110905",0,0,1,1,"dummy"
"110906",0,1,0,1,"dummy"
"110907",0,0,2,2,"dummy"
"110908",4,21,5,30,"dummy"
"110909",17,0,0,17,"dummy"
"110912",0,2,0,2,"dummy"
"110913",3,0,0,3,"dummy"
"110918",0,0,3,3,"dummy"
"110919",0,3,0,3,"dummy"
"110920",0,0,1,1,"dummy"
"110921",3,0,0,3,"dummy"
"110922",12,0,3,15,"dummy"
"110924",0,3,1,4,"dummy"
"110925",1,3,0,4,"dummy"
"110926",4,6,1,11,"dummy"
"110929",0,0,1,1,"dummy"
"110930",0,1,1,2,"dummy"
"110931",1,4,1,6,"dummy"
"110949",0,0,0,0,"dummy"
"110950",5,0,2,7,"dummy"
"110951",0,0,0,0,"dummy"
"110953",2,1,1,4,"dummy"
"110954",0,1,0,1,"dummy"
"110958",4,0,0,4,"dummy"
"110959",0,1,2,3,"dummy"
"110960",0,1,0,1,"dummy"
"110962",2,0,3,5,"dummy"
"110965",0,1,0,1,"dummy"
"110971",0,0,1,1,"dummy"
"110972",0,0,1,1,"dummy"
"110973",0,0,1,1,"dummy"
"110974",0,2,0,2,"dummy"
"110975",0,4,0,4,"dummy"
"110976",0,1,0,1,"dummy"
"110977",0,3,0,3,"dummy"
"110978",3,3,0,6,"dummy"
"110979",3,3,0,6,"dummy"
"110980",0,2,0,2,"dummy"
"110981",0,0,1,1,"dummy"
"110982",0,1,0,1,"dummy"
"110983",0,1,0,1,"dummy"
"110984",3,8,0,11,"dummy"
"110985",0,1,0,1,"dummy"
"110986",0,0,2,2,"dummy"
"110987",0,1,1,2,"dummy"
"110988",0,2,1,3,"dummy"
"110989",0,1,0,1,"dummy"
"110990",1,0,0,1,"dummy"
"110991",6,0,0,6,"dummy"
"110992",2,0,0,2,"dummy"
"111113",2,0,1,3,"dummy"
"111116",2,0,0,2,"dummy"
"111117",0,0,0,0,"dummy"
"111120",0,0,1,1,"dummy"
"111121",0,0,1,1,"dummy"
"111122",0,1,1,2,"dummy"
"111123",1,0,1,2,"dummy"
"111127",0,1,0,1,"dummy"
"111143",0,1,0,1,"dummy"
"111161",0,1,0,1,"dummy"
"111162",1,1,1,3,"dummy"
"111163",6,7,0,13,"dummy"
"111170",3,1,2,6,"dummy"
"111171",0,1,0,1,"dummy"
"111174",6,11,0,17,"dummy"
"111175",18,2,1,21,"dummy"
"111178",1,8,0,9,"dummy"
"111183",26,3,3,32,"dummy"
"111199",0,1,1,2,"dummy"
"111200",1,5,0,6,"dummy"
"111201",4,6,1,11,"dummy"
"111206",3,0,0,3,"dummy"
"111207",2,1,0,3,"dummy"
"111208",1,5,1,7,"dummy"
"111212",0,0,1,1,"dummy"
"111259",1,5,1,7,"dummy"
"111260",0,2,1,3,"dummy"
"111261",3,0,0,3,"dummy"
"111266",1,0,0,1,"dummy"
"111267",0,1,0,1,"dummy"
"111268",0,9,0,9,"dummy"
"111269",9,3,0,12,"dummy"
"111279",3,3,0,6,"dummy"
"111280",0,0,1,1,"dummy"
"111281",0,0,0,0,"dummy"
"111282",2,1,1,4,"dummy"
"111283",0,0,0,0,"dummy"
"111284",2,4,2,8,"dummy"
"111285",1,3,1,5,"dummy"
"111286",0,0,0,0,"dummy"
"111287",0,1,0,1,"dummy"
"111288",1,2,0,3,"dummy"
"111291",0,2,0,2,"dummy"
"111292",1,0,1,2,"dummy"
"111293",24,20,6,50,"dummy"
"111294",0,0,1,1,"dummy"
"111295",1,4,0,5,"dummy"
"111303",0,0,1,1,"dummy"
"111309",1,4,1,6,"dummy"
"111312",0,1,0,1,"dummy"
"111330",0,3,4,7,"dummy"
"110996",0,0,0,0,"dummy"
"111001",0,1,0,1,"dummy"
"111040",4,2,6,12,"dummy"
"111041",5,0,1,6,"dummy"
"111042",0,5,1,6,"dummy"
"111046",3,8,0,11,"dummy"
"111047",0,1,0,1,"dummy"
"111048",0,0,1,1,"dummy"
"111049",2,6,0,8,"dummy"
"111050",14,14,0,28,"dummy"
"111051",0,2,0,2,"dummy"
"111052",0,0,1,1,"dummy"
"111053",0,8,0,8,"dummy"
"111125",0,0,3,3,"dummy"
"111129",0,3,0,3,"dummy"
"111130",1,1,0,2,"dummy"
"111131",0,0,1,1,"dummy"
"111132",0,0,1,1,"dummy"
"111133",0,0,2,2,"dummy"
"111134",0,1,0,1,"dummy"
"111135",0,1,0,1,"dummy"
"111136",4,10,2,16,"dummy"
"111137",0,0,3,3,"dummy"
"111138",8,2,1,11,"dummy"
"111139",2,8,1,11,"dummy"
"111145",13,2,0,15,"dummy"
"111148",0,0,0,0,"dummy"
"111149",1,0,0,1,"dummy"
"111150",0,0,1,1,"dummy"
"111151",2,0,0,2,"dummy"
"111152",0,0,1,1,"dummy"
"111153",0,1,0,1,"dummy"
"111154",0,2,0,2,"dummy"
"111155",0,0,0,0,"dummy"
"111156",0,0,0,0,"dummy"
"111157",4,0,0,4,"dummy"
"111158",0,0,0,0,"dummy"
"111159",0,0,0,0,"dummy"
"111165",0,0,3,3,"dummy"
"111166",0,0,1,1,"dummy"
"111167",0,0,0,0,"dummy"
"111168",0,7,0,7,"dummy"
"111210",0,0,1,1,"dummy"
"111216",3,0,0,3,"dummy"
"111219",0,11,0,11,"dummy"
"111220",14,0,1,15,"dummy"
"111221",0,3,0,3,"dummy"
"111222",0,1,0,1,"dummy"
"111223",0,1,0,1,"dummy"
"111224",0,1,0,1,"dummy"
"111225",2,1,1,4,"dummy"
"111226",0,1,0,1,"dummy"
"111227",0,5,1,6,"dummy"
"111228",0,0,1,1,"dummy"
"111229",0,2,0,2,"dummy"
"111230",1,2,0,3,"dummy"
"111231",1,0,1,2,"dummy"
"111232",3,2,0,5,"dummy"
"111233",1,2,0,3,"dummy"
"111234",3,2,0,5,"dummy"
"111235",0,0,1,1,"dummy"
"111236",3,1,0,4,"dummy"
"111237",1,2,0,3,"dummy"
"111238",2,1,0,3,"dummy"
"111239",0,0,1,1,"dummy"
"111240",0,0,1,1,"dummy"
"111241",0,2,0,2,"dummy"
"111242",1,2,0,3,"dummy"
"111243",0,0,1,1,"dummy"
"111244",1,0,0,1,"dummy"
"111245",0,0,1,1,"dummy"
"111246",0,0,1,1,"dummy"
"111247",0,1,0,1,"dummy"
"111248",0,3,0,3,"dummy"
"111249",1,4,1,6,"dummy"
"111250",20,0,2,22,"dummy"
"111251",0,2,0,2,"dummy"
"111252",0,0,1,1,"dummy"
"111253",1,19,2,22,"dummy"
"111254",0,2,0,2,"dummy"
"111255",21,1,2,24,"dummy"
"111256",0,2,1,3,"dummy"
"111257",0,1,1,2,"dummy"
"111263",3,7,3,13,"dummy"
"111264",8,3,1,12,"dummy"
"111271",0,1,2,3,"dummy"
"111272",6,4,0,10,"dummy"
"111273",2,3,1,6,"dummy"
"111274",0,1,0,1,"dummy"
"111275",0,2,0,2,"dummy"
"111276",0,3,0,3,"dummy"
"111277",0,0,1,1,"dummy"
"111297",0,1,0,1,"dummy"
"111298",0,0,0,0,"dummy"
"111299",0,1,0,1,"dummy"
"111300",1,0,1,2,"dummy"
"111301",0,0,1,1,"dummy"
"111305",0,1,0,1,"dummy"
"111306",0,0,1,1,"dummy"
"111307",0,0,1,1,"dummy"
"111314",2,4,0,6,"dummy"
"111315",0,2,0,2,"dummy"
"111316",0,2,0,2,"dummy"
"111317",10,2,0,12,"dummy"
"111318",0,2,0,2,"dummy"
"111319",0,0,0,0,"dummy"
"111320",0,0,3,3,"dummy"
"111321",0,5,0,5,"dummy"
"111322",1,0,1,2,"dummy"
"111327",10,0,2,12,"dummy"
"111328",1,1,0,2,"dummy"
"111360",0,15,0,15,"dummy"
"111361",0,1,0,1,"dummy"
"111362",0,0,0,0,"dummy"
"111363",6,0,2,8,"dummy"
"111364",0,1,0,1,"dummy"
"111365",0,0,1,1,"dummy"
"111366",0,1,1,2,"dummy"
"111367",0,0,1,1,"dummy"
"111368",0,0,1,1,"dummy"
"111369",0,0,1,1,"dummy"
"111370",0,0,2,2,"dummy"
"111371",2,0,4,6,"dummy"
"111372",0,0,2,2,"dummy"
"111373",0,1,1,2,"dummy"
"111374",1,0,0,1,"dummy"
"111375",0,0,1,1,"dummy"
"111376",0,0,1,1,"dummy"
"111380",0,4,0,4,"dummy"
"111387",0,4,0,4,"dummy"
"111388",2,3,0,5,"dummy"
"111335",0,1,0,1,"dummy"
"111336",0,0,0,0,"dummy"
"111337",0,0,0,0,"dummy"
"111338",13,1,1,15,"dummy"
"111339",0,0,0,0,"dummy"
"111340",0,0,0,0,"dummy"
"111355",0,0,1,1,"dummy"
"111356",0,0,1,1,"dummy"
"111357",0,0,2,2,"dummy"
"111358",26,3,7,36,"dummy"
"111378",5,3,0,8,"dummy"
"111384",0,1,0,1,"dummy"
"111385",0,0,1,1,"dummy"
"111390",0,3,0,3,"dummy"
"111391",0,0,1,1,"dummy"
"111392",0,0,1,1,"dummy"
"111393",0,0,1,1,"dummy"
"111394",0,0,1,1,"dummy"
"111400",1,0,0,1,"dummy"
"111401",2,0,0,2,"dummy"
"111432",0,0,1,1,"dummy"
"111440",2,3,0,5,"dummy"
"111441",59,4,0,63,"dummy"
"111442",3,2,2,7,"dummy"
"111443",0,3,0,3,"dummy"
"111446",0,0,1,1,"dummy"
"111447",3,5,2,10,"dummy"
"111448",0,0,4,4,"dummy"
"111463",0,0,1,1,"dummy"
"111464",2,6,0,8,"dummy"
"111466",0,2,0,2,"dummy"
"111467",0,0,0,0,"dummy"
"111470",0,1,3,4,"dummy"
"111471",5,3,0,8,"dummy"
"111472",1,0,0,1,"dummy"
"111473",0,6,0,6,"dummy"
"111474",1,3,0,4,"dummy"
"111475",6,0,0,6,"dummy"
"111476",0,3,0,3,"dummy"
"111477",0,2,0,2,"dummy"
"111485",0,0,1,1,"dummy"
"111487",2,0,0,2,"dummy"
"111488",0,3,0,3,"dummy"
"111489",0,2,0,2,"dummy"
"111490",4,6,0,10,"dummy"
"111491",0,0,0,0,"dummy"
"111496",0,1,0,1,"dummy"
"111497",0,2,0,2,"dummy"
"111498",0,1,1,2,"dummy"
"111502",0,4,0,4,"dummy"
"111523",0,0,1,1,"dummy"
"111524",0,0,1,1,"dummy"
"111525",0,0,1,1,"dummy"
"111526",0,0,1,1,"dummy"
"111527",0,0,1,1,"dummy"
"111528",0,0,1,1,"dummy"
"111529",0,1,1,2,"dummy"
"111530",0,0,1,1,"dummy"
"111531",0,0,1,1,"dummy"
"111532",0,0,1,1,"dummy"
"111533",0,0,1,1,"dummy"
"111534",0,0,1,1,"dummy"
"111535",0,0,1,1,"dummy"
"111536",0,1,0,1,"dummy"
"111537",0,0,1,1,"dummy"
"111547",2,0,0,2,"dummy"
"111550",2,15,4,21,"dummy"
"111554",0,0,1,1,"dummy"
"111555",0,0,1,1,"dummy"
"111556",0,1,0,1,"dummy"
"111558",0,3,0,3,"dummy"
"111559",0,1,0,1,"dummy"
"111560",3,7,2,12,"dummy"
"111565",0,1,0,1,"dummy"
"111566",0,0,0,0,"dummy"
"111567",1,2,0,3,"dummy"
"111568",2,2,0,4,"dummy"
"111569",2,8,0,10,"dummy"
"111570",1,2,0,3,"dummy"
"111571",0,1,3,4,"dummy"
"111572",1,1,0,2,"dummy"
"111573",1,0,3,4,"dummy"
"111574",0,1,3,4,"dummy"
"111575",0,1,0,1,"dummy"
"111576",10,6,2,18,"dummy"
"111577",2,0,0,2,"dummy"
"111578",0,0,1,1,"dummy"
"111579",2,2,0,4,"dummy"
"111580",1,4,0,5,"dummy"
"111581",11,3,0,14,"dummy"
"111582",1,1,0,2,"dummy"
"111583",0,1,0,1,"dummy"
"111584",5,2,1,8,"dummy"
"111585",2,0,0,2,"dummy"
"111586",1,2,0,3,"dummy"
"111587",2,0,1,3,"dummy"
"111588",2,1,0,3,"dummy"
"111589",1,2,0,3,"dummy"
"111590",2,1,0,3,"dummy"
"111591",2,0,0,2,"dummy"
"111592",0,2,0,2,"dummy"
"111593",0,0,1,1,"dummy"
"111594",7,1,0,8,"dummy"
"111595",2,0,0,2,"dummy"
"111596",1,0,1,2,"dummy"
"111597",1,3,3,7,"dummy"
"111598",0,0,3,3,"dummy"
"111599",0,0,1,1,"dummy"
"111600",0,12,0,12,"dummy"
"111601",0,0,0,0,"dummy"
"111602",0,1,0,1,"dummy"
"111603",5,1,0,6,"dummy"
"111604",7,4,3,14,"dummy"
"111605",2,4,0,6,"dummy"
"111632",0,0,2,2,"dummy"
"111634",1,3,0,4,"dummy"
"111635",0,1,0,1,"dummy"
"111636",0,1,0,1,"dummy"
"111637",0,1,1,2,"dummy"
"111638",0,1,0,1,"dummy"
"111643",0,0,1,1,"dummy"
"111664",0,3,1,4,"dummy"
"111665",0,0,1,1,"dummy"
"111668",0,2,0,2,"dummy"
"111669",5,0,0,5,"dummy"
"111670",0,7,0,7,"dummy"
"111671",0,3,0,3,"dummy"
"111673",11,5,2,18,"dummy"
"111674",0,0,1,1,"dummy"
"111675",0,0,1,1,"dummy"
"111676",0,0,1,1,"dummy"
"111677",0,0,1,1,"dummy"
"111678",0,0,1,1,"dummy"
"111679",0,2,0,2,"dummy"
"111680",0,0,1,1,"dummy"
"111683",0,2,0,2,"dummy"
"111684",0,3,0,3,"dummy"
"111685",0,2,0,2,"dummy"
"111687",0,0,1,1,"dummy"
"111688",1,2,0,3,"dummy"
"111690",0,2,1,3,"dummy"
"111691",1,5,1,7,"dummy"
"111702",0,1,0,1,"dummy"
"111704",6,7,4,17,"dummy"
"111705",0,1,0,1,"dummy"
"111707",3,2,1,6,"dummy"
"111708",0,0,1,1,"dummy"
"111709",0,0,1,1,"dummy"
"111711",1,0,0,1,"dummy"
"111717",0,0,7,7,"dummy"
"111720",1,0,2,3,"dummy"
"111721",0,1,2,3,"dummy"
"111722",0,1,0,1,"dummy"
"111723",0,0,0,0,"dummy"
"111724",0,0,1,1,"dummy"
"111725",0,0,3,3,"dummy"
"111726",0,0,3,3,"dummy"
"111727",0,0,4,4,"dummy"
"111728",2,3,1,6,"dummy"
"111737",4,1,0,5,"dummy"
"111738",2,0,1,3,"dummy"
"111739",3,1,0,4,"dummy"
"111740",0,1,0,1,"dummy"
"111744",0,6,0,6,"dummy"
"111745",0,6,0,6,"dummy"
"111746",8,0,0,8,"dummy"
"111747",2,2,1,5,"dummy"
"111748",0,2,0,2,"dummy"
"111749",6,2,2,10,"dummy"
"111750",0,0,1,1,"dummy"
"111751",0,2,0,2,"dummy"
"111754",0,0,0,0,"dummy"
"111756",0,1,0,1,"dummy"
"111757",0,1,0,1,"dummy"
"111758",0,1,0,1,"dummy"
"111759",0,1,0,1,"dummy"
"111760",0,0,0,0,"dummy"
"111761",0,4,0,4,"dummy"
"111762",0,0,1,1,"dummy"
"111763",0,1,0,1,"dummy"
"111764",0,3,0,3,"dummy"
"111768",0,0,1,1,"dummy"
"111769",0,0,1,1,"dummy"
"111771",0,4,0,4,"dummy"
"111772",4,8,0,12,"dummy"
"111774",0,0,0,0,"dummy"
"111775",0,0,1,1,"dummy"
"111776",0,0,1,1,"dummy"
"111777",0,0,1,1,"dummy"
"111783",4,1,0,5,"dummy"
"111784",1,0,0,1,"dummy"
"111785",1,0,0,1,"dummy"
"111795",7,6,1,14,"dummy"
"111796",0,4,0,4,"dummy"
"111798",4,5,3,12,"dummy"
"111799",5,2,0,7,"dummy"
"111801",0,0,0,0,"dummy"
"111802",0,0,0,0,"dummy"
"111805",0,1,0,1,"dummy"
"111807",0,1,0,1,"dummy"
"111808",0,1,0,1,"dummy"
"111809",0,7,0,7,"dummy"
"111810",0,2,0,2,"dummy"
"111811",1,1,0,2,"dummy"
"111812",14,4,2,20,"dummy"
"111813",4,0,0,4,"dummy"
"111815",0,0,1,1,"dummy"
"111818",0,0,1,1,"dummy"
"111819",1,3,1,5,"dummy"
"111822",2,2,2,6,"dummy"
"111823",7,12,0,19,"dummy"
"111824",4,1,0,5,"dummy"
"111825",0,1,0,1,"dummy"
"111826",0,2,0,2,"dummy"
"111831",0,0,1,1,"dummy"
"111832",8,8,1,17,"dummy"
"111836",0,2,0,2,"dummy"
"111837",0,1,0,1,"dummy"
"111839",0,0,1,1,"dummy"
"111840",0,1,0,1,"dummy"
"111856",13,8,3,24,"dummy"
"111857",0,0,0,0,"dummy"
"111859",0,1,0,1,"dummy"
"111860",0,0,1,1,"dummy"
"111861",3,0,3,6,"dummy"
"111862",0,2,0,2,"dummy"
"111863",0,1,0,1,"dummy"
"111865",0,1,0,1,"dummy"
"111866",0,0,2,2,"dummy"
"111867",0,0,1,1,"dummy"
"111871",1,0,0,1,"dummy"
"111872",8,1,3,12,"dummy"
"111874",0,1,0,1,"dummy"
"111875",10,0,1,11,"dummy"
"111876",6,14,2,22,"dummy"
"111877",3,2,2,7,"dummy"
"111884",0,3,0,3,"dummy"
"111885",0,3,0,3,"dummy"
"111886",3,3,0,6,"dummy"
"111888",1,2,1,4,"dummy"
"111889",0,19,0,19,"dummy"
"111890",0,0,1,1,"dummy"
"111891",0,2,1,3,"dummy"
"111892",0,0,1,1,"dummy"
"111893",0,0,1,1,"dummy"
"111894",0,0,1,1,"dummy"
"111895",0,0,1,1,"dummy"
"111896",3,6,3,12,"dummy"
"111897",1,1,0,2,"dummy"
"111898",1,1,0,2,"dummy"
"111899",0,1,0,1,"dummy"
"111900",2,4,1,7,"dummy"
"111960",1,5,0,6,"dummy"
"111961",0,2,0,2,"dummy"
"111970",0,5,0,5,"dummy"
"111971",1,17,0,18,"dummy"
"111972",4,11,0,15,"dummy"
"111973",0,1,0,1,"dummy"
"111974",0,1,0,1,"dummy"
"111976",0,1,0,1,"dummy"
"111981",0,0,0,0,"dummy"
"111982",0,0,1,1,"dummy"
"111983",1,5,2,8,"dummy"
"111984",13,0,1,14,"dummy"
"111985",0,0,1,1,"dummy"
"111986",0,1,0,1,"dummy"
"111987",0,0,1,1,"dummy"
"111988",0,0,1,1,"dummy"
"111989",0,0,1,1,"dummy"
"111990",0,0,1,1,"dummy"
"111995",0,0,0,0,"dummy"
"111996",0,7,0,7,"dummy"
"111998",0,3,0,3,"dummy"
"112003",0,15,0,15,"dummy"
"112004",0,0,2,2,"dummy"
"112005",0,0,1,1,"dummy"
"112006",0,3,1,4,"dummy"
"112007",0,1,0,1,"dummy"
"112008",1,0,0,1,"dummy"
"112009",0,7,0,7,"dummy"
"112010",0,0,1,1,"dummy"
"112011",0,2,1,3,"dummy"
"112014",1,2,1,4,"dummy"
"112022",0,7,0,7,"dummy"
"112023",0,0,2,2,"dummy"
"112024",0,0,1,1,"dummy"
"112025",1,4,0,5,"dummy"
"112026",0,4,0,4,"dummy"
"112027",0,2,1,3,"dummy"
"112028",0,1,0,1,"dummy"
"112032",0,0,6,6,"dummy"
"112033",0,0,7,7,"dummy"
"112035",2,7,1,10,"dummy"
"112039",0,0,1,1,"dummy"
"112040",2,2,4,8,"dummy"
"112041",0,0,4,4,"dummy"
"112042",0,2,5,7,"dummy"
"112043",0,4,1,5,"dummy"
"112049",0,0,1,1,"dummy"
"112051",2,7,0,9,"dummy"
"112052",1,0,0,1,"dummy"
"112053",2,4,1,7,"dummy"
"112054",24,2,1,27,"dummy"
"112060",1,0,1,2,"dummy"
"112062",0,2,2,4,"dummy"
"112063",0,0,1,1,"dummy"
"112065",3,3,0,6,"dummy"
"112066",1,0,0,1,"dummy"
"112068",6,0,4,10,"dummy"
"112069",0,0,1,1,"dummy"
"112071",0,0,0,0,"dummy"
"112072",0,0,3,3,"dummy"
"112073",1,1,0,2,"dummy"
"112074",0,1,0,1,"dummy"
"112075",1,0,0,1,"dummy"
"112083",0,1,0,1,"dummy"
"112085",0,1,0,1,"dummy"
"112086",1,0,0,1,"dummy"
"112088",0,0,1,1,"dummy"
"112089",0,0,0,0,"dummy"
"112092",0,8,1,9,"dummy"
"112095",1,4,0,5,"dummy"
"112096",7,7,1,15,"dummy"
"112103",1,5,0,6,"dummy"
"112106",0,0,1,1,"dummy"
"112108",0,1,0,1,"dummy"
"112109",0,0,1,1,"dummy"
"112111",7,4,1,12,"dummy"
"112112",0,25,0,25,"dummy"
"112113",3,2,1,6,"dummy"
"112114",0,1,0,1,"dummy"
"112115",0,0,1,1,"dummy"
"112116",3,4,2,9,"dummy"
"112117",2,0,0,2,"dummy"
"112118",3,5,6,14,"dummy"
"112119",11,0,7,18,"dummy"
"112120",0,1,0,1,"dummy"
"112122",0,7,0,7,"dummy"
"112123",0,0,1,1,"dummy"
"112124",0,0,1,1,"dummy"
"112125",3,2,1,6,"dummy"
"112126",0,0,1,1,"dummy"
"112127",0,0,3,3,"dummy"
"112128",0,0,1,1,"dummy"
"112131",2,4,7,13,"dummy"
"112132",0,0,2,2,"dummy"
"112138",0,2,0,2,"dummy"
"112139",1,0,1,2,"dummy"
"112140",0,3,0,3,"dummy"
"112141",0,0,1,1,"dummy"
"112142",0,1,0,1,"dummy"
"112148",0,0,2,2,"dummy"
"112149",0,0,1,1,"dummy"
"112151",0,1,0,1,"dummy"
"112152",0,1,3,4,"dummy"
"112154",1,11,4,16,"dummy"
"112155",6,10,7,23,"dummy"
"112156",10,5,7,22,"dummy"
"112157",0,1,0,1,"dummy"
"112160",0,0,1,1,"dummy"
"112163",0,0,1,1,"dummy"
"112164",0,1,2,3,"dummy"
"112165",1,0,1,2,"dummy"
"112166",0,0,2,2,"dummy"
"112167",0,0,2,2,"dummy"
"112168",0,1,3,4,"dummy"
"112169",1,0,1,2,"dummy"
"112170",0,9,2,11,"dummy"
"112171",0,0,0,0,"dummy"
"112172",0,0,2,2,"dummy"
"112173",5,1,2,8,"dummy"
"112175",0,0,1,1,"dummy"
"112176",0,0,3,3,"dummy"
"112182",0,4,1,5,"dummy"
"112183",14,22,0,36,"dummy"
"112184",0,1,0,1,"dummy"
"112185",0,2,0,2,"dummy"
"112186",0,2,0,2,"dummy"
"112187",0,4,0,4,"dummy"
"112188",1,1,0,2,"dummy"
"112189",0,1,0,1,"dummy"
"112190",0,1,0,1,"dummy"
"112191",0,8,0,8,"dummy"
"112193",0,0,2,2,"dummy"
"112196",0,1,0,1,"dummy"
"112197",0,1,0,1,"dummy"
"112198",0,10,0,10,"dummy"
"112200",0,0,1,1,"dummy"
"112201",0,1,0,1,"dummy"
"112202",0,2,0,2,"dummy"
"112203",2,0,1,3,"dummy"
"112204",0,3,1,4,"dummy"
"112205",2,0,1,3,"dummy"
"112206",0,2,0,2,"dummy"
"112207",0,0,1,1,"dummy"
"112254",0,1,0,1,"dummy"
"112257",0,0,3,3,"dummy"
"112258",0,0,0,0,"dummy"
"112259",0,0,1,1,"dummy"
"112263",1,5,0,6,"dummy"
"112264",3,1,0,4,"dummy"
"112265",2,2,0,4,"dummy"
"112266",1,3,0,4,"dummy"
"112267",9,8,5,22,"dummy"
"112268",5,0,1,6,"dummy"
"112269",0,0,1,1,"dummy"
"112277",0,2,0,2,"dummy"
"112278",12,2,0,14,"dummy"
"112283",1,1,0,2,"dummy"
"112284",0,1,0,1,"dummy"
"112285",0,1,0,1,"dummy"
"112286",0,3,0,3,"dummy"
"112313",0,1,0,1,"dummy"
"112314",7,1,3,11,"dummy"
"112315",0,1,0,1,"dummy"
"112316",0,0,0,0,"dummy"
"112317",0,1,0,1,"dummy"
"112318",0,3,0,3,"dummy"
"112327",0,1,0,1,"dummy"
"112328",0,0,1,1,"dummy"
"112329",0,10,0,10,"dummy"
"112370",0,0,1,1,"dummy"
"112371",0,0,1,1,"dummy"
"112372",0,0,1,1,"dummy"
"112376",0,4,0,4,"dummy"
"112377",1,0,0,1,"dummy"
"112382",0,6,0,6,"dummy"
"112383",0,7,1,8,"dummy"
"112384",1,1,0,2,"dummy"
"112385",9,0,2,11,"dummy"
"112395",0,2,0,2,"dummy"
"112410",0,0,1,1,"dummy"
"112411",0,0,3,3,"dummy"
"112414",8,42,4,54,"dummy"
"112425",0,1,0,1,"dummy"
"112434",15,2,4,21,"dummy"
"112435",0,0,1,1,"dummy"
"112436",0,0,1,1,"dummy"
"112437",0,0,1,1,"dummy"
"112445",0,0,1,1,"dummy"
"112473",0,1,0,1,"dummy"
"112474",0,2,0,2,"dummy"
"112209",0,1,0,1,"dummy"
"112210",0,1,0,1,"dummy"
"112211",15,4,1,20,"dummy"
"112212",4,16,1,21,"dummy"
"112213",0,1,0,1,"dummy"
"112214",0,1,0,1,"dummy"
"112215",1,2,0,3,"dummy"
"112216",0,1,0,1,"dummy"
"112217",0,1,0,1,"dummy"
"112228",0,2,0,2,"dummy"
"112231",0,0,1,1,"dummy"
"112234",1,0,0,1,"dummy"
"112235",0,0,1,1,"dummy"
"112236",2,0,0,2,"dummy"
"112237",0,1,0,1,"dummy"
"112238",0,0,0,0,"dummy"
"112239",0,0,1,1,"dummy"
"112242",0,0,0,0,"dummy"
"112243",0,2,1,3,"dummy"
"112244",2,2,0,4,"dummy"
"112245",0,0,0,0,"dummy"
"112246",0,0,0,0,"dummy"
"112247",0,0,0,0,"dummy"
"112248",0,0,0,0,"dummy"
"112249",0,0,0,0,"dummy"
"112250",0,3,0,3,"dummy"
"112251",2,0,0,2,"dummy"
"112252",0,0,0,0,"dummy"
"112261",0,3,0,3,"dummy"
"112271",0,0,6,6,"dummy"
"112272",1,6,8,15,"dummy"
"112273",0,0,0,0,"dummy"
"112274",0,0,1,1,"dummy"
"112275",0,0,1,1,"dummy"
"112288",3,3,2,8,"dummy"
"112289",3,1,0,4,"dummy"
"112295",0,0,3,3,"dummy"
"112296",0,2,0,2,"dummy"
"112297",1,0,0,1,"dummy"
"112298",0,2,1,3,"dummy"
"112299",1,4,0,5,"dummy"
"112300",0,2,0,2,"dummy"
"112301",0,1,0,1,"dummy"
"112302",0,2,0,2,"dummy"
"112303",0,3,0,3,"dummy"
"112306",0,1,2,3,"dummy"
"112307",0,0,0,0,"dummy"
"112308",0,1,0,1,"dummy"
"112309",4,0,2,6,"dummy"
"112310",1,0,0,1,"dummy"
"112311",0,0,0,0,"dummy"
"112320",0,1,0,1,"dummy"
"112321",0,3,0,3,"dummy"
"112322",0,2,0,2,"dummy"
"112323",1,2,1,4,"dummy"
"112324",4,2,1,7,"dummy"
"112325",0,0,0,0,"dummy"
"112340",0,0,0,0,"dummy"
"112341",0,0,1,1,"dummy"
"112342",0,0,1,1,"dummy"
"112343",0,0,1,1,"dummy"
"112344",3,2,1,6,"dummy"
"112345",0,1,1,2,"dummy"
"112346",0,0,1,1,"dummy"
"112347",0,2,0,2,"dummy"
"112348",0,0,1,1,"dummy"
"112374",2,0,2,4,"dummy"
"112387",0,0,1,1,"dummy"
"112388",14,1,2,17,"dummy"
"112389",0,2,0,2,"dummy"
"112390",0,1,2,3,"dummy"
"112391",0,0,0,0,"dummy"
"112392",0,2,0,2,"dummy"
"112393",0,0,1,1,"dummy"
"112402",3,0,0,3,"dummy"
"112403",0,0,1,1,"dummy"
"112404",0,0,1,1,"dummy"
"112405",0,0,1,1,"dummy"
"112406",18,8,0,26,"dummy"
"112460",2,2,0,4,"dummy"
"112465",5,1,1,7,"dummy"
"112468",0,0,1,1,"dummy"
"112469",0,0,1,1,"dummy"
"112470",0,0,2,2,"dummy"
"112471",26,3,7,36,"dummy"
"112476",0,0,0,0,"dummy"
"112479",2,3,2,7,"dummy"
"112480",1,0,0,1,"dummy"
"112493",0,0,1,1,"dummy"
"112494",0,0,0,0,"dummy"
"112495",0,0,1,1,"dummy"
"112498",1,0,2,3,"dummy"
"112499",1,0,0,1,"dummy"
"112526",11,5,4,20,"dummy"
"112527",0,0,1,1,"dummy"
"112528",0,1,0,1,"dummy"
"112532",0,2,2,4,"dummy"
"112533",0,2,2,4,"dummy"
"112534",0,0,2,2,"dummy"
"112535",0,0,2,2,"dummy"
"112536",1,9,0,10,"dummy"
"112574",0,0,1,1,"dummy"
"112579",12,0,1,13,"dummy"
"112584",0,8,0,8,"dummy"
"112585",0,5,0,5,"dummy"
"112586",0,2,0,2,"dummy"
"112587",2,1,0,3,"dummy"
"112588",0,1,2,3,"dummy"
"112589",0,1,0,1,"dummy"
"112593",1,0,0,1,"dummy"
"112596",1,3,1,5,"dummy"
"112597",0,3,0,3,"dummy"
"112598",1,0,0,1,"dummy"
"112599",1,9,0,10,"dummy"
"112600",3,4,0,7,"dummy"
"112601",0,0,1,1,"dummy"
"112602",4,4,1,9,"dummy"
"112603",0,1,0,1,"dummy"
"112604",0,0,1,1,"dummy"
"112605",0,0,1,1,"dummy"
"112606",2,0,2,4,"dummy"
"112633",0,1,2,3,"dummy"
"112634",0,0,0,0,"dummy"
"112635",0,1,0,1,"dummy"
"112636",4,0,2,6,"dummy"
"112637",1,0,0,1,"dummy"
"112638",0,0,0,0,"dummy"
"112646",1,3,0,4,"dummy"
"112647",4,3,0,7,"dummy"
"112648",5,10,0,15,"dummy"
"112649",4,3,0,7,"dummy"
"112650",3,3,0,6,"dummy"
"112651",3,3,0,6,"dummy"
"112652",0,2,0,2,"dummy"
"112653",3,3,0,6,"dummy"
"112654",0,0,1,1,"dummy"
"112655",3,3,0,6,"dummy"
"112656",0,0,1,1,"dummy"
"112657",3,3,3,9,"dummy"
"112658",3,3,3,9,"dummy"
"112659",3,3,3,9,"dummy"
"112501",0,3,1,4,"dummy"
"112502",0,2,0,2,"dummy"
"112503",3,3,1,7,"dummy"
"112504",0,1,0,1,"dummy"
"112505",2,4,3,9,"dummy"
"112506",0,5,0,5,"dummy"
"112518",2,6,2,10,"dummy"
"112530",0,0,1,1,"dummy"
"112538",0,0,1,1,"dummy"
"112545",1,0,0,1,"dummy"
"112546",0,2,0,2,"dummy"
"112547",0,0,1,1,"dummy"
"112552",0,0,1,1,"dummy"
"112553",0,3,0,3,"dummy"
"112554",0,0,1,1,"dummy"
"112557",18,1,0,19,"dummy"
"112558",0,0,1,1,"dummy"
"112570",0,0,1,1,"dummy"
"112591",0,0,1,1,"dummy"
"112608",0,0,1,1,"dummy"
"112609",0,0,1,1,"dummy"
"112610",0,0,1,1,"dummy"
"112611",0,0,1,1,"dummy"
"112612",0,0,1,1,"dummy"
"112613",0,0,1,1,"dummy"
"112614",0,0,1,1,"dummy"
"112615",0,0,1,1,"dummy"
"112616",0,0,1,1,"dummy"
"112617",0,0,1,1,"dummy"
"112618",0,0,1,1,"dummy"
"112619",0,0,1,1,"dummy"
"112620",0,0,1,1,"dummy"
"112621",0,0,1,1,"dummy"
"112622",0,0,1,1,"dummy"
"112623",0,0,1,1,"dummy"
"112624",0,0,1,1,"dummy"
"112625",0,0,1,1,"dummy"
"112626",0,0,1,1,"dummy"
"112627",0,0,1,1,"dummy"
"112628",0,0,1,1,"dummy"
"112631",0,0,0,0,"dummy"
"112640",0,1,2,3,"dummy"
"112641",0,0,0,0,"dummy"
"112642",0,2,0,2,"dummy"
"112643",5,0,2,7,"dummy"
"112644",1,0,0,1,"dummy"
"112667",0,0,2,2,"dummy"
"112668",2,14,0,16,"dummy"
"112669",40,8,2,50,"dummy"
"112670",1,1,0,2,"dummy"
"112671",0,4,0,4,"dummy"
"112672",0,1,0,1,"dummy"
"112673",0,0,0,0,"dummy"
"112682",0,0,1,1,"dummy"
"112675",4,0,3,7,"dummy"
"112676",1,1,0,2,"dummy"
"112679",0,0,0,0,"dummy"
"112680",0,0,0,0,"dummy"
"112684",3,0,0,3,"dummy"
"112685",2,0,1,3,"dummy"
"112686",0,1,0,1,"dummy"
"112702",0,1,0,1,"dummy"
"112707",0,0,1,1,"dummy"
"112709",0,0,0,0,"dummy"
"112711",0,1,1,2,"dummy"
"112720",0,0,0,0,"dummy"
"112725",0,1,0,1,"dummy"
"112726",0,0,0,0,"dummy"
"112728",0,1,0,1,"dummy"
"112729",0,0,2,2,"dummy"
"112730",0,0,1,1,"dummy"
"112732",0,6,0,6,"dummy"
"112733",0,1,0,1,"dummy"
"112736",0,2,0,2,"dummy"
"112741",0,4,0,4,"dummy"
"112742",3,7,4,14,"dummy"
"112745",14,14,5,33,"dummy"
"112746",4,5,1,10,"dummy"
"112747",14,9,1,24,"dummy"
"112751",0,2,0,2,"dummy"
"112753",0,0,1,1,"dummy"
"112760",0,0,1,1,"dummy"
"112785",0,3,1,4,"dummy"
"112788",0,1,0,1,"dummy"
"112789",0,1,0,1,"dummy"
"112790",0,2,0,2,"dummy"
"112791",1,0,0,1,"dummy"
"112792",0,2,0,2,"dummy"
"112815",0,1,0,1,"dummy"
"112816",0,0,0,0,"dummy"
"112818",1,1,0,2,"dummy"
"112819",0,0,1,1,"dummy"
"112820",0,0,1,1,"dummy"
"112823",0,2,0,2,"dummy"
"112825",0,0,1,1,"dummy"
"112826",0,2,0,2,"dummy"
"112827",0,0,2,2,"dummy"
"112828",5,2,4,11,"dummy"
"112829",0,1,0,1,"dummy"
"112830",0,1,0,1,"dummy"
"112831",0,0,0,0,"dummy"
"112832",0,0,0,0,"dummy"
"112833",0,0,0,0,"dummy"
"112834",0,0,0,0,"dummy"
"112843",2,0,0,2,"dummy"
"112844",6,7,5,18,"dummy"
"112845",0,0,5,5,"dummy"
"112856",0,8,0,8,"dummy"
"112857",0,3,0,3,"dummy"
"112858",3,0,0,3,"dummy"
"112859",0,1,0,1,"dummy"
"112860",1,3,0,4,"dummy"
"112861",0,1,0,1,"dummy"
"112862",0,3,0,3,"dummy"
"112863",0,4,0,4,"dummy"
"112864",8,3,0,11,"dummy"
"112865",3,5,1,9,"dummy"
"112866",1,8,0,9,"dummy"
"112867",0,1,0,1,"dummy"
"112868",0,1,0,1,"dummy"
"112869",1,0,1,2,"dummy"
"112870",0,2,0,2,"dummy"
"112871",0,0,1,1,"dummy"
"112872",2,3,1,6,"dummy"
"112873",0,21,0,21,"dummy"
"112874",1,1,0,2,"dummy"
"112875",2,3,0,5,"dummy"
"112876",3,5,0,8,"dummy"
"112877",3,11,0,14,"dummy"
"112878",9,4,0,13,"dummy"
"112879",1,8,0,9,"dummy"
"112880",0,4,0,4,"dummy"
"112881",3,5,12,20,"dummy"
"112882",0,1,4,5,"dummy"
"112883",0,1,0,1,"dummy"
"112884",0,1,0,1,"dummy"
"112886",1,7,0,8,"dummy"
"112888",0,0,1,1,"dummy"
"112889",0,0,1,1,"dummy"
"112890",0,6,0,6,"dummy"
"112898",0,1,0,1,"dummy"
"112899",0,1,1,2,"dummy"
"112900",25,8,4,37,"dummy"
"112902",0,0,1,1,"dummy"
"112903",0,0,1,1,"dummy"
"112904",2,0,0,2,"dummy"
"112906",0,0,0,0,"dummy"
"112908",0,0,2,2,"dummy"
"112909",0,1,0,1,"dummy"
"112921",2,5,0,7,"dummy"
"112922",0,1,0,1,"dummy"
"112925",2,0,0,2,"dummy"
"112926",0,1,0,1,"dummy"
"112927",0,1,0,1,"dummy"
"112928",1,0,0,1,"dummy"
"112929",2,12,0,14,"dummy"
"112930",37,0,2,39,"dummy"
"112931",0,3,0,3,"dummy"
"112932",0,0,2,2,"dummy"
"112933",4,0,0,4,"dummy"
"112934",1,0,0,1,"dummy"
"112935",1,0,0,1,"dummy"
"112936",0,0,1,1,"dummy"
"112938",0,4,0,4,"dummy"
"112939",0,0,1,1,"dummy"
"112948",0,1,0,1,"dummy"
"112958",0,0,1,1,"dummy"
"112960",1,0,2,3,"dummy"
"112961",0,1,2,3,"dummy"
"112962",0,1,0,1,"dummy"
"112963",0,0,0,0,"dummy"
"112964",0,0,1,1,"dummy"
"112965",0,0,3,3,"dummy"
"112966",0,0,3,3,"dummy"
"112967",0,0,4,4,"dummy"
"112968",2,3,1,6,"dummy"
"112975",1,0,0,1,"dummy"
"112976",1,0,1,2,"dummy"
"112977",0,0,0,0,"dummy"
"112978",1,3,0,4,"dummy"
"112979",0,0,1,1,"dummy"
"112980",0,0,0,0,"dummy"
"112981",6,3,3,12,"dummy"
"112982",3,2,0,5,"dummy"
"112983",0,0,1,1,"dummy"
"112996",0,0,0,0,"dummy"
"112999",1,1,0,2,"dummy"
"113016",1,2,1,4,"dummy"
"113017",5,3,3,11,"dummy"
"113018",1,4,0,5,"dummy"
"113025",0,0,1,1,"dummy"
"113026",0,1,2,3,"dummy"
"113027",0,0,2,2,"dummy"
"113028",0,0,1,1,"dummy"
"113029",0,0,1,1,"dummy"
"113030",3,0,6,9,"dummy"
"113051",0,0,1,1,"dummy"
"113052",3,3,2,8,"dummy"
"113053",1,0,0,1,"dummy"
"113054",12,0,4,16,"dummy"
"113055",0,1,0,1,"dummy"
"113056",1,1,1,3,"dummy"
"113057",0,3,1,4,"dummy"
"113058",0,0,2,2,"dummy"
"113059",0,7,0,7,"dummy"
"113060",4,1,0,5,"dummy"
"113061",1,12,0,13,"dummy"
"113062",0,0,1,1,"dummy"
"113063",0,5,0,5,"dummy"
"113064",12,13,1,26,"dummy"
"113065",0,12,0,12,"dummy"
"113066",0,0,3,3,"dummy"
"113067",4,5,3,12,"dummy"
"113068",0,0,3,3,"dummy"
"113069",12,0,1,13,"dummy"
"113070",0,0,2,2,"dummy"
"113071",0,0,1,1,"dummy"
"113072",1,0,0,1,"dummy"
"113073",0,0,3,3,"dummy"
"113074",17,25,0,42,"dummy"
"113075",0,4,0,4,"dummy"
"113076",1,2,1,4,"dummy"
"113077",0,1,0,1,"dummy"
"113078",0,1,0,1,"dummy"
"113079",0,1,0,1,"dummy"
"113080",1,3,0,4,"dummy"
"113081",5,1,0,6,"dummy"
"113082",0,1,0,1,"dummy"
"113083",1,3,0,4,"dummy"
"113084",1,0,1,2,"dummy"
"113085",0,1,0,1,"dummy"
"113086",0,1,1,2,"dummy"
"113087",0,0,1,1,"dummy"
"113088",0,2,0,2,"dummy"
"113089",0,1,0,1,"dummy"
"113092",0,0,1,1,"dummy"
"113093",0,0,1,1,"dummy"
"113094",0,0,3,3,"dummy"
"113095",0,1,2,3,"dummy"
"113100",0,0,0,0,"dummy"
"113101",1,4,1,6,"dummy"
"113102",8,5,3,16,"dummy"
"113103",2,5,2,9,"dummy"
"113104",0,1,0,1,"dummy"
"113105",3,9,0,12,"dummy"
"113106",1,0,0,1,"dummy"
"113113",0,0,0,0,"dummy"
"113114",0,0,2,2,"dummy"
"113121",0,2,0,2,"dummy"
"113126",0,0,0,0,"dummy"
"113127",0,0,0,0,"dummy"
"113128",0,1,0,1,"dummy"
"113129",0,0,0,0,"dummy"
"113130",0,0,0,0,"dummy"
"113131",0,0,0,0,"dummy"
"113132",0,0,1,1,"dummy"
"113133",0,6,0,6,"dummy"
"113134",0,0,0,0,"dummy"
"113135",0,0,0,0,"dummy"
"113136",0,0,0,0,"dummy"
"113137",0,0,0,0,"dummy"
"113138",0,0,0,0,"dummy"
"113139",0,0,0,0,"dummy"
"113140",6,0,0,6,"dummy"
"113141",0,0,0,0,"dummy"
"113142",0,0,0,0,"dummy"
"113143",0,0,0,0,"dummy"
"113144",0,0,0,0,"dummy"
"112988",0,1,0,1,"dummy"
"112989",0,1,0,1,"dummy"
"112990",6,3,0,9,"dummy"
"112991",0,2,0,2,"dummy"
"112992",8,8,0,16,"dummy"
"113001",2,4,0,6,"dummy"
"113002",0,2,0,2,"dummy"
"113003",0,2,0,2,"dummy"
"113004",10,2,0,12,"dummy"
"113005",0,2,0,2,"dummy"
"113006",0,0,0,0,"dummy"
"113007",0,0,3,3,"dummy"
"113008",0,5,0,5,"dummy"
"113011",0,0,0,0,"dummy"
"113014",0,0,0,0,"dummy"
"113020",0,0,1,1,"dummy"
"113021",0,0,3,3,"dummy"
"113032",0,0,0,0,"dummy"
"113033",0,3,0,3,"dummy"
"113034",0,2,0,2,"dummy"
"113035",0,3,0,3,"dummy"
"113036",0,3,0,3,"dummy"
"113037",0,4,0,4,"dummy"
"113038",0,4,0,4,"dummy"
"113039",0,2,0,2,"dummy"
"113040",0,3,0,3,"dummy"
"113041",0,2,0,2,"dummy"
"113108",0,16,0,16,"dummy"
"113109",2,1,0,3,"dummy"
"113110",0,3,0,3,"dummy"
"113111",1,9,0,10,"dummy"
"113189",0,0,1,1,"dummy"
"113200",0,1,0,1,"dummy"
"113201",0,0,0,0,"dummy"
"113202",0,0,1,1,"dummy"
"113205",0,0,1,1,"dummy"
"113235",0,5,0,5,"dummy"
"113236",1,0,0,1,"dummy"
"113237",0,0,0,0,"dummy"
"113238",0,2,0,2,"dummy"
"113239",0,1,0,1,"dummy"
"113240",0,1,0,1,"dummy"
"113241",0,1,0,1,"dummy"
"113242",0,1,0,1,"dummy"
"113243",0,1,0,1,"dummy"
"113244",0,1,0,1,"dummy"
"113245",1,1,0,2,"dummy"
"113246",0,1,0,1,"dummy"
"113249",0,0,1,1,"dummy"
"113258",4,4,1,9,"dummy"
"113259",0,0,1,1,"dummy"
"113260",1,0,0,1,"dummy"
"113263",1,3,1,5,"dummy"
"113264",2,5,0,7,"dummy"
"113282",0,0,1,1,"dummy"
"113283",6,3,2,11,"dummy"
"113325",0,1,1,2,"dummy"
"113326",0,0,0,0,"dummy"
"113145",0,0,0,0,"dummy"
"113146",0,0,0,0,"dummy"
"113147",0,0,0,0,"dummy"
"113148",0,0,0,0,"dummy"
"113149",0,0,0,0,"dummy"
"113150",0,0,1,1,"dummy"
"113151",0,0,0,0,"dummy"
"113152",0,0,0,0,"dummy"
"113153",0,0,0,0,"dummy"
"113154",0,0,0,0,"dummy"
"113155",0,0,0,0,"dummy"
"113156",0,0,0,0,"dummy"
"113157",0,0,0,0,"dummy"
"113158",0,0,2,2,"dummy"
"113159",0,0,1,1,"dummy"
"113160",0,0,1,1,"dummy"
"113161",0,0,0,0,"dummy"
"113162",0,0,0,0,"dummy"
"113163",0,0,0,0,"dummy"
"113164",0,0,0,0,"dummy"
"113165",0,0,0,0,"dummy"
"113166",0,0,0,0,"dummy"
"113167",0,0,0,0,"dummy"
"113168",0,0,0,0,"dummy"
"113171",0,1,0,1,"dummy"
"113172",0,1,0,1,"dummy"
"113173",0,0,1,1,"dummy"
"113174",0,1,2,3,"dummy"
"113179",0,0,0,0,"dummy"
"113180",0,0,0,0,"dummy"
"113181",0,1,1,2,"dummy"
"113182",0,1,0,1,"dummy"
"113183",0,0,2,2,"dummy"
"113184",0,0,0,0,"dummy"
"113185",1,0,1,2,"dummy"
"113191",0,1,0,1,"dummy"
"113192",4,2,1,7,"dummy"
"113197",0,0,1,1,"dummy"
"113198",0,0,1,1,"dummy"
"113251",0,1,0,1,"dummy"
"113252",1,1,0,2,"dummy"
"113253",0,1,1,2,"dummy"
"113254",1,1,0,2,"dummy"
"113278",0,1,0,1,"dummy"
"113279",9,11,0,20,"dummy"
"113280",0,1,0,1,"dummy"
"113285",0,2,0,2,"dummy"
"113288",0,0,3,3,"dummy"
"113289",0,5,1,6,"dummy"
"113300",0,1,1,2,"dummy"
"113301",2,2,2,6,"dummy"
"113305",0,12,0,12,"dummy"
"113306",0,1,0,1,"dummy"
"113307",0,3,0,3,"dummy"
"113346",0,0,1,1,"dummy"
"113347",0,2,0,2,"dummy"
"113357",0,2,0,2,"dummy"
"113358",0,3,0,3,"dummy"
"113359",3,2,1,6,"dummy"
"113360",4,2,1,7,"dummy"
"113361",1,5,0,6,"dummy"
"113380",0,1,0,1,"dummy"
"113381",0,2,0,2,"dummy"
"113384",3,9,0,12,"dummy"
"113385",2,2,1,5,"dummy"
"113386",1,1,0,2,"dummy"
"113387",1,0,1,2,"dummy"
"113388",0,0,1,1,"dummy"
"113389",0,0,1,1,"dummy"
"113390",1,0,0,1,"dummy"
"113391",0,1,0,1,"dummy"
"113392",0,0,1,1,"dummy"
"113393",0,0,1,1,"dummy"
"113394",0,0,1,1,"dummy"
"113395",0,0,1,1,"dummy"
"113327",4,0,0,4,"dummy"
"113328",0,1,0,1,"dummy"
"113329",0,1,0,1,"dummy"
"113330",3,0,0,3,"dummy"
"113331",12,8,0,20,"dummy"
"113332",0,0,0,0,"dummy"
"113333",8,2,0,10,"dummy"
"113336",1,3,2,6,"dummy"
"113337",0,4,2,6,"dummy"
"113338",2,2,3,7,"dummy"
"113339",0,11,0,11,"dummy"
"113340",0,0,2,2,"dummy"
"113351",2,1,1,4,"dummy"
"113352",1,7,1,9,"dummy"
"113353",0,3,2,5,"dummy"
"113363",0,0,1,1,"dummy"
"113364",0,0,1,1,"dummy"
"113365",0,0,1,1,"dummy"
"113366",0,0,2,2,"dummy"
"113367",0,0,1,1,"dummy"
"113370",1,4,0,5,"dummy"
"113371",0,2,0,2,"dummy"
"113372",0,2,0,2,"dummy"
"113373",1,0,0,1,"dummy"
"113374",0,0,2,2,"dummy"
"113375",2,4,1,7,"dummy"
"113376",0,0,4,4,"dummy"
"113377",0,0,4,4,"dummy"
"113378",0,6,0,6,"dummy"
"113422",0,0,1,1,"dummy"
"113427",0,0,0,0,"dummy"
"113428",4,15,2,21,"dummy"
"113429",0,1,0,1,"dummy"
"113430",0,1,0,1,"dummy"
"113431",6,0,0,6,"dummy"
"113432",2,4,0,6,"dummy"
"113439",0,0,0,0,"dummy"
"113440",0,3,0,3,"dummy"
"113441",5,0,1,6,"dummy"
"113442",1,2,0,3,"dummy"
"113454",0,0,1,1,"dummy"
"113455",1,4,0,5,"dummy"
"113456",1,2,1,4,"dummy"
"113465",0,0,1,1,"dummy"
"113466",0,0,1,1,"dummy"
"113467",0,1,0,1,"dummy"
"113468",0,1,0,1,"dummy"
"113473",2,1,0,3,"dummy"
"113493",0,0,0,0,"dummy"
"113494",0,0,1,1,"dummy"
"113495",1,0,1,2,"dummy"
"113502",0,1,0,1,"dummy"
"113503",1,3,0,4,"dummy"
"113504",4,27,0,31,"dummy"
"113513",0,1,5,6,"dummy"
"113535",0,0,1,1,"dummy"
"113536",1,1,0,2,"dummy"
"113537",1,0,0,1,"dummy"
"113538",1,0,1,2,"dummy"
"113539",0,0,1,1,"dummy"
"113540",0,5,2,7,"dummy"
"113541",5,0,2,7,"dummy"
"113542",0,1,0,1,"dummy"
"113543",0,5,2,7,"dummy"
"113544",0,0,1,1,"dummy"
"113545",0,0,0,0,"dummy"
"113546",8,6,1,15,"dummy"
"113547",1,0,0,1,"dummy"
"113548",1,0,0,1,"dummy"
"113549",0,0,0,0,"dummy"
"113550",0,0,0,0,"dummy"
"113584",0,1,0,1,"dummy"
"113585",0,0,1,1,"dummy"
"113586",0,0,2,2,"dummy"
"113587",0,1,1,2,"dummy"
"113396",1,1,0,2,"dummy"
"113397",0,0,1,1,"dummy"
"113398",1,1,0,2,"dummy"
"113399",1,1,0,2,"dummy"
"113400",1,1,0,2,"dummy"
"113401",0,0,1,1,"dummy"
"113402",0,0,1,1,"dummy"
"113403",0,0,1,1,"dummy"
"113404",0,0,1,1,"dummy"
"113405",0,0,1,1,"dummy"
"113406",0,0,1,1,"dummy"
"113407",0,0,1,1,"dummy"
"113408",0,0,1,1,"dummy"
"113409",0,0,1,1,"dummy"
"113410",0,0,1,1,"dummy"
"113411",0,0,0,0,"dummy"
"113412",0,0,1,1,"dummy"
"113413",0,0,1,1,"dummy"
"113414",0,0,1,1,"dummy"
"113415",0,0,1,1,"dummy"
"113416",0,0,1,1,"dummy"
"113417",0,0,1,1,"dummy"
"113418",0,0,1,1,"dummy"
"113419",0,0,1,1,"dummy"
"113420",0,0,1,1,"dummy"
"113434",11,10,1,22,"dummy"
"113437",0,0,3,3,"dummy"
"113447",0,1,2,3,"dummy"
"113448",0,2,0,2,"dummy"
"113449",1,1,0,2,"dummy"
"113450",0,0,1,1,"dummy"
"113451",1,1,0,2,"dummy"
"113452",1,0,0,1,"dummy"
"113458",3,0,0,3,"dummy"
"113459",0,4,0,4,"dummy"
"113460",4,4,0,8,"dummy"
"113461",1,0,0,1,"dummy"
"113462",0,1,0,1,"dummy"
"113463",2,2,0,4,"dummy"
"113475",0,1,0,1,"dummy"
"113476",0,1,0,1,"dummy"
"113477",2,1,0,3,"dummy"
"113478",0,0,0,0,"dummy"
"113483",0,0,1,1,"dummy"
"113488",0,5,0,5,"dummy"
"113489",0,1,0,1,"dummy"
"113490",5,0,0,5,"dummy"
"113491",0,1,0,1,"dummy"
"113497",0,0,2,2,"dummy"
"113500",0,3,0,3,"dummy"
"113515",0,1,0,1,"dummy"
"113516",0,3,0,3,"dummy"
"113517",9,9,0,18,"dummy"
"113518",9,9,0,18,"dummy"
"113519",1,1,0,2,"dummy"
"113520",0,5,1,6,"dummy"
"113521",0,0,3,3,"dummy"
"113522",0,0,3,3,"dummy"
"113523",1,0,0,1,"dummy"
"113524",0,1,0,1,"dummy"
"113527",0,0,0,0,"dummy"
"113528",0,0,0,0,"dummy"
"113529",0,0,0,0,"dummy"
"113533",1,2,2,5,"dummy"
"113593",0,0,1,1,"dummy"
"113594",0,0,1,1,"dummy"
"113597",0,1,0,1,"dummy"
"113598",0,0,0,0,"dummy"
"113599",1,1,0,2,"dummy"
"113600",0,4,1,5,"dummy"
"113601",0,0,0,0,"dummy"
"113609",1,1,0,2,"dummy"
"113618",0,16,2,18,"dummy"
"113619",0,0,0,0,"dummy"
"113620",0,0,1,1,"dummy"
"113621",3,0,0,3,"dummy"
"113622",0,1,0,1,"dummy"
"113590",0,2,0,2,"dummy"
"113591",0,2,0,2,"dummy"
"113603",0,2,0,2,"dummy"
"113604",4,6,0,10,"dummy"
"113605",0,1,0,1,"dummy"
"113606",0,2,0,2,"dummy"
"113607",0,1,0,1,"dummy"
"113613",0,2,0,2,"dummy"
"113614",0,1,0,1,"dummy"
"113637",0,1,0,1,"dummy"
"113642",0,4,0,4,"dummy"
"113643",0,0,1,1,"dummy"
"113644",8,8,0,16,"dummy"
"113647",0,2,0,2,"dummy"
"113648",0,1,0,1,"dummy"
"113649",0,0,1,1,"dummy"
"113650",0,0,1,1,"dummy"
"113651",6,0,0,6,"dummy"
"113652",8,4,3,15,"dummy"
"113653",0,2,0,2,"dummy"
"113654",4,0,0,4,"dummy"
"113655",0,4,0,4,"dummy"
"113656",0,3,1,4,"dummy"
"113657",1,12,0,13,"dummy"
"113658",0,3,0,3,"dummy"
"113666",0,3,0,3,"dummy"
"113667",3,3,3,9,"dummy"
"113668",0,2,1,3,"dummy"
"113669",0,1,0,1,"dummy"
"113670",0,0,3,3,"dummy"
"113671",0,1,3,4,"dummy"
"113672",1,1,0,2,"dummy"
"113673",0,0,0,0,"dummy"
"113678",0,1,0,1,"dummy"
"113679",1,4,0,5,"dummy"
"113680",0,5,0,5,"dummy"
"113681",0,1,0,1,"dummy"
"113682",0,1,0,1,"dummy"
"113691",24,20,3,47,"dummy"
"113692",20,24,5,49,"dummy"
"113693",0,1,0,1,"dummy"
"113694",0,1,0,1,"dummy"
"113695",0,0,2,2,"dummy"
"113696",36,4,0,40,"dummy"
"113697",0,2,0,2,"dummy"
"113698",0,1,0,1,"dummy"
"113699",4,8,1,13,"dummy"
"113700",1,1,0,2,"dummy"
"113701",0,1,1,2,"dummy"
"113706",0,1,0,1,"dummy"
"113709",0,0,1,1,"dummy"
"113714",0,0,1,1,"dummy"
"113715",0,4,0,4,"dummy"
"113716",0,1,0,1,"dummy"
"113717",1,1,0,2,"dummy"
"113718",1,1,0,2,"dummy"
"113719",0,0,2,2,"dummy"
"113720",0,2,0,2,"dummy"
"113721",1,0,0,1,"dummy"
"113727",0,0,0,0,"dummy"
"113728",0,3,0,3,"dummy"
"113729",0,0,1,1,"dummy"
"113730",0,2,0,2,"dummy"
"113731",0,0,1,1,"dummy"
"113732",0,2,0,2,"dummy"
"113733",0,2,0,2,"dummy"
"113734",0,2,0,2,"dummy"
"113745",0,0,1,1,"dummy"
"113760",0,2,0,2,"dummy"
"113763",0,4,0,4,"dummy"
"113768",0,0,1,1,"dummy"
"113780",1,1,0,2,"dummy"
"113781",1,1,4,6,"dummy"
"113782",0,0,1,1,"dummy"
"113783",0,0,1,1,"dummy"
"113784",0,0,1,1,"dummy"
"113785",3,1,0,4,"dummy"
"113623",4,2,3,9,"dummy"
"113624",0,3,2,5,"dummy"
"113625",2,4,0,6,"dummy"
"113626",2,0,0,2,"dummy"
"113627",0,1,0,1,"dummy"
"113628",0,2,4,6,"dummy"
"113631",0,0,2,2,"dummy"
"113660",1,0,0,1,"dummy"
"113661",0,9,0,9,"dummy"
"113664",0,0,0,0,"dummy"
"113711",0,8,0,8,"dummy"
"113712",0,1,0,1,"dummy"
"113736",2,9,4,15,"dummy"
"113737",0,0,1,1,"dummy"
"113738",0,2,0,2,"dummy"
"113741",0,1,0,1,"dummy"
"113747",0,1,0,1,"dummy"
"113748",0,1,0,1,"dummy"
"113749",0,0,1,1,"dummy"
"113750",0,2,0,2,"dummy"
"113751",0,2,0,2,"dummy"
"113758",0,1,0,1,"dummy"
"113765",0,0,1,1,"dummy"
"113766",0,0,2,2,"dummy"
"113770",2,4,0,6,"dummy"
"113771",0,2,0,2,"dummy"
"113772",0,2,0,2,"dummy"
"113773",10,2,0,12,"dummy"
"113774",0,2,0,2,"dummy"
"113775",0,0,0,0,"dummy"
"113776",0,0,3,3,"dummy"
"113777",0,5,0,5,"dummy"
"113778",1,0,1,2,"dummy"
"113819",0,0,0,0,"dummy"
"113820",0,0,0,0,"dummy"
"113821",0,0,0,0,"dummy"
"113829",0,0,1,1,"dummy"
"113830",0,0,2,2,"dummy"
"113831",0,0,1,1,"dummy"
"113934",0,0,0,0,"dummy"
"113935",0,0,1,1,"dummy"
"113936",3,0,0,3,"dummy"
"113937",0,1,0,1,"dummy"
"113938",0,0,1,1,"dummy"
"113939",0,0,0,0,"dummy"
"113940",0,1,0,1,"dummy"
"113941",3,1,0,4,"dummy"
"113942",0,0,1,1,"dummy"
"113943",8,4,1,13,"dummy"
"113786",0,0,1,1,"dummy"
"113787",0,0,1,1,"dummy"
"113788",2,4,4,10,"dummy"
"113789",0,0,3,3,"dummy"
"113790",0,0,1,1,"dummy"
"113791",0,3,0,3,"dummy"
"113792",1,1,0,2,"dummy"
"113793",0,0,1,1,"dummy"
"113794",4,1,0,5,"dummy"
"113795",0,3,1,4,"dummy"
"113796",3,1,1,5,"dummy"
"113797",0,1,0,1,"dummy"
"113798",0,2,0,2,"dummy"
"113799",0,0,1,1,"dummy"
"113800",2,2,1,5,"dummy"
"113801",0,0,1,1,"dummy"
"113802",0,1,1,2,"dummy"
"113803",0,0,1,1,"dummy"
"113804",0,0,2,2,"dummy"
"113805",0,0,1,1,"dummy"
"113806",3,1,1,5,"dummy"
"113807",0,0,1,1,"dummy"
"113808",0,0,1,1,"dummy"
"113809",0,0,1,1,"dummy"
"113810",3,2,2,7,"dummy"
"113811",0,0,1,1,"dummy"
"113812",0,0,2,2,"dummy"
"113813",0,0,1,1,"dummy"
"113814",2,1,0,3,"dummy"
"113815",1,0,0,1,"dummy"
"113816",0,1,1,2,"dummy"
"113817",0,0,1,1,"dummy"
"113823",0,0,1,1,"dummy"
"113824",0,0,1,1,"dummy"
"113825",0,0,1,1,"dummy"
"113833",0,16,0,16,"dummy"
"113834",0,3,0,3,"dummy"
"113878",7,0,0,7,"dummy"
"113914",3,4,1,8,"dummy"
"113915",0,67,0,67,"dummy"
"113916",0,0,1,1,"dummy"
"113917",0,1,0,1,"dummy"
"113918",0,2,0,2,"dummy"
"113919",2,0,0,2,"dummy"
"113920",0,1,0,1,"dummy"
"113921",0,2,0,2,"dummy"
"113922",2,0,1,3,"dummy"
"113923",0,1,0,1,"dummy"
"113924",0,0,1,1,"dummy"
"113925",0,2,0,2,"dummy"
"113926",4,0,0,4,"dummy"
"113927",0,2,0,2,"dummy"
"113928",0,2,0,2,"dummy"
"113929",0,0,1,1,"dummy"
"113930",40,46,21,107,"dummy"
"113931",46,46,23,115,"dummy"
"113932",2,0,0,2,"dummy"
"113950",9,5,0,14,"dummy"
"113951",0,2,0,2,"dummy"
"113952",1,1,1,3,"dummy"
"113955",17,12,5,34,"dummy"
"113956",1,1,0,2,"dummy"
"113957",0,0,0,0,"dummy"
"113958",0,1,0,1,"dummy"
"113959",6,9,5,20,"dummy"
"113960",0,2,0,2,"dummy"
"113961",0,0,1,1,"dummy"
"113962",0,1,2,3,"dummy"
"113963",5,10,12,27,"dummy"
"113981",6,2,1,9,"dummy"
"113982",2,6,1,9,"dummy"
"113983",6,2,1,9,"dummy"
"113984",0,0,0,0,"dummy"
"113988",0,3,5,8,"dummy"
"113989",0,0,0,0,"dummy"
"114006",0,0,1,1,"dummy"
"114007",1,0,0,1,"dummy"
"114008",0,2,0,2,"dummy"
"114009",0,11,1,12,"dummy"
"114010",14,5,2,21,"dummy"
"114011",0,0,0,0,"dummy"
"113944",1,0,0,1,"dummy"
"113945",0,0,0,0,"dummy"
"113946",0,0,0,0,"dummy"
"113979",1,0,0,1,"dummy"
"113986",1,0,2,3,"dummy"
"113993",4,3,5,12,"dummy"
"113994",0,0,1,1,"dummy"
"113995",0,2,2,4,"dummy"
"113996",1,0,0,1,"dummy"
"113997",0,0,0,0,"dummy"
"113998",0,1,0,1,"dummy"
"113999",1,0,0,1,"dummy"
"114024",0,0,1,1,"dummy"
"114031",2,0,0,2,"dummy"
"114032",1,0,0,1,"dummy"
"114041",0,0,0,0,"dummy"
"114042",0,0,0,0,"dummy"
"114043",0,0,0,0,"dummy"
"114044",0,0,1,1,"dummy"
"114052",0,1,0,1,"dummy"
"114053",0,2,1,3,"dummy"
"114054",0,0,0,0,"dummy"
"114082",0,0,1,1,"dummy"
"114083",0,0,1,1,"dummy"
"114084",0,0,1,1,"dummy"
"114085",0,0,1,1,"dummy"
"114097",1,3,1,5,"dummy"
"114098",3,1,0,4,"dummy"
"114099",3,3,1,7,"dummy"
"114100",0,0,2,2,"dummy"
"114101",0,1,0,1,"dummy"
"114102",0,1,0,1,"dummy"
"114110",1,1,1,3,"dummy"
"114130",0,1,0,1,"dummy"
"114131",0,1,0,1,"dummy"
"114132",0,15,0,15,"dummy"
"114133",0,2,0,2,"dummy"
"114134",7,0,0,7,"dummy"
"114135",0,2,0,2,"dummy"
"114196",0,0,1,1,"dummy"
"114197",0,0,2,2,"dummy"
"114198",0,1,1,2,"dummy"
"114199",0,0,1,1,"dummy"
"114200",0,0,1,1,"dummy"
"114201",0,0,1,1,"dummy"
"114202",0,0,1,1,"dummy"
"114203",0,0,1,1,"dummy"
"114014",0,0,1,1,"dummy"
"114015",0,0,0,0,"dummy"
"114026",0,4,0,4,"dummy"
"114027",0,0,3,3,"dummy"
"114028",0,1,0,1,"dummy"
"114029",0,5,1,6,"dummy"
"114039",13,1,1,15,"dummy"
"114048",5,0,2,7,"dummy"
"114049",0,6,2,8,"dummy"
"114050",0,0,0,0,"dummy"
"114064",0,8,0,8,"dummy"
"114065",0,2,0,2,"dummy"
"114066",0,1,0,1,"dummy"
"114067",0,6,3,9,"dummy"
"114068",0,2,0,2,"dummy"
"114069",0,1,0,1,"dummy"
"114070",2,2,2,6,"dummy"
"114071",0,1,1,2,"dummy"
"114072",0,0,1,1,"dummy"
"114073",0,0,1,1,"dummy"
"114074",0,0,2,2,"dummy"
"114075",0,0,1,1,"dummy"
"114076",0,0,1,1,"dummy"
"114077",0,0,1,1,"dummy"
"114078",0,0,1,1,"dummy"
"114079",0,1,0,1,"dummy"
"114080",0,0,1,1,"dummy"
"114094",0,16,2,18,"dummy"
"114095",0,0,0,0,"dummy"
"114104",0,4,2,6,"dummy"
"114105",2,4,0,6,"dummy"
"114106",0,0,1,1,"dummy"
"114107",0,1,1,2,"dummy"
"114108",0,1,0,1,"dummy"
"114114",0,0,2,2,"dummy"
"114115",0,0,1,1,"dummy"
"114116",0,0,1,1,"dummy"
"114117",1,1,0,2,"dummy"
"114120",0,1,1,2,"dummy"
"114137",0,1,0,1,"dummy"
"114138",2,1,1,4,"dummy"
"114205",0,0,0,0,"dummy"
"114217",2,1,0,3,"dummy"
"114218",0,0,2,2,"dummy"
"114219",0,3,0,3,"dummy"
"114220",0,0,1,1,"dummy"
"114223",3,3,5,11,"dummy"
"114224",0,1,0,1,"dummy"
"114225",2,7,2,11,"dummy"
"114229",1,0,0,1,"dummy"
"114230",5,6,0,11,"dummy"
"114231",4,2,2,8,"dummy"
"114232",0,4,0,4,"dummy"
"114235",0,0,1,1,"dummy"
"114236",0,1,0,1,"dummy"
"114237",0,0,1,1,"dummy"
"114241",0,0,1,1,"dummy"
"114242",0,0,1,1,"dummy"
"114260",0,2,0,2,"dummy"
"114261",0,4,0,4,"dummy"
"114262",0,1,0,1,"dummy"
"114263",0,0,1,1,"dummy"
"114264",0,2,0,2,"dummy"
"114265",1,1,0,2,"dummy"
"114266",0,2,0,2,"dummy"
"114268",0,1,0,1,"dummy"
"114271",0,0,0,0,"dummy"
"114289",0,0,1,1,"dummy"
"114291",4,7,0,11,"dummy"
"114298",0,16,3,19,"dummy"
"114299",0,0,1,1,"dummy"
"114300",0,0,0,0,"dummy"
"114301",0,0,0,0,"dummy"
"114302",2,0,0,2,"dummy"
"114309",1,1,4,6,"dummy"
"114312",0,0,1,1,"dummy"
"114314",3,8,0,11,"dummy"
"114316",0,1,0,1,"dummy"
"114317",0,1,0,1,"dummy"
"114318",0,1,0,1,"dummy"
"114319",0,1,0,1,"dummy"
"114320",0,1,0,1,"dummy"
"114321",0,0,1,1,"dummy"
"114322",7,0,0,7,"dummy"
"114323",0,4,0,4,"dummy"
"114324",0,1,1,2,"dummy"
"114325",0,1,0,1,"dummy"
"114326",0,0,1,1,"dummy"
"114331",0,2,0,2,"dummy"
"114332",0,0,1,1,"dummy"
"114333",0,2,0,2,"dummy"
"114344",1,0,3,4,"dummy"
"114345",0,1,1,2,"dummy"
"114346",0,0,1,1,"dummy"
"114347",1,0,0,1,"dummy"
"114349",0,2,0,2,"dummy"
"114351",6,0,0,6,"dummy"
"114352",2,5,2,9,"dummy"
"114359",6,6,1,13,"dummy"
"114360",8,2,3,13,"dummy"
"114361",3,4,0,7,"dummy"
"114362",0,1,0,1,"dummy"
"114363",5,10,5,20,"dummy"
"114364",1,0,0,1,"dummy"
"114365",3,3,0,6,"dummy"
"114366",0,8,0,8,"dummy"
"114367",0,1,0,1,"dummy"
"114368",7,4,0,11,"dummy"
"114369",6,3,1,10,"dummy"
"114370",0,0,1,1,"dummy"
"114371",9,4,1,14,"dummy"
"114372",0,0,0,0,"dummy"
"114375",1,0,0,1,"dummy"
"114376",2,2,0,4,"dummy"
"114377",2,2,0,4,"dummy"
"114378",0,0,1,1,"dummy"
"114380",0,1,0,1,"dummy"
"114381",0,0,1,1,"dummy"
"114384",2,7,3,12,"dummy"
"114385",0,3,1,4,"dummy"
"114387",6,1,0,7,"dummy"
"114388",3,0,2,5,"dummy"
"114389",0,0,0,0,"dummy"
"114390",0,0,0,0,"dummy"
"114391",0,0,0,0,"dummy"
"114392",0,0,1,1,"dummy"
"114393",0,0,0,0,"dummy"
"114394",0,0,0,0,"dummy"
"114397",0,0,1,1,"dummy"
"114411",3,1,1,5,"dummy"
"114414",0,7,1,8,"dummy"
"114415",8,23,1,32,"dummy"
"114416",20,7,2,29,"dummy"
"114417",7,20,2,29,"dummy"
"114419",9,4,1,14,"dummy"
"114421",0,0,1,1,"dummy"
"114431",0,0,1,1,"dummy"
"114432",3,1,1,5,"dummy"
"114433",0,0,0,0,"dummy"
"114434",7,4,7,18,"dummy"
"114441",0,0,1,1,"dummy"
"114442",0,0,1,1,"dummy"
"114444",0,0,0,0,"dummy"
"114445",0,2,0,2,"dummy"
"114450",0,0,0,0,"dummy"
"114454",2,2,1,5,"dummy"
"114455",0,0,0,0,"dummy"
"114456",0,2,3,5,"dummy"
"114457",0,0,10,10,"dummy"
"114458",0,0,1,1,"dummy"
"114459",0,1,1,2,"dummy"
"114460",0,1,0,1,"dummy"
"114461",0,1,0,1,"dummy"
"114462",0,1,1,2,"dummy"
"114463",0,0,0,0,"dummy"
"114464",0,0,1,1,"dummy"
"114465",0,14,3,17,"dummy"
"114466",0,4,10,14,"dummy"
"114467",0,0,5,5,"dummy"
"114468",4,4,3,11,"dummy"
"114470",0,4,0,4,"dummy"
"114471",0,7,0,7,"dummy"
"114472",0,0,1,1,"dummy"
"114473",0,0,1,1,"dummy"
"114474",0,0,1,1,"dummy"
"114477",1,0,1,2,"dummy"
"114478",1,0,0,1,"dummy"
"114479",0,0,1,1,"dummy"
"114480",0,1,1,2,"dummy"
"114481",0,0,0,0,"dummy"
"114482",0,0,1,1,"dummy"
"114483",0,0,1,1,"dummy"
"114484",0,0,1,1,"dummy"
"114485",3,1,0,4,"dummy"
"114486",0,0,3,3,"dummy"
"114487",0,1,0,1,"dummy"
"114488",0,1,0,1,"dummy"
"114489",2,1,0,3,"dummy"
"114490",1,5,0,6,"dummy"
"114492",0,2,0,2,"dummy"
"114493",0,0,1,1,"dummy"
"114494",1,4,1,6,"dummy"
"114495",1,0,0,1,"dummy"
"114497",1,33,0,34,"dummy"
"114499",7,1,4,12,"dummy"
"114500",1,2,1,4,"dummy"
"114501",0,0,2,2,"dummy"
"114503",0,0,1,1,"dummy"
"114504",0,0,1,1,"dummy"
"114508",0,5,0,5,"dummy"
"114510",2,2,0,4,"dummy"
"114511",0,0,1,1,"dummy"
"114512",4,5,0,9,"dummy"
"114513",0,3,0,3,"dummy"
"114514",1,0,0,1,"dummy"
"114515",0,3,0,3,"dummy"
"114516",0,0,2,2,"dummy"
"114517",0,1,1,2,"dummy"
"114518",2,1,0,3,"dummy"
"114519",0,1,7,8,"dummy"
"114520",1,0,1,2,"dummy"
"114521",1,3,0,4,"dummy"
"114522",0,0,1,1,"dummy"
"114523",1,0,3,4,"dummy"
"114524",1,1,2,4,"dummy"
"114525",1,0,0,1,"dummy"
"114526",0,0,2,2,"dummy"
"114527",0,0,2,2,"dummy"
"114528",0,0,1,1,"dummy"
"114529",0,0,2,2,"dummy"
"114534",0,2,0,2,"dummy"
"114535",0,0,0,0,"dummy"
"114536",3,1,0,4,"dummy"
"114537",0,1,0,1,"dummy"
"114538",0,0,0,0,"dummy"
"114539",0,0,0,0,"dummy"
"114540",0,1,0,1,"dummy"
"114541",0,2,0,2,"dummy"
"114542",0,0,0,0,"dummy"
"114543",0,0,2,2,"dummy"
"114544",1,2,1,4,"dummy"
"114545",14,7,4,25,"dummy"
"114546",0,2,0,2,"dummy"
"114547",3,9,1,13,"dummy"
"114548",1,1,0,2,"dummy"
"114549",1,5,0,6,"dummy"
"114550",2,2,0,4,"dummy"
"114556",0,1,0,1,"dummy"
"114557",2,2,2,6,"dummy"
"114558",0,0,0,0,"dummy"
"114559",0,4,0,4,"dummy"
"114560",0,1,0,1,"dummy"
"114561",2,4,2,8,"dummy"
"114562",5,12,5,22,"dummy"
"114563",0,6,0,6,"dummy"
"114564",0,13,0,13,"dummy"
"114565",3,1,4,8,"dummy"
"114566",0,0,1,1,"dummy"
"114567",6,3,1,10,"dummy"
"114568",5,9,2,16,"dummy"
"114569",0,0,0,0,"dummy"
"114570",0,0,0,0,"dummy"
"114571",0,0,1,1,"dummy"
"114573",0,4,1,5,"dummy"
"114574",12,0,2,14,"dummy"
"114575",0,1,0,1,"dummy"
"114576",10,11,5,26,"dummy"
"114577",12,2,1,15,"dummy"
"114582",5,0,0,5,"dummy"
"114583",0,5,0,5,"dummy"
"114586",18,32,2,52,"dummy"
"114587",0,0,1,1,"dummy"
"114590",2,0,2,4,"dummy"
"114592",0,0,1,1,"dummy"
"114593",1,5,0,6,"dummy"
"114594",1,5,1,7,"dummy"
"114595",2,0,0,2,"dummy"
"114596",0,0,1,1,"dummy"
"114599",0,0,1,1,"dummy"
"114600",1,5,0,6,"dummy"
"114602",1,2,0,3,"dummy"
"114603",0,0,1,1,"dummy"
"114604",0,0,1,1,"dummy"
"114605",0,0,1,1,"dummy"
"114606",0,0,1,1,"dummy"
"114608",1,4,0,5,"dummy"
"114615",1,2,0,3,"dummy"
"114616",15,24,2,41,"dummy"
"114617",0,2,1,3,"dummy"
"114618",5,6,2,13,"dummy"
"114619",9,6,1,16,"dummy"
"114620",0,3,0,3,"dummy"
"114621",0,4,0,4,"dummy"
"114622",0,0,1,1,"dummy"
"114625",0,3,6,9,"dummy"
"114626",2,1,6,9,"dummy"
"114627",2,1,5,8,"dummy"
"114628",0,0,1,1,"dummy"
"114636",0,0,1,1,"dummy"
"114666",9,6,2,17,"dummy"
"114667",2,2,0,4,"dummy"
"114672",0,3,3,6,"dummy"
"114675",0,2,0,2,"dummy"
"114679",3,0,0,3,"dummy"
"114697",0,1,0,1,"dummy"
"114698",0,1,0,1,"dummy"
"114699",5,6,3,14,"dummy"
"114700",4,1,2,7,"dummy"
"114701",0,2,0,2,"dummy"
"114702",0,3,1,4,"dummy"
"114703",2,2,1,5,"dummy"
"114704",0,0,0,0,"dummy"
"114705",0,4,0,4,"dummy"
"114706",0,3,0,3,"dummy"
"114707",0,0,0,0,"dummy"
"114708",2,6,1,9,"dummy"
"114709",0,1,0,1,"dummy"
"114714",21,3,3,27,"dummy"
"114715",0,0,1,1,"dummy"
"114718",0,1,0,1,"dummy"
"114726",0,0,0,0,"dummy"
"114727",0,0,1,1,"dummy"
"114728",1,1,0,2,"dummy"
"114729",0,18,0,18,"dummy"
"114730",2,0,0,2,"dummy"
"114731",0,2,1,3,"dummy"
"114732",0,0,0,0,"dummy"
"114733",0,0,0,0,"dummy"
"114737",0,1,0,1,"dummy"
"114738",0,0,0,0,"dummy"
"114752",1,3,3,7,"dummy"
"114753",0,0,0,0,"dummy"
"114754",0,0,1,1,"dummy"
"114632",3,4,0,7,"dummy"
"114640",0,1,0,1,"dummy"
"114641",0,0,0,0,"dummy"
"114642",4,4,0,8,"dummy"
"114643",0,0,0,0,"dummy"
"114644",5,0,0,5,"dummy"
"114645",0,0,0,0,"dummy"
"114646",0,0,0,0,"dummy"
"114649",0,5,0,5,"dummy"
"114677",0,0,0,0,"dummy"
"114681",0,1,0,1,"dummy"
"114688",1,11,0,12,"dummy"
"114689",0,6,0,6,"dummy"
"114690",2,2,4,8,"dummy"
"114691",7,4,0,11,"dummy"
"114692",0,4,0,4,"dummy"
"114695",0,0,1,1,"dummy"
"114720",0,5,0,5,"dummy"
"114721",0,0,0,0,"dummy"
"114722",0,1,0,1,"dummy"
"114723",1,0,0,1,"dummy"
"114724",0,1,0,1,"dummy"
"114735",0,0,2,2,"dummy"
"114740",3,21,2,26,"dummy"
"114741",0,7,1,8,"dummy"
"114742",4,3,2,9,"dummy"
"114747",0,0,1,1,"dummy"
"114750",0,0,0,0,"dummy"
"114756",0,13,0,13,"dummy"
"114757",0,1,0,1,"dummy"
"114760",0,1,0,1,"dummy"
"114761",0,0,1,1,"dummy"
"114763",0,1,0,1,"dummy"
"114765",0,0,2,2,"dummy"
"114766",0,0,1,1,"dummy"
"114767",0,0,1,1,"dummy"
"114768",0,2,2,4,"dummy"
"114769",0,2,0,2,"dummy"
"114770",0,0,1,1,"dummy"
"114771",2,2,1,5,"dummy"
"114772",0,0,2,2,"dummy"
"114773",0,0,2,2,"dummy"
"114774",0,0,2,2,"dummy"
"114775",0,0,2,2,"dummy"
"114776",0,0,1,1,"dummy"
"114777",0,0,2,2,"dummy"
"114778",0,0,2,2,"dummy"
"114779",0,0,2,2,"dummy"
"114780",0,0,2,2,"dummy"
"114781",1,2,1,4,"dummy"
"114782",0,0,2,2,"dummy"
"114783",0,0,1,1,"dummy"
"114784",0,0,2,2,"dummy"
"114785",0,0,1,1,"dummy"
"114786",0,0,2,2,"dummy"
"114787",2,1,2,5,"dummy"
"114788",0,0,2,2,"dummy"
"114789",0,1,0,1,"dummy"
"114790",0,0,2,2,"dummy"
"114791",0,0,1,1,"dummy"
"114792",2,0,0,2,"dummy"
"114793",0,0,1,1,"dummy"
"114794",2,0,0,2,"dummy"
"114795",0,0,1,1,"dummy"
"114811",2,1,2,5,"dummy"
"114812",0,2,2,4,"dummy"
"114813",0,0,2,2,"dummy"
"114814",0,1,0,1,"dummy"
"114816",0,0,1,1,"dummy"
"114837",1,4,1,6,"dummy"
"114838",11,3,1,15,"dummy"
"114839",1,1,0,2,"dummy"
"114840",0,5,1,6,"dummy"
"114841",0,1,0,1,"dummy"
"114842",1,0,1,2,"dummy"
"114843",0,1,0,1,"dummy"
"114844",0,1,0,1,"dummy"
"114845",0,0,1,1,"dummy"
"114846",2,1,0,3,"dummy"
"114847",0,1,0,1,"dummy"
"114866",0,1,0,1,"dummy"
"114867",0,0,1,1,"dummy"
"114868",0,1,1,2,"dummy"
"114869",0,0,1,1,"dummy"
"114870",0,0,3,3,"dummy"
"114871",0,0,1,1,"dummy"
"114889",0,1,1,2,"dummy"
"114890",0,0,1,1,"dummy"
"114891",1,1,0,2,"dummy"
"114892",0,1,0,1,"dummy"
"114893",1,2,1,4,"dummy"
"114894",0,2,1,3,"dummy"
"114895",2,4,0,6,"dummy"
"114896",2,3,2,7,"dummy"
"114897",4,1,0,5,"dummy"
"114898",1,0,0,1,"dummy"
"114899",4,0,2,6,"dummy"
"114900",1,2,0,3,"dummy"
"114901",4,2,2,8,"dummy"
"114902",1,0,0,1,"dummy"
"114903",0,0,1,1,"dummy"
"114904",0,1,0,1,"dummy"
"114910",0,0,1,1,"dummy"
"114920",0,0,1,1,"dummy"
"114923",6,2,2,10,"dummy"
"114924",2,6,2,10,"dummy"
"114925",0,0,1,1,"dummy"
"114944",0,1,0,1,"dummy"
"114945",4,3,2,9,"dummy"
"114962",0,0,1,1,"dummy"
"114981",1,2,0,3,"dummy"
"114982",0,0,1,1,"dummy"
"114988",2,2,0,4,"dummy"
"114989",2,1,0,3,"dummy"
"114990",3,0,0,3,"dummy"
"114991",0,2,0,2,"dummy"
"114992",2,1,0,3,"dummy"
"114993",1,2,2,5,"dummy"
"114994",3,3,3,9,"dummy"
"115015",3,2,2,7,"dummy"
"115018",0,0,0,0,"dummy"
"115019",0,1,0,1,"dummy"
"115020",8,1,0,9,"dummy"
"115021",0,0,0,0,"dummy"
"115022",0,0,0,0,"dummy"
"115023",1,10,0,11,"dummy"
"115024",7,1,0,8,"dummy"
"115025",2,0,3,5,"dummy"
"115037",0,0,1,1,"dummy"
"115038",0,0,0,0,"dummy"
"115039",0,1,0,1,"dummy"
"115040",1,2,0,3,"dummy"
"115041",0,1,0,1,"dummy"
"115042",1,10,1,12,"dummy"
"115043",1,1,0,2,"dummy"
"115044",0,1,0,1,"dummy"
"115045",7,2,0,9,"dummy"
"115046",0,1,0,1,"dummy"
"115047",0,0,1,1,"dummy"
"115048",0,0,2,2,"dummy"
"115049",0,0,1,1,"dummy"
"114849",0,0,0,0,"dummy"
"114850",2,15,1,18,"dummy"
"114851",0,1,2,3,"dummy"
"114852",1,0,1,2,"dummy"
"114853",0,0,1,1,"dummy"
"114854",0,0,1,1,"dummy"
"114855",0,1,0,1,"dummy"
"114856",51,50,2,103,"dummy"
"114857",0,0,1,1,"dummy"
"114858",0,1,2,3,"dummy"
"114859",1,0,0,1,"dummy"
"114860",0,0,16,16,"dummy"
"114861",0,0,2,2,"dummy"
"114862",0,1,0,1,"dummy"
"114863",0,0,1,1,"dummy"
"114864",1,0,0,1,"dummy"
"114885",0,4,0,4,"dummy"
"114906",5,5,1,11,"dummy"
"114907",5,5,1,11,"dummy"
"114908",0,0,1,1,"dummy"
"114912",1,0,4,5,"dummy"
"114913",0,0,2,2,"dummy"
"114916",0,4,1,5,"dummy"
"114927",0,1,0,1,"dummy"
"114928",0,0,0,0,"dummy"
"114929",0,1,1,2,"dummy"
"114930",0,11,0,11,"dummy"
"114931",3,1,0,4,"dummy"
"114932",0,0,1,1,"dummy"
"114941",9,13,0,22,"dummy"
"114942",15,4,3,22,"dummy"
"114957",0,2,0,2,"dummy"
"114958",1,3,0,4,"dummy"
"114959",0,1,1,2,"dummy"
"114960",0,2,1,3,"dummy"
"114964",1,0,1,2,"dummy"
"114967",0,0,0,0,"dummy"
"114968",0,2,0,2,"dummy"
"114984",0,0,1,1,"dummy"
"114985",0,0,1,1,"dummy"
"114986",0,1,0,1,"dummy"
"114998",2,2,0,4,"dummy"
"114999",1,2,0,3,"dummy"
"115004",0,3,0,3,"dummy"
"115005",3,4,1,8,"dummy"
"115006",2,0,0,2,"dummy"
"115009",8,0,0,8,"dummy"
"115010",0,0,0,0,"dummy"
"115011",0,1,0,1,"dummy"
"115027",0,0,1,1,"dummy"
"115028",1,0,1,2,"dummy"
"115029",0,0,1,1,"dummy"
"115030",0,0,1,1,"dummy"
"115031",0,6,3,9,"dummy"
"115032",0,1,0,1,"dummy"
"115033",0,0,0,0,"dummy"
"115061",2,0,0,2,"dummy"
"115062",2,2,0,4,"dummy"
"115065",24,0,3,27,"dummy"
"115066",0,24,2,26,"dummy"
"115067",3,1,0,4,"dummy"
"115068",22,0,2,24,"dummy"
"115073",2,2,0,4,"dummy"
"115074",0,1,0,1,"dummy"
"115075",3,3,0,6,"dummy"
"115076",0,3,0,3,"dummy"
"115077",2,3,0,5,"dummy"
"115078",0,2,0,2,"dummy"
"115081",0,2,1,3,"dummy"
"115082",0,1,0,1,"dummy"
"115083",0,0,1,1,"dummy"
"115084",2,2,1,5,"dummy"
"115085",1,0,0,1,"dummy"
"115054",3,11,0,14,"dummy"
"115055",5,3,0,8,"dummy"
"115056",0,3,0,3,"dummy"
"115057",7,10,1,18,"dummy"
"115070",0,1,1,2,"dummy"
"115071",0,1,0,1,"dummy"
"115089",0,1,0,1,"dummy"
"115092",1,0,1,2,"dummy"
"115096",0,0,1,1,"dummy"
"115097",0,0,1,1,"dummy"
"115098",0,0,1,1,"dummy"
"115101",0,1,0,1,"dummy"
"115105",0,0,3,3,"dummy"
"115111",0,0,1,1,"dummy"
"115112",1,0,0,1,"dummy"
"115113",0,0,0,0,"dummy"
"115114",0,1,1,2,"dummy"
"115131",1,5,1,7,"dummy"
"115132",1,5,3,9,"dummy"
"115148",0,0,1,1,"dummy"
"115153",1,2,0,3,"dummy"
"115163",13,1,2,16,"dummy"
"115164",0,0,1,1,"dummy"
"115167",0,0,1,1,"dummy"
"115168",2,2,0,4,"dummy"
"115176",0,0,1,1,"dummy"
"115177",0,0,1,1,"dummy"
"115178",0,1,1,2,"dummy"
"115179",0,1,0,1,"dummy"
"115180",2,1,0,3,"dummy"
"115181",0,1,0,1,"dummy"
"115182",1,0,0,1,"dummy"
"115183",4,1,0,5,"dummy"
"115186",10,0,0,10,"dummy"
"115187",0,1,0,1,"dummy"
"115188",0,0,1,1,"dummy"
"115198",0,0,2,2,"dummy"
"115203",0,0,1,1,"dummy"
"115204",0,0,1,1,"dummy"
"115205",6,0,4,10,"dummy"
"115214",0,1,0,1,"dummy"
"115218",0,4,0,4,"dummy"
"115219",3,3,1,7,"dummy"
"115220",2,4,1,7,"dummy"
"115221",0,0,0,0,"dummy"
"115224",0,0,1,1,"dummy"
"115234",0,1,0,1,"dummy"
"115235",6,2,4,12,"dummy"
"115236",0,6,5,11,"dummy"
"115237",1,2,2,5,"dummy"
"115238",0,0,0,0,"dummy"
"115241",0,1,0,1,"dummy"
"115242",1,0,0,1,"dummy"
"115243",0,1,0,1,"dummy"
"115244",1,1,0,2,"dummy"
"115245",1,0,0,1,"dummy"
"115254",0,1,0,1,"dummy"
"115255",1,0,1,2,"dummy"
"115258",0,0,1,1,"dummy"
"115259",1,0,0,1,"dummy"
"115260",3,3,0,6,"dummy"
"115261",0,1,0,1,"dummy"
"115262",1,3,2,6,"dummy"
"115266",0,0,2,2,"dummy"
"115267",1,1,3,5,"dummy"
"115272",2,2,0,4,"dummy"
"115273",0,1,0,1,"dummy"
"115094",2,3,0,5,"dummy"
"115107",0,1,0,1,"dummy"
"115116",3,3,0,6,"dummy"
"115117",0,0,2,2,"dummy"
"115118",0,0,1,1,"dummy"
"115119",11,0,0,11,"dummy"
"115120",0,2,0,2,"dummy"
"115121",0,1,1,2,"dummy"
"115122",5,5,0,10,"dummy"
"115123",0,0,1,1,"dummy"
"115126",0,2,0,2,"dummy"
"115127",2,0,0,2,"dummy"
"115128",0,2,0,2,"dummy"
"115129",1,2,0,3,"dummy"
"115140",1,1,0,2,"dummy"
"115155",4,0,0,4,"dummy"
"115156",0,0,0,0,"dummy"
"115157",2,1,0,3,"dummy"
"115158",0,0,0,0,"dummy"
"115159",0,0,1,1,"dummy"
"115170",1,0,0,1,"dummy"
"115173",0,4,0,4,"dummy"
"115174",0,0,1,1,"dummy"
"115190",0,0,1,1,"dummy"
"115191",0,6,0,6,"dummy"
"115192",0,0,2,2,"dummy"
"115193",0,2,0,2,"dummy"
"115194",0,0,0,0,"dummy"
"115195",3,0,4,7,"dummy"
"115196",0,0,1,1,"dummy"
"115200",0,0,1,1,"dummy"
"115201",0,0,1,1,"dummy"
"115207",0,0,1,1,"dummy"
"115208",0,0,1,1,"dummy"
"115209",0,0,1,1,"dummy"
"115210",0,0,1,1,"dummy"
"115216",0,0,0,0,"dummy"
"115247",2,0,1,3,"dummy"
"115248",0,1,1,2,"dummy"
"115249",0,0,1,1,"dummy"
"115250",0,0,0,0,"dummy"
"115251",0,0,0,0,"dummy"
"115252",0,0,0,0,"dummy"
"115264",0,0,1,1,"dummy"
"115269",0,1,0,1,"dummy"
"115270",0,1,0,1,"dummy"
"115275",0,6,0,6,"dummy"
"115276",0,3,0,3,"dummy"
"115282",3,0,2,5,"dummy"
"115291",6,22,2,30,"dummy"
"115292",0,0,1,1,"dummy"
"115293",3,3,1,7,"dummy"
"115294",6,2,0,8,"dummy"
"115295",3,2,2,7,"dummy"
"115296",18,19,0,37,"dummy"
"115297",0,0,0,0,"dummy"
"115314",0,1,0,1,"dummy"
"115315",1,6,0,7,"dummy"
"115323",0,1,0,1,"dummy"
"115324",0,4,3,7,"dummy"
"115325",1,1,0,2,"dummy"
"115329",0,1,0,1,"dummy"
"115330",0,0,1,1,"dummy"
"115288",0,1,0,1,"dummy"
"115289",0,0,1,1,"dummy"
"115303",0,2,0,2,"dummy"
"115304",0,1,1,2,"dummy"
"115305",0,2,1,3,"dummy"
"115306",1,6,4,11,"dummy"
"115309",2,1,0,3,"dummy"
"115310",0,3,0,3,"dummy"
"115327",0,0,2,2,"dummy"
"115403",1,4,1,6,"dummy"
"115404",0,1,0,1,"dummy"
"115405",0,0,1,1,"dummy"
"115406",0,1,0,1,"dummy"
"115407",1,0,0,1,"dummy"
"115408",1,0,0,1,"dummy"
"115409",1,2,1,4,"dummy"
"115410",2,3,0,5,"dummy"
"115411",4,1,0,5,"dummy"
"115412",1,0,0,1,"dummy"
"115414",5,1,2,8,"dummy"
"115415",0,1,0,1,"dummy"
"115417",0,8,0,8,"dummy"
"115418",0,7,0,7,"dummy"
"115419",14,1,0,15,"dummy"
"115420",0,3,0,3,"dummy"
"115423",0,0,2,2,"dummy"
"115426",0,2,0,2,"dummy"
"115428",0,1,1,2,"dummy"
"115429",9,1,3,13,"dummy"
"115430",0,1,2,3,"dummy"
"115433",0,0,0,0,"dummy"
"115435",2,0,0,2,"dummy"
"115436",0,0,1,1,"dummy"
"115437",0,4,0,4,"dummy"
"115438",1,0,0,1,"dummy"
"115439",0,0,1,1,"dummy"
"115442",0,0,3,3,"dummy"
"115445",0,1,0,1,"dummy"
"115447",0,1,0,1,"dummy"
"115451",5,8,0,13,"dummy"
"115452",16,58,0,74,"dummy"
"115455",2,3,4,9,"dummy"
"115456",0,1,2,3,"dummy"
"115457",0,0,1,1,"dummy"
"115458",0,0,1,1,"dummy"
"115459",0,3,2,5,"dummy"
"115461",0,0,0,0,"dummy"
"115462",0,0,0,0,"dummy"
"115463",0,0,1,1,"dummy"
"115464",0,0,2,2,"dummy"
"115465",0,0,1,1,"dummy"
"115466",3,0,0,3,"dummy"
"115467",0,0,0,0,"dummy"
"115468",0,0,0,0,"dummy"
"115477",3,24,1,28,"dummy"
"115478",5,5,0,10,"dummy"
"115480",1,9,2,12,"dummy"
"115483",0,2,0,2,"dummy"
"115485",1,1,0,2,"dummy"
"115486",0,2,0,2,"dummy"
"115487",2,0,1,3,"dummy"
"115494",0,0,0,0,"dummy"
"115498",0,0,1,1,"dummy"
"115499",0,2,0,2,"dummy"
"115500",0,0,1,1,"dummy"
"115501",1,3,3,7,"dummy"
"115505",0,4,0,4,"dummy"
"115506",0,1,0,1,"dummy"
"115513",0,3,0,3,"dummy"
"115514",2,5,1,8,"dummy"
"115515",0,0,1,1,"dummy"
"115516",0,0,0,0,"dummy"
"115518",0,1,0,1,"dummy"
"115537",0,1,0,1,"dummy"
"115539",2,4,0,6,"dummy"
"115540",0,2,0,2,"dummy"
"115541",0,2,0,2,"dummy"
"115542",10,2,0,12,"dummy"
"115543",0,2,0,2,"dummy"
"115548",3,3,0,6,"dummy"
"115549",3,3,0,6,"dummy"
"115550",0,0,3,3,"dummy"
"115551",1,0,0,1,"dummy"
"115552",4,0,0,4,"dummy"
"115554",0,1,0,1,"dummy"
"115556",0,0,1,1,"dummy"
"115559",0,7,4,11,"dummy"
"115560",0,0,1,1,"dummy"
"115561",0,7,0,7,"dummy"
"115562",3,2,0,5,"dummy"
"115564",0,1,0,1,"dummy"
"115566",0,0,1,1,"dummy"
"115586",0,5,0,5,"dummy"
"115587",0,3,0,3,"dummy"
"115589",0,0,1,1,"dummy"
"115591",1,0,0,1,"dummy"
"115594",0,1,0,1,"dummy"
"115595",1,2,1,4,"dummy"
"115596",0,2,0,2,"dummy"
"115597",0,2,0,2,"dummy"
"115598",2,2,0,4,"dummy"
"115600",4,39,1,44,"dummy"
"115601",0,0,1,1,"dummy"
"115602",7,2,3,12,"dummy"
"115603",0,0,0,0,"dummy"
"115604",0,3,0,3,"dummy"
"115605",0,0,8,8,"dummy"
"115606",3,3,11,17,"dummy"
"115609",0,6,0,6,"dummy"
"115614",0,0,1,1,"dummy"
"115615",0,3,0,3,"dummy"
"115616",3,8,1,12,"dummy"
"115658",9,11,3,23,"dummy"
"115659",4,4,1,9,"dummy"
"115660",0,2,0,2,"dummy"
"115661",0,0,2,2,"dummy"
"115662",3,7,0,10,"dummy"
"115667",0,2,0,2,"dummy"
"115671",0,0,1,1,"dummy"
"115673",0,3,0,3,"dummy"
"115674",0,1,0,1,"dummy"
"115675",0,6,1,7,"dummy"
"115676",1,1,1,3,"dummy"
"115677",0,0,0,0,"dummy"
"115678",1,1,0,2,"dummy"
"115679",1,4,0,5,"dummy"
"115680",0,3,0,3,"dummy"
"115681",2,2,0,4,"dummy"
"115682",0,1,0,1,"dummy"
"115683",3,3,0,6,"dummy"
"115684",2,2,0,4,"dummy"
"115685",2,0,0,2,"dummy"
"115686",11,8,2,21,"dummy"
"115691",0,2,0,2,"dummy"
"115694",0,0,0,0,"dummy"
"115695",6,11,3,20,"dummy"
"115696",2,0,0,2,"dummy"
"115697",5,16,2,23,"dummy"
"115698",2,0,0,2,"dummy"
"115699",7,1,0,8,"dummy"
"115701",12,0,3,15,"dummy"
"115702",4,4,0,8,"dummy"
"115703",9,2,0,11,"dummy"
"115712",2,4,0,6,"dummy"
"115713",0,0,1,1,"dummy"
"115714",0,6,0,6,"dummy"
"115716",0,3,0,3,"dummy"
"115718",0,1,6,7,"dummy"
"115719",0,0,2,2,"dummy"
"115720",0,0,2,2,"dummy"
"115721",0,0,2,2,"dummy"
"115735",7,11,1,19,"dummy"
"115736",0,0,1,1,"dummy"
"115737",16,21,5,42,"dummy"
"115738",0,1,1,2,"dummy"
"115739",2,8,0,10,"dummy"
"115740",2,1,0,3,"dummy"
"115741",2,2,1,5,"dummy"
"115742",0,1,1,2,"dummy"
"115743",0,0,1,1,"dummy"
"115744",0,3,1,4,"dummy"
"115745",6,8,0,14,"dummy"
"115746",0,2,0,2,"dummy"
"115747",0,2,0,2,"dummy"
"115791",0,2,0,2,"dummy"
"115792",1,2,1,4,"dummy"
"115793",0,1,1,2,"dummy"
"115796",0,0,2,2,"dummy"
"115799",2,2,1,5,"dummy"
"115800",0,0,3,3,"dummy"
"115804",0,0,1,1,"dummy"
"115808",0,0,1,1,"dummy"
"115809",0,0,1,1,"dummy"
"115810",0,1,0,1,"dummy"
"115811",0,0,1,1,"dummy"
"115812",5,9,4,18,"dummy"
"115813",7,14,4,25,"dummy"
"115814",0,1,1,2,"dummy"
"115815",0,1,0,1,"dummy"
"115816",1,1,1,3,"dummy"
"115817",0,0,1,1,"dummy"
"115818",0,1,0,1,"dummy"
"115819",0,0,1,1,"dummy"
"115820",4,3,0,7,"dummy"
"115822",0,2,0,2,"dummy"
"115823",0,1,0,1,"dummy"
"115824",0,0,1,1,"dummy"
"115825",0,0,0,0,"dummy"
"115826",1,0,0,1,"dummy"
"115828",0,0,1,1,"dummy"
"115830",0,0,2,2,"dummy"
"115837",9,1,1,11,"dummy"
"115853",1,0,0,1,"dummy"
"115862",0,1,0,1,"dummy"
"115863",0,1,0,1,"dummy"
"115866",0,5,3,8,"dummy"
"115867",1,0,0,1,"dummy"
"115868",13,8,0,21,"dummy"
"115869",0,0,1,1,"dummy"
"115870",0,0,0,0,"dummy"
"115871",3,2,0,5,"dummy"
"115872",3,1,0,4,"dummy"
"115873",2,7,0,9,"dummy"
"115874",5,19,1,25,"dummy"
"115879",6,8,3,17,"dummy"
"115880",0,1,0,1,"dummy"
"115887",0,0,1,1,"dummy"
"115892",4,0,0,4,"dummy"
"115897",10,0,2,12,"dummy"
"115898",0,0,0,0,"dummy"
"115899",0,0,1,1,"dummy"
"115904",0,0,2,2,"dummy"
"115905",0,0,1,1,"dummy"
"115906",0,0,2,2,"dummy"
"115915",0,0,1,1,"dummy"
"115929",1,1,1,3,"dummy"
"115943",0,7,0,7,"dummy"
"115951",0,0,1,1,"dummy"
"115952",6,1,1,8,"dummy"
"115953",0,0,1,1,"dummy"
"115954",1,2,1,4,"dummy"
"115955",1,0,0,1,"dummy"
"115956",0,0,1,1,"dummy"
"115957",1,2,1,4,"dummy"
"115958",3,0,0,3,"dummy"
"115959",0,0,0,0,"dummy"
"115960",0,1,0,1,"dummy"
"115961",1,0,0,1,"dummy"
"115962",0,4,1,5,"dummy"
"115963",0,5,1,6,"dummy"
"115964",0,0,1,1,"dummy"
"115965",0,0,0,0,"dummy"
"115966",11,2,1,14,"dummy"
"115967",0,0,1,1,"dummy"
"115968",0,0,1,1,"dummy"
"115969",0,1,0,1,"dummy"
"115970",1,0,0,1,"dummy"
"115971",0,5,0,5,"dummy"
"115972",0,0,1,1,"dummy"
"115973",0,2,0,2,"dummy"
"115974",0,1,0,1,"dummy"
"115975",0,0,0,0,"dummy"
"115976",0,0,2,2,"dummy"
"115977",1,0,2,3,"dummy"
"115978",0,0,1,1,"dummy"
"115979",3,3,0,6,"dummy"
"115980",0,0,1,1,"dummy"
"115981",0,0,1,1,"dummy"
"115982",3,3,2,8,"dummy"
"115983",0,0,1,1,"dummy"
"115984",0,0,1,1,"dummy"
"115985",0,0,1,1,"dummy"
"115986",0,0,2,2,"dummy"
"115987",0,0,2,2,"dummy"
"115988",0,0,2,2,"dummy"
"115989",0,0,2,2,"dummy"
"115990",0,1,0,1,"dummy"
"115991",1,0,0,1,"dummy"
"115992",0,0,2,2,"dummy"
"115993",0,0,2,2,"dummy"
"115994",0,0,2,2,"dummy"
"115995",2,0,0,2,"dummy"
"115996",0,0,0,0,"dummy"
"115997",1,1,0,2,"dummy"
"115998",0,0,2,2,"dummy"
"115999",0,1,0,1,"dummy"
"116000",0,0,2,2,"dummy"
"116001",1,0,0,1,"dummy"
"116002",1,1,0,2,"dummy"
"116003",0,0,0,0,"dummy"
"116004",0,0,0,0,"dummy"
"116005",0,0,1,1,"dummy"
"116006",0,0,1,1,"dummy"
"116007",0,0,1,1,"dummy"
"116008",0,1,1,2,"dummy"
"116009",0,0,1,1,"dummy"
"116010",0,0,1,1,"dummy"
"116011",0,0,1,1,"dummy"
"116012",0,0,1,1,"dummy"
"116013",0,0,1,1,"dummy"
"115841",0,1,0,1,"dummy"
"115842",0,4,1,5,"dummy"
"115843",5,0,1,6,"dummy"
"115844",0,0,1,1,"dummy"
"115845",0,0,1,1,"dummy"
"115846",0,1,1,2,"dummy"
"115847",0,0,1,1,"dummy"
"115848",0,0,2,2,"dummy"
"115849",0,0,1,1,"dummy"
"115850",0,0,1,1,"dummy"
"115851",0,0,1,1,"dummy"
"115860",2,5,2,9,"dummy"
"115882",0,0,1,1,"dummy"
"115883",0,0,2,2,"dummy"
"115884",0,2,0,2,"dummy"
"115885",0,0,2,2,"dummy"
"115889",0,0,1,1,"dummy"
"115890",0,2,1,3,"dummy"
"115917",0,1,0,1,"dummy"
"115918",2,0,0,2,"dummy"
"115919",0,1,0,1,"dummy"
"115920",8,3,0,11,"dummy"
"115923",5,0,0,5,"dummy"
"115931",3,3,0,6,"dummy"
"115934",0,7,3,10,"dummy"
"115935",1,4,1,6,"dummy"
"115936",0,0,0,0,"dummy"
"115937",1,1,0,2,"dummy"
"115938",1,0,0,1,"dummy"
"115939",0,0,1,1,"dummy"
"115940",0,0,1,1,"dummy"
"115941",0,1,0,1,"dummy"
"115947",0,0,1,1,"dummy"
"115948",0,0,1,1,"dummy"
"115949",0,0,1,1,"dummy"
"116033",0,1,0,1,"dummy"
"116084",0,0,2,2,"dummy"
"116085",0,0,4,4,"dummy"
"116086",3,0,0,3,"dummy"
"116099",4,1,1,6,"dummy"
"116100",0,0,2,2,"dummy"
"116101",2,2,0,4,"dummy"
"116104",1,0,0,1,"dummy"
"116108",0,3,0,3,"dummy"
"116135",0,0,1,1,"dummy"
"116136",0,0,1,1,"dummy"
"116137",0,0,1,1,"dummy"
"116140",0,1,0,1,"dummy"
"116141",0,0,1,1,"dummy"
"116142",0,2,0,2,"dummy"
"116143",0,0,1,1,"dummy"
"116144",0,1,0,1,"dummy"
"116145",0,1,0,1,"dummy"
"116146",1,0,1,2,"dummy"
"116147",0,1,0,1,"dummy"
"116167",0,1,0,1,"dummy"
"116168",0,0,1,1,"dummy"
"116183",0,1,0,1,"dummy"
"116260",0,4,0,4,"dummy"
"116261",1,2,1,4,"dummy"
"116262",1,0,0,1,"dummy"
"116263",0,4,0,4,"dummy"
"116264",0,2,0,2,"dummy"
"116014",0,0,1,1,"dummy"
"116015",0,0,1,1,"dummy"
"116016",0,0,1,1,"dummy"
"116017",0,0,1,1,"dummy"
"116018",0,0,1,1,"dummy"
"116019",0,0,1,1,"dummy"
"116020",0,0,1,1,"dummy"
"116021",0,0,1,1,"dummy"
"116022",0,0,1,1,"dummy"
"116023",0,0,1,1,"dummy"
"116024",0,0,1,1,"dummy"
"116025",0,0,1,1,"dummy"
"116026",0,0,1,1,"dummy"
"116027",0,0,1,1,"dummy"
"116028",0,0,1,1,"dummy"
"116029",0,0,1,1,"dummy"
"116030",0,0,1,1,"dummy"
"116031",0,0,1,1,"dummy"
"116035",0,0,2,2,"dummy"
"116036",5,5,1,11,"dummy"
"116037",0,2,1,3,"dummy"
"116038",2,0,1,3,"dummy"
"116039",0,0,1,1,"dummy"
"116040",0,0,1,1,"dummy"
"116041",0,0,1,1,"dummy"
"116042",0,0,1,1,"dummy"
"116043",0,0,1,1,"dummy"
"116044",0,0,1,1,"dummy"
"116045",0,0,1,1,"dummy"
"116046",0,0,1,1,"dummy"
"116047",0,0,1,1,"dummy"
"116048",0,0,1,1,"dummy"
"116049",0,0,1,1,"dummy"
"116050",0,0,1,1,"dummy"
"116051",0,0,1,1,"dummy"
"116052",0,0,1,1,"dummy"
"116053",0,0,1,1,"dummy"
"116054",0,0,1,1,"dummy"
"116055",0,0,1,1,"dummy"
"116056",0,0,1,1,"dummy"
"116057",0,0,1,1,"dummy"
"116058",0,0,1,1,"dummy"
"116059",0,0,1,1,"dummy"
"116060",0,0,1,1,"dummy"
"116061",0,0,1,1,"dummy"
"116062",0,0,1,1,"dummy"
"116063",0,0,1,1,"dummy"
"116066",0,1,0,1,"dummy"
"116067",0,1,0,1,"dummy"
"116068",0,0,1,1,"dummy"
"116069",0,1,0,1,"dummy"
"116070",0,0,1,1,"dummy"
"116080",0,0,0,0,"dummy"
"116088",10,5,0,15,"dummy"
"116089",0,1,0,1,"dummy"
"116090",0,0,1,1,"dummy"
"116091",0,0,1,1,"dummy"
"116092",3,2,0,5,"dummy"
"116093",2,0,0,2,"dummy"
"116094",0,2,0,2,"dummy"
"116095",2,2,0,4,"dummy"
"116096",4,0,0,4,"dummy"
"116097",0,4,0,4,"dummy"
"116106",0,0,0,0,"dummy"
"116151",0,3,0,3,"dummy"
"116152",1,0,4,5,"dummy"
"116153",0,0,0,0,"dummy"
"116154",0,0,0,0,"dummy"
"116155",0,0,0,0,"dummy"
"116156",0,0,1,1,"dummy"
"116159",1,11,4,16,"dummy"
"116160",6,3,2,11,"dummy"
"116161",0,0,1,1,"dummy"
"116162",0,0,1,1,"dummy"
"116163",0,1,0,1,"dummy"
"116174",0,0,2,2,"dummy"
"116175",0,0,1,1,"dummy"
"116180",0,0,0,0,"dummy"
"116181",0,1,1,2,"dummy"
"116185",20,0,3,23,"dummy"
"116212",1,0,0,1,"dummy"
"116215",0,0,0,0,"dummy"
"116216",5,6,0,11,"dummy"
"116217",8,18,2,28,"dummy"
"116218",23,44,4,71,"dummy"
"116219",0,1,0,1,"dummy"
"116220",32,7,2,41,"dummy"
"116221",0,3,0,3,"dummy"
"116222",5,5,0,10,"dummy"
"116223",0,4,0,4,"dummy"
"116224",0,0,0,0,"dummy"
"116225",1,0,0,1,"dummy"
"116226",2,7,0,9,"dummy"
"116227",0,7,0,7,"dummy"
"116228",0,2,0,2,"dummy"
"116229",0,3,0,3,"dummy"
"116230",0,1,0,1,"dummy"
"116231",0,4,0,4,"dummy"
"116232",2,0,0,2,"dummy"
"116233",0,1,0,1,"dummy"
"116234",0,1,0,1,"dummy"
"116235",0,3,0,3,"dummy"
"116236",3,0,0,3,"dummy"
"116237",1,1,0,2,"dummy"
"116238",0,0,0,0,"dummy"
"116239",0,2,0,2,"dummy"
"116240",0,0,1,1,"dummy"
"116241",0,0,1,1,"dummy"
"116242",6,1,0,7,"dummy"
"116243",0,1,0,1,"dummy"
"116244",3,0,0,3,"dummy"
"116245",1,3,1,5,"dummy"
"116246",2,2,0,4,"dummy"
"116247",3,6,0,9,"dummy"
"116252",0,1,2,3,"dummy"
"116253",0,0,0,0,"dummy"
"116254",0,1,0,1,"dummy"
"116255",4,0,2,6,"dummy"
"116256",1,0,0,1,"dummy"
"116257",0,0,0,0,"dummy"
"116258",0,0,0,0,"dummy"
"116318",0,0,0,0,"dummy"
"116321",0,0,1,1,"dummy"
"116333",0,4,0,4,"dummy"
"116334",0,0,1,1,"dummy"
"116352",0,1,1,2,"dummy"
"116358",1,5,0,6,"dummy"
"116359",2,7,0,9,"dummy"
"116360",1,8,0,9,"dummy"
"116370",0,1,4,5,"dummy"
"116371",0,0,1,1,"dummy"
"116372",0,0,1,1,"dummy"
"116373",2,1,0,3,"dummy"
"116374",0,0,1,1,"dummy"
"116382",0,2,2,4,"dummy"
"116383",0,2,4,6,"dummy"
"116386",0,0,0,0,"dummy"
"116387",0,0,0,0,"dummy"
"116388",0,0,0,0,"dummy"
"116394",2,0,3,5,"dummy"
"116400",0,0,0,0,"dummy"
"116401",0,0,0,0,"dummy"
"116411",0,0,0,0,"dummy"
"116412",9,11,0,20,"dummy"
"116413",3,0,2,5,"dummy"
"116414",7,9,1,17,"dummy"
"116415",0,1,0,1,"dummy"
"116419",0,0,1,1,"dummy"
"116426",0,2,0,2,"dummy"
"116427",0,1,0,1,"dummy"
"116428",0,0,1,1,"dummy"
"116265",0,1,0,1,"dummy"
"116266",2,1,0,3,"dummy"
"116267",0,1,0,1,"dummy"
"116268",0,0,0,0,"dummy"
"116269",0,0,0,0,"dummy"
"116270",1,0,1,2,"dummy"
"116271",0,2,0,2,"dummy"
"116272",0,1,0,1,"dummy"
"116273",0,1,0,1,"dummy"
"116274",0,2,1,3,"dummy"
"116275",3,1,1,5,"dummy"
"116276",0,0,0,0,"dummy"
"116277",0,2,0,2,"dummy"
"116278",0,1,0,1,"dummy"
"116279",0,1,0,1,"dummy"
"116280",4,0,0,4,"dummy"
"116281",0,0,0,0,"dummy"
"116282",0,0,0,0,"dummy"
"116283",0,0,0,0,"dummy"
"116284",4,5,3,12,"dummy"
"116314",0,0,1,1,"dummy"
"116315",0,4,2,6,"dummy"
"116316",0,1,0,1,"dummy"
"116323",0,1,0,1,"dummy"
"116324",0,0,3,3,"dummy"
"116336",0,12,1,13,"dummy"
"116337",0,0,0,0,"dummy"
"116338",0,0,0,0,"dummy"
"116339",0,0,0,0,"dummy"
"116340",0,0,1,1,"dummy"
"116341",0,0,1,1,"dummy"
"116342",0,1,1,2,"dummy"
"116343",0,0,1,1,"dummy"
"116344",1,1,1,3,"dummy"
"116345",13,0,1,14,"dummy"
"116348",1,2,0,3,"dummy"
"116362",1,0,1,2,"dummy"
"116363",0,0,1,1,"dummy"
"116376",0,3,0,3,"dummy"
"116379",0,2,0,2,"dummy"
"116380",0,0,1,1,"dummy"
"116390",2,6,1,9,"dummy"
"116391",4,0,1,5,"dummy"
"116392",6,1,2,9,"dummy"
"116396",2,1,0,3,"dummy"
"116397",1,5,0,6,"dummy"
"116398",1,2,0,3,"dummy"
"116403",0,5,3,8,"dummy"
"116417",0,0,0,0,"dummy"
"116442",0,0,1,1,"dummy"
"116445",0,0,1,1,"dummy"
"116448",0,0,2,2,"dummy"
"116452",0,0,3,3,"dummy"
"116453",0,0,3,3,"dummy"
"116458",10,2,1,13,"dummy"
"116459",0,1,0,1,"dummy"
"116460",0,1,0,1,"dummy"
"116461",0,0,1,1,"dummy"
"116462",0,5,0,5,"dummy"
"116463",0,0,0,0,"dummy"
"116467",0,0,1,1,"dummy"
"116429",2,6,2,10,"dummy"
"116430",1,0,0,1,"dummy"
"116431",2,0,0,2,"dummy"
"116432",0,2,0,2,"dummy"
"116433",3,0,2,5,"dummy"
"116434",0,0,1,1,"dummy"
"116437",0,1,0,1,"dummy"
"116438",3,0,1,4,"dummy"
"116450",0,2,0,2,"dummy"
"116465",2,2,2,6,"dummy"
"116491",1,0,1,2,"dummy"
"116492",0,0,0,0,"dummy"
"116517",6,7,3,16,"dummy"
"116518",0,0,1,1,"dummy"
"116519",0,0,1,1,"dummy"
"116520",1,0,0,1,"dummy"
"116521",0,0,1,1,"dummy"
"116522",0,4,0,4,"dummy"
"116523",0,2,0,2,"dummy"
"116524",2,0,0,2,"dummy"
"116525",0,2,0,2,"dummy"
"116529",0,2,0,2,"dummy"
"116538",5,0,0,5,"dummy"
"116539",8,0,1,9,"dummy"
"116540",0,4,0,4,"dummy"
"116541",1,9,0,10,"dummy"
"116542",10,4,0,14,"dummy"
"116543",1,0,0,1,"dummy"
"116544",0,0,2,2,"dummy"
"116545",3,1,1,5,"dummy"
"116546",0,0,1,1,"dummy"
"116547",0,0,1,1,"dummy"
"116548",3,1,2,6,"dummy"
"116549",0,1,0,1,"dummy"
"116550",2,0,1,3,"dummy"
"116568",0,1,3,4,"dummy"
"116569",0,0,2,2,"dummy"
"116601",0,0,0,0,"dummy"
"116602",0,0,0,0,"dummy"
"116625",0,1,0,1,"dummy"
"116629",0,1,0,1,"dummy"
"116630",14,27,3,44,"dummy"
"116644",0,1,0,1,"dummy"
"116703",0,3,0,3,"dummy"
"116715",2,0,1,3,"dummy"
"116716",0,0,1,1,"dummy"
"116717",0,1,0,1,"dummy"
"116720",0,37,0,37,"dummy"
"116721",0,5,0,5,"dummy"
"116722",0,0,1,1,"dummy"
"116723",2,2,2,6,"dummy"
"116724",0,0,2,2,"dummy"
"116468",0,0,2,2,"dummy"
"116469",4,1,0,5,"dummy"
"116470",0,0,1,1,"dummy"
"116471",1,2,1,4,"dummy"
"116472",2,0,0,2,"dummy"
"116473",0,0,1,1,"dummy"
"116476",0,1,0,1,"dummy"
"116477",0,1,0,1,"dummy"
"116478",0,2,0,2,"dummy"
"116479",0,0,0,0,"dummy"
"116480",3,3,1,7,"dummy"
"116481",3,3,1,7,"dummy"
"116484",0,2,0,2,"dummy"
"116485",0,0,0,0,"dummy"
"116486",0,0,0,0,"dummy"
"116487",0,0,2,2,"dummy"
"116496",0,0,1,1,"dummy"
"116503",1,0,0,1,"dummy"
"116504",1,6,1,8,"dummy"
"116527",0,3,0,3,"dummy"
"116552",0,1,0,1,"dummy"
"116555",0,2,0,2,"dummy"
"116556",0,1,0,1,"dummy"
"116557",0,0,1,1,"dummy"
"116558",1,0,1,2,"dummy"
"116559",1,4,1,6,"dummy"
"116560",3,1,1,5,"dummy"
"116563",0,2,0,2,"dummy"
"116566",0,0,0,0,"dummy"
"116573",0,0,0,0,"dummy"
"116574",0,0,0,0,"dummy"
"116575",6,0,0,6,"dummy"
"116578",0,2,0,2,"dummy"
"116579",3,2,0,5,"dummy"
"116580",0,1,0,1,"dummy"
"116581",0,1,0,1,"dummy"
"116582",6,0,1,7,"dummy"
"116583",0,1,0,1,"dummy"
"116584",0,2,0,2,"dummy"
"116585",1,0,1,2,"dummy"
"116586",0,0,2,2,"dummy"
"116587",2,1,0,3,"dummy"
"116588",1,4,0,5,"dummy"
"116589",0,2,1,3,"dummy"
"116590",3,3,4,10,"dummy"
"116591",0,0,1,1,"dummy"
"116592",2,1,0,3,"dummy"
"116593",0,1,1,2,"dummy"
"116594",0,3,0,3,"dummy"
"116595",0,2,0,2,"dummy"
"116596",2,3,1,6,"dummy"
"116597",1,5,4,10,"dummy"
"116598",2,5,1,8,"dummy"
"116599",0,0,1,1,"dummy"
"116604",0,1,0,1,"dummy"
"116605",0,0,2,2,"dummy"
"116606",2,4,2,8,"dummy"
"116607",0,6,0,6,"dummy"
"116608",0,1,1,2,"dummy"
"116609",0,2,0,2,"dummy"
"116610",0,1,0,1,"dummy"
"116611",0,0,1,1,"dummy"
"116612",0,1,0,1,"dummy"
"116613",3,1,0,4,"dummy"
"116614",0,3,0,3,"dummy"
"116615",9,4,0,13,"dummy"
"116616",8,3,0,11,"dummy"
"116617",0,2,0,2,"dummy"
"116618",2,4,2,8,"dummy"
"116619",0,1,0,1,"dummy"
"116620",3,3,0,6,"dummy"
"116623",0,0,1,1,"dummy"
"116627",1,0,0,1,"dummy"
"116632",0,0,1,1,"dummy"
"116633",2,0,6,8,"dummy"
"116634",6,11,2,19,"dummy"
"116635",6,1,1,8,"dummy"
"116636",0,0,3,3,"dummy"
"116637",0,0,1,1,"dummy"
"116638",0,0,1,1,"dummy"
"116639",0,0,2,2,"dummy"
"116640",0,0,1,1,"dummy"
"116646",0,0,2,2,"dummy"
"116647",0,0,1,1,"dummy"
"116648",2,2,0,4,"dummy"
"116649",3,3,3,9,"dummy"
"116650",0,0,1,1,"dummy"
"116651",0,0,1,1,"dummy"
"116652",0,0,1,1,"dummy"
"116653",0,0,1,1,"dummy"
"116654",0,2,1,3,"dummy"
"116655",0,1,0,1,"dummy"
"116656",1,1,0,2,"dummy"
"116657",4,1,0,5,"dummy"
"116658",0,0,1,1,"dummy"
"116659",2,2,1,5,"dummy"
"116660",0,0,1,1,"dummy"
"116661",0,1,1,2,"dummy"
"116662",0,0,1,1,"dummy"
"116663",0,0,2,2,"dummy"
"116664",0,0,1,1,"dummy"
"116665",0,0,1,1,"dummy"
"116666",0,0,1,1,"dummy"
"116667",2,2,1,5,"dummy"
"116668",2,2,0,4,"dummy"
"116669",0,0,2,2,"dummy"
"116670",0,0,1,1,"dummy"
"116671",5,2,0,7,"dummy"
"116672",0,1,0,1,"dummy"
"116673",0,0,1,1,"dummy"
"116674",0,0,1,1,"dummy"
"116675",0,0,1,1,"dummy"
"116676",0,0,1,1,"dummy"
"116677",0,0,1,1,"dummy"
"116678",0,1,1,2,"dummy"
"116679",0,0,1,1,"dummy"
"116713",0,0,4,4,"dummy"
"116738",0,0,2,2,"dummy"
"116739",4,0,0,4,"dummy"
"116740",0,0,2,2,"dummy"
"116741",0,0,2,2,"dummy"
"116742",0,0,2,2,"dummy"
"116820",0,0,0,0,"dummy"
"116821",0,1,0,1,"dummy"
"116822",0,0,1,1,"dummy"
"116825",0,0,1,1,"dummy"
"116826",0,0,2,2,"dummy"
"116827",0,0,1,1,"dummy"
"116828",2,1,0,3,"dummy"
"116829",0,2,0,2,"dummy"
"116830",0,0,1,1,"dummy"
"116831",0,1,0,1,"dummy"
"116832",0,0,1,1,"dummy"
"116833",0,0,1,1,"dummy"
"116834",0,1,0,1,"dummy"
"116835",0,5,0,5,"dummy"
"116836",0,1,0,1,"dummy"
"116837",9,0,2,11,"dummy"
"116838",0,1,0,1,"dummy"
"116839",0,3,0,3,"dummy"
"116840",0,1,0,1,"dummy"
"116841",0,1,0,1,"dummy"
"116842",0,1,0,1,"dummy"
"116843",0,1,0,1,"dummy"
"116844",0,1,0,1,"dummy"
"116845",0,9,0,9,"dummy"
"116846",0,4,0,4,"dummy"
"116847",2,3,0,5,"dummy"
"116848",0,0,1,1,"dummy"
"116849",0,1,0,1,"dummy"
"116850",2,3,0,5,"dummy"
"116851",0,1,1,2,"dummy"
"116852",0,1,1,2,"dummy"
"116853",1,0,0,1,"dummy"
"116854",0,0,1,1,"dummy"
"116855",4,2,0,6,"dummy"
"116856",0,1,0,1,"dummy"
"116857",2,3,0,5,"dummy"
"116858",1,8,0,9,"dummy"
"116859",0,0,0,0,"dummy"
"116860",2,2,0,4,"dummy"
"116861",7,0,0,7,"dummy"
"116862",0,0,3,3,"dummy"
"116863",0,1,1,2,"dummy"
"116864",0,0,0,0,"dummy"
"116865",0,1,0,1,"dummy"
"116866",4,2,1,7,"dummy"
"116867",0,0,1,1,"dummy"
"116868",0,0,1,1,"dummy"
"116869",0,1,0,1,"dummy"
"116870",0,1,0,1,"dummy"
"116871",0,1,0,1,"dummy"
"116872",0,4,0,4,"dummy"
"116725",2,2,3,7,"dummy"
"116726",0,0,2,2,"dummy"
"116727",0,0,2,2,"dummy"
"116728",0,0,4,4,"dummy"
"116729",0,0,4,4,"dummy"
"116730",0,0,5,5,"dummy"
"116731",0,0,2,2,"dummy"
"116732",2,0,0,2,"dummy"
"116733",0,4,0,4,"dummy"
"116734",4,0,0,4,"dummy"
"116735",0,2,0,2,"dummy"
"116736",0,2,0,2,"dummy"
"116748",0,1,0,1,"dummy"
"116749",5,4,0,9,"dummy"
"116750",0,8,0,8,"dummy"
"116751",2,6,0,8,"dummy"
"116752",0,1,1,2,"dummy"
"116753",1,0,0,1,"dummy"
"116754",0,1,1,2,"dummy"
"116755",0,1,0,1,"dummy"
"116756",0,0,1,1,"dummy"
"116757",3,2,0,5,"dummy"
"116758",0,1,0,1,"dummy"
"116759",0,0,1,1,"dummy"
"116760",1,6,0,7,"dummy"
"116761",0,0,1,1,"dummy"
"116762",3,3,2,8,"dummy"
"116763",1,1,1,3,"dummy"
"116764",0,1,0,1,"dummy"
"116765",0,1,1,2,"dummy"
"116766",0,1,0,1,"dummy"
"116767",0,1,0,1,"dummy"
"116768",1,0,0,1,"dummy"
"116769",0,1,0,1,"dummy"
"116770",29,1,2,32,"dummy"
"116771",0,0,1,1,"dummy"
"116772",1,0,0,1,"dummy"
"116773",0,0,1,1,"dummy"
"116774",1,0,1,2,"dummy"
"116775",0,0,0,0,"dummy"
"116776",2,0,0,2,"dummy"
"116777",0,0,2,2,"dummy"
"116778",0,0,0,0,"dummy"
"116779",0,0,2,2,"dummy"
"116780",0,0,1,1,"dummy"
"116781",0,0,1,1,"dummy"
"116782",0,1,0,1,"dummy"
"116783",1,0,0,1,"dummy"
"116784",0,3,0,3,"dummy"
"116785",0,0,1,1,"dummy"
"116786",0,1,0,1,"dummy"
"116787",0,0,0,0,"dummy"
"116788",0,0,0,0,"dummy"
"116789",0,0,2,2,"dummy"
"116790",0,0,1,1,"dummy"
"116791",0,0,1,1,"dummy"
"116792",0,0,1,1,"dummy"
"116793",0,0,1,1,"dummy"
"116794",0,0,1,1,"dummy"
"116795",0,0,1,1,"dummy"
"116796",0,0,2,2,"dummy"
"116797",0,0,2,2,"dummy"
"116798",0,0,2,2,"dummy"
"116799",0,0,2,2,"dummy"
"116800",0,0,2,2,"dummy"
"116801",0,0,2,2,"dummy"
"116802",0,0,2,2,"dummy"
"116803",0,0,2,2,"dummy"
"116804",0,0,2,2,"dummy"
"116805",2,0,0,2,"dummy"
"116806",0,0,1,1,"dummy"
"116807",0,0,0,0,"dummy"
"116808",0,0,0,0,"dummy"
"116809",1,1,0,2,"dummy"
"116810",0,1,0,1,"dummy"
"116811",0,0,3,3,"dummy"
"116812",0,0,1,1,"dummy"
"116813",1,0,0,1,"dummy"
"116814",1,1,0,2,"dummy"
"116815",0,0,1,1,"dummy"
"116816",0,0,1,1,"dummy"
"116817",0,1,0,1,"dummy"
"116818",0,0,1,1,"dummy"
"116876",2,0,0,2,"dummy"
"116877",4,5,0,9,"dummy"
"116878",6,1,2,9,"dummy"
"116879",0,0,1,1,"dummy"
"116881",0,0,3,3,"dummy"
"116883",0,2,0,2,"dummy"
"116884",0,0,1,1,"dummy"
"116885",0,1,0,1,"dummy"
"116886",0,0,1,1,"dummy"
"116892",0,1,0,1,"dummy"
"116893",39,1,1,41,"dummy"
"116894",2,11,0,13,"dummy"
"116895",3,1,1,5,"dummy"
"116896",1,0,0,1,"dummy"
"116897",1,2,1,4,"dummy"
"116898",1,0,0,1,"dummy"
"116899",0,1,1,2,"dummy"
"116900",0,0,2,2,"dummy"
"116901",10,4,1,15,"dummy"
"116903",0,1,2,3,"dummy"
"116904",4,7,1,12,"dummy"
"116905",3,4,0,7,"dummy"
"116906",2,4,2,8,"dummy"
"116908",6,3,0,9,"dummy"
"116909",3,11,0,14,"dummy"
"116911",2,2,3,7,"dummy"
"116912",0,0,0,0,"dummy"
"116914",0,0,2,2,"dummy"
"116916",0,2,0,2,"dummy"
"116917",0,2,0,2,"dummy"
"116918",0,2,0,2,"dummy"
"116921",1,1,0,2,"dummy"
"116923",4,1,2,7,"dummy"
"116924",0,0,1,1,"dummy"
"116926",0,0,1,1,"dummy"
"116927",0,0,0,0,"dummy"
"116930",0,0,0,0,"dummy"
"116931",0,0,1,1,"dummy"
"116932",0,0,1,1,"dummy"
"116933",3,0,0,3,"dummy"
"116936",1,1,0,2,"dummy"
"116938",0,2,0,2,"dummy"
"116939",0,4,0,4,"dummy"
"116940",0,0,1,1,"dummy"
"116941",0,5,1,6,"dummy"
"116942",1,1,0,2,"dummy"
"116943",0,4,0,4,"dummy"
"116944",12,3,4,19,"dummy"
"116945",1,2,1,4,"dummy"
"116946",0,0,1,1,"dummy"
"116947",39,2,0,41,"dummy"
"116948",0,0,1,1,"dummy"
"116949",0,1,0,1,"dummy"
"116952",0,0,4,4,"dummy"
"116955",0,0,1,1,"dummy"
"116956",0,0,1,1,"dummy"
"116957",0,0,2,2,"dummy"
"116958",26,3,7,36,"dummy"
"116960",0,0,3,3,"dummy"
"116961",0,0,1,1,"dummy"
"116963",1,1,1,3,"dummy"
"116964",5,3,2,10,"dummy"
"116965",0,2,0,2,"dummy"
"116966",0,3,0,3,"dummy"
"116967",0,3,0,3,"dummy"
"116968",0,1,1,2,"dummy"
"116973",0,0,0,0,"dummy"
"116980",1,1,1,3,"dummy"
"116981",0,0,2,2,"dummy"
"116982",0,0,2,2,"dummy"
"116983",0,0,1,1,"dummy"
"116985",2,0,0,2,"dummy"
"116986",0,1,0,1,"dummy"
"116988",2,1,3,6,"dummy"
"116993",0,1,0,1,"dummy"
"116997",1,8,0,9,"dummy"
"116998",2,8,2,12,"dummy"
"117002",0,0,1,1,"dummy"
"117003",0,0,1,1,"dummy"
"117004",1,1,0,2,"dummy"
"117005",1,0,0,1,"dummy"
"117009",2,5,2,9,"dummy"
"117017",1,11,0,12,"dummy"
"117018",0,1,0,1,"dummy"
"117020",18,4,2,24,"dummy"
"117022",0,1,2,3,"dummy"
"117023",0,3,0,3,"dummy"
"117024",0,2,0,2,"dummy"
"117026",0,0,1,1,"dummy"
"117027",0,0,1,1,"dummy"
"117028",0,0,1,1,"dummy"
"117029",1,1,0,2,"dummy"
"117030",1,2,0,3,"dummy"
"117033",4,1,4,9,"dummy"
"117038",0,1,0,1,"dummy"
"117039",0,5,0,5,"dummy"
"117040",0,0,1,1,"dummy"
"117041",0,2,0,2,"dummy"
"117045",4,4,0,8,"dummy"
"117047",0,0,1,1,"dummy"
"117048",0,0,1,1,"dummy"
"117049",0,0,1,1,"dummy"
"117051",0,1,0,1,"dummy"
"117053",7,10,5,22,"dummy"
"117055",0,2,0,2,"dummy"
"117057",0,0,0,0,"dummy"
"117061",7,0,0,7,"dummy"
"117062",0,0,1,1,"dummy"
"117064",0,0,1,1,"dummy"
"117065",0,1,0,1,"dummy"
"117066",0,0,1,1,"dummy"
"117067",0,2,0,2,"dummy"
"117068",0,1,0,1,"dummy"
"117069",1,0,0,1,"dummy"
"117071",1,5,1,7,"dummy"
"117074",0,1,0,1,"dummy"
"117076",6,5,1,12,"dummy"
"117087",0,1,1,2,"dummy"
"117088",0,1,0,1,"dummy"
"117089",1,1,0,2,"dummy"
"117090",5,13,1,19,"dummy"
"117092",0,0,1,1,"dummy"
"117100",2,4,0,6,"dummy"
"117101",0,2,0,2,"dummy"
"117102",0,2,0,2,"dummy"
"117103",10,2,0,12,"dummy"
"117104",0,2,0,2,"dummy"
"117105",0,0,0,0,"dummy"
"117108",0,0,1,1,"dummy"
"117111",0,2,3,5,"dummy"
"117112",0,0,1,1,"dummy"
"117113",0,0,1,1,"dummy"
"117116",0,1,0,1,"dummy"
"117118",0,0,0,0,"dummy"
"117121",3,3,0,6,"dummy"
"117122",0,1,0,1,"dummy"
"117132",2,5,2,9,"dummy"
"117135",1,2,0,3,"dummy"
"117136",2,5,2,9,"dummy"
"117137",0,0,1,1,"dummy"
"117138",0,0,1,1,"dummy"
"117139",0,1,0,1,"dummy"
"117141",0,0,1,1,"dummy"
"117143",1,2,1,4,"dummy"
"117144",1,0,2,3,"dummy"
"117145",0,2,0,2,"dummy"
"117146",0,2,0,2,"dummy"
"117147",0,2,0,2,"dummy"
"117148",2,3,5,10,"dummy"
"117149",0,1,0,1,"dummy"
"117150",0,0,1,1,"dummy"
"117151",0,1,0,1,"dummy"
"117152",0,1,0,1,"dummy"
"117153",1,0,0,1,"dummy"
"117154",0,2,0,2,"dummy"
"117155",0,1,0,1,"dummy"
"117156",0,1,0,1,"dummy"
"117158",0,7,1,8,"dummy"
"117160",1,1,0,2,"dummy"
"117161",0,1,0,1,"dummy"
"117162",0,1,0,1,"dummy"
"117163",0,0,1,1,"dummy"
"117164",0,0,4,4,"dummy"
"117165",0,3,2,5,"dummy"
"117166",1,2,0,3,"dummy"
"117167",2,3,0,5,"dummy"
"117168",0,1,0,1,"dummy"
"117169",0,3,0,3,"dummy"
"117172",9,0,2,11,"dummy"
"117177",0,1,0,1,"dummy"
"117176",0,0,0,0,"dummy"
"117175",0,1,0,1,"dummy"
"117179",0,0,0,0,"dummy"
"117180",2,1,5,8,"dummy"
"117187",0,0,0,0,"dummy"
"117188",0,0,0,0,"dummy"
"117190",2,0,2,4,"dummy"
"117192",2,0,0,2,"dummy"
"117193",0,0,1,1,"dummy"
"117194",0,0,1,1,"dummy"
"117195",0,0,0,0,"dummy"
"117196",0,0,1,1,"dummy"
"117197",0,0,3,3,"dummy"
"117198",0,1,1,2,"dummy"
"117199",0,0,2,2,"dummy"
"117200",0,0,2,2,"dummy"
"117201",1,1,2,4,"dummy"
"117202",5,19,1,25,"dummy"
"117203",0,1,2,3,"dummy"
"117204",0,0,2,2,"dummy"
"117205",0,0,3,3,"dummy"
"117206",0,0,2,2,"dummy"
"117207",0,0,2,2,"dummy"
"117208",0,0,2,2,"dummy"
"117209",0,0,2,2,"dummy"
"117210",0,0,2,2,"dummy"
"117211",0,0,2,2,"dummy"
"117212",0,0,2,2,"dummy"
"117213",0,0,2,2,"dummy"
"117214",0,0,2,2,"dummy"
"117216",3,2,0,5,"dummy"
"117217",4,10,2,16,"dummy"
"117218",0,9,0,9,"dummy"
"117222",0,1,4,5,"dummy"
"117223",0,0,1,1,"dummy"
"117224",0,0,1,1,"dummy"
"117225",2,1,0,3,"dummy"
"117226",0,0,1,1,"dummy"
"117229",0,70,2,72,"dummy"
"117230",2,8,8,18,"dummy"
"117231",11,2,1,14,"dummy"
"117232",3,5,8,16,"dummy"
"117233",1,2,1,4,"dummy"
"117234",1,1,0,2,"dummy"
"117235",0,3,0,3,"dummy"
"117237",0,4,2,6,"dummy"
"117238",0,0,1,1,"dummy"
"117239",0,0,1,1,"dummy"
"117240",0,1,0,1,"dummy"
"117241",3,0,1,4,"dummy"
"117242",0,0,1,1,"dummy"
"117243",0,0,0,0,"dummy"
"117244",1,0,0,1,"dummy"
"117245",0,1,0,1,"dummy"
"117246",1,0,0,1,"dummy"
"117247",0,0,1,1,"dummy"
"117248",0,5,0,5,"dummy"
"117270",0,2,0,2,"dummy"
"117278",1,0,0,1,"dummy"
"117427",0,0,0,0,"dummy"
"117428",2,0,0,2,"dummy"
"117435",0,0,0,0,"dummy"
"117436",0,0,1,1,"dummy"
"117534",0,1,0,1,"dummy"
"117535",1,1,0,2,"dummy"
"117536",0,0,1,1,"dummy"
"117537",0,0,1,1,"dummy"
"117538",0,0,1,1,"dummy"
"117539",0,0,2,2,"dummy"
"117540",0,0,1,1,"dummy"
"117541",0,0,1,1,"dummy"
"117542",1,0,0,1,"dummy"
"117543",0,0,1,1,"dummy"
"117253",0,0,0,0,"dummy"
"117254",0,0,1,1,"dummy"
"117255",0,0,0,0,"dummy"
"117256",0,0,1,1,"dummy"
"117257",0,0,0,0,"dummy"
"117258",0,0,0,0,"dummy"
"117265",0,0,1,1,"dummy"
"117268",0,0,1,1,"dummy"
"117272",0,0,1,1,"dummy"
"117275",2,7,3,12,"dummy"
"117276",0,0,1,1,"dummy"
"117376",0,1,4,5,"dummy"
"117377",14,9,3,26,"dummy"
"117378",0,0,0,0,"dummy"
"117381",1,0,1,2,"dummy"
"117382",0,0,2,2,"dummy"
"117414",0,0,0,0,"dummy"
"117415",0,0,1,1,"dummy"
"117416",0,0,1,1,"dummy"
"117438",1,1,1,3,"dummy"
"117448",0,3,0,3,"dummy"
"117532",4,2,3,9,"dummy"
"117556",0,0,1,1,"dummy"
"117601",1,2,0,3,"dummy"
"117602",0,0,1,1,"dummy"
"117663",0,0,0,0,"dummy"
"117664",1,0,0,1,"dummy"
"117682",0,0,0,0,"dummy"
"117683",0,0,1,1,"dummy"
"117684",3,0,0,3,"dummy"
"117685",0,1,0,1,"dummy"
"117686",0,0,1,1,"dummy"
"117552",0,0,1,1,"dummy"
"117553",0,1,0,1,"dummy"
"117554",0,0,1,1,"dummy"
"117562",0,0,1,1,"dummy"
"117565",0,0,1,1,"dummy"
"117566",1,0,1,2,"dummy"
"117567",0,0,2,2,"dummy"
"117568",0,0,1,1,"dummy"
"117569",0,0,2,2,"dummy"
"117570",0,0,2,2,"dummy"
"117571",0,0,2,2,"dummy"
"117572",0,0,2,2,"dummy"
"117573",0,0,2,2,"dummy"
"117574",0,0,2,2,"dummy"
"117575",0,0,2,2,"dummy"
"117576",0,1,1,2,"dummy"
"117577",0,1,1,2,"dummy"
"117578",1,3,0,4,"dummy"
"117579",0,0,0,0,"dummy"
"117580",0,0,2,2,"dummy"
"117581",0,0,2,2,"dummy"
"117582",0,0,2,2,"dummy"
"117583",0,0,2,2,"dummy"
"117589",0,10,0,10,"dummy"
"117590",0,1,0,1,"dummy"
"117591",1,1,0,2,"dummy"
"117592",0,1,0,1,"dummy"
"117593",0,0,0,0,"dummy"
"117594",0,3,0,3,"dummy"
"117597",0,1,1,2,"dummy"
"117598",1,0,1,2,"dummy"
"117599",2,0,0,2,"dummy"
"117660",0,2,0,2,"dummy"
"117661",0,0,0,0,"dummy"
"117690",0,1,0,1,"dummy"
"117691",0,0,2,2,"dummy"
"117692",3,2,1,6,"dummy"
"117693",0,0,1,1,"dummy"
"117694",0,0,0,0,"dummy"
"117695",0,0,0,0,"dummy"
"117696",0,0,0,0,"dummy"
"117697",0,0,2,2,"dummy"
"117698",0,0,0,0,"dummy"
"117699",0,0,0,0,"dummy"
"117700",0,0,0,0,"dummy"
"117701",0,0,0,0,"dummy"
"117702",0,0,2,2,"dummy"
"117703",0,0,0,0,"dummy"
"117715",0,0,1,1,"dummy"
"117716",0,2,0,2,"dummy"
"117717",0,0,2,2,"dummy"
"117718",0,0,1,1,"dummy"
"117719",0,0,1,1,"dummy"
"117729",0,1,0,1,"dummy"
"117730",0,2,0,2,"dummy"
"117776",1,1,1,3,"dummy"
"117777",1,1,1,3,"dummy"
"117778",1,5,3,9,"dummy"
"117779",9,5,2,16,"dummy"
"117780",1,0,0,1,"dummy"
"117781",1,0,0,1,"dummy"
"117782",7,3,3,13,"dummy"
"117783",0,0,3,3,"dummy"
"117792",1,0,0,1,"dummy"
"117793",0,1,0,1,"dummy"
"117794",1,5,1,7,"dummy"
"117795",0,2,0,2,"dummy"
"117800",6,7,3,16,"dummy"
"117804",0,1,0,1,"dummy"
"117705",0,2,0,2,"dummy"
"117706",0,1,0,1,"dummy"
"117707",0,0,1,1,"dummy"
"117708",0,1,1,2,"dummy"
"117709",0,0,1,1,"dummy"
"117710",0,0,3,3,"dummy"
"117711",0,0,1,1,"dummy"
"117721",2,2,1,5,"dummy"
"117722",0,0,1,1,"dummy"
"117727",0,0,1,1,"dummy"
"117732",2,2,0,4,"dummy"
"117735",0,2,0,2,"dummy"
"117736",0,2,0,2,"dummy"
"117737",0,1,0,1,"dummy"
"117738",0,1,0,1,"dummy"
"117739",0,3,0,3,"dummy"
"117747",0,4,3,7,"dummy"
"117748",0,4,3,7,"dummy"
"117749",0,0,10,10,"dummy"
"117750",4,5,0,9,"dummy"
"117751",0,1,0,1,"dummy"
"117752",6,2,3,11,"dummy"
"117753",0,3,0,3,"dummy"
"117754",12,4,3,19,"dummy"
"117755",2,0,1,3,"dummy"
"117756",0,0,1,1,"dummy"
"117757",0,1,0,1,"dummy"
"117758",0,0,1,1,"dummy"
"117759",0,0,1,1,"dummy"
"117760",0,0,1,1,"dummy"
"117761",0,0,1,1,"dummy"
"117762",0,0,1,1,"dummy"
"117767",0,0,0,0,"dummy"
"117768",1,0,0,1,"dummy"
"117773",0,2,0,2,"dummy"
"117774",0,0,1,1,"dummy"
"117785",2,4,0,6,"dummy"
"117786",0,2,0,2,"dummy"
"117787",0,2,0,2,"dummy"
"117788",10,2,0,12,"dummy"
"117789",0,2,0,2,"dummy"
"117790",0,0,0,0,"dummy"
"117802",2,0,3,5,"dummy"
"117831",2,2,0,4,"dummy"
"117868",0,0,2,2,"dummy"
"117869",0,0,2,2,"dummy"
"117870",0,0,1,1,"dummy"
"117871",0,2,0,2,"dummy"
"117872",5,5,3,13,"dummy"
"117894",2,0,0,2,"dummy"
"117895",0,0,0,0,"dummy"
"117896",0,1,0,1,"dummy"
"117897",0,0,0,0,"dummy"
"117898",0,9,1,10,"dummy"
"117899",0,0,0,0,"dummy"
"117900",0,0,0,0,"dummy"
"117901",0,2,0,2,"dummy"
"117906",0,0,4,4,"dummy"
"117907",0,1,0,1,"dummy"
"117913",0,1,0,1,"dummy"
"117914",3,6,0,9,"dummy"
"117915",0,0,4,4,"dummy"
"117916",2,2,1,5,"dummy"
"117921",3,3,1,7,"dummy"
"117922",0,0,1,1,"dummy"
"117923",0,0,1,1,"dummy"
"117924",1,0,0,1,"dummy"
"117925",0,0,0,0,"dummy"
"117926",0,0,0,0,"dummy"
"117940",3,3,2,8,"dummy"
"117941",0,0,1,1,"dummy"
"117942",1,2,0,3,"dummy"
"117943",0,1,0,1,"dummy"
"117944",0,0,3,3,"dummy"
"117945",0,0,1,1,"dummy"
"117946",0,1,0,1,"dummy"
"117947",0,1,4,5,"dummy"
"117833",0,0,0,0,"dummy"
"117834",0,0,0,0,"dummy"
"117835",0,1,0,1,"dummy"
"117836",2,0,0,2,"dummy"
"117837",0,1,0,1,"dummy"
"117838",1,1,0,2,"dummy"
"117839",0,0,0,0,"dummy"
"117840",0,0,1,1,"dummy"
"117841",0,1,0,1,"dummy"
"117842",0,0,0,0,"dummy"
"117843",0,1,0,1,"dummy"
"117844",0,0,0,0,"dummy"
"117845",0,1,0,1,"dummy"
"117846",0,0,1,1,"dummy"
"117847",0,1,0,1,"dummy"
"117848",6,1,1,8,"dummy"
"117849",1,6,1,8,"dummy"
"117850",0,6,0,6,"dummy"
"117851",0,0,0,0,"dummy"
"117852",0,0,1,1,"dummy"
"117853",0,0,0,0,"dummy"
"117854",6,0,0,6,"dummy"
"117855",0,6,0,6,"dummy"
"117856",1,0,0,1,"dummy"
"117857",0,0,0,0,"dummy"
"117858",0,0,0,0,"dummy"
"117859",0,0,0,0,"dummy"
"117860",0,0,0,0,"dummy"
"117861",0,0,0,0,"dummy"
"117862",0,0,0,0,"dummy"
"117863",0,2,0,2,"dummy"
"117864",0,0,0,0,"dummy"
"117865",6,0,0,6,"dummy"
"117866",0,2,0,2,"dummy"
"117874",0,3,0,3,"dummy"
"117875",1,1,2,4,"dummy"
"117876",1,3,0,4,"dummy"
"117877",0,0,3,3,"dummy"
"117878",0,1,2,3,"dummy"
"117879",0,0,1,1,"dummy"
"117880",1,1,0,2,"dummy"
"117881",0,0,1,1,"dummy"
"117882",0,4,0,4,"dummy"
"117883",0,11,1,12,"dummy"
"117884",1,0,0,1,"dummy"
"117885",2,5,0,7,"dummy"
"117886",0,0,1,1,"dummy"
"117887",0,2,0,2,"dummy"
"117888",3,3,1,7,"dummy"
"117889",0,0,1,1,"dummy"
"117890",2,0,0,2,"dummy"
"117891",0,0,1,1,"dummy"
"117892",1,0,0,1,"dummy"
"117911",0,1,0,1,"dummy"
"117918",0,0,1,1,"dummy"
"117919",0,0,1,1,"dummy"
"117952",6,5,2,13,"dummy"
"117957",3,12,2,17,"dummy"
"117960",5,5,1,11,"dummy"
"117961",0,4,1,5,"dummy"
"117962",0,2,1,3,"dummy"
"117963",0,1,0,1,"dummy"
"117966",5,1,0,6,"dummy"
"117967",0,0,1,1,"dummy"
"117968",0,0,0,0,"dummy"
"117969",2,1,0,3,"dummy"
"117970",6,0,1,7,"dummy"
"117975",0,0,1,1,"dummy"
"117976",0,1,0,1,"dummy"
"117987",0,0,0,0,"dummy"
"117990",0,0,1,1,"dummy"
"117998",1,3,0,4,"dummy"
"117999",0,3,1,4,"dummy"
"118000",0,1,0,1,"dummy"
"118003",0,2,1,3,"dummy"
"118004",0,0,0,0,"dummy"
"118011",0,0,0,0,"dummy"
"118012",0,0,0,0,"dummy"
"118013",0,0,0,0,"dummy"
"118024",0,0,1,1,"dummy"
"117948",0,0,2,2,"dummy"
"117949",0,0,1,1,"dummy"
"117950",0,0,2,2,"dummy"
"117982",0,0,0,0,"dummy"
"117985",3,0,0,3,"dummy"
"117992",2,4,0,6,"dummy"
"117993",0,2,0,2,"dummy"
"117994",0,2,0,2,"dummy"
"117995",10,2,0,12,"dummy"
"117996",0,2,0,2,"dummy"
"118006",0,5,0,5,"dummy"
"118007",2,0,1,3,"dummy"
"118021",3,1,0,4,"dummy"
"118022",5,1,0,6,"dummy"
"118032",0,0,1,1,"dummy"
"118033",0,0,1,1,"dummy"
"118034",0,0,2,2,"dummy"
"118035",0,0,1,1,"dummy"
"118036",0,0,0,0,"dummy"
"118037",2,0,0,2,"dummy"
"118038",0,0,1,1,"dummy"
"118039",2,0,0,2,"dummy"
"118040",0,2,0,2,"dummy"
"118041",0,2,0,2,"dummy"
"118042",0,1,0,1,"dummy"
"118043",0,0,1,1,"dummy"
"118044",0,0,1,1,"dummy"
"118045",0,1,0,1,"dummy"
"118046",1,2,0,3,"dummy"
"118047",0,1,0,1,"dummy"
"118048",2,2,0,4,"dummy"
"118049",0,2,0,2,"dummy"
"118127",0,0,2,2,"dummy"
"118128",0,0,4,4,"dummy"
"118131",0,2,0,2,"dummy"
"118137",0,4,2,6,"dummy"
"118138",0,2,0,2,"dummy"
"118139",1,0,0,1,"dummy"
"118140",0,1,0,1,"dummy"
"118141",0,0,1,1,"dummy"
"118142",1,1,0,2,"dummy"
"118143",1,0,0,1,"dummy"
"118144",0,1,0,1,"dummy"
"118145",0,4,0,4,"dummy"
"118146",3,0,0,3,"dummy"
"118147",2,0,0,2,"dummy"
"118148",0,1,0,1,"dummy"
"118149",0,1,0,1,"dummy"
"118150",0,1,0,1,"dummy"
"118151",1,0,0,1,"dummy"
"118152",0,2,0,2,"dummy"
"118153",0,3,0,3,"dummy"
"118154",0,2,0,2,"dummy"
"118155",2,1,2,5,"dummy"
"118156",0,1,1,2,"dummy"
"118157",4,14,3,21,"dummy"
"118158",0,0,1,1,"dummy"
"118159",1,0,1,2,"dummy"
"118160",0,1,1,2,"dummy"
"118164",1,3,2,6,"dummy"
"118170",1,4,1,6,"dummy"
"118171",1,0,1,2,"dummy"
"118172",2,0,0,2,"dummy"
"118173",0,0,0,0,"dummy"
"118178",0,0,1,1,"dummy"
"118182",1,1,0,2,"dummy"
"118027",0,0,1,1,"dummy"
"118028",0,0,1,1,"dummy"
"118029",0,0,1,1,"dummy"
"118030",0,0,1,1,"dummy"
"118051",2,7,1,10,"dummy"
"118057",1,1,2,4,"dummy"
"118060",10,0,2,12,"dummy"
"118083",0,5,0,5,"dummy"
"118084",0,0,1,1,"dummy"
"118085",5,0,0,5,"dummy"
"118086",6,0,2,8,"dummy"
"118087",0,6,2,8,"dummy"
"118113",0,1,3,4,"dummy"
"118114",25,7,8,40,"dummy"
"118115",0,2,0,2,"dummy"
"118118",0,3,0,3,"dummy"
"118119",0,1,0,1,"dummy"
"118120",0,1,0,1,"dummy"
"118121",0,2,0,2,"dummy"
"118122",0,0,1,1,"dummy"
"118123",2,1,0,3,"dummy"
"118124",1,2,0,3,"dummy"
"118125",0,2,0,2,"dummy"
"118162",0,0,0,0,"dummy"
"118168",1,1,0,2,"dummy"
"118180",0,0,0,0,"dummy"
"118185",0,1,0,1,"dummy"
"118186",0,7,3,10,"dummy"
"118187",3,1,1,5,"dummy"
"118188",0,1,1,2,"dummy"
"118189",2,2,0,4,"dummy"
"118190",2,2,0,4,"dummy"
"118191",0,3,0,3,"dummy"
"118192",2,0,0,2,"dummy"
"118193",0,0,1,1,"dummy"
"118194",0,1,1,2,"dummy"
"118195",0,0,1,1,"dummy"
"118196",0,1,0,1,"dummy"
"118197",0,0,0,0,"dummy"
"118198",0,5,0,5,"dummy"
"118204",0,1,3,4,"dummy"
"118205",0,2,1,3,"dummy"
"118206",0,6,0,6,"dummy"
"118207",0,2,0,2,"dummy"
"118208",0,1,3,4,"dummy"
"118209",25,5,2,32,"dummy"
"118210",0,0,1,1,"dummy"
"118225",0,17,0,17,"dummy"
"118226",2,0,0,2,"dummy"
"118227",0,0,0,0,"dummy"
"118228",0,5,1,6,"dummy"
"118229",0,0,0,0,"dummy"
"118232",0,7,0,7,"dummy"
"118247",10,3,0,13,"dummy"
"118248",0,5,0,5,"dummy"
"118252",2,0,0,2,"dummy"
"118258",0,8,1,9,"dummy"
"118276",0,2,0,2,"dummy"
"118277",4,5,2,11,"dummy"
"118308",0,0,0,0,"dummy"
"118183",0,0,1,1,"dummy"
"118200",4,9,4,17,"dummy"
"118201",0,1,0,1,"dummy"
"118202",1,0,3,4,"dummy"
"118212",0,1,0,1,"dummy"
"118213",0,3,4,7,"dummy"
"118214",2,0,0,2,"dummy"
"118215",3,5,0,8,"dummy"
"118216",0,0,1,1,"dummy"
"118217",0,0,1,1,"dummy"
"118222",0,2,1,3,"dummy"
"118223",0,0,1,1,"dummy"
"118250",0,3,0,3,"dummy"
"118254",0,0,0,0,"dummy"
"118255",2,2,2,6,"dummy"
"118256",1,2,0,3,"dummy"
"118262",2,0,0,2,"dummy"
"118263",11,7,3,21,"dummy"
"118264",3,0,0,3,"dummy"
"118265",0,3,0,3,"dummy"
"118266",0,2,0,2,"dummy"
"118267",6,22,7,35,"dummy"
"118268",1,1,0,2,"dummy"
"118269",5,7,0,12,"dummy"
"118270",5,14,0,19,"dummy"
"118271",0,0,1,1,"dummy"
"118274",0,0,1,1,"dummy"
"118279",0,5,1,6,"dummy"
"118280",0,1,1,2,"dummy"
"118281",1,0,1,2,"dummy"
"118282",7,27,1,35,"dummy"
"118283",0,2,0,2,"dummy"
"118284",4,0,0,4,"dummy"
"118285",0,2,0,2,"dummy"
"118286",4,3,0,7,"dummy"
"118287",11,0,2,13,"dummy"
"118291",0,3,3,6,"dummy"
"118292",0,1,0,1,"dummy"
"118293",33,6,1,40,"dummy"
"118294",0,0,1,1,"dummy"
"118295",0,0,1,1,"dummy"
"118296",5,9,9,23,"dummy"
"118297",5,1,0,6,"dummy"
"118298",4,3,0,7,"dummy"
"118299",0,7,0,7,"dummy"
"118300",2,0,0,2,"dummy"
"118301",5,14,0,19,"dummy"
"118302",2,0,0,2,"dummy"
"118303",0,0,0,0,"dummy"
"118304",0,0,0,0,"dummy"
"118305",0,0,0,0,"dummy"
"118306",2,2,0,4,"dummy"
"118314",3,3,1,7,"dummy"
"118315",1,1,0,2,"dummy"
"118319",0,1,0,1,"dummy"
"118320",0,1,0,1,"dummy"
"118322",0,0,0,0,"dummy"
"118323",0,0,1,1,"dummy"
"118327",16,18,4,38,"dummy"
"118330",1,2,1,4,"dummy"
"118331",4,2,1,7,"dummy"
"118334",0,0,0,0,"dummy"
"118335",5,0,2,7,"dummy"
"118336",0,0,0,0,"dummy"
"118341",0,0,1,1,"dummy"
"118342",0,0,2,2,"dummy"
"118343",2,0,4,6,"dummy"
"118344",0,0,4,4,"dummy"
"118345",0,0,1,1,"dummy"
"118348",5,2,6,13,"dummy"
"118349",2,1,0,3,"dummy"
"118350",0,0,3,3,"dummy"
"118351",0,0,0,0,"dummy"
"118355",0,0,0,0,"dummy"
"118356",0,0,0,0,"dummy"
"118386",1,0,1,2,"dummy"
"118387",0,1,0,1,"dummy"
"118388",4,2,0,6,"dummy"
"118389",0,4,0,4,"dummy"
"118390",0,0,1,1,"dummy"
"118391",0,2,0,2,"dummy"
"118398",0,5,0,5,"dummy"
"118399",3,3,0,6,"dummy"
"118400",0,2,0,2,"dummy"
"118401",0,1,0,1,"dummy"
"118402",0,1,0,1,"dummy"
"118403",4,4,1,9,"dummy"
"118404",2,2,0,4,"dummy"
"118405",0,1,0,1,"dummy"
"118406",6,6,1,13,"dummy"
"118407",0,2,0,2,"dummy"
"118408",0,0,2,2,"dummy"
"118409",0,2,0,2,"dummy"
"118410",11,11,1,23,"dummy"
"118411",2,2,0,4,"dummy"
"118421",1,0,0,1,"dummy"
"118422",0,0,1,1,"dummy"
"118425",0,1,0,1,"dummy"
"118427",0,0,1,1,"dummy"
"118429",0,1,0,1,"dummy"
"118430",0,1,0,1,"dummy"
"118431",0,1,0,1,"dummy"
"118435",0,1,0,1,"dummy"
"118436",8,1,0,9,"dummy"
"118437",0,0,0,0,"dummy"
"118438",0,0,0,0,"dummy"
"118439",1,10,0,11,"dummy"
"118440",7,1,0,8,"dummy"
"118441",2,0,3,5,"dummy"
"118443",0,0,1,1,"dummy"
"118444",0,0,1,1,"dummy"
"118445",0,0,1,1,"dummy"
"118446",0,0,1,1,"dummy"
"118447",0,0,1,1,"dummy"
"118448",6,6,2,14,"dummy"
"118449",0,0,1,1,"dummy"
"118450",0,0,1,1,"dummy"
"118452",0,1,2,3,"dummy"
"118453",0,1,0,1,"dummy"
"118457",2,4,0,6,"dummy"
"118458",0,2,0,2,"dummy"
"118459",0,2,0,2,"dummy"
"118460",10,2,0,12,"dummy"
"118461",0,2,0,2,"dummy"
"118462",0,0,0,0,"dummy"
"118463",0,0,3,3,"dummy"
"118464",0,5,0,5,"dummy"
"118466",7,0,0,7,"dummy"
"118467",0,0,1,1,"dummy"
"118468",7,2,0,9,"dummy"
"118469",0,2,0,2,"dummy"
"118470",0,0,1,1,"dummy"
"118471",0,0,1,1,"dummy"
"118473",0,9,1,10,"dummy"
"118474",0,4,2,6,"dummy"
"118476",3,0,1,4,"dummy"
"118477",17,16,3,36,"dummy"
"118478",1,0,6,7,"dummy"
"118479",0,0,0,0,"dummy"
"118480",5,5,4,14,"dummy"
"118481",1,0,1,2,"dummy"
"118484",2,0,0,2,"dummy"
"118485",1,0,1,2,"dummy"
"118486",0,0,2,2,"dummy"
"118487",2,1,5,8,"dummy"
"118488",0,0,1,1,"dummy"
"118489",1,0,1,2,"dummy"
"118490",0,0,1,1,"dummy"
"118491",0,0,2,2,"dummy"
"118493",0,2,0,2,"dummy"
"118494",1,8,1,10,"dummy"
"118495",0,0,1,1,"dummy"
"118496",1,3,0,4,"dummy"
"118497",0,0,2,2,"dummy"
"118498",1,0,0,1,"dummy"
"118499",0,0,0,0,"dummy"
"118502",0,0,0,0,"dummy"
"118503",2,0,0,2,"dummy"
"118505",0,0,2,2,"dummy"
"118509",12,15,0,27,"dummy"
"118510",0,1,0,1,"dummy"
"118511",0,2,0,2,"dummy"
"118512",2,2,0,4,"dummy"
"118513",0,1,0,1,"dummy"
"118515",2,2,0,4,"dummy"
"118516",0,0,1,1,"dummy"
"118517",0,1,1,2,"dummy"
"118518",1,0,0,1,"dummy"
"118519",0,1,0,1,"dummy"
"118520",6,4,6,16,"dummy"
"118521",2,7,0,9,"dummy"
"118522",9,3,2,14,"dummy"
"118523",0,0,1,1,"dummy"
"118532",0,17,0,17,"dummy"
"118533",0,1,0,1,"dummy"
"118534",0,1,0,1,"dummy"
"118535",0,0,0,0,"dummy"
"118536",0,1,0,1,"dummy"
"118537",0,0,1,1,"dummy"
"118538",2,0,0,2,"dummy"
"118539",3,3,0,6,"dummy"
"118540",0,2,0,2,"dummy"
"118541",0,2,0,2,"dummy"
"118543",2,0,0,2,"dummy"
"118545",0,0,1,1,"dummy"
"118546",0,0,1,1,"dummy"
"118548",12,4,1,17,"dummy"
"118549",0,13,2,15,"dummy"
"118550",0,7,0,7,"dummy"
"118551",22,0,0,22,"dummy"
"118552",3,1,0,4,"dummy"
"118553",1,0,0,1,"dummy"
"118554",0,0,0,0,"dummy"
"118555",2,0,0,2,"dummy"
"118556",2,2,2,6,"dummy"
"118557",0,0,1,1,"dummy"
"118559",0,1,0,1,"dummy"
"118567",0,2,0,2,"dummy"
"118568",0,3,0,3,"dummy"
"118569",0,2,0,2,"dummy"
"118570",0,2,0,2,"dummy"
"118571",0,0,1,1,"dummy"
"118577",3,3,1,7,"dummy"
"118578",4,0,1,5,"dummy"
"118586",0,2,2,4,"dummy"
"118587",5,0,0,5,"dummy"
"118589",0,1,0,1,"dummy"
"118590",1,0,2,3,"dummy"
"118606",0,0,1,1,"dummy"
"118607",0,0,0,0,"dummy"
"118609",0,1,0,1,"dummy"
"118610",1,5,0,6,"dummy"
"118611",0,0,0,0,"dummy"
"118612",0,0,0,0,"dummy"
"118613",0,0,0,0,"dummy"
"118614",3,2,5,10,"dummy"
"118617",0,0,1,1,"dummy"
"118626",0,7,0,7,"dummy"
"118627",0,0,3,3,"dummy"
"118628",1,2,3,6,"dummy"
"118629",0,0,1,1,"dummy"
"118631",0,0,0,0,"dummy"
"118632",0,0,0,0,"dummy"
"118633",0,0,0,0,"dummy"
"118636",2,3,3,8,"dummy"
"118637",6,5,5,16,"dummy"
"118638",0,0,1,1,"dummy"
"118639",0,2,1,3,"dummy"
"118640",0,2,0,2,"dummy"
"118641",2,8,6,16,"dummy"
"118642",3,8,0,11,"dummy"
"118643",0,0,0,0,"dummy"
"118644",0,1,1,2,"dummy"
"118645",8,2,7,17,"dummy"
"118646",3,11,6,20,"dummy"
"118647",3,0,1,4,"dummy"
"118648",1,2,0,3,"dummy"
"118649",0,0,1,1,"dummy"
"118651",4,5,3,12,"dummy"
"118652",2,0,3,5,"dummy"
"118653",3,0,1,4,"dummy"
"118660",0,0,1,1,"dummy"
"118662",2,4,0,6,"dummy"
"118663",0,2,0,2,"dummy"
"118664",0,2,0,2,"dummy"
"118665",10,2,0,12,"dummy"
"118666",0,2,0,2,"dummy"
"118667",0,0,0,0,"dummy"
"118668",0,0,3,3,"dummy"
"118671",0,2,0,2,"dummy"
"118672",0,2,0,2,"dummy"
"118673",0,1,0,1,"dummy"
"118674",0,0,1,1,"dummy"
"118675",0,2,0,2,"dummy"
"118677",0,2,0,2,"dummy"
"118678",0,0,0,0,"dummy"
"118679",2,0,1,3,"dummy"
"118682",1,0,1,2,"dummy"
"118683",0,0,1,1,"dummy"
"118684",0,0,1,1,"dummy"
"118686",1,5,0,6,"dummy"
"118687",0,4,1,5,"dummy"
"118688",4,0,1,5,"dummy"
"118690",0,0,1,1,"dummy"
"118691",0,0,0,0,"dummy"
"118692",0,1,1,2,"dummy"
"118693",0,1,2,3,"dummy"
"118695",5,2,1,8,"dummy"
"118696",0,0,1,1,"dummy"
"118727",0,0,1,1,"dummy"
"118728",3,4,0,7,"dummy"
"118729",0,2,0,2,"dummy"
"118730",0,1,0,1,"dummy"
"118731",0,2,0,2,"dummy"
"118732",0,0,0,0,"dummy"
"118733",0,0,0,0,"dummy"
"118735",0,0,0,0,"dummy"
"118736",0,0,1,1,"dummy"
"118738",0,1,0,1,"dummy"
"118739",0,1,0,1,"dummy"
"118740",0,1,0,1,"dummy"
"118741",0,1,0,1,"dummy"
"118742",2,0,0,2,"dummy"
"118743",0,0,2,2,"dummy"
"118747",0,0,0,0,"dummy"
"118748",0,0,0,0,"dummy"
"118750",0,0,0,0,"dummy"
"118751",3,5,1,9,"dummy"
"118752",2,1,0,3,"dummy"
"118753",0,0,1,1,"dummy"
"118754",2,2,5,9,"dummy"
"118755",0,0,2,2,"dummy"
"118757",2,7,1,10,"dummy"
"118758",3,0,2,5,"dummy"
"118759",0,0,2,2,"dummy"
"118762",0,0,1,1,"dummy"
"118766",0,2,0,2,"dummy"
"118769",19,6,7,32,"dummy"
"118771",0,5,0,5,"dummy"
"118772",1,1,1,3,"dummy"
"118773",0,4,0,4,"dummy"
"118774",1,0,0,1,"dummy"
"118775",1,2,1,4,"dummy"
"118776",0,0,0,0,"dummy"
"118777",0,1,0,1,"dummy"
"118778",2,1,0,3,"dummy"
"118779",0,1,0,1,"dummy"
"118780",0,1,0,1,"dummy"
"118781",1,0,0,1,"dummy"
"118782",5,5,0,10,"dummy"
"118783",0,1,4,5,"dummy"
"118784",0,1,0,1,"dummy"
"118785",0,1,5,6,"dummy"
"118786",1,0,0,1,"dummy"
"118787",0,1,0,1,"dummy"
"118788",0,1,0,1,"dummy"
"118789",11,10,3,24,"dummy"
"118790",0,0,2,2,"dummy"
"118791",0,0,2,2,"dummy"
"118792",0,0,1,1,"dummy"
"118794",0,2,0,2,"dummy"
"118796",2,0,1,3,"dummy"
"118797",0,2,1,3,"dummy"
"118798",2,0,3,5,"dummy"
"118799",0,0,2,2,"dummy"
"118800",0,3,5,8,"dummy"
"118801",0,0,2,2,"dummy"
"118802",0,0,0,0,"dummy"
"118803",1,3,0,4,"dummy"
"118804",1,4,0,5,"dummy"
"118805",4,1,0,5,"dummy"
"118806",1,2,0,3,"dummy"
"118807",0,0,1,1,"dummy"
"118808",0,0,0,0,"dummy"
"118809",5,1,2,8,"dummy"
"118810",14,6,2,22,"dummy"
"118811",1,0,0,1,"dummy"
"118812",0,0,1,1,"dummy"
"118813",1,5,0,6,"dummy"
"118816",6,7,2,15,"dummy"
"118817",0,1,0,1,"dummy"
"118818",0,0,0,0,"dummy"
"118819",2,3,0,5,"dummy"
"118820",1,0,0,1,"dummy"
"118823",1,2,1,4,"dummy"
"118825",0,1,0,1,"dummy"
"118826",0,0,1,1,"dummy"
"118831",0,0,0,0,"dummy"
"118832",0,8,0,8,"dummy"
"118833",0,0,1,1,"dummy"
"118834",2,1,0,3,"dummy"
"118835",0,0,0,0,"dummy"
"118836",1,0,0,1,"dummy"
"118837",0,0,0,0,"dummy"
"118838",0,0,0,0,"dummy"
"118852",6,11,1,18,"dummy"
"118853",3,5,0,8,"dummy"
"118858",15,40,12,67,"dummy"
"118859",1,3,3,7,"dummy"
"118861",0,0,1,1,"dummy"
"118862",0,0,1,1,"dummy"
"118864",0,0,0,0,"dummy"
"118865",0,0,0,0,"dummy"
"118866",0,0,0,0,"dummy"
"118867",0,0,0,0,"dummy"
"118868",0,0,0,0,"dummy"
"118869",0,0,0,0,"dummy"
"118906",0,1,0,1,"dummy"
"118907",0,2,0,2,"dummy"
"118908",0,4,0,4,"dummy"
"118909",0,1,1,2,"dummy"
"118910",1,0,0,1,"dummy"
"118911",0,2,2,4,"dummy"
"118912",2,12,3,17,"dummy"
"118913",0,0,1,1,"dummy"
"118915",0,4,0,4,"dummy"
"118916",1,7,0,8,"dummy"
"118917",0,5,0,5,"dummy"
"118920",0,1,0,1,"dummy"
"118921",0,2,0,2,"dummy"
"118965",1,2,3,6,"dummy"
"118966",0,0,4,4,"dummy"
"118967",0,1,0,1,"dummy"
"118968",0,0,1,1,"dummy"
"118969",0,2,0,2,"dummy"
"118970",12,0,0,12,"dummy"
"118971",4,16,1,21,"dummy"
"118972",12,0,0,12,"dummy"
"118973",4,4,1,9,"dummy"
"118974",0,0,0,0,"dummy"
"118977",0,0,1,1,"dummy"
"118978",0,2,0,2,"dummy"
"118979",6,1,0,7,"dummy"
"118980",1,12,1,14,"dummy"
"118981",0,0,1,1,"dummy"
"118982",1,0,0,1,"dummy"
"118983",0,2,0,2,"dummy"
"118984",12,12,0,24,"dummy"
"118985",0,0,1,1,"dummy"
"118986",0,0,0,0,"dummy"
"118987",0,0,0,0,"dummy"
"118988",0,0,1,1,"dummy"
"118989",0,2,0,2,"dummy"
"118990",2,3,2,7,"dummy"
"118991",1,2,0,3,"dummy"
"118992",0,0,0,0,"dummy"
"118994",1,1,0,2,"dummy"
"118995",0,0,1,1,"dummy"
"118996",0,2,0,2,"dummy"
"118997",0,0,4,4,"dummy"
"119008",2,5,2,9,"dummy"
"119009",1,0,0,1,"dummy"
"119010",0,3,0,3,"dummy"
"119011",3,2,0,5,"dummy"
"119013",0,1,0,1,"dummy"
"119015",0,0,1,1,"dummy"
"119016",2,3,2,7,"dummy"
"119017",1,0,0,1,"dummy"
"119018",3,22,2,27,"dummy"
"119021",0,0,1,1,"dummy"
"119022",0,0,0,0,"dummy"
"119025",0,2,0,2,"dummy"
"119026",0,0,1,1,"dummy"
"119031",0,3,0,3,"dummy"
"119034",1,0,0,1,"dummy"
"119035",2,0,1,3,"dummy"
"119036",0,0,0,0,"dummy"
"119037",0,1,0,1,"dummy"
"119038",8,1,0,9,"dummy"
"119039",0,0,0,0,"dummy"
"119040",0,0,0,0,"dummy"
"119041",1,10,0,11,"dummy"
"119042",7,1,0,8,"dummy"
"119043",0,0,1,1,"dummy"
"119044",2,0,3,5,"dummy"
"119047",2,5,2,9,"dummy"
"119049",0,9,3,12,"dummy"
"119050",7,3,0,10,"dummy"
"119051",0,0,1,1,"dummy"
"119052",1,3,2,6,"dummy"
"119053",0,1,0,1,"dummy"
"119055",0,0,1,1,"dummy"
"119056",0,1,1,2,"dummy"
"119057",0,0,1,1,"dummy"
"119058",3,1,2,6,"dummy"
"119061",0,3,0,3,"dummy"
"119064",0,0,1,1,"dummy"
"119065",19,12,4,35,"dummy"
"119067",0,0,0,0,"dummy"
"119069",3,1,0,4,"dummy"
"119070",0,0,0,0,"dummy"
"119071",3,1,1,5,"dummy"
"119079",2,22,0,24,"dummy"
"119081",2,5,0,7,"dummy"
"119082",0,6,0,6,"dummy"
"119083",0,0,0,0,"dummy"
"119084",0,1,0,1,"dummy"
"119085",0,2,0,2,"dummy"
"119087",6,8,0,14,"dummy"
"119088",6,1,0,7,"dummy"
"119091",0,0,1,1,"dummy"
"119098",0,0,2,2,"dummy"
"119102",0,2,0,2,"dummy"
"119105",0,0,0,0,"dummy"
"119106",0,0,0,0,"dummy"
"119109",0,7,1,8,"dummy"
"119110",3,2,0,5,"dummy"
"119111",5,9,1,15,"dummy"
"119112",2,0,0,2,"dummy"
"119113",0,16,0,16,"dummy"
"119115",0,4,4,8,"dummy"
"119116",16,10,4,30,"dummy"
"119117",0,1,0,1,"dummy"
"119118",9,7,5,21,"dummy"
"119119",0,1,0,1,"dummy"
"119120",0,2,1,3,"dummy"
"119121",0,0,0,0,"dummy"
"119122",0,1,0,1,"dummy"
"119123",0,2,0,2,"dummy"
"119124",0,0,1,1,"dummy"
"119125",0,1,0,1,"dummy"
"119143",0,0,0,0,"dummy"
"119144",0,1,0,1,"dummy"
"119149",2,8,1,11,"dummy"
"119152",0,9,0,9,"dummy"
"119153",0,0,1,1,"dummy"
"119155",4,0,0,4,"dummy"
"119158",0,0,3,3,"dummy"
"119159",0,0,1,1,"dummy"
"119160",0,0,1,1,"dummy"
"119162",1,1,0,2,"dummy"
"119164",0,2,1,3,"dummy"
"119165",8,16,2,26,"dummy"
"119166",14,11,1,26,"dummy"
"119167",17,0,0,17,"dummy"
"119168",0,0,0,0,"dummy"
"119169",0,0,0,0,"dummy"
"119170",0,0,0,0,"dummy"
"119171",0,0,1,1,"dummy"
"119172",0,0,1,1,"dummy"
"119173",0,0,0,0,"dummy"
"119174",1,3,1,5,"dummy"
"119175",2,2,1,5,"dummy"
"119176",0,0,1,1,"dummy"
"119177",0,0,1,1,"dummy"
"119178",0,0,1,1,"dummy"
"119179",0,0,1,1,"dummy"
"119180",0,0,1,1,"dummy"
"119181",0,0,1,1,"dummy"
"119182",0,0,1,1,"dummy"
"119183",6,4,2,12,"dummy"
"119184",0,0,1,1,"dummy"
"119185",0,0,1,1,"dummy"
"119186",0,0,1,1,"dummy"
"119187",0,0,1,1,"dummy"
"119188",0,0,1,1,"dummy"
"119189",0,0,1,1,"dummy"
"119208",1,0,0,1,"dummy"
"119209",0,0,1,1,"dummy"
"119212",0,3,0,3,"dummy"
"119213",2,2,0,4,"dummy"
"119214",1,1,0,2,"dummy"
"119215",0,0,1,1,"dummy"
"119216",1,1,1,3,"dummy"
"119217",0,1,1,2,"dummy"
"119218",1,5,0,6,"dummy"
"119219",3,1,0,4,"dummy"
"119220",0,0,2,2,"dummy"
"119221",0,0,2,2,"dummy"
"119222",0,3,0,3,"dummy"
"119223",2,1,0,3,"dummy"
"119224",0,0,1,1,"dummy"
"119225",0,0,1,1,"dummy"
"119226",8,3,0,11,"dummy"
"119227",0,0,2,2,"dummy"
"119228",0,0,2,2,"dummy"
"119229",3,1,0,4,"dummy"
"119230",1,1,0,2,"dummy"
"119231",0,0,1,1,"dummy"
"119232",0,1,0,1,"dummy"
"119234",2,0,3,5,"dummy"
"119239",4,1,1,6,"dummy"
"119241",0,1,0,1,"dummy"
"119243",0,2,0,2,"dummy"
"119244",0,0,1,1,"dummy"
"119245",1,0,0,1,"dummy"
"119246",0,0,1,1,"dummy"
"119247",0,0,0,0,"dummy"
"119248",4,8,0,12,"dummy"
"119249",0,0,0,0,"dummy"
"119250",0,1,0,1,"dummy"
"119251",1,0,0,1,"dummy"
"119252",0,0,0,0,"dummy"
"119319",0,0,1,1,"dummy"
"119320",0,0,1,1,"dummy"
"119321",0,0,1,1,"dummy"
"119322",0,0,1,1,"dummy"
"119326",2,0,0,2,"dummy"
"119328",0,2,0,2,"dummy"
"119330",0,1,0,1,"dummy"
"119332",0,0,1,1,"dummy"
"119333",0,0,1,1,"dummy"
"119334",0,1,0,1,"dummy"
"119336",15,0,4,19,"dummy"
"119338",0,8,0,8,"dummy"
"119339",1,7,1,9,"dummy"
"119340",0,11,0,11,"dummy"
"119341",0,5,2,7,"dummy"
"119343",0,0,1,1,"dummy"
"119344",0,4,0,4,"dummy"
"119345",2,2,1,5,"dummy"
"119346",0,1,0,1,"dummy"
"119347",13,7,3,23,"dummy"
"119348",0,5,0,5,"dummy"
"119349",0,9,2,11,"dummy"
"119350",1,0,0,1,"dummy"
"119352",1,0,0,1,"dummy"
"119353",0,0,0,0,"dummy"
"119354",0,7,0,7,"dummy"
"119355",4,7,1,12,"dummy"
"119356",0,0,0,0,"dummy"
"119357",0,0,1,1,"dummy"
"119359",0,1,0,1,"dummy"
"119361",3,7,5,15,"dummy"
"119362",0,1,0,1,"dummy"
"119363",0,4,1,5,"dummy"
"119364",0,0,6,6,"dummy"
"119365",0,0,4,4,"dummy"
"119371",0,3,0,3,"dummy"
"119374",4,1,0,5,"dummy"
"119375",3,6,0,9,"dummy"
"119376",0,1,0,1,"dummy"
"119377",12,18,2,32,"dummy"
"119378",0,2,0,2,"dummy"
"119379",1,4,1,6,"dummy"
"119380",2,1,0,3,"dummy"
"119381",0,4,0,4,"dummy"
"119382",0,0,1,1,"dummy"
"119383",0,2,0,2,"dummy"
"119384",0,2,0,2,"dummy"
"119385",2,2,0,4,"dummy"
"119386",1,1,0,2,"dummy"
"119387",1,1,0,2,"dummy"
"119388",0,0,0,0,"dummy"
"119389",1,1,0,2,"dummy"
"119390",1,1,0,2,"dummy"
"119391",4,0,0,4,"dummy"
"119392",0,4,0,4,"dummy"
"119393",0,1,0,1,"dummy"
"119394",8,0,0,8,"dummy"
"119395",0,3,0,3,"dummy"
"119396",0,0,1,1,"dummy"
"119397",3,2,0,5,"dummy"
"119398",0,0,1,1,"dummy"
"119399",1,0,0,1,"dummy"
"119400",1,0,0,1,"dummy"
"119401",0,2,0,2,"dummy"
"119402",0,1,0,1,"dummy"
"119403",3,2,0,5,"dummy"
"119404",4,4,0,8,"dummy"
"119411",0,0,1,1,"dummy"
"119412",0,0,1,1,"dummy"
"119413",0,0,1,1,"dummy"
"119414",0,0,1,1,"dummy"
"119417",0,1,0,1,"dummy"
"119419",0,1,0,1,"dummy"
"119420",2,0,0,2,"dummy"
"119421",0,0,0,0,"dummy"
"119423",2,1,0,3,"dummy"
"119424",3,11,4,18,"dummy"
"119425",0,2,0,2,"dummy"
"119426",3,0,0,3,"dummy"
"119427",0,2,2,4,"dummy"
"119428",9,2,1,12,"dummy"
"119430",0,0,1,1,"dummy"
"119434",1,4,0,5,"dummy"
"119435",2,2,2,6,"dummy"
"119436",6,20,0,26,"dummy"
"119438",0,0,2,2,"dummy"
"119439",0,0,2,2,"dummy"
"119441",0,5,2,7,"dummy"
"119444",0,0,1,1,"dummy"
"119445",2,2,0,4,"dummy"
"119449",0,0,1,1,"dummy"
"119458",2,4,0,6,"dummy"
"119459",1,1,0,2,"dummy"
"119460",0,1,0,1,"dummy"
"119461",2,2,0,4,"dummy"
"119462",0,0,1,1,"dummy"
"119463",0,1,0,1,"dummy"
"119464",10,10,5,25,"dummy"
"119465",0,1,1,2,"dummy"
"119466",0,1,1,2,"dummy"
"119467",0,0,1,1,"dummy"
"119468",0,1,0,1,"dummy"
"119469",1,1,0,2,"dummy"
"119470",5,1,1,7,"dummy"
"119471",0,2,0,2,"dummy"
"119472",0,0,0,0,"dummy"
"119473",0,2,0,2,"dummy"
"119474",0,1,0,1,"dummy"
"119476",28,7,0,35,"dummy"
"119477",6,8,1,15,"dummy"
"119478",0,1,0,1,"dummy"
"119479",1,0,0,1,"dummy"
"119480",4,3,0,7,"dummy"
"119481",0,1,0,1,"dummy"
"119482",1,0,0,1,"dummy"
"119483",0,1,0,1,"dummy"
"119484",0,3,0,3,"dummy"
"119485",0,1,0,1,"dummy"
"119486",0,1,0,1,"dummy"
"119488",0,0,1,1,"dummy"
"119489",0,0,1,1,"dummy"
"119490",0,0,1,1,"dummy"
"119494",0,0,0,0,"dummy"
"119500",0,0,3,3,"dummy"
"119501",0,1,0,1,"dummy"
"119502",0,1,0,1,"dummy"
"119503",0,1,0,1,"dummy"
"119504",0,0,2,2,"dummy"
"119505",0,0,4,4,"dummy"
"119506",0,6,0,6,"dummy"
"119507",0,0,0,0,"dummy"
"119508",0,0,0,0,"dummy"
"119510",0,2,0,2,"dummy"
"119512",1,0,3,4,"dummy"
"119514",0,0,0,0,"dummy"
"119515",0,0,0,0,"dummy"
"119516",0,0,0,0,"dummy"
"119517",0,0,3,3,"dummy"
"119518",0,0,0,0,"dummy"
"119521",0,9,2,11,"dummy"
"119523",0,0,1,1,"dummy"
"119524",0,0,1,1,"dummy"
"119525",0,0,1,1,"dummy"
"119526",0,0,2,2,"dummy"
"119527",0,0,1,1,"dummy"
"119528",0,0,1,1,"dummy"
"119529",0,0,1,1,"dummy"
"119530",0,0,1,1,"dummy"
"119531",0,0,1,1,"dummy"
"119532",0,0,1,1,"dummy"
"119533",4,1,1,6,"dummy"
"119536",0,0,0,0,"dummy"
"119537",0,0,0,0,"dummy"
"119538",0,0,2,2,"dummy"
"119539",0,0,4,4,"dummy"
"119540",0,0,3,3,"dummy"
"119561",0,0,0,0,"dummy"
"119562",2,1,0,3,"dummy"
"119563",14,6,1,21,"dummy"
"119564",2,0,0,2,"dummy"
"119565",0,0,1,1,"dummy"
"119566",0,0,1,1,"dummy"
"119567",0,0,1,1,"dummy"
"119568",0,1,0,1,"dummy"
"119569",0,0,1,1,"dummy"
"119570",0,0,1,1,"dummy"
"119572",0,0,0,0,"dummy"
"119573",0,0,1,1,"dummy"
"119575",0,0,1,1,"dummy"
"119595",0,2,0,2,"dummy"
"119596",1,4,3,8,"dummy"
"119598",0,0,1,1,"dummy"
"119599",1,3,0,4,"dummy"
"119600",1,2,0,3,"dummy"
"119601",0,0,1,1,"dummy"
"119602",7,0,2,9,"dummy"
"119603",0,1,2,3,"dummy"
"119614",0,0,0,0,"dummy"
"119615",0,0,1,1,"dummy"
"119616",0,2,0,2,"dummy"
"119621",0,1,0,1,"dummy"
"119623",0,0,2,2,"dummy"
"119639",0,0,0,0,"dummy"
"119640",0,0,0,0,"dummy"
"119641",0,0,0,0,"dummy"
"119642",0,0,0,0,"dummy"
"119643",0,0,0,0,"dummy"
"119647",1,0,0,1,"dummy"
"119648",0,1,0,1,"dummy"
"119649",6,6,1,13,"dummy"
"119650",1,1,0,2,"dummy"
"119651",1,0,0,1,"dummy"
"119652",9,8,0,17,"dummy"
"119654",0,1,1,2,"dummy"
"119655",1,0,0,1,"dummy"
"119656",0,1,0,1,"dummy"
"119657",3,18,3,24,"dummy"
"119658",5,5,0,10,"dummy"
"119659",2,1,0,3,"dummy"
"119661",2,2,0,4,"dummy"
"119662",0,0,2,2,"dummy"
"119663",0,0,1,1,"dummy"
"119664",0,0,1,1,"dummy"
"119665",0,1,1,2,"dummy"
"119666",13,14,1,28,"dummy"
"119667",1,0,0,1,"dummy"
"119668",1,0,0,1,"dummy"
"119669",4,1,0,5,"dummy"
"119670",1,1,0,2,"dummy"
"119671",1,9,0,10,"dummy"
"119672",0,0,0,0,"dummy"
"119675",2,0,1,3,"dummy"
"119677",0,0,4,4,"dummy"
"119678",0,1,0,1,"dummy"
"119684",0,0,3,3,"dummy"
"119685",0,1,0,1,"dummy"
"119690",1,1,0,2,"dummy"
"119691",0,0,1,1,"dummy"
"119692",0,0,1,1,"dummy"
"119693",0,0,1,1,"dummy"
"119694",0,0,1,1,"dummy"
"119695",0,2,1,3,"dummy"
"119696",2,14,1,17,"dummy"
"119697",0,1,0,1,"dummy"
"119698",0,4,0,4,"dummy"
"119699",2,0,0,2,"dummy"
"119700",0,2,0,2,"dummy"
"119701",4,3,0,7,"dummy"
"119702",0,0,0,0,"dummy"
"119703",1,1,0,2,"dummy"
"119705",4,2,1,7,"dummy"
"119706",0,0,1,1,"dummy"
"119708",0,0,2,2,"dummy"
"119709",0,2,0,2,"dummy"
"119710",0,0,1,1,"dummy"
"119712",0,1,0,1,"dummy"
"119713",1,0,1,2,"dummy"
"119714",2,1,6,9,"dummy"
"119715",13,5,2,20,"dummy"
"119716",5,13,2,20,"dummy"
"119721",3,3,1,7,"dummy"
"119722",1,1,0,2,"dummy"
"119723",2,5,0,7,"dummy"
"119726",0,0,1,1,"dummy"
"119727",0,0,0,0,"dummy"
"119728",0,1,0,1,"dummy"
"119729",1,2,0,3,"dummy"
"119746",0,1,1,2,"dummy"
"119748",0,0,1,1,"dummy"
"119750",0,0,0,0,"dummy"
"119751",0,1,0,1,"dummy"
"119752",1,10,0,11,"dummy"
"119753",0,5,0,5,"dummy"
"119754",7,3,0,10,"dummy"
"119755",0,0,0,0,"dummy"
"119756",1,0,2,3,"dummy"
"119757",0,0,4,4,"dummy"
"119758",0,2,0,2,"dummy"
"119759",0,1,0,1,"dummy"
"119763",1,2,0,3,"dummy"
"119764",0,0,2,2,"dummy"
"119766",1,1,0,2,"dummy"
"119767",0,0,3,3,"dummy"
"119768",1,0,1,2,"dummy"
"119772",0,0,1,1,"dummy"
"119774",0,1,0,1,"dummy"
"119775",0,1,0,1,"dummy"
"119776",0,1,0,1,"dummy"
"119785",0,1,0,1,"dummy"
"119788",4,8,2,14,"dummy"
"119791",2,4,0,6,"dummy"
"119792",10,3,2,15,"dummy"
"119798",0,6,0,6,"dummy"
"119799",0,6,0,6,"dummy"
"119800",0,1,0,1,"dummy"
"119801",0,5,0,5,"dummy"
"119802",0,0,1,1,"dummy"
"119803",2,2,0,4,"dummy"
"119804",1,1,0,2,"dummy"
"119805",0,1,0,1,"dummy"
"119806",0,1,0,1,"dummy"
"119807",0,2,0,2,"dummy"
"119808",0,0,2,2,"dummy"
"119810",1,1,0,2,"dummy"
"119811",1,2,0,3,"dummy"
"119812",1,1,0,2,"dummy"
"119813",0,0,1,1,"dummy"
"119814",0,0,1,1,"dummy"
"119816",1,0,1,2,"dummy"
"119817",0,0,1,1,"dummy"
"119818",0,2,1,3,"dummy"
"119819",1,0,0,1,"dummy"
"119820",2,2,0,4,"dummy"
"119821",10,0,0,10,"dummy"
"119822",2,2,0,4,"dummy"
"119826",0,0,1,1,"dummy"
"119827",1,0,1,2,"dummy"
"119828",0,1,0,1,"dummy"
"119831",0,2,0,2,"dummy"
"119833",0,2,3,5,"dummy"
"119834",2,0,3,5,"dummy"
"119835",0,0,2,2,"dummy"
"119839",0,2,0,2,"dummy"
"119853",0,6,0,6,"dummy"
"119854",0,0,1,1,"dummy"
"119855",0,0,1,1,"dummy"
"119856",0,0,2,2,"dummy"
"119857",0,0,1,1,"dummy"
"119858",0,0,1,1,"dummy"
"119860",0,0,0,0,"dummy"
"119861",0,0,0,0,"dummy"
"119862",0,0,0,0,"dummy"
"119863",0,0,0,0,"dummy"
"119864",0,0,0,0,"dummy"
"119865",0,2,4,6,"dummy"
"119866",0,0,0,0,"dummy"
"119867",0,0,0,0,"dummy"
"119868",0,0,2,2,"dummy"
"119869",0,1,0,1,"dummy"
"119870",0,0,0,0,"dummy"
"119871",0,0,0,0,"dummy"
"119872",0,0,0,0,"dummy"
"119873",0,0,0,0,"dummy"
"119875",0,1,1,2,"dummy"
"119876",0,2,0,2,"dummy"
"119877",0,2,0,2,"dummy"
"119878",4,0,0,4,"dummy"
"119879",0,0,1,1,"dummy"
"119880",0,1,0,1,"dummy"
"119881",0,0,1,1,"dummy"
"119882",0,2,0,2,"dummy"
"119883",1,5,0,6,"dummy"
"119884",1,2,0,3,"dummy"
"119891",0,16,0,16,"dummy"
"119892",2,1,0,3,"dummy"
"119893",0,15,1,16,"dummy"
"119894",4,4,0,8,"dummy"
"119895",0,3,0,3,"dummy"
"119897",0,0,0,0,"dummy"
"119898",2,1,3,6,"dummy"
"119899",0,0,1,1,"dummy"
"119900",1,1,0,2,"dummy"
"119901",0,1,0,1,"dummy"
"119902",2,5,1,8,"dummy"
"119903",0,1,0,1,"dummy"
"119905",0,0,1,1,"dummy"
"119906",0,8,0,8,"dummy"
"119908",0,0,1,1,"dummy"
"119909",0,0,1,1,"dummy"
"119910",5,19,0,24,"dummy"
"119922",0,0,0,0,"dummy"
"119926",4,1,0,5,"dummy"
"119927",0,4,0,4,"dummy"
"119929",2,3,0,5,"dummy"
"119930",4,1,0,5,"dummy"
"119931",2,2,3,7,"dummy"
"119932",0,1,0,1,"dummy"
"119933",1,1,0,2,"dummy"
"119935",0,1,0,1,"dummy"
"119936",0,0,1,1,"dummy"
"119937",9,42,2,53,"dummy"
"119939",0,6,3,9,"dummy"
"119943",0,0,0,0,"dummy"
"119944",3,4,0,7,"dummy"
"119945",1,2,1,4,"dummy"
"119946",0,5,0,5,"dummy"
"120031",0,0,1,1,"dummy"
"120032",0,0,1,1,"dummy"
"120033",0,0,1,1,"dummy"
"120036",0,1,0,1,"dummy"
"120037",1,0,0,1,"dummy"
"120038",2,1,0,3,"dummy"
"120047",1,0,1,2,"dummy"
"120048",0,0,2,2,"dummy"
"120049",1,0,0,1,"dummy"
"120050",0,3,4,7,"dummy"
"120051",0,2,0,2,"dummy"
"120059",0,2,1,3,"dummy"
"120060",0,1,0,1,"dummy"
"120061",0,0,1,1,"dummy"
"120062",0,0,1,1,"dummy"
"120063",0,0,1,1,"dummy"
"120069",9,2,2,13,"dummy"
"120083",0,0,1,1,"dummy"
"120084",0,0,1,1,"dummy"
"120085",0,0,1,1,"dummy"
"120086",0,0,1,1,"dummy"
"120087",0,0,1,1,"dummy"
"120088",0,0,1,1,"dummy"
"120089",0,0,1,1,"dummy"
"120090",0,0,1,1,"dummy"
"120091",0,0,1,1,"dummy"
"120092",0,0,1,1,"dummy"
"120093",0,0,1,1,"dummy"
"120094",0,0,1,1,"dummy"
"120095",0,0,1,1,"dummy"
"120191",2,4,0,6,"dummy"
"120192",0,2,0,2,"dummy"
"120193",0,2,0,2,"dummy"
"120194",10,2,0,12,"dummy"
"120195",0,2,0,2,"dummy"
"120206",5,16,3,24,"dummy"
"120210",0,3,1,4,"dummy"
"120217",3,1,2,6,"dummy"
"120226",4,15,5,24,"dummy"
"120227",1,1,1,3,"dummy"
"120242",0,0,0,0,"dummy"
"120243",0,0,0,0,"dummy"
"120244",0,0,2,2,"dummy"
"120245",0,0,1,1,"dummy"
"120246",0,0,1,1,"dummy"
"120250",0,0,2,2,"dummy"
"119950",0,1,0,1,"dummy"
"119951",2,2,4,8,"dummy"
"120015",1,0,1,2,"dummy"
"120016",0,0,0,0,"dummy"
"120017",0,0,2,2,"dummy"
"120018",0,0,1,1,"dummy"
"120023",0,0,0,0,"dummy"
"120024",0,0,3,3,"dummy"
"120029",0,5,0,5,"dummy"
"120057",0,0,7,7,"dummy"
"120067",1,3,0,4,"dummy"
"120071",0,0,0,0,"dummy"
"120074",0,1,0,1,"dummy"
"120081",0,0,1,1,"dummy"
"120097",3,3,1,7,"dummy"
"120098",0,0,1,1,"dummy"
"120099",0,0,1,1,"dummy"
"120100",1,0,0,1,"dummy"
"120101",0,0,0,0,"dummy"
"120102",0,0,0,0,"dummy"
"120110",6,10,5,21,"dummy"
"120111",0,0,1,1,"dummy"
"120112",0,0,1,1,"dummy"
"120181",0,0,2,2,"dummy"
"120199",0,1,0,1,"dummy"
"120200",1,0,0,1,"dummy"
"120208",0,0,1,1,"dummy"
"120229",2,0,0,2,"dummy"
"120230",0,0,1,1,"dummy"
"120231",0,0,4,4,"dummy"
"120234",0,4,0,4,"dummy"
"120235",0,4,0,4,"dummy"
"120236",0,1,0,1,"dummy"
"120237",1,5,0,6,"dummy"
"120238",2,1,1,4,"dummy"
"120239",0,0,2,2,"dummy"
"120240",0,5,0,5,"dummy"
"120248",8,7,1,16,"dummy"
"120365",0,4,1,5,"dummy"
"120366",0,1,0,1,"dummy"
"120367",0,0,1,1,"dummy"
"120368",0,0,1,1,"dummy"
"120369",0,0,1,1,"dummy"
"120372",0,0,0,0,"dummy"
"120373",0,0,0,0,"dummy"
"120440",0,0,1,1,"dummy"
"120441",0,0,1,1,"dummy"
"120442",1,2,0,3,"dummy"
"120451",2,5,1,8,"dummy"
"120454",0,1,2,3,"dummy"
"120455",1,0,1,2,"dummy"
"120456",0,0,1,1,"dummy"
"120457",0,0,1,1,"dummy"
"120458",0,1,1,2,"dummy"
"120459",3,10,3,16,"dummy"
"120462",0,0,1,1,"dummy"
"120463",0,0,1,1,"dummy"
"120464",0,0,1,1,"dummy"
"120465",4,0,2,6,"dummy"
"120466",0,0,0,0,"dummy"
"120467",0,0,1,1,"dummy"
"120468",0,0,1,1,"dummy"
"120499",0,4,0,4,"dummy"
"120500",0,0,1,1,"dummy"
"120501",0,3,0,3,"dummy"
"120502",0,1,0,1,"dummy"
"120503",0,1,0,1,"dummy"
"120504",4,0,1,5,"dummy"
"120532",0,1,0,1,"dummy"
"120535",0,1,0,1,"dummy"
"120536",0,2,0,2,"dummy"
"120543",2,2,0,4,"dummy"
"120544",1,2,0,3,"dummy"
"120545",8,20,4,32,"dummy"
"120546",17,29,3,49,"dummy"
"120547",8,0,0,8,"dummy"
"120548",0,5,0,5,"dummy"
"120558",1,1,0,2,"dummy"
"120559",0,0,0,0,"dummy"
"120560",2,7,1,10,"dummy"
"120573",0,3,0,3,"dummy"
"120574",0,7,1,8,"dummy"
"120575",2,15,0,17,"dummy"
"120604",1,4,1,6,"dummy"
"120610",1,11,0,12,"dummy"
"120619",0,0,2,2,"dummy"
"120620",0,0,1,1,"dummy"
"120621",0,0,1,1,"dummy"
"120375",0,1,0,1,"dummy"
"120376",0,0,0,0,"dummy"
"120390",0,0,0,0,"dummy"
"120419",0,0,0,0,"dummy"
"120420",0,0,3,3,"dummy"
"120425",0,1,0,1,"dummy"
"120428",1,2,1,4,"dummy"
"120431",0,4,1,5,"dummy"
"120432",0,0,1,1,"dummy"
"120433",0,0,1,1,"dummy"
"120434",7,6,0,13,"dummy"
"120444",4,2,1,7,"dummy"
"120470",5,13,4,22,"dummy"
"120496",14,1,0,15,"dummy"
"120497",1,2,0,3,"dummy"
"120506",2,2,0,4,"dummy"
"120507",0,0,0,0,"dummy"
"120508",1,4,1,6,"dummy"
"120509",0,0,0,0,"dummy"
"120510",3,3,1,7,"dummy"
"120511",0,3,1,4,"dummy"
"120512",0,1,0,1,"dummy"
"120513",7,3,0,10,"dummy"
"120514",4,2,0,6,"dummy"
"120515",6,3,0,9,"dummy"
"120516",0,3,0,3,"dummy"
"120517",0,2,0,2,"dummy"
"120518",3,7,2,12,"dummy"
"120519",2,3,0,5,"dummy"
"120520",3,2,0,5,"dummy"
"120521",5,6,1,12,"dummy"
"120522",2,3,0,5,"dummy"
"120523",0,2,0,2,"dummy"
"120524",0,3,0,3,"dummy"
"120525",4,0,0,4,"dummy"
"120526",0,3,0,3,"dummy"
"120527",13,8,2,23,"dummy"
"120528",0,1,0,1,"dummy"
"120529",0,1,0,1,"dummy"
"120530",0,0,2,2,"dummy"
"120538",1,0,0,1,"dummy"
"120539",0,0,1,1,"dummy"
"120550",0,0,0,0,"dummy"
"120551",3,1,0,4,"dummy"
"120552",0,2,0,2,"dummy"
"120553",5,6,2,13,"dummy"
"120554",6,6,0,12,"dummy"
"120564",0,0,1,1,"dummy"
"120565",0,0,2,2,"dummy"
"120566",0,1,1,2,"dummy"
"120583",0,4,0,4,"dummy"
"120584",0,0,1,1,"dummy"
"120585",0,0,1,1,"dummy"
"120586",0,0,1,1,"dummy"
"120587",0,0,1,1,"dummy"
"120588",0,0,1,1,"dummy"
"120589",2,0,0,2,"dummy"
"120590",0,0,1,1,"dummy"
"120591",0,0,1,1,"dummy"
"120592",0,0,1,1,"dummy"
"120593",0,0,1,1,"dummy"
"120594",0,0,1,1,"dummy"
"120595",0,0,1,1,"dummy"
"120596",0,0,1,1,"dummy"
"120599",0,1,0,1,"dummy"
"120600",1,1,1,3,"dummy"
"120601",0,3,0,3,"dummy"
"120602",2,0,0,2,"dummy"
"120606",1,0,1,2,"dummy"
"120607",0,2,0,2,"dummy"
"120608",1,0,0,1,"dummy"
"120634",0,13,3,16,"dummy"
"120699",0,0,1,1,"dummy"
"120709",1,1,0,2,"dummy"
"120710",1,1,0,2,"dummy"
"120711",1,3,0,4,"dummy"
"120714",0,12,0,12,"dummy"
"120721",0,1,0,1,"dummy"
"120722",0,0,1,1,"dummy"
"120723",0,2,0,2,"dummy"
"120724",3,0,1,4,"dummy"
"120725",0,0,1,1,"dummy"
"120735",2,0,0,2,"dummy"
"120741",0,0,1,1,"dummy"
"120742",0,0,0,0,"dummy"
"120743",0,0,0,0,"dummy"
"120744",0,0,0,0,"dummy"
"120745",0,0,1,1,"dummy"
"120746",0,0,0,0,"dummy"
"120747",0,0,0,0,"dummy"
"120764",1,0,0,1,"dummy"
"120770",0,0,1,1,"dummy"
"120780",1,0,0,1,"dummy"
"120781",0,1,0,1,"dummy"
"120782",0,0,1,1,"dummy"
"120783",1,0,1,2,"dummy"
"120784",0,1,1,2,"dummy"
"120785",0,0,1,1,"dummy"
"120786",0,0,1,1,"dummy"
"120787",0,4,0,4,"dummy"
"120788",1,2,0,3,"dummy"
"120789",0,0,1,1,"dummy"
"120790",11,17,5,33,"dummy"
"120793",0,0,2,2,"dummy"
"120806",3,3,2,8,"dummy"
"120807",0,0,1,1,"dummy"
"120812",0,1,0,1,"dummy"
"120825",0,1,0,1,"dummy"
"120826",0,3,0,3,"dummy"
"120827",0,1,0,1,"dummy"
"120828",0,0,1,1,"dummy"
"120836",2,1,0,3,"dummy"
"120837",2,1,0,3,"dummy"
"120841",0,0,1,1,"dummy"
"120842",1,13,1,15,"dummy"
"120843",0,0,2,2,"dummy"
"120844",13,1,0,14,"dummy"
"120852",0,1,0,1,"dummy"
"120853",0,1,0,1,"dummy"
"120854",2,2,2,6,"dummy"
"120855",0,3,2,5,"dummy"
"120856",2,3,0,5,"dummy"
"120857",0,0,1,1,"dummy"
"120863",2,4,0,6,"dummy"
"120864",0,2,0,2,"dummy"
"120865",0,2,0,2,"dummy"
"120866",10,2,0,12,"dummy"
"120867",0,2,0,2,"dummy"
"120868",0,0,0,0,"dummy"
"120869",0,0,3,3,"dummy"
"120870",0,5,0,5,"dummy"
"120878",0,0,1,1,"dummy"
"120624",12,3,1,16,"dummy"
"120625",0,0,0,0,"dummy"
"120626",2,26,4,32,"dummy"
"120627",11,0,4,15,"dummy"
"120628",0,4,0,4,"dummy"
"120631",0,1,0,1,"dummy"
"120632",0,2,0,2,"dummy"
"120638",2,1,0,3,"dummy"
"120641",0,2,0,2,"dummy"
"120642",0,0,1,1,"dummy"
"120643",2,2,0,4,"dummy"
"120644",0,0,1,1,"dummy"
"120697",0,1,0,1,"dummy"
"120701",1,7,1,9,"dummy"
"120702",0,2,2,4,"dummy"
"120703",2,1,0,3,"dummy"
"120704",0,1,0,1,"dummy"
"120705",0,1,0,1,"dummy"
"120706",1,0,0,1,"dummy"
"120707",0,2,0,2,"dummy"
"120718",0,1,0,1,"dummy"
"120719",0,1,0,1,"dummy"
"120737",2,0,2,4,"dummy"
"120753",5,5,5,15,"dummy"
"120756",0,2,0,2,"dummy"
"120757",0,1,0,1,"dummy"
"120758",0,8,0,8,"dummy"
"120759",0,0,1,1,"dummy"
"120760",0,2,0,2,"dummy"
"120761",4,5,0,9,"dummy"
"120762",0,2,0,2,"dummy"
"120766",3,3,0,6,"dummy"
"120767",0,0,1,1,"dummy"
"120768",0,0,0,0,"dummy"
"120776",0,1,0,1,"dummy"
"120795",0,0,1,1,"dummy"
"120800",0,0,0,0,"dummy"
"120801",5,4,5,14,"dummy"
"120802",1,2,0,3,"dummy"
"120803",0,1,0,1,"dummy"
"120804",0,2,0,2,"dummy"
"120809",0,0,1,1,"dummy"
"120810",0,0,1,1,"dummy"
"120814",0,0,1,1,"dummy"
"120815",0,0,1,1,"dummy"
"120816",0,0,1,1,"dummy"
"120817",0,0,1,1,"dummy"
"120818",0,0,1,1,"dummy"
"120819",0,0,1,1,"dummy"
"120823",0,1,0,1,"dummy"
"120832",0,0,1,1,"dummy"
"120833",0,0,1,1,"dummy"
"120834",7,1,0,8,"dummy"
"120839",0,0,1,1,"dummy"
"120846",9,0,3,12,"dummy"
"120849",0,0,1,1,"dummy"
"120850",1,0,0,1,"dummy"
"120861",0,0,0,0,"dummy"
"120872",0,3,0,3,"dummy"
"120873",0,1,0,1,"dummy"
"120874",0,0,1,1,"dummy"
"120875",5,7,1,13,"dummy"
"120876",0,4,7,11,"dummy"
"120883",2,0,0,2,"dummy"
"120891",0,1,3,4,"dummy"
"120892",0,3,0,3,"dummy"
"120908",0,0,0,0,"dummy"
"120909",0,2,0,2,"dummy"
"120910",0,2,0,2,"dummy"
"120879",0,0,1,1,"dummy"
"120880",2,6,0,8,"dummy"
"120881",16,43,2,61,"dummy"
"120885",0,3,0,3,"dummy"
"120886",7,16,1,24,"dummy"
"120887",4,5,3,12,"dummy"
"120894",0,0,1,1,"dummy"
"120895",0,6,0,6,"dummy"
"120896",6,20,0,26,"dummy"
"120897",0,0,2,2,"dummy"
"120898",1,0,0,1,"dummy"
"120899",9,16,4,29,"dummy"
"120900",10,1,0,11,"dummy"
"120901",2,0,0,2,"dummy"
"120902",0,2,0,2,"dummy"
"120903",0,1,0,1,"dummy"
"120904",0,14,0,14,"dummy"
"120905",0,1,0,1,"dummy"
"120906",0,0,1,1,"dummy"
"120917",1,8,0,9,"dummy"
"120918",0,0,0,0,"dummy"
"120919",0,0,0,0,"dummy"
"120920",0,0,0,0,"dummy"
"120921",0,0,0,0,"dummy"
"120922",0,0,0,0,"dummy"
"120923",0,0,0,0,"dummy"
"120924",0,0,0,0,"dummy"
"120925",0,0,0,0,"dummy"
"120934",2,0,3,5,"dummy"
"120937",0,0,1,1,"dummy"
"120938",0,13,0,13,"dummy"
"120939",2,4,0,6,"dummy"
"120940",7,48,6,61,"dummy"
"120941",4,4,0,8,"dummy"
"120942",7,14,5,26,"dummy"
"120943",0,3,0,3,"dummy"
"120944",0,2,0,2,"dummy"
"120945",1,0,0,1,"dummy"
"120946",0,1,0,1,"dummy"
"120947",159,5,9,173,"dummy"
"120950",0,0,0,0,"dummy"
"120951",0,0,0,0,"dummy"
"120952",0,0,1,1,"dummy"
"120953",2,1,0,3,"dummy"
"120954",1,0,0,1,"dummy"
"120955",1,0,0,1,"dummy"
"120956",1,0,0,1,"dummy"
"120957",0,0,0,0,"dummy"
"120958",2,0,0,2,"dummy"
"120959",0,2,1,3,"dummy"
"120960",2,0,0,2,"dummy"
"120961",0,0,1,1,"dummy"
"120962",0,0,0,0,"dummy"
"120963",1,2,0,3,"dummy"
"120964",0,0,0,0,"dummy"
"120965",0,0,0,0,"dummy"
"120966",0,0,0,0,"dummy"
"120967",0,0,0,0,"dummy"
"120970",0,1,1,2,"dummy"
"120971",0,2,0,2,"dummy"
"120972",0,5,0,5,"dummy"
"120911",0,6,0,6,"dummy"
"120912",0,1,0,1,"dummy"
"120913",1,4,0,5,"dummy"
"120914",2,0,0,2,"dummy"
"120915",0,0,1,1,"dummy"
"120927",0,1,0,1,"dummy"
"120930",0,1,0,1,"dummy"
"120975",0,3,0,3,"dummy"
"120976",0,2,0,2,"dummy"
"120987",0,9,0,9,"dummy"
"120988",10,0,0,10,"dummy"
"120989",0,0,4,4,"dummy"
"120993",2,8,3,13,"dummy"
"120994",5,0,0,5,"dummy"
"120996",0,0,0,0,"dummy"
"120999",0,1,0,1,"dummy"
"121001",0,0,1,1,"dummy"
"121003",0,0,1,1,"dummy"
"121004",0,0,1,1,"dummy"
"121005",0,0,1,1,"dummy"
"121006",0,0,1,1,"dummy"
"121007",1,4,1,6,"dummy"
"121008",5,5,1,11,"dummy"
"121016",0,2,0,2,"dummy"
"121018",5,6,1,12,"dummy"
"121019",1,1,0,2,"dummy"
"121028",0,2,0,2,"dummy"
"121029",1,1,1,3,"dummy"
"121030",0,0,1,1,"dummy"
"121031",0,0,1,1,"dummy"
"121032",0,0,4,4,"dummy"
"121033",0,0,2,2,"dummy"
"121034",7,0,0,7,"dummy"
"121036",0,3,0,3,"dummy"
"121039",0,0,1,1,"dummy"
"121041",0,0,1,1,"dummy"
"121042",4,2,0,6,"dummy"
"121043",3,2,0,5,"dummy"
"121044",1,0,0,1,"dummy"
"121045",0,1,0,1,"dummy"
"121046",1,0,0,1,"dummy"
"121047",3,5,4,12,"dummy"
"121048",1,0,0,1,"dummy"
"121049",0,0,2,2,"dummy"
"121050",0,1,0,1,"dummy"
"121056",0,0,1,1,"dummy"
"121059",0,2,1,3,"dummy"
"121061",0,0,4,4,"dummy"
"121062",1,0,0,1,"dummy"
"121063",0,1,0,1,"dummy"
"121074",0,1,0,1,"dummy"
"121075",0,0,3,3,"dummy"
"121077",1,0,1,2,"dummy"
"121078",2,0,3,5,"dummy"
"121079",1,0,0,1,"dummy"
"121080",1,2,0,3,"dummy"
"121081",0,8,0,8,"dummy"
"121082",9,0,0,9,"dummy"
"121087",14,6,4,24,"dummy"
"121088",1,0,0,1,"dummy"
"121089",0,0,4,4,"dummy"
"121090",0,3,0,3,"dummy"
"121091",0,0,3,3,"dummy"
"121092",0,0,4,4,"dummy"
"121094",0,4,3,7,"dummy"
"121095",0,0,2,2,"dummy"
"121096",1,0,0,1,"dummy"
"121097",0,0,3,3,"dummy"
"121098",1,0,0,1,"dummy"
"121099",5,1,0,6,"dummy"
"121100",4,0,0,4,"dummy"
"121101",7,3,4,14,"dummy"
"121104",0,0,1,1,"dummy"
"121107",0,0,1,1,"dummy"
"121110",0,5,0,5,"dummy"
"121163",1,0,0,1,"dummy"
"121166",2,4,0,6,"dummy"
"121167",0,2,0,2,"dummy"
"121168",0,2,0,2,"dummy"
"121169",10,2,0,12,"dummy"
"121170",0,2,0,2,"dummy"
"121171",0,0,0,0,"dummy"
"121173",0,1,0,1,"dummy"
"121178",1,7,5,13,"dummy"
"121180",0,1,0,1,"dummy"
"121181",3,0,0,3,"dummy"
"121182",0,8,0,8,"dummy"
"121183",0,3,0,3,"dummy"
"121185",0,0,0,0,"dummy"
"121186",0,0,0,0,"dummy"
"121187",0,0,0,0,"dummy"
"121188",0,0,0,0,"dummy"
"121189",0,0,0,0,"dummy"
"121190",0,0,0,0,"dummy"
"121191",0,0,0,0,"dummy"
"121192",0,0,0,0,"dummy"
"121201",1,1,1,3,"dummy"
"121203",0,2,1,3,"dummy"
"121206",0,0,3,3,"dummy"
"121207",0,1,0,1,"dummy"
"121208",0,1,0,1,"dummy"
"121210",7,5,0,12,"dummy"
"121211",2,2,0,4,"dummy"
"121215",0,0,1,1,"dummy"
"121216",9,6,0,15,"dummy"
"121220",1,11,0,12,"dummy"
"121222",4,6,2,12,"dummy"
"121223",0,0,0,0,"dummy"
"121224",0,0,1,1,"dummy"
"121226",0,2,0,2,"dummy"
"121227",2,0,0,2,"dummy"
"121228",0,2,0,2,"dummy"
"121229",2,0,0,2,"dummy"
"121230",0,1,0,1,"dummy"
"121231",0,1,0,1,"dummy"
"121232",0,0,1,1,"dummy"
"121233",0,0,1,1,"dummy"
"121234",3,3,1,7,"dummy"
"121235",0,0,1,1,"dummy"
"121236",0,0,1,1,"dummy"
"121237",0,0,1,1,"dummy"
"121238",0,0,1,1,"dummy"
"121239",0,0,1,1,"dummy"
"121240",0,0,1,1,"dummy"
"121241",0,0,1,1,"dummy"
"121242",0,0,1,1,"dummy"
"121243",0,0,1,1,"dummy"
"121244",0,0,1,1,"dummy"
"121245",0,0,1,1,"dummy"
"121246",0,0,1,1,"dummy"
"121247",0,0,1,1,"dummy"
"121248",0,0,1,1,"dummy"
"121249",0,0,1,1,"dummy"
"121251",1,1,1,3,"dummy"
"121252",1,1,0,2,"dummy"
"121253",2,3,1,6,"dummy"
"121255",0,0,1,1,"dummy"
"121258",0,1,0,1,"dummy"
"121260",0,1,0,1,"dummy"
"121264",0,0,1,1,"dummy"
"121269",0,1,0,1,"dummy"
"121272",0,1,0,1,"dummy"
"121273",1,0,0,1,"dummy"
"121274",0,0,1,1,"dummy"
"121275",2,2,5,9,"dummy"
"121277",0,3,0,3,"dummy"
"121278",0,1,0,1,"dummy"
"121280",0,0,1,1,"dummy"
"121281",0,0,1,1,"dummy"
"121282",0,0,1,1,"dummy"
"121283",1,3,0,4,"dummy"
"121284",0,0,2,2,"dummy"
"121290",0,0,1,1,"dummy"
"121291",0,2,3,5,"dummy"
"121294",0,6,1,7,"dummy"
"121297",2,2,2,6,"dummy"
"121298",2,2,1,5,"dummy"
"121299",1,9,1,11,"dummy"
"121300",0,0,1,1,"dummy"
"121301",2,2,2,6,"dummy"
"121302",0,1,2,3,"dummy"
"121303",2,2,1,5,"dummy"
"121304",0,2,0,2,"dummy"
"121305",0,0,1,1,"dummy"
"121355",0,2,1,3,"dummy"
"121356",0,1,0,1,"dummy"
"121357",0,0,1,1,"dummy"
"121363",2,0,4,6,"dummy"
"121364",0,0,0,0,"dummy"
"121365",0,1,0,1,"dummy"
"121366",0,0,1,1,"dummy"
"121397",0,1,0,1,"dummy"
"121399",0,1,0,1,"dummy"
"121400",0,4,0,4,"dummy"
"121401",0,1,0,1,"dummy"
"121406",1,0,0,1,"dummy"
"121407",1,10,0,11,"dummy"
"121408",0,0,3,3,"dummy"
"121413",0,1,0,1,"dummy"
"121414",0,1,0,1,"dummy"
"121415",1,0,0,1,"dummy"
"121416",0,2,2,4,"dummy"
"121417",0,0,1,1,"dummy"
"121418",0,0,1,1,"dummy"
"121420",0,0,0,0,"dummy"
"121421",0,0,3,3,"dummy"
"121424",0,2,0,2,"dummy"
"121425",1,0,0,1,"dummy"
"121426",0,0,0,0,"dummy"
"121427",5,0,1,6,"dummy"
"121430",4,5,2,11,"dummy"
"121433",0,4,0,4,"dummy"
"121434",1,0,0,1,"dummy"
"121435",1,0,0,1,"dummy"
"121436",2,0,0,2,"dummy"
"121437",0,0,2,2,"dummy"
"121438",3,0,1,4,"dummy"
"121439",0,0,1,1,"dummy"
"121440",0,0,1,1,"dummy"
"121441",0,0,1,1,"dummy"
"121443",0,16,0,16,"dummy"
"121444",0,3,0,3,"dummy"
"121445",1,0,0,1,"dummy"
"121446",0,1,0,1,"dummy"
"121447",4,29,1,34,"dummy"
"121448",0,0,1,1,"dummy"
"121449",3,0,1,4,"dummy"
"121450",0,1,0,1,"dummy"
"121452",0,0,2,2,"dummy"
"121453",0,1,0,1,"dummy"
"121454",0,4,1,5,"dummy"
"121455",0,1,0,1,"dummy"
"121456",4,3,1,8,"dummy"
"121457",0,0,1,1,"dummy"
"121458",0,0,0,0,"dummy"
"121459",0,5,0,5,"dummy"
"121462",0,1,0,1,"dummy"
"121463",0,0,1,1,"dummy"
"121465",8,4,0,12,"dummy"
"121467",2,7,0,9,"dummy"
"121468",0,0,1,1,"dummy"
"121469",0,0,1,1,"dummy"
"121470",0,1,0,1,"dummy"
"121471",7,1,2,10,"dummy"
"121472",1,9,3,13,"dummy"
"121473",2,0,1,3,"dummy"
"121474",0,0,1,1,"dummy"
"121475",2,2,0,4,"dummy"
"121476",0,0,0,0,"dummy"
"121478",0,2,0,2,"dummy"
"121479",0,1,0,1,"dummy"
"121480",1,0,0,1,"dummy"
"121481",1,0,0,1,"dummy"
"121482",0,0,1,1,"dummy"
"121484",0,1,0,1,"dummy"
"121487",0,2,2,4,"dummy"
"121491",6,4,4,14,"dummy"
"121493",0,0,1,1,"dummy"
"121494",0,0,0,0,"dummy"
"121497",0,1,0,1,"dummy"
"121499",0,0,0,0,"dummy"
"121500",0,0,0,0,"dummy"
"121503",0,3,0,3,"dummy"
"121504",0,0,0,0,"dummy"
"121507",1,0,0,1,"dummy"
"121508",0,0,1,1,"dummy"
"121509",0,1,2,3,"dummy"
"121511",0,0,1,1,"dummy"
"121512",3,20,1,24,"dummy"
"121513",2,11,1,14,"dummy"
"121514",2,9,1,12,"dummy"
"121515",0,0,0,0,"dummy"
"121516",0,0,0,0,"dummy"
"121517",0,0,1,1,"dummy"
"121518",0,2,0,2,"dummy"
"121537",0,6,0,6,"dummy"
"121538",0,2,0,2,"dummy"
"121539",1,0,0,1,"dummy"
"121540",0,0,1,1,"dummy"
"121541",0,3,0,3,"dummy"
"121542",0,0,1,1,"dummy"
"121546",0,1,0,1,"dummy"
"121547",0,5,0,5,"dummy"
"121548",0,2,1,3,"dummy"
"121549",0,0,1,1,"dummy"
"121551",0,3,0,3,"dummy"
"121552",1,0,4,5,"dummy"
"121553",0,0,0,0,"dummy"
"121554",0,3,0,3,"dummy"
"121555",0,0,0,0,"dummy"
"121556",0,0,1,1,"dummy"
"121561",0,1,0,1,"dummy"
"121564",2,1,0,3,"dummy"
"121565",0,0,1,1,"dummy"
"121566",0,0,1,1,"dummy"
"121567",14,9,0,23,"dummy"
"121568",0,1,0,1,"dummy"
"121571",0,0,4,4,"dummy"
"121572",2,3,0,5,"dummy"
"121573",5,5,0,10,"dummy"
"121575",0,1,0,1,"dummy"
"121576",0,0,1,1,"dummy"
"121581",0,1,2,3,"dummy"
"121582",0,0,0,0,"dummy"
"121583",0,1,0,1,"dummy"
"121584",4,0,2,6,"dummy"
"121585",1,0,0,1,"dummy"
"121586",0,0,0,0,"dummy"
"121588",0,0,2,2,"dummy"
"121590",0,7,3,10,"dummy"
"121591",0,2,1,3,"dummy"
"121592",3,6,0,9,"dummy"
"121593",2,0,0,2,"dummy"
"121596",0,0,0,0,"dummy"
"121597",0,0,0,0,"dummy"
"121598",0,0,0,0,"dummy"
"121599",0,0,0,0,"dummy"
"121600",0,0,0,0,"dummy"
"121601",0,0,0,0,"dummy"
"121632",0,0,1,1,"dummy"
"121634",0,1,0,1,"dummy"
"121635",0,2,0,2,"dummy"
"121636",0,0,0,0,"dummy"
"121637",0,0,1,1,"dummy"
"121638",2,0,0,2,"dummy"
"121639",0,1,0,1,"dummy"
"121640",1,1,2,4,"dummy"
"121641",0,1,0,1,"dummy"
"121645",1,1,0,2,"dummy"
"121646",0,0,0,0,"dummy"
"121647",0,5,0,5,"dummy"
"121648",0,2,0,2,"dummy"
"121652",0,4,0,4,"dummy"
"121654",1,9,0,10,"dummy"
"121655",6,0,0,6,"dummy"
"121656",0,6,0,6,"dummy"
"121659",0,1,0,1,"dummy"
"121661",1,8,2,11,"dummy"
"121663",2,7,0,9,"dummy"
"121664",1,0,0,1,"dummy"
"121665",0,0,1,1,"dummy"
"121666",0,6,0,6,"dummy"
"121667",2,9,0,11,"dummy"
"121668",0,2,0,2,"dummy"
"121670",0,0,0,0,"dummy"
"121671",0,0,0,0,"dummy"
"121673",0,0,0,0,"dummy"
"121674",0,0,0,0,"dummy"
"121675",0,0,0,0,"dummy"
"121676",0,0,0,0,"dummy"
"121677",0,0,0,0,"dummy"
"121692",0,1,0,1,"dummy"
"121693",0,1,0,1,"dummy"
"121694",1,0,0,1,"dummy"
"121695",0,4,0,4,"dummy"
"121696",0,1,0,1,"dummy"
"121697",4,4,0,8,"dummy"
"121698",1,0,3,4,"dummy"
"121699",3,3,0,6,"dummy"
"121700",3,3,0,6,"dummy"
"121701",3,0,0,3,"dummy"
"121702",0,3,0,3,"dummy"
"121703",1,2,0,3,"dummy"
"121704",2,1,0,3,"dummy"
"121705",1,0,0,1,"dummy"
"121706",0,1,0,1,"dummy"
"121707",0,2,0,2,"dummy"
"121708",1,0,0,1,"dummy"
"121723",36,24,4,64,"dummy"
"121724",2,5,1,8,"dummy"
"121725",0,1,0,1,"dummy"
"121730",0,1,0,1,"dummy"
"121732",4,0,0,4,"dummy"
"121734",0,2,0,2,"dummy"
"121736",6,0,0,6,"dummy"
"121737",0,1,0,1,"dummy"
"121738",0,1,0,1,"dummy"
"121739",1,0,0,1,"dummy"
"121740",2,14,0,16,"dummy"
"121742",2,0,3,5,"dummy"
"121745",0,0,2,2,"dummy"
"121746",9,3,2,14,"dummy"
"121747",1,0,0,1,"dummy"
"121748",0,1,0,1,"dummy"
"121749",3,1,0,4,"dummy"
"121750",0,0,1,1,"dummy"
"121751",0,2,0,2,"dummy"
"121752",1,0,1,2,"dummy"
"121753",0,0,1,1,"dummy"
"121754",1,0,0,1,"dummy"
"121831",7,39,4,50,"dummy"
"121858",0,1,0,1,"dummy"
"121859",0,1,0,1,"dummy"
"121861",0,0,1,1,"dummy"
"121862",0,0,1,1,"dummy"
"121865",0,2,2,4,"dummy"
"121866",5,5,0,10,"dummy"
"121867",9,9,0,18,"dummy"
"121868",0,3,0,3,"dummy"
"121870",1,2,0,3,"dummy"
"121889",3,3,0,6,"dummy"
"121891",2,0,0,2,"dummy"
"121892",0,2,0,2,"dummy"
"121893",0,0,1,1,"dummy"
"121897",7,13,9,29,"dummy"
"121898",0,2,0,2,"dummy"
"121899",1,2,1,4,"dummy"
"121900",0,2,1,3,"dummy"
"121901",0,0,1,1,"dummy"
"121902",1,1,0,2,"dummy"
"121903",0,2,0,2,"dummy"
"121904",0,0,0,0,"dummy"
"121905",0,6,0,6,"dummy"
"121906",0,1,0,1,"dummy"
"121907",0,1,0,1,"dummy"
"121908",0,3,0,3,"dummy"
"121909",0,0,0,0,"dummy"
"121910",0,0,0,0,"dummy"
"121911",0,0,0,0,"dummy"
"121912",0,0,0,0,"dummy"
"121934",8,1,0,9,"dummy"
"121935",0,0,1,1,"dummy"
"121936",0,0,3,3,"dummy"
"121950",0,0,0,0,"dummy"
"121951",0,0,0,0,"dummy"
"121952",0,0,0,0,"dummy"
"121954",4,8,11,23,"dummy"
"121955",0,0,1,1,"dummy"
"121957",0,0,1,1,"dummy"
"121959",0,0,0,0,"dummy"
"121960",0,0,0,0,"dummy"
"121961",0,0,0,0,"dummy"
"121962",0,0,0,0,"dummy"
"121963",0,0,0,0,"dummy"
"121964",0,0,0,0,"dummy"
"121965",0,0,0,0,"dummy"
"121966",0,0,1,1,"dummy"
"121967",0,0,0,0,"dummy"
"121968",0,0,0,0,"dummy"
"121969",0,0,0,0,"dummy"
"121971",0,0,1,1,"dummy"
"121972",1,2,2,5,"dummy"
"121973",0,0,2,2,"dummy"
"121974",0,0,0,0,"dummy"
"121975",6,1,1,8,"dummy"
"121976",0,2,2,4,"dummy"
"121977",0,1,0,1,"dummy"
"121978",10,14,2,26,"dummy"
"121979",0,0,0,0,"dummy"
"121980",0,3,1,4,"dummy"
"121981",2,5,1,8,"dummy"
"121982",7,10,1,18,"dummy"
"121983",0,1,0,1,"dummy"
"121984",0,0,0,0,"dummy"
"121985",0,0,0,0,"dummy"
"121986",1,12,1,14,"dummy"
"121987",0,1,1,2,"dummy"
"121988",0,0,2,2,"dummy"
"121989",0,0,1,1,"dummy"
"121990",0,0,1,1,"dummy"
"121991",0,0,1,1,"dummy"
"121992",0,0,1,1,"dummy"
"121993",0,0,1,1,"dummy"
"121994",0,0,1,1,"dummy"
"121995",0,0,1,1,"dummy"
"121996",0,0,1,1,"dummy"
"121997",0,0,1,1,"dummy"
"121998",0,0,1,1,"dummy"
"121999",0,0,1,1,"dummy"
"122000",0,1,0,1,"dummy"
"122001",0,0,1,1,"dummy"
"122002",0,0,1,1,"dummy"
"122003",0,0,1,1,"dummy"
"122004",0,0,1,1,"dummy"
"122005",0,0,1,1,"dummy"
"122006",0,0,1,1,"dummy"
"122007",0,0,3,3,"dummy"
"122008",0,0,1,1,"dummy"
"122009",0,0,1,1,"dummy"
"122011",1,1,0,2,"dummy"
"122012",0,1,1,2,"dummy"
"122013",0,1,0,1,"dummy"
"122014",2,3,0,5,"dummy"
"122015",1,1,1,3,"dummy"
"122016",0,0,1,1,"dummy"
"122017",4,0,1,5,"dummy"
"122018",0,0,1,1,"dummy"
"122019",0,0,2,2,"dummy"
"122020",0,0,1,1,"dummy"
"122022",0,18,1,19,"dummy"
"122023",0,14,2,16,"dummy"
"122024",0,2,2,4,"dummy"
"122025",0,0,1,1,"dummy"
"122026",0,1,0,1,"dummy"
"122032",0,8,0,8,"dummy"
"122033",0,5,0,5,"dummy"
"122034",0,4,0,4,"dummy"
"122035",6,0,2,8,"dummy"
"122062",0,1,0,1,"dummy"
"122063",1,0,1,2,"dummy"
"122064",0,2,0,2,"dummy"
"122065",0,14,0,14,"dummy"
"122066",14,0,0,14,"dummy"
"122067",0,14,0,14,"dummy"
"122071",0,0,0,0,"dummy"
"122072",0,0,0,0,"dummy"
"122073",4,0,1,5,"dummy"
"122074",1,2,0,3,"dummy"
"122075",4,4,1,9,"dummy"
"122076",0,6,0,6,"dummy"
"122077",0,2,0,2,"dummy"
"122078",0,0,1,1,"dummy"
"122079",0,4,0,4,"dummy"
"122081",0,2,0,2,"dummy"
"122083",2,1,2,5,"dummy"
"122084",2,1,1,4,"dummy"
"122085",1,2,1,4,"dummy"
"122086",0,0,2,2,"dummy"
"122087",1,1,2,4,"dummy"
"122093",1,3,0,4,"dummy"
"122094",2,1,0,3,"dummy"
"122095",1,2,0,3,"dummy"
"122096",0,0,1,1,"dummy"
"122104",0,1,0,1,"dummy"
"122113",0,0,1,1,"dummy"
"122114",0,1,0,1,"dummy"
"122115",0,0,1,1,"dummy"
"122116",0,0,1,1,"dummy"
"122117",3,21,0,24,"dummy"
"122118",2,1,0,3,"dummy"
"122119",3,4,0,7,"dummy"
"122120",1,9,0,10,"dummy"
"122121",8,6,1,15,"dummy"
"122122",6,27,2,35,"dummy"
"122123",0,1,0,1,"dummy"
"122124",1,0,0,1,"dummy"
"122130",5,1,6,12,"dummy"
"122134",1,12,0,13,"dummy"
"122135",2,1,0,3,"dummy"
"122136",0,1,0,1,"dummy"
"122137",2,2,1,5,"dummy"
"122138",2,0,0,2,"dummy"
"122146",0,0,1,1,"dummy"
"122147",0,0,0,0,"dummy"
"122148",0,0,0,0,"dummy"
"122153",0,0,0,0,"dummy"
"122154",0,0,0,0,"dummy"
"122156",2,2,0,4,"dummy"
"122157",0,0,3,3,"dummy"
"122158",0,0,0,0,"dummy"
"122159",0,1,0,1,"dummy"
"122160",0,0,2,2,"dummy"
"122163",0,12,0,12,"dummy"
"122165",0,1,0,1,"dummy"
"122166",0,1,0,1,"dummy"
"122167",1,0,0,1,"dummy"
"122169",0,3,0,3,"dummy"
"122174",5,8,6,19,"dummy"
"122176",0,1,0,1,"dummy"
"122184",4,1,0,5,"dummy"
"122186",0,3,2,5,"dummy"
"122187",4,5,0,9,"dummy"
"122188",1,0,1,2,"dummy"
"122189",3,1,0,4,"dummy"
"122190",0,0,1,1,"dummy"
"122191",0,1,0,1,"dummy"
"122192",3,0,1,4,"dummy"
"122193",0,0,1,1,"dummy"
"122194",0,2,2,4,"dummy"
"122195",0,1,0,1,"dummy"
"122196",3,6,0,9,"dummy"
"122197",3,1,0,4,"dummy"
"122198",1,2,0,3,"dummy"
"122199",0,0,1,1,"dummy"
"122200",2,5,0,7,"dummy"
"122202",0,0,0,0,"dummy"
"122204",2,4,0,6,"dummy"
"122205",0,2,0,2,"dummy"
"122206",0,2,0,2,"dummy"
"122207",10,2,0,12,"dummy"
"122208",0,2,0,2,"dummy"
"122209",0,0,0,0,"dummy"
"122210",0,0,3,3,"dummy"
"122211",0,5,0,5,"dummy"
"122213",0,0,0,0,"dummy"
"122215",3,2,0,5,"dummy"
"122216",1,1,0,2,"dummy"
"122218",4,0,0,4,"dummy"
"122219",0,1,0,1,"dummy"
"122220",0,0,1,1,"dummy"
"122221",0,0,0,0,"dummy"
"122222",0,6,0,6,"dummy"
"122223",0,0,0,0,"dummy"
"122224",0,11,1,12,"dummy"
"122225",0,3,0,3,"dummy"
"122226",0,4,0,4,"dummy"
"122227",3,8,0,11,"dummy"
"122228",0,2,0,2,"dummy"
"122229",8,9,0,17,"dummy"
"122230",0,2,0,2,"dummy"
"122231",8,7,0,15,"dummy"
"122232",6,4,0,10,"dummy"
"122233",0,0,3,3,"dummy"
"122235",0,10,0,10,"dummy"
"122237",0,0,0,0,"dummy"
"122238",6,7,2,15,"dummy"
"122240",0,2,0,2,"dummy"
"122241",0,1,0,1,"dummy"
"122242",0,4,0,4,"dummy"
"122243",0,0,1,1,"dummy"
"122244",4,1,1,6,"dummy"
"122245",1,4,1,6,"dummy"
"122246",0,0,1,1,"dummy"
"122247",0,2,1,3,"dummy"
"122248",13,5,2,20,"dummy"
"122249",1,0,2,3,"dummy"
"122250",12,5,2,19,"dummy"
"122251",2,2,0,4,"dummy"
"122252",0,0,1,1,"dummy"
"122253",0,0,1,1,"dummy"
"122254",0,0,1,1,"dummy"
"122255",0,0,1,1,"dummy"
"122256",0,0,1,1,"dummy"
"122257",0,0,1,1,"dummy"
"122258",0,0,1,1,"dummy"
"122259",0,0,1,1,"dummy"
"122260",0,0,1,1,"dummy"
"122261",7,5,2,14,"dummy"
"122262",0,0,1,1,"dummy"
"122263",0,2,0,2,"dummy"
"122264",4,2,0,6,"dummy"
"122265",0,0,1,1,"dummy"
"122266",0,0,1,1,"dummy"
"122267",0,0,1,1,"dummy"
"122268",0,0,1,1,"dummy"
"122270",0,0,1,1,"dummy"
"122271",0,0,0,0,"dummy"
"122273",0,2,0,2,"dummy"
"122274",0,4,3,7,"dummy"
"122275",0,0,2,2,"dummy"
"122276",1,0,0,1,"dummy"
"122277",0,0,3,3,"dummy"
"122278",5,1,0,6,"dummy"
"122279",5,0,0,5,"dummy"
"122280",7,3,4,14,"dummy"
"122284",1,3,0,4,"dummy"
"122285",0,0,0,0,"dummy"
"122289",0,0,1,1,"dummy"
"122290",0,0,1,1,"dummy"
"122291",0,0,1,1,"dummy"
"122292",0,0,1,1,"dummy"
"122293",1,4,1,6,"dummy"
"122294",0,0,0,0,"dummy"
"122295",5,5,1,11,"dummy"
"122297",1,0,0,1,"dummy"
"122298",0,2,2,4,"dummy"
"122299",0,0,0,0,"dummy"
"122300",3,3,0,6,"dummy"
"122301",0,2,0,2,"dummy"
"122303",0,5,0,5,"dummy"
"122304",0,0,1,1,"dummy"
"122305",1,0,4,5,"dummy"
"122306",0,0,1,1,"dummy"
"122307",0,3,0,3,"dummy"
"122308",0,0,1,1,"dummy"
"122310",1,0,0,1,"dummy"
"122314",0,0,0,0,"dummy"
"122315",0,25,0,25,"dummy"
"122316",0,1,0,1,"dummy"
"122317",0,4,0,4,"dummy"
"122318",0,2,0,2,"dummy"
"122319",1,0,1,2,"dummy"
"122333",0,0,1,1,"dummy"
"122334",0,1,0,1,"dummy"
"122341",0,0,1,1,"dummy"
"122342",0,0,1,1,"dummy"
"122343",0,0,1,1,"dummy"
"122347",0,0,0,0,"dummy"
"122352",0,16,0,16,"dummy"
"122354",1,7,0,8,"dummy"
"122357",0,1,1,2,"dummy"
"122358",0,6,0,6,"dummy"
"122359",6,1,0,7,"dummy"
"122363",0,0,1,1,"dummy"
"122372",1,1,0,2,"dummy"
"122373",0,1,0,1,"dummy"
"122376",0,3,0,3,"dummy"
"122377",0,5,0,5,"dummy"
"122378",0,2,0,2,"dummy"
"122380",5,7,1,13,"dummy"
"122381",0,1,1,2,"dummy"
"122382",3,4,2,9,"dummy"
"122384",0,0,0,0,"dummy"
"122386",0,1,1,2,"dummy"
"122388",0,1,0,1,"dummy"
"122389",0,0,1,1,"dummy"
"122390",0,0,1,1,"dummy"
"122392",4,7,1,12,"dummy"
"122393",0,1,0,1,"dummy"
"122396",0,0,0,0,"dummy"
"122397",0,1,0,1,"dummy"
"122404",0,0,0,0,"dummy"
"122405",0,0,0,0,"dummy"
"122406",1,2,0,3,"dummy"
"122412",0,1,0,1,"dummy"
"122413",0,0,1,1,"dummy"
"122414",0,0,1,1,"dummy"
"122415",0,0,1,1,"dummy"
"122419",0,0,0,0,"dummy"
"122420",0,4,2,6,"dummy"
"122421",0,0,0,0,"dummy"
"122422",0,0,0,0,"dummy"
"122423",1,1,0,2,"dummy"
"122424",0,0,3,3,"dummy"
"122425",1,1,0,2,"dummy"
"122426",4,0,0,4,"dummy"
"122429",0,0,1,1,"dummy"
"122443",0,1,1,2,"dummy"
"122444",0,0,2,2,"dummy"
"122446",0,0,0,0,"dummy"
"122447",0,0,1,1,"dummy"
"122448",0,0,1,1,"dummy"
"122452",2,0,1,3,"dummy"
"122453",0,1,1,2,"dummy"
"122454",1,3,1,5,"dummy"
"122455",0,1,0,1,"dummy"
"122456",0,1,0,1,"dummy"
"122457",0,2,0,2,"dummy"
"122458",4,3,2,9,"dummy"
"122459",0,0,2,2,"dummy"
"122460",0,1,0,1,"dummy"
"122461",0,1,0,1,"dummy"
"122462",0,1,0,1,"dummy"
"122465",0,0,1,1,"dummy"
"122467",0,1,1,2,"dummy"
"122469",7,4,0,11,"dummy"
"122470",2,2,0,4,"dummy"
"122471",2,2,0,4,"dummy"
"122472",1,4,3,8,"dummy"
"122473",0,0,1,1,"dummy"
"122474",5,0,0,5,"dummy"
"122477",1,3,4,8,"dummy"
"122479",0,1,0,1,"dummy"
"122480",0,12,3,15,"dummy"
"122483",8,7,2,17,"dummy"
"122484",14,9,5,28,"dummy"
"122485",0,14,4,18,"dummy"
"122486",14,0,4,18,"dummy"
"122487",0,0,2,2,"dummy"
"122488",6,8,0,14,"dummy"
"122493",0,0,0,0,"dummy"
"122494",0,0,1,1,"dummy"
"122495",0,2,3,5,"dummy"
"122497",0,0,4,4,"dummy"
"122498",10,5,3,18,"dummy"
"122499",2,3,0,5,"dummy"
"122500",0,0,0,0,"dummy"
"122501",6,2,4,12,"dummy"
"122502",0,1,0,1,"dummy"
"122503",1,1,0,2,"dummy"
"122506",1,0,0,1,"dummy"
"122509",2,1,1,4,"dummy"
"122510",0,1,0,1,"dummy"
"122513",8,6,0,14,"dummy"
"122514",0,1,0,1,"dummy"
"122515",0,0,2,2,"dummy"
"122516",0,0,2,2,"dummy"
"122517",0,0,1,1,"dummy"
"122520",0,0,1,1,"dummy"
"122521",2,2,0,4,"dummy"
"122522",3,4,0,7,"dummy"
"122523",1,3,0,4,"dummy"
"122526",0,1,0,1,"dummy"
"122527",0,0,2,2,"dummy"
"122528",0,0,1,1,"dummy"
"122529",0,0,2,2,"dummy"
"122530",0,0,1,1,"dummy"
"122531",0,0,1,1,"dummy"
"122532",0,0,1,1,"dummy"
"122533",0,0,1,1,"dummy"
"122534",0,0,1,1,"dummy"
"122535",0,3,0,3,"dummy"
"122536",0,0,1,1,"dummy"
"122537",0,0,1,1,"dummy"
"122538",0,0,1,1,"dummy"
"122539",0,0,1,1,"dummy"
"122540",0,0,1,1,"dummy"
"122541",0,2,0,2,"dummy"
"122542",0,0,1,1,"dummy"
"122543",0,0,1,1,"dummy"
"122544",0,0,1,1,"dummy"
"122545",0,0,1,1,"dummy"
"122546",0,0,1,1,"dummy"
"122547",0,0,1,1,"dummy"
"122548",0,0,1,1,"dummy"
"122549",0,0,1,1,"dummy"
"122550",0,0,1,1,"dummy"
"122551",0,0,1,1,"dummy"
"122552",0,0,1,1,"dummy"
"122553",0,0,1,1,"dummy"
"122554",0,0,1,1,"dummy"
"122555",0,0,1,1,"dummy"
"122556",0,0,1,1,"dummy"
"122559",0,0,1,1,"dummy"
"122560",0,0,0,0,"dummy"
"122562",0,5,0,5,"dummy"
"122563",0,1,0,1,"dummy"
"122564",7,2,4,13,"dummy"
"122565",0,0,1,1,"dummy"
"122566",4,2,1,7,"dummy"
"122569",0,1,1,2,"dummy"
"122570",0,10,2,12,"dummy"
"122571",0,0,1,1,"dummy"
"122572",0,0,1,1,"dummy"
"122573",0,0,2,2,"dummy"
"122575",1,0,1,2,"dummy"
"122576",0,1,1,2,"dummy"
"122577",0,0,1,1,"dummy"
"122578",1,1,1,3,"dummy"
"122579",0,1,1,2,"dummy"
"122580",0,1,0,1,"dummy"
"122586",0,0,1,1,"dummy"
"122587",7,8,4,19,"dummy"
"122589",1,3,0,4,"dummy"
"122594",0,0,1,1,"dummy"
"122600",0,0,3,3,"dummy"
"122601",0,1,0,1,"dummy"
"122602",1,0,0,1,"dummy"
"122603",0,1,0,1,"dummy"
"122604",0,1,0,1,"dummy"
"122605",0,1,0,1,"dummy"
"122606",0,3,0,3,"dummy"
"122607",0,0,1,1,"dummy"
"122608",3,1,0,4,"dummy"
"122611",0,0,0,0,"dummy"
"122613",0,3,0,3,"dummy"
"122619",0,2,3,5,"dummy"
"122620",0,0,1,1,"dummy"
"122622",3,3,0,6,"dummy"
"122623",4,4,1,9,"dummy"
"122624",0,2,1,3,"dummy"
"122625",1,0,0,1,"dummy"
"122626",0,1,0,1,"dummy"
"122650",0,1,0,1,"dummy"
"122651",0,1,0,1,"dummy"
"122652",0,1,0,1,"dummy"
"122653",0,1,0,1,"dummy"
"122654",0,1,0,1,"dummy"
"122655",0,1,0,1,"dummy"
"122656",6,0,1,7,"dummy"
"122657",0,1,0,1,"dummy"
"122658",0,1,0,1,"dummy"
"122708",6,16,2,24,"dummy"
"122711",13,14,2,29,"dummy"
"122712",10,4,1,15,"dummy"
"122730",0,1,0,1,"dummy"
"122731",0,1,0,1,"dummy"
"122732",1,1,0,2,"dummy"
"122733",0,2,0,2,"dummy"
"122734",0,2,0,2,"dummy"
"122735",0,2,0,2,"dummy"
"122736",0,1,0,1,"dummy"
"122737",0,1,0,1,"dummy"
"122738",0,0,3,3,"dummy"
"122739",1,1,0,2,"dummy"
"122740",0,0,2,2,"dummy"
"122741",5,3,1,9,"dummy"
"122742",0,1,0,1,"dummy"
"122776",0,1,2,3,"dummy"
"122779",0,1,0,1,"dummy"
"122784",0,0,2,2,"dummy"
"122785",0,2,0,2,"dummy"
"122786",2,7,5,14,"dummy"
"122787",0,0,3,3,"dummy"
"122788",1,1,0,2,"dummy"
"122789",0,0,3,3,"dummy"
"122790",1,1,4,6,"dummy"
"122795",0,6,0,6,"dummy"
"122809",0,0,0,0,"dummy"
"122810",0,0,1,1,"dummy"
"122827",0,1,0,1,"dummy"
"122842",1,17,1,19,"dummy"
"122843",0,0,1,1,"dummy"
"122844",1,2,0,3,"dummy"
"122845",0,1,1,2,"dummy"
"122846",8,3,0,11,"dummy"
"122847",1,5,0,6,"dummy"
"122848",0,8,1,9,"dummy"
"122849",0,5,0,5,"dummy"
"122850",9,1,2,12,"dummy"
"122851",0,0,1,1,"dummy"
"122852",0,0,0,0,"dummy"
"122853",0,1,0,1,"dummy"
"122854",0,2,0,2,"dummy"
"122855",0,5,0,5,"dummy"
"122856",0,2,0,2,"dummy"
"122857",0,2,0,2,"dummy"
"122858",2,1,1,4,"dummy"
"122859",0,2,0,2,"dummy"
"122860",0,0,0,0,"dummy"
"122861",1,0,0,1,"dummy"
"122669",0,0,0,0,"dummy"
"122670",0,0,0,0,"dummy"
"122675",0,1,0,1,"dummy"
"122680",0,1,0,1,"dummy"
"122681",2,3,0,5,"dummy"
"122682",0,1,0,1,"dummy"
"122683",18,5,1,24,"dummy"
"122684",0,2,0,2,"dummy"
"122687",0,0,1,1,"dummy"
"122688",2,3,3,8,"dummy"
"122693",15,1,0,16,"dummy"
"122694",0,1,0,1,"dummy"
"122695",0,2,0,2,"dummy"
"122696",9,8,1,18,"dummy"
"122697",2,1,0,3,"dummy"
"122698",1,1,2,4,"dummy"
"122699",0,1,1,2,"dummy"
"122700",0,2,0,2,"dummy"
"122701",0,0,0,0,"dummy"
"122702",1,0,0,1,"dummy"
"122703",0,1,0,1,"dummy"
"122704",2,0,0,2,"dummy"
"122718",4,3,0,7,"dummy"
"122719",2,5,0,7,"dummy"
"122720",1,1,1,3,"dummy"
"122721",0,0,1,1,"dummy"
"122722",1,1,1,3,"dummy"
"122723",0,1,0,1,"dummy"
"122724",0,0,1,1,"dummy"
"122725",1,1,0,2,"dummy"
"122726",1,1,0,2,"dummy"
"122727",0,1,0,1,"dummy"
"122728",1,0,0,1,"dummy"
"122744",1,5,3,9,"dummy"
"122745",0,4,0,4,"dummy"
"122750",1,1,0,2,"dummy"
"122774",0,1,0,1,"dummy"
"122781",0,2,4,6,"dummy"
"122782",10,0,3,13,"dummy"
"122792",0,0,0,0,"dummy"
"122793",0,1,0,1,"dummy"
"122797",0,1,1,2,"dummy"
"122798",0,1,0,1,"dummy"
"122799",1,0,0,1,"dummy"
"122800",0,0,0,0,"dummy"
"122801",0,1,0,1,"dummy"
"122802",0,1,0,1,"dummy"
"122803",3,1,1,5,"dummy"
"122804",0,1,1,2,"dummy"
"122805",0,0,0,0,"dummy"
"122806",1,0,0,1,"dummy"
"122807",0,0,1,1,"dummy"
"122825",0,0,1,1,"dummy"
"122863",0,0,2,2,"dummy"
"122864",0,0,0,0,"dummy"
"122879",0,7,0,7,"dummy"
"122880",2,7,0,9,"dummy"
"122881",7,0,2,9,"dummy"
"122882",0,1,0,1,"dummy"
"122883",0,0,1,1,"dummy"
"122884",4,15,6,25,"dummy"
"122885",3,7,1,11,"dummy"
"122886",2,1,1,4,"dummy"
"122887",0,0,2,2,"dummy"
"122888",0,0,1,1,"dummy"
"122889",0,0,1,1,"dummy"
"122890",13,0,3,16,"dummy"
"122891",0,0,1,1,"dummy"
"122892",0,0,1,1,"dummy"
"122893",0,3,1,4,"dummy"
"122894",0,0,1,1,"dummy"
"122895",0,0,1,1,"dummy"
"122896",0,0,1,1,"dummy"
"122901",0,0,1,1,"dummy"
"122915",0,1,0,1,"dummy"
"122920",0,0,0,0,"dummy"
"122924",0,1,0,1,"dummy"
"122937",17,8,0,25,"dummy"
"122946",0,1,0,1,"dummy"
"122947",0,0,1,1,"dummy"
"122948",1,3,2,6,"dummy"
"122949",0,0,1,1,"dummy"
"122950",0,0,1,1,"dummy"
"122959",4,0,5,9,"dummy"
"122962",0,1,0,1,"dummy"
"122967",1,4,2,7,"dummy"
"122971",2,0,0,2,"dummy"
"122972",0,2,0,2,"dummy"
"122973",0,0,2,2,"dummy"
"122978",2,7,1,10,"dummy"
"122979",3,0,2,5,"dummy"
"122980",0,0,2,2,"dummy"
"122990",0,1,0,1,"dummy"
"122991",1,0,0,1,"dummy"
"122992",1,0,0,1,"dummy"
"122993",0,0,0,0,"dummy"
"122994",0,0,5,5,"dummy"
"123008",7,2,4,13,"dummy"
"123009",0,26,0,26,"dummy"
"123010",1,1,0,2,"dummy"
"123011",0,0,1,1,"dummy"
"123012",0,1,0,1,"dummy"
"123013",0,1,0,1,"dummy"
"123014",0,2,0,2,"dummy"
"123015",0,5,0,5,"dummy"
"123016",1,1,2,4,"dummy"
"123017",0,1,0,1,"dummy"
"123018",0,1,0,1,"dummy"
"123034",1,0,0,1,"dummy"
"123035",0,1,0,1,"dummy"
"123036",1,7,1,9,"dummy"
"123066",0,0,1,1,"dummy"
"123067",0,0,1,1,"dummy"
"123068",0,0,1,1,"dummy"
"123069",0,0,1,1,"dummy"
"123070",0,0,1,1,"dummy"
"123089",0,0,1,1,"dummy"
"123090",0,2,0,2,"dummy"
"123091",0,1,0,1,"dummy"
"123092",0,0,0,0,"dummy"
"123093",0,0,3,3,"dummy"
"123094",0,0,1,1,"dummy"
"123095",0,0,1,1,"dummy"
"123096",0,0,1,1,"dummy"
"123097",0,0,1,1,"dummy"
"123098",0,0,1,1,"dummy"
"123143",0,0,1,1,"dummy"
"123144",0,0,1,1,"dummy"
"123171",0,2,0,2,"dummy"
"123172",0,2,0,2,"dummy"
"123173",0,1,0,1,"dummy"
"123179",3,0,5,8,"dummy"
"123180",2,0,0,2,"dummy"
"123222",0,1,0,1,"dummy"
"123223",7,3,0,10,"dummy"
"123224",2,5,1,8,"dummy"
"123225",10,8,3,21,"dummy"
"123226",0,0,0,0,"dummy"
"123227",0,6,0,6,"dummy"
"123228",0,0,0,0,"dummy"
"122922",0,2,0,2,"dummy"
"122926",0,1,0,1,"dummy"
"122927",0,0,3,3,"dummy"
"122928",0,0,1,1,"dummy"
"122931",0,0,1,1,"dummy"
"122932",0,0,1,1,"dummy"
"122933",0,0,1,1,"dummy"
"122939",1,1,0,2,"dummy"
"122940",2,2,0,4,"dummy"
"122952",0,16,0,16,"dummy"
"122953",10,2,0,12,"dummy"
"122954",3,2,0,5,"dummy"
"122955",6,3,1,10,"dummy"
"122956",0,0,0,0,"dummy"
"122957",2,0,0,2,"dummy"
"122964",0,0,0,0,"dummy"
"122965",0,2,0,2,"dummy"
"122969",0,1,0,1,"dummy"
"122984",0,6,4,10,"dummy"
"122985",0,1,0,1,"dummy"
"122986",0,0,4,4,"dummy"
"122996",2,0,2,4,"dummy"
"122997",1,0,2,3,"dummy"
"123002",0,1,0,1,"dummy"
"123003",0,0,1,1,"dummy"
"123004",0,0,1,1,"dummy"
"123022",2,3,1,6,"dummy"
"123023",0,1,0,1,"dummy"
"123024",1,0,5,6,"dummy"
"123025",0,0,2,2,"dummy"
"123026",0,1,1,2,"dummy"
"123031",0,0,2,2,"dummy"
"123032",8,6,0,14,"dummy"
"123038",0,1,0,1,"dummy"
"123039",0,1,0,1,"dummy"
"123040",1,0,0,1,"dummy"
"123041",0,1,0,1,"dummy"
"123042",0,1,0,1,"dummy"
"123043",0,1,0,1,"dummy"
"123044",1,9,0,10,"dummy"
"123045",0,0,1,1,"dummy"
"123046",0,1,0,1,"dummy"
"123047",4,2,0,6,"dummy"
"123048",2,5,0,7,"dummy"
"123049",0,0,1,1,"dummy"
"123050",0,0,4,4,"dummy"
"123051",0,2,4,6,"dummy"
"123052",0,0,0,0,"dummy"
"123053",2,3,0,5,"dummy"
"123054",0,0,1,1,"dummy"
"123055",4,6,2,12,"dummy"
"123056",0,0,2,2,"dummy"
"123057",0,2,1,3,"dummy"
"123058",4,4,0,8,"dummy"
"123059",13,0,2,15,"dummy"
"123060",20,14,1,35,"dummy"
"123061",1,0,0,1,"dummy"
"123062",0,3,0,3,"dummy"
"123063",1,0,0,1,"dummy"
"123064",0,1,0,1,"dummy"
"123072",0,1,0,1,"dummy"
"123102",0,0,1,1,"dummy"
"123103",2,2,0,4,"dummy"
"123104",0,0,1,1,"dummy"
"123126",0,0,1,1,"dummy"
"123129",0,2,0,2,"dummy"
"123130",0,0,2,2,"dummy"
"123131",1,1,0,2,"dummy"
"123132",1,0,0,1,"dummy"
"123133",10,0,1,11,"dummy"
"123134",0,11,1,12,"dummy"
"123135",12,0,2,14,"dummy"
"123136",0,1,0,1,"dummy"
"123137",0,6,1,7,"dummy"
"123138",0,0,0,0,"dummy"
"123146",0,0,0,0,"dummy"
"123147",0,0,1,1,"dummy"
"123148",3,2,0,5,"dummy"
"123149",0,1,0,1,"dummy"
"123150",0,0,1,1,"dummy"
"123151",0,0,2,2,"dummy"
"123152",0,0,0,0,"dummy"
"123153",0,1,0,1,"dummy"
"123154",3,1,0,4,"dummy"
"123155",1,0,0,1,"dummy"
"123156",0,0,0,0,"dummy"
"123157",0,0,0,0,"dummy"
"123160",4,5,0,9,"dummy"
"123161",0,4,1,5,"dummy"
"123162",0,0,1,1,"dummy"
"123163",0,0,1,1,"dummy"
"123164",0,3,0,3,"dummy"
"123165",0,1,0,1,"dummy"
"123166",0,1,0,1,"dummy"
"123175",0,0,1,1,"dummy"
"123182",0,1,0,1,"dummy"
"123183",3,1,3,7,"dummy"
"123184",0,1,0,1,"dummy"
"123185",0,1,0,1,"dummy"
"123186",2,2,0,4,"dummy"
"123187",2,2,0,4,"dummy"
"123192",1,1,0,2,"dummy"
"123193",0,0,1,1,"dummy"
"123194",0,1,0,1,"dummy"
"123195",0,0,1,1,"dummy"
"123196",1,0,0,1,"dummy"
"123197",0,1,1,2,"dummy"
"123198",1,0,1,2,"dummy"
"123199",0,0,3,3,"dummy"
"123200",1,1,0,2,"dummy"
"123201",1,1,1,3,"dummy"
"123202",0,0,1,1,"dummy"
"123203",0,0,1,1,"dummy"
"123204",0,0,1,1,"dummy"
"123205",0,0,1,1,"dummy"
"123206",0,1,0,1,"dummy"
"123207",0,1,0,1,"dummy"
"123208",0,2,1,3,"dummy"
"123209",1,1,1,3,"dummy"
"123210",0,1,2,3,"dummy"
"123211",1,0,2,3,"dummy"
"123212",1,1,1,3,"dummy"
"123213",1,1,0,2,"dummy"
"123214",1,2,3,6,"dummy"
"123215",2,2,0,4,"dummy"
"123216",3,3,3,9,"dummy"
"123230",0,1,0,1,"dummy"
"123233",7,6,1,14,"dummy"
"123234",1,5,0,6,"dummy"
"123240",0,0,0,0,"dummy"
"123241",0,3,2,5,"dummy"
"123242",0,2,0,2,"dummy"
"123251",0,1,0,1,"dummy"
"123252",1,0,0,1,"dummy"
"123253",0,0,1,1,"dummy"
"123254",2,0,1,3,"dummy"
"123255",2,4,0,6,"dummy"
"123256",1,4,0,5,"dummy"
"123257",1,1,0,2,"dummy"
"123258",0,1,0,1,"dummy"
"123259",2,1,0,3,"dummy"
"123260",0,1,1,2,"dummy"
"123261",0,0,1,1,"dummy"
"123262",0,1,0,1,"dummy"
"123263",0,0,1,1,"dummy"
"123264",0,0,1,1,"dummy"
"123265",0,0,1,1,"dummy"
"123266",0,0,1,1,"dummy"
"123267",0,0,1,1,"dummy"
"123268",1,0,0,1,"dummy"
"123269",0,0,1,1,"dummy"
"123270",0,1,0,1,"dummy"
"123271",0,1,0,1,"dummy"
"123294",0,1,0,1,"dummy"
"123238",0,1,0,1,"dummy"
"123298",2,6,0,8,"dummy"
"123299",0,0,1,1,"dummy"
"123300",11,0,0,11,"dummy"
"123301",1,0,0,1,"dummy"
"123302",0,0,2,2,"dummy"
"123313",0,0,1,1,"dummy"
"123314",0,1,0,1,"dummy"
"123315",0,1,0,1,"dummy"
"123316",0,0,0,0,"dummy"
"123317",1,1,0,2,"dummy"
"123318",1,1,0,2,"dummy"
"123319",7,0,0,7,"dummy"
"123334",1,0,0,1,"dummy"
"123335",0,0,1,1,"dummy"
"123336",0,1,0,1,"dummy"
"123337",1,6,3,10,"dummy"
"123338",0,2,0,2,"dummy"
"123339",0,1,0,1,"dummy"
"123340",0,0,2,2,"dummy"
"123341",0,0,2,2,"dummy"
"123295",2,4,0,6,"dummy"
"123296",0,0,2,2,"dummy"
"123304",0,0,0,0,"dummy"
"123305",5,1,1,7,"dummy"
"123329",0,2,0,2,"dummy"
"123330",1,0,0,1,"dummy"
"123331",2,0,0,2,"dummy"
"123332",0,0,1,1,"dummy"
"123488",0,0,4,4,"dummy"
"123489",0,0,1,1,"dummy"
"123490",0,0,3,3,"dummy"
"123491",0,21,0,21,"dummy"
"123494",0,0,1,1,"dummy"
"123531",2,4,4,10,"dummy"
"123534",0,0,1,1,"dummy"
"123535",0,1,0,1,"dummy"
"123540",0,0,8,8,"dummy"
"123541",0,2,0,2,"dummy"
"123569",0,0,0,0,"dummy"
"123570",1,1,0,2,"dummy"
"123571",1,1,0,2,"dummy"
"123572",0,1,0,1,"dummy"
"123599",6,0,0,6,"dummy"
"123600",2,5,2,9,"dummy"
"123604",0,0,0,0,"dummy"
"123605",0,0,0,0,"dummy"
"123614",0,0,2,2,"dummy"
"123615",0,0,1,1,"dummy"
"123616",0,0,1,1,"dummy"
"123620",1,3,0,4,"dummy"
"123621",0,2,0,2,"dummy"
"123633",0,0,1,1,"dummy"
"123634",0,0,0,0,"dummy"
"123635",0,0,2,2,"dummy"
"123636",0,0,0,0,"dummy"
"123651",0,0,0,0,"dummy"
"123652",0,0,2,2,"dummy"
"123682",0,0,1,1,"dummy"
"123683",0,0,1,1,"dummy"
"123684",0,0,1,1,"dummy"
"123685",0,0,1,1,"dummy"
"123686",0,1,0,1,"dummy"
"123486",0,0,1,1,"dummy"
"123507",2,0,1,3,"dummy"
"123508",0,0,1,1,"dummy"
"123509",0,0,1,1,"dummy"
"123517",1,0,0,1,"dummy"
"123518",1,2,0,3,"dummy"
"123537",0,7,0,7,"dummy"
"123538",0,2,0,2,"dummy"
"123543",0,1,0,1,"dummy"
"123544",1,1,0,2,"dummy"
"123545",0,1,0,1,"dummy"
"123546",0,7,0,7,"dummy"
"123547",0,0,0,0,"dummy"
"123548",0,0,1,1,"dummy"
"123549",0,10,1,11,"dummy"
"123557",0,4,1,5,"dummy"
"123558",0,3,0,3,"dummy"
"123559",7,5,1,13,"dummy"
"123560",0,1,0,1,"dummy"
"123561",0,2,0,2,"dummy"
"123564",0,0,1,1,"dummy"
"123602",0,2,0,2,"dummy"
"123609",0,4,0,4,"dummy"
"123610",4,7,0,11,"dummy"
"123611",0,2,0,2,"dummy"
"123612",1,6,1,8,"dummy"
"123618",0,2,0,2,"dummy"
"123625",0,0,1,1,"dummy"
"123626",0,0,1,1,"dummy"
"123627",0,0,1,1,"dummy"
"123628",0,0,1,1,"dummy"
"123629",0,0,1,1,"dummy"
"123630",0,0,1,1,"dummy"
"123631",0,1,8,9,"dummy"
"123638",2,4,1,7,"dummy"
"123639",0,4,1,5,"dummy"
"123640",1,7,0,8,"dummy"
"123641",4,0,0,4,"dummy"
"123642",7,1,0,8,"dummy"
"123643",1,0,0,1,"dummy"
"123644",0,0,0,0,"dummy"
"123645",0,0,0,0,"dummy"
"123646",0,0,0,0,"dummy"
"123649",0,0,1,1,"dummy"
"123656",0,2,1,3,"dummy"
"123657",1,0,0,1,"dummy"
"123671",0,1,0,1,"dummy"
"123672",0,0,1,1,"dummy"
"123673",0,1,2,3,"dummy"
"123674",0,1,0,1,"dummy"
"123675",0,1,0,1,"dummy"
"123678",1,2,0,3,"dummy"
"123679",0,2,0,2,"dummy"
"123680",0,2,0,2,"dummy"
"123687",0,0,1,1,"dummy"
"123745",1,3,0,4,"dummy"
"123746",4,5,2,11,"dummy"
"123747",0,1,2,3,"dummy"
"123748",0,1,0,1,"dummy"
"123750",0,2,0,2,"dummy"
"123752",6,0,2,8,"dummy"
"123753",0,1,0,1,"dummy"
"123754",0,0,1,1,"dummy"
"123755",0,2,1,3,"dummy"
"123756",0,3,0,3,"dummy"
"123757",0,0,1,1,"dummy"
"123758",0,2,2,4,"dummy"
"123759",0,2,2,4,"dummy"
"123763",1,2,0,3,"dummy"
"123764",0,2,0,2,"dummy"
"123765",0,1,0,1,"dummy"
"123766",0,0,0,0,"dummy"
"123767",0,2,0,2,"dummy"
"123768",2,0,0,2,"dummy"
"123770",2,0,0,2,"dummy"
"123772",0,2,0,2,"dummy"
"123776",0,1,0,1,"dummy"
"123779",0,1,1,2,"dummy"
"123780",0,0,0,0,"dummy"
"123781",0,1,0,1,"dummy"
"123782",0,1,0,1,"dummy"
"123783",1,0,0,1,"dummy"
"123786",2,2,3,7,"dummy"
"123787",0,1,0,1,"dummy"
"123788",0,0,4,4,"dummy"
"123789",2,1,4,7,"dummy"
"123790",0,3,0,3,"dummy"
"123791",0,0,1,1,"dummy"
"123792",1,1,0,2,"dummy"
"123793",1,4,0,5,"dummy"
"123794",1,1,0,2,"dummy"
"123797",0,1,1,2,"dummy"
"123798",0,0,1,1,"dummy"
"123799",1,2,1,4,"dummy"
"123800",32,5,0,37,"dummy"
"123824",0,0,2,2,"dummy"
"123827",0,1,0,1,"dummy"
"123828",3,3,0,6,"dummy"
"123829",3,4,0,7,"dummy"
"123830",2,3,0,5,"dummy"
"123831",2,0,0,2,"dummy"
"123843",0,9,0,9,"dummy"
"123845",0,1,0,1,"dummy"
"123847",0,0,1,1,"dummy"
"123850",1,0,0,1,"dummy"
"123851",0,1,0,1,"dummy"
"123852",1,17,0,18,"dummy"
"123853",0,1,0,1,"dummy"
"123854",5,6,1,12,"dummy"
"123855",0,1,0,1,"dummy"
"123856",0,0,1,1,"dummy"
"123857",0,1,0,1,"dummy"
"123866",0,3,1,4,"dummy"
"123867",3,3,3,9,"dummy"
"123868",0,0,1,1,"dummy"
"123869",0,3,0,3,"dummy"
"123870",0,1,0,1,"dummy"
"123871",1,0,0,1,"dummy"
"123872",0,1,0,1,"dummy"
"123873",0,0,1,1,"dummy"
"123874",0,0,1,1,"dummy"
"123896",0,0,1,1,"dummy"
"123897",0,0,1,1,"dummy"
"123898",1,4,2,7,"dummy"
"123899",0,7,0,7,"dummy"
"123900",1,3,1,5,"dummy"
"123901",13,1,1,15,"dummy"
"123902",1,7,0,8,"dummy"
"123903",0,1,0,1,"dummy"
"123904",1,3,0,4,"dummy"
"123905",2,0,1,3,"dummy"
"123906",1,0,3,4,"dummy"
"123908",9,39,2,50,"dummy"
"123909",0,0,0,0,"dummy"
"123910",0,7,2,9,"dummy"
"123911",3,2,0,5,"dummy"
"123912",0,0,1,1,"dummy"
"123914",0,0,1,1,"dummy"
"123915",2,1,1,4,"dummy"
"123918",0,0,0,0,"dummy"
"123920",0,0,6,6,"dummy"
"123921",0,3,0,3,"dummy"
"123922",0,0,3,3,"dummy"
"123924",3,3,0,6,"dummy"
"123925",0,2,0,2,"dummy"
"123926",0,1,0,1,"dummy"
"123927",3,0,0,3,"dummy"
"123928",0,0,1,1,"dummy"
"123929",3,0,0,3,"dummy"
"123931",0,0,0,0,"dummy"
"123932",0,0,0,0,"dummy"
"123933",0,0,1,1,"dummy"
"123935",4,3,1,8,"dummy"
"123936",2,2,0,4,"dummy"
"123987",0,0,1,1,"dummy"
"123989",0,0,0,0,"dummy"
"123994",0,0,0,0,"dummy"
"123995",0,4,0,4,"dummy"
"123996",6,0,0,6,"dummy"
"123997",0,0,0,0,"dummy"
"123998",0,0,0,0,"dummy"
"124001",4,9,1,14,"dummy"
"124002",0,1,0,1,"dummy"
"124003",0,1,4,5,"dummy"
"124004",0,1,0,1,"dummy"
"124005",0,0,0,0,"dummy"
"124006",2,5,0,7,"dummy"
"124007",1,1,0,2,"dummy"
"124008",1,6,0,7,"dummy"
"124009",2,2,1,5,"dummy"
"124010",1,6,0,7,"dummy"
"124011",1,0,0,1,"dummy"
"124012",6,0,0,6,"dummy"
"124013",0,0,1,1,"dummy"
"124014",0,1,0,1,"dummy"
"124015",4,0,4,8,"dummy"
"124020",2,4,2,8,"dummy"
"124024",2,9,3,14,"dummy"
"124025",9,3,3,15,"dummy"
"124026",3,2,1,6,"dummy"
"124027",0,11,0,11,"dummy"
"124028",0,0,0,0,"dummy"
"124029",0,0,1,1,"dummy"
"124030",0,0,1,1,"dummy"
"124031",14,6,4,24,"dummy"
"124034",0,0,1,1,"dummy"
"124035",0,1,0,1,"dummy"
"124039",0,0,1,1,"dummy"
"124040",0,0,1,1,"dummy"
"124041",1,5,0,6,"dummy"
"124042",0,4,3,7,"dummy"
"124043",0,1,0,1,"dummy"
"124044",0,1,0,1,"dummy"
"124045",0,0,1,1,"dummy"
"124046",11,9,1,21,"dummy"
"124047",1,5,0,6,"dummy"
"124048",12,6,2,20,"dummy"
"124053",0,0,0,0,"dummy"
"124055",0,2,0,2,"dummy"
"124056",23,18,1,42,"dummy"
"124060",0,0,3,3,"dummy"
"124062",0,1,0,1,"dummy"
"124064",1,1,1,3,"dummy"
"124067",0,2,1,3,"dummy"
"124071",0,0,1,1,"dummy"
"124073",0,0,1,1,"dummy"
"124074",0,2,0,2,"dummy"
"124075",1,0,0,1,"dummy"
"124076",0,1,0,1,"dummy"
"124077",3,1,1,5,"dummy"
"124078",0,1,0,1,"dummy"
"124080",0,2,0,2,"dummy"
"124081",0,2,0,2,"dummy"
"124082",5,5,2,12,"dummy"
"124083",1,1,0,2,"dummy"
"124084",3,3,0,6,"dummy"
"124100",2,0,3,5,"dummy"
"124101",0,2,0,2,"dummy"
"124102",3,2,0,5,"dummy"
"124103",6,6,0,12,"dummy"
"124104",0,1,1,2,"dummy"
"124105",7,16,9,32,"dummy"
"124108",0,1,2,3,"dummy"
"124111",0,0,1,1,"dummy"
"124112",29,2,1,32,"dummy"
"124113",1,0,0,1,"dummy"
"124115",3,3,0,6,"dummy"
"124116",0,3,1,4,"dummy"
"124117",0,0,0,0,"dummy"
"124118",1,0,1,2,"dummy"
"124120",2,0,4,6,"dummy"
"124121",1,2,0,3,"dummy"
"124122",1,2,0,3,"dummy"
"124123",0,6,2,8,"dummy"
"124124",0,0,1,1,"dummy"
"124125",2,0,0,2,"dummy"
"124126",0,5,0,5,"dummy"
"124127",1,1,0,2,"dummy"
"124128",1,0,0,1,"dummy"
"124129",0,2,4,6,"dummy"
"124130",0,2,0,2,"dummy"
"124131",0,2,0,2,"dummy"
"124132",2,4,0,6,"dummy"
"124133",0,0,1,1,"dummy"
"124134",0,16,2,18,"dummy"
"124141",0,1,0,1,"dummy"
"124143",1,0,0,1,"dummy"
"124144",0,0,1,1,"dummy"
"124145",0,1,0,1,"dummy"
"124146",1,1,0,2,"dummy"
"124147",0,5,0,5,"dummy"
"124148",0,1,0,1,"dummy"
"124149",0,1,0,1,"dummy"
"124150",0,1,1,2,"dummy"
"124152",0,1,2,3,"dummy"
"124153",0,0,0,0,"dummy"
"124154",0,2,0,2,"dummy"
"124155",5,0,2,7,"dummy"
"124156",1,0,0,1,"dummy"
"124160",3,19,0,22,"dummy"
"124161",5,0,1,6,"dummy"
"124162",0,4,0,4,"dummy"
"124163",0,1,0,1,"dummy"
"124164",0,0,4,4,"dummy"
"124165",0,2,0,2,"dummy"
"124166",0,0,0,0,"dummy"
"124168",0,1,0,1,"dummy"
"124169",1,4,0,5,"dummy"
"124171",0,1,0,1,"dummy"
"124186",0,1,0,1,"dummy"
"124187",6,6,2,14,"dummy"
"124188",0,1,0,1,"dummy"
"124189",8,9,2,19,"dummy"
"124190",0,1,0,1,"dummy"
"124191",0,1,0,1,"dummy"
"124195",0,0,0,0,"dummy"
"124197",1,1,1,3,"dummy"
"124198",0,0,1,1,"dummy"
"124199",1,0,1,2,"dummy"
"124200",0,0,1,1,"dummy"
"124201",4,1,1,6,"dummy"
"124202",3,6,1,10,"dummy"
"124203",0,0,1,1,"dummy"
"124204",1,1,2,4,"dummy"
"124211",21,10,0,31,"dummy"
"124212",7,10,2,19,"dummy"
"124213",42,0,2,44,"dummy"
"124215",2,12,1,15,"dummy"
"124216",7,1,3,11,"dummy"
"124217",0,0,1,1,"dummy"
"124219",0,0,1,1,"dummy"
"124221",0,6,0,6,"dummy"
"124222",0,3,0,3,"dummy"
"124223",0,0,1,1,"dummy"
"124224",0,9,0,9,"dummy"
"124225",8,1,0,9,"dummy"
"124226",0,1,0,1,"dummy"
"124227",0,5,0,5,"dummy"
"124228",0,1,0,1,"dummy"
"124229",0,1,0,1,"dummy"
"124230",0,1,0,1,"dummy"
"124231",0,3,0,3,"dummy"
"124244",0,0,0,0,"dummy"
"124245",0,0,1,1,"dummy"
"124246",5,5,0,10,"dummy"
"124248",0,13,0,13,"dummy"
"124260",0,0,1,1,"dummy"
"124269",0,0,1,1,"dummy"
"124270",16,3,1,20,"dummy"
"124279",0,0,1,1,"dummy"
"124280",0,1,0,1,"dummy"
"124281",0,0,1,1,"dummy"
"124282",0,0,1,1,"dummy"
"124283",0,0,1,1,"dummy"
"124284",0,0,1,1,"dummy"
"124285",1,0,0,1,"dummy"
"124286",0,1,0,1,"dummy"
"124288",0,0,1,1,"dummy"
"124289",0,3,0,3,"dummy"
"124290",2,4,3,9,"dummy"
"124292",0,1,0,1,"dummy"
"124294",4,2,0,6,"dummy"
"124302",0,1,1,2,"dummy"
"124303",2,3,0,5,"dummy"
"124304",1,2,2,5,"dummy"
"124306",1,0,0,1,"dummy"
"124307",0,1,0,1,"dummy"
"124308",0,1,0,1,"dummy"
"124309",0,2,0,2,"dummy"
"124310",0,1,0,1,"dummy"
"124311",0,0,1,1,"dummy"
"124312",0,0,1,1,"dummy"
"124313",0,1,0,1,"dummy"
"124314",0,0,1,1,"dummy"
"124315",0,1,0,1,"dummy"
"124316",0,0,3,3,"dummy"
"124317",0,1,0,1,"dummy"
"124318",0,5,0,5,"dummy"
"124319",0,3,2,5,"dummy"
"124320",4,0,0,4,"dummy"
"124322",0,0,2,2,"dummy"
"124324",4,4,1,9,"dummy"
"124325",3,2,0,5,"dummy"
"124327",5,0,0,5,"dummy"
"124328",0,2,0,2,"dummy"
"124329",0,0,2,2,"dummy"
"124339",0,0,0,0,"dummy"
"124340",0,0,0,0,"dummy"
"124342",0,0,0,0,"dummy"
"124343",0,0,0,0,"dummy"
"124346",0,0,0,0,"dummy"
"124347",0,0,0,0,"dummy"
"124348",0,0,0,0,"dummy"
"124349",0,1,0,1,"dummy"
"124350",1,0,0,1,"dummy"
"124351",0,4,0,4,"dummy"
"124352",0,0,0,0,"dummy"
"124353",0,1,0,1,"dummy"
"124355",1,0,1,2,"dummy"
"124359",0,0,1,1,"dummy"
"124360",0,0,1,1,"dummy"
"124362",0,1,0,1,"dummy"
"124363",0,0,1,1,"dummy"
"124375",3,6,2,11,"dummy"
"124376",7,4,0,11,"dummy"
"124377",0,13,0,13,"dummy"
"124378",0,1,0,1,"dummy"
"124380",0,0,3,3,"dummy"
"124382",0,1,0,1,"dummy"
"124383",0,0,1,1,"dummy"
"124384",0,0,3,3,"dummy"
"124385",1,0,0,1,"dummy"
"124386",2,0,0,2,"dummy"
"124387",5,8,1,14,"dummy"
"124389",0,5,0,5,"dummy"
"124390",0,3,0,3,"dummy"
"124391",0,1,0,1,"dummy"
"124392",1,4,0,5,"dummy"
"124393",0,0,1,1,"dummy"
"124394",1,1,0,2,"dummy"
"124395",1,2,0,3,"dummy"
"124396",2,1,0,3,"dummy"
"124397",4,2,0,6,"dummy"
"124401",2,0,0,2,"dummy"
"124402",0,0,0,0,"dummy"
"124403",7,7,0,14,"dummy"
"124404",0,0,1,1,"dummy"
"124405",5,2,0,7,"dummy"
"124406",0,0,1,1,"dummy"
"124407",0,3,0,3,"dummy"
"124408",0,0,3,3,"dummy"
"124409",3,3,0,6,"dummy"
"124411",0,0,0,0,"dummy"
"124412",0,0,0,0,"dummy"
"124413",0,0,0,0,"dummy"
"124422",0,1,0,1,"dummy"
"124423",0,0,3,3,"dummy"
"124424",0,1,0,1,"dummy"
"124428",0,0,1,1,"dummy"
"124429",0,2,0,2,"dummy"
"124430",0,0,0,0,"dummy"
"124431",0,0,1,1,"dummy"
"124432",0,2,0,2,"dummy"
"124436",0,1,0,1,"dummy"
"124438",0,0,0,0,"dummy"
"124439",0,4,0,4,"dummy"
"124440",2,0,0,2,"dummy"
"124441",4,0,2,6,"dummy"
"124450",0,0,1,1,"dummy"
"124451",0,0,1,1,"dummy"
"124452",0,0,1,1,"dummy"
"124453",0,0,1,1,"dummy"
"124454",0,0,0,0,"dummy"
"124455",0,0,1,1,"dummy"
"124462",1,1,0,2,"dummy"
"124463",0,0,1,1,"dummy"
"124465",0,4,0,4,"dummy"
"124466",0,6,0,6,"dummy"
"124467",0,0,2,2,"dummy"
"124468",0,0,2,2,"dummy"
"124469",0,1,0,1,"dummy"
"124470",31,7,2,40,"dummy"
"124471",0,1,0,1,"dummy"
"124472",3,5,0,8,"dummy"
"124473",0,0,5,5,"dummy"
"124474",13,14,3,30,"dummy"
"124475",0,1,0,1,"dummy"
"124476",0,1,0,1,"dummy"
"124482",3,2,3,8,"dummy"
"124483",4,2,2,8,"dummy"
"124484",5,1,3,9,"dummy"
"124489",25,2,2,29,"dummy"
"124491",0,0,0,0,"dummy"
"124501",2,5,2,9,"dummy"
"124502",1,3,1,5,"dummy"
"124503",4,4,2,10,"dummy"
"124507",0,0,1,1,"dummy"
"124511",6,0,1,7,"dummy"
"124512",3,8,0,11,"dummy"
"124513",2,8,0,10,"dummy"
"124514",2,25,0,27,"dummy"
"124515",7,2,1,10,"dummy"
"124516",0,2,0,2,"dummy"
"124517",0,4,0,4,"dummy"
"124518",0,2,0,2,"dummy"
"124520",0,0,1,1,"dummy"
"124536",0,1,0,1,"dummy"
"124537",0,4,0,4,"dummy"
"124538",0,1,0,1,"dummy"
"124539",0,1,0,1,"dummy"
"124540",0,1,0,1,"dummy"
"124541",1,0,1,2,"dummy"
"124542",0,2,0,2,"dummy"
"124543",1,2,2,5,"dummy"
"124544",0,3,0,3,"dummy"
"124545",7,1,1,9,"dummy"
"124546",0,7,0,7,"dummy"
"124547",0,2,0,2,"dummy"
"124548",0,1,0,1,"dummy"
"124549",0,1,0,1,"dummy"
"124550",2,7,0,9,"dummy"
"124551",0,1,1,2,"dummy"
"124552",1,2,0,3,"dummy"
"124553",1,0,0,1,"dummy"
"124554",0,0,1,1,"dummy"
"124555",0,0,1,1,"dummy"
"124556",15,10,2,27,"dummy"
"124557",10,15,1,26,"dummy"
"124561",0,1,0,1,"dummy"
"124562",0,0,0,0,"dummy"
"124563",1,0,0,1,"dummy"
"124564",1,2,0,3,"dummy"
"124566",0,3,3,6,"dummy"
"124568",0,0,1,1,"dummy"
"124569",0,1,0,1,"dummy"
"124570",0,1,0,1,"dummy"
"124572",0,0,1,1,"dummy"
"124573",0,2,0,2,"dummy"
"124574",6,1,0,7,"dummy"
"124575",1,12,1,14,"dummy"
"124576",0,0,1,1,"dummy"
"124577",1,0,0,1,"dummy"
"124578",0,6,0,6,"dummy"
"124579",4,0,2,6,"dummy"
"124580",0,5,0,5,"dummy"
"124581",0,0,0,0,"dummy"
"124582",0,12,0,12,"dummy"
"124583",0,0,1,1,"dummy"
"124584",0,0,0,0,"dummy"
"124585",0,0,0,0,"dummy"
"124586",12,0,1,13,"dummy"
"124587",0,2,0,2,"dummy"
"124588",1,0,0,1,"dummy"
"124589",0,0,2,2,"dummy"
"124590",2,3,2,7,"dummy"
"124591",1,2,0,3,"dummy"
"124592",0,0,0,0,"dummy"
"124593",0,0,0,0,"dummy"
"124594",0,0,0,0,"dummy"
"124595",0,0,2,2,"dummy"
"124596",3,0,0,3,"dummy"
"124597",0,0,2,2,"dummy"
"124598",4,5,0,9,"dummy"
"124600",0,2,0,2,"dummy"
"124601",7,12,0,19,"dummy"
"124602",19,1,3,23,"dummy"
"124630",0,1,0,1,"dummy"
"124631",0,1,0,1,"dummy"
"124632",0,0,0,0,"dummy"
"124633",0,2,2,4,"dummy"
"124634",1,0,1,2,"dummy"
"124636",0,0,0,0,"dummy"
"124637",0,0,5,5,"dummy"
"124638",0,0,1,1,"dummy"
"124639",0,0,1,1,"dummy"
"124699",0,0,1,1,"dummy"
"124700",2,2,0,4,"dummy"
"124701",3,4,0,7,"dummy"
"124702",1,3,0,4,"dummy"
"124704",1,11,4,16,"dummy"
"124707",0,0,2,2,"dummy"
"124708",0,0,2,2,"dummy"
"124709",0,0,2,2,"dummy"
"124710",0,2,2,4,"dummy"
"124712",1,2,0,3,"dummy"
"124713",1,0,0,1,"dummy"
"124716",0,6,0,6,"dummy"
"124718",0,1,0,1,"dummy"
"124719",3,3,1,7,"dummy"
"124720",0,2,0,2,"dummy"
"124725",0,0,1,1,"dummy"
"124726",0,0,1,1,"dummy"
"124727",0,1,0,1,"dummy"
"124729",0,2,0,2,"dummy"
"124730",0,1,1,2,"dummy"
"124731",0,0,0,0,"dummy"
"124732",5,17,1,23,"dummy"
"124733",0,3,0,3,"dummy"
"124734",0,0,1,1,"dummy"
"124735",2,2,0,4,"dummy"
"124736",0,0,2,2,"dummy"
"124738",0,0,0,0,"dummy"
"124739",1,0,0,1,"dummy"
"124741",0,1,0,1,"dummy"
"124768",9,1,0,10,"dummy"
"124776",4,1,0,5,"dummy"
"124777",1,0,0,1,"dummy"
"124778",0,0,0,0,"dummy"
"124779",0,0,0,0,"dummy"
"124781",0,0,1,1,"dummy"
"124783",0,3,0,3,"dummy"
"124785",0,0,0,0,"dummy"
"124786",4,0,0,4,"dummy"
"124790",0,2,0,2,"dummy"
"124791",0,1,0,1,"dummy"
"124792",0,0,1,1,"dummy"
"124793",0,1,0,1,"dummy"
"124794",0,1,0,1,"dummy"
"124797",0,0,1,1,"dummy"
"124801",1,0,1,2,"dummy"
"124802",0,1,0,1,"dummy"
"124803",1,0,1,2,"dummy"
"124804",0,1,0,1,"dummy"
"124805",0,1,0,1,"dummy"
"124809",0,0,6,6,"dummy"
"124811",2,8,3,13,"dummy"
"124812",7,0,0,7,"dummy"
"124813",0,1,0,1,"dummy"
"124814",0,1,0,1,"dummy"
"124815",0,0,1,1,"dummy"
"124816",0,2,1,3,"dummy"
"124817",0,3,0,3,"dummy"
"124818",0,1,1,2,"dummy"
"124821",0,0,2,2,"dummy"
"124823",1,0,0,1,"dummy"
"124824",0,1,0,1,"dummy"
"124825",1,4,1,6,"dummy"
"124827",0,0,2,2,"dummy"
"124828",2,0,4,6,"dummy"
"124829",0,0,4,4,"dummy"
"124830",0,0,1,1,"dummy"
"124832",0,0,0,0,"dummy"
"124835",0,1,1,2,"dummy"
"124842",0,0,0,0,"dummy"
"124843",0,0,0,0,"dummy"
"124847",2,3,0,5,"dummy"
"124848",59,4,0,63,"dummy"
"124849",3,2,2,7,"dummy"
"124850",0,3,0,3,"dummy"
"124854",0,1,0,1,"dummy"
"124857",3,1,0,4,"dummy"
"124858",7,10,1,18,"dummy"
"124859",3,0,0,3,"dummy"
"124872",0,0,1,1,"dummy"
"124873",1,1,1,3,"dummy"
"124874",1,3,0,4,"dummy"
"124877",5,6,4,15,"dummy"
"124881",2,0,3,5,"dummy"
"124882",0,1,0,1,"dummy"
"124885",0,1,0,1,"dummy"
"124886",0,1,0,1,"dummy"
"124887",0,2,0,2,"dummy"
"124889",0,1,0,1,"dummy"
"124890",0,1,0,1,"dummy"
"124893",0,0,1,1,"dummy"
"124894",1,2,0,3,"dummy"
"124895",0,0,1,1,"dummy"
"124896",10,38,3,51,"dummy"
"124897",11,3,2,16,"dummy"
"124898",2,1,1,4,"dummy"
"124899",2,5,7,14,"dummy"
"124900",0,0,2,2,"dummy"
"124901",0,6,2,8,"dummy"
"124902",0,0,1,1,"dummy"
"124903",1,0,0,1,"dummy"
"124904",13,16,5,34,"dummy"
"124909",0,1,0,1,"dummy"
"124910",1,0,0,1,"dummy"
"124911",0,1,0,1,"dummy"
"124912",0,0,3,3,"dummy"
"124913",0,0,1,1,"dummy"
"124918",0,0,2,2,"dummy"
"124919",0,2,0,2,"dummy"
"124920",0,0,2,2,"dummy"
"124957",0,1,0,1,"dummy"
"124958",0,4,0,4,"dummy"
"124963",2,5,2,9,"dummy"
"124966",0,1,3,4,"dummy"
"124967",1,0,0,1,"dummy"
"124968",0,1,0,1,"dummy"
"124969",0,1,0,1,"dummy"
"124970",0,1,0,1,"dummy"
"124971",4,5,0,9,"dummy"
"124972",11,20,4,35,"dummy"
"124973",0,4,0,4,"dummy"
"124976",1,0,1,2,"dummy"
"124977",0,3,1,4,"dummy"
"124978",0,0,3,3,"dummy"
"124980",0,0,2,2,"dummy"
"124991",0,1,0,1,"dummy"
"124992",2,1,0,3,"dummy"
"124993",0,0,1,1,"dummy"
"124994",0,2,0,2,"dummy"
"124995",0,1,0,1,"dummy"
"124996",3,3,1,7,"dummy"
"124997",2,0,0,2,"dummy"
"124998",1,4,1,6,"dummy"
"124999",1,4,0,5,"dummy"
"125000",0,1,0,1,"dummy"
"125001",1,0,0,1,"dummy"
"125003",2,3,0,5,"dummy"
"125006",2,3,0,5,"dummy"
"125007",0,1,0,1,"dummy"
"125008",2,2,1,5,"dummy"
"125009",19,9,3,31,"dummy"
"125017",0,2,0,2,"dummy"
"125018",2,0,0,2,"dummy"
"125019",0,2,0,2,"dummy"
"125020",0,0,0,0,"dummy"
"125021",0,0,1,1,"dummy"
"125022",0,0,0,0,"dummy"
"125023",0,0,2,2,"dummy"
"125026",4,4,3,11,"dummy"
"125029",0,1,0,1,"dummy"
"125031",0,1,0,1,"dummy"
"125032",0,1,0,1,"dummy"
"125033",0,1,0,1,"dummy"
"125034",0,1,0,1,"dummy"
"125035",0,3,0,3,"dummy"
"125036",2,0,0,2,"dummy"
"125037",0,1,0,1,"dummy"
"125038",0,1,0,1,"dummy"
"125039",0,0,1,1,"dummy"
"125040",0,0,1,1,"dummy"
"125041",0,1,1,2,"dummy"
"125042",0,0,1,1,"dummy"
"125043",0,1,0,1,"dummy"
"125044",0,0,1,1,"dummy"
"125045",0,0,1,1,"dummy"
"125046",44,3,2,49,"dummy"
"125047",0,0,1,1,"dummy"
"125048",8,3,0,11,"dummy"
"125049",0,0,2,2,"dummy"
"125050",0,1,0,1,"dummy"
"125051",0,1,0,1,"dummy"
"125053",0,0,2,2,"dummy"
"125054",0,0,1,1,"dummy"
"125055",0,14,3,17,"dummy"
"125056",2,3,0,5,"dummy"
"125057",4,1,2,7,"dummy"
"125059",2,0,0,2,"dummy"
"125060",10,9,3,22,"dummy"
"125061",5,1,0,6,"dummy"
"125062",6,1,2,9,"dummy"
"125079",0,1,1,2,"dummy"
"125080",0,0,0,0,"dummy"
"125081",0,0,1,1,"dummy"
"125082",0,1,0,1,"dummy"
"125083",6,11,8,25,"dummy"
"125090",0,0,1,1,"dummy"
"125091",0,0,0,0,"dummy"
"125092",0,1,0,1,"dummy"
"125093",0,0,1,1,"dummy"
"125094",4,13,1,18,"dummy"
"125100",0,2,0,2,"dummy"
"125101",0,0,0,0,"dummy"
"125102",0,0,0,0,"dummy"
"125103",1,2,0,3,"dummy"
"125105",2,3,4,9,"dummy"
"125106",0,0,2,2,"dummy"
"125107",4,10,0,14,"dummy"
"125108",8,6,0,14,"dummy"
"125139",0,8,0,8,"dummy"
"125140",0,0,2,2,"dummy"
"125141",6,5,1,12,"dummy"
"125142",0,0,1,1,"dummy"
"125149",0,0,3,3,"dummy"
"125172",3,0,0,3,"dummy"
"125173",2,9,0,11,"dummy"
"125174",0,1,0,1,"dummy"
"125175",0,0,1,1,"dummy"
"125176",7,1,2,10,"dummy"
"125177",0,2,0,2,"dummy"
"125178",0,0,0,0,"dummy"
"125179",1,0,0,1,"dummy"
"125180",0,0,0,0,"dummy"
"125192",0,1,0,1,"dummy"
"125193",2,2,1,5,"dummy"
"125194",3,1,0,4,"dummy"
"125195",0,0,1,1,"dummy"
"125196",1,6,0,7,"dummy"
"125197",0,1,0,1,"dummy"
"125198",4,4,0,8,"dummy"
"125199",1,2,0,3,"dummy"
"125113",0,0,1,1,"dummy"
"125114",0,1,0,1,"dummy"
"125115",0,4,0,4,"dummy"
"125116",1,2,0,3,"dummy"
"125117",0,3,0,3,"dummy"
"125118",1,0,2,3,"dummy"
"125119",39,2,4,45,"dummy"
"125120",0,2,0,2,"dummy"
"125121",1,1,0,2,"dummy"
"125122",1,1,0,2,"dummy"
"125123",0,2,0,2,"dummy"
"125124",3,4,0,7,"dummy"
"125125",4,5,0,9,"dummy"
"125126",0,4,1,5,"dummy"
"125127",0,0,1,1,"dummy"
"125130",0,1,0,1,"dummy"
"125131",0,2,0,2,"dummy"
"125132",0,2,0,2,"dummy"
"125133",1,0,0,1,"dummy"
"125134",0,0,0,0,"dummy"
"125135",0,2,0,2,"dummy"
"125136",0,2,0,2,"dummy"
"125137",2,0,0,2,"dummy"
"125144",0,1,2,3,"dummy"
"125145",0,1,1,2,"dummy"
"125146",0,0,1,1,"dummy"
"125147",2,0,0,2,"dummy"
"125155",2,3,0,5,"dummy"
"125156",1,0,0,1,"dummy"
"125157",1,0,0,1,"dummy"
"125164",0,0,1,1,"dummy"
"125165",0,0,0,0,"dummy"
"125166",1,10,1,12,"dummy"
"125167",7,2,1,10,"dummy"
"125168",3,1,0,4,"dummy"
"125169",0,0,1,1,"dummy"
"125170",0,0,0,0,"dummy"
"125201",1,0,0,1,"dummy"
"125202",0,1,0,1,"dummy"
"125203",2,6,0,8,"dummy"
"125204",1,2,0,3,"dummy"
"125205",15,25,2,42,"dummy"
"125206",0,3,0,3,"dummy"
"125207",5,5,1,11,"dummy"
"125208",0,1,0,1,"dummy"
"125356",2,4,0,6,"dummy"
"125357",0,2,0,2,"dummy"
"125358",0,2,0,2,"dummy"
"125359",10,2,0,12,"dummy"
"125360",0,2,0,2,"dummy"
"125361",0,0,0,0,"dummy"
"125365",0,3,0,3,"dummy"
"125370",0,0,0,0,"dummy"
"125375",0,12,0,12,"dummy"
"125378",1,0,0,1,"dummy"
"125379",0,0,0,0,"dummy"
"125380",0,0,0,0,"dummy"
"125392",0,2,2,4,"dummy"
"125393",1,0,0,1,"dummy"
"125394",0,1,0,1,"dummy"
"125395",0,2,0,2,"dummy"
"125396",5,6,0,11,"dummy"
"125397",0,0,0,0,"dummy"
"125398",0,1,0,1,"dummy"
"125400",0,5,0,5,"dummy"
"125401",2,2,0,4,"dummy"
"125402",0,0,1,1,"dummy"
"125403",0,4,0,4,"dummy"
"125407",23,24,5,52,"dummy"
"125408",1,1,0,2,"dummy"
"125409",0,2,0,2,"dummy"
"125410",7,4,2,13,"dummy"
"125411",0,0,0,0,"dummy"
"125412",0,0,0,0,"dummy"
"125413",1,1,0,2,"dummy"
"125414",3,2,1,6,"dummy"
"125415",5,6,0,11,"dummy"
"125416",0,3,0,3,"dummy"
"125417",3,1,0,4,"dummy"
"125418",11,5,6,22,"dummy"
"125419",0,1,0,1,"dummy"
"125420",0,0,3,3,"dummy"
"125421",1,2,2,5,"dummy"
"125423",5,7,0,12,"dummy"
"125424",0,0,0,0,"dummy"
"125425",0,0,1,1,"dummy"
"125453",0,0,1,1,"dummy"
"125473",0,0,1,1,"dummy"
"125487",0,0,1,1,"dummy"
"125488",0,1,1,2,"dummy"
"125489",0,0,2,2,"dummy"
"125490",0,0,2,2,"dummy"
"125491",0,0,1,1,"dummy"
"125492",0,0,1,1,"dummy"
"125493",0,0,1,1,"dummy"
"125494",0,0,1,1,"dummy"
"125495",0,1,1,2,"dummy"
"125496",0,0,1,1,"dummy"
"125497",0,0,1,1,"dummy"
"125498",0,0,1,1,"dummy"
"125502",0,0,1,1,"dummy"
"125504",1,4,0,5,"dummy"
"125505",0,0,1,1,"dummy"
"125508",0,2,0,2,"dummy"
"125509",0,1,0,1,"dummy"
"125510",0,1,0,1,"dummy"
"125511",0,0,1,1,"dummy"
"125512",0,0,1,1,"dummy"
"125513",0,0,1,1,"dummy"
"125514",0,0,1,1,"dummy"
"125518",0,1,0,1,"dummy"
"125519",0,0,1,1,"dummy"
"125520",0,1,0,1,"dummy"
"125521",0,0,1,1,"dummy"
"125522",0,2,0,2,"dummy"
"125524",0,0,0,0,"dummy"
"125525",0,1,1,2,"dummy"
"125526",0,0,1,1,"dummy"
"125527",4,5,4,13,"dummy"
"125528",0,0,0,0,"dummy"
"125533",0,1,0,1,"dummy"
"125534",0,1,0,1,"dummy"
"125536",1,1,0,2,"dummy"
"125537",0,4,0,4,"dummy"
"125538",0,1,0,1,"dummy"
"125539",0,4,0,4,"dummy"
"125540",0,0,2,2,"dummy"
"125541",0,0,2,2,"dummy"
"125542",0,1,0,1,"dummy"
"125543",2,3,2,7,"dummy"
"125544",0,0,1,1,"dummy"
"125545",0,1,2,3,"dummy"
"125546",2,1,0,3,"dummy"
"125547",5,3,1,9,"dummy"
"125548",0,0,1,1,"dummy"
"125549",0,0,1,1,"dummy"
"125550",0,0,3,3,"dummy"
"125551",0,0,2,2,"dummy"
"125566",2,4,0,6,"dummy"
"125567",0,2,0,2,"dummy"
"125568",0,2,0,2,"dummy"
"125569",10,2,0,12,"dummy"
"125570",0,2,0,2,"dummy"
"125611",0,1,0,1,"dummy"
"125612",0,3,0,3,"dummy"
"125613",0,0,1,1,"dummy"
"125614",0,2,2,4,"dummy"
"125615",0,0,1,1,"dummy"
"125616",0,1,0,1,"dummy"
"125617",2,1,2,5,"dummy"
"125618",0,0,1,1,"dummy"
"125621",2,0,0,2,"dummy"
"125623",1,0,0,1,"dummy"
"125624",2,0,1,3,"dummy"
"125625",0,0,0,0,"dummy"
"125626",0,1,0,1,"dummy"
"125627",8,1,0,9,"dummy"
"125628",0,0,0,0,"dummy"
"125629",0,0,0,0,"dummy"
"125630",1,10,0,11,"dummy"
"125631",7,1,0,8,"dummy"
"125632",2,0,3,5,"dummy"
"125635",0,2,1,3,"dummy"
"125636",0,1,0,1,"dummy"
"125637",0,1,0,1,"dummy"
"125638",0,1,1,2,"dummy"
"125639",0,0,1,1,"dummy"
"125642",0,1,0,1,"dummy"
"125645",0,3,0,3,"dummy"
"125651",2,2,0,4,"dummy"
"125652",2,1,3,6,"dummy"
"125653",0,4,0,4,"dummy"
"125654",2,11,3,16,"dummy"
"125656",0,1,0,1,"dummy"
"125657",0,1,0,1,"dummy"
"125658",0,1,0,1,"dummy"
"125660",1,0,0,1,"dummy"
"125661",0,2,0,2,"dummy"
"125662",1,0,0,1,"dummy"
"125663",0,0,3,3,"dummy"
"125664",4,2,0,6,"dummy"
"125665",1,0,1,2,"dummy"
"125667",0,0,0,0,"dummy"
"125668",0,0,0,0,"dummy"
"125669",0,1,0,1,"dummy"
"125670",0,0,0,0,"dummy"
"125671",0,0,0,0,"dummy"
"125672",0,0,0,0,"dummy"
"125677",0,2,0,2,"dummy"
"125678",6,1,0,7,"dummy"
"125679",0,0,0,0,"dummy"
"125680",0,0,1,1,"dummy"
"125681",0,4,0,4,"dummy"
"125682",0,1,0,1,"dummy"
"125687",0,0,0,0,"dummy"
"125688",0,0,0,0,"dummy"
"125689",0,3,0,3,"dummy"
"125690",7,24,0,31,"dummy"
"125691",4,0,0,4,"dummy"
"125692",0,1,0,1,"dummy"
"125695",0,25,0,25,"dummy"
"125699",2,0,0,2,"dummy"
"125700",2,4,0,6,"dummy"
"125701",0,0,0,0,"dummy"
"125704",0,1,0,1,"dummy"
"125706",4,4,1,9,"dummy"
"125707",0,1,0,1,"dummy"
"125708",0,1,0,1,"dummy"
"125709",3,2,1,6,"dummy"
"125710",0,1,0,1,"dummy"
"125711",0,0,1,1,"dummy"
"125713",0,2,0,2,"dummy"
"125714",0,0,1,1,"dummy"
"125715",0,0,1,1,"dummy"
"125716",0,0,1,1,"dummy"
"125717",0,0,1,1,"dummy"
"125734",2,0,1,3,"dummy"
"125735",0,0,0,0,"dummy"
"125736",0,0,3,3,"dummy"
"125737",0,0,1,1,"dummy"
"125738",0,18,1,19,"dummy"
"125739",0,0,5,5,"dummy"
"125740",4,3,0,7,"dummy"
"125741",0,0,1,1,"dummy"
"125742",0,1,2,3,"dummy"
"125743",0,2,2,4,"dummy"
"125744",0,0,1,1,"dummy"
"125745",0,0,1,1,"dummy"
"125746",2,0,0,2,"dummy"
"125747",0,1,1,2,"dummy"
"125748",0,2,0,2,"dummy"
"125752",0,3,2,5,"dummy"
"125753",5,5,1,11,"dummy"
"125755",0,0,0,0,"dummy"
"125756",0,0,0,0,"dummy"
"125757",0,0,0,0,"dummy"
"125758",1,2,0,3,"dummy"
"125759",0,0,0,0,"dummy"
"125762",7,0,0,7,"dummy"
"125763",0,0,8,8,"dummy"
"125764",0,0,1,1,"dummy"
"125765",8,6,11,25,"dummy"
"125766",0,0,1,1,"dummy"
"125767",0,0,1,1,"dummy"
"125768",0,0,1,1,"dummy"
"125769",0,0,1,1,"dummy"
"125774",0,1,0,1,"dummy"
"125775",2,1,1,4,"dummy"
"125829",1,0,0,1,"dummy"
"125831",1,2,0,3,"dummy"
"125833",0,1,0,1,"dummy"
"125834",0,1,0,1,"dummy"
"125835",0,1,0,1,"dummy"
"125836",0,3,0,3,"dummy"
"125838",0,8,0,8,"dummy"
"125839",2,12,2,16,"dummy"
"125840",2,8,3,13,"dummy"
"125843",4,14,4,22,"dummy"
"125844",1,4,4,9,"dummy"
"125846",0,0,1,1,"dummy"
"125847",1,9,2,12,"dummy"
"125848",0,7,0,7,"dummy"
"125849",2,0,0,2,"dummy"
"125861",0,0,0,0,"dummy"
"125862",0,2,0,2,"dummy"
"125863",0,0,1,1,"dummy"
"125864",0,2,0,2,"dummy"
"125866",0,0,0,0,"dummy"
"125867",0,0,1,1,"dummy"
"125868",4,8,0,12,"dummy"
"125869",2,0,0,2,"dummy"
"125870",8,3,0,11,"dummy"
"125871",0,0,1,1,"dummy"
"125872",0,1,0,1,"dummy"
"125873",0,2,0,2,"dummy"
"125874",0,2,0,2,"dummy"
"125875",0,2,0,2,"dummy"
"125876",0,2,0,2,"dummy"
"125877",0,0,0,0,"dummy"
"125878",8,0,0,8,"dummy"
"125879",0,0,0,0,"dummy"
"125880",0,0,0,0,"dummy"
"125881",0,0,0,0,"dummy"
"125882",0,0,0,0,"dummy"
"125883",0,1,0,1,"dummy"
"125884",0,0,0,0,"dummy"
"125885",0,0,0,0,"dummy"
"125891",1,2,0,3,"dummy"
"125892",0,0,3,3,"dummy"
"125893",0,0,1,1,"dummy"
"125894",2,8,7,17,"dummy"
"125896",0,3,1,4,"dummy"
"125898",0,1,0,1,"dummy"
"125900",0,2,0,2,"dummy"
"125901",0,1,0,1,"dummy"
"125902",0,1,1,2,"dummy"
"125903",0,1,0,1,"dummy"
"125904",1,1,2,4,"dummy"
"125905",1,2,0,3,"dummy"
"125906",0,0,0,0,"dummy"
"125907",0,0,1,1,"dummy"
"125908",0,0,0,0,"dummy"
"125926",0,24,0,24,"dummy"
"125928",2,3,1,6,"dummy"
"125931",2,4,0,6,"dummy"
"125932",0,2,0,2,"dummy"
"125933",0,2,0,2,"dummy"
"125934",10,2,0,12,"dummy"
"125935",0,2,0,2,"dummy"
"125936",0,0,0,0,"dummy"
"125937",0,0,3,3,"dummy"
"125938",0,5,0,5,"dummy"
"125939",1,0,1,2,"dummy"
"125943",53,22,8,83,"dummy"
"125944",3,0,2,5,"dummy"
"125945",0,1,1,2,"dummy"
"125946",0,0,2,2,"dummy"
"125947",0,3,3,6,"dummy"
"125948",0,0,1,1,"dummy"
"125949",0,0,1,1,"dummy"
"125950",1,0,0,1,"dummy"
"125952",0,2,2,4,"dummy"
"125953",0,0,2,2,"dummy"
"125954",2,1,0,3,"dummy"
"125955",0,1,0,1,"dummy"
"125956",0,2,0,2,"dummy"
"125958",0,0,1,1,"dummy"
"125960",1,2,0,3,"dummy"
"125961",1,0,0,1,"dummy"
"125963",0,2,1,3,"dummy"
"125976",0,2,0,2,"dummy"
"125977",0,0,1,1,"dummy"
"125978",0,1,0,1,"dummy"
"125979",0,0,0,0,"dummy"
"125980",2,2,1,5,"dummy"
"125981",0,1,0,1,"dummy"
"125982",0,1,0,1,"dummy"
"125983",2,2,0,4,"dummy"
"125984",0,0,0,0,"dummy"
"125985",0,0,0,0,"dummy"
"125987",0,6,2,8,"dummy"
"125988",0,0,1,1,"dummy"
"125989",0,0,0,0,"dummy"
"125990",1,1,1,3,"dummy"
"125991",0,0,2,2,"dummy"
"125992",1,0,0,1,"dummy"
"125993",0,2,1,3,"dummy"
"125994",0,0,1,1,"dummy"
"125995",2,2,0,4,"dummy"
"125996",0,1,1,2,"dummy"
"125997",3,5,3,11,"dummy"
"125998",1,2,2,5,"dummy"
"125999",0,1,1,2,"dummy"
"126000",0,3,0,3,"dummy"
"126001",2,0,0,2,"dummy"
"126002",0,2,0,2,"dummy"
"126003",1,1,0,2,"dummy"
"126004",3,0,0,3,"dummy"
"126005",2,2,0,4,"dummy"
"126007",1,0,1,2,"dummy"
"126008",3,0,1,4,"dummy"
"126009",0,1,0,1,"dummy"
"126010",0,0,1,1,"dummy"
"126012",0,0,0,0,"dummy"
"126042",6,0,0,6,"dummy"
"126043",2,5,2,9,"dummy"
"126046",1,0,0,1,"dummy"
"126047",2,1,0,3,"dummy"
"126048",0,0,1,1,"dummy"
"126073",0,0,1,1,"dummy"
"126080",0,0,0,0,"dummy"
"126081",0,0,0,0,"dummy"
"126084",0,3,1,4,"dummy"
"126085",0,16,0,16,"dummy"
"126086",6,0,0,6,"dummy"
"126097",0,0,1,1,"dummy"
"126098",0,0,1,1,"dummy"
"126102",0,1,3,4,"dummy"
"126103",1,0,3,4,"dummy"
"126104",0,1,0,1,"dummy"
"126105",0,0,1,1,"dummy"
"126114",0,1,0,1,"dummy"
"126116",1,4,0,5,"dummy"
"126117",0,2,0,2,"dummy"
"126118",2,0,0,2,"dummy"
"126119",0,4,0,4,"dummy"
"126120",0,1,0,1,"dummy"
"126121",0,1,0,1,"dummy"
"126122",8,9,6,23,"dummy"
"126123",0,1,0,1,"dummy"
"126125",0,0,1,1,"dummy"
"126161",0,0,1,1,"dummy"
"126162",0,0,0,0,"dummy"
"126163",0,0,0,0,"dummy"
"126166",0,0,1,1,"dummy"
"126167",0,0,1,1,"dummy"
"126168",0,0,1,1,"dummy"
"126169",0,1,1,2,"dummy"
"126171",2,4,3,9,"dummy"
"126172",1,1,0,2,"dummy"
"126173",4,3,4,11,"dummy"
"126174",0,4,0,4,"dummy"
"126178",0,1,0,1,"dummy"
"126179",3,3,0,6,"dummy"
"126180",0,2,0,2,"dummy"
"126181",0,1,0,1,"dummy"
"126182",1,0,0,1,"dummy"
"126183",0,0,1,1,"dummy"
"126184",0,1,0,1,"dummy"
"126185",15,1,1,17,"dummy"
"126186",1,0,0,1,"dummy"
"126187",0,0,1,1,"dummy"
"126188",2,2,0,4,"dummy"
"126190",5,11,12,28,"dummy"
"126191",0,0,2,2,"dummy"
"126235",0,1,0,1,"dummy"
"126237",5,1,4,10,"dummy"
"126239",0,0,1,1,"dummy"
"126240",2,0,4,6,"dummy"
"126242",5,7,1,13,"dummy"
"126243",1,4,4,9,"dummy"
"126244",0,2,0,2,"dummy"
"126245",0,2,0,2,"dummy"
"126246",4,0,0,4,"dummy"
"126247",12,7,3,22,"dummy"
"126248",0,0,1,1,"dummy"
"126249",3,6,0,9,"dummy"
"126254",14,4,0,18,"dummy"
"126255",0,1,0,1,"dummy"
"126269",0,1,3,4,"dummy"
"126272",0,8,0,8,"dummy"
"126273",7,0,0,7,"dummy"
"126274",1,1,0,2,"dummy"
"126284",1,0,0,1,"dummy"
"126285",0,2,0,2,"dummy"
"126286",0,1,0,1,"dummy"
"126289",0,3,0,3,"dummy"
"126290",0,1,0,1,"dummy"
"126291",0,6,0,6,"dummy"
"126294",6,0,2,8,"dummy"
"126295",1,0,0,1,"dummy"
"126296",5,3,0,8,"dummy"
"126297",9,8,1,18,"dummy"
"126299",0,8,0,8,"dummy"
"126300",0,2,0,2,"dummy"
"126301",12,18,3,33,"dummy"
"126302",0,2,0,2,"dummy"
"126303",1,0,1,2,"dummy"
"126304",0,0,10,10,"dummy"
"126305",0,0,1,1,"dummy"
"126306",1,0,5,6,"dummy"
"126307",1,0,1,2,"dummy"
"126308",0,5,0,5,"dummy"
"126312",0,1,2,3,"dummy"
"126313",0,0,1,1,"dummy"
"126316",1,0,1,2,"dummy"
"126317",0,2,0,2,"dummy"
"126318",2,0,0,2,"dummy"
"126326",0,2,0,2,"dummy"
"126337",12,6,8,26,"dummy"
"126339",0,0,1,1,"dummy"
"126341",0,2,0,2,"dummy"
"126363",0,1,0,1,"dummy"
"126365",0,2,0,2,"dummy"
"126367",0,2,0,2,"dummy"
"126368",0,0,1,1,"dummy"
"126369",0,0,0,0,"dummy"
"126370",0,0,0,0,"dummy"
"126371",0,0,0,0,"dummy"
"126374",0,1,0,1,"dummy"
"126375",0,2,0,2,"dummy"
"126376",0,1,0,1,"dummy"
"126377",3,2,1,6,"dummy"
"126378",3,1,0,4,"dummy"
"126379",0,0,2,2,"dummy"
"126380",0,1,0,1,"dummy"
"126381",0,0,0,0,"dummy"
"126382",0,0,0,0,"dummy"
"126383",0,1,1,2,"dummy"
"126384",0,0,1,1,"dummy"
"126385",0,2,0,2,"dummy"
"126425",1,11,0,12,"dummy"
"126426",0,0,0,0,"dummy"
"126430",1,0,0,1,"dummy"
"126431",2,0,0,2,"dummy"
"126436",0,1,0,1,"dummy"
"126568",1,0,2,3,"dummy"
"126576",6,6,8,20,"dummy"
"126587",11,10,4,25,"dummy"
"126588",6,8,1,15,"dummy"
"126589",0,1,0,1,"dummy"
"126590",1,0,0,1,"dummy"
"126591",4,3,1,8,"dummy"
"126592",0,1,0,1,"dummy"
"126593",1,0,0,1,"dummy"
"126594",0,1,0,1,"dummy"
"126595",0,2,0,2,"dummy"
"126596",0,0,1,1,"dummy"
"126607",1,5,1,7,"dummy"
"126610",3,0,0,3,"dummy"
"126615",0,1,0,1,"dummy"
"126616",0,0,1,1,"dummy"
"126617",0,2,0,2,"dummy"
"126618",0,0,1,1,"dummy"
"126621",1,1,0,2,"dummy"
"126628",5,7,0,12,"dummy"
"126629",6,5,0,11,"dummy"
"126630",0,0,0,0,"dummy"
"126631",1,0,0,1,"dummy"
"126638",5,6,3,14,"dummy"
"126639",2,2,0,4,"dummy"
"126640",3,3,0,6,"dummy"
"126641",2,2,1,5,"dummy"
"126642",0,1,0,1,"dummy"
"126643",1,2,0,3,"dummy"
"126644",1,1,0,2,"dummy"
"126645",0,1,2,3,"dummy"
"126646",1,0,0,1,"dummy"
"126647",2,1,0,3,"dummy"
"126648",0,2,0,2,"dummy"
"126649",0,2,0,2,"dummy"
"126650",0,1,0,1,"dummy"
"126651",0,2,0,2,"dummy"
"126652",2,2,0,4,"dummy"
"126657",0,1,0,1,"dummy"
"126662",0,1,0,1,"dummy"
"126663",1,0,0,1,"dummy"
"126677",0,5,0,5,"dummy"
"126678",0,1,0,1,"dummy"
"126679",2,2,0,4,"dummy"
"126680",1,4,0,5,"dummy"
"126681",10,3,1,14,"dummy"
"126682",0,2,0,2,"dummy"
"126683",2,1,0,3,"dummy"
"126684",2,0,1,3,"dummy"
"126685",0,1,0,1,"dummy"
"126686",10,1,1,12,"dummy"
"126687",0,0,0,0,"dummy"
"126688",0,0,0,0,"dummy"
"126689",1,5,1,7,"dummy"
"126428",4,0,0,4,"dummy"
"126433",0,2,0,2,"dummy"
"126434",1,0,1,2,"dummy"
"126438",0,1,1,2,"dummy"
"126439",1,0,1,2,"dummy"
"126445",0,1,0,1,"dummy"
"126446",1,2,0,3,"dummy"
"126447",0,0,3,3,"dummy"
"126450",0,2,0,2,"dummy"
"126451",0,1,0,1,"dummy"
"126454",0,1,0,1,"dummy"
"126457",2,0,2,4,"dummy"
"126521",0,0,0,0,"dummy"
"126522",0,0,0,0,"dummy"
"126555",1,9,1,11,"dummy"
"126556",4,16,2,22,"dummy"
"126557",3,6,1,10,"dummy"
"126558",4,4,1,9,"dummy"
"126559",0,1,1,2,"dummy"
"126560",0,0,0,0,"dummy"
"126561",0,0,0,0,"dummy"
"126564",0,0,1,1,"dummy"
"126565",0,0,1,1,"dummy"
"126566",0,0,1,1,"dummy"
"126572",1,0,0,1,"dummy"
"126578",6,2,3,11,"dummy"
"126579",0,0,0,0,"dummy"
"126598",0,1,0,1,"dummy"
"126599",0,2,0,2,"dummy"
"126600",0,6,0,6,"dummy"
"126601",0,1,0,1,"dummy"
"126602",2,8,0,10,"dummy"
"126603",1,0,0,1,"dummy"
"126612",16,12,3,31,"dummy"
"126613",0,2,1,3,"dummy"
"126633",1,1,0,2,"dummy"
"126634",0,0,3,3,"dummy"
"126635",0,0,1,1,"dummy"
"126636",0,12,0,12,"dummy"
"126654",0,2,0,2,"dummy"
"126655",1,1,0,2,"dummy"
"126659",2,0,1,3,"dummy"
"126660",1,1,1,3,"dummy"
"126665",0,1,0,1,"dummy"
"126666",0,0,1,1,"dummy"
"126667",0,0,1,1,"dummy"
"126673",18,28,3,49,"dummy"
"126709",8,2,1,11,"dummy"
"126710",1,7,1,9,"dummy"
"126711",0,0,0,0,"dummy"
"126712",0,1,3,4,"dummy"
"126713",2,1,0,3,"dummy"
"126722",0,1,0,1,"dummy"
"126725",1,0,0,1,"dummy"
"126728",3,3,0,6,"dummy"
"126729",0,0,1,1,"dummy"
"126730",0,0,1,1,"dummy"
"126736",1,2,0,3,"dummy"
"126737",0,0,3,3,"dummy"
"126738",0,0,4,4,"dummy"
"126739",0,0,2,2,"dummy"
"126752",0,0,1,1,"dummy"
"126753",2,0,0,2,"dummy"
"126754",3,1,0,4,"dummy"
"126690",0,0,0,0,"dummy"
"126691",0,0,0,0,"dummy"
"126692",0,0,0,0,"dummy"
"126693",0,0,0,0,"dummy"
"126694",0,0,0,0,"dummy"
"126695",0,0,0,0,"dummy"
"126696",0,0,0,0,"dummy"
"126697",0,0,0,0,"dummy"
"126698",0,0,0,0,"dummy"
"126699",0,0,0,0,"dummy"
"126700",0,0,0,0,"dummy"
"126701",0,3,1,4,"dummy"
"126707",1,5,0,6,"dummy"
"126719",0,0,1,1,"dummy"
"126720",4,1,0,5,"dummy"
"126732",0,0,1,1,"dummy"
"126733",0,3,3,6,"dummy"
"126734",2,0,1,3,"dummy"
"126741",0,0,1,1,"dummy"
"126742",0,5,0,5,"dummy"
"126743",0,0,0,0,"dummy"
"126744",0,1,0,1,"dummy"
"126756",2,5,2,9,"dummy"
"126761",1,0,0,1,"dummy"
"126762",0,0,1,1,"dummy"
"126779",2,1,0,3,"dummy"
"126782",4,19,2,25,"dummy"
"126786",0,0,1,1,"dummy"
"126799",3,3,3,9,"dummy"
"126800",0,0,0,0,"dummy"
"126801",0,0,0,0,"dummy"
"126802",0,1,0,1,"dummy"
"126803",1,0,0,1,"dummy"
"126804",4,4,0,8,"dummy"
"126805",0,0,1,1,"dummy"
"126831",0,2,0,2,"dummy"
"126832",0,2,2,4,"dummy"
"126833",2,2,1,5,"dummy"
"126834",0,0,3,3,"dummy"
"126835",1,2,1,4,"dummy"
"126836",2,6,0,8,"dummy"
"126837",0,0,1,1,"dummy"
"126838",0,0,1,1,"dummy"
"126839",7,3,0,10,"dummy"
"126840",0,7,2,9,"dummy"
"126841",0,0,4,4,"dummy"
"126842",3,4,0,7,"dummy"
"126843",0,0,1,1,"dummy"
"126844",0,1,0,1,"dummy"
"126845",0,2,0,2,"dummy"
"126846",0,7,0,7,"dummy"
"126847",3,1,0,4,"dummy"
"126858",0,1,0,1,"dummy"
"126883",4,2,4,10,"dummy"
"126764",0,0,1,1,"dummy"
"126765",0,0,1,1,"dummy"
"126768",0,3,0,3,"dummy"
"126773",0,0,1,1,"dummy"
"126784",0,2,1,3,"dummy"
"126788",0,1,0,1,"dummy"
"126789",0,1,0,1,"dummy"
"126790",0,0,3,3,"dummy"
"126791",0,0,3,3,"dummy"
"126792",0,0,1,1,"dummy"
"126795",1,4,2,7,"dummy"
"126796",0,2,0,2,"dummy"
"126797",0,1,0,1,"dummy"
"126807",0,1,0,1,"dummy"
"126808",0,15,1,16,"dummy"
"126809",0,1,0,1,"dummy"
"126810",0,1,0,1,"dummy"
"126811",7,8,0,15,"dummy"
"126812",2,2,0,4,"dummy"
"126813",1,6,1,8,"dummy"
"126814",0,0,1,1,"dummy"
"126815",1,0,0,1,"dummy"
"126816",2,5,2,9,"dummy"
"126817",0,0,1,1,"dummy"
"126818",5,24,0,29,"dummy"
"126849",0,0,0,0,"dummy"
"126850",0,1,0,1,"dummy"
"126851",8,1,0,9,"dummy"
"126852",0,0,0,0,"dummy"
"126853",0,0,0,0,"dummy"
"126854",1,10,0,11,"dummy"
"126855",7,1,0,8,"dummy"
"126856",2,0,3,5,"dummy"
"126885",0,0,0,0,"dummy"
"126886",0,0,0,0,"dummy"
"126921",0,0,1,1,"dummy"
"126922",0,0,0,0,"dummy"
"126925",1,0,0,1,"dummy"
"126929",0,0,0,0,"dummy"
"126931",0,0,1,1,"dummy"
"126932",0,0,1,1,"dummy"
"126934",1,0,0,1,"dummy"
"126935",1,2,0,3,"dummy"
"126937",0,1,0,1,"dummy"
"126938",2,2,1,5,"dummy"
"126940",0,1,1,2,"dummy"
"126945",0,0,0,0,"dummy"
"126946",2,1,1,4,"dummy"
"126954",0,3,0,3,"dummy"
"126955",2,2,0,4,"dummy"
"126956",0,1,0,1,"dummy"
"126957",1,0,0,1,"dummy"
"126958",1,3,0,4,"dummy"
"126959",0,1,1,2,"dummy"
"126960",3,3,2,8,"dummy"
"126961",2,2,0,4,"dummy"
"126964",0,3,2,5,"dummy"
"126965",6,0,2,8,"dummy"
"126966",1,1,0,2,"dummy"
"126967",0,1,0,1,"dummy"
"126968",2,0,0,2,"dummy"
"126969",0,4,1,5,"dummy"
"126970",3,0,0,3,"dummy"
"126971",0,1,4,5,"dummy"
"126972",0,0,5,5,"dummy"
"126973",0,0,5,5,"dummy"
"126975",0,1,0,1,"dummy"
"126976",0,1,0,1,"dummy"
"126977",0,2,0,2,"dummy"
"126979",6,1,2,9,"dummy"
"126980",0,4,1,5,"dummy"
"126981",4,0,1,5,"dummy"
"126983",0,0,1,1,"dummy"
"126984",0,0,0,0,"dummy"
"126986",0,0,1,1,"dummy"
"126987",0,0,1,1,"dummy"
"126988",0,22,0,22,"dummy"
"126995",0,3,1,4,"dummy"
"126996",0,0,2,2,"dummy"
"126997",0,0,1,1,"dummy"
"126998",0,0,2,2,"dummy"
"127002",0,12,8,20,"dummy"
"127003",24,22,4,50,"dummy"
"127004",9,3,2,14,"dummy"
"127005",4,3,1,8,"dummy"
"127006",4,9,1,14,"dummy"
"127007",0,0,1,1,"dummy"
"127008",0,0,1,1,"dummy"
"127011",11,23,6,40,"dummy"
"127012",0,5,0,5,"dummy"
"127013",0,1,3,4,"dummy"
"127015",2,1,2,5,"dummy"
"127017",0,1,1,2,"dummy"
"127018",0,7,0,7,"dummy"
"127019",1,0,0,1,"dummy"
"127021",0,1,0,1,"dummy"
"127022",0,1,0,1,"dummy"
"127023",0,1,0,1,"dummy"
"127024",1,1,0,2,"dummy"
"127025",0,6,0,6,"dummy"
"127026",0,2,0,2,"dummy"
"127027",0,10,0,10,"dummy"
"127028",10,0,0,10,"dummy"
"127032",1,1,0,2,"dummy"
"127033",1,8,1,10,"dummy"
"127037",0,4,0,4,"dummy"
"127038",0,0,1,1,"dummy"
"127039",3,10,2,15,"dummy"
"127040",0,2,0,2,"dummy"
"127043",0,1,0,1,"dummy"
"127048",0,1,0,1,"dummy"
"127049",0,0,0,0,"dummy"
"127050",0,0,0,0,"dummy"
"127051",0,0,0,0,"dummy"
"127052",0,0,0,0,"dummy"
"127053",0,0,0,0,"dummy"
"127054",0,0,0,0,"dummy"
"127055",0,0,0,0,"dummy"
"127056",0,0,0,0,"dummy"
"127057",0,0,0,0,"dummy"
"127058",0,2,1,3,"dummy"
"127059",0,0,0,0,"dummy"
"127060",0,0,0,0,"dummy"
"127061",0,0,0,0,"dummy"
"127062",0,0,0,0,"dummy"
"127063",0,0,0,0,"dummy"
"127064",0,2,0,2,"dummy"
"127065",0,2,0,2,"dummy"
"127066",0,0,0,0,"dummy"
"127067",0,0,0,0,"dummy"
"127068",0,0,0,0,"dummy"
"127074",0,0,1,1,"dummy"
"127075",0,0,1,1,"dummy"
"127076",0,0,1,1,"dummy"
"127077",0,1,0,1,"dummy"
"127078",0,1,0,1,"dummy"
"127079",1,4,0,5,"dummy"
"127080",1,8,0,9,"dummy"
"127081",0,0,1,1,"dummy"
"127082",1,2,6,9,"dummy"
"127083",5,2,0,7,"dummy"
"127084",2,0,1,3,"dummy"
"127085",1,3,1,5,"dummy"
"127086",0,0,1,1,"dummy"
"127087",13,16,1,30,"dummy"
"127088",12,6,1,19,"dummy"
"127089",4,5,1,10,"dummy"
"127090",0,1,0,1,"dummy"
"127091",1,0,1,2,"dummy"
"127092",0,1,0,1,"dummy"
"127093",0,1,0,1,"dummy"
"127094",0,1,0,1,"dummy"
"127095",1,1,0,2,"dummy"
"127096",0,1,0,1,"dummy"
"127097",0,1,0,1,"dummy"
"127101",0,3,0,3,"dummy"
"127102",3,1,0,4,"dummy"
"127103",0,3,0,3,"dummy"
"127104",0,0,1,1,"dummy"
"127105",1,1,0,2,"dummy"
"127106",0,1,0,1,"dummy"
"127109",0,0,1,1,"dummy"
"127110",0,0,2,2,"dummy"
"127112",0,1,0,1,"dummy"
"127113",2,2,0,4,"dummy"
"127114",2,2,0,4,"dummy"
"127115",0,1,0,1,"dummy"
"127116",0,5,0,5,"dummy"
"127117",1,10,0,11,"dummy"
"127118",9,9,0,18,"dummy"
"127119",0,2,0,2,"dummy"
"127120",2,1,0,3,"dummy"
"127121",1,0,0,1,"dummy"
"127122",0,1,0,1,"dummy"
"127123",0,1,0,1,"dummy"
"127124",0,0,2,2,"dummy"
"127127",0,1,0,1,"dummy"
"127128",0,1,0,1,"dummy"
"127129",2,1,0,3,"dummy"
"127130",1,2,0,3,"dummy"
"127131",0,0,0,0,"dummy"
"127132",2,2,0,4,"dummy"
"127133",2,3,0,5,"dummy"
"127135",0,1,1,2,"dummy"
"127136",0,0,1,1,"dummy"
"127137",12,0,6,18,"dummy"
"127138",1,0,0,1,"dummy"
"127140",0,3,0,3,"dummy"
"127141",3,0,0,3,"dummy"
"127142",0,4,0,4,"dummy"
"127146",0,3,0,3,"dummy"
"127147",13,23,1,37,"dummy"
"127148",0,0,0,0,"dummy"
"127149",0,0,1,1,"dummy"
"127150",5,3,5,13,"dummy"
"127152",0,1,0,1,"dummy"
"127160",0,2,0,2,"dummy"
"127161",2,1,0,3,"dummy"
"127162",0,0,1,1,"dummy"
"127163",0,0,1,1,"dummy"
"127164",3,1,1,5,"dummy"
"127165",0,0,1,1,"dummy"
"127166",0,0,1,1,"dummy"
"127173",0,0,1,1,"dummy"
"127175",0,1,0,1,"dummy"
"127179",0,0,1,1,"dummy"
"127180",0,3,0,3,"dummy"
"127181",0,0,2,2,"dummy"
"127182",0,0,2,2,"dummy"
"127183",1,4,0,5,"dummy"
"127184",0,2,2,4,"dummy"
"127185",0,0,1,1,"dummy"
"127186",0,1,2,3,"dummy"
"127187",0,0,2,2,"dummy"
"127188",1,0,0,1,"dummy"
"127189",2,0,2,4,"dummy"
"127190",2,2,0,4,"dummy"
"127191",2,2,0,4,"dummy"
"127192",2,2,0,4,"dummy"
"127193",0,2,0,2,"dummy"
"127194",4,4,0,8,"dummy"
"127195",0,2,0,2,"dummy"
"127196",0,0,2,2,"dummy"
"127197",0,0,0,0,"dummy"
"127198",0,0,1,1,"dummy"
"127199",0,2,1,3,"dummy"
"127200",0,0,1,1,"dummy"
"127201",2,0,0,2,"dummy"
"127204",1,3,1,5,"dummy"
"127208",0,10,0,10,"dummy"
"127209",1,0,0,1,"dummy"
"127210",0,3,1,4,"dummy"
"127251",0,0,1,1,"dummy"
"127252",1,0,0,1,"dummy"
"127259",2,0,3,5,"dummy"
"127263",0,0,1,1,"dummy"
"127285",0,8,0,8,"dummy"
"127286",0,0,1,1,"dummy"
"127307",0,0,1,1,"dummy"
"127308",0,0,0,0,"dummy"
"127309",2,0,1,3,"dummy"
"127310",2,2,0,4,"dummy"
"127311",0,1,0,1,"dummy"
"127312",4,4,2,10,"dummy"
"127313",0,0,1,1,"dummy"
"127314",2,1,0,3,"dummy"
"127315",0,1,0,1,"dummy"
"127316",0,0,0,0,"dummy"
"127317",9,3,5,17,"dummy"
"127318",0,5,0,5,"dummy"
"127319",3,0,0,3,"dummy"
"127320",0,2,0,2,"dummy"
"127321",0,0,0,0,"dummy"
"127322",0,2,0,2,"dummy"
"127323",0,2,0,2,"dummy"
"127324",1,1,0,2,"dummy"
"127325",0,4,0,4,"dummy"
"127326",2,0,0,2,"dummy"
"127327",0,1,0,1,"dummy"
"127330",0,0,0,0,"dummy"
"127331",5,0,2,7,"dummy"
"127332",0,0,0,0,"dummy"
"127335",0,0,1,1,"dummy"
"127336",0,0,2,2,"dummy"
"127361",0,5,0,5,"dummy"
"127362",0,0,1,1,"dummy"
"127363",0,1,0,1,"dummy"
"127364",0,1,0,1,"dummy"
"127365",1,0,2,3,"dummy"
"127366",0,2,1,3,"dummy"
"127367",0,1,0,1,"dummy"
"127368",0,5,1,6,"dummy"
"127369",0,1,1,2,"dummy"
"127370",0,4,0,4,"dummy"
"127371",0,5,0,5,"dummy"
"127372",3,0,0,3,"dummy"
"127373",0,8,0,8,"dummy"
"127374",3,3,0,6,"dummy"
"127375",5,4,0,9,"dummy"
"127376",4,4,0,8,"dummy"
"127377",5,6,0,11,"dummy"
"127378",2,2,0,4,"dummy"
"127379",3,3,0,6,"dummy"
"127380",5,5,0,10,"dummy"
"127381",20,25,5,50,"dummy"
"127382",2,1,1,4,"dummy"
"127383",0,1,0,1,"dummy"
"127384",0,2,0,2,"dummy"
"127385",0,1,0,1,"dummy"
"127386",0,0,1,1,"dummy"
"127387",0,0,0,0,"dummy"
"127388",0,0,1,1,"dummy"
"127389",2,6,0,8,"dummy"
"127390",5,6,1,12,"dummy"
"127391",2,6,0,8,"dummy"
"127392",2,2,4,8,"dummy"
"127393",0,0,1,1,"dummy"
"127394",0,0,2,2,"dummy"
"127395",2,6,0,8,"dummy"
"127396",3,3,1,7,"dummy"
"127442",0,0,1,1,"dummy"
"127443",0,1,2,3,"dummy"
"127444",0,1,1,2,"dummy"
"127445",0,0,1,1,"dummy"
"127446",1,1,0,2,"dummy"
"127452",2,0,0,2,"dummy"
"127453",0,0,2,2,"dummy"
"127454",1,1,0,2,"dummy"
"127223",0,1,0,1,"dummy"
"127233",8,0,0,8,"dummy"
"127234",0,2,1,3,"dummy"
"127237",0,1,0,1,"dummy"
"127238",0,1,0,1,"dummy"
"127239",6,2,2,10,"dummy"
"127240",0,0,3,3,"dummy"
"127254",0,0,1,1,"dummy"
"127255",1,0,0,1,"dummy"
"127261",0,0,1,1,"dummy"
"127265",0,0,1,1,"dummy"
"127266",0,0,1,1,"dummy"
"127269",0,3,0,3,"dummy"
"127270",0,0,0,0,"dummy"
"127271",1,0,1,2,"dummy"
"127272",0,2,0,2,"dummy"
"127273",2,2,1,5,"dummy"
"127274",0,5,0,5,"dummy"
"127275",0,1,0,1,"dummy"
"127276",1,0,0,1,"dummy"
"127277",0,0,1,1,"dummy"
"127278",0,0,1,1,"dummy"
"127279",0,0,1,1,"dummy"
"127280",0,0,1,1,"dummy"
"127281",0,0,2,2,"dummy"
"127282",3,5,2,10,"dummy"
"127283",0,0,1,1,"dummy"
"127288",0,2,0,2,"dummy"
"127289",0,0,1,1,"dummy"
"127290",2,0,0,2,"dummy"
"127338",0,5,0,5,"dummy"
"127339",0,0,1,1,"dummy"
"127340",0,1,0,1,"dummy"
"127341",0,1,0,1,"dummy"
"127342",1,0,2,3,"dummy"
"127343",0,2,1,3,"dummy"
"127344",0,1,0,1,"dummy"
"127345",0,1,1,2,"dummy"
"127346",0,8,0,8,"dummy"
"127347",3,3,0,6,"dummy"
"127348",6,5,0,11,"dummy"
"127351",0,2,0,2,"dummy"
"127356",0,0,1,1,"dummy"
"127357",0,0,1,1,"dummy"
"127358",0,1,0,1,"dummy"
"127359",0,1,0,1,"dummy"
"127398",3,5,3,11,"dummy"
"127399",2,3,0,5,"dummy"
"127400",3,1,0,4,"dummy"
"127401",0,0,2,2,"dummy"
"127402",3,6,2,11,"dummy"
"127403",0,0,0,0,"dummy"
"127404",1,0,0,1,"dummy"
"127405",0,2,0,2,"dummy"
"127406",2,2,0,4,"dummy"
"127407",0,1,0,1,"dummy"
"127408",2,0,0,2,"dummy"
"127409",1,3,4,8,"dummy"
"127410",0,3,1,4,"dummy"
"127411",1,2,0,3,"dummy"
"127412",1,1,0,2,"dummy"
"127413",2,0,1,3,"dummy"
"127414",1,1,3,5,"dummy"
"127415",2,3,1,6,"dummy"
"127416",7,2,3,12,"dummy"
"127417",1,1,0,2,"dummy"
"127418",0,1,0,1,"dummy"
"127419",0,2,2,4,"dummy"
"127420",0,2,0,2,"dummy"
"127421",0,9,0,9,"dummy"
"127422",0,8,0,8,"dummy"
"127427",0,1,4,5,"dummy"
"127430",0,4,4,8,"dummy"
"127431",0,0,4,4,"dummy"
"127432",0,2,0,2,"dummy"
"127433",0,3,0,3,"dummy"
"127434",0,2,0,2,"dummy"
"127435",3,6,6,15,"dummy"
"127436",0,1,0,1,"dummy"
"127437",0,2,0,2,"dummy"
"127440",2,0,3,5,"dummy"
"127456",0,0,1,1,"dummy"
"127459",5,15,2,22,"dummy"
"127461",0,2,0,2,"dummy"
"127462",0,2,0,2,"dummy"
"127463",0,1,0,1,"dummy"
"127464",0,7,0,7,"dummy"
"127465",0,1,0,1,"dummy"
"127466",6,8,13,27,"dummy"
"127467",2,12,4,18,"dummy"
"127468",0,1,0,1,"dummy"
"127469",10,13,0,23,"dummy"
"127470",3,38,1,42,"dummy"
"127471",1,3,3,7,"dummy"
"127472",0,1,0,1,"dummy"
"127473",0,1,1,2,"dummy"
"127474",0,2,0,2,"dummy"
"127475",0,0,1,1,"dummy"
"127476",0,3,1,4,"dummy"
"127477",0,0,1,1,"dummy"
"127478",0,0,3,3,"dummy"
"127479",0,0,3,3,"dummy"
"127480",0,1,0,1,"dummy"
"127481",19,3,0,22,"dummy"
"127482",22,5,0,27,"dummy"
"127483",3,3,3,9,"dummy"
"127484",0,1,0,1,"dummy"
"127485",1,1,0,2,"dummy"
"127486",1,2,0,3,"dummy"
"127487",0,2,10,12,"dummy"
"127488",0,1,1,2,"dummy"
"127489",0,0,1,1,"dummy"
"127490",10,3,0,13,"dummy"
"127491",2,2,0,4,"dummy"
"127492",8,1,1,10,"dummy"
"127493",6,0,0,6,"dummy"
"127494",2,1,0,3,"dummy"
"127495",5,5,0,10,"dummy"
"127496",0,1,0,1,"dummy"
"127497",0,1,0,1,"dummy"
"127498",0,1,0,1,"dummy"
"127499",2,2,0,4,"dummy"
"127500",0,0,3,3,"dummy"
"127501",3,3,0,6,"dummy"
"127502",5,0,0,5,"dummy"
"127503",0,1,3,4,"dummy"
"127504",2,1,0,3,"dummy"
"127505",0,0,2,2,"dummy"
"127506",0,0,1,1,"dummy"
"127507",1,0,1,2,"dummy"
"127508",0,0,1,1,"dummy"
"127509",0,3,1,4,"dummy"
"127510",0,0,1,1,"dummy"
"127511",2,0,1,3,"dummy"
"127512",0,0,1,1,"dummy"
"127513",6,1,1,8,"dummy"
"127514",1,0,1,2,"dummy"
"127515",0,1,2,3,"dummy"
"127516",1,1,0,2,"dummy"
"127517",0,0,0,0,"dummy"
"127518",0,2,1,3,"dummy"
"127519",0,1,1,2,"dummy"
"127520",0,5,1,6,"dummy"
"127521",0,0,1,1,"dummy"
"127522",0,2,0,2,"dummy"
"127523",0,1,1,2,"dummy"
"127524",0,0,1,1,"dummy"
"127526",0,1,1,2,"dummy"
"127527",0,4,0,4,"dummy"
"127529",0,1,0,1,"dummy"
"127530",1,2,0,3,"dummy"
"127531",0,3,0,3,"dummy"
"127533",0,1,0,1,"dummy"
"127534",0,1,0,1,"dummy"
"127535",0,0,1,1,"dummy"
"127539",0,2,0,2,"dummy"
"127540",0,0,2,2,"dummy"
"127541",0,0,2,2,"dummy"
"127543",0,0,2,2,"dummy"
"127544",6,0,1,7,"dummy"
"127546",15,0,0,15,"dummy"
"127547",0,0,0,0,"dummy"
"127549",0,1,0,1,"dummy"
"127550",0,0,1,1,"dummy"
"127552",0,0,1,1,"dummy"
"127553",0,0,1,1,"dummy"
"127554",0,0,1,1,"dummy"
"127555",0,0,1,1,"dummy"
"127556",0,0,1,1,"dummy"
"127557",0,0,1,1,"dummy"
"127558",0,0,1,1,"dummy"
"127559",0,0,1,1,"dummy"
"127560",0,0,1,1,"dummy"
"127561",0,0,1,1,"dummy"
"127562",0,0,1,1,"dummy"
"127563",0,0,1,1,"dummy"
"127564",0,0,1,1,"dummy"
"127565",0,0,1,1,"dummy"
"127566",0,0,1,1,"dummy"
"127567",0,0,1,1,"dummy"
"127568",0,0,1,1,"dummy"
"127569",0,0,1,1,"dummy"
"127570",0,0,1,1,"dummy"
"127571",0,0,1,1,"dummy"
"127572",0,0,1,1,"dummy"
"127586",0,5,0,5,"dummy"
"127587",0,1,1,2,"dummy"
"127588",5,0,0,5,"dummy"
"127593",0,1,1,2,"dummy"
"127594",0,0,1,1,"dummy"
"127601",0,2,0,2,"dummy"
"127602",0,2,0,2,"dummy"
"127630",0,0,2,2,"dummy"
"127639",0,0,1,1,"dummy"
"127642",0,7,0,7,"dummy"
"127643",0,0,0,0,"dummy"
"127644",0,0,0,0,"dummy"
"127647",0,5,0,5,"dummy"
"127648",0,2,0,2,"dummy"
"127671",0,1,0,1,"dummy"
"127672",0,3,1,4,"dummy"
"127673",11,6,5,22,"dummy"
"127674",1,1,1,3,"dummy"
"127675",0,1,0,1,"dummy"
"127676",0,3,0,3,"dummy"
"127677",0,0,2,2,"dummy"
"127687",0,0,1,1,"dummy"
"127688",1,10,0,11,"dummy"
"127689",12,10,4,26,"dummy"
"127693",9,1,2,12,"dummy"
"127694",1,2,1,4,"dummy"
"127695",0,0,0,0,"dummy"
"127715",12,14,3,29,"dummy"
"127716",0,0,2,2,"dummy"
"127719",1,0,0,1,"dummy"
"127720",2,0,1,3,"dummy"
"127721",0,0,0,0,"dummy"
"127722",0,1,0,1,"dummy"
"127723",8,1,0,9,"dummy"
"127724",0,0,0,0,"dummy"
"127725",0,0,0,0,"dummy"
"127726",1,10,0,11,"dummy"
"127727",7,1,0,8,"dummy"
"127728",2,0,3,5,"dummy"
"127733",0,0,1,1,"dummy"
"127752",0,0,1,1,"dummy"
"127753",0,0,1,1,"dummy"
"127754",0,1,0,1,"dummy"
"127761",1,1,0,2,"dummy"
"127762",0,1,0,1,"dummy"
"127763",0,0,1,1,"dummy"
"127764",0,0,1,1,"dummy"
"127765",0,0,1,1,"dummy"
"127766",0,2,0,2,"dummy"
"127767",0,1,0,1,"dummy"
"127768",0,1,1,2,"dummy"
"127769",0,0,2,2,"dummy"
"127770",2,2,3,7,"dummy"
"127771",0,0,1,1,"dummy"
"127772",0,0,1,1,"dummy"
"127773",0,0,1,1,"dummy"
"127774",0,0,1,1,"dummy"
"127775",0,0,1,1,"dummy"
"127776",0,0,2,2,"dummy"
"127777",2,2,8,12,"dummy"
"127778",0,0,1,1,"dummy"
"127779",0,0,1,1,"dummy"
"127780",0,0,1,1,"dummy"
"127781",0,0,1,1,"dummy"
"127782",0,0,1,1,"dummy"
"127783",0,0,1,1,"dummy"
"127784",0,0,1,1,"dummy"
"127821",5,1,1,7,"dummy"
"127822",0,0,1,1,"dummy"
"127823",0,0,1,1,"dummy"
"127824",0,0,1,1,"dummy"
"127825",0,0,1,1,"dummy"
"127826",0,0,1,1,"dummy"
"127574",0,0,1,1,"dummy"
"127577",0,0,1,1,"dummy"
"127578",0,0,1,1,"dummy"
"127579",1,3,0,4,"dummy"
"127580",2,1,0,3,"dummy"
"127581",0,0,1,1,"dummy"
"127582",0,0,1,1,"dummy"
"127583",0,0,3,3,"dummy"
"127584",0,0,2,2,"dummy"
"127590",0,0,1,1,"dummy"
"127591",0,0,2,2,"dummy"
"127598",0,1,0,1,"dummy"
"127599",0,1,0,1,"dummy"
"127604",15,4,5,24,"dummy"
"127605",3,4,5,12,"dummy"
"127606",0,0,0,0,"dummy"
"127607",0,0,1,1,"dummy"
"127608",1,2,0,3,"dummy"
"127609",1,0,0,1,"dummy"
"127610",0,1,0,1,"dummy"
"127611",0,1,0,1,"dummy"
"127612",6,4,4,14,"dummy"
"127613",4,8,5,17,"dummy"
"127614",1,2,2,5,"dummy"
"127615",0,2,0,2,"dummy"
"127616",12,1,4,17,"dummy"
"127617",0,0,1,1,"dummy"
"127618",0,2,0,2,"dummy"
"127619",0,1,0,1,"dummy"
"127620",0,2,0,2,"dummy"
"127621",0,1,1,2,"dummy"
"127622",0,0,1,1,"dummy"
"127623",0,0,1,1,"dummy"
"127624",0,0,1,1,"dummy"
"127625",2,2,0,4,"dummy"
"127626",1,1,0,2,"dummy"
"127627",1,1,0,2,"dummy"
"127628",0,0,1,1,"dummy"
"127632",0,3,1,4,"dummy"
"127633",7,13,0,20,"dummy"
"127634",0,0,1,1,"dummy"
"127635",2,5,0,7,"dummy"
"127636",0,1,0,1,"dummy"
"127637",1,2,0,3,"dummy"
"127650",0,1,1,2,"dummy"
"127651",0,0,1,1,"dummy"
"127652",1,2,1,4,"dummy"
"127653",32,5,0,37,"dummy"
"127656",0,1,0,1,"dummy"
"127660",1,1,1,3,"dummy"
"127661",0,1,0,1,"dummy"
"127662",0,1,0,1,"dummy"
"127663",0,1,0,1,"dummy"
"127664",1,0,0,1,"dummy"
"127665",2,20,0,22,"dummy"
"127679",0,1,0,1,"dummy"
"127680",0,0,0,0,"dummy"
"127681",0,1,0,1,"dummy"
"127682",3,9,0,12,"dummy"
"127683",0,1,0,1,"dummy"
"127684",5,3,3,11,"dummy"
"127685",2,2,2,6,"dummy"
"127697",2,3,0,5,"dummy"
"127698",0,0,1,1,"dummy"
"127712",0,16,0,16,"dummy"
"127713",2,1,0,3,"dummy"
"127730",0,1,0,1,"dummy"
"127731",1,2,1,4,"dummy"
"127735",17,12,3,32,"dummy"
"127736",22,1,1,24,"dummy"
"127737",6,4,0,10,"dummy"
"127738",0,4,0,4,"dummy"
"127739",9,8,0,17,"dummy"
"127740",9,23,1,33,"dummy"
"127741",0,3,0,3,"dummy"
"127742",1,2,0,3,"dummy"
"127743",1,2,1,4,"dummy"
"127756",0,2,0,2,"dummy"
"127757",1,0,0,1,"dummy"
"127758",0,1,0,1,"dummy"
"127759",0,1,0,1,"dummy"
"127786",0,9,1,10,"dummy"
"127789",5,3,1,9,"dummy"
"127790",8,5,1,14,"dummy"
"127791",0,0,1,1,"dummy"
"127794",0,0,1,1,"dummy"
"127795",0,1,0,1,"dummy"
"127796",0,0,1,1,"dummy"
"127799",1,0,0,1,"dummy"
"127800",2,0,1,3,"dummy"
"127801",0,0,0,0,"dummy"
"127802",0,1,0,1,"dummy"
"127803",8,1,0,9,"dummy"
"127804",0,0,0,0,"dummy"
"127805",0,0,0,0,"dummy"
"127806",1,10,0,11,"dummy"
"127807",7,1,0,8,"dummy"
"127808",2,0,3,5,"dummy"
"127836",7,6,1,14,"dummy"
"127837",6,7,0,13,"dummy"
"127838",0,1,0,1,"dummy"
"127866",0,0,1,1,"dummy"
"127872",0,0,1,1,"dummy"
"127873",6,7,0,13,"dummy"
"127874",7,6,2,15,"dummy"
"127884",17,28,2,47,"dummy"
"127885",4,11,0,15,"dummy"
"127886",0,5,2,7,"dummy"
"127887",0,0,2,2,"dummy"
"127888",1,5,3,9,"dummy"
"127889",4,5,0,9,"dummy"
"127898",0,0,2,2,"dummy"
"127899",1,0,0,1,"dummy"
"127900",0,0,1,1,"dummy"
"127901",0,1,0,1,"dummy"
"127902",5,0,0,5,"dummy"
"127905",2,0,3,5,"dummy"
"127908",0,7,0,7,"dummy"
"127909",0,8,0,8,"dummy"
"127910",0,7,0,7,"dummy"
"127911",5,3,3,11,"dummy"
"127912",0,0,0,0,"dummy"
"127913",0,3,0,3,"dummy"
"127922",0,0,1,1,"dummy"
"127923",0,0,0,0,"dummy"
"127935",0,0,0,0,"dummy"
"127943",0,0,0,0,"dummy"
"127944",0,0,0,0,"dummy"
"127945",0,0,0,0,"dummy"
"127948",1,0,1,2,"dummy"
"127956",0,0,2,2,"dummy"
"127962",0,1,0,1,"dummy"
"127965",0,1,0,1,"dummy"
"127973",0,0,2,2,"dummy"
"127974",0,0,1,1,"dummy"
"128008",0,5,0,5,"dummy"
"128009",1,0,0,1,"dummy"
"128010",0,2,0,2,"dummy"
"128011",0,2,0,2,"dummy"
"127827",0,0,1,1,"dummy"
"127850",10,10,0,20,"dummy"
"127851",0,1,0,1,"dummy"
"127852",2,4,0,6,"dummy"
"127853",0,1,0,1,"dummy"
"127864",0,2,0,2,"dummy"
"127868",0,3,0,3,"dummy"
"127869",0,0,2,2,"dummy"
"127870",9,7,2,18,"dummy"
"127878",0,0,1,1,"dummy"
"127879",0,0,1,1,"dummy"
"127880",0,0,1,1,"dummy"
"127891",0,4,0,4,"dummy"
"127892",0,0,0,0,"dummy"
"127893",0,1,0,1,"dummy"
"127896",1,0,0,1,"dummy"
"127915",0,1,0,1,"dummy"
"127916",0,3,0,3,"dummy"
"127919",0,1,0,1,"dummy"
"127920",1,0,0,1,"dummy"
"127925",1,2,2,5,"dummy"
"127926",0,5,1,6,"dummy"
"127927",2,2,0,4,"dummy"
"127928",0,0,0,0,"dummy"
"127931",4,0,1,5,"dummy"
"127932",2,0,0,2,"dummy"
"127933",0,1,0,1,"dummy"
"127937",0,0,1,1,"dummy"
"127938",0,0,1,1,"dummy"
"127939",0,0,1,1,"dummy"
"127952",0,0,1,1,"dummy"
"127953",0,4,2,6,"dummy"
"127954",2,3,1,6,"dummy"
"127958",0,1,0,1,"dummy"
"127959",4,7,2,13,"dummy"
"127960",0,1,0,1,"dummy"
"127971",2,0,0,2,"dummy"
"128005",1,0,0,1,"dummy"
"128006",0,1,0,1,"dummy"
"128016",1,0,1,2,"dummy"
"128021",2,1,1,4,"dummy"
"128022",0,1,1,2,"dummy"
"128027",0,0,1,1,"dummy"
"128033",2,2,0,4,"dummy"
"128034",0,2,0,2,"dummy"
"128035",0,1,0,1,"dummy"
"128038",0,0,2,2,"dummy"
"128039",0,0,1,1,"dummy"
"128040",2,1,0,3,"dummy"
"128047",0,0,1,1,"dummy"
"128048",0,3,0,3,"dummy"
"128058",1,0,0,1,"dummy"
"128063",2,0,0,2,"dummy"
"128074",0,1,0,1,"dummy"
"128075",0,0,1,1,"dummy"
"128076",1,2,2,5,"dummy"
"128079",2,2,1,5,"dummy"
"128088",2,0,2,4,"dummy"
"128012",2,0,0,2,"dummy"
"128013",0,2,1,3,"dummy"
"128014",4,0,0,4,"dummy"
"128018",0,4,0,4,"dummy"
"128019",0,1,0,1,"dummy"
"128024",4,8,1,13,"dummy"
"128025",9,1,1,11,"dummy"
"128029",5,0,0,5,"dummy"
"128030",0,0,0,0,"dummy"
"128031",0,0,1,1,"dummy"
"128050",0,1,0,1,"dummy"
"128053",0,2,0,2,"dummy"
"128054",1,0,0,1,"dummy"
"128055",0,0,1,1,"dummy"
"128056",0,0,1,1,"dummy"
"128065",0,0,1,1,"dummy"
"128071",2,11,0,13,"dummy"
"128072",0,2,0,2,"dummy"
"128090",0,0,1,1,"dummy"
"128093",0,0,0,0,"dummy"
"128094",0,1,0,1,"dummy"
"128095",2,10,2,14,"dummy"
"128096",0,0,2,2,"dummy"
"128102",0,0,0,0,"dummy"
"128105",1,2,3,6,"dummy"
"128106",19,0,3,22,"dummy"
"128110",0,3,0,3,"dummy"
"128116",0,0,1,1,"dummy"
"128117",0,1,0,1,"dummy"
"128130",1,1,2,4,"dummy"
"128131",3,1,2,6,"dummy"
"128173",0,2,1,3,"dummy"
"128174",0,3,0,3,"dummy"
"128179",36,24,4,64,"dummy"
"128180",2,5,1,8,"dummy"
"128181",0,1,0,1,"dummy"
"128182",0,1,0,1,"dummy"
"128183",31,20,2,53,"dummy"
"128188",2,6,2,10,"dummy"
"128189",0,3,0,3,"dummy"
"128190",1,1,0,2,"dummy"
"128191",0,3,0,3,"dummy"
"128192",0,0,2,2,"dummy"
"128193",2,0,1,3,"dummy"
"128194",0,8,1,9,"dummy"
"128197",0,0,0,0,"dummy"
"128198",0,0,0,0,"dummy"
"128205",0,0,2,2,"dummy"
"128221",0,2,0,2,"dummy"
"128222",0,1,0,1,"dummy"
"128229",1,1,1,3,"dummy"
"128230",0,0,1,1,"dummy"
"128235",0,2,0,2,"dummy"
"128236",3,0,1,4,"dummy"
"128239",0,2,2,4,"dummy"
"128240",1,0,0,1,"dummy"
"128098",2,6,0,8,"dummy"
"128114",11,1,0,12,"dummy"
"128119",2,7,1,10,"dummy"
"128120",0,0,3,3,"dummy"
"128121",0,1,0,1,"dummy"
"128122",1,1,0,2,"dummy"
"128123",0,2,0,2,"dummy"
"128124",1,14,0,15,"dummy"
"128125",0,17,0,17,"dummy"
"128126",0,0,1,1,"dummy"
"128127",17,0,0,17,"dummy"
"128128",0,0,3,3,"dummy"
"128133",0,0,1,1,"dummy"
"128152",0,0,0,0,"dummy"
"128153",1,4,1,6,"dummy"
"128154",8,5,3,16,"dummy"
"128155",2,5,2,9,"dummy"
"128156",0,1,0,1,"dummy"
"128157",3,9,0,12,"dummy"
"128158",14,24,2,40,"dummy"
"128159",0,0,2,2,"dummy"
"128160",0,0,2,2,"dummy"
"128165",0,0,1,1,"dummy"
"128166",0,1,0,1,"dummy"
"128167",0,2,0,2,"dummy"
"128209",0,1,0,1,"dummy"
"128210",0,2,1,3,"dummy"
"128211",0,1,0,1,"dummy"
"128214",0,0,0,0,"dummy"
"128215",0,0,0,0,"dummy"
"128218",26,27,3,56,"dummy"
"128219",3,3,0,6,"dummy"
"128224",0,1,0,1,"dummy"
"128225",0,2,0,2,"dummy"
"128226",0,0,1,1,"dummy"
"128227",0,0,0,0,"dummy"
"128242",1,2,3,6,"dummy"
"128243",0,0,1,1,"dummy"
"128244",2,3,0,5,"dummy"
"128245",1,1,0,2,"dummy"
"128246",16,0,1,17,"dummy"
"128247",0,11,0,11,"dummy"
"128248",1,0,0,1,"dummy"
"128249",0,3,0,3,"dummy"
"128250",0,6,0,6,"dummy"
"128251",0,1,0,1,"dummy"
"128252",0,1,0,1,"dummy"
"128253",0,0,1,1,"dummy"
"128254",0,0,1,1,"dummy"
"128255",0,0,1,1,"dummy"
"128256",0,0,1,1,"dummy"
"128257",0,0,1,1,"dummy"
"128258",0,0,1,1,"dummy"
"128259",5,0,0,5,"dummy"
"128260",0,3,0,3,"dummy"
"128261",0,0,1,1,"dummy"
"128262",0,0,1,1,"dummy"
"128263",0,0,1,1,"dummy"
"128264",0,3,0,3,"dummy"
"128265",0,0,1,1,"dummy"
"128266",0,0,1,1,"dummy"
"128267",0,0,1,1,"dummy"
"128268",0,0,1,1,"dummy"
"128269",0,0,1,1,"dummy"
"128270",0,0,1,1,"dummy"
"128271",0,0,1,1,"dummy"
"128272",1,1,0,2,"dummy"
"128273",1,0,0,1,"dummy"
"128274",0,0,1,1,"dummy"
"128275",0,0,1,1,"dummy"
"128276",0,0,1,1,"dummy"
"128277",0,0,0,0,"dummy"
"128278",0,10,1,11,"dummy"
"128279",0,0,1,1,"dummy"
"128280",0,0,1,1,"dummy"
"128281",0,0,1,1,"dummy"
"128282",1,2,0,3,"dummy"
"128283",0,0,1,1,"dummy"
"128284",1,1,0,2,"dummy"
"128285",5,2,2,9,"dummy"
"128286",0,0,1,1,"dummy"
"128287",0,0,1,1,"dummy"
"128288",0,0,1,1,"dummy"
"128289",0,1,2,3,"dummy"
"128290",0,0,1,1,"dummy"
"128291",2,2,1,5,"dummy"
"128292",0,0,1,1,"dummy"
"128293",0,0,1,1,"dummy"
"128294",0,0,1,1,"dummy"
"128295",0,1,1,2,"dummy"
"128296",0,2,0,2,"dummy"
"128297",0,0,1,1,"dummy"
"128298",0,0,1,1,"dummy"
"128299",1,2,0,3,"dummy"
"128300",4,1,0,5,"dummy"
"128301",0,2,0,2,"dummy"
"128302",0,0,1,1,"dummy"
"128303",0,1,0,1,"dummy"
"128304",0,0,1,1,"dummy"
"128305",0,0,1,1,"dummy"
"128306",1,1,0,2,"dummy"
"128307",1,1,0,2,"dummy"
"128405",0,0,1,1,"dummy"
"128332",0,1,0,1,"dummy"
"128334",0,2,0,2,"dummy"
"128335",0,1,0,1,"dummy"
"128337",2,0,0,2,"dummy"
"128338",0,0,1,1,"dummy"
"128343",0,0,1,1,"dummy"
"128344",0,1,0,1,"dummy"
"128345",1,0,0,1,"dummy"
"128346",0,0,1,1,"dummy"
"128347",0,0,3,3,"dummy"
"128350",0,0,1,1,"dummy"
"128351",5,4,3,12,"dummy"
"128352",2,8,2,12,"dummy"
"128353",0,4,0,4,"dummy"
"128354",5,7,2,14,"dummy"
"128355",0,4,0,4,"dummy"
"128356",2,0,0,2,"dummy"
"128357",0,0,4,4,"dummy"
"128359",0,0,1,1,"dummy"
"128362",0,1,0,1,"dummy"
"128364",0,1,0,1,"dummy"
"128365",1,0,0,1,"dummy"
"128367",0,1,0,1,"dummy"
"128368",1,2,1,4,"dummy"
"128369",2,1,3,6,"dummy"
"128370",0,1,0,1,"dummy"
"128372",0,3,0,3,"dummy"
"128374",0,5,0,5,"dummy"
"128375",0,2,0,2,"dummy"
"128376",0,1,0,1,"dummy"
"128377",0,0,2,2,"dummy"
"128379",5,12,5,22,"dummy"
"128380",13,12,12,37,"dummy"
"128381",4,7,0,11,"dummy"
"128382",16,7,5,28,"dummy"
"128383",4,10,2,16,"dummy"
"128384",0,0,1,1,"dummy"
"128387",0,5,1,6,"dummy"
"128388",6,2,1,9,"dummy"
"128392",1,3,0,4,"dummy"
"128393",1,1,0,2,"dummy"
"128394",3,5,2,10,"dummy"
"128395",0,5,1,6,"dummy"
"128396",3,3,2,8,"dummy"
"128398",0,0,0,0,"dummy"
"128399",2,0,0,2,"dummy"
"128400",2,1,0,3,"dummy"
"128401",0,2,0,2,"dummy"
"128402",3,0,0,3,"dummy"
"128403",0,0,0,0,"dummy"
"128404",2,0,0,2,"dummy"
"128406",0,0,1,1,"dummy"
"128407",1,0,0,1,"dummy"
"128410",2,4,0,6,"dummy"
"128411",0,2,0,2,"dummy"
"128412",0,2,0,2,"dummy"
"128413",10,2,0,12,"dummy"
"128414",0,2,0,2,"dummy"
"128415",0,0,0,0,"dummy"
"128416",0,0,3,3,"dummy"
"128417",0,5,0,5,"dummy"
"128418",1,0,1,2,"dummy"
"128422",0,0,1,1,"dummy"
"128425",3,3,0,6,"dummy"
"128426",3,3,0,6,"dummy"
"128427",9,3,1,13,"dummy"
"128428",0,17,2,19,"dummy"
"128429",0,6,0,6,"dummy"
"128430",6,2,4,12,"dummy"
"128431",4,5,3,12,"dummy"
"128432",2,0,0,2,"dummy"
"128433",0,0,1,1,"dummy"
"128434",0,0,0,0,"dummy"
"128435",0,0,1,1,"dummy"
"128436",0,2,0,2,"dummy"
"128437",2,0,0,2,"dummy"
"128439",0,0,2,2,"dummy"
"128440",0,0,2,2,"dummy"
"128442",5,5,0,10,"dummy"
"128443",2,0,0,2,"dummy"
"128445",0,8,0,8,"dummy"
"128446",2,3,0,5,"dummy"
"128449",3,0,0,3,"dummy"
"128450",0,2,0,2,"dummy"
"128451",0,1,1,2,"dummy"
"128452",0,1,0,1,"dummy"
"128453",0,0,1,1,"dummy"
"128455",0,0,1,1,"dummy"
"128460",3,1,0,4,"dummy"
"128461",0,1,0,1,"dummy"
"128462",3,4,0,7,"dummy"
"128463",0,3,0,3,"dummy"
"128464",1,4,0,5,"dummy"
"128465",0,0,1,1,"dummy"
"128466",0,0,1,1,"dummy"
"128467",3,1,0,4,"dummy"
"128471",2,0,3,5,"dummy"
"128472",1,0,0,1,"dummy"
"128473",0,1,0,1,"dummy"
"128474",0,1,1,2,"dummy"
"128477",0,1,0,1,"dummy"
"128478",9,11,0,20,"dummy"
"128479",0,1,0,1,"dummy"
"128480",0,0,3,3,"dummy"
"128482",3,0,0,3,"dummy"
"128483",0,0,1,1,"dummy"
"128487",0,0,0,0,"dummy"
"128490",2,6,2,10,"dummy"
"128492",0,0,1,1,"dummy"
"128493",0,0,1,1,"dummy"
"128494",0,1,0,1,"dummy"
"128495",0,1,0,1,"dummy"
"128496",1,1,1,3,"dummy"
"128497",4,7,1,12,"dummy"
"128498",6,1,5,12,"dummy"
"128499",0,5,2,7,"dummy"
"128500",0,0,1,1,"dummy"
"128501",0,0,1,1,"dummy"
"128502",0,0,1,1,"dummy"
"128504",6,0,4,10,"dummy"
"128505",0,2,0,2,"dummy"
"128506",0,3,0,3,"dummy"
"128507",0,7,0,7,"dummy"
"128508",0,5,0,5,"dummy"
"128509",0,2,0,2,"dummy"
"128510",0,1,0,1,"dummy"
"128511",0,2,0,2,"dummy"
"128512",1,2,0,3,"dummy"
"128513",11,8,6,25,"dummy"
"128514",0,2,0,2,"dummy"
"128516",0,0,2,2,"dummy"
"128517",0,0,0,0,"dummy"
"128518",0,1,0,1,"dummy"
"128519",2,0,2,4,"dummy"
"128520",0,0,2,2,"dummy"
"128521",0,1,0,1,"dummy"
"128522",0,1,0,1,"dummy"
"128525",0,1,2,3,"dummy"
"128526",0,0,0,0,"dummy"
"128527",0,1,0,1,"dummy"
"128528",4,0,2,6,"dummy"
"128529",1,0,0,1,"dummy"
"128530",0,0,0,0,"dummy"
"128531",0,0,0,0,"dummy"
"128534",0,1,0,1,"dummy"
"128535",0,0,1,1,"dummy"
"128536",0,0,2,2,"dummy"
"128539",3,3,3,9,"dummy"
"128540",1,8,1,10,"dummy"
"128541",12,1,4,17,"dummy"
"128542",0,0,2,2,"dummy"
"128546",5,12,3,20,"dummy"
"128547",1,0,0,1,"dummy"
"128550",0,0,0,0,"dummy"
"128551",0,2,0,2,"dummy"
"128552",0,0,0,0,"dummy"
"128553",0,1,0,1,"dummy"
"128556",1,5,0,6,"dummy"
"128557",3,4,1,8,"dummy"
"128558",1,4,1,6,"dummy"
"128560",0,0,0,0,"dummy"
"128561",0,0,0,0,"dummy"
"128562",0,0,0,0,"dummy"
"128563",0,0,0,0,"dummy"
"128565",0,2,0,2,"dummy"
"128567",0,7,4,11,"dummy"
"128570",0,1,0,1,"dummy"
"128571",0,1,0,1,"dummy"
"128572",0,0,1,1,"dummy"
"128573",5,0,1,6,"dummy"
"128574",0,5,0,5,"dummy"
"128575",0,1,0,1,"dummy"
"128576",0,13,1,14,"dummy"
"128577",0,2,1,3,"dummy"
"128578",1,2,0,3,"dummy"
"128579",6,6,0,12,"dummy"
"128580",1,2,0,3,"dummy"
"128581",1,3,0,4,"dummy"
"128582",9,1,1,11,"dummy"
"128583",13,1,0,14,"dummy"
"128584",1,7,0,8,"dummy"
"128585",2,1,0,3,"dummy"
"128586",0,1,0,1,"dummy"
"128587",1,1,0,2,"dummy"
"128588",2,0,0,2,"dummy"
"128589",0,2,0,2,"dummy"
"128590",3,0,0,3,"dummy"
"128591",0,0,1,1,"dummy"
"128592",3,0,0,3,"dummy"
"128593",0,1,0,1,"dummy"
"128594",2,1,2,5,"dummy"
"128595",3,5,1,9,"dummy"
"128596",1,20,1,22,"dummy"
"128597",14,4,1,19,"dummy"
"128598",1,15,2,18,"dummy"
"128599",3,3,1,7,"dummy"
"128600",0,0,1,1,"dummy"
"128602",0,0,1,1,"dummy"
"128603",0,0,0,0,"dummy"
"128606",8,2,0,10,"dummy"
"128607",2,2,0,4,"dummy"
"128608",0,3,0,3,"dummy"
"128610",0,3,1,4,"dummy"
"128612",0,0,1,1,"dummy"
"128615",5,8,4,17,"dummy"
"128616",1,3,1,5,"dummy"
"128617",0,0,0,0,"dummy"
"128618",1,1,0,2,"dummy"
"128619",3,2,1,6,"dummy"
"128620",5,0,3,8,"dummy"
"128621",1,0,1,2,"dummy"
"128622",0,0,1,1,"dummy"
"128623",0,0,1,1,"dummy"
"128630",4,4,0,8,"dummy"
"128631",1,2,0,3,"dummy"
"128632",0,1,0,1,"dummy"
"128633",0,5,0,5,"dummy"
"128634",0,0,2,2,"dummy"
"128635",0,0,1,1,"dummy"
"128637",2,2,3,7,"dummy"
"128638",0,0,3,3,"dummy"
"128639",0,0,3,3,"dummy"
"128640",0,0,3,3,"dummy"
"128641",0,0,3,3,"dummy"
"128642",0,0,3,3,"dummy"
"128645",0,0,0,0,"dummy"
"128646",10,2,3,15,"dummy"
"128647",12,1,1,14,"dummy"
"128648",3,22,4,29,"dummy"
"128649",22,4,2,28,"dummy"
"128650",0,0,2,2,"dummy"
"128653",10,5,2,17,"dummy"
"128654",0,0,1,1,"dummy"
"128655",0,1,0,1,"dummy"
"128656",1,0,1,2,"dummy"
"128658",0,1,0,1,"dummy"
"128659",1,7,1,9,"dummy"
"128660",5,6,0,11,"dummy"
"128661",5,2,0,7,"dummy"
"128662",0,1,1,2,"dummy"
"128663",2,0,0,2,"dummy"
"128665",0,0,0,0,"dummy"
"128667",5,4,1,10,"dummy"
"128668",0,0,1,1,"dummy"
"128669",0,0,4,4,"dummy"
"128670",2,6,1,9,"dummy"
"128672",0,2,0,2,"dummy"
"128673",0,0,1,1,"dummy"
"128674",0,0,2,2,"dummy"
"128676",0,0,1,1,"dummy"
"128677",0,0,1,1,"dummy"
"128678",1,0,0,1,"dummy"
"128679",0,0,1,1,"dummy"
"128680",0,0,3,3,"dummy"
"128681",5,5,0,10,"dummy"
"128682",0,0,0,0,"dummy"
"128683",7,4,0,11,"dummy"
"128684",1,3,0,4,"dummy"
"128685",0,0,1,1,"dummy"
"128686",7,1,0,8,"dummy"
"128687",0,0,0,0,"dummy"
"128688",6,8,2,16,"dummy"
"128689",0,0,0,0,"dummy"
"128690",0,0,1,1,"dummy"
"128691",0,0,0,0,"dummy"
"128692",0,0,1,1,"dummy"
"128693",8,6,0,14,"dummy"
"128694",12,12,0,24,"dummy"
"128695",0,0,0,0,"dummy"
"128696",0,1,0,1,"dummy"
"128697",17,17,0,34,"dummy"
"128698",0,0,0,0,"dummy"
"128699",0,0,0,0,"dummy"
"128700",0,0,0,0,"dummy"
"128701",0,3,1,4,"dummy"
"128729",0,0,0,0,"dummy"
"128730",0,0,0,0,"dummy"
"128735",0,0,1,1,"dummy"
"128736",0,2,0,2,"dummy"
"128738",2,2,0,4,"dummy"
"128741",0,0,1,1,"dummy"
"128742",0,1,0,1,"dummy"
"128744",2,2,1,5,"dummy"
"128751",0,0,1,1,"dummy"
"128760",0,0,1,1,"dummy"
"128794",1,2,1,4,"dummy"
"128795",1,0,0,1,"dummy"
"128797",0,0,0,0,"dummy"
"128798",0,0,0,0,"dummy"
"128801",0,0,1,1,"dummy"
"128802",0,0,1,1,"dummy"
"128803",0,1,0,1,"dummy"
"128805",0,0,1,1,"dummy"
"128806",0,0,0,0,"dummy"
"128807",3,9,1,13,"dummy"
"128808",0,0,0,0,"dummy"
"128811",0,0,2,2,"dummy"
"128813",21,22,4,47,"dummy"
"128814",0,1,0,1,"dummy"
"128815",0,2,0,2,"dummy"
"128816",27,4,2,33,"dummy"
"128817",2,4,2,8,"dummy"
"128818",0,0,1,1,"dummy"
"128819",0,0,1,1,"dummy"
"128820",0,0,1,1,"dummy"
"128821",4,2,2,8,"dummy"
"128823",0,0,1,1,"dummy"
"128824",0,0,0,0,"dummy"
"128826",0,0,1,1,"dummy"
"128827",0,1,0,1,"dummy"
"128828",0,0,1,1,"dummy"
"128829",0,0,2,2,"dummy"
"128831",0,1,0,1,"dummy"
"128832",8,0,0,8,"dummy"
"128833",0,0,1,1,"dummy"
"128834",0,0,1,1,"dummy"
"128835",1,0,0,1,"dummy"
"128836",0,2,0,2,"dummy"
"128837",3,1,1,5,"dummy"
"128838",3,4,1,8,"dummy"
"128857",0,0,0,0,"dummy"
"128858",0,0,1,1,"dummy"
"128859",0,0,1,1,"dummy"
"128860",0,0,1,1,"dummy"
"128861",17,6,4,27,"dummy"
"128862",0,0,1,1,"dummy"
"128863",0,0,1,1,"dummy"
"128875",0,0,0,0,"dummy"
"128876",0,0,0,0,"dummy"
"128878",0,1,0,1,"dummy"
"128880",0,3,1,4,"dummy"
"128882",0,2,2,4,"dummy"
"128884",0,3,1,4,"dummy"
"128887",0,1,0,1,"dummy"
"128890",0,2,0,2,"dummy"
"128891",1,10,1,12,"dummy"
"128892",1,1,0,2,"dummy"
"128893",0,1,0,1,"dummy"
"128894",7,2,0,9,"dummy"
"128895",0,1,0,1,"dummy"
"128896",0,0,1,1,"dummy"
"128897",0,0,2,2,"dummy"
"128901",0,2,0,2,"dummy"
"128902",0,1,0,1,"dummy"
"128906",0,1,0,1,"dummy"
"128907",0,1,0,1,"dummy"
"128908",4,1,2,7,"dummy"
"128909",1,0,1,2,"dummy"
"128910",0,3,1,4,"dummy"
"128913",6,7,8,21,"dummy"
"128914",2,1,3,6,"dummy"
"128915",0,3,0,3,"dummy"
"128916",1,1,0,2,"dummy"
"128917",5,1,6,12,"dummy"
"128918",1,1,0,2,"dummy"
"128919",0,0,1,1,"dummy"
"128948",0,0,2,2,"dummy"
"128949",0,1,0,1,"dummy"
"128950",0,0,2,2,"dummy"
"128951",0,4,0,4,"dummy"
"128952",0,0,1,1,"dummy"
"128953",0,0,1,1,"dummy"
"128954",0,0,2,2,"dummy"
"128955",0,0,2,2,"dummy"
"128956",0,0,2,2,"dummy"
"128962",0,0,1,1,"dummy"
"128963",0,0,0,0,"dummy"
"128984",0,0,1,1,"dummy"
"128985",14,5,2,21,"dummy"
"128997",0,0,1,1,"dummy"
"128998",0,0,1,1,"dummy"
"128999",0,0,1,1,"dummy"
"129000",0,0,1,1,"dummy"
"129001",0,1,0,1,"dummy"
"129002",0,3,1,4,"dummy"
"129003",1,3,0,4,"dummy"
"129015",0,0,0,0,"dummy"
"129016",0,0,1,1,"dummy"
"129017",3,0,0,3,"dummy"
"129018",0,1,0,1,"dummy"
"129019",1,0,1,2,"dummy"
"129020",0,1,0,1,"dummy"
"129021",0,0,0,0,"dummy"
"129022",2,1,0,3,"dummy"
"129023",1,0,0,1,"dummy"
"129024",0,0,0,0,"dummy"
"129025",0,0,0,0,"dummy"
"129055",0,1,0,1,"dummy"
"129056",0,0,1,1,"dummy"
"129063",0,0,1,1,"dummy"
"129064",0,0,1,1,"dummy"
"129065",2,0,0,2,"dummy"
"129066",0,2,0,2,"dummy"
"129067",0,0,1,1,"dummy"
"129068",0,2,1,3,"dummy"
"129076",2,4,0,6,"dummy"
"129077",0,2,0,2,"dummy"
"129078",0,2,0,2,"dummy"
"129079",10,2,0,12,"dummy"
"129080",0,2,0,2,"dummy"
"129081",0,0,0,0,"dummy"
"129082",3,3,8,14,"dummy"
"129083",0,1,0,1,"dummy"
"129084",1,0,1,2,"dummy"
"129085",2,3,2,7,"dummy"
"129086",3,3,1,7,"dummy"
"129087",0,2,1,3,"dummy"
"129088",0,0,1,1,"dummy"
"129089",0,0,1,1,"dummy"
"129090",0,0,1,1,"dummy"
"129091",0,1,1,2,"dummy"
"129092",0,0,1,1,"dummy"
"129093",0,0,1,1,"dummy"
"129094",3,2,2,7,"dummy"
"129119",3,7,1,11,"dummy"
"129120",0,0,5,5,"dummy"
"129121",0,0,1,1,"dummy"
"129122",0,0,1,1,"dummy"
"129123",0,1,0,1,"dummy"
"129124",1,0,0,1,"dummy"
"129125",0,1,0,1,"dummy"
"129126",0,0,0,0,"dummy"
"129127",0,0,0,0,"dummy"
"129128",9,9,1,19,"dummy"
"129129",0,6,0,6,"dummy"
"129130",0,2,0,2,"dummy"
"129131",0,1,0,1,"dummy"
"129132",0,1,0,1,"dummy"
"129133",1,0,0,1,"dummy"
"129134",1,0,0,1,"dummy"
"129135",2,0,0,2,"dummy"
"129136",3,0,0,3,"dummy"
"129137",0,0,0,0,"dummy"
"129138",0,0,0,0,"dummy"
"128921",2,29,4,35,"dummy"
"128922",4,0,0,4,"dummy"
"128923",0,18,0,18,"dummy"
"128924",0,2,0,2,"dummy"
"128925",0,1,0,1,"dummy"
"128926",0,1,1,2,"dummy"
"128927",0,2,0,2,"dummy"
"128928",13,22,5,40,"dummy"
"128929",0,1,0,1,"dummy"
"128930",32,32,5,69,"dummy"
"128931",0,1,1,2,"dummy"
"128932",0,1,0,1,"dummy"
"128933",4,4,2,10,"dummy"
"128934",19,30,3,52,"dummy"
"128935",11,15,0,26,"dummy"
"128936",1,2,0,3,"dummy"
"128937",0,0,3,3,"dummy"
"128938",0,1,0,1,"dummy"
"128939",0,0,2,2,"dummy"
"128940",0,0,0,0,"dummy"
"128941",0,0,0,0,"dummy"
"128942",8,0,0,8,"dummy"
"128943",0,1,0,1,"dummy"
"128944",9,13,4,26,"dummy"
"128945",0,0,0,0,"dummy"
"128946",1,0,0,1,"dummy"
"128960",0,1,0,1,"dummy"
"128987",0,2,0,2,"dummy"
"128988",0,1,0,1,"dummy"
"128989",0,2,0,2,"dummy"
"128990",0,0,1,1,"dummy"
"128991",1,0,0,1,"dummy"
"128992",1,0,0,1,"dummy"
"128993",1,12,0,13,"dummy"
"128994",0,0,0,0,"dummy"
"128995",8,16,2,26,"dummy"
"129007",1,4,0,5,"dummy"
"129010",0,0,0,0,"dummy"
"129011",0,0,0,0,"dummy"
"129027",0,11,1,12,"dummy"
"129030",1,5,1,7,"dummy"
"129031",0,16,1,17,"dummy"
"129032",0,3,1,4,"dummy"
"129039",15,10,0,25,"dummy"
"129040",5,5,4,14,"dummy"
"129041",4,7,0,11,"dummy"
"129042",4,1,0,5,"dummy"
"129043",0,4,0,4,"dummy"
"129044",0,1,1,2,"dummy"
"129045",0,2,2,4,"dummy"
"129046",0,1,0,1,"dummy"
"129047",1,1,0,2,"dummy"
"129048",3,0,2,5,"dummy"
"129049",1,0,0,1,"dummy"
"129050",0,1,0,1,"dummy"
"129051",18,16,8,42,"dummy"
"129058",0,0,0,0,"dummy"
"129059",0,1,0,1,"dummy"
"129060",0,0,1,1,"dummy"
"129061",0,0,1,1,"dummy"
"129072",0,2,1,3,"dummy"
"129073",3,2,3,8,"dummy"
"129074",1,2,0,3,"dummy"
"129103",3,20,0,23,"dummy"
"129108",2,5,0,7,"dummy"
"129109",3,1,0,4,"dummy"
"129110",2,0,0,2,"dummy"
"129111",0,2,0,2,"dummy"
"129112",0,1,0,1,"dummy"
"129113",0,3,0,3,"dummy"
"129114",0,7,0,7,"dummy"
"129115",0,3,2,5,"dummy"
"129116",0,1,1,2,"dummy"
"129117",0,0,2,2,"dummy"
"129142",0,0,1,1,"dummy"
"129143",0,1,0,1,"dummy"
"129144",0,1,1,2,"dummy"
"129149",0,1,0,1,"dummy"
"129150",4,2,3,9,"dummy"
"129169",0,0,1,1,"dummy"
"129170",0,0,1,1,"dummy"
"129171",0,0,1,1,"dummy"
"129172",6,20,1,27,"dummy"
"129139",0,0,0,0,"dummy"
"129140",0,0,0,0,"dummy"
"129163",1,1,0,2,"dummy"
"129164",11,0,0,11,"dummy"
"129165",2,14,1,17,"dummy"
"129166",13,12,4,29,"dummy"
"129167",1,1,1,3,"dummy"
"129188",0,0,4,4,"dummy"
"129189",0,1,0,1,"dummy"
"129190",0,0,2,2,"dummy"
"129191",0,0,1,1,"dummy"
"129192",3,0,0,3,"dummy"
"129193",0,4,0,4,"dummy"
"129194",0,0,1,1,"dummy"
"129195",1,1,0,2,"dummy"
"129196",0,3,0,3,"dummy"
"129197",0,1,0,1,"dummy"
"129198",2,1,1,4,"dummy"
"129199",1,0,1,2,"dummy"
"129219",0,0,1,1,"dummy"
"129220",0,3,1,4,"dummy"
"129221",0,0,2,2,"dummy"
"129222",0,1,1,2,"dummy"
"129223",0,0,1,1,"dummy"
"129229",0,0,1,1,"dummy"
"129230",6,8,1,15,"dummy"
"129251",1,3,1,5,"dummy"
"129252",1,2,0,3,"dummy"
"129259",5,2,1,8,"dummy"
"129260",5,3,0,8,"dummy"
"129264",0,0,1,1,"dummy"
"129265",3,0,0,3,"dummy"
"129283",2,1,0,3,"dummy"
"129286",0,1,0,1,"dummy"
"129294",0,1,0,1,"dummy"
"129307",0,0,0,0,"dummy"
"129334",0,1,0,1,"dummy"
"129335",1,0,0,1,"dummy"
"129336",0,0,0,0,"dummy"
"129337",0,2,0,2,"dummy"
"129338",1,0,0,1,"dummy"
"129342",4,2,1,7,"dummy"
"129343",0,0,0,0,"dummy"
"129348",0,1,0,1,"dummy"
"129349",0,0,0,0,"dummy"
"129350",0,1,0,1,"dummy"
"129351",1,1,0,2,"dummy"
"129352",0,1,0,1,"dummy"
"129353",0,0,1,1,"dummy"
"129356",2,0,3,5,"dummy"
"129357",0,0,2,2,"dummy"
"129358",0,7,0,7,"dummy"
"129375",0,1,1,2,"dummy"
"129380",0,2,1,3,"dummy"
"129381",0,1,0,1,"dummy"
"129382",1,4,1,6,"dummy"
"129383",2,2,0,4,"dummy"
"129384",0,1,1,2,"dummy"
"129385",0,0,1,1,"dummy"
"129386",0,0,1,1,"dummy"
"129387",0,0,1,1,"dummy"
"129388",1,1,2,4,"dummy"
"129389",5,12,2,19,"dummy"
"129390",0,0,2,2,"dummy"
"129391",0,2,1,3,"dummy"
"129392",0,1,1,2,"dummy"
"129398",0,0,1,1,"dummy"
"129411",0,0,0,0,"dummy"
"129412",5,0,2,7,"dummy"
"129173",6,2,1,9,"dummy"
"129174",7,6,1,14,"dummy"
"129175",1,0,0,1,"dummy"
"129176",0,0,0,0,"dummy"
"129177",9,4,1,14,"dummy"
"129178",0,0,3,3,"dummy"
"129179",0,1,0,1,"dummy"
"129180",2,2,0,4,"dummy"
"129183",1,2,0,3,"dummy"
"129184",0,4,0,4,"dummy"
"129185",0,1,1,2,"dummy"
"129186",2,5,1,8,"dummy"
"129203",0,3,0,3,"dummy"
"129204",24,20,2,46,"dummy"
"129205",0,1,0,1,"dummy"
"129206",1,3,7,11,"dummy"
"129207",0,0,1,1,"dummy"
"129208",1,6,5,12,"dummy"
"129209",0,1,0,1,"dummy"
"129210",1,2,1,4,"dummy"
"129211",0,1,0,1,"dummy"
"129212",0,1,0,1,"dummy"
"129213",6,5,0,11,"dummy"
"129214",0,3,2,5,"dummy"
"129215",0,1,0,1,"dummy"
"129216",0,2,0,2,"dummy"
"129217",0,1,0,1,"dummy"
"129225",0,1,0,1,"dummy"
"129226",0,0,0,0,"dummy"
"129227",6,3,1,10,"dummy"
"129232",2,0,0,2,"dummy"
"129233",0,1,0,1,"dummy"
"129234",1,0,3,4,"dummy"
"129237",1,14,0,15,"dummy"
"129240",0,0,0,0,"dummy"
"129241",0,0,1,1,"dummy"
"129242",4,8,0,12,"dummy"
"129243",1,1,0,2,"dummy"
"129244",8,3,0,11,"dummy"
"129245",0,0,1,1,"dummy"
"129246",0,1,0,1,"dummy"
"129247",0,2,0,2,"dummy"
"129254",5,6,0,11,"dummy"
"129255",0,0,0,0,"dummy"
"129256",0,2,0,2,"dummy"
"129257",1,3,1,5,"dummy"
"129262",0,0,1,1,"dummy"
"129269",0,0,2,2,"dummy"
"129270",0,1,0,1,"dummy"
"129271",0,0,1,1,"dummy"
"129274",0,1,0,1,"dummy"
"129275",0,1,0,1,"dummy"
"129276",0,0,1,1,"dummy"
"129277",0,2,1,3,"dummy"
"129278",0,0,2,2,"dummy"
"129279",0,8,2,10,"dummy"
"129280",0,0,0,0,"dummy"
"129281",8,7,0,15,"dummy"
"129288",0,18,4,22,"dummy"
"129289",0,1,0,1,"dummy"
"129290",0,0,1,1,"dummy"
"129291",0,2,1,3,"dummy"
"129292",0,0,1,1,"dummy"
"129296",5,1,0,6,"dummy"
"129305",5,5,0,10,"dummy"
"129309",0,2,0,2,"dummy"
"129312",0,5,0,5,"dummy"
"129329",0,1,0,1,"dummy"
"129330",2,2,1,5,"dummy"
"129331",1,1,0,2,"dummy"
"129332",4,2,2,8,"dummy"
"129340",0,0,1,1,"dummy"
"129369",0,0,1,1,"dummy"
"129370",0,0,0,0,"dummy"
"129371",0,0,0,0,"dummy"
"129377",2,0,0,2,"dummy"
"129378",0,0,0,0,"dummy"
"129394",0,0,0,0,"dummy"
"129395",5,0,2,7,"dummy"
"129396",0,0,0,0,"dummy"
"129402",0,0,0,0,"dummy"
"129403",0,0,1,1,"dummy"
"129404",3,2,0,5,"dummy"
"129405",0,0,1,1,"dummy"
"129406",0,1,0,1,"dummy"
"129407",0,2,0,2,"dummy"
"129415",0,1,0,1,"dummy"
"129416",0,1,1,2,"dummy"
"129417",0,1,0,1,"dummy"
"129418",0,1,0,1,"dummy"
"129422",1,1,0,2,"dummy"
"129426",0,0,1,1,"dummy"
"129429",1,0,0,1,"dummy"
"129430",0,1,0,1,"dummy"
"129438",0,0,2,2,"dummy"
"129441",0,0,2,2,"dummy"
"129442",5,5,2,12,"dummy"
"129480",0,1,0,1,"dummy"
"129481",0,0,1,1,"dummy"
"129482",0,2,0,2,"dummy"
"129483",0,5,0,5,"dummy"
"129491",1,5,0,6,"dummy"
"129506",0,1,0,1,"dummy"
"129509",2,4,0,6,"dummy"
"129510",0,2,0,2,"dummy"
"129511",0,2,0,2,"dummy"
"129512",10,2,0,12,"dummy"
"129513",0,2,0,2,"dummy"
"129514",0,0,0,0,"dummy"
"129515",0,0,3,3,"dummy"
"129516",0,5,0,5,"dummy"
"129517",1,0,1,2,"dummy"
"129530",0,0,0,0,"dummy"
"129531",0,0,0,0,"dummy"
"129532",0,0,0,0,"dummy"
"129543",0,2,0,2,"dummy"
"129544",2,2,3,7,"dummy"
"129548",2,5,0,7,"dummy"
"129549",0,0,1,1,"dummy"
"129558",0,0,1,1,"dummy"
"129561",2,0,1,3,"dummy"
"129565",0,3,0,3,"dummy"
"129566",0,6,1,7,"dummy"
"129567",1,2,1,4,"dummy"
"129568",2,2,2,6,"dummy"
"129573",0,1,0,1,"dummy"
"129576",0,0,0,0,"dummy"
"129577",0,0,1,1,"dummy"
"129578",0,0,1,1,"dummy"
"129597",0,0,1,1,"dummy"
"129598",0,1,0,1,"dummy"
"129599",0,0,0,0,"dummy"
"129600",1,4,4,9,"dummy"
"129601",2,4,1,7,"dummy"
"129602",0,0,1,1,"dummy"
"129639",0,0,2,2,"dummy"
"129640",2,0,1,3,"dummy"
"129641",0,0,1,1,"dummy"
"129642",4,1,0,5,"dummy"
"129413",0,0,0,0,"dummy"
"129420",0,0,0,0,"dummy"
"129424",0,0,1,1,"dummy"
"129432",0,0,2,2,"dummy"
"129435",0,0,0,0,"dummy"
"129436",0,0,0,0,"dummy"
"129444",10,15,1,26,"dummy"
"129445",2,1,1,4,"dummy"
"129446",0,0,1,1,"dummy"
"129447",0,8,0,8,"dummy"
"129448",4,4,0,8,"dummy"
"129449",0,6,3,9,"dummy"
"129450",10,1,3,14,"dummy"
"129451",14,10,3,27,"dummy"
"129452",5,18,1,24,"dummy"
"129453",18,5,5,28,"dummy"
"129454",6,17,6,29,"dummy"
"129455",17,5,5,27,"dummy"
"129456",5,19,5,29,"dummy"
"129457",2,3,1,6,"dummy"
"129458",6,1,0,7,"dummy"
"129459",1,0,1,2,"dummy"
"129460",0,3,0,3,"dummy"
"129461",0,1,0,1,"dummy"
"129462",18,8,2,28,"dummy"
"129463",0,2,0,2,"dummy"
"129464",1,1,1,3,"dummy"
"129465",5,6,5,16,"dummy"
"129466",3,1,1,5,"dummy"
"129467",0,0,0,0,"dummy"
"129468",0,0,1,1,"dummy"
"129469",1,0,1,2,"dummy"
"129470",0,1,0,1,"dummy"
"129471",1,0,0,1,"dummy"
"129474",0,1,0,1,"dummy"
"129475",0,0,0,0,"dummy"
"129476",0,0,1,1,"dummy"
"129477",0,1,0,1,"dummy"
"129478",0,1,0,1,"dummy"
"129525",0,1,0,1,"dummy"
"129526",3,3,5,11,"dummy"
"129527",0,0,1,1,"dummy"
"129528",0,2,0,2,"dummy"
"129534",4,7,1,12,"dummy"
"129535",15,8,1,24,"dummy"
"129536",0,0,1,1,"dummy"
"129537",0,1,0,1,"dummy"
"129538",0,1,0,1,"dummy"
"129539",0,0,1,1,"dummy"
"129540",2,4,5,11,"dummy"
"129541",0,1,1,2,"dummy"
"129546",0,3,0,3,"dummy"
"129582",0,0,1,1,"dummy"
"129583",4,0,1,5,"dummy"
"129591",4,0,1,5,"dummy"
"129592",7,0,1,8,"dummy"
"129593",0,0,0,0,"dummy"
"129594",6,1,1,8,"dummy"
"129595",0,0,1,1,"dummy"
"129607",0,2,0,2,"dummy"
"129608",2,7,1,10,"dummy"
"129609",0,4,0,4,"dummy"
"129610",0,2,0,2,"dummy"
"129611",1,2,0,3,"dummy"
"129612",1,3,0,4,"dummy"
"129615",24,9,8,41,"dummy"
"129616",18,9,1,28,"dummy"
"129617",0,0,1,1,"dummy"
"129636",0,1,0,1,"dummy"
"129637",0,3,1,4,"dummy"
"129643",0,0,1,1,"dummy"
"129644",0,6,0,6,"dummy"
"129645",1,0,1,2,"dummy"
"129656",1,3,0,4,"dummy"
"129657",0,1,1,2,"dummy"
"129658",0,1,0,1,"dummy"
"129659",0,1,1,2,"dummy"
"129660",0,2,0,2,"dummy"
"129661",2,0,1,3,"dummy"
"129662",1,0,0,1,"dummy"
"129663",1,0,0,1,"dummy"
"129664",0,1,0,1,"dummy"
"129665",0,0,0,0,"dummy"
"129666",8,20,3,31,"dummy"
"129667",3,2,2,7,"dummy"
"129668",2,8,3,13,"dummy"
"129647",2,4,0,6,"dummy"
"129648",0,2,0,2,"dummy"
"129649",0,2,0,2,"dummy"
"129650",10,2,0,12,"dummy"
"129651",0,2,0,2,"dummy"
"129652",0,0,0,0,"dummy"
"129653",0,0,3,3,"dummy"
"129654",0,5,0,5,"dummy"
"129670",0,0,0,0,"dummy"
"129671",0,1,0,1,"dummy"
"129672",0,0,1,1,"dummy"
"129673",0,2,0,2,"dummy"
"129674",0,4,0,4,"dummy"
"129675",1,0,0,1,"dummy"
"129676",2,2,0,4,"dummy"
"129677",2,4,0,6,"dummy"
"129678",2,2,0,4,"dummy"
"129679",38,2,3,43,"dummy"
"129680",0,2,0,2,"dummy"
"129681",0,0,1,1,"dummy"
"129682",2,0,0,2,"dummy"
"129683",0,0,1,1,"dummy"
"129688",0,1,0,1,"dummy"
"129689",0,0,0,0,"dummy"
"129692",0,4,1,5,"dummy"
"129694",3,0,2,5,"dummy"
"129695",0,0,1,1,"dummy"
"129697",0,0,2,2,"dummy"
"129698",0,0,3,3,"dummy"
"129699",0,0,1,1,"dummy"
"129700",0,0,1,1,"dummy"
"129701",0,1,0,1,"dummy"
"129703",0,0,2,2,"dummy"
"129705",0,2,0,2,"dummy"
"129732",0,0,1,1,"dummy"
"129736",0,0,0,0,"dummy"
"129737",0,2,0,2,"dummy"
"129738",0,0,1,1,"dummy"
"129739",4,0,2,6,"dummy"
"129740",2,0,2,4,"dummy"
"129743",3,12,1,16,"dummy"
"129744",0,10,0,10,"dummy"
"129745",0,2,0,2,"dummy"
"129753",0,0,0,0,"dummy"
"129754",2,1,0,3,"dummy"
"129755",0,2,0,2,"dummy"
"129756",1,0,1,2,"dummy"
"129757",1,11,0,12,"dummy"
"129759",1,1,0,2,"dummy"
"129767",0,0,1,1,"dummy"
"129768",0,2,1,3,"dummy"
"129769",2,1,1,4,"dummy"
"129770",1,0,0,1,"dummy"
"129771",0,1,0,1,"dummy"
"129772",0,0,0,0,"dummy"
"129773",1,0,1,2,"dummy"
"129774",0,1,0,1,"dummy"
"129775",1,1,0,2,"dummy"
"129776",2,2,0,4,"dummy"
"129777",0,0,1,1,"dummy"
"129778",1,1,0,2,"dummy"
"129779",1,1,0,2,"dummy"
"129780",3,2,1,6,"dummy"
"129781",0,0,3,3,"dummy"
"129782",0,0,1,1,"dummy"
"129783",2,0,0,2,"dummy"
"129784",1,6,5,12,"dummy"
"129785",0,0,1,1,"dummy"
"129786",0,0,1,1,"dummy"
"129787",0,0,0,0,"dummy"
"129788",0,0,0,0,"dummy"
"129790",0,1,0,1,"dummy"
"129795",0,0,0,0,"dummy"
"129796",0,0,0,0,"dummy"
"129815",0,0,0,0,"dummy"
"129816",0,0,0,0,"dummy"
"129821",5,2,2,9,"dummy"
"129822",0,0,1,1,"dummy"
"129824",0,0,0,0,"dummy"
"129825",0,0,0,0,"dummy"
"129831",0,0,3,3,"dummy"
"129833",0,2,1,3,"dummy"
"129835",0,1,0,1,"dummy"
"129837",1,5,1,7,"dummy"
"129838",4,8,1,13,"dummy"
"129839",0,0,0,0,"dummy"
"129840",1,2,0,3,"dummy"
"129841",0,0,1,1,"dummy"
"129842",0,0,1,1,"dummy"
"129843",0,0,1,1,"dummy"
"129844",0,0,0,0,"dummy"
"129845",0,0,0,0,"dummy"
"129846",0,1,0,1,"dummy"
"129847",0,0,0,0,"dummy"
"129849",0,1,1,2,"dummy"
"129850",1,0,0,1,"dummy"
"129851",0,0,1,1,"dummy"
"129852",1,7,1,9,"dummy"
"129853",3,9,1,13,"dummy"
"129854",0,1,0,1,"dummy"
"129855",0,2,0,2,"dummy"
"129856",9,9,3,21,"dummy"
"129857",0,1,0,1,"dummy"
"129858",1,0,1,2,"dummy"
"129859",0,0,1,1,"dummy"
"129860",0,0,1,1,"dummy"
"129861",0,0,1,1,"dummy"
"129862",0,0,1,1,"dummy"
"129863",0,0,1,1,"dummy"
"129864",0,0,1,1,"dummy"
"129865",0,0,1,1,"dummy"
"129866",0,1,0,1,"dummy"
"129869",0,0,1,1,"dummy"
"129870",0,0,1,1,"dummy"
"129872",0,1,0,1,"dummy"
"129873",3,4,0,7,"dummy"
"129875",0,4,0,4,"dummy"
"129877",0,0,1,1,"dummy"
"129879",1,1,0,2,"dummy"
"129880",0,1,0,1,"dummy"
"129881",0,1,0,1,"dummy"
"129882",0,1,2,3,"dummy"
"129883",0,0,0,0,"dummy"
"129884",17,1,0,18,"dummy"
"129885",0,1,0,1,"dummy"
"129886",0,0,0,0,"dummy"
"129887",1,3,0,4,"dummy"
"129888",1,1,1,3,"dummy"
"129889",0,1,0,1,"dummy"
"129890",0,1,0,1,"dummy"
"129891",0,1,0,1,"dummy"
"129892",0,2,0,2,"dummy"
"129893",0,0,0,0,"dummy"
"129894",0,2,0,2,"dummy"
"129895",1,0,0,1,"dummy"
"129896",0,0,0,0,"dummy"
"129897",0,1,0,1,"dummy"
"129898",0,0,0,0,"dummy"
"129900",0,0,1,1,"dummy"
"129901",0,0,1,1,"dummy"
"129902",1,0,1,2,"dummy"
"129903",0,0,2,2,"dummy"
"129904",0,0,1,1,"dummy"
"129905",0,0,0,0,"dummy"
"129906",0,1,1,2,"dummy"
"129907",0,0,1,1,"dummy"
"129908",3,3,2,8,"dummy"
"129909",0,0,1,1,"dummy"
"129910",0,0,1,1,"dummy"
"129911",0,0,1,1,"dummy"
"129912",0,0,1,1,"dummy"
"129913",0,0,1,1,"dummy"
"129914",0,0,0,0,"dummy"
"129915",1,0,0,1,"dummy"
"129916",0,1,0,1,"dummy"
"129917",0,0,1,1,"dummy"
"129918",0,12,0,12,"dummy"
"129921",0,0,1,1,"dummy"
"129924",0,0,1,1,"dummy"
"129925",4,0,0,4,"dummy"
"129926",0,2,0,2,"dummy"
"129927",6,6,1,13,"dummy"
"129929",0,1,1,2,"dummy"
"129930",1,1,0,2,"dummy"
"129931",11,2,2,15,"dummy"
"129935",0,0,0,0,"dummy"
"129936",0,2,0,2,"dummy"
"129937",0,1,0,1,"dummy"
"129938",0,0,1,1,"dummy"
"129939",0,2,0,2,"dummy"
"129940",0,2,0,2,"dummy"
"129941",1,0,2,3,"dummy"
"129947",1,2,1,4,"dummy"
"129948",15,0,0,15,"dummy"
"129949",0,18,0,18,"dummy"
"129951",0,0,1,1,"dummy"
"129952",0,1,0,1,"dummy"
"129953",0,0,0,0,"dummy"
"129957",3,5,0,8,"dummy"
"129959",0,0,1,1,"dummy"
"129960",4,18,1,23,"dummy"
"129962",0,1,0,1,"dummy"
"129963",0,1,0,1,"dummy"
"129964",0,2,0,2,"dummy"
"129965",0,1,1,2,"dummy"
"129966",0,1,0,1,"dummy"
"129968",5,5,0,10,"dummy"
"129969",0,0,0,0,"dummy"
"129970",0,0,1,1,"dummy"
"129971",11,24,1,36,"dummy"
"129973",0,0,0,0,"dummy"
"129974",0,0,0,0,"dummy"
"129975",0,0,0,0,"dummy"
"129978",9,7,0,16,"dummy"
"129979",0,1,0,1,"dummy"
"129980",1,6,1,8,"dummy"
"129981",0,5,0,5,"dummy"
"129982",10,4,0,14,"dummy"
"129983",6,9,0,15,"dummy"
"129984",0,0,0,0,"dummy"
"129985",4,2,0,6,"dummy"
"129986",1,0,2,3,"dummy"
"129987",1,1,0,2,"dummy"
"129988",2,0,0,2,"dummy"
"129989",0,9,1,10,"dummy"
"129990",1,5,2,8,"dummy"
"129991",0,1,3,4,"dummy"
"129992",0,1,3,4,"dummy"
"129993",0,0,1,1,"dummy"
"129994",0,0,3,3,"dummy"
"129995",5,9,1,15,"dummy"
"129996",7,3,0,10,"dummy"
"129997",1,1,0,2,"dummy"
"129998",0,1,0,1,"dummy"
"129999",0,2,0,2,"dummy"
"130000",1,0,0,1,"dummy"
"130001",0,8,1,9,"dummy"
"130002",2,2,4,8,"dummy"
"130003",0,2,0,2,"dummy"
"130004",0,0,2,2,"dummy"
"130005",0,0,2,2,"dummy"
"130006",0,0,2,2,"dummy"
"130007",0,0,1,1,"dummy"
"130008",0,0,1,1,"dummy"
"130009",0,0,1,1,"dummy"
"130010",0,0,2,2,"dummy"
"130011",0,0,1,1,"dummy"
"130012",0,0,1,1,"dummy"
"130013",0,0,3,3,"dummy"
"130023",1,1,0,2,"dummy"
"130027",0,2,0,2,"dummy"
"130029",0,2,3,5,"dummy"
"130030",0,0,1,1,"dummy"
"130032",2,4,0,6,"dummy"
"130033",0,2,0,2,"dummy"
"130034",0,2,0,2,"dummy"
"130035",10,2,0,12,"dummy"
"130036",0,2,0,2,"dummy"
"130037",0,0,0,0,"dummy"
"130038",0,0,3,3,"dummy"
"130039",0,5,0,5,"dummy"
"130040",1,0,1,2,"dummy"
"130053",0,2,0,2,"dummy"
"130054",0,0,1,1,"dummy"
"130055",0,0,3,3,"dummy"
"130056",2,2,1,5,"dummy"
"130057",0,0,3,3,"dummy"
"130069",1,4,1,6,"dummy"
"130070",2,0,0,2,"dummy"
"130075",0,0,1,1,"dummy"
"130078",0,0,0,0,"dummy"
"130079",10,10,0,20,"dummy"
"130080",9,13,0,22,"dummy"
"130081",0,1,0,1,"dummy"
"130089",0,0,1,1,"dummy"
"130108",3,15,4,22,"dummy"
"130109",0,1,0,1,"dummy"
"130110",0,0,1,1,"dummy"
"130111",0,1,0,1,"dummy"
"130112",0,0,1,1,"dummy"
"130113",7,7,1,15,"dummy"
"130114",0,4,0,4,"dummy"
"130115",0,0,1,1,"dummy"
"130116",0,0,1,1,"dummy"
"130117",0,0,1,1,"dummy"
"130118",0,0,1,1,"dummy"
"130123",1,0,0,1,"dummy"
"130130",0,1,1,2,"dummy"
"130131",1,7,0,8,"dummy"
"130135",0,3,1,4,"dummy"
"130136",0,0,1,1,"dummy"
"130137",2,0,0,2,"dummy"
"130138",2,4,1,7,"dummy"
"130139",1,0,0,1,"dummy"
"130147",0,1,0,1,"dummy"
"130148",0,1,0,1,"dummy"
"130149",0,1,0,1,"dummy"
"130150",0,10,0,10,"dummy"
"130151",5,0,0,5,"dummy"
"130152",0,7,0,7,"dummy"
"130153",1,6,0,7,"dummy"
"130154",0,1,0,1,"dummy"
"130155",6,0,0,6,"dummy"
"130156",0,1,0,1,"dummy"
"130157",0,1,0,1,"dummy"
"130161",0,4,0,4,"dummy"
"130162",1,5,0,6,"dummy"
"130163",1,2,1,4,"dummy"
"130164",0,0,1,1,"dummy"
"130170",12,4,5,21,"dummy"
"130171",0,2,0,2,"dummy"
"130172",0,1,0,1,"dummy"
"130173",10,2,2,14,"dummy"
"130174",0,0,2,2,"dummy"
"130208",0,0,1,1,"dummy"
"130209",0,0,1,1,"dummy"
"130210",1,9,2,12,"dummy"
"130211",3,4,0,7,"dummy"
"130212",0,1,0,1,"dummy"
"130213",1,0,1,2,"dummy"
"130224",0,0,1,1,"dummy"
"130225",0,6,2,8,"dummy"
"130226",1,0,0,1,"dummy"
"130227",2,1,0,3,"dummy"
"130230",0,1,0,1,"dummy"
"130231",0,1,0,1,"dummy"
"130234",2,5,2,9,"dummy"
"130250",0,0,1,1,"dummy"
"130049",0,1,0,1,"dummy"
"130059",1,0,0,1,"dummy"
"130060",0,2,1,3,"dummy"
"130061",0,1,0,1,"dummy"
"130062",0,0,0,0,"dummy"
"130063",0,1,0,1,"dummy"
"130066",1,7,0,8,"dummy"
"130067",3,2,1,6,"dummy"
"130083",0,0,1,1,"dummy"
"130084",0,0,0,0,"dummy"
"130087",0,0,0,0,"dummy"
"130091",2,0,3,5,"dummy"
"130120",0,0,0,0,"dummy"
"130121",0,0,0,0,"dummy"
"130125",0,0,1,1,"dummy"
"130126",0,4,0,4,"dummy"
"130127",2,1,0,3,"dummy"
"130128",0,1,0,1,"dummy"
"130133",0,1,2,3,"dummy"
"130159",9,0,4,13,"dummy"
"130168",0,0,0,0,"dummy"
"130176",0,1,1,2,"dummy"
"130177",0,1,0,1,"dummy"
"130178",0,0,1,1,"dummy"
"130179",1,1,2,4,"dummy"
"130180",1,1,2,4,"dummy"
"130181",0,2,0,2,"dummy"
"130182",0,0,3,3,"dummy"
"130183",0,0,2,2,"dummy"
"130184",2,2,0,4,"dummy"
"130197",2,0,0,2,"dummy"
"130198",3,0,0,3,"dummy"
"130199",0,0,0,0,"dummy"
"130200",0,0,1,1,"dummy"
"130201",0,0,1,1,"dummy"
"130202",1,0,0,1,"dummy"
"130215",5,2,0,7,"dummy"
"130218",0,0,1,1,"dummy"
"130219",0,0,1,1,"dummy"
"130220",1,0,0,1,"dummy"
"130236",4,4,3,11,"dummy"
"130237",0,1,0,1,"dummy"
"130238",2,0,3,5,"dummy"
"130239",3,0,1,4,"dummy"
"130242",0,0,2,2,"dummy"
"130243",0,1,0,1,"dummy"
"130244",0,0,1,1,"dummy"
"130245",0,0,1,1,"dummy"
"130246",0,1,0,1,"dummy"
"130256",0,1,0,1,"dummy"
"130262",0,1,0,1,"dummy"
"130263",0,0,2,2,"dummy"
"130264",0,0,2,2,"dummy"
"130265",1,10,2,13,"dummy"
"130269",1,0,0,1,"dummy"
"130270",2,0,1,3,"dummy"
"130271",0,0,0,0,"dummy"
"130272",0,1,0,1,"dummy"
"130273",8,1,0,9,"dummy"
"130274",0,0,0,0,"dummy"
"130275",0,0,0,0,"dummy"
"130276",1,10,0,11,"dummy"
"130277",7,1,0,8,"dummy"
"130278",2,0,3,5,"dummy"
"130303",0,2,0,2,"dummy"
"130304",0,1,0,1,"dummy"
"130305",0,5,0,5,"dummy"
"130306",4,5,2,11,"dummy"
"130307",6,3,1,10,"dummy"
"130258",0,0,1,1,"dummy"
"130259",0,0,0,0,"dummy"
"130260",0,2,1,3,"dummy"
"130267",0,1,0,1,"dummy"
"130284",1,0,0,1,"dummy"
"130285",0,1,0,1,"dummy"
"130286",0,1,0,1,"dummy"
"130287",0,0,1,1,"dummy"
"130288",0,2,0,2,"dummy"
"130289",0,2,0,2,"dummy"
"130300",0,1,0,1,"dummy"
"130301",0,0,1,1,"dummy"
"130310",1,3,1,5,"dummy"
"130311",12,4,1,17,"dummy"
"130312",0,0,0,0,"dummy"
"130313",0,0,0,0,"dummy"
"130316",0,1,0,1,"dummy"
"130317",1,3,2,6,"dummy"
"130318",0,0,1,1,"dummy"
"130319",0,0,1,1,"dummy"
"130347",0,0,1,1,"dummy"
"130350",0,2,0,2,"dummy"
"130351",0,2,0,2,"dummy"
"130352",0,2,0,2,"dummy"
"130353",1,4,1,6,"dummy"
"130354",2,1,0,3,"dummy"
"130355",0,8,0,8,"dummy"
"130356",8,0,0,8,"dummy"
"130357",0,0,1,1,"dummy"
"130358",0,0,1,1,"dummy"
"130359",0,1,0,1,"dummy"
"130396",0,3,0,3,"dummy"
"130397",0,1,0,1,"dummy"
"130400",4,4,0,8,"dummy"
"130413",0,1,0,1,"dummy"
"130414",0,0,1,1,"dummy"
"130415",0,0,1,1,"dummy"
"130416",0,0,1,1,"dummy"
"130417",0,0,1,1,"dummy"
"130418",0,0,1,1,"dummy"
"130419",0,0,1,1,"dummy"
"130420",0,0,1,1,"dummy"
"130421",0,0,1,1,"dummy"
"130422",0,0,1,1,"dummy"
"130423",0,0,1,1,"dummy"
"130424",0,0,1,1,"dummy"
"130425",0,0,1,1,"dummy"
"130426",0,0,1,1,"dummy"
"130427",0,0,1,1,"dummy"
"130428",0,0,1,1,"dummy"
"130429",0,0,1,1,"dummy"
"130430",0,0,1,1,"dummy"
"130431",0,0,1,1,"dummy"
"130432",0,0,1,1,"dummy"
"130438",0,1,0,1,"dummy"
"130439",5,2,2,9,"dummy"
"130440",0,0,0,0,"dummy"
"130441",0,0,1,1,"dummy"
"130444",1,0,0,1,"dummy"
"130445",1,1,0,2,"dummy"
"130514",2,0,0,2,"dummy"
"130515",0,2,3,5,"dummy"
"130519",0,2,0,2,"dummy"
"130520",1,2,4,7,"dummy"
"130521",0,0,1,1,"dummy"
"130522",0,4,0,4,"dummy"
"130523",0,0,2,2,"dummy"
"130524",0,0,1,1,"dummy"
"130525",0,0,1,1,"dummy"
"130539",0,0,2,2,"dummy"
"130543",1,3,0,4,"dummy"
"130550",6,6,3,15,"dummy"
"130551",3,4,0,7,"dummy"
"130554",0,1,0,1,"dummy"
"130308",1,0,0,1,"dummy"
"130321",4,6,2,12,"dummy"
"130324",2,4,0,6,"dummy"
"130325",0,2,0,2,"dummy"
"130326",0,2,0,2,"dummy"
"130327",10,2,0,12,"dummy"
"130328",0,2,0,2,"dummy"
"130329",0,0,0,0,"dummy"
"130330",0,0,3,3,"dummy"
"130331",0,5,0,5,"dummy"
"130332",1,0,1,2,"dummy"
"130337",1,0,0,1,"dummy"
"130341",1,0,2,3,"dummy"
"130342",0,1,0,1,"dummy"
"130343",1,0,0,1,"dummy"
"130344",0,0,2,2,"dummy"
"130345",5,4,2,11,"dummy"
"130361",0,0,1,1,"dummy"
"130364",5,6,1,12,"dummy"
"130365",0,0,3,3,"dummy"
"130366",2,0,0,2,"dummy"
"130367",0,9,0,9,"dummy"
"130368",0,1,0,1,"dummy"
"130369",13,8,3,24,"dummy"
"130370",0,0,1,1,"dummy"
"130371",5,11,3,19,"dummy"
"130372",1,1,0,2,"dummy"
"130373",0,0,0,0,"dummy"
"130374",5,4,4,13,"dummy"
"130375",11,6,5,22,"dummy"
"130376",6,11,4,21,"dummy"
"130377",9,1,3,13,"dummy"
"130378",1,7,0,8,"dummy"
"130402",0,17,3,20,"dummy"
"130403",0,1,3,4,"dummy"
"130404",0,4,0,4,"dummy"
"130405",0,0,1,1,"dummy"
"130410",0,0,1,1,"dummy"
"130411",0,12,0,12,"dummy"
"130436",0,3,1,4,"dummy"
"130447",2,0,0,2,"dummy"
"130448",1,0,0,1,"dummy"
"130449",1,2,0,3,"dummy"
"130450",2,1,0,3,"dummy"
"130451",0,0,1,1,"dummy"
"130452",1,3,0,4,"dummy"
"130453",2,1,1,4,"dummy"
"130454",0,1,0,1,"dummy"
"130455",0,1,1,2,"dummy"
"130456",0,2,0,2,"dummy"
"130457",3,0,0,3,"dummy"
"130458",2,2,1,5,"dummy"
"130459",0,0,0,0,"dummy"
"130460",3,1,1,5,"dummy"
"130461",0,0,0,0,"dummy"
"130462",0,0,0,0,"dummy"
"130463",0,1,0,1,"dummy"
"130464",0,1,0,1,"dummy"
"130465",1,2,1,4,"dummy"
"130466",0,1,0,1,"dummy"
"130467",0,0,3,3,"dummy"
"130468",1,6,3,10,"dummy"
"130469",0,2,0,2,"dummy"
"130470",0,1,0,1,"dummy"
"130471",0,4,1,5,"dummy"
"130472",0,1,0,1,"dummy"
"130473",0,0,1,1,"dummy"
"130474",0,6,0,6,"dummy"
"130475",0,1,0,1,"dummy"
"130476",0,6,0,6,"dummy"
"130477",0,1,0,1,"dummy"
"130478",0,0,0,0,"dummy"
"130479",0,0,2,2,"dummy"
"130480",0,8,0,8,"dummy"
"130481",0,2,0,2,"dummy"
"130482",0,2,0,2,"dummy"
"130483",0,0,1,1,"dummy"
"130484",0,0,0,0,"dummy"
"130485",0,0,1,1,"dummy"
"130486",0,1,0,1,"dummy"
"130487",0,3,0,3,"dummy"
"130488",6,0,0,6,"dummy"
"130489",0,0,1,1,"dummy"
"130490",0,0,1,1,"dummy"
"130491",0,0,0,0,"dummy"
"130492",0,1,0,1,"dummy"
"130493",0,1,0,1,"dummy"
"130494",0,0,1,1,"dummy"
"130495",52,8,4,64,"dummy"
"130496",1,15,0,16,"dummy"
"130497",1,1,0,2,"dummy"
"130498",0,0,14,14,"dummy"
"130503",0,0,0,0,"dummy"
"130512",0,0,2,2,"dummy"
"130517",0,0,1,1,"dummy"
"130527",0,0,1,1,"dummy"
"130528",2,2,6,10,"dummy"
"130529",0,9,0,9,"dummy"
"130530",12,2,5,19,"dummy"
"130531",10,4,0,14,"dummy"
"130532",4,5,3,12,"dummy"
"130533",0,1,1,2,"dummy"
"130534",3,1,0,4,"dummy"
"130535",2,2,2,6,"dummy"
"130541",3,2,0,5,"dummy"
"130545",3,0,0,3,"dummy"
"130546",0,0,0,0,"dummy"
"130547",6,7,2,15,"dummy"
"130548",5,15,1,21,"dummy"
"130630",4,10,1,15,"dummy"
"130631",8,0,0,8,"dummy"
"130632",3,0,0,3,"dummy"
"130633",0,1,1,2,"dummy"
"130634",0,0,0,0,"dummy"
"130635",0,4,0,4,"dummy"
"130636",11,0,3,14,"dummy"
"130637",0,0,1,1,"dummy"
"130649",12,6,0,18,"dummy"
"130654",0,4,0,4,"dummy"
"130661",0,0,0,0,"dummy"
"130673",0,1,0,1,"dummy"
"130674",0,0,1,1,"dummy"
"130687",0,0,2,2,"dummy"
"130688",0,0,2,2,"dummy"
"130691",8,10,7,25,"dummy"
"130694",1,0,0,1,"dummy"
"130695",0,2,0,2,"dummy"
"130696",0,0,1,1,"dummy"
"130697",4,2,2,8,"dummy"
"130698",3,1,1,5,"dummy"
"130699",0,0,0,0,"dummy"
"130734",0,0,1,1,"dummy"
"130735",0,0,1,1,"dummy"
"130736",1,2,0,3,"dummy"
"130737",1,0,0,1,"dummy"
"130738",0,2,0,2,"dummy"
"130739",2,2,0,4,"dummy"
"130740",6,4,0,10,"dummy"
"130744",3,0,0,3,"dummy"
"130745",1,2,0,3,"dummy"
"130746",0,2,2,4,"dummy"
"130747",0,2,1,3,"dummy"
"130748",3,4,1,8,"dummy"
"130749",0,2,0,2,"dummy"
"130555",0,1,0,1,"dummy"
"130556",0,0,1,1,"dummy"
"130557",3,3,0,6,"dummy"
"130558",0,1,1,2,"dummy"
"130559",0,1,0,1,"dummy"
"130560",0,0,1,1,"dummy"
"130561",3,3,1,7,"dummy"
"130562",0,0,2,2,"dummy"
"130563",1,0,0,1,"dummy"
"130564",0,0,0,0,"dummy"
"130565",0,0,1,1,"dummy"
"130612",16,13,7,36,"dummy"
"130613",3,3,4,10,"dummy"
"130614",0,0,2,2,"dummy"
"130615",0,1,2,3,"dummy"
"130616",4,4,0,8,"dummy"
"130617",2,0,0,2,"dummy"
"130618",0,2,0,2,"dummy"
"130619",0,1,0,1,"dummy"
"130620",3,0,1,4,"dummy"
"130621",0,1,1,2,"dummy"
"130622",0,0,3,3,"dummy"
"130623",0,1,0,1,"dummy"
"130639",0,0,0,0,"dummy"
"130640",0,0,1,1,"dummy"
"130647",0,0,0,0,"dummy"
"130656",0,0,1,1,"dummy"
"130657",0,0,1,1,"dummy"
"130669",0,4,1,5,"dummy"
"130670",0,0,2,2,"dummy"
"130671",0,1,1,2,"dummy"
"130676",0,0,1,1,"dummy"
"130718",0,4,0,4,"dummy"
"130728",2,0,3,5,"dummy"
"130731",0,1,0,1,"dummy"
"130732",0,0,1,1,"dummy"
"130742",0,0,1,1,"dummy"
"130760",0,0,1,1,"dummy"
"130765",3,4,1,8,"dummy"
"130766",0,1,1,2,"dummy"
"130767",0,0,1,1,"dummy"
"130768",0,1,1,2,"dummy"
"130769",0,1,1,2,"dummy"
"130770",0,0,0,0,"dummy"
"130771",0,0,0,0,"dummy"
"130772",0,1,1,2,"dummy"
"130773",0,0,1,1,"dummy"
"130774",0,2,1,3,"dummy"
"130775",1,0,0,1,"dummy"
"130780",0,0,1,1,"dummy"
"130795",0,11,0,11,"dummy"
"130806",1,0,1,2,"dummy"
"130811",7,4,0,11,"dummy"
"130812",1,0,0,1,"dummy"
"130821",0,0,1,1,"dummy"
"130822",0,0,1,1,"dummy"
"130850",0,2,0,2,"dummy"
"130853",0,2,0,2,"dummy"
"130854",0,2,0,2,"dummy"
"130855",0,2,0,2,"dummy"
"130856",0,0,2,2,"dummy"
"130860",11,7,2,20,"dummy"
"130750",0,0,1,1,"dummy"
"130755",0,0,4,4,"dummy"
"130758",0,0,1,1,"dummy"
"130777",0,1,0,1,"dummy"
"130778",0,1,0,1,"dummy"
"130788",0,2,0,2,"dummy"
"130789",0,1,0,1,"dummy"
"130801",0,2,0,2,"dummy"
"130802",0,1,0,1,"dummy"
"130803",2,21,0,23,"dummy"
"130804",0,2,0,2,"dummy"
"130808",0,2,0,2,"dummy"
"130809",0,1,0,1,"dummy"
"130840",1,0,0,1,"dummy"
"130841",0,1,0,1,"dummy"
"130842",0,2,0,2,"dummy"
"130845",0,0,0,0,"dummy"
"130846",0,0,0,0,"dummy"
"130847",0,0,0,0,"dummy"
"130848",0,0,0,0,"dummy"
"130862",3,6,6,15,"dummy"
"130879",0,0,1,1,"dummy"
"130880",0,0,3,3,"dummy"
"130881",6,8,2,16,"dummy"
"130882",3,3,2,8,"dummy"
"130883",4,1,1,6,"dummy"
"130884",0,4,0,4,"dummy"
"130885",0,0,0,0,"dummy"
"130886",0,1,0,1,"dummy"
"130887",0,0,1,1,"dummy"
"130888",0,1,0,1,"dummy"
"130889",2,0,0,2,"dummy"
"130890",0,2,0,2,"dummy"
"130894",0,1,0,1,"dummy"
"130895",3,2,0,5,"dummy"
"130896",0,1,0,1,"dummy"
"130897",0,3,0,3,"dummy"
"130898",0,0,0,0,"dummy"
"130899",3,0,0,3,"dummy"
"130900",0,0,2,2,"dummy"
"130901",0,0,1,1,"dummy"
"130902",3,1,0,4,"dummy"
"130903",0,0,1,1,"dummy"
"130904",0,0,0,0,"dummy"
"130905",0,0,0,0,"dummy"
"130906",2,4,1,7,"dummy"
"130909",0,3,2,5,"dummy"
"130910",0,1,0,1,"dummy"
"130918",0,1,0,1,"dummy"
"130919",0,1,0,1,"dummy"
"130922",0,1,0,1,"dummy"
"130948",1,0,1,2,"dummy"
"130949",0,0,1,1,"dummy"
"130952",0,0,2,2,"dummy"
"130960",0,0,0,0,"dummy"
"130961",2,0,0,2,"dummy"
"130962",0,2,0,2,"dummy"
"130963",0,1,0,1,"dummy"
"130964",0,0,1,1,"dummy"
"130969",0,3,0,3,"dummy"
"130970",0,1,0,1,"dummy"
"130971",4,5,0,9,"dummy"
"130866",0,2,0,2,"dummy"
"130867",0,1,0,1,"dummy"
"130868",0,0,1,1,"dummy"
"130869",0,0,1,1,"dummy"
"130870",6,0,0,6,"dummy"
"130871",8,4,3,15,"dummy"
"130872",0,2,0,2,"dummy"
"130873",4,0,0,4,"dummy"
"130874",0,4,0,4,"dummy"
"130875",0,3,1,4,"dummy"
"130876",1,12,0,13,"dummy"
"130877",2,1,0,3,"dummy"
"130892",0,0,1,1,"dummy"
"130914",6,0,0,6,"dummy"
"130915",0,0,1,1,"dummy"
"130916",3,1,0,4,"dummy"
"130926",1,2,0,3,"dummy"
"130927",0,2,0,2,"dummy"
"130928",0,1,0,1,"dummy"
"130931",0,0,1,1,"dummy"
"130932",0,2,0,2,"dummy"
"130933",0,0,1,1,"dummy"
"130934",0,1,0,1,"dummy"
"130935",0,0,0,0,"dummy"
"130936",0,0,1,1,"dummy"
"130937",0,0,0,0,"dummy"
"130938",0,0,1,1,"dummy"
"130956",2,2,0,4,"dummy"
"130957",0,1,0,1,"dummy"
"130958",1,0,0,1,"dummy"
"130988",0,7,0,7,"dummy"
"130989",0,1,0,1,"dummy"
"130990",1,1,0,2,"dummy"
"130991",0,0,1,1,"dummy"
"130972",0,14,0,14,"dummy"
"130973",9,12,4,25,"dummy"
"130974",2,0,0,2,"dummy"
"130975",0,10,0,10,"dummy"
"130976",17,17,3,37,"dummy"
"130977",0,2,1,3,"dummy"
"130978",18,0,1,19,"dummy"
"130979",0,0,0,0,"dummy"
"130980",0,2,0,2,"dummy"
"130981",2,0,0,2,"dummy"
"130982",0,2,0,2,"dummy"
"130983",0,10,1,11,"dummy"
"130984",1,0,0,1,"dummy"
"130997",1,0,0,1,"dummy"
"130998",0,1,0,1,"dummy"
"130999",0,0,1,1,"dummy"
"131003",4,1,3,8,"dummy"
"131006",0,0,1,1,"dummy"
"131008",9,1,0,10,"dummy"
"131009",22,0,0,22,"dummy"
"131010",2,1,3,6,"dummy"
"131012",0,2,0,2,"dummy"
"131013",0,1,0,1,"dummy"
"131014",6,0,1,7,"dummy"
"131015",0,1,0,1,"dummy"
"131019",4,1,7,12,"dummy"
"131020",0,0,1,1,"dummy"
"131021",1,6,0,7,"dummy"
"131024",1,1,0,2,"dummy"
"131028",12,3,0,15,"dummy"
"131029",0,0,1,1,"dummy"
"131030",0,1,0,1,"dummy"
"131031",2,0,0,2,"dummy"
"131034",2,0,1,3,"dummy"
"131035",0,1,1,2,"dummy"
"131036",0,0,1,1,"dummy"
"131037",0,0,0,0,"dummy"
"131038",0,0,0,0,"dummy"
"131039",0,0,0,0,"dummy"
"131058",0,0,3,3,"dummy"
"131059",0,1,1,2,"dummy"
"131060",0,0,1,1,"dummy"
"131061",0,0,3,3,"dummy"
"131062",0,0,1,1,"dummy"
"131065",3,1,0,4,"dummy"
"131066",0,1,0,1,"dummy"
"131067",0,3,0,3,"dummy"
"131068",0,1,0,1,"dummy"
"131069",0,0,1,1,"dummy"
"131070",0,4,0,4,"dummy"
"131071",2,2,2,6,"dummy"
"131072",0,2,0,2,"dummy"
"131073",4,0,0,4,"dummy"
"131074",3,1,0,4,"dummy"
"131075",1,5,0,6,"dummy"
"131076",0,0,0,0,"dummy"
"131077",0,0,2,2,"dummy"
"131079",0,3,0,3,"dummy"
"131092",0,0,1,1,"dummy"
"131093",1,2,0,3,"dummy"
"131095",0,1,0,1,"dummy"
"131096",0,1,1,2,"dummy"
"131097",1,0,0,1,"dummy"
"131098",0,1,0,1,"dummy"
"131101",3,3,0,6,"dummy"
"131102",0,0,3,3,"dummy"
"131103",0,0,2,2,"dummy"
"131104",0,6,1,7,"dummy"
"131105",0,0,5,5,"dummy"
"131112",0,4,1,5,"dummy"
"131113",0,1,0,1,"dummy"
"131114",4,0,0,4,"dummy"
"131115",0,0,1,1,"dummy"
"131116",0,1,0,1,"dummy"
"131117",0,0,0,0,"dummy"
"131118",0,3,0,3,"dummy"
"131120",0,2,0,2,"dummy"
"131122",0,0,0,0,"dummy"
"131123",0,0,1,1,"dummy"
"131124",0,3,1,4,"dummy"
"131125",2,2,1,5,"dummy"
"131126",0,1,0,1,"dummy"
"131127",1,2,0,3,"dummy"
"131128",0,2,0,2,"dummy"
"131130",1,4,3,8,"dummy"
"131132",0,1,0,1,"dummy"
"131133",7,37,6,50,"dummy"
"131134",1,0,0,1,"dummy"
"131135",0,2,0,2,"dummy"
"131136",0,0,2,2,"dummy"
"131137",0,1,0,1,"dummy"
"131138",0,0,2,2,"dummy"
"131139",0,0,1,1,"dummy"
"131140",0,0,0,0,"dummy"
"131145",0,1,0,1,"dummy"
"131147",0,0,1,1,"dummy"
"131148",1,0,0,1,"dummy"
"131150",0,9,2,11,"dummy"
"131151",0,7,0,7,"dummy"
"131153",0,1,0,1,"dummy"
"131154",0,1,0,1,"dummy"
"131155",0,1,0,1,"dummy"
"131156",0,0,1,1,"dummy"
"131157",0,1,0,1,"dummy"
"131158",0,1,0,1,"dummy"
"131160",0,5,0,5,"dummy"
"131161",3,5,1,9,"dummy"
"131163",2,1,0,3,"dummy"
"131166",0,0,1,1,"dummy"
"131169",0,0,1,1,"dummy"
"131170",0,0,1,1,"dummy"
"131172",0,4,0,4,"dummy"
"131174",11,15,4,30,"dummy"
"131175",0,0,3,3,"dummy"
"131176",4,5,3,12,"dummy"
"131177",0,3,0,3,"dummy"
"131178",0,3,2,5,"dummy"
"131179",1,1,1,3,"dummy"
"131180",3,3,2,8,"dummy"
"131181",3,2,2,7,"dummy"
"131182",4,0,0,4,"dummy"
"131183",8,5,6,19,"dummy"
"131184",2,0,1,3,"dummy"
"131186",0,2,0,2,"dummy"
"131187",0,0,1,1,"dummy"
"131188",0,0,1,1,"dummy"
"131197",0,2,0,2,"dummy"
"131198",2,6,1,9,"dummy"
"131199",0,0,1,1,"dummy"
"131203",0,0,1,1,"dummy"
"131213",0,2,3,5,"dummy"
"131215",0,0,1,1,"dummy"
"131216",0,0,1,1,"dummy"
"131219",0,1,1,2,"dummy"
"131223",0,1,0,1,"dummy"
"131230",3,3,3,9,"dummy"
"131231",3,3,0,6,"dummy"
"131232",0,1,0,1,"dummy"
"131235",0,2,0,2,"dummy"
"131238",1,0,0,1,"dummy"
"131239",0,0,1,1,"dummy"
"131240",0,0,1,1,"dummy"
"131247",0,1,0,1,"dummy"
"131248",0,2,2,4,"dummy"
"131249",0,0,4,4,"dummy"
"131250",0,2,0,2,"dummy"
"131251",4,4,1,9,"dummy"
"131252",2,5,1,8,"dummy"
"131253",0,2,0,2,"dummy"
"131254",7,1,1,9,"dummy"
"131271",0,1,0,1,"dummy"
"131272",0,0,1,1,"dummy"
"131273",0,0,0,0,"dummy"
"131274",0,0,0,0,"dummy"
"131278",15,0,1,16,"dummy"
"131280",0,6,0,6,"dummy"
"131281",0,0,1,1,"dummy"
"131283",0,0,1,1,"dummy"
"131284",0,0,2,2,"dummy"
"131287",0,0,1,1,"dummy"
"131290",0,1,0,1,"dummy"
"131292",0,0,0,0,"dummy"
"131293",0,0,0,0,"dummy"
"131295",1,4,1,6,"dummy"
"131298",0,0,2,2,"dummy"
"131299",0,0,2,2,"dummy"
"131300",0,0,2,2,"dummy"
"131304",3,2,1,6,"dummy"
"131308",0,0,2,2,"dummy"
"131310",2,8,0,10,"dummy"
"131311",1,0,1,2,"dummy"
"131312",0,0,1,1,"dummy"
"131313",0,0,0,0,"dummy"
"131315",0,0,1,1,"dummy"
"131322",2,2,0,4,"dummy"
"131323",2,2,0,4,"dummy"
"131324",3,9,0,12,"dummy"
"131325",9,1,0,10,"dummy"
"131326",1,9,0,10,"dummy"
"131327",10,1,0,11,"dummy"
"131328",0,1,0,1,"dummy"
"131329",3,8,0,11,"dummy"
"131332",0,3,3,6,"dummy"
"131334",36,0,0,36,"dummy"
"131335",0,0,0,0,"dummy"
"131336",0,0,3,3,"dummy"
"131337",0,0,0,0,"dummy"
"131338",0,0,1,1,"dummy"
"131339",0,0,0,0,"dummy"
"131340",0,0,0,0,"dummy"
"131341",0,0,0,0,"dummy"
"131342",0,0,1,1,"dummy"
"131343",0,0,1,1,"dummy"
"131344",0,0,0,0,"dummy"
"131345",71,17,9,97,"dummy"
"131347",0,0,1,1,"dummy"
"131348",0,3,0,3,"dummy"
"131349",0,4,0,4,"dummy"
"131350",0,1,0,1,"dummy"
"131351",0,8,0,8,"dummy"
"131352",8,3,0,11,"dummy"
"131353",0,1,1,2,"dummy"
"131354",0,2,0,2,"dummy"
"131358",0,0,2,2,"dummy"
"131361",0,0,1,1,"dummy"
"131364",0,0,1,1,"dummy"
"131365",0,1,1,2,"dummy"
"131366",1,1,0,2,"dummy"
"131367",0,1,2,3,"dummy"
"131372",6,0,0,6,"dummy"
"131373",2,5,2,9,"dummy"
"131375",0,1,0,1,"dummy"
"131398",0,0,1,1,"dummy"
"131399",0,0,1,1,"dummy"
"131400",1,0,2,3,"dummy"
"131401",0,0,1,1,"dummy"
"131402",0,0,1,1,"dummy"
"131403",0,0,1,1,"dummy"
"131404",0,0,1,1,"dummy"
"131405",0,0,1,1,"dummy"
"131406",0,0,1,1,"dummy"
"131407",0,0,2,2,"dummy"
"131408",0,0,1,1,"dummy"
"131409",0,0,1,1,"dummy"
"131410",0,0,1,1,"dummy"
"131411",0,0,1,1,"dummy"
"131412",0,0,1,1,"dummy"
"131413",0,0,0,0,"dummy"
"131414",0,0,1,1,"dummy"
"131415",0,0,1,1,"dummy"
"131416",0,0,1,1,"dummy"
"131417",0,0,0,0,"dummy"
"131418",1,0,0,1,"dummy"
"131419",0,1,1,2,"dummy"
"131424",3,4,2,9,"dummy"
"131467",2,0,0,2,"dummy"
"131468",0,0,0,0,"dummy"
"131469",0,1,0,1,"dummy"
"131480",3,0,0,3,"dummy"
"131481",0,0,1,1,"dummy"
"131482",1,0,0,1,"dummy"
"131483",4,4,1,9,"dummy"
"131484",1,0,0,1,"dummy"
"131485",0,0,5,5,"dummy"
"131502",0,0,0,0,"dummy"
"131503",0,0,0,0,"dummy"
"131505",0,0,2,2,"dummy"
"131506",0,5,0,5,"dummy"
"131507",0,2,0,2,"dummy"
"131508",1,0,0,1,"dummy"
"131511",0,2,1,3,"dummy"
"131512",0,0,1,1,"dummy"
"131513",1,0,1,2,"dummy"
"131514",0,1,0,1,"dummy"
"131515",0,0,0,0,"dummy"
"131516",0,0,1,1,"dummy"
"131517",0,1,0,1,"dummy"
"131519",1,0,1,2,"dummy"
"131520",0,3,0,3,"dummy"
"131523",2,0,3,5,"dummy"
"131525",0,0,0,0,"dummy"
"131526",0,0,0,0,"dummy"
"131527",0,0,0,0,"dummy"
"131528",0,0,0,0,"dummy"
"131529",0,0,0,0,"dummy"
"131530",0,0,0,0,"dummy"
"131531",0,0,0,0,"dummy"
"131532",0,0,0,0,"dummy"
"131533",0,0,0,0,"dummy"
"131534",0,0,0,0,"dummy"
"131535",0,0,0,0,"dummy"
"131536",0,0,0,0,"dummy"
"131537",0,0,0,0,"dummy"
"131538",0,0,0,0,"dummy"
"131552",3,3,0,6,"dummy"
"131553",2,24,0,26,"dummy"
"131554",0,2,0,2,"dummy"
"131559",1,4,0,5,"dummy"
"131560",0,3,0,3,"dummy"
"131561",0,5,1,6,"dummy"
"131562",0,2,0,2,"dummy"
"131568",0,10,0,10,"dummy"
"131569",10,0,0,10,"dummy"
"131600",0,0,1,1,"dummy"
"131601",0,1,0,1,"dummy"
"131602",1,2,0,3,"dummy"
"131652",0,0,1,1,"dummy"
"131653",0,0,0,0,"dummy"
"131654",4,2,0,6,"dummy"
"131655",5,7,0,12,"dummy"
"131656",0,2,0,2,"dummy"
"131657",0,0,0,0,"dummy"
"131660",7,0,4,11,"dummy"
"131668",0,2,0,2,"dummy"
"131669",0,0,0,0,"dummy"
"131756",0,0,3,3,"dummy"
"131757",0,1,2,3,"dummy"
"131758",0,0,2,2,"dummy"
"131761",2,3,0,5,"dummy"
"131762",6,5,1,12,"dummy"
"131763",2,3,0,5,"dummy"
"131776",0,2,0,2,"dummy"
"131777",0,1,1,2,"dummy"
"131778",0,0,0,0,"dummy"
"131779",4,1,0,5,"dummy"
"131542",0,0,0,0,"dummy"
"131543",0,0,0,0,"dummy"
"131544",0,0,0,0,"dummy"
"131545",0,0,1,1,"dummy"
"131546",0,0,0,0,"dummy"
"131547",0,1,1,2,"dummy"
"131548",2,1,0,3,"dummy"
"131549",0,0,1,1,"dummy"
"131550",2,2,0,4,"dummy"
"131556",5,7,1,13,"dummy"
"131557",7,3,1,11,"dummy"
"131564",0,0,1,1,"dummy"
"131565",0,0,1,1,"dummy"
"131566",9,5,3,17,"dummy"
"131573",5,5,2,12,"dummy"
"131574",1,0,0,1,"dummy"
"131575",0,2,0,2,"dummy"
"131576",1,3,1,5,"dummy"
"131577",0,0,1,1,"dummy"
"131578",0,1,1,2,"dummy"
"131579",2,0,1,3,"dummy"
"131580",2,5,1,8,"dummy"
"131581",2,0,1,3,"dummy"
"131582",0,1,1,2,"dummy"
"131583",0,2,0,2,"dummy"
"131584",0,1,0,1,"dummy"
"131585",1,0,0,1,"dummy"
"131586",0,11,0,11,"dummy"
"131587",0,0,0,0,"dummy"
"131588",0,5,3,8,"dummy"
"131589",1,1,1,3,"dummy"
"131590",1,1,1,3,"dummy"
"131591",0,1,0,1,"dummy"
"131592",0,0,1,1,"dummy"
"131593",0,0,1,1,"dummy"
"131594",0,0,1,1,"dummy"
"131664",1,14,0,15,"dummy"
"131714",0,0,2,2,"dummy"
"131715",0,0,2,2,"dummy"
"131716",0,0,1,1,"dummy"
"131731",2,2,1,5,"dummy"
"131732",0,1,0,1,"dummy"
"131733",0,1,0,1,"dummy"
"131734",0,1,0,1,"dummy"
"131735",0,2,0,2,"dummy"
"131736",0,1,0,1,"dummy"
"131737",1,2,0,3,"dummy"
"131738",0,1,0,1,"dummy"
"131739",6,5,1,12,"dummy"
"131740",0,1,0,1,"dummy"
"131741",0,4,1,5,"dummy"
"131742",0,2,0,2,"dummy"
"131743",0,1,0,1,"dummy"
"131744",0,0,1,1,"dummy"
"131745",1,0,0,1,"dummy"
"131746",0,1,0,1,"dummy"
"131747",0,4,0,4,"dummy"
"131748",2,0,0,2,"dummy"
"131749",0,0,0,0,"dummy"
"131750",0,2,0,2,"dummy"
"131751",0,0,1,1,"dummy"
"131752",0,2,0,2,"dummy"
"131753",0,3,0,3,"dummy"
"131754",3,0,0,3,"dummy"
"131765",0,0,0,0,"dummy"
"131766",0,0,0,0,"dummy"
"131769",0,0,1,1,"dummy"
"131774",0,1,0,1,"dummy"
"131787",1,1,0,2,"dummy"
"131799",0,0,1,1,"dummy"
"131800",0,0,1,1,"dummy"
"131780",1,0,0,1,"dummy"
"131781",0,0,0,0,"dummy"
"131782",0,0,0,0,"dummy"
"131948",2,0,2,4,"dummy"
"131984",0,1,0,1,"dummy"
"131987",2,0,1,3,"dummy"
"131988",0,0,0,0,"dummy"
"131993",0,1,0,1,"dummy"
"131996",1,0,0,1,"dummy"
"132001",1,2,0,3,"dummy"
"132037",1,10,3,14,"dummy"
"132038",0,0,1,1,"dummy"
"132039",7,12,4,23,"dummy"
"132040",4,4,0,8,"dummy"
"132043",0,1,0,1,"dummy"
"132044",0,2,1,3,"dummy"
"132058",0,1,0,1,"dummy"
"132059",1,1,2,4,"dummy"
"132071",0,0,1,1,"dummy"
"132090",1,0,0,1,"dummy"
"132093",0,5,0,5,"dummy"
"132103",5,2,0,7,"dummy"
"132104",0,2,0,2,"dummy"
"132105",1,0,0,1,"dummy"
"132106",1,0,0,1,"dummy"
"132137",0,0,1,1,"dummy"
"132138",3,3,1,7,"dummy"
"132139",2,2,1,5,"dummy"
"132142",2,0,1,3,"dummy"
"132143",0,0,1,1,"dummy"
"132150",0,0,1,1,"dummy"
"132151",0,5,0,5,"dummy"
"132152",0,0,0,0,"dummy"
"132153",0,2,0,2,"dummy"
"132157",3,4,3,10,"dummy"
"132158",4,1,0,5,"dummy"
"132159",1,4,0,5,"dummy"
"132160",0,1,2,3,"dummy"
"132161",1,0,0,1,"dummy"
"132176",0,0,0,0,"dummy"
"132184",0,0,2,2,"dummy"
"132187",0,1,1,2,"dummy"
"132190",0,0,0,0,"dummy"
"132191",19,0,1,20,"dummy"
"132192",0,0,1,1,"dummy"
"132193",0,2,1,3,"dummy"
"132194",1,0,0,1,"dummy"
"132198",0,0,2,2,"dummy"
"132207",0,0,1,1,"dummy"
"132208",0,0,1,1,"dummy"
"132209",0,0,1,1,"dummy"
"132210",0,0,1,1,"dummy"
"132214",4,10,0,14,"dummy"
"132215",1,0,0,1,"dummy"
"132216",1,2,0,3,"dummy"
"132217",1,0,1,2,"dummy"
"132218",1,1,0,2,"dummy"
"132230",0,0,2,2,"dummy"
"132237",0,0,0,0,"dummy"
"132238",0,0,0,0,"dummy"
"131956",0,6,1,7,"dummy"
"131957",2,0,0,2,"dummy"
"131958",4,0,0,4,"dummy"
"131959",0,3,0,3,"dummy"
"131960",0,1,0,1,"dummy"
"131961",4,0,0,4,"dummy"
"131962",1,3,0,4,"dummy"
"131963",0,0,1,1,"dummy"
"131964",2,0,0,2,"dummy"
"131965",4,0,0,4,"dummy"
"131966",0,5,0,5,"dummy"
"131967",0,1,0,1,"dummy"
"131968",2,0,0,2,"dummy"
"131969",6,6,1,13,"dummy"
"131970",2,0,0,2,"dummy"
"131971",4,2,1,7,"dummy"
"131972",0,0,1,1,"dummy"
"131973",0,2,0,2,"dummy"
"131976",0,13,1,14,"dummy"
"131977",0,1,0,1,"dummy"
"131978",1,4,0,5,"dummy"
"131979",5,6,0,11,"dummy"
"131980",3,0,0,3,"dummy"
"131981",1,1,0,2,"dummy"
"131982",2,0,0,2,"dummy"
"131990",0,1,0,1,"dummy"
"131991",6,4,2,12,"dummy"
"132007",0,0,2,2,"dummy"
"132008",0,0,1,1,"dummy"
"132009",0,0,1,1,"dummy"
"132010",0,1,0,1,"dummy"
"132011",1,0,1,2,"dummy"
"132012",0,1,0,1,"dummy"
"132013",1,0,0,1,"dummy"
"132014",3,2,1,6,"dummy"
"132015",0,0,0,0,"dummy"
"132016",0,0,0,0,"dummy"
"132017",0,0,1,1,"dummy"
"132018",0,0,1,1,"dummy"
"132019",0,0,2,2,"dummy"
"132020",0,0,1,1,"dummy"
"132021",0,1,0,1,"dummy"
"132022",0,0,1,1,"dummy"
"132023",0,0,1,1,"dummy"
"132024",0,0,1,1,"dummy"
"132025",0,0,1,1,"dummy"
"132026",0,0,1,1,"dummy"
"132027",0,0,2,2,"dummy"
"132028",0,0,1,1,"dummy"
"132029",3,0,0,3,"dummy"
"132030",0,0,1,1,"dummy"
"132031",0,0,1,1,"dummy"
"132032",0,0,1,1,"dummy"
"132033",0,0,1,1,"dummy"
"132034",0,0,1,1,"dummy"
"132035",0,0,1,1,"dummy"
"132073",0,0,2,2,"dummy"
"132074",0,2,0,2,"dummy"
"132075",0,2,0,2,"dummy"
"132076",0,0,1,1,"dummy"
"132077",0,13,0,13,"dummy"
"132078",0,0,0,0,"dummy"
"132079",7,5,4,16,"dummy"
"132101",2,0,2,4,"dummy"
"132112",9,25,1,35,"dummy"
"132113",1,2,2,5,"dummy"
"132114",0,0,0,0,"dummy"
"132115",0,0,1,1,"dummy"
"132116",0,0,1,1,"dummy"
"132117",0,0,1,1,"dummy"
"132118",0,0,1,1,"dummy"
"132119",0,2,0,2,"dummy"
"132120",2,2,0,4,"dummy"
"132121",1,4,0,5,"dummy"
"132122",0,2,0,2,"dummy"
"132123",26,19,5,50,"dummy"
"132124",13,15,3,31,"dummy"
"132125",15,1,1,17,"dummy"
"132126",1,5,0,6,"dummy"
"132127",0,2,0,2,"dummy"
"132128",8,16,1,25,"dummy"
"132133",0,0,2,2,"dummy"
"132134",3,3,0,6,"dummy"
"132135",0,0,4,4,"dummy"
"132155",2,2,0,4,"dummy"
"132163",0,0,0,0,"dummy"
"132164",1,0,0,1,"dummy"
"132171",0,0,1,1,"dummy"
"132172",0,0,1,1,"dummy"
"132178",4,13,2,19,"dummy"
"132196",0,0,1,1,"dummy"
"132200",2,1,0,3,"dummy"
"132201",0,6,0,6,"dummy"
"132202",0,0,0,0,"dummy"
"132203",2,3,0,5,"dummy"
"132212",1,2,0,3,"dummy"
"132220",0,0,1,1,"dummy"
"132221",0,0,1,1,"dummy"
"132222",0,0,1,1,"dummy"
"132223",0,0,1,1,"dummy"
"132224",0,0,1,1,"dummy"
"132225",0,0,2,2,"dummy"
"132226",0,0,0,0,"dummy"
"132227",0,0,1,1,"dummy"
"132228",0,0,1,1,"dummy"
"132232",0,1,0,1,"dummy"
"132233",0,0,0,0,"dummy"
"132240",0,1,0,1,"dummy"
"132241",5,4,0,9,"dummy"
"132242",0,8,0,8,"dummy"
"132243",2,6,0,8,"dummy"
"132244",0,1,1,2,"dummy"
"132245",1,0,0,1,"dummy"
"132246",0,1,1,2,"dummy"
"132247",0,1,0,1,"dummy"
"132248",0,0,1,1,"dummy"
"132249",3,2,0,5,"dummy"
"132250",0,1,0,1,"dummy"
"132251",0,0,1,1,"dummy"
"132252",1,6,0,7,"dummy"
"132253",0,0,1,1,"dummy"
"132254",3,3,2,8,"dummy"
"132255",1,1,1,3,"dummy"
"132256",0,1,0,1,"dummy"
"132257",0,1,1,2,"dummy"
"132258",0,1,0,1,"dummy"
"132259",0,1,0,1,"dummy"
"132260",1,0,0,1,"dummy"
"132261",0,1,0,1,"dummy"
"132262",29,1,2,32,"dummy"
"132263",0,0,1,1,"dummy"
"132264",1,0,0,1,"dummy"
"132265",0,0,1,1,"dummy"
"132266",1,0,1,2,"dummy"
"132267",0,0,0,0,"dummy"
"132268",2,0,0,2,"dummy"
"132269",0,0,2,2,"dummy"
"132270",0,0,0,0,"dummy"
"132271",0,0,2,2,"dummy"
"132272",0,0,1,1,"dummy"
"132273",0,0,1,1,"dummy"
"132274",0,1,0,1,"dummy"
"132275",1,0,0,1,"dummy"
"132276",0,3,0,3,"dummy"
"132277",0,0,1,1,"dummy"
"132278",0,1,0,1,"dummy"
"132279",0,0,0,0,"dummy"
"132280",0,0,0,0,"dummy"
"132281",0,0,2,2,"dummy"
"132282",0,0,1,1,"dummy"
"132283",0,0,1,1,"dummy"
"132284",0,0,1,1,"dummy"
"132285",0,0,1,1,"dummy"
"132286",0,0,1,1,"dummy"
"132287",0,0,1,1,"dummy"
"132288",0,0,2,2,"dummy"
"132289",0,0,2,2,"dummy"
"132290",0,0,2,2,"dummy"
"132291",0,0,2,2,"dummy"
"132292",0,0,2,2,"dummy"
"132300",0,1,0,1,"dummy"
"132301",1,0,0,1,"dummy"
"132302",0,7,0,7,"dummy"
"132303",3,16,0,19,"dummy"
"132304",0,0,0,0,"dummy"
"132305",0,0,1,1,"dummy"
"132306",0,0,1,1,"dummy"
"132307",0,0,1,1,"dummy"
"132308",4,1,1,6,"dummy"
"132309",0,8,2,10,"dummy"
"132310",0,1,0,1,"dummy"
"132311",0,1,0,1,"dummy"
"132294",0,0,1,1,"dummy"
"132297",0,0,1,1,"dummy"
"132298",0,2,1,3,"dummy"
"132312",0,0,1,1,"dummy"
"132313",0,0,1,1,"dummy"
"132314",2,3,7,12,"dummy"
"132315",0,1,0,1,"dummy"
"132316",6,8,11,25,"dummy"
"132317",0,1,0,1,"dummy"
"132318",0,2,0,2,"dummy"
"132319",0,5,0,5,"dummy"
"132320",40,4,3,47,"dummy"
"132321",0,0,0,0,"dummy"
"132322",0,0,0,0,"dummy"
"132323",0,4,0,4,"dummy"
"132324",0,2,0,2,"dummy"
"132325",0,0,0,0,"dummy"
"132326",0,0,0,0,"dummy"
"132327",0,0,0,0,"dummy"
"132328",0,0,1,1,"dummy"
"132329",4,0,1,5,"dummy"
"132330",0,0,0,0,"dummy"
"132331",0,0,0,0,"dummy"
"132332",0,0,0,0,"dummy"
"132333",0,14,0,14,"dummy"
"132334",1,3,2,6,"dummy"
"132335",0,2,0,2,"dummy"
"132336",0,0,1,1,"dummy"
"132337",0,0,0,0,"dummy"
"132338",0,0,0,0,"dummy"
"132339",0,0,0,0,"dummy"
"132340",0,0,0,0,"dummy"
"132341",0,0,0,0,"dummy"
"132342",0,0,1,1,"dummy"
"132343",0,0,1,1,"dummy"
"132346",6,0,1,7,"dummy"
"132361",1,2,0,3,"dummy"
"132362",0,0,0,0,"dummy"
"132363",0,0,1,1,"dummy"
"132364",0,1,0,1,"dummy"
"132370",0,1,0,1,"dummy"
"132371",1,1,0,2,"dummy"
"132373",0,0,1,1,"dummy"
"132376",0,1,0,1,"dummy"
"132377",0,0,1,1,"dummy"
"132378",0,0,1,1,"dummy"
"132379",0,1,0,1,"dummy"
"132380",0,1,0,1,"dummy"
"132383",0,0,1,1,"dummy"
"132384",2,0,0,2,"dummy"
"132385",0,2,0,2,"dummy"
"132387",3,3,0,6,"dummy"
"132388",0,0,0,0,"dummy"
"132390",0,0,1,1,"dummy"
"132391",0,0,1,1,"dummy"
"132392",0,0,3,3,"dummy"
"132393",0,0,1,1,"dummy"
"132394",0,0,1,1,"dummy"
"132396",0,0,1,1,"dummy"
"132397",0,0,1,1,"dummy"
"132401",7,0,1,8,"dummy"
"132403",0,0,1,1,"dummy"
"132404",0,1,0,1,"dummy"
"132405",5,3,0,8,"dummy"
"132406",1,1,1,3,"dummy"
"132407",2,4,0,6,"dummy"
"132408",6,0,0,6,"dummy"
"132409",11,22,3,36,"dummy"
"132410",7,5,3,15,"dummy"
"132411",9,8,1,18,"dummy"
"132414",0,0,1,1,"dummy"
"132415",0,0,1,1,"dummy"
"132416",0,0,1,1,"dummy"
"132417",1,3,0,4,"dummy"
"132418",5,0,0,5,"dummy"
"132420",0,1,0,1,"dummy"
"132421",0,0,1,1,"dummy"
"132422",4,2,4,10,"dummy"
"132444",0,8,0,8,"dummy"
"132445",0,5,0,5,"dummy"
"132446",0,2,0,2,"dummy"
"132447",2,1,0,3,"dummy"
"132448",0,1,1,2,"dummy"
"132449",1,2,1,4,"dummy"
"132450",0,0,1,1,"dummy"
"132454",0,0,0,0,"dummy"
"132462",4,3,4,11,"dummy"
"132463",1,0,0,1,"dummy"
"132464",3,3,2,8,"dummy"
"132468",0,0,1,1,"dummy"
"132469",1,4,2,7,"dummy"
"132470",0,1,3,4,"dummy"
"132472",0,0,1,1,"dummy"
"132474",1,0,0,1,"dummy"
"132476",7,1,0,8,"dummy"
"132477",0,0,0,0,"dummy"
"132478",0,0,0,0,"dummy"
"132480",0,0,1,1,"dummy"
"132481",2,6,5,13,"dummy"
"132482",2,2,1,5,"dummy"
"132483",0,3,0,3,"dummy"
"132484",0,0,0,0,"dummy"
"132485",0,0,0,0,"dummy"
"132488",0,2,0,2,"dummy"
"132489",0,0,1,1,"dummy"
"132490",1,2,0,3,"dummy"
"132492",0,1,0,1,"dummy"
"132493",0,1,0,1,"dummy"
"132494",0,2,0,2,"dummy"
"132499",0,0,1,1,"dummy"
"132503",0,0,1,1,"dummy"
"132504",4,0,1,5,"dummy"
"132505",0,2,1,3,"dummy"
"132506",2,0,0,2,"dummy"
"132507",0,0,1,1,"dummy"
"132509",0,2,0,2,"dummy"
"132510",0,0,0,0,"dummy"
"132511",3,2,1,6,"dummy"
"132513",0,6,0,6,"dummy"
"132514",0,6,0,6,"dummy"
"132515",0,1,1,2,"dummy"
"132516",0,1,0,1,"dummy"
"132517",0,0,1,1,"dummy"
"132518",0,0,1,1,"dummy"
"132519",0,1,0,1,"dummy"
"132520",0,1,0,1,"dummy"
"132521",0,1,0,1,"dummy"
"132522",0,1,0,1,"dummy"
"132523",1,0,0,1,"dummy"
"132524",2,0,0,2,"dummy"
"132525",4,1,0,5,"dummy"
"132527",1,0,0,1,"dummy"
"132528",2,0,1,3,"dummy"
"132529",0,0,0,0,"dummy"
"132530",0,1,0,1,"dummy"
"132531",8,1,0,9,"dummy"
"132532",0,0,0,0,"dummy"
"132533",0,0,0,0,"dummy"
"132534",1,10,0,11,"dummy"
"132535",7,1,0,8,"dummy"
"132536",2,0,3,5,"dummy"
"132539",0,0,2,2,"dummy"
"132540",0,1,0,1,"dummy"
"132541",0,0,2,2,"dummy"
"132542",0,0,2,2,"dummy"
"132543",0,0,1,1,"dummy"
"132545",0,0,2,2,"dummy"
"132546",0,5,0,5,"dummy"
"132547",1,0,0,1,"dummy"
"132548",0,2,0,2,"dummy"
"132549",0,1,0,1,"dummy"
"132551",0,1,0,1,"dummy"
"132552",0,5,0,5,"dummy"
"132553",0,0,2,2,"dummy"
"132554",0,1,0,1,"dummy"
"132555",0,3,0,3,"dummy"
"132556",0,2,0,2,"dummy"
"132557",9,6,0,15,"dummy"
"132558",0,0,1,1,"dummy"
"132559",1,0,0,1,"dummy"
"132560",0,9,0,9,"dummy"
"132561",2,1,1,4,"dummy"
"132562",0,1,2,3,"dummy"
"132569",2,0,0,2,"dummy"
"132570",3,0,2,5,"dummy"
"132586",0,0,1,1,"dummy"
"132599",4,1,0,5,"dummy"
"132614",0,3,0,3,"dummy"
"132615",3,6,4,13,"dummy"
"132616",0,3,0,3,"dummy"
"132617",0,1,0,1,"dummy"
"132620",1,0,0,1,"dummy"
"132643",0,2,0,2,"dummy"
"132644",0,1,0,1,"dummy"
"132645",1,0,0,1,"dummy"
"132646",0,1,0,1,"dummy"
"132647",0,0,0,0,"dummy"
"132648",4,1,0,5,"dummy"
"132649",1,0,0,1,"dummy"
"132650",0,0,0,0,"dummy"
"132651",0,0,0,0,"dummy"
"132660",0,1,0,1,"dummy"
"132661",26,25,9,60,"dummy"
"132662",1,1,0,2,"dummy"
"132663",8,8,0,16,"dummy"
"132664",1,2,0,3,"dummy"
"132665",4,4,0,8,"dummy"
"132666",24,29,8,61,"dummy"
"132667",1,1,1,3,"dummy"
"132668",5,1,0,6,"dummy"
"132669",34,10,5,49,"dummy"
"132670",12,24,2,38,"dummy"
"132671",0,0,1,1,"dummy"
"132672",0,8,0,8,"dummy"
"132673",5,5,0,10,"dummy"
"132674",7,1,1,9,"dummy"
"132675",2,3,0,5,"dummy"
"132678",0,0,0,0,"dummy"
"132679",0,0,1,1,"dummy"
"132680",0,0,1,1,"dummy"
"132681",0,0,0,0,"dummy"
"132682",0,0,0,0,"dummy"
"132683",0,0,0,0,"dummy"
"132684",0,0,0,0,"dummy"
"132685",0,0,0,0,"dummy"
"132686",0,0,1,1,"dummy"
"132687",0,0,0,0,"dummy"
"132695",0,0,1,1,"dummy"
"132696",0,0,1,1,"dummy"
"132697",3,2,0,5,"dummy"
"132700",6,0,0,6,"dummy"
"132701",2,5,2,9,"dummy"
"132704",1,0,0,1,"dummy"
"132705",0,1,0,1,"dummy"
"132706",0,4,0,4,"dummy"
"132707",0,2,0,2,"dummy"
"132708",0,2,0,2,"dummy"
"132709",2,2,0,4,"dummy"
"132710",4,5,1,10,"dummy"
"132729",0,1,0,1,"dummy"
"132748",0,6,0,6,"dummy"
"132749",3,4,0,7,"dummy"
"132750",1,0,0,1,"dummy"
"132751",0,0,0,0,"dummy"
"132763",3,0,1,4,"dummy"
"132768",1,1,0,2,"dummy"
"132769",1,4,0,5,"dummy"
"132776",0,1,0,1,"dummy"
"132777",0,2,0,2,"dummy"
"132778",2,0,1,3,"dummy"
"132779",0,0,1,1,"dummy"
"132784",0,0,0,0,"dummy"
"132785",0,0,1,1,"dummy"
"132564",2,3,1,6,"dummy"
"132567",0,0,1,1,"dummy"
"132580",0,0,1,1,"dummy"
"132594",0,0,0,0,"dummy"
"132595",0,0,0,0,"dummy"
"132596",0,0,0,0,"dummy"
"132597",0,0,0,0,"dummy"
"132622",3,2,0,5,"dummy"
"132623",9,3,0,12,"dummy"
"132624",1,7,0,8,"dummy"
"132625",4,7,0,11,"dummy"
"132628",0,0,2,2,"dummy"
"132631",1,3,0,4,"dummy"
"132632",0,1,0,1,"dummy"
"132633",1,0,0,1,"dummy"
"132634",1,0,0,1,"dummy"
"132635",0,1,0,1,"dummy"
"132636",0,1,0,1,"dummy"
"132639",0,2,2,4,"dummy"
"132640",0,1,0,1,"dummy"
"132641",0,0,1,1,"dummy"
"132657",0,0,1,1,"dummy"
"132658",0,0,0,0,"dummy"
"132712",0,1,0,1,"dummy"
"132713",0,0,1,1,"dummy"
"132714",1,11,0,12,"dummy"
"132719",1,0,0,1,"dummy"
"132727",0,1,0,1,"dummy"
"132738",0,6,2,8,"dummy"
"132739",0,0,2,2,"dummy"
"132740",0,0,2,2,"dummy"
"132741",0,0,2,2,"dummy"
"132744",2,7,1,10,"dummy"
"132745",0,4,1,5,"dummy"
"132746",0,1,0,1,"dummy"
"132753",2,0,0,2,"dummy"
"132754",0,0,0,0,"dummy"
"132755",0,0,0,0,"dummy"
"132756",0,0,0,0,"dummy"
"132759",9,33,0,42,"dummy"
"132760",4,8,0,12,"dummy"
"132761",3,12,0,15,"dummy"
"132765",0,0,0,0,"dummy"
"132766",0,2,0,2,"dummy"
"132771",1,8,0,9,"dummy"
"132772",5,3,1,9,"dummy"
"132793",0,0,2,2,"dummy"
"132794",1,1,0,2,"dummy"
"132795",0,0,1,1,"dummy"
"132829",3,3,0,6,"dummy"
"132830",3,1,1,5,"dummy"
"132831",5,9,4,18,"dummy"
"132853",0,1,0,1,"dummy"
"132869",0,0,1,1,"dummy"
"132870",0,2,1,3,"dummy"
"132879",0,2,0,2,"dummy"
"132880",1,1,0,2,"dummy"
"132883",0,0,1,1,"dummy"
"132786",0,1,0,1,"dummy"
"132787",9,8,1,18,"dummy"
"132788",0,2,0,2,"dummy"
"132789",1,2,0,3,"dummy"
"132797",2,1,0,3,"dummy"
"132823",0,1,2,3,"dummy"
"132824",0,0,1,1,"dummy"
"132825",1,1,0,2,"dummy"
"132855",0,1,0,1,"dummy"
"132856",3,2,0,5,"dummy"
"132857",0,1,0,1,"dummy"
"132858",0,3,0,3,"dummy"
"132859",0,0,0,0,"dummy"
"132860",3,0,0,3,"dummy"
"132861",0,0,2,2,"dummy"
"132862",0,0,1,1,"dummy"
"132863",3,1,0,4,"dummy"
"132864",0,0,1,1,"dummy"
"132865",0,0,0,0,"dummy"
"132866",0,0,0,0,"dummy"
"132867",2,4,1,7,"dummy"
"132872",0,1,0,1,"dummy"
"132873",0,0,1,1,"dummy"
"132876",2,2,0,4,"dummy"
"132877",0,0,4,4,"dummy"
"132890",0,1,1,2,"dummy"
"132893",1,0,0,1,"dummy"
"132896",0,2,0,2,"dummy"
"132900",2,3,0,5,"dummy"
"132910",0,1,0,1,"dummy"
"132911",0,1,0,1,"dummy"
"132912",0,3,0,3,"dummy"
"132913",2,0,0,2,"dummy"
"132930",0,12,8,20,"dummy"
"132931",24,22,4,50,"dummy"
"132932",9,3,2,14,"dummy"
"132933",4,3,1,8,"dummy"
"132934",4,9,1,14,"dummy"
"132935",0,0,1,1,"dummy"
"132936",0,0,1,1,"dummy"
"132939",0,0,0,0,"dummy"
"132940",0,0,0,0,"dummy"
"132941",0,0,0,0,"dummy"
"132942",0,0,0,0,"dummy"
"132943",0,0,0,0,"dummy"
"132967",0,0,2,2,"dummy"
"132982",0,0,2,2,"dummy"
"132983",0,1,2,3,"dummy"
"132995",0,0,1,1,"dummy"
"132996",0,10,0,10,"dummy"
"133002",0,0,0,0,"dummy"
"133003",0,0,2,2,"dummy"
"133009",9,22,3,34,"dummy"
"133010",0,2,0,2,"dummy"
"133011",0,2,0,2,"dummy"
"133012",9,2,2,13,"dummy"
"133013",4,2,0,6,"dummy"
"133014",0,1,0,1,"dummy"
"133015",1,7,0,8,"dummy"
"133025",3,3,0,6,"dummy"
"133026",0,0,2,2,"dummy"
"133027",2,1,0,3,"dummy"
"133028",0,0,2,2,"dummy"
"133029",7,11,1,19,"dummy"
"133030",0,1,0,1,"dummy"
"133055",0,1,1,2,"dummy"
"133056",1,0,1,2,"dummy"
"132884",0,1,0,1,"dummy"
"132885",0,0,1,1,"dummy"
"132888",2,15,2,19,"dummy"
"132898",19,1,4,24,"dummy"
"132902",0,5,0,5,"dummy"
"132905",0,2,1,3,"dummy"
"132906",0,1,0,1,"dummy"
"132915",4,14,1,19,"dummy"
"132916",0,0,1,1,"dummy"
"132919",2,0,0,2,"dummy"
"132920",0,0,0,0,"dummy"
"132923",0,3,1,4,"dummy"
"132924",0,1,0,1,"dummy"
"132927",0,0,1,1,"dummy"
"132928",0,0,1,1,"dummy"
"132947",2,0,0,2,"dummy"
"132948",0,0,1,1,"dummy"
"132949",0,1,0,1,"dummy"
"132950",2,0,0,2,"dummy"
"132951",1,6,0,7,"dummy"
"132952",0,0,4,4,"dummy"
"132958",0,0,1,1,"dummy"
"132959",0,2,1,3,"dummy"
"132960",0,1,1,2,"dummy"
"132961",0,1,1,2,"dummy"
"132964",0,0,1,1,"dummy"
"132965",0,1,0,1,"dummy"
"132975",0,0,0,0,"dummy"
"132976",0,0,0,0,"dummy"
"132977",0,0,0,0,"dummy"
"132978",0,0,0,0,"dummy"
"132979",0,0,0,0,"dummy"
"132980",0,0,0,0,"dummy"
"133005",1,3,0,4,"dummy"
"133006",14,15,2,31,"dummy"
"133007",3,5,4,12,"dummy"
"133064",0,1,0,1,"dummy"
"133077",0,1,0,1,"dummy"
"133078",0,2,0,2,"dummy"
"133099",0,0,1,1,"dummy"
"133100",0,0,1,1,"dummy"
"133101",0,1,0,1,"dummy"
"133102",1,4,2,7,"dummy"
"133110",0,0,0,0,"dummy"
"133111",0,0,0,0,"dummy"
"133209",0,0,1,1,"dummy"
"133210",1,0,0,1,"dummy"
"133211",0,0,1,1,"dummy"
"133212",1,7,2,10,"dummy"
"133213",7,2,2,11,"dummy"
"133214",0,1,0,1,"dummy"
"133215",2,4,0,6,"dummy"
"133216",0,2,0,2,"dummy"
"133059",0,0,0,0,"dummy"
"133060",4,0,0,4,"dummy"
"133061",0,1,0,1,"dummy"
"133062",0,0,0,0,"dummy"
"133066",1,3,0,4,"dummy"
"133067",0,1,0,1,"dummy"
"133068",0,1,0,1,"dummy"
"133069",1,0,0,1,"dummy"
"133070",1,0,0,1,"dummy"
"133071",1,1,0,2,"dummy"
"133072",0,1,0,1,"dummy"
"133073",1,0,0,1,"dummy"
"133074",1,0,0,1,"dummy"
"133075",0,0,1,1,"dummy"
"133080",0,4,0,4,"dummy"
"133081",0,0,0,0,"dummy"
"133084",0,1,5,6,"dummy"
"133085",0,1,0,1,"dummy"
"133088",0,1,0,1,"dummy"
"133089",0,0,1,1,"dummy"
"133090",0,0,1,1,"dummy"
"133091",0,1,1,2,"dummy"
"133092",15,13,0,28,"dummy"
"133093",7,4,0,11,"dummy"
"133094",3,4,1,8,"dummy"
"133095",0,0,2,2,"dummy"
"133113",10,34,4,48,"dummy"
"133114",1,2,0,3,"dummy"
"133115",0,7,0,7,"dummy"
"133116",3,1,0,4,"dummy"
"133117",4,1,2,7,"dummy"
"133118",15,0,2,17,"dummy"
"133119",1,2,1,4,"dummy"
"133120",0,0,1,1,"dummy"
"133150",1,1,1,3,"dummy"
"133151",0,0,0,0,"dummy"
"133152",0,1,1,2,"dummy"
"133153",0,1,0,1,"dummy"
"133154",0,0,1,1,"dummy"
"133155",0,0,1,1,"dummy"
"133156",0,0,1,1,"dummy"
"133163",0,0,1,1,"dummy"
"133171",0,17,0,17,"dummy"
"133172",0,1,4,5,"dummy"
"133173",0,0,5,5,"dummy"
"133174",0,0,1,1,"dummy"
"133175",0,0,5,5,"dummy"
"133176",0,0,1,1,"dummy"
"133177",0,0,1,1,"dummy"
"133178",2,1,0,3,"dummy"
"133179",0,0,1,1,"dummy"
"133182",0,0,0,0,"dummy"
"133183",0,0,0,0,"dummy"
"133186",0,1,0,1,"dummy"
"133187",3,4,0,7,"dummy"
"133188",0,1,0,1,"dummy"
"133189",0,1,0,1,"dummy"
"133190",5,3,1,9,"dummy"
"133191",2,0,0,2,"dummy"
"133192",0,0,1,1,"dummy"
"133195",0,0,2,2,"dummy"
"133198",0,0,0,0,"dummy"
"133199",0,3,1,4,"dummy"
"133200",2,0,0,2,"dummy"
"133201",0,1,1,2,"dummy"
"133202",0,0,3,3,"dummy"
"133203",3,0,0,3,"dummy"
"133204",0,0,0,0,"dummy"
"133205",0,0,2,2,"dummy"
"133206",0,0,1,1,"dummy"
"133207",1,0,0,1,"dummy"
"133227",0,4,0,4,"dummy"
"133244",4,0,2,6,"dummy"
"133245",0,0,1,1,"dummy"
"133271",1,0,0,1,"dummy"
"133275",0,2,1,3,"dummy"
"133278",0,0,1,1,"dummy"
"133217",1,0,0,1,"dummy"
"133218",1,0,1,2,"dummy"
"133219",0,0,0,0,"dummy"
"133222",2,1,0,3,"dummy"
"133223",1,0,0,1,"dummy"
"133224",1,0,0,1,"dummy"
"133225",0,0,1,1,"dummy"
"133231",1,6,0,7,"dummy"
"133232",2,2,0,4,"dummy"
"133233",8,4,0,12,"dummy"
"133234",0,0,0,0,"dummy"
"133235",0,3,0,3,"dummy"
"133236",0,2,1,3,"dummy"
"133237",6,0,2,8,"dummy"
"133238",0,0,7,7,"dummy"
"133239",10,0,0,10,"dummy"
"133240",0,2,0,2,"dummy"
"133241",3,15,2,20,"dummy"
"133242",1,2,0,3,"dummy"
"133247",1,2,0,3,"dummy"
"133255",0,1,0,1,"dummy"
"133256",4,0,3,7,"dummy"
"133257",0,3,3,6,"dummy"
"133258",3,0,2,5,"dummy"
"133259",0,0,1,1,"dummy"
"133273",0,0,0,0,"dummy"
"133280",0,0,1,1,"dummy"
"133312",0,2,0,2,"dummy"
"133321",1,1,0,2,"dummy"
"133322",1,1,0,2,"dummy"
"133323",1,0,0,1,"dummy"
"133324",0,4,0,4,"dummy"
"133325",4,0,0,4,"dummy"
"133326",1,1,0,2,"dummy"
"133327",0,0,0,0,"dummy"
"133335",0,2,0,2,"dummy"
"133339",0,1,0,1,"dummy"
"133361",0,1,0,1,"dummy"
"133362",0,6,0,6,"dummy"
"133363",1,0,0,1,"dummy"
"133388",0,1,1,2,"dummy"
"133389",15,0,2,17,"dummy"
"133390",0,1,1,2,"dummy"
"133391",0,0,1,1,"dummy"
"133392",1,0,1,2,"dummy"
"133393",0,0,1,1,"dummy"
"133394",0,0,1,1,"dummy"
"133418",0,1,0,1,"dummy"
"133425",0,0,1,1,"dummy"
"133426",0,4,0,4,"dummy"
"133427",0,1,2,3,"dummy"
"133428",1,0,1,2,"dummy"
"133429",0,1,1,2,"dummy"
"133430",0,0,1,1,"dummy"
"133431",0,1,0,1,"dummy"
"133434",0,1,0,1,"dummy"
"133448",3,1,0,4,"dummy"
"133449",5,7,3,15,"dummy"
"133450",0,1,0,1,"dummy"
"133451",3,2,1,6,"dummy"
"133456",0,7,4,11,"dummy"
"133461",2,4,1,7,"dummy"
"133462",17,11,2,30,"dummy"
"133284",0,0,1,1,"dummy"
"133285",0,0,1,1,"dummy"
"133288",0,0,1,1,"dummy"
"133289",0,1,1,2,"dummy"
"133290",0,0,2,2,"dummy"
"133291",0,0,1,1,"dummy"
"133292",2,3,3,8,"dummy"
"133293",0,1,3,4,"dummy"
"133294",1,0,0,1,"dummy"
"133295",0,1,1,2,"dummy"
"133296",3,1,1,5,"dummy"
"133297",0,1,0,1,"dummy"
"133302",2,4,0,6,"dummy"
"133303",0,2,0,2,"dummy"
"133304",0,2,0,2,"dummy"
"133305",10,2,0,12,"dummy"
"133306",0,2,0,2,"dummy"
"133307",0,0,0,0,"dummy"
"133308",0,0,3,3,"dummy"
"133309",0,5,0,5,"dummy"
"133310",1,0,1,2,"dummy"
"133314",5,20,5,30,"dummy"
"133315",0,0,0,0,"dummy"
"133316",1,0,1,2,"dummy"
"133317",0,0,3,3,"dummy"
"133329",0,4,0,4,"dummy"
"133330",0,0,3,3,"dummy"
"133331",0,1,0,1,"dummy"
"133332",0,1,0,1,"dummy"
"133333",3,1,1,5,"dummy"
"133337",21,6,1,28,"dummy"
"133341",7,1,2,10,"dummy"
"133342",0,0,3,3,"dummy"
"133345",0,0,0,0,"dummy"
"133346",0,0,0,0,"dummy"
"133347",0,1,0,1,"dummy"
"133350",0,1,0,1,"dummy"
"133365",0,0,1,1,"dummy"
"133368",0,0,1,1,"dummy"
"133369",0,0,1,1,"dummy"
"133370",0,1,0,1,"dummy"
"133398",0,1,0,1,"dummy"
"133409",0,0,1,1,"dummy"
"133410",0,0,1,1,"dummy"
"133411",4,2,1,7,"dummy"
"133412",0,0,2,2,"dummy"
"133413",0,0,1,1,"dummy"
"133414",0,0,1,1,"dummy"
"133415",0,0,1,1,"dummy"
"133416",0,0,1,1,"dummy"
"133420",0,6,0,6,"dummy"
"133421",3,3,0,6,"dummy"
"133422",5,2,0,7,"dummy"
"133423",0,0,5,5,"dummy"
"133436",0,0,1,1,"dummy"
"133445",0,0,1,1,"dummy"
"133446",0,0,1,1,"dummy"
"133453",0,0,0,0,"dummy"
"133454",0,0,0,0,"dummy"
"133458",0,0,0,0,"dummy"
"133459",0,0,0,0,"dummy"
"133464",1,0,0,1,"dummy"
"133467",1,2,0,3,"dummy"
"133468",0,0,1,1,"dummy"
"133471",0,12,0,12,"dummy"
"133474",0,1,2,3,"dummy"
"133478",0,1,0,1,"dummy"
"133484",5,0,0,5,"dummy"
"133485",0,0,1,1,"dummy"
"133488",0,0,0,0,"dummy"
"133489",0,0,0,0,"dummy"
"133492",0,2,0,2,"dummy"
"133493",0,0,2,2,"dummy"
"133494",0,0,1,1,"dummy"
"133495",0,0,1,1,"dummy"
"133496",0,0,1,1,"dummy"
"133497",0,7,1,8,"dummy"
"133498",0,13,1,14,"dummy"
"133499",0,4,0,4,"dummy"
"133500",25,0,0,25,"dummy"
"133501",8,2,0,10,"dummy"
"133507",0,0,2,2,"dummy"
"133508",2,0,0,2,"dummy"
"133510",3,0,5,8,"dummy"
"133511",0,0,1,1,"dummy"
"133512",0,2,0,2,"dummy"
"133518",3,6,0,9,"dummy"
"133519",0,0,2,2,"dummy"
"133520",0,0,0,0,"dummy"
"133521",0,1,0,1,"dummy"
"133522",0,1,0,1,"dummy"
"133527",2,9,1,12,"dummy"
"133528",0,1,0,1,"dummy"
"133529",0,0,1,1,"dummy"
"133530",0,6,1,7,"dummy"
"133531",1,0,0,1,"dummy"
"133533",1,0,1,2,"dummy"
"133534",1,0,0,1,"dummy"
"133535",0,1,1,2,"dummy"
"133536",5,11,0,16,"dummy"
"133537",0,0,1,1,"dummy"
"133538",0,0,1,1,"dummy"
"133539",0,0,1,1,"dummy"
"133540",0,1,0,1,"dummy"
"133541",0,3,0,3,"dummy"
"133542",0,0,1,1,"dummy"
"133544",1,4,0,5,"dummy"
"133545",0,3,1,4,"dummy"
"133546",0,0,0,0,"dummy"
"133547",8,0,0,8,"dummy"
"133548",0,4,0,4,"dummy"
"133550",2,0,0,2,"dummy"
"133551",1,3,2,6,"dummy"
"133552",0,1,0,1,"dummy"
"133553",1,0,0,1,"dummy"
"133554",0,2,0,2,"dummy"
"133555",0,2,0,2,"dummy"
"133556",0,4,0,4,"dummy"
"133557",0,2,2,4,"dummy"
"133559",0,1,0,1,"dummy"
"133560",0,2,0,2,"dummy"
"133561",5,2,1,8,"dummy"
"133562",0,0,0,0,"dummy"
"133563",0,0,3,3,"dummy"
"133564",0,0,0,0,"dummy"
"133565",0,0,0,0,"dummy"
"133568",2,6,1,9,"dummy"
"133569",3,1,0,4,"dummy"
"133570",6,1,0,7,"dummy"
"133571",0,0,3,3,"dummy"
"133572",0,2,1,3,"dummy"
"133573",0,1,0,1,"dummy"
"133574",1,2,3,6,"dummy"
"133576",0,5,0,5,"dummy"
"133577",1,1,0,2,"dummy"
"133578",2,0,2,4,"dummy"
"133584",0,1,1,2,"dummy"
"133585",0,1,2,3,"dummy"
"133586",0,1,0,1,"dummy"
"133587",0,0,3,3,"dummy"
"133589",0,0,1,1,"dummy"
"133591",0,8,0,8,"dummy"
"133593",7,7,2,16,"dummy"
"133594",0,0,3,3,"dummy"
"133595",0,1,0,1,"dummy"
"133596",1,1,0,2,"dummy"
"133610",0,0,1,1,"dummy"
"133611",0,0,1,1,"dummy"
"133612",0,1,0,1,"dummy"
"133613",0,1,0,1,"dummy"
"133616",0,0,2,2,"dummy"
"133617",0,3,0,3,"dummy"
"133618",0,0,1,1,"dummy"
"133620",0,0,1,1,"dummy"
"133621",0,1,0,1,"dummy"
"133622",0,0,1,1,"dummy"
"133623",16,0,0,16,"dummy"
"133624",0,1,0,1,"dummy"
"133625",16,22,1,39,"dummy"
"133626",0,0,1,1,"dummy"
"133630",4,20,1,25,"dummy"
"133631",0,2,0,2,"dummy"
"133634",0,1,0,1,"dummy"
"133635",1,0,0,1,"dummy"
"133636",0,1,0,1,"dummy"
"133637",0,1,0,1,"dummy"
"133638",0,0,1,1,"dummy"
"133639",0,0,0,0,"dummy"
"133640",0,0,0,0,"dummy"
"133641",0,0,1,1,"dummy"
"133642",0,0,1,1,"dummy"
"133643",0,0,1,1,"dummy"
"133644",1,1,0,2,"dummy"
"133645",0,7,3,10,"dummy"
"133646",0,0,0,0,"dummy"
"133647",1,0,0,1,"dummy"
"133648",0,0,0,0,"dummy"
"133649",1,0,0,1,"dummy"
"133650",0,0,2,2,"dummy"
"133651",0,1,1,2,"dummy"
"133654",0,13,2,15,"dummy"
"133656",3,2,0,5,"dummy"
"133658",0,3,0,3,"dummy"
"133670",0,5,0,5,"dummy"
"133671",0,0,1,1,"dummy"
"133672",0,0,2,2,"dummy"
"133673",0,0,1,1,"dummy"
"133674",1,0,0,1,"dummy"
"133680",0,2,0,2,"dummy"
"133681",0,1,0,1,"dummy"
"133682",2,0,1,3,"dummy"
"133683",0,0,1,1,"dummy"
"133684",0,0,1,1,"dummy"
"133685",0,0,1,1,"dummy"
"133686",0,1,3,4,"dummy"
"133687",1,0,1,2,"dummy"
"133688",0,4,0,4,"dummy"
"133689",0,0,0,0,"dummy"
"133690",4,0,0,4,"dummy"
"133692",0,1,0,1,"dummy"
"133693",0,4,0,4,"dummy"
"133694",0,1,0,1,"dummy"
"133709",0,0,3,3,"dummy"
"133710",17,33,2,52,"dummy"
"133712",0,0,1,1,"dummy"
"133713",0,0,1,1,"dummy"
"133714",0,1,1,2,"dummy"
"133715",0,2,0,2,"dummy"
"133716",0,0,1,1,"dummy"
"133717",0,1,3,4,"dummy"
"133718",0,0,1,1,"dummy"
"133720",0,1,1,2,"dummy"
"133724",0,0,1,1,"dummy"
"133725",21,20,1,42,"dummy"
"133727",0,0,5,5,"dummy"
"133729",1,0,0,1,"dummy"
"133733",0,0,1,1,"dummy"
"133734",0,0,0,0,"dummy"
"133735",0,0,0,0,"dummy"
"133738",0,8,0,8,"dummy"
"133739",0,0,0,0,"dummy"
"133740",0,2,0,2,"dummy"
"133741",2,1,1,4,"dummy"
"133742",2,0,1,3,"dummy"
"133743",0,2,0,2,"dummy"
"133746",0,3,0,3,"dummy"
"133747",0,0,0,0,"dummy"
"133753",0,0,1,1,"dummy"
"133754",0,2,0,2,"dummy"
"133760",0,0,1,1,"dummy"
"133761",0,0,1,1,"dummy"
"133763",1,0,0,1,"dummy"
"133764",1,0,0,1,"dummy"
"133765",0,0,0,0,"dummy"
"133766",1,0,0,1,"dummy"
"133769",11,1,0,12,"dummy"
"133770",0,2,0,2,"dummy"
"133773",0,0,0,0,"dummy"
"133781",5,4,2,11,"dummy"
"133782",4,5,2,11,"dummy"
"133783",1,1,0,2,"dummy"
"133784",0,0,0,0,"dummy"
"133785",0,0,3,3,"dummy"
"133786",0,0,0,0,"dummy"
"133787",4,2,1,7,"dummy"
"133788",3,3,2,8,"dummy"
"133789",0,1,0,1,"dummy"
"133790",0,0,2,2,"dummy"
"133792",0,5,0,5,"dummy"
"133793",0,0,0,0,"dummy"
"133794",1,4,0,5,"dummy"
"133795",0,0,3,3,"dummy"
"133798",0,1,1,2,"dummy"
"133799",0,1,1,2,"dummy"
"133800",0,5,7,12,"dummy"
"133801",0,6,0,6,"dummy"
"133802",1,0,2,3,"dummy"
"133804",0,1,1,2,"dummy"
"133805",1,0,0,1,"dummy"
"133806",0,1,0,1,"dummy"
"133808",0,34,0,34,"dummy"
"133809",2,7,0,9,"dummy"
"133810",1,0,0,1,"dummy"
"133811",1,0,0,1,"dummy"
"133812",29,29,1,59,"dummy"
"133813",3,3,0,6,"dummy"
"133814",2,1,0,3,"dummy"
"133815",4,4,0,8,"dummy"
"133816",16,17,0,33,"dummy"
"133817",0,0,2,2,"dummy"
"133818",0,0,2,2,"dummy"
"133819",0,2,1,3,"dummy"
"133820",0,0,2,2,"dummy"
"133821",0,0,2,2,"dummy"
"133822",0,0,1,1,"dummy"
"133824",0,2,0,2,"dummy"
"133825",0,2,0,2,"dummy"
"133828",0,0,1,1,"dummy"
"133838",0,0,2,2,"dummy"
"133839",2,1,0,3,"dummy"
"133840",0,0,1,1,"dummy"
"133841",7,8,3,18,"dummy"
"133842",0,0,0,0,"dummy"
"133843",0,0,3,3,"dummy"
"133844",0,0,3,3,"dummy"
"133845",0,0,0,0,"dummy"
"133846",12,0,0,12,"dummy"
"133847",0,1,0,1,"dummy"
"133848",1,0,3,4,"dummy"
"133849",0,1,0,1,"dummy"
"133850",0,0,1,1,"dummy"
"133851",0,0,3,3,"dummy"
"133852",0,0,1,1,"dummy"
"133853",0,0,3,3,"dummy"
"133854",0,5,0,5,"dummy"
"133855",5,4,0,9,"dummy"
"133858",0,2,0,2,"dummy"
"133859",0,2,1,3,"dummy"
"133860",10,24,1,35,"dummy"
"133861",1,10,1,12,"dummy"
"133862",0,1,0,1,"dummy"
"133863",1,1,0,2,"dummy"
"133869",0,0,1,1,"dummy"
"133870",0,1,0,1,"dummy"
"133871",2,2,0,4,"dummy"
"133879",1,6,0,7,"dummy"
"133880",1,0,0,1,"dummy"
"133881",2,16,2,20,"dummy"
"133882",0,12,2,14,"dummy"
"133883",0,1,0,1,"dummy"
"133884",0,0,1,1,"dummy"
"133885",0,1,0,1,"dummy"
"133886",0,0,1,1,"dummy"
"133887",0,1,0,1,"dummy"
"133888",23,1,2,26,"dummy"
"133889",0,0,1,1,"dummy"
"133890",0,0,1,1,"dummy"
"133893",0,3,0,3,"dummy"
"133894",1,0,0,1,"dummy"
"133895",0,0,1,1,"dummy"
"133896",0,0,0,0,"dummy"
"133917",1,2,0,3,"dummy"
"133918",0,0,1,1,"dummy"
"133922",0,2,0,2,"dummy"
"133923",0,2,0,2,"dummy"
"133924",0,2,0,2,"dummy"
"133925",0,1,1,2,"dummy"
"133926",6,1,1,8,"dummy"
"133927",0,5,0,5,"dummy"
"133928",0,1,0,1,"dummy"
"133929",4,0,0,4,"dummy"
"133930",2,0,1,3,"dummy"
"133931",0,2,0,2,"dummy"
"133932",0,0,1,1,"dummy"
"133933",0,1,0,1,"dummy"
"133942",0,0,1,1,"dummy"
"133943",0,0,2,2,"dummy"
"133944",0,0,1,1,"dummy"
"133977",0,1,0,1,"dummy"
"133978",0,1,0,1,"dummy"
"133995",1,1,0,2,"dummy"
"133996",0,0,0,0,"dummy"
"133997",0,1,0,1,"dummy"
"134007",2,1,1,4,"dummy"
"134008",0,0,1,1,"dummy"
"134012",0,1,0,1,"dummy"
"134013",1,0,0,1,"dummy"
"134014",7,1,0,8,"dummy"
"134015",0,0,1,1,"dummy"
"134020",0,2,0,2,"dummy"
"134036",0,0,1,1,"dummy"
"134037",0,0,1,1,"dummy"
"134038",0,2,2,4,"dummy"
"134039",1,0,2,3,"dummy"
"134048",0,1,1,2,"dummy"
"133867",1,0,0,1,"dummy"
"133875",0,1,0,1,"dummy"
"133900",0,0,0,0,"dummy"
"133901",0,0,1,1,"dummy"
"133902",3,2,0,5,"dummy"
"133903",0,0,1,1,"dummy"
"133904",0,1,0,1,"dummy"
"133905",0,2,0,2,"dummy"
"133906",0,0,0,0,"dummy"
"133907",0,0,2,2,"dummy"
"133908",0,0,0,0,"dummy"
"133909",4,1,0,5,"dummy"
"133910",1,0,0,1,"dummy"
"133911",0,0,0,0,"dummy"
"133912",1,4,0,5,"dummy"
"133913",0,0,0,0,"dummy"
"133920",0,0,1,1,"dummy"
"133935",0,0,1,1,"dummy"
"133938",2,1,4,7,"dummy"
"133939",0,0,3,3,"dummy"
"133940",0,0,1,1,"dummy"
"133948",2,2,2,6,"dummy"
"133949",0,1,0,1,"dummy"
"133950",0,2,0,2,"dummy"
"133953",2,10,0,12,"dummy"
"133956",0,0,0,0,"dummy"
"133957",0,0,0,0,"dummy"
"133958",0,0,1,1,"dummy"
"133959",1,0,0,1,"dummy"
"133960",0,0,0,0,"dummy"
"133961",0,0,0,0,"dummy"
"133962",0,0,0,0,"dummy"
"133963",0,0,0,0,"dummy"
"133964",0,0,1,1,"dummy"
"133965",0,0,0,0,"dummy"
"133966",0,0,0,0,"dummy"
"133973",0,0,1,1,"dummy"
"133974",1,0,1,2,"dummy"
"133975",0,0,1,1,"dummy"
"133980",0,0,0,0,"dummy"
"133983",0,0,1,1,"dummy"
"133984",0,2,0,2,"dummy"
"133985",4,14,2,20,"dummy"
"133990",0,0,1,1,"dummy"
"134022",2,3,2,7,"dummy"
"134025",0,0,1,1,"dummy"
"134034",0,0,1,1,"dummy"
"134045",0,3,1,4,"dummy"
"134046",11,2,0,13,"dummy"
"134050",0,0,2,2,"dummy"
"134051",0,0,2,2,"dummy"
"134052",1,2,2,5,"dummy"
"134053",0,2,1,3,"dummy"
"134054",0,1,0,1,"dummy"
"134055",0,1,0,1,"dummy"
"134056",4,2,1,7,"dummy"
"134061",0,1,0,1,"dummy"
"134087",4,6,0,10,"dummy"
"134090",0,1,0,1,"dummy"
"134091",6,6,1,13,"dummy"
"134092",2,2,2,6,"dummy"
"134093",0,1,0,1,"dummy"
"134094",0,1,0,1,"dummy"
"134108",2,0,0,2,"dummy"
"134109",0,0,0,0,"dummy"
"134115",1,1,1,3,"dummy"
"134058",1,3,0,4,"dummy"
"134059",2,4,2,8,"dummy"
"134085",0,0,1,1,"dummy"
"134096",0,2,0,2,"dummy"
"134097",0,2,0,2,"dummy"
"134098",3,3,1,7,"dummy"
"134099",0,2,1,3,"dummy"
"134100",0,0,2,2,"dummy"
"134101",5,5,1,11,"dummy"
"134102",4,2,0,6,"dummy"
"134103",5,5,0,10,"dummy"
"134104",0,0,1,1,"dummy"
"134105",4,1,2,7,"dummy"
"134106",0,0,1,1,"dummy"
"134113",0,4,0,4,"dummy"
"134117",5,3,0,8,"dummy"
"134118",2,2,0,4,"dummy"
"134130",0,1,2,3,"dummy"
"134131",0,2,0,2,"dummy"
"134132",1,1,1,3,"dummy"
"134133",0,1,0,1,"dummy"
"134134",0,0,1,1,"dummy"
"134152",0,1,0,1,"dummy"
"134153",0,0,1,1,"dummy"
"134158",0,3,0,3,"dummy"
"134159",0,1,0,1,"dummy"
"134160",2,1,1,4,"dummy"
"134161",1,0,0,1,"dummy"
"134162",0,0,1,1,"dummy"
"134201",0,0,2,2,"dummy"
"134202",0,0,1,1,"dummy"
"134203",0,0,1,1,"dummy"
"134204",0,1,0,1,"dummy"
"134205",0,0,1,1,"dummy"
"134206",0,0,1,1,"dummy"
"134211",0,3,0,3,"dummy"
"134212",0,0,2,2,"dummy"
"134213",0,18,0,18,"dummy"
"134214",0,0,0,0,"dummy"
"134215",9,5,5,19,"dummy"
"134216",0,0,5,5,"dummy"
"134217",0,1,0,1,"dummy"
"134218",4,4,0,8,"dummy"
"134219",0,4,1,5,"dummy"
"134220",0,0,1,1,"dummy"
"134221",0,3,1,4,"dummy"
"134222",0,1,0,1,"dummy"
"134223",0,3,0,3,"dummy"
"134228",4,0,0,4,"dummy"
"134229",0,0,1,1,"dummy"
"134243",4,13,2,19,"dummy"
"134244",0,1,1,2,"dummy"
"134245",1,4,0,5,"dummy"
"134246",0,8,3,11,"dummy"
"134247",12,0,1,13,"dummy"
"134250",0,1,0,1,"dummy"
"134251",0,2,1,3,"dummy"
"134252",0,1,0,1,"dummy"
"134128",0,7,0,7,"dummy"
"134138",6,0,0,6,"dummy"
"134139",3,1,3,7,"dummy"
"134140",0,1,0,1,"dummy"
"134141",0,1,0,1,"dummy"
"134142",0,2,0,2,"dummy"
"134143",0,0,1,1,"dummy"
"134144",10,11,3,24,"dummy"
"134145",4,0,0,4,"dummy"
"134146",2,10,1,13,"dummy"
"134149",0,1,0,1,"dummy"
"134150",0,1,1,2,"dummy"
"134164",1,4,1,6,"dummy"
"134187",2,2,0,4,"dummy"
"134188",0,0,0,0,"dummy"
"134189",2,1,5,8,"dummy"
"134190",0,0,2,2,"dummy"
"134199",2,2,0,4,"dummy"
"134225",8,5,1,14,"dummy"
"134226",2,5,0,7,"dummy"
"134231",0,1,0,1,"dummy"
"134234",4,2,2,8,"dummy"
"134235",0,1,0,1,"dummy"
"134254",0,7,4,11,"dummy"
"134255",1,6,0,7,"dummy"
"134256",0,11,0,11,"dummy"
"134257",3,1,1,5,"dummy"
"134258",1,3,0,4,"dummy"
"134259",9,0,0,9,"dummy"
"134260",18,21,5,44,"dummy"
"134261",0,2,0,2,"dummy"
"134271",3,1,1,5,"dummy"
"134277",0,0,1,1,"dummy"
"134283",0,0,1,1,"dummy"
"134284",0,2,0,2,"dummy"
"134285",1,1,0,2,"dummy"
"134290",0,0,0,0,"dummy"
"134291",0,3,0,3,"dummy"
"134292",0,10,0,10,"dummy"
"134293",0,1,0,1,"dummy"
"134294",0,0,0,0,"dummy"
"134297",0,0,1,1,"dummy"
"134298",2,1,1,4,"dummy"
"134308",0,0,1,1,"dummy"
"134309",0,0,1,1,"dummy"
"134314",0,6,1,7,"dummy"
"134315",0,0,2,2,"dummy"
"134316",5,7,0,12,"dummy"
"134317",0,1,0,1,"dummy"
"134318",0,0,1,1,"dummy"
"134319",11,8,4,23,"dummy"
"134320",0,3,0,3,"dummy"
"134327",0,2,0,2,"dummy"
"134328",1,3,1,5,"dummy"
"134329",3,1,0,4,"dummy"
"134342",0,1,0,1,"dummy"
"134358",0,1,0,1,"dummy"
"134359",4,4,1,9,"dummy"
"134360",0,0,0,0,"dummy"
"134361",4,4,0,8,"dummy"
"134362",0,1,0,1,"dummy"
"134363",0,3,0,3,"dummy"
"134364",0,2,0,2,"dummy"
"134365",0,2,2,4,"dummy"
"134366",2,0,0,2,"dummy"
"134367",0,2,0,2,"dummy"
"134368",0,2,0,2,"dummy"
"134369",1,12,0,13,"dummy"
"134370",2,0,0,2,"dummy"
"134267",0,0,1,1,"dummy"
"134268",1,0,1,2,"dummy"
"134269",0,1,0,1,"dummy"
"134273",0,0,1,1,"dummy"
"134274",11,0,2,13,"dummy"
"134275",0,1,0,1,"dummy"
"134281",0,2,0,2,"dummy"
"134322",0,0,2,2,"dummy"
"134323",6,12,3,21,"dummy"
"134331",0,1,1,2,"dummy"
"134338",0,0,0,0,"dummy"
"134339",0,3,0,3,"dummy"
"134340",0,9,4,13,"dummy"
"134344",0,0,1,1,"dummy"
"134349",2,4,0,6,"dummy"
"134350",0,2,0,2,"dummy"
"134351",0,2,0,2,"dummy"
"134352",10,2,0,12,"dummy"
"134353",0,2,0,2,"dummy"
"134374",3,2,0,5,"dummy"
"134375",4,5,5,14,"dummy"
"134376",0,0,2,2,"dummy"
"134377",0,0,1,1,"dummy"
"134378",0,5,5,10,"dummy"
"134379",2,9,3,14,"dummy"
"134380",0,0,1,1,"dummy"
"134381",1,9,2,12,"dummy"
"134382",3,0,0,3,"dummy"
"134383",1,0,0,1,"dummy"
"134384",0,5,1,6,"dummy"
"134385",2,2,0,4,"dummy"
"134392",0,0,0,0,"dummy"
"134393",0,0,0,0,"dummy"
"134404",0,11,0,11,"dummy"
"134409",0,2,2,4,"dummy"
"134410",0,3,2,5,"dummy"
"134411",0,0,1,1,"dummy"
"134416",0,0,2,2,"dummy"
"134423",0,0,3,3,"dummy"
"134424",5,5,1,11,"dummy"
"134425",0,0,3,3,"dummy"
"134426",1,1,1,3,"dummy"
"134443",0,0,0,0,"dummy"
"134444",0,0,0,0,"dummy"
"134454",0,2,0,2,"dummy"
"134455",10,0,2,12,"dummy"
"134456",0,6,0,6,"dummy"
"134457",0,4,1,5,"dummy"
"134458",3,1,0,4,"dummy"
"134459",2,2,2,6,"dummy"
"134460",0,0,1,1,"dummy"
"134461",0,1,0,1,"dummy"
"134462",0,0,1,1,"dummy"
"134463",1,3,1,5,"dummy"
"134464",0,1,0,1,"dummy"
"134465",0,0,0,0,"dummy"
"134515",0,1,0,1,"dummy"
"134527",5,5,2,12,"dummy"
"134528",1,1,0,2,"dummy"
"134529",5,6,0,11,"dummy"
"134530",1,2,0,3,"dummy"
"134531",0,1,0,1,"dummy"
"134532",0,2,0,2,"dummy"
"134533",0,0,0,0,"dummy"
"134534",2,0,0,2,"dummy"
"134537",1,1,0,2,"dummy"
"134538",1,1,0,2,"dummy"
"134547",0,2,0,2,"dummy"
"134548",2,0,0,2,"dummy"
"134389",3,1,1,5,"dummy"
"134390",0,4,1,5,"dummy"
"134395",0,0,1,1,"dummy"
"134396",0,0,1,1,"dummy"
"134399",2,0,3,5,"dummy"
"134400",1,0,0,1,"dummy"
"134401",0,1,0,1,"dummy"
"134402",0,1,1,2,"dummy"
"134413",3,5,1,9,"dummy"
"134414",7,7,1,15,"dummy"
"134469",0,2,0,2,"dummy"
"134470",8,0,0,8,"dummy"
"134471",0,2,1,3,"dummy"
"134472",7,47,4,58,"dummy"
"134473",0,5,1,6,"dummy"
"134476",0,7,0,7,"dummy"
"134477",0,5,0,5,"dummy"
"134478",0,3,0,3,"dummy"
"134479",18,3,0,21,"dummy"
"134480",0,15,0,15,"dummy"
"134481",0,0,1,1,"dummy"
"134482",6,5,0,11,"dummy"
"134483",29,2,0,31,"dummy"
"134486",0,0,1,1,"dummy"
"134487",4,3,1,8,"dummy"
"134488",3,3,0,6,"dummy"
"134489",1,0,2,3,"dummy"
"134490",0,0,3,3,"dummy"
"134511",1,22,4,27,"dummy"
"134512",12,12,0,24,"dummy"
"134513",0,0,1,1,"dummy"
"134517",0,2,0,2,"dummy"
"134518",0,4,0,4,"dummy"
"134521",1,0,0,1,"dummy"
"134522",0,2,0,2,"dummy"
"134523",1,3,0,4,"dummy"
"134540",2,9,0,11,"dummy"
"134541",0,1,0,1,"dummy"
"134542",0,3,0,3,"dummy"
"134543",3,11,5,19,"dummy"
"134544",0,1,0,1,"dummy"
"134545",2,2,9,13,"dummy"
"134554",0,1,0,1,"dummy"
"134555",0,0,1,1,"dummy"
"134556",1,0,0,1,"dummy"
"134557",1,1,0,2,"dummy"
"134558",0,1,0,1,"dummy"
"134559",0,0,1,1,"dummy"
"134562",1,0,0,1,"dummy"
"134563",9,0,0,9,"dummy"
"134566",0,1,0,1,"dummy"
"134569",0,0,2,2,"dummy"
"134572",0,1,0,1,"dummy"
"134573",0,0,1,1,"dummy"
"134574",0,0,1,1,"dummy"
"134575",0,1,0,1,"dummy"
"134578",0,2,1,3,"dummy"
"134579",0,0,1,1,"dummy"
"134580",0,0,1,1,"dummy"
"134581",0,1,0,1,"dummy"
"134587",2,4,0,6,"dummy"
"134588",0,2,0,2,"dummy"
"134589",0,2,0,2,"dummy"
"134590",10,2,0,12,"dummy"
"134591",0,2,0,2,"dummy"
"134592",0,0,0,0,"dummy"
"134593",0,0,3,3,"dummy"
"134594",0,5,0,5,"dummy"
"134601",0,1,0,1,"dummy"
"134654",10,0,5,15,"dummy"
"134655",0,0,1,1,"dummy"
"134549",7,0,1,8,"dummy"
"134550",0,0,0,0,"dummy"
"134551",0,0,0,0,"dummy"
"134552",0,0,0,0,"dummy"
"134583",1,1,2,4,"dummy"
"134603",1,1,0,2,"dummy"
"134604",4,6,1,11,"dummy"
"134605",0,0,0,0,"dummy"
"134606",0,4,0,4,"dummy"
"134607",4,21,2,27,"dummy"
"134608",3,1,0,4,"dummy"
"134609",2,4,1,7,"dummy"
"134610",0,4,0,4,"dummy"
"134611",1,0,0,1,"dummy"
"134612",0,1,0,1,"dummy"
"134613",0,0,1,1,"dummy"
"134614",0,0,1,1,"dummy"
"134615",0,0,1,1,"dummy"
"134616",0,1,0,1,"dummy"
"134617",11,1,0,12,"dummy"
"134618",0,0,2,2,"dummy"
"134619",0,4,0,4,"dummy"
"134620",0,1,0,1,"dummy"
"134621",0,1,0,1,"dummy"
"134622",24,4,0,28,"dummy"
"134623",0,0,1,1,"dummy"
"134624",0,0,1,1,"dummy"
"134625",0,0,1,1,"dummy"
"134626",13,10,0,23,"dummy"
"134627",0,1,1,2,"dummy"
"134628",0,0,1,1,"dummy"
"134629",0,0,1,1,"dummy"
"134630",0,0,1,1,"dummy"
"134631",0,0,1,1,"dummy"
"134632",0,0,1,1,"dummy"
"134633",0,0,1,1,"dummy"
"134634",0,0,1,1,"dummy"
"134635",0,0,0,0,"dummy"
"134636",0,0,1,1,"dummy"
"134637",0,0,1,1,"dummy"
"134638",0,0,1,1,"dummy"
"134639",1,0,0,1,"dummy"
"134640",0,0,1,1,"dummy"
"134641",0,0,0,0,"dummy"
"134642",0,0,0,0,"dummy"
"134643",0,0,1,1,"dummy"
"134644",0,0,1,1,"dummy"
"134645",0,0,1,1,"dummy"
"134646",0,0,1,1,"dummy"
"134647",0,0,1,1,"dummy"
"134648",0,3,2,5,"dummy"
"134649",0,1,0,1,"dummy"
"134650",0,0,0,0,"dummy"
"134651",0,0,0,0,"dummy"
"134652",14,1,0,15,"dummy"
"134660",0,1,0,1,"dummy"
"134666",3,6,2,11,"dummy"
"134667",5,40,1,46,"dummy"
"134668",22,3,0,25,"dummy"
"134669",0,0,1,1,"dummy"
"134670",0,0,0,0,"dummy"
"134656",0,0,1,1,"dummy"
"134657",1,5,1,7,"dummy"
"134658",0,1,0,1,"dummy"
"134672",0,0,0,0,"dummy"
"134674",4,0,0,4,"dummy"
"134675",1,0,0,1,"dummy"
"134676",0,0,0,0,"dummy"
"134684",0,0,1,1,"dummy"
"134686",2,1,0,3,"dummy"
"134688",0,0,5,5,"dummy"
"134690",0,0,1,1,"dummy"
"134696",0,4,0,4,"dummy"
"134697",0,1,0,1,"dummy"
"134698",1,7,0,8,"dummy"
"134699",1,13,0,14,"dummy"
"134706",2,0,2,4,"dummy"
"134707",0,2,0,2,"dummy"
"134709",2,2,1,5,"dummy"
"134710",0,0,0,0,"dummy"
"134712",0,3,0,3,"dummy"
"134714",2,4,0,6,"dummy"
"134715",0,2,0,2,"dummy"
"134716",0,2,0,2,"dummy"
"134717",10,2,0,12,"dummy"
"134718",0,2,0,2,"dummy"
"134719",0,0,0,0,"dummy"
"134720",0,0,3,3,"dummy"
"134721",0,5,0,5,"dummy"
"134725",1,0,0,1,"dummy"
"134727",0,0,1,1,"dummy"
"134728",0,0,1,1,"dummy"
"134730",1,2,0,3,"dummy"
"134732",0,1,0,1,"dummy"
"134733",0,2,0,2,"dummy"
"134734",0,0,0,0,"dummy"
"134735",1,4,1,6,"dummy"
"134736",13,11,0,24,"dummy"
"134737",14,0,2,16,"dummy"
"134738",0,3,2,5,"dummy"
"134739",0,3,0,3,"dummy"
"134740",0,1,0,1,"dummy"
"134742",0,1,0,1,"dummy"
"134743",0,9,0,9,"dummy"
"134744",4,4,2,10,"dummy"
"134745",4,4,2,10,"dummy"
"134746",1,0,0,1,"dummy"
"134747",0,2,0,2,"dummy"
"134748",0,3,0,3,"dummy"
"134749",2,0,0,2,"dummy"
"134750",0,1,0,1,"dummy"
"134755",0,2,0,2,"dummy"
"134756",0,2,0,2,"dummy"
"134758",0,0,4,4,"dummy"
"134762",0,0,1,1,"dummy"
"134765",7,22,0,29,"dummy"
"134766",0,5,0,5,"dummy"
"134767",3,3,0,6,"dummy"
"134768",3,0,0,3,"dummy"
"134769",3,2,0,5,"dummy"
"134770",3,1,1,5,"dummy"
"134773",0,0,1,1,"dummy"
"134792",0,0,0,0,"dummy"
"134793",0,2,0,2,"dummy"
"134794",18,0,2,20,"dummy"
"134802",3,2,0,5,"dummy"
"134803",0,6,1,7,"dummy"
"134804",7,1,0,8,"dummy"
"134805",0,2,0,2,"dummy"
"134807",0,1,0,1,"dummy"
"134808",0,0,1,1,"dummy"
"134809",0,0,1,1,"dummy"
"134810",0,0,0,0,"dummy"
"134811",0,0,0,0,"dummy"
"134813",0,0,4,4,"dummy"
"134815",0,1,0,1,"dummy"
"134816",0,1,0,1,"dummy"
"134818",1,1,4,6,"dummy"
"134823",2,0,3,5,"dummy"
"134826",0,6,2,8,"dummy"
"134827",0,1,0,1,"dummy"
"134828",0,0,4,4,"dummy"
"134829",0,1,0,1,"dummy"
"134830",0,0,1,1,"dummy"
"134831",0,0,1,1,"dummy"
"134832",0,2,2,4,"dummy"
"134833",0,0,1,1,"dummy"
"134835",0,1,0,1,"dummy"
"134837",4,0,0,4,"dummy"
"134838",1,0,0,1,"dummy"
"134842",4,1,0,5,"dummy"
"134843",1,8,1,10,"dummy"
"134844",0,0,0,0,"dummy"
"134845",0,0,0,0,"dummy"
"134846",2,0,0,2,"dummy"
"134847",5,0,0,5,"dummy"
"134857",0,0,2,2,"dummy"
"134858",6,8,0,14,"dummy"
"134859",0,1,0,1,"dummy"
"134860",8,11,0,19,"dummy"
"134861",0,0,0,0,"dummy"
"134862",0,2,0,2,"dummy"
"134864",3,2,1,6,"dummy"
"134865",0,5,1,6,"dummy"
"134866",0,2,0,2,"dummy"
"134867",4,0,1,5,"dummy"
"134868",0,0,1,1,"dummy"
"134869",0,0,1,1,"dummy"
"134870",0,0,1,1,"dummy"
"134871",0,0,1,1,"dummy"
"134873",0,2,0,2,"dummy"
"134875",7,1,3,11,"dummy"
"134876",0,6,0,6,"dummy"
"134877",0,0,0,0,"dummy"
"134878",2,1,0,3,"dummy"
"134879",0,0,2,2,"dummy"
"134880",1,4,1,6,"dummy"
"134881",0,6,0,6,"dummy"
"134882",0,0,0,0,"dummy"
"134883",0,0,1,1,"dummy"
"134884",2,0,0,2,"dummy"
"134885",1,4,0,5,"dummy"
"134893",0,0,0,0,"dummy"
"134894",0,0,0,0,"dummy"
"134895",3,3,0,6,"dummy"
"134898",6,2,3,11,"dummy"
"134901",0,1,0,1,"dummy"
"134902",2,0,1,3,"dummy"
"134910",0,1,0,1,"dummy"
"134911",0,1,0,1,"dummy"
"134913",0,3,0,3,"dummy"
"134914",1,3,0,4,"dummy"
"134915",0,2,0,2,"dummy"
"134916",0,1,0,1,"dummy"
"134919",2,0,0,2,"dummy"
"134920",0,0,0,0,"dummy"
"134922",0,2,0,2,"dummy"
"134923",1,0,1,2,"dummy"
"134924",2,0,0,2,"dummy"
"134925",0,0,1,1,"dummy"
"134926",0,2,0,2,"dummy"
"134927",0,4,0,4,"dummy"
"134928",0,15,0,15,"dummy"
"134929",1,18,2,21,"dummy"
"134930",7,5,3,15,"dummy"
"134931",0,2,0,2,"dummy"
"134932",0,5,0,5,"dummy"
"134935",0,2,0,2,"dummy"
"134936",2,2,0,4,"dummy"
"134937",0,0,1,1,"dummy"
"134938",0,0,0,0,"dummy"
"134939",0,0,1,1,"dummy"
"134940",1,1,0,2,"dummy"
"134941",1,1,0,2,"dummy"
"134942",1,1,0,2,"dummy"
"134946",0,1,0,1,"dummy"
"134947",1,13,4,18,"dummy"
"134951",0,2,1,3,"dummy"
"134952",0,3,0,3,"dummy"
"134953",2,1,0,3,"dummy"
"134954",1,1,0,2,"dummy"
"134955",0,0,1,1,"dummy"
"134956",1,1,0,2,"dummy"
"134957",3,2,1,6,"dummy"
"134958",1,4,0,5,"dummy"
"134959",0,0,1,1,"dummy"
"134960",4,1,0,5,"dummy"
"134961",2,3,1,6,"dummy"
"134962",0,0,1,1,"dummy"
"134983",0,10,4,14,"dummy"
"134991",0,0,0,0,"dummy"
"134992",0,0,0,0,"dummy"
"134993",0,3,1,4,"dummy"
"134994",0,0,4,4,"dummy"
"134995",2,4,1,7,"dummy"
"135003",0,0,1,1,"dummy"
"135006",0,0,1,1,"dummy"
"135007",1,0,0,1,"dummy"
"135008",0,1,0,1,"dummy"
"135009",0,1,0,1,"dummy"
"135010",0,2,0,2,"dummy"
"135011",12,4,5,21,"dummy"
"135012",2,11,1,14,"dummy"
"135013",1,0,0,1,"dummy"
"135014",1,0,1,2,"dummy"
"135015",0,3,0,3,"dummy"
"135016",4,1,3,8,"dummy"
"135017",0,1,0,1,"dummy"
"135018",0,0,0,0,"dummy"
"135019",8,2,2,12,"dummy"
"135021",0,14,0,14,"dummy"
"135025",0,0,1,1,"dummy"
"135026",0,0,4,4,"dummy"
"135029",0,0,1,1,"dummy"
"135033",0,2,0,2,"dummy"
"135034",0,1,0,1,"dummy"
"135035",7,5,4,16,"dummy"
"135036",0,2,0,2,"dummy"
"135037",0,7,0,7,"dummy"
"135040",1,0,1,2,"dummy"
"135041",0,0,1,1,"dummy"
"135043",2,2,3,7,"dummy"
"135044",3,0,3,6,"dummy"
"135045",0,0,1,1,"dummy"
"135046",2,2,0,4,"dummy"
"135047",0,1,0,1,"dummy"
"135048",0,0,0,0,"dummy"
"135049",4,2,0,6,"dummy"
"135050",2,2,0,4,"dummy"
"135052",1,3,0,4,"dummy"
"135058",0,0,0,0,"dummy"
"135059",0,0,1,1,"dummy"
"135061",0,0,1,1,"dummy"
"135065",27,38,0,65,"dummy"
"135066",0,0,0,0,"dummy"
"135067",0,0,1,1,"dummy"
"135068",0,0,2,2,"dummy"
"135072",0,2,0,2,"dummy"
"135073",0,4,0,4,"dummy"
"135074",0,2,0,2,"dummy"
"135075",0,2,0,2,"dummy"
"135076",0,1,0,1,"dummy"
"135081",1,3,4,8,"dummy"
"135082",0,0,3,3,"dummy"
"135088",0,1,0,1,"dummy"
"135089",3,1,0,4,"dummy"
"135090",0,0,2,2,"dummy"
"135093",0,0,0,0,"dummy"
"135094",0,0,0,0,"dummy"
"135096",1,1,0,2,"dummy"
"135099",0,0,0,0,"dummy"
"135100",0,0,0,0,"dummy"
"135101",4,4,1,9,"dummy"
"135102",0,0,0,0,"dummy"
"135103",0,0,0,0,"dummy"
"135104",0,1,0,1,"dummy"
"135105",0,0,0,0,"dummy"
"135106",0,0,0,0,"dummy"
"135107",0,0,0,0,"dummy"
"135108",0,0,0,0,"dummy"
"135109",0,2,0,2,"dummy"
"135110",8,2,1,11,"dummy"
"135111",6,3,3,12,"dummy"
"135112",0,0,1,1,"dummy"
"135113",6,0,0,6,"dummy"
"135114",3,2,0,5,"dummy"
"135115",0,0,1,1,"dummy"
"135119",1,3,0,4,"dummy"
"135120",0,1,0,1,"dummy"
"135121",0,1,0,1,"dummy"
"135131",0,1,0,1,"dummy"
"135136",0,12,0,12,"dummy"
"135137",0,3,0,3,"dummy"
"135141",0,2,0,2,"dummy"
"135142",2,2,2,6,"dummy"
"135143",0,0,1,1,"dummy"
"135145",25,0,1,26,"dummy"
"135146",0,0,0,0,"dummy"
"135147",0,0,3,3,"dummy"
"135153",0,1,0,1,"dummy"
"135154",0,0,1,1,"dummy"
"135157",0,1,0,1,"dummy"
"135158",1,2,0,3,"dummy"
"135160",1,1,0,2,"dummy"
"135161",0,1,0,1,"dummy"
"135162",0,0,5,5,"dummy"
"135164",1,2,1,4,"dummy"
"135165",0,0,1,1,"dummy"
"135166",0,0,1,1,"dummy"
"135167",0,0,1,1,"dummy"
"135171",2,1,0,3,"dummy"
"135172",0,2,0,2,"dummy"
"135173",0,6,0,6,"dummy"
"135174",0,2,0,2,"dummy"
"135179",1,0,1,2,"dummy"
"135180",0,0,2,2,"dummy"
"135182",10,9,5,24,"dummy"
"135183",0,2,0,2,"dummy"
"135184",0,1,2,3,"dummy"
"135185",1,9,5,15,"dummy"
"135186",5,7,5,17,"dummy"
"135187",15,1,4,20,"dummy"
"135188",1,11,2,14,"dummy"
"135189",3,1,0,4,"dummy"
"135194",24,7,2,33,"dummy"
"135196",0,0,1,1,"dummy"
"135200",0,1,0,1,"dummy"
"135216",0,0,0,0,"dummy"
"135217",1,2,0,3,"dummy"
"135218",0,1,0,1,"dummy"
"135226",1,1,0,2,"dummy"
"135227",0,9,0,9,"dummy"
"135228",0,2,0,2,"dummy"
"135230",10,12,1,23,"dummy"
"135231",2,0,0,2,"dummy"
"135232",0,1,0,1,"dummy"
"135234",6,1,0,7,"dummy"
"135235",0,0,1,1,"dummy"
"135236",8,6,0,14,"dummy"
"135237",0,1,0,1,"dummy"
"135244",0,1,0,1,"dummy"
"135245",0,0,1,1,"dummy"
"135249",0,0,0,0,"dummy"
"135250",0,0,1,1,"dummy"
"135252",0,0,1,1,"dummy"
"135253",41,6,3,50,"dummy"
"135254",1,3,0,4,"dummy"
"135255",1,5,0,6,"dummy"
"135256",1,0,0,1,"dummy"
"135257",0,3,0,3,"dummy"
"135258",8,2,1,11,"dummy"
"135259",0,2,0,2,"dummy"
"135261",1,1,0,2,"dummy"
"135262",0,0,0,0,"dummy"
"135263",0,2,0,2,"dummy"
"135264",0,1,0,1,"dummy"
"135265",1,2,0,3,"dummy"
"135266",0,0,0,0,"dummy"
"135267",0,1,0,1,"dummy"
"135279",2,3,0,5,"dummy"
"135282",0,0,2,2,"dummy"
"135283",0,0,2,2,"dummy"
"135284",0,0,2,2,"dummy"
"135285",0,1,0,1,"dummy"
"135286",0,0,3,3,"dummy"
"135287",0,0,3,3,"dummy"
"135288",0,0,2,2,"dummy"
"135289",0,1,3,4,"dummy"
"135290",1,0,0,1,"dummy"
"135291",0,1,0,1,"dummy"
"135293",2,0,0,2,"dummy"
"135296",0,0,0,0,"dummy"
"135297",0,0,0,0,"dummy"
"135298",0,0,0,0,"dummy"
"135300",0,0,1,1,"dummy"
"135301",0,1,0,1,"dummy"
"135303",0,0,0,0,"dummy"
"135304",0,0,0,0,"dummy"
"135305",0,0,1,1,"dummy"
"135310",1,2,0,3,"dummy"
"135311",0,1,0,1,"dummy"
"135320",0,1,0,1,"dummy"
"135323",3,4,1,8,"dummy"
"135327",0,0,1,1,"dummy"
"135328",22,13,4,39,"dummy"
"135329",2,2,0,4,"dummy"
"135330",2,5,0,7,"dummy"
"135331",0,2,0,2,"dummy"
"135332",0,1,0,1,"dummy"
"135333",2,0,0,2,"dummy"
"135334",0,0,0,0,"dummy"
"135339",2,3,1,6,"dummy"
"135340",0,1,1,2,"dummy"
"135341",0,0,1,1,"dummy"
"135344",0,0,0,0,"dummy"
"135345",0,4,0,4,"dummy"
"135348",0,0,1,1,"dummy"
"135349",0,0,1,1,"dummy"
"135350",0,0,2,2,"dummy"
"135351",26,3,7,36,"dummy"
"135353",0,1,0,1,"dummy"
"135354",2,4,0,6,"dummy"
"135355",2,1,0,3,"dummy"
"135356",0,0,1,1,"dummy"
"135357",0,0,1,1,"dummy"
"135358",0,0,1,1,"dummy"
"135360",0,0,1,1,"dummy"
"135362",0,3,1,4,"dummy"
"135365",0,1,0,1,"dummy"
"135366",0,1,0,1,"dummy"
"135367",0,1,0,1,"dummy"
"135368",0,3,0,3,"dummy"
"135371",0,4,0,4,"dummy"
"135385",0,2,0,2,"dummy"
"135387",4,4,0,8,"dummy"
"135389",0,1,0,1,"dummy"
"135395",0,0,2,2,"dummy"
"135401",0,0,1,1,"dummy"
"135404",0,4,0,4,"dummy"
"135405",0,1,0,1,"dummy"
"135406",0,0,1,1,"dummy"
"135407",8,8,0,16,"dummy"
"135408",2,2,0,4,"dummy"
"135409",0,0,1,1,"dummy"
"135410",0,0,1,1,"dummy"
"135411",0,0,1,1,"dummy"
"135412",26,3,1,30,"dummy"
"135413",0,0,1,1,"dummy"
"135414",0,3,0,3,"dummy"
"135415",0,0,1,1,"dummy"
"135416",0,1,0,1,"dummy"
"135417",0,3,0,3,"dummy"
"135418",2,0,0,2,"dummy"
"135419",0,1,1,2,"dummy"
"135420",0,0,1,1,"dummy"
"135421",3,5,0,8,"dummy"
"135422",0,0,1,1,"dummy"
"135423",1,0,0,1,"dummy"
"135424",0,2,0,2,"dummy"
"135425",0,0,1,1,"dummy"
"135426",1,1,0,2,"dummy"
"135427",1,1,0,2,"dummy"
"135428",1,1,0,2,"dummy"
"135429",0,0,0,0,"dummy"
"135430",0,0,1,1,"dummy"
"135431",2,0,0,2,"dummy"
"135432",0,0,1,1,"dummy"
"135433",4,3,0,7,"dummy"
"135434",6,6,1,13,"dummy"
"135435",0,0,1,1,"dummy"
"135436",0,3,0,3,"dummy"
"135437",1,5,1,7,"dummy"
"135438",0,1,0,1,"dummy"
"135439",8,1,0,9,"dummy"
"135440",0,5,0,5,"dummy"
"135441",0,1,0,1,"dummy"
"135442",0,1,0,1,"dummy"
"135445",0,1,0,1,"dummy"
"135446",0,0,1,1,"dummy"
"135447",0,0,1,1,"dummy"
"135449",0,0,1,1,"dummy"
"135450",0,0,1,1,"dummy"
"135451",0,0,2,2,"dummy"
"135452",0,0,1,1,"dummy"
"135453",0,0,0,0,"dummy"
"135454",0,1,0,1,"dummy"
"135455",1,0,0,1,"dummy"
"135456",2,0,0,2,"dummy"
"135457",0,0,1,1,"dummy"
"135458",0,1,0,1,"dummy"
"135459",0,2,0,2,"dummy"
"135460",0,0,1,1,"dummy"
"135461",0,0,1,1,"dummy"
"135462",0,0,1,1,"dummy"
"135463",0,2,0,2,"dummy"
"135464",0,1,0,1,"dummy"
"135465",3,4,0,7,"dummy"
"135466",0,3,0,3,"dummy"
"135467",2,0,0,2,"dummy"
"135468",0,2,0,2,"dummy"
"135469",0,1,0,1,"dummy"
"135470",2,7,0,9,"dummy"
"135471",2,0,0,2,"dummy"
"135472",2,2,0,4,"dummy"
"135473",0,2,0,2,"dummy"
"135474",0,2,0,2,"dummy"
"135475",0,2,0,2,"dummy"
"135476",0,0,2,2,"dummy"
"135478",0,0,0,0,"dummy"
"135481",3,7,1,11,"dummy"
"135482",0,0,0,0,"dummy"
"135486",2,0,3,5,"dummy"
"135488",18,32,1,51,"dummy"
"135489",9,4,0,13,"dummy"
"135490",3,12,0,15,"dummy"
"135491",41,25,5,71,"dummy"
"135494",6,0,0,6,"dummy"
"135500",5,8,2,15,"dummy"
"135501",0,10,0,10,"dummy"
"135502",0,11,0,11,"dummy"
"135503",0,3,0,3,"dummy"
"135504",0,2,0,2,"dummy"
"135505",0,2,0,2,"dummy"
"135506",0,0,3,3,"dummy"
"135510",4,7,2,13,"dummy"
"135518",0,1,1,2,"dummy"
"135519",0,0,2,2,"dummy"
"135520",0,0,1,1,"dummy"
"135521",0,0,0,0,"dummy"
"135522",0,0,1,1,"dummy"
"135524",0,0,0,0,"dummy"
"135525",0,1,0,1,"dummy"
"135526",0,0,1,1,"dummy"
"135527",0,0,1,1,"dummy"
"135528",0,0,1,1,"dummy"
"135531",0,0,1,1,"dummy"
"135532",0,0,1,1,"dummy"
"135533",0,0,1,1,"dummy"
"135534",0,9,2,11,"dummy"
"135535",2,0,0,2,"dummy"
"135537",0,0,1,1,"dummy"
"135538",0,0,1,1,"dummy"
"135539",2,1,1,4,"dummy"
"135540",0,0,1,1,"dummy"
"135543",0,0,0,0,"dummy"
"135547",0,1,0,1,"dummy"
"135548",10,0,2,12,"dummy"
"135549",0,10,2,12,"dummy"
"135550",0,2,2,4,"dummy"
"135551",10,0,5,15,"dummy"
"135552",3,0,3,6,"dummy"
"135560",0,0,0,0,"dummy"
"135562",0,1,0,1,"dummy"
"135563",0,0,1,1,"dummy"
"135564",2,1,2,5,"dummy"
"135565",1,3,1,5,"dummy"
"135566",0,1,0,1,"dummy"
"135567",0,2,0,2,"dummy"
"135568",0,0,3,3,"dummy"
"135579",2,3,0,5,"dummy"
"135580",3,3,0,6,"dummy"
"135581",8,0,0,8,"dummy"
"135582",0,0,1,1,"dummy"
"135584",0,0,0,0,"dummy"
"135585",0,0,0,0,"dummy"
"135586",0,0,0,0,"dummy"
"135587",0,0,0,0,"dummy"
"135588",0,0,0,0,"dummy"
"135594",0,7,0,7,"dummy"
"135596",1,2,2,5,"dummy"
"135607",5,2,1,8,"dummy"
"135608",0,0,1,1,"dummy"
"135612",0,0,1,1,"dummy"
"135614",0,29,0,29,"dummy"
"135618",0,3,0,3,"dummy"
"135619",1,2,0,3,"dummy"
"135620",1,0,0,1,"dummy"
"135621",0,0,1,1,"dummy"
"135622",3,7,1,11,"dummy"
"135623",0,0,1,1,"dummy"
"135627",0,3,1,4,"dummy"
"135628",4,0,1,5,"dummy"
"135629",0,0,2,2,"dummy"
"135630",0,0,2,2,"dummy"
"135631",0,0,0,0,"dummy"
"135632",1,3,1,5,"dummy"
"135633",2,3,3,8,"dummy"
"135634",0,0,1,1,"dummy"
"135635",3,0,0,3,"dummy"
"135636",0,1,0,1,"dummy"
"135637",0,0,0,0,"dummy"
"135638",0,1,1,2,"dummy"
"135639",0,0,0,0,"dummy"
"135640",0,1,0,1,"dummy"
"135641",1,8,1,10,"dummy"
"135644",0,2,0,2,"dummy"
"135645",4,0,0,4,"dummy"
"135646",5,3,1,9,"dummy"
"135647",0,0,1,1,"dummy"
"135648",0,2,0,2,"dummy"
"135649",0,0,0,0,"dummy"
"135650",1,1,0,2,"dummy"
"135651",0,0,0,0,"dummy"
"135652",0,1,1,2,"dummy"
"135653",0,0,0,0,"dummy"
"135654",0,0,1,1,"dummy"
"135655",0,0,0,0,"dummy"
"135656",0,2,0,2,"dummy"
"135657",0,0,1,1,"dummy"
"135658",0,0,2,2,"dummy"
"135659",0,0,1,1,"dummy"
"135660",0,1,0,1,"dummy"
"135661",0,0,1,1,"dummy"
"135662",0,0,1,1,"dummy"
"135663",0,0,1,1,"dummy"
"135664",0,0,1,1,"dummy"
"135665",0,0,0,0,"dummy"
"135667",12,20,4,36,"dummy"
"135668",1,3,2,6,"dummy"
"135669",5,0,1,6,"dummy"
"135670",3,7,1,11,"dummy"
"135679",0,0,0,0,"dummy"
"135680",0,0,0,0,"dummy"
"135681",0,1,0,1,"dummy"
"135682",0,1,0,1,"dummy"
"135683",0,0,0,0,"dummy"
"135687",5,6,2,13,"dummy"
"135688",1,6,4,11,"dummy"
"135695",0,0,1,1,"dummy"
"135696",0,0,0,0,"dummy"
"135697",2,7,0,9,"dummy"
"135698",3,0,1,4,"dummy"
"135700",12,1,5,18,"dummy"
"135702",0,1,1,2,"dummy"
"135704",0,4,0,4,"dummy"
"135705",1,3,0,4,"dummy"
"135706",0,4,0,4,"dummy"
"135707",0,0,1,1,"dummy"
"135708",0,1,0,1,"dummy"
"135710",0,1,0,1,"dummy"
"135713",4,2,2,8,"dummy"
"135715",0,11,0,11,"dummy"
"135716",0,0,2,2,"dummy"
"135720",2,4,0,6,"dummy"
"135721",0,2,0,2,"dummy"
"135722",0,2,0,2,"dummy"
"135723",10,2,0,12,"dummy"
"135724",0,2,0,2,"dummy"
"135725",0,0,0,0,"dummy"
"135726",0,0,0,0,"dummy"
"135728",0,2,0,2,"dummy"
"135729",0,2,0,2,"dummy"
"135730",5,5,0,10,"dummy"
"135731",4,1,0,5,"dummy"
"135732",1,1,2,4,"dummy"
"135733",0,0,0,0,"dummy"
"135736",0,1,0,1,"dummy"
"135737",0,1,0,1,"dummy"
"135738",2,1,0,3,"dummy"
"135741",3,3,0,6,"dummy"
"135744",2,1,0,3,"dummy"
"135745",2,2,0,4,"dummy"
"135746",0,0,1,1,"dummy"
"135747",2,5,1,8,"dummy"
"135749",0,0,1,1,"dummy"
"135750",0,1,0,1,"dummy"
"135752",0,1,0,1,"dummy"
"135753",0,0,1,1,"dummy"
"135754",0,0,1,1,"dummy"
"135755",0,0,1,1,"dummy"
"135756",0,0,1,1,"dummy"
"135757",5,2,2,9,"dummy"
"135760",0,2,1,3,"dummy"
"135761",0,0,0,0,"dummy"
"135762",0,0,1,1,"dummy"
"135763",0,0,0,0,"dummy"
"135764",0,2,0,2,"dummy"
"135765",0,0,1,1,"dummy"
"135766",0,0,2,2,"dummy"
"135767",0,0,1,1,"dummy"
"135768",0,1,0,1,"dummy"
"135769",0,0,1,1,"dummy"
"135770",0,0,1,1,"dummy"
"135771",0,0,1,1,"dummy"
"135772",0,0,1,1,"dummy"
"135773",0,0,0,0,"dummy"
"135774",1,1,0,2,"dummy"
"135775",0,0,1,1,"dummy"
"135776",0,1,0,1,"dummy"
"135777",0,0,1,1,"dummy"
"135778",0,0,1,1,"dummy"
"135779",0,0,0,0,"dummy"
"135780",0,0,0,0,"dummy"
"135781",0,0,1,1,"dummy"
"135782",0,0,1,1,"dummy"
"135783",0,0,0,0,"dummy"
"135784",0,0,0,0,"dummy"
"135785",0,0,0,0,"dummy"
"135786",1,0,0,1,"dummy"
"135787",0,1,0,1,"dummy"
"135788",0,0,0,0,"dummy"
"135789",2,9,1,12,"dummy"
"135790",0,1,0,1,"dummy"
"135791",0,0,1,1,"dummy"
"135792",0,0,1,1,"dummy"
"135794",0,0,1,1,"dummy"
"135805",10,1,1,12,"dummy"
"135810",0,1,0,1,"dummy"
"135813",0,3,0,3,"dummy"
"135814",1,0,0,1,"dummy"
"135815",2,7,0,9,"dummy"
"135816",0,1,0,1,"dummy"
"135817",5,5,2,12,"dummy"
"135820",4,2,1,7,"dummy"
"135821",0,1,0,1,"dummy"
"135822",0,1,0,1,"dummy"
"135824",0,0,1,1,"dummy"
"135825",1,0,0,1,"dummy"
"135833",2,0,3,5,"dummy"
"135835",1,5,2,8,"dummy"
"135836",1,0,0,1,"dummy"
"135845",0,0,1,1,"dummy"
"135846",0,1,0,1,"dummy"
"135847",0,0,1,1,"dummy"
"135848",0,0,1,1,"dummy"
"135849",2,5,2,9,"dummy"
"135850",0,1,0,1,"dummy"
"135851",5,8,1,14,"dummy"
"135852",0,1,0,1,"dummy"
"135853",0,1,0,1,"dummy"
"135854",2,3,0,5,"dummy"
"135855",0,1,0,1,"dummy"
"135856",12,10,1,23,"dummy"
"135857",7,8,0,15,"dummy"
"135859",0,1,2,3,"dummy"
"135860",52,4,4,60,"dummy"
"135861",2,7,3,12,"dummy"
"135862",0,1,2,3,"dummy"
"135863",0,1,0,1,"dummy"
"135864",7,2,3,12,"dummy"
"135878",0,0,1,1,"dummy"
"135880",0,0,1,1,"dummy"
"135881",9,14,2,25,"dummy"
"135882",0,0,1,1,"dummy"
"135883",0,4,0,4,"dummy"
"135884",0,1,1,2,"dummy"
"135888",0,0,0,0,"dummy"
"135889",1,0,0,1,"dummy"
"135890",0,0,1,1,"dummy"
"135891",1,1,0,2,"dummy"
"135892",6,0,0,6,"dummy"
"135893",2,0,0,2,"dummy"
"135894",0,0,1,1,"dummy"
"135895",0,0,1,1,"dummy"
"135896",2,2,1,5,"dummy"
"135897",0,0,0,0,"dummy"
"135898",0,0,0,0,"dummy"
"135899",0,1,0,1,"dummy"
"135900",0,0,1,1,"dummy"
"135901",0,4,0,4,"dummy"
"135902",4,0,0,4,"dummy"
"135903",0,0,0,0,"dummy"
"135904",0,0,0,0,"dummy"
"135905",0,0,0,0,"dummy"
"135909",2,6,0,8,"dummy"
"135910",0,0,1,1,"dummy"
"135911",0,1,0,1,"dummy"
"135913",1,1,0,2,"dummy"
"135914",0,0,0,0,"dummy"
"135915",0,2,0,2,"dummy"
"135916",0,0,1,1,"dummy"
"135931",6,0,0,6,"dummy"
"135932",2,5,2,9,"dummy"
"135934",0,0,0,0,"dummy"
"135935",0,2,0,2,"dummy"
"135936",1,3,0,4,"dummy"
"135938",0,0,1,1,"dummy"
"135939",0,2,1,3,"dummy"
"135942",0,2,0,2,"dummy"
"135943",0,3,0,3,"dummy"
"135950",7,6,0,13,"dummy"
"135951",0,1,1,2,"dummy"
"135954",0,2,0,2,"dummy"
"135955",0,0,0,0,"dummy"
"135958",0,0,1,1,"dummy"
"135961",8,1,1,10,"dummy"
"135962",4,12,2,18,"dummy"
"135967",0,1,0,1,"dummy"
"135968",0,0,1,1,"dummy"
"135969",0,0,1,1,"dummy"
"135970",0,0,1,1,"dummy"
"135972",0,1,1,2,"dummy"
"135973",0,6,0,6,"dummy"
"135974",6,0,0,6,"dummy"
"135975",4,6,0,10,"dummy"
"135976",0,0,4,4,"dummy"
"135977",1,2,3,6,"dummy"
"135979",0,2,0,2,"dummy"
"135980",0,5,0,5,"dummy"
"135981",6,1,1,8,"dummy"
"135982",4,3,0,7,"dummy"
"135983",0,1,0,1,"dummy"
"135984",0,0,0,0,"dummy"
"135985",0,0,0,0,"dummy"
"135987",0,1,0,1,"dummy"
"135988",0,0,0,0,"dummy"
"135989",1,2,0,3,"dummy"
"135990",2,2,0,4,"dummy"
"135991",2,8,0,10,"dummy"
"135992",1,2,0,3,"dummy"
"135993",0,1,3,4,"dummy"
"135994",1,1,0,2,"dummy"
"135995",1,0,3,4,"dummy"
"135996",0,1,3,4,"dummy"
"135997",0,1,0,1,"dummy"
"135998",10,6,2,18,"dummy"
"135999",2,0,0,2,"dummy"
"136000",0,0,1,1,"dummy"
"136001",16,7,5,28,"dummy"
"136002",7,4,2,13,"dummy"
"136003",1,3,1,5,"dummy"
"136004",9,1,0,10,"dummy"
"136005",3,1,1,5,"dummy"
"136006",0,4,1,5,"dummy"
"136007",5,0,1,6,"dummy"
"136008",0,0,0,0,"dummy"
"136023",0,0,1,1,"dummy"
"136024",0,0,1,1,"dummy"
"136025",0,0,1,1,"dummy"
"136026",0,0,1,1,"dummy"
"136027",0,0,1,1,"dummy"
"136028",5,2,1,8,"dummy"
"136029",0,0,1,1,"dummy"
"136030",0,0,1,1,"dummy"
"136031",2,5,1,8,"dummy"
"136032",0,0,1,1,"dummy"
"136033",0,0,1,1,"dummy"
"136034",0,0,1,1,"dummy"
"136038",0,0,0,0,"dummy"
"136041",0,0,2,2,"dummy"
"136043",1,0,0,1,"dummy"
"136044",4,2,0,6,"dummy"
"136045",0,0,0,0,"dummy"
"136046",1,2,0,3,"dummy"
"136049",0,1,0,1,"dummy"
"136050",0,1,0,1,"dummy"
"136051",0,1,0,1,"dummy"
"136052",0,0,2,2,"dummy"
"136053",2,5,0,7,"dummy"
"136054",2,2,0,4,"dummy"
"136056",1,0,1,2,"dummy"
"136057",0,0,1,1,"dummy"
"136058",0,1,1,2,"dummy"
"136059",6,6,4,16,"dummy"
"136060",0,0,2,2,"dummy"
"136062",0,2,0,2,"dummy"
"136064",3,0,0,3,"dummy"
"136065",0,0,2,2,"dummy"
"136066",0,1,0,1,"dummy"
"136067",8,0,0,8,"dummy"
"136068",0,1,0,1,"dummy"
"136069",2,2,0,4,"dummy"
"136073",2,0,0,2,"dummy"
"136075",2,8,2,12,"dummy"
"136076",2,2,1,5,"dummy"
"136077",0,0,1,1,"dummy"
"136078",2,10,3,15,"dummy"
"136080",8,6,3,17,"dummy"
"136082",0,2,0,2,"dummy"
"136083",2,0,0,2,"dummy"
"136084",0,5,2,7,"dummy"
"136088",0,1,0,1,"dummy"
"136089",0,0,1,1,"dummy"
"136090",0,7,1,8,"dummy"
"136091",0,1,0,1,"dummy"
"136093",0,8,4,12,"dummy"
"136095",0,0,1,1,"dummy"
"136097",0,0,1,1,"dummy"
"136099",3,1,0,4,"dummy"
"136100",0,2,0,2,"dummy"
"136102",0,0,1,1,"dummy"
"136105",0,2,0,2,"dummy"
"136106",0,1,0,1,"dummy"
"136107",0,1,0,1,"dummy"
"136108",0,0,1,1,"dummy"
"136109",0,0,1,1,"dummy"
"136110",0,0,1,1,"dummy"
"136111",0,0,1,1,"dummy"
"136115",3,0,0,3,"dummy"
"136116",3,1,3,7,"dummy"
"136117",0,0,2,2,"dummy"
"136118",0,0,0,0,"dummy"
"136119",2,50,1,53,"dummy"
"136120",18,14,13,45,"dummy"
"136121",21,1,2,24,"dummy"
"136122",18,3,1,22,"dummy"
"136113",0,0,3,3,"dummy"
"136124",0,0,1,1,"dummy"
"136130",0,0,0,0,"dummy"
"136131",0,0,0,0,"dummy"
"136135",0,2,0,2,"dummy"
"136136",0,1,0,1,"dummy"
"136137",1,0,0,1,"dummy"
"136138",0,0,1,1,"dummy"
"136139",3,0,0,3,"dummy"
"136140",6,3,0,9,"dummy"
"136141",0,2,0,2,"dummy"
"136142",1,1,0,2,"dummy"
"136143",0,0,0,0,"dummy"
"136144",0,0,1,1,"dummy"
"136145",0,0,0,0,"dummy"
"136146",0,0,1,1,"dummy"
"136147",0,0,0,0,"dummy"
"136148",0,2,0,2,"dummy"
"136149",0,0,1,1,"dummy"
"136150",0,0,1,1,"dummy"
"136151",0,0,1,1,"dummy"
"136152",0,0,0,0,"dummy"
"136153",0,0,1,1,"dummy"
"136154",0,0,1,1,"dummy"
"136155",0,0,1,1,"dummy"
"136156",0,0,0,0,"dummy"
"136157",1,10,0,11,"dummy"
"136158",0,0,1,1,"dummy"
"136159",9,1,0,10,"dummy"
"136160",0,0,1,1,"dummy"
"136161",0,0,1,1,"dummy"
"136162",0,0,1,1,"dummy"
"136163",0,0,0,0,"dummy"
"136164",0,0,0,0,"dummy"
"136165",0,0,1,1,"dummy"
"136166",0,0,0,0,"dummy"
"136167",0,0,0,0,"dummy"
"136168",0,0,0,0,"dummy"
"136169",0,0,0,0,"dummy"
"136170",0,0,0,0,"dummy"
"136171",1,0,0,1,"dummy"
"136172",0,1,0,1,"dummy"
"136173",0,0,0,0,"dummy"
"136174",7,11,1,19,"dummy"
"136175",0,0,1,1,"dummy"
"136176",0,0,1,1,"dummy"
"136178",5,4,2,11,"dummy"
"136179",4,5,2,11,"dummy"
"136180",1,1,0,2,"dummy"
"136181",0,0,0,0,"dummy"
"136182",0,0,3,3,"dummy"
"136183",0,0,0,0,"dummy"
"136184",4,2,1,7,"dummy"
"136185",3,3,2,8,"dummy"
"136186",0,1,0,1,"dummy"
"136187",0,0,2,2,"dummy"
"136189",0,0,1,1,"dummy"
"136204",0,0,0,0,"dummy"
"136205",0,2,0,2,"dummy"
"136206",0,2,0,2,"dummy"
"136207",0,1,0,1,"dummy"
"136210",0,1,0,1,"dummy"
"136211",0,9,0,9,"dummy"
"136212",0,1,1,2,"dummy"
"136214",1,1,0,2,"dummy"
"136215",0,3,0,3,"dummy"
"136216",2,1,0,3,"dummy"
"136217",2,0,0,2,"dummy"
"136218",0,0,1,1,"dummy"
"136221",0,0,0,0,"dummy"
"136222",0,0,1,1,"dummy"
"136226",4,4,0,8,"dummy"
"136227",0,0,1,1,"dummy"
"136228",3,1,0,4,"dummy"
"136232",2,11,2,15,"dummy"
"136235",3,4,0,7,"dummy"
"136236",0,2,0,2,"dummy"
"136238",1,1,4,6,"dummy"
"136240",0,1,0,1,"dummy"
"136241",0,2,0,2,"dummy"
"136242",0,4,0,4,"dummy"
"136243",0,2,4,6,"dummy"
"136244",0,0,1,1,"dummy"
"136245",1,2,0,3,"dummy"
"136246",2,1,0,3,"dummy"
"136249",3,3,0,6,"dummy"
"136250",0,1,0,1,"dummy"
"136251",0,2,0,2,"dummy"
"136252",0,1,0,1,"dummy"
"136257",0,10,2,12,"dummy"
"136258",0,0,1,1,"dummy"
"136259",0,3,0,3,"dummy"
"136260",9,0,1,10,"dummy"
"136262",0,4,0,4,"dummy"
"136265",0,0,1,1,"dummy"
"136266",0,0,0,0,"dummy"
"136268",0,0,1,1,"dummy"
"136269",1,2,3,6,"dummy"
"136270",2,1,1,4,"dummy"
"136272",4,1,0,5,"dummy"
"136273",0,0,2,2,"dummy"
"136274",0,0,1,1,"dummy"
"136275",1,0,0,1,"dummy"
"136276",0,0,1,1,"dummy"
"136277",5,7,2,14,"dummy"
"136278",1,19,0,20,"dummy"
"136280",3,0,0,3,"dummy"
"136281",0,4,0,4,"dummy"
"136282",0,1,0,1,"dummy"
"136283",0,0,1,1,"dummy"
"136284",0,0,1,1,"dummy"
"136286",0,0,1,1,"dummy"
"136287",0,0,1,1,"dummy"
"136288",0,0,1,1,"dummy"
"136291",1,6,4,11,"dummy"
"136308",1,0,1,2,"dummy"
"136309",0,0,1,1,"dummy"
"136312",0,3,0,3,"dummy"
"136313",3,0,0,3,"dummy"
"136314",0,3,0,3,"dummy"
"136321",2,0,0,2,"dummy"
"136323",0,0,2,2,"dummy"
"136327",1,0,0,1,"dummy"
"136328",0,1,0,1,"dummy"
"136330",0,0,2,2,"dummy"
"136335",0,1,2,3,"dummy"
"136336",0,0,0,0,"dummy"
"136337",0,1,0,1,"dummy"
"136338",4,0,2,6,"dummy"
"136339",1,0,0,1,"dummy"
"136340",0,0,0,0,"dummy"
"136342",0,0,1,1,"dummy"
"136343",1,0,0,1,"dummy"
"136345",0,1,0,1,"dummy"
"136349",0,0,1,1,"dummy"
"136351",0,3,0,3,"dummy"
"136352",0,4,5,9,"dummy"
"136390",0,2,0,2,"dummy"
"136391",1,0,1,2,"dummy"
"136392",2,2,1,5,"dummy"
"136395",1,0,0,1,"dummy"
"136396",0,1,0,1,"dummy"
"136415",0,0,1,1,"dummy"
"136416",0,1,1,2,"dummy"
"136417",1,0,0,1,"dummy"
"136439",0,1,1,2,"dummy"
"136440",0,2,0,2,"dummy"
"136441",0,0,1,1,"dummy"
"136442",1,1,0,2,"dummy"
"136443",2,0,1,3,"dummy"
"136455",3,4,2,9,"dummy"
"136459",0,0,1,1,"dummy"
"136460",0,0,1,1,"dummy"
"136461",0,1,0,1,"dummy"
"136462",1,1,0,2,"dummy"
"136463",0,0,1,1,"dummy"
"136464",1,0,1,2,"dummy"
"136465",0,0,1,1,"dummy"
"136475",0,0,1,1,"dummy"
"136476",0,0,2,2,"dummy"
"136477",0,0,1,1,"dummy"
"136478",0,9,1,10,"dummy"
"136484",2,3,1,6,"dummy"
"136505",1,0,0,1,"dummy"
"136506",2,2,0,4,"dummy"
"136507",1,0,0,1,"dummy"
"136508",0,0,3,3,"dummy"
"136509",1,0,2,3,"dummy"
"136510",0,0,1,1,"dummy"
"136511",3,4,1,8,"dummy"
"136521",2,5,2,9,"dummy"
"136526",0,31,0,31,"dummy"
"136527",0,1,0,1,"dummy"
"136554",0,0,2,2,"dummy"
"136555",0,0,0,0,"dummy"
"136556",1,1,0,2,"dummy"
"136557",0,1,0,1,"dummy"
"136558",1,2,1,4,"dummy"
"136559",0,2,0,2,"dummy"
"136560",2,1,1,4,"dummy"
"136561",0,0,3,3,"dummy"
"136562",0,4,0,4,"dummy"
"136563",1,0,1,2,"dummy"
"136564",0,2,0,2,"dummy"
"136565",0,0,1,1,"dummy"
"136566",0,3,0,3,"dummy"
"136567",0,1,1,2,"dummy"
"136578",0,0,1,1,"dummy"
"136581",0,18,6,24,"dummy"
"136582",1,2,0,3,"dummy"
"136583",7,0,0,7,"dummy"
"136584",0,0,1,1,"dummy"
"136604",1,2,0,3,"dummy"
"136610",0,0,1,1,"dummy"
"136611",0,1,0,1,"dummy"
"136354",0,0,1,1,"dummy"
"136355",0,7,0,7,"dummy"
"136356",0,2,2,4,"dummy"
"136357",0,1,2,3,"dummy"
"136358",0,1,1,2,"dummy"
"136359",0,2,0,2,"dummy"
"136360",1,5,1,7,"dummy"
"136361",4,4,1,9,"dummy"
"136362",0,1,0,1,"dummy"
"136363",0,0,3,3,"dummy"
"136364",0,0,3,3,"dummy"
"136365",0,8,0,8,"dummy"
"136366",1,4,0,5,"dummy"
"136367",0,2,1,3,"dummy"
"136368",10,1,0,11,"dummy"
"136369",4,1,0,5,"dummy"
"136370",0,0,0,0,"dummy"
"136371",0,0,0,0,"dummy"
"136372",0,0,3,3,"dummy"
"136373",0,0,3,3,"dummy"
"136374",0,0,3,3,"dummy"
"136375",0,0,1,1,"dummy"
"136378",1,0,0,1,"dummy"
"136381",4,4,1,9,"dummy"
"136382",0,2,0,2,"dummy"
"136383",4,4,0,8,"dummy"
"136384",0,1,0,1,"dummy"
"136385",2,2,1,5,"dummy"
"136386",2,2,0,4,"dummy"
"136387",1,1,0,2,"dummy"
"136388",0,3,0,3,"dummy"
"136398",8,5,0,13,"dummy"
"136399",4,4,0,8,"dummy"
"136400",7,1,1,9,"dummy"
"136403",0,1,0,1,"dummy"
"136404",0,0,0,0,"dummy"
"136405",2,5,1,8,"dummy"
"136406",7,7,1,15,"dummy"
"136407",12,14,3,29,"dummy"
"136408",0,0,0,0,"dummy"
"136409",1,0,0,1,"dummy"
"136428",0,0,0,0,"dummy"
"136429",0,1,0,1,"dummy"
"136430",0,0,1,1,"dummy"
"136431",0,0,0,0,"dummy"
"136432",0,1,0,1,"dummy"
"136433",0,0,1,1,"dummy"
"136434",0,0,2,2,"dummy"
"136435",0,0,2,2,"dummy"
"136436",0,0,0,0,"dummy"
"136437",0,0,0,0,"dummy"
"136445",1,2,1,4,"dummy"
"136446",5,2,0,7,"dummy"
"136453",2,5,2,9,"dummy"
"136457",3,3,0,6,"dummy"
"136469",0,1,0,1,"dummy"
"136470",2,0,2,4,"dummy"
"136473",0,0,1,1,"dummy"
"136482",7,0,0,7,"dummy"
"136486",0,3,0,3,"dummy"
"136487",1,0,0,1,"dummy"
"136488",0,0,1,1,"dummy"
"136489",6,2,0,8,"dummy"
"136490",0,1,0,1,"dummy"
"136491",0,0,1,1,"dummy"
"136492",0,1,1,2,"dummy"
"136493",1,0,0,1,"dummy"
"136494",2,9,1,12,"dummy"
"136495",0,0,0,0,"dummy"
"136496",0,0,1,1,"dummy"
"136497",0,0,0,0,"dummy"
"136498",10,0,1,11,"dummy"
"136501",0,0,1,1,"dummy"
"136502",0,0,2,2,"dummy"
"136503",0,8,0,8,"dummy"
"136518",0,0,1,1,"dummy"
"136519",0,0,0,0,"dummy"
"136529",0,0,2,2,"dummy"
"136532",0,0,1,1,"dummy"
"136533",0,0,1,1,"dummy"
"136534",0,0,1,1,"dummy"
"136535",0,0,1,1,"dummy"
"136536",0,0,1,1,"dummy"
"136537",0,0,1,1,"dummy"
"136538",0,0,1,1,"dummy"
"136539",0,0,1,1,"dummy"
"136540",0,0,1,1,"dummy"
"136541",0,0,1,1,"dummy"
"136542",0,0,1,1,"dummy"
"136543",0,0,1,1,"dummy"
"136544",0,0,1,1,"dummy"
"136545",0,0,1,1,"dummy"
"136546",0,0,1,1,"dummy"
"136547",0,0,1,1,"dummy"
"136548",0,0,1,1,"dummy"
"136549",0,0,1,1,"dummy"
"136550",0,0,1,1,"dummy"
"136551",0,0,1,1,"dummy"
"136552",0,0,1,1,"dummy"
"136569",0,1,0,1,"dummy"
"136570",0,2,0,2,"dummy"
"136571",0,2,0,2,"dummy"
"136572",0,0,1,1,"dummy"
"136573",0,3,2,5,"dummy"
"136574",2,2,0,4,"dummy"
"136590",2,0,3,5,"dummy"
"136591",1,0,0,1,"dummy"
"136592",0,1,0,1,"dummy"
"136593",0,1,1,2,"dummy"
"136606",0,3,0,3,"dummy"
"136607",2,1,1,4,"dummy"
"136608",0,1,0,1,"dummy"
"136613",6,8,1,15,"dummy"
"136614",0,0,0,0,"dummy"
"136623",1,0,0,1,"dummy"
"136624",0,1,0,1,"dummy"
"136635",4,3,1,8,"dummy"
"136636",1,0,0,1,"dummy"
"136637",0,1,0,1,"dummy"
"136638",0,1,0,1,"dummy"
"136639",0,0,1,1,"dummy"
"136640",0,0,1,1,"dummy"
"136641",0,0,0,0,"dummy"
"136646",1,0,0,1,"dummy"
"136647",0,1,0,1,"dummy"
"136654",2,4,0,6,"dummy"
"136655",1,0,0,1,"dummy"
"136656",0,0,1,1,"dummy"
"136659",5,2,0,7,"dummy"
"136660",0,0,2,2,"dummy"
"136661",2,10,1,13,"dummy"
"136671",0,2,0,2,"dummy"
"136674",0,14,0,14,"dummy"
"136688",1,8,1,10,"dummy"
"136689",0,1,0,1,"dummy"
"136690",1,8,0,9,"dummy"
"136691",0,18,3,21,"dummy"
"136692",2,2,0,4,"dummy"
"136693",3,0,0,3,"dummy"
"136694",0,1,0,1,"dummy"
"136695",0,0,1,1,"dummy"
"136716",0,0,1,1,"dummy"
"136774",2,4,0,6,"dummy"
"136775",0,2,0,2,"dummy"
"136776",0,2,0,2,"dummy"
"136777",10,2,0,12,"dummy"
"136778",0,2,0,2,"dummy"
"136779",0,0,0,0,"dummy"
"136780",0,0,3,3,"dummy"
"136781",0,5,0,5,"dummy"
"136782",1,0,1,2,"dummy"
"136788",0,0,1,1,"dummy"
"136789",0,0,1,1,"dummy"
"136792",0,0,0,0,"dummy"
"136616",0,3,0,3,"dummy"
"136621",3,40,0,43,"dummy"
"136626",2,1,0,3,"dummy"
"136627",0,1,0,1,"dummy"
"136649",2,1,5,8,"dummy"
"136650",0,0,1,1,"dummy"
"136651",1,2,0,3,"dummy"
"136652",0,0,0,0,"dummy"
"136680",0,6,4,10,"dummy"
"136681",0,0,0,0,"dummy"
"136682",6,0,0,6,"dummy"
"136683",1,9,0,10,"dummy"
"136684",1,0,0,1,"dummy"
"136714",1,1,2,4,"dummy"
"136757",0,0,0,0,"dummy"
"136758",3,0,0,3,"dummy"
"136759",0,0,1,1,"dummy"
"136760",3,2,0,5,"dummy"
"136761",0,2,0,2,"dummy"
"136762",0,5,0,5,"dummy"
"136763",0,0,0,0,"dummy"
"136764",0,0,1,1,"dummy"
"136765",0,1,0,1,"dummy"
"136766",0,0,0,0,"dummy"
"136767",0,0,0,0,"dummy"
"136768",0,0,2,2,"dummy"
"136769",5,0,0,5,"dummy"
"136770",0,0,0,0,"dummy"
"136771",0,0,0,0,"dummy"
"136772",1,0,0,1,"dummy"
"136784",14,7,0,21,"dummy"
"136793",0,0,0,0,"dummy"
"136794",0,0,0,0,"dummy"
"136795",0,0,0,0,"dummy"
"136796",0,0,0,0,"dummy"
"136797",0,0,0,0,"dummy"
"136798",0,0,0,0,"dummy"
"136799",0,0,0,0,"dummy"
"136800",0,0,0,0,"dummy"
"136806",4,0,0,4,"dummy"
"136812",0,9,0,9,"dummy"
"136814",1,1,2,4,"dummy"
"136815",1,0,0,1,"dummy"
"136817",13,2,2,17,"dummy"
"136818",0,0,1,1,"dummy"
"136820",0,0,0,0,"dummy"
"136821",0,0,2,2,"dummy"
"136827",0,2,0,2,"dummy"
"136828",0,0,1,1,"dummy"
"136831",5,10,2,17,"dummy"
"136832",0,0,0,0,"dummy"
"136844",2,4,0,6,"dummy"
"136845",0,2,0,2,"dummy"
"136846",0,2,0,2,"dummy"
"136847",10,2,0,12,"dummy"
"136848",0,2,0,2,"dummy"
"136851",0,1,0,1,"dummy"
"136852",0,16,0,16,"dummy"
"136854",0,1,0,1,"dummy"
"136858",0,1,0,1,"dummy"
"136859",0,18,2,20,"dummy"
"136860",27,2,2,31,"dummy"
"136861",0,4,1,5,"dummy"
"136862",0,0,1,1,"dummy"
"136865",0,3,3,6,"dummy"
"136866",1,0,2,3,"dummy"
"136867",7,11,1,19,"dummy"
"136868",4,5,1,10,"dummy"
"136870",0,0,1,1,"dummy"
"136871",0,1,0,1,"dummy"
"136872",0,0,1,1,"dummy"
"136874",0,2,0,2,"dummy"
"136875",0,20,0,20,"dummy"
"136876",0,2,3,5,"dummy"
"136877",1,2,0,3,"dummy"
"136878",0,0,1,1,"dummy"
"136879",0,0,1,1,"dummy"
"136881",0,1,0,1,"dummy"
"136889",3,2,2,7,"dummy"
"136890",1,5,0,6,"dummy"
"136891",2,2,0,4,"dummy"
"136892",0,1,1,2,"dummy"
"136894",1,3,0,4,"dummy"
"136895",0,0,1,1,"dummy"
"136896",0,0,1,1,"dummy"
"136897",0,2,1,3,"dummy"
"136898",0,4,0,4,"dummy"
"136900",2,2,0,4,"dummy"
"136901",0,5,0,5,"dummy"
"136902",0,8,0,8,"dummy"
"136903",5,2,2,9,"dummy"
"136904",0,1,0,1,"dummy"
"136905",0,0,2,2,"dummy"
"136906",0,1,0,1,"dummy"
"136907",0,2,0,2,"dummy"
"136908",2,1,0,3,"dummy"
"136910",0,1,0,1,"dummy"
"136913",3,9,2,14,"dummy"
"136914",4,18,2,24,"dummy"
"136915",0,2,0,2,"dummy"
"136918",0,1,0,1,"dummy"
"136919",0,0,1,1,"dummy"
"136920",0,1,0,1,"dummy"
"136922",0,0,1,1,"dummy"
"136937",4,3,2,9,"dummy"
"136938",0,1,0,1,"dummy"
"136939",0,0,2,2,"dummy"
"136940",0,0,1,1,"dummy"
"136941",0,0,1,1,"dummy"
"136942",0,0,1,1,"dummy"
"136944",0,1,0,1,"dummy"
"136945",2,0,0,2,"dummy"
"136946",0,2,0,2,"dummy"
"136947",5,21,2,28,"dummy"
"136948",0,0,1,1,"dummy"
"136949",20,4,2,26,"dummy"
"136950",0,0,1,1,"dummy"
"136951",0,2,0,2,"dummy"
"136952",0,2,0,2,"dummy"
"136953",1,5,0,6,"dummy"
"136954",2,0,0,2,"dummy"
"136955",0,5,0,5,"dummy"
"136956",0,1,0,1,"dummy"
"136957",0,2,0,2,"dummy"
"136958",2,0,0,2,"dummy"
"136960",0,0,0,0,"dummy"
"136970",0,1,2,3,"dummy"
"136971",0,0,0,0,"dummy"
"136974",0,1,0,1,"dummy"
"136975",2,0,0,2,"dummy"
"136976",0,1,0,1,"dummy"
"136977",0,0,0,0,"dummy"
"136978",0,2,0,2,"dummy"
"136979",1,2,1,4,"dummy"
"136980",0,2,0,2,"dummy"
"136981",11,0,0,11,"dummy"
"136982",0,0,1,1,"dummy"
"136983",1,3,0,4,"dummy"
"136984",1,1,1,3,"dummy"
"136985",0,0,1,1,"dummy"
"136986",0,1,0,1,"dummy"
"136988",0,0,1,1,"dummy"
"136991",2,2,0,4,"dummy"
"136993",0,1,0,1,"dummy"
"136996",0,0,0,0,"dummy"
"136997",13,0,0,13,"dummy"
"136998",0,13,0,13,"dummy"
"137000",0,1,0,1,"dummy"
"137009",3,11,1,15,"dummy"
"137010",1,2,0,3,"dummy"
"137011",0,0,1,1,"dummy"
"137012",9,7,3,19,"dummy"
"137013",0,1,3,4,"dummy"
"137015",0,0,0,0,"dummy"
"137016",0,0,1,1,"dummy"
"137019",1,5,0,6,"dummy"
"137022",1,0,0,1,"dummy"
"137023",0,1,0,1,"dummy"
"137024",0,1,0,1,"dummy"
"137025",1,0,0,1,"dummy"
"137026",9,0,1,10,"dummy"
"137029",0,1,0,1,"dummy"
"137030",3,8,1,12,"dummy"
"137031",12,10,4,26,"dummy"
"137032",0,1,0,1,"dummy"
"137033",14,25,3,42,"dummy"
"137035",0,0,1,1,"dummy"
"137037",0,0,0,0,"dummy"
"137038",0,0,0,0,"dummy"
"137039",0,0,0,0,"dummy"
"137040",0,0,0,0,"dummy"
"137041",9,7,4,20,"dummy"
"137042",0,0,1,1,"dummy"
"137043",0,0,0,0,"dummy"
"137044",0,0,0,0,"dummy"
"137045",0,0,2,2,"dummy"
"137048",2,2,0,4,"dummy"
"137049",17,21,3,41,"dummy"
"137050",1,0,0,1,"dummy"
"137051",0,1,0,1,"dummy"
"137052",2,0,0,2,"dummy"
"137053",1,2,0,3,"dummy"
"137056",0,1,0,1,"dummy"
"137057",1,4,1,6,"dummy"
"137059",0,1,0,1,"dummy"
"137060",0,0,0,0,"dummy"
"137069",1,1,0,2,"dummy"
"137071",2,0,0,2,"dummy"
"137072",0,1,0,1,"dummy"
"137073",0,0,1,1,"dummy"
"137074",0,0,1,1,"dummy"
"137076",0,2,0,2,"dummy"
"137078",0,1,0,1,"dummy"
"137079",0,0,2,2,"dummy"
"137083",0,1,0,1,"dummy"
"137084",1,0,0,1,"dummy"
"137085",0,1,0,1,"dummy"
"137086",0,1,0,1,"dummy"
"137087",0,1,0,1,"dummy"
"137088",0,1,0,1,"dummy"
"137090",10,6,2,18,"dummy"
"137091",1,1,1,3,"dummy"
"137093",0,0,1,1,"dummy"
"137096",0,8,1,9,"dummy"
"137098",0,0,1,1,"dummy"
"137099",2,1,1,4,"dummy"
"137111",0,1,1,2,"dummy"
"137112",9,0,2,11,"dummy"
"137114",6,1,1,8,"dummy"
"137115",0,0,0,0,"dummy"
"137117",0,0,1,1,"dummy"
"137119",1,2,0,3,"dummy"
"137120",0,0,1,1,"dummy"
"137121",4,9,2,15,"dummy"
"137122",1,2,0,3,"dummy"
"137123",2,0,0,2,"dummy"
"137124",0,1,0,1,"dummy"
"137126",4,0,0,4,"dummy"
"137127",0,1,0,1,"dummy"
"137128",0,0,0,0,"dummy"
"137129",0,1,0,1,"dummy"
"137130",7,0,0,7,"dummy"
"137131",0,3,0,3,"dummy"
"137133",10,0,0,10,"dummy"
"137134",0,2,0,2,"dummy"
"137135",0,1,0,1,"dummy"
"137137",0,1,0,1,"dummy"
"137141",0,1,0,1,"dummy"
"137142",0,1,0,1,"dummy"
"137143",0,1,0,1,"dummy"
"137144",0,3,0,3,"dummy"
"137145",0,1,0,1,"dummy"
"137146",1,2,0,3,"dummy"
"137147",0,2,0,2,"dummy"
"137148",0,0,1,1,"dummy"
"137149",0,1,0,1,"dummy"
"137150",0,0,1,1,"dummy"
"137151",0,0,1,1,"dummy"
"137152",0,1,0,1,"dummy"
"137153",0,1,0,1,"dummy"
"137154",0,2,0,2,"dummy"
"137160",0,1,1,2,"dummy"
"137170",0,0,1,1,"dummy"
"137171",0,0,1,1,"dummy"
"137172",0,0,2,2,"dummy"
"137173",2,0,4,6,"dummy"
"137174",0,0,4,4,"dummy"
"137175",0,0,1,1,"dummy"
"137212",2,1,2,5,"dummy"
"137220",0,2,0,2,"dummy"
"137221",5,5,1,11,"dummy"
"137222",1,3,1,5,"dummy"
"137223",8,26,8,42,"dummy"
"137224",0,0,1,1,"dummy"
"137225",0,2,3,5,"dummy"
"137226",7,22,7,36,"dummy"
"137251",1,7,1,9,"dummy"
"137261",0,1,0,1,"dummy"
"137262",9,2,1,12,"dummy"
"137269",0,0,2,2,"dummy"
"137274",0,2,0,2,"dummy"
"137275",2,11,0,13,"dummy"
"137282",0,2,1,3,"dummy"
"137283",0,8,0,8,"dummy"
"137284",0,0,1,1,"dummy"
"137285",1,1,0,2,"dummy"
"137360",6,5,2,13,"dummy"
"137370",10,21,1,32,"dummy"
"137371",2,2,0,4,"dummy"
"137372",0,11,1,12,"dummy"
"137373",1,1,2,4,"dummy"
"137381",1,1,1,3,"dummy"
"137386",0,0,0,0,"dummy"
"137393",0,2,0,2,"dummy"
"137394",0,1,0,1,"dummy"
"137395",0,0,1,1,"dummy"
"137396",0,0,1,1,"dummy"
"137397",6,0,0,6,"dummy"
"137398",8,4,3,15,"dummy"
"137399",0,2,0,2,"dummy"
"137400",4,0,0,4,"dummy"
"137401",0,4,0,4,"dummy"
"137402",0,3,1,4,"dummy"
"137403",1,12,0,13,"dummy"
"137404",0,3,0,3,"dummy"
"137419",0,0,1,1,"dummy"
"137436",2,0,0,2,"dummy"
"137437",0,0,1,1,"dummy"
"137438",0,3,0,3,"dummy"
"137439",0,0,1,1,"dummy"
"137440",0,1,0,1,"dummy"
"137441",0,0,0,0,"dummy"
"137442",0,1,0,1,"dummy"
"137449",0,6,0,6,"dummy"
"137450",4,10,0,14,"dummy"
"137451",0,0,3,3,"dummy"
"137452",0,1,0,1,"dummy"
"137489",0,18,1,19,"dummy"
"137496",0,0,0,0,"dummy"
"137497",0,0,0,0,"dummy"
"137500",2,4,1,7,"dummy"
"137236",0,6,0,6,"dummy"
"137237",0,5,0,5,"dummy"
"137238",0,3,0,3,"dummy"
"137239",0,1,0,1,"dummy"
"137240",0,1,0,1,"dummy"
"137241",3,4,1,8,"dummy"
"137242",0,0,2,2,"dummy"
"137243",0,1,0,1,"dummy"
"137253",0,0,1,1,"dummy"
"137254",0,6,1,7,"dummy"
"137255",0,0,1,1,"dummy"
"137256",0,1,1,2,"dummy"
"137257",1,2,1,4,"dummy"
"137289",4,9,0,13,"dummy"
"137290",2,2,0,4,"dummy"
"137291",1,0,0,1,"dummy"
"137292",0,2,0,2,"dummy"
"137293",0,1,0,1,"dummy"
"137294",0,3,0,3,"dummy"
"137295",2,2,0,4,"dummy"
"137296",0,0,0,0,"dummy"
"137297",2,7,3,12,"dummy"
"137298",0,0,1,1,"dummy"
"137299",0,6,0,6,"dummy"
"137300",0,0,2,2,"dummy"
"137301",0,0,1,1,"dummy"
"137302",0,3,0,3,"dummy"
"137303",0,1,0,1,"dummy"
"137304",2,4,1,7,"dummy"
"137305",0,6,0,6,"dummy"
"137306",0,0,1,1,"dummy"
"137307",1,0,0,1,"dummy"
"137308",0,0,3,3,"dummy"
"137309",0,0,3,3,"dummy"
"137310",0,2,0,2,"dummy"
"137311",0,1,0,1,"dummy"
"137312",0,1,0,1,"dummy"
"137313",0,1,0,1,"dummy"
"137314",0,3,0,3,"dummy"
"137315",0,1,0,1,"dummy"
"137316",0,2,0,2,"dummy"
"137317",0,0,0,0,"dummy"
"137318",0,1,0,1,"dummy"
"137319",0,0,0,0,"dummy"
"137320",0,4,0,4,"dummy"
"137321",0,1,0,1,"dummy"
"137322",0,2,0,2,"dummy"
"137323",0,0,1,1,"dummy"
"137324",0,2,0,2,"dummy"
"137325",0,1,0,1,"dummy"
"137326",0,3,0,3,"dummy"
"137327",3,0,0,3,"dummy"
"137328",0,1,0,1,"dummy"
"137329",0,1,0,1,"dummy"
"137330",0,3,0,3,"dummy"
"137331",0,0,1,1,"dummy"
"137332",0,4,0,4,"dummy"
"137333",1,0,0,1,"dummy"
"137334",0,2,0,2,"dummy"
"137335",0,4,0,4,"dummy"
"137336",2,0,4,6,"dummy"
"137337",4,0,0,4,"dummy"
"137338",0,5,0,5,"dummy"
"137339",4,2,1,7,"dummy"
"137340",2,4,1,7,"dummy"
"137341",4,0,1,5,"dummy"
"137342",0,2,1,3,"dummy"
"137343",0,1,0,1,"dummy"
"137344",23,31,5,59,"dummy"
"137345",20,14,1,35,"dummy"
"137346",9,9,0,18,"dummy"
"137347",5,6,1,12,"dummy"
"137348",2,0,0,2,"dummy"
"137349",0,3,0,3,"dummy"
"137350",0,0,0,0,"dummy"
"137351",4,6,0,10,"dummy"
"137352",4,0,0,4,"dummy"
"137353",0,0,0,0,"dummy"
"137354",0,4,0,4,"dummy"
"137355",4,2,0,6,"dummy"
"137356",0,4,0,4,"dummy"
"137357",0,4,0,4,"dummy"
"137358",4,0,0,4,"dummy"
"137362",0,0,1,1,"dummy"
"137363",0,0,2,2,"dummy"
"137364",0,1,1,2,"dummy"
"137375",2,7,4,13,"dummy"
"137376",0,0,1,1,"dummy"
"137377",9,1,0,10,"dummy"
"137383",0,1,0,1,"dummy"
"137384",0,0,4,4,"dummy"
"137414",4,1,0,5,"dummy"
"137415",1,0,0,1,"dummy"
"137416",0,0,0,0,"dummy"
"137417",0,0,0,0,"dummy"
"137423",0,1,1,2,"dummy"
"137424",2,0,1,3,"dummy"
"137425",8,4,4,16,"dummy"
"137426",4,9,5,18,"dummy"
"137427",0,0,0,0,"dummy"
"137428",0,0,1,1,"dummy"
"137429",6,1,0,7,"dummy"
"137430",0,0,0,0,"dummy"
"137431",0,6,0,6,"dummy"
"137432",0,2,0,2,"dummy"
"137433",0,0,0,0,"dummy"
"137434",3,0,5,8,"dummy"
"137444",7,10,0,17,"dummy"
"137447",0,2,0,2,"dummy"
"137454",0,1,0,1,"dummy"
"137465",1,0,0,1,"dummy"
"137466",2,0,0,2,"dummy"
"137469",3,2,1,6,"dummy"
"137470",1,0,0,1,"dummy"
"137473",19,5,2,26,"dummy"
"137478",0,0,1,1,"dummy"
"137481",1,3,0,4,"dummy"
"137486",0,12,0,12,"dummy"
"137487",0,12,2,14,"dummy"
"137493",2,0,0,2,"dummy"
"137494",2,0,0,2,"dummy"
"137504",0,2,0,2,"dummy"
"137505",0,3,5,8,"dummy"
"137524",0,1,1,2,"dummy"
"137534",1,4,0,5,"dummy"
"137535",0,0,0,0,"dummy"
"137536",4,1,0,5,"dummy"
"137546",0,1,0,1,"dummy"
"137547",1,9,0,10,"dummy"
"137548",4,4,2,10,"dummy"
"137549",0,0,2,2,"dummy"
"137550",3,1,1,5,"dummy"
"137551",0,1,1,2,"dummy"
"137552",0,1,0,1,"dummy"
"137553",0,2,0,2,"dummy"
"137554",0,1,1,2,"dummy"
"137555",1,2,1,4,"dummy"
"137556",1,0,0,1,"dummy"
"137557",2,1,1,4,"dummy"
"137558",0,0,1,1,"dummy"
"137559",0,0,1,1,"dummy"
"137560",0,2,0,2,"dummy"
"137561",0,0,1,1,"dummy"
"137562",4,2,1,7,"dummy"
"137603",3,2,0,5,"dummy"
"137604",6,12,2,20,"dummy"
"137501",3,1,0,4,"dummy"
"137502",0,0,0,0,"dummy"
"137507",0,1,1,2,"dummy"
"137508",0,2,1,3,"dummy"
"137509",1,0,1,2,"dummy"
"137510",0,1,0,1,"dummy"
"137511",0,4,1,5,"dummy"
"137512",0,0,1,1,"dummy"
"137513",1,0,0,1,"dummy"
"137514",0,1,0,1,"dummy"
"137515",0,0,1,1,"dummy"
"137516",0,1,0,1,"dummy"
"137517",0,0,1,1,"dummy"
"137520",1,4,1,6,"dummy"
"137526",11,1,0,12,"dummy"
"137527",0,2,0,2,"dummy"
"137530",0,1,1,2,"dummy"
"137531",7,9,7,23,"dummy"
"137532",1,3,0,4,"dummy"
"137542",0,0,2,2,"dummy"
"137543",0,0,1,1,"dummy"
"137544",0,0,2,2,"dummy"
"137564",4,0,0,4,"dummy"
"137565",0,0,1,1,"dummy"
"137566",0,0,0,0,"dummy"
"137567",0,1,0,1,"dummy"
"137570",2,0,0,2,"dummy"
"137571",0,1,0,1,"dummy"
"137572",0,1,0,1,"dummy"
"137573",1,0,0,1,"dummy"
"137574",1,0,0,1,"dummy"
"137575",0,1,0,1,"dummy"
"137578",0,0,0,0,"dummy"
"137579",1,0,0,1,"dummy"
"137580",0,0,1,1,"dummy"
"137581",2,0,0,2,"dummy"
"137582",0,0,1,1,"dummy"
"137583",0,1,0,1,"dummy"
"137584",0,2,0,2,"dummy"
"137591",1,1,0,2,"dummy"
"137592",0,6,0,6,"dummy"
"137593",0,7,0,7,"dummy"
"137594",0,1,0,1,"dummy"
"137595",0,2,0,2,"dummy"
"137596",0,0,1,1,"dummy"
"137601",0,0,0,0,"dummy"
"137611",0,2,1,3,"dummy"
"137612",2,0,0,2,"dummy"
"137613",0,1,0,1,"dummy"
"137614",0,3,0,3,"dummy"
"137615",2,0,0,2,"dummy"
"137616",0,0,0,0,"dummy"
"137617",0,2,0,2,"dummy"
"137618",4,0,0,4,"dummy"
"137619",0,2,0,2,"dummy"
"137635",0,0,2,2,"dummy"
"137636",0,0,2,2,"dummy"
"137637",0,0,1,1,"dummy"
"137643",0,2,0,2,"dummy"
"137654",0,0,0,0,"dummy"
"137655",0,0,0,0,"dummy"
"137656",0,0,0,0,"dummy"
"137657",0,0,0,0,"dummy"
"137658",0,0,0,0,"dummy"
"137659",0,0,0,0,"dummy"
"137660",1,0,0,1,"dummy"
"137661",0,0,0,0,"dummy"
"137662",0,0,1,1,"dummy"
"137663",0,0,0,0,"dummy"
"137664",0,0,0,0,"dummy"
"137665",2,2,0,4,"dummy"
"137688",0,1,0,1,"dummy"
"137605",1,3,0,4,"dummy"
"137606",1,0,1,2,"dummy"
"137607",0,3,0,3,"dummy"
"137608",0,1,0,1,"dummy"
"137609",4,1,2,7,"dummy"
"137633",3,2,0,5,"dummy"
"137641",0,0,1,1,"dummy"
"137645",10,6,1,17,"dummy"
"137646",0,0,0,0,"dummy"
"137647",0,2,0,2,"dummy"
"137648",0,1,0,1,"dummy"
"137667",0,3,0,3,"dummy"
"137670",0,1,0,1,"dummy"
"137690",1,0,0,1,"dummy"
"137691",5,1,0,6,"dummy"
"137711",1,3,0,4,"dummy"
"137712",0,1,1,2,"dummy"
"137713",0,0,1,1,"dummy"
"137714",0,1,0,1,"dummy"
"137715",2,3,4,9,"dummy"
"137716",0,3,0,3,"dummy"
"137719",0,2,1,3,"dummy"
"137724",0,3,0,3,"dummy"
"137736",0,1,6,7,"dummy"
"137760",2,8,0,10,"dummy"
"137763",0,0,0,0,"dummy"
"137764",0,0,0,0,"dummy"
"137765",0,0,0,0,"dummy"
"137777",0,0,2,2,"dummy"
"137778",0,4,0,4,"dummy"
"137779",0,0,2,2,"dummy"
"137780",0,0,2,2,"dummy"
"137781",0,2,0,2,"dummy"
"137785",1,3,0,4,"dummy"
"137796",0,1,0,1,"dummy"
"137828",47,10,4,61,"dummy"
"137853",0,0,0,0,"dummy"
"137854",0,0,0,0,"dummy"
"137855",0,0,0,0,"dummy"
"137856",0,6,0,6,"dummy"
"137869",1,0,0,1,"dummy"
"137870",0,0,3,3,"dummy"
"137871",0,1,0,1,"dummy"
"137872",0,0,0,0,"dummy"
"137875",0,0,1,1,"dummy"
"137876",1,0,0,1,"dummy"
"137877",4,1,0,5,"dummy"
"137878",0,2,2,4,"dummy"
"137883",0,0,0,0,"dummy"
"137888",0,1,0,1,"dummy"
"137889",2,0,2,4,"dummy"
"137900",0,0,4,4,"dummy"
"137901",3,6,1,10,"dummy"
"137902",2,5,0,7,"dummy"
"137903",0,1,0,1,"dummy"
"137904",2,2,0,4,"dummy"
"137905",0,1,0,1,"dummy"
"137906",0,6,0,6,"dummy"
"137907",0,2,0,2,"dummy"
"137708",0,0,2,2,"dummy"
"137709",0,0,2,2,"dummy"
"137721",2,5,0,7,"dummy"
"137722",0,0,2,2,"dummy"
"137726",0,0,1,1,"dummy"
"137727",1,1,0,2,"dummy"
"137728",0,0,1,1,"dummy"
"137729",0,1,0,1,"dummy"
"137732",1,8,0,9,"dummy"
"137753",0,2,0,2,"dummy"
"137754",0,1,0,1,"dummy"
"137755",0,0,1,1,"dummy"
"137756",1,1,0,2,"dummy"
"137767",0,0,1,1,"dummy"
"137768",0,1,0,1,"dummy"
"137769",1,0,0,1,"dummy"
"137774",0,2,0,2,"dummy"
"137775",0,0,1,1,"dummy"
"137783",0,3,0,3,"dummy"
"137787",0,1,0,1,"dummy"
"137816",0,2,0,2,"dummy"
"137817",0,2,0,2,"dummy"
"137818",0,1,0,1,"dummy"
"137819",0,0,0,0,"dummy"
"137858",0,1,0,1,"dummy"
"137859",0,1,0,1,"dummy"
"137860",1,0,0,1,"dummy"
"137861",1,0,0,1,"dummy"
"137864",0,0,1,1,"dummy"
"137865",0,1,1,2,"dummy"
"137866",0,0,4,4,"dummy"
"137867",0,1,0,1,"dummy"
"137885",0,0,1,1,"dummy"
"137886",1,3,0,4,"dummy"
"137891",0,2,0,2,"dummy"
"137892",1,0,1,2,"dummy"
"137923",7,6,2,15,"dummy"
"137926",0,3,0,3,"dummy"
"137927",0,1,0,1,"dummy"
"137928",3,0,0,3,"dummy"
"137929",0,0,3,3,"dummy"
"137930",0,2,0,2,"dummy"
"137931",0,6,0,6,"dummy"
"137932",0,0,0,0,"dummy"
"137933",5,1,2,8,"dummy"
"137934",0,6,0,6,"dummy"
"137935",3,3,0,6,"dummy"
"137936",3,3,0,6,"dummy"
"137937",0,9,1,10,"dummy"
"137950",0,1,0,1,"dummy"
"137953",2,4,0,6,"dummy"
"137954",0,1,0,1,"dummy"
"137955",0,2,0,2,"dummy"
"137956",0,0,1,1,"dummy"
"137957",0,2,1,3,"dummy"
"137958",0,0,0,0,"dummy"
"137959",0,3,0,3,"dummy"
"137960",3,5,0,8,"dummy"
"137961",6,3,1,10,"dummy"
"137962",4,5,0,9,"dummy"
"137963",1,1,0,2,"dummy"
"137964",1,0,2,3,"dummy"
"137965",0,1,2,3,"dummy"
"137966",1,0,2,3,"dummy"
"137967",2,1,0,3,"dummy"
"137968",0,2,3,5,"dummy"
"137995",0,0,0,0,"dummy"
"137996",0,0,0,0,"dummy"
"138013",0,1,0,1,"dummy"
"137908",0,1,0,1,"dummy"
"137909",1,4,13,18,"dummy"
"137910",1,1,0,2,"dummy"
"137911",0,3,0,3,"dummy"
"137916",1,1,0,2,"dummy"
"137917",1,2,0,3,"dummy"
"137920",0,0,1,1,"dummy"
"137921",0,1,1,2,"dummy"
"137939",0,1,0,1,"dummy"
"137940",0,0,0,0,"dummy"
"137941",0,0,0,0,"dummy"
"137942",0,0,2,2,"dummy"
"137943",0,0,1,1,"dummy"
"137944",0,0,1,1,"dummy"
"137945",0,0,0,0,"dummy"
"137946",10,10,3,23,"dummy"
"137947",0,0,1,1,"dummy"
"137948",0,1,1,2,"dummy"
"137970",0,1,0,1,"dummy"
"137971",0,1,0,1,"dummy"
"137972",0,5,0,5,"dummy"
"137973",0,0,0,0,"dummy"
"137974",0,1,0,1,"dummy"
"137975",0,1,0,1,"dummy"
"137976",0,1,0,1,"dummy"
"137977",0,0,1,1,"dummy"
"137978",0,1,0,1,"dummy"
"137979",0,1,0,1,"dummy"
"137980",0,1,0,1,"dummy"
"137981",1,0,1,2,"dummy"
"137982",0,5,0,5,"dummy"
"137983",0,0,0,0,"dummy"
"137984",2,2,0,4,"dummy"
"137985",0,2,0,2,"dummy"
"137988",0,8,0,8,"dummy"
"137989",0,6,0,6,"dummy"
"137992",0,0,1,1,"dummy"
"137993",0,0,1,1,"dummy"
"137998",0,2,0,2,"dummy"
"137999",0,0,1,1,"dummy"
"138000",0,1,0,1,"dummy"
"138006",2,1,1,4,"dummy"
"138007",2,8,2,12,"dummy"
"138008",0,0,1,1,"dummy"
"138009",3,4,1,8,"dummy"
"138010",0,0,1,1,"dummy"
"138011",0,0,1,1,"dummy"
"138048",0,2,0,2,"dummy"
"138049",2,0,1,3,"dummy"
"138050",0,1,0,1,"dummy"
"138051",0,1,0,1,"dummy"
"138052",1,4,1,6,"dummy"
"138053",0,0,1,1,"dummy"
"138054",3,0,5,8,"dummy"
"138055",0,3,5,8,"dummy"
"138056",2,0,5,7,"dummy"
"138057",0,0,0,0,"dummy"
"138058",1,0,0,1,"dummy"
"138061",3,3,0,6,"dummy"
"138062",0,1,0,1,"dummy"
"138063",0,0,1,1,"dummy"
"138071",0,2,0,2,"dummy"
"138075",0,22,0,22,"dummy"
"138076",0,7,0,7,"dummy"
"138077",0,2,0,2,"dummy"
"138078",0,1,0,1,"dummy"
"138081",0,0,1,1,"dummy"
"138082",0,0,2,2,"dummy"
"138083",6,3,4,13,"dummy"
"138084",0,0,3,3,"dummy"
"138090",0,0,1,1,"dummy"
"138091",0,0,0,0,"dummy"
"138094",0,1,0,1,"dummy"
"138096",0,0,3,3,"dummy"
"138097",0,2,0,2,"dummy"
"138098",2,1,0,3,"dummy"
"138099",1,5,6,12,"dummy"
"138105",2,15,1,18,"dummy"
"138106",0,1,0,1,"dummy"
"138107",18,3,0,21,"dummy"
"138108",0,1,0,1,"dummy"
"138109",0,1,0,1,"dummy"
"138110",1,0,0,1,"dummy"
"138111",0,0,1,1,"dummy"
"138112",0,0,1,1,"dummy"
"138113",0,0,0,0,"dummy"
"138114",1,1,8,10,"dummy"
"138115",0,0,1,1,"dummy"
"138116",0,0,1,1,"dummy"
"138117",0,0,1,1,"dummy"
"138118",0,0,0,0,"dummy"
"138121",0,10,1,11,"dummy"
"138123",0,1,0,1,"dummy"
"138124",0,0,0,0,"dummy"
"138125",0,1,0,1,"dummy"
"138127",0,1,0,1,"dummy"
"138128",0,2,0,2,"dummy"
"138130",0,4,0,4,"dummy"
"138131",0,10,0,10,"dummy"
"138132",0,2,0,2,"dummy"
"138133",0,3,0,3,"dummy"
"138134",2,3,0,5,"dummy"
"138135",0,1,0,1,"dummy"
"138136",1,6,0,7,"dummy"
"138137",0,0,1,1,"dummy"
"138139",0,0,1,1,"dummy"
"138140",0,0,4,4,"dummy"
"138141",0,0,1,1,"dummy"
"138142",0,0,3,3,"dummy"
"138143",0,0,1,1,"dummy"
"138144",4,2,0,6,"dummy"
"138145",1,1,3,5,"dummy"
"138146",1,1,3,5,"dummy"
"138147",0,0,1,1,"dummy"
"138148",0,0,1,1,"dummy"
"138150",0,3,0,3,"dummy"
"138159",0,0,1,1,"dummy"
"138161",0,1,0,1,"dummy"
"138162",1,0,0,1,"dummy"
"138163",1,2,2,5,"dummy"
"138164",1,1,0,2,"dummy"
"138165",0,3,0,3,"dummy"
"138166",0,2,0,2,"dummy"
"138167",0,0,1,1,"dummy"
"138168",0,1,0,1,"dummy"
"138169",0,2,0,2,"dummy"
"138170",0,1,0,1,"dummy"
"138171",7,4,0,11,"dummy"
"138172",2,3,0,5,"dummy"
"138173",0,0,0,0,"dummy"
"138174",9,6,3,18,"dummy"
"138178",0,1,0,1,"dummy"
"138184",4,1,0,5,"dummy"
"138185",0,2,0,2,"dummy"
"138186",0,4,0,4,"dummy"
"138187",2,4,0,6,"dummy"
"138188",1,3,0,4,"dummy"
"138192",2,4,0,6,"dummy"
"138193",0,2,0,2,"dummy"
"138194",0,2,0,2,"dummy"
"138195",10,2,0,12,"dummy"
"138196",0,2,0,2,"dummy"
"138197",0,0,0,0,"dummy"
"138198",0,0,3,3,"dummy"
"138199",0,5,0,5,"dummy"
"138202",0,0,1,1,"dummy"
"138204",0,2,1,3,"dummy"
"138205",2,0,1,3,"dummy"
"138207",0,0,0,0,"dummy"
"138236",0,0,3,3,"dummy"
"138238",1,0,1,2,"dummy"
"138239",1,2,0,3,"dummy"
"138242",0,0,0,0,"dummy"
"138246",0,0,1,1,"dummy"
"138250",0,1,0,1,"dummy"
"138252",6,32,4,42,"dummy"
"138253",16,28,3,47,"dummy"
"138259",1,4,2,7,"dummy"
"138260",0,1,2,3,"dummy"
"138262",0,0,1,1,"dummy"
"138263",0,7,0,7,"dummy"
"138264",0,0,5,5,"dummy"
"138265",6,0,2,8,"dummy"
"138266",4,12,1,17,"dummy"
"138267",6,0,0,6,"dummy"
"138268",12,6,3,21,"dummy"
"138269",0,0,1,1,"dummy"
"138270",15,12,5,32,"dummy"
"138273",0,0,1,1,"dummy"
"138286",3,2,0,5,"dummy"
"138287",0,3,0,3,"dummy"
"138289",9,6,1,16,"dummy"
"138292",1,1,2,4,"dummy"
"138295",0,3,0,3,"dummy"
"138296",0,1,0,1,"dummy"
"138298",3,2,0,5,"dummy"
"138299",10,4,0,14,"dummy"
"138300",1,0,0,1,"dummy"
"138301",1,0,1,2,"dummy"
"138304",2,2,2,6,"dummy"
"138305",0,2,0,2,"dummy"
"138308",0,3,0,3,"dummy"
"138309",0,0,1,1,"dummy"
"138315",0,0,1,1,"dummy"
"138316",0,0,0,0,"dummy"
"138318",0,1,0,1,"dummy"
"138320",0,0,1,1,"dummy"
"138327",0,0,2,2,"dummy"
"138332",0,0,2,2,"dummy"
"138333",0,0,1,1,"dummy"
"138335",0,1,0,1,"dummy"
"138336",0,1,0,1,"dummy"
"138337",1,1,1,3,"dummy"
"138338",0,0,2,2,"dummy"
"138339",8,14,0,22,"dummy"
"138340",0,0,0,0,"dummy"
"138341",0,0,0,0,"dummy"
"138342",13,3,1,17,"dummy"
"138343",1,0,0,1,"dummy"
"138344",0,0,0,0,"dummy"
"138345",0,1,0,1,"dummy"
"138346",2,4,3,9,"dummy"
"138348",0,0,2,2,"dummy"
"138350",0,0,2,2,"dummy"
"138352",0,5,2,7,"dummy"
"138353",0,1,1,2,"dummy"
"138354",0,0,2,2,"dummy"
"138355",0,0,2,2,"dummy"
"138356",0,0,0,0,"dummy"
"138358",0,3,0,3,"dummy"
"138359",1,0,0,1,"dummy"
"138361",8,34,2,44,"dummy"
"138362",27,4,2,33,"dummy"
"138363",0,1,1,2,"dummy"
"138364",4,13,1,18,"dummy"
"138365",3,3,0,6,"dummy"
"138366",0,7,0,7,"dummy"
"138367",0,3,0,3,"dummy"
"138368",0,1,0,1,"dummy"
"138369",0,1,0,1,"dummy"
"138370",0,0,1,1,"dummy"
"138371",0,1,0,1,"dummy"
"138373",0,1,0,1,"dummy"
"138375",0,0,1,1,"dummy"
"138377",0,0,2,2,"dummy"
"138379",6,6,0,12,"dummy"
"138380",0,1,0,1,"dummy"
"138381",0,2,0,2,"dummy"
"138389",0,0,2,2,"dummy"
"138390",0,0,1,1,"dummy"
"138391",0,0,2,2,"dummy"
"138392",0,0,1,1,"dummy"
"138393",0,0,2,2,"dummy"
"138395",0,0,1,1,"dummy"
"138397",0,0,1,1,"dummy"
"138398",0,0,2,2,"dummy"
"138399",26,3,7,36,"dummy"
"138405",0,3,0,3,"dummy"
"138406",1,12,2,15,"dummy"
"138407",1,0,0,1,"dummy"
"138408",2,0,1,3,"dummy"
"138410",1,0,0,1,"dummy"
"138411",2,0,1,3,"dummy"
"138412",0,0,0,0,"dummy"
"138413",0,1,0,1,"dummy"
"138414",8,1,0,9,"dummy"
"138415",0,0,0,0,"dummy"
"138416",0,0,0,0,"dummy"
"138417",1,10,0,11,"dummy"
"138418",7,1,0,8,"dummy"
"138419",2,0,3,5,"dummy"
"138449",0,1,0,1,"dummy"
"138450",0,3,0,3,"dummy"
"138451",0,3,0,3,"dummy"
"138452",0,2,0,2,"dummy"
"138453",2,2,0,4,"dummy"
"138463",2,1,0,3,"dummy"
"138464",0,1,0,1,"dummy"
"138465",2,1,1,4,"dummy"
"138466",0,17,0,17,"dummy"
"138467",0,0,1,1,"dummy"
"138468",0,0,1,1,"dummy"
"138469",15,0,0,15,"dummy"
"138470",0,3,0,3,"dummy"
"138471",1,0,0,1,"dummy"
"138472",0,1,0,1,"dummy"
"138473",0,1,1,2,"dummy"
"138474",15,5,0,20,"dummy"
"138477",0,0,1,1,"dummy"
"138499",4,10,4,18,"dummy"
"138507",1,1,1,3,"dummy"
"138508",0,0,1,1,"dummy"
"138509",3,7,4,14,"dummy"
"138510",7,5,3,15,"dummy"
"138511",7,5,2,14,"dummy"
"138512",0,0,3,3,"dummy"
"138513",0,0,1,1,"dummy"
"138514",5,4,3,12,"dummy"
"138515",4,13,0,17,"dummy"
"138516",0,0,1,1,"dummy"
"138517",0,0,1,1,"dummy"
"138518",0,0,1,1,"dummy"
"138519",0,0,1,1,"dummy"
"138520",14,7,5,26,"dummy"
"138521",0,1,0,1,"dummy"
"138522",6,2,0,8,"dummy"
"138523",2,2,0,4,"dummy"
"138568",1,2,0,3,"dummy"
"138572",38,20,2,60,"dummy"
"138573",4,5,2,11,"dummy"
"138574",1,0,0,1,"dummy"
"138575",0,1,0,1,"dummy"
"138586",24,10,2,36,"dummy"
"138587",0,0,0,0,"dummy"
"138588",0,0,1,1,"dummy"
"138421",0,0,1,1,"dummy"
"138424",0,0,3,3,"dummy"
"138425",12,1,0,13,"dummy"
"138426",4,0,0,4,"dummy"
"138427",6,5,0,11,"dummy"
"138428",1,2,0,3,"dummy"
"138429",1,0,0,1,"dummy"
"138430",0,1,0,1,"dummy"
"138431",5,3,0,8,"dummy"
"138432",0,1,0,1,"dummy"
"138433",1,1,0,2,"dummy"
"138434",16,15,0,31,"dummy"
"138435",3,4,0,7,"dummy"
"138436",13,6,0,19,"dummy"
"138437",4,3,0,7,"dummy"
"138438",2,0,0,2,"dummy"
"138439",0,2,0,2,"dummy"
"138440",0,2,0,2,"dummy"
"138441",0,0,1,1,"dummy"
"138442",3,3,3,9,"dummy"
"138443",0,0,1,1,"dummy"
"138444",0,0,1,1,"dummy"
"138447",0,1,0,1,"dummy"
"138455",4,9,4,17,"dummy"
"138479",3,0,1,4,"dummy"
"138482",0,0,0,0,"dummy"
"138483",0,0,0,0,"dummy"
"138484",1,0,0,1,"dummy"
"138485",0,0,0,0,"dummy"
"138486",0,2,0,2,"dummy"
"138497",1,0,0,1,"dummy"
"138501",1,0,0,1,"dummy"
"138502",0,19,1,20,"dummy"
"138503",1,6,1,8,"dummy"
"138504",0,0,1,1,"dummy"
"138505",2,14,1,17,"dummy"
"138541",0,0,1,1,"dummy"
"138542",0,0,1,1,"dummy"
"138543",0,0,1,1,"dummy"
"138544",0,0,1,1,"dummy"
"138547",0,0,1,1,"dummy"
"138548",0,1,0,1,"dummy"
"138551",0,16,0,16,"dummy"
"138554",0,0,0,0,"dummy"
"138555",0,0,0,0,"dummy"
"138560",0,1,0,1,"dummy"
"138561",0,0,1,1,"dummy"
"138564",3,5,0,8,"dummy"
"138565",0,0,5,5,"dummy"
"138566",0,0,0,0,"dummy"
"138577",0,0,1,1,"dummy"
"138578",0,2,0,2,"dummy"
"138579",1,22,0,23,"dummy"
"138580",21,2,1,24,"dummy"
"138581",9,14,2,25,"dummy"
"138582",0,0,0,0,"dummy"
"138583",0,2,0,2,"dummy"
"138584",0,0,0,0,"dummy"
"138590",0,0,1,1,"dummy"
"138594",0,2,0,2,"dummy"
"138595",2,0,0,2,"dummy"
"138596",0,2,0,2,"dummy"
"138597",1,2,0,3,"dummy"
"138632",0,1,1,2,"dummy"
"138633",0,2,0,2,"dummy"
"138634",0,6,0,6,"dummy"
"138635",0,1,1,2,"dummy"
"138636",1,1,0,2,"dummy"
"138637",0,1,0,1,"dummy"
"138638",4,0,0,4,"dummy"
"138639",0,5,0,5,"dummy"
"138640",1,0,1,2,"dummy"
"138641",0,4,0,4,"dummy"
"138642",0,2,0,2,"dummy"
"138643",0,0,3,3,"dummy"
"138644",4,1,0,5,"dummy"
"138645",0,10,0,10,"dummy"
"138646",0,0,4,4,"dummy"
"138662",0,1,0,1,"dummy"
"138663",0,0,0,0,"dummy"
"138664",0,5,0,5,"dummy"
"138665",0,2,0,2,"dummy"
"138666",0,0,0,0,"dummy"
"138667",7,5,1,13,"dummy"
"138668",0,3,0,3,"dummy"
"138669",0,3,0,3,"dummy"
"138670",0,1,0,1,"dummy"
"138671",1,2,1,4,"dummy"
"138672",5,4,0,9,"dummy"
"138673",18,19,3,40,"dummy"
"138680",0,6,0,6,"dummy"
"138681",1,6,2,9,"dummy"
"138682",0,1,0,1,"dummy"
"138683",0,9,0,9,"dummy"
"138684",7,3,1,11,"dummy"
"138685",2,2,4,8,"dummy"
"138686",0,0,1,1,"dummy"
"138687",0,0,1,1,"dummy"
"138688",2,0,0,2,"dummy"
"138689",0,0,1,1,"dummy"
"138696",1,3,0,4,"dummy"
"138697",2,10,0,12,"dummy"
"138698",1,6,0,7,"dummy"
"138699",0,1,0,1,"dummy"
"138700",0,2,0,2,"dummy"
"138701",0,0,1,1,"dummy"
"138702",3,4,0,7,"dummy"
"138703",22,1,0,23,"dummy"
"138704",0,3,0,3,"dummy"
"138710",0,0,1,1,"dummy"
"138713",0,1,0,1,"dummy"
"138714",5,3,1,9,"dummy"
"138715",0,0,1,1,"dummy"
"138716",11,4,5,20,"dummy"
"138717",0,1,1,2,"dummy"
"138718",0,2,1,3,"dummy"
"138722",0,0,1,1,"dummy"
"138723",0,0,1,1,"dummy"
"138724",0,0,1,1,"dummy"
"138727",8,17,1,26,"dummy"
"138728",14,3,5,22,"dummy"
"138729",1,1,6,8,"dummy"
"138730",0,1,1,2,"dummy"
"138735",1,0,0,1,"dummy"
"138762",13,15,3,31,"dummy"
"138763",1,1,0,2,"dummy"
"138764",3,6,5,14,"dummy"
"138765",0,0,0,0,"dummy"
"138766",0,3,0,3,"dummy"
"138767",5,0,0,5,"dummy"
"138768",0,0,1,1,"dummy"
"138769",4,0,0,4,"dummy"
"138772",0,3,0,3,"dummy"
"138776",0,0,1,1,"dummy"
"138777",10,1,0,11,"dummy"
"138778",0,0,0,0,"dummy"
"138779",0,0,1,1,"dummy"
"138780",0,0,1,1,"dummy"
"138781",1,1,1,3,"dummy"
"138782",0,0,1,1,"dummy"
"138783",0,0,1,1,"dummy"
"138784",0,1,0,1,"dummy"
"138785",3,5,0,8,"dummy"
"138786",0,0,1,1,"dummy"
"138787",0,0,1,1,"dummy"
"138788",1,1,0,2,"dummy"
"138789",2,4,1,7,"dummy"
"138790",0,0,1,1,"dummy"
"138791",0,1,0,1,"dummy"
"138792",2,6,0,8,"dummy"
"138793",1,3,0,4,"dummy"
"138794",0,0,1,1,"dummy"
"138795",5,0,0,5,"dummy"
"138796",5,8,0,13,"dummy"
"138797",0,1,0,1,"dummy"
"138798",1,0,0,1,"dummy"
"138799",6,6,2,14,"dummy"
"138800",7,7,3,17,"dummy"
"138801",1,0,0,1,"dummy"
"138802",0,2,1,3,"dummy"
"138803",1,1,1,3,"dummy"
"138647",0,0,1,1,"dummy"
"138648",0,0,1,1,"dummy"
"138649",2,2,4,8,"dummy"
"138650",0,0,0,0,"dummy"
"138651",6,2,0,8,"dummy"
"138691",0,0,3,3,"dummy"
"138692",1,2,1,4,"dummy"
"138693",6,1,0,7,"dummy"
"138694",0,0,1,1,"dummy"
"138708",0,13,0,13,"dummy"
"138720",0,1,0,1,"dummy"
"138744",0,0,0,0,"dummy"
"138745",0,0,0,0,"dummy"
"138748",0,17,0,17,"dummy"
"138749",6,7,9,22,"dummy"
"138758",0,0,1,1,"dummy"
"138759",1,1,2,4,"dummy"
"138760",0,0,1,1,"dummy"
"138774",5,11,1,17,"dummy"
"138807",0,0,1,1,"dummy"
"138808",0,0,1,1,"dummy"
"138809",0,1,0,1,"dummy"
"138835",0,0,0,0,"dummy"
"138844",0,0,4,4,"dummy"
"138845",7,6,0,13,"dummy"
"138846",0,0,3,3,"dummy"
"138863",0,1,0,1,"dummy"
"138873",0,0,1,1,"dummy"
"138874",10,9,2,21,"dummy"
"138875",0,1,0,1,"dummy"
"138876",0,1,0,1,"dummy"
"138882",0,1,0,1,"dummy"
"138883",0,1,0,1,"dummy"
"138884",0,5,0,5,"dummy"
"138898",1,0,0,1,"dummy"
"138899",0,2,0,2,"dummy"
"138923",37,8,5,50,"dummy"
"138926",0,0,1,1,"dummy"
"138804",0,2,1,3,"dummy"
"138805",0,1,0,1,"dummy"
"138833",2,3,0,5,"dummy"
"138837",2,6,0,8,"dummy"
"138838",1,1,1,3,"dummy"
"138839",0,0,2,2,"dummy"
"138840",0,0,2,2,"dummy"
"138841",10,12,5,27,"dummy"
"138842",0,3,0,3,"dummy"
"138848",0,0,2,2,"dummy"
"138849",0,0,1,1,"dummy"
"138852",0,0,1,1,"dummy"
"138853",4,12,1,17,"dummy"
"138856",0,1,2,3,"dummy"
"138861",0,11,3,14,"dummy"
"138865",4,3,3,10,"dummy"
"138866",2,4,4,10,"dummy"
"138867",0,0,1,1,"dummy"
"138868",3,2,4,9,"dummy"
"138869",0,0,0,0,"dummy"
"138870",0,0,1,1,"dummy"
"138871",0,0,3,3,"dummy"
"138880",3,8,4,15,"dummy"
"138886",2,5,0,7,"dummy"
"138887",0,2,0,2,"dummy"
"138888",0,1,0,1,"dummy"
"138889",6,8,0,14,"dummy"
"138890",4,3,0,7,"dummy"
"138891",0,0,2,2,"dummy"
"138892",0,0,2,2,"dummy"
"138940",0,1,0,1,"dummy"
"138941",0,1,0,1,"dummy"
"138942",0,1,1,2,"dummy"
"138943",1,1,0,2,"dummy"
"138944",0,0,0,0,"dummy"
"138958",0,1,0,1,"dummy"
"138963",1,0,2,3,"dummy"
"138964",0,3,2,5,"dummy"
"138965",0,1,0,1,"dummy"
"138966",0,0,3,3,"dummy"
"138967",5,6,0,11,"dummy"
"138976",0,0,2,2,"dummy"
"138979",0,0,2,2,"dummy"
"138980",1,0,1,2,"dummy"
"138981",0,0,1,1,"dummy"
"138982",2,2,1,5,"dummy"
"138988",0,1,0,1,"dummy"
"138989",1,1,0,2,"dummy"
"138992",0,1,1,2,"dummy"
"138993",0,1,0,1,"dummy"
"138994",2,6,1,9,"dummy"
"138997",4,2,0,6,"dummy"
"138998",0,2,0,2,"dummy"
"138999",0,1,0,1,"dummy"
"139000",0,1,0,1,"dummy"
"139001",2,0,0,2,"dummy"
"139002",1,0,0,1,"dummy"
"139003",1,2,0,3,"dummy"
"139004",0,1,1,2,"dummy"
"139005",10,9,5,24,"dummy"
"138938",0,0,2,2,"dummy"
"138952",0,0,1,1,"dummy"
"138953",0,0,2,2,"dummy"
"138954",2,0,4,6,"dummy"
"138955",0,0,4,4,"dummy"
"138956",0,0,1,1,"dummy"
"138971",2,4,2,8,"dummy"
"138972",4,1,0,5,"dummy"
"138973",1,2,2,5,"dummy"
"138974",1,1,3,5,"dummy"
"138984",0,0,0,0,"dummy"
"139024",1,1,0,2,"dummy"
"139025",0,10,0,10,"dummy"
"139084",0,0,1,1,"dummy"
"139088",0,1,0,1,"dummy"
"139089",0,5,0,5,"dummy"
"139090",0,1,0,1,"dummy"
"139091",0,1,0,1,"dummy"
"139092",2,9,0,11,"dummy"
"139093",0,6,0,6,"dummy"
"139094",2,0,0,2,"dummy"
"139097",0,0,2,2,"dummy"
"139119",0,0,0,0,"dummy"
"139120",4,8,0,12,"dummy"
"139121",1,0,0,1,"dummy"
"139125",0,1,0,1,"dummy"
"139126",0,3,0,3,"dummy"
"139127",10,2,2,14,"dummy"
"139128",10,3,0,13,"dummy"
"139129",0,0,1,1,"dummy"
"139130",0,0,1,1,"dummy"
"139131",0,2,0,2,"dummy"
"139132",0,1,0,1,"dummy"
"139133",0,1,0,1,"dummy"
"139141",1,4,1,6,"dummy"
"139142",0,0,3,3,"dummy"
"139143",0,0,3,3,"dummy"
"139144",0,1,1,2,"dummy"
"139145",0,0,1,1,"dummy"
"139146",0,0,1,1,"dummy"
"139147",0,0,1,1,"dummy"
"139148",0,0,4,4,"dummy"
"139149",0,1,1,2,"dummy"
"139150",0,0,1,1,"dummy"
"139155",1,2,1,4,"dummy"
"139201",0,1,3,4,"dummy"
"139202",1,0,0,1,"dummy"
"139203",1,2,0,3,"dummy"
"139204",1,3,4,8,"dummy"
"139233",2,0,1,3,"dummy"
"139022",0,0,1,1,"dummy"
"139038",0,1,2,3,"dummy"
"139039",0,0,0,0,"dummy"
"139040",0,1,0,1,"dummy"
"139041",4,0,2,6,"dummy"
"139042",1,0,0,1,"dummy"
"139043",0,0,0,0,"dummy"
"139044",0,0,0,0,"dummy"
"139080",0,0,2,2,"dummy"
"139081",0,0,3,3,"dummy"
"139082",4,6,0,10,"dummy"
"139086",0,0,0,0,"dummy"
"139123",0,0,1,1,"dummy"
"139135",1,0,0,1,"dummy"
"139138",0,4,0,4,"dummy"
"139139",0,1,0,1,"dummy"
"139206",2,0,1,3,"dummy"
"139207",7,8,0,15,"dummy"
"139208",0,0,0,0,"dummy"
"139209",0,0,0,0,"dummy"
"139210",0,0,0,0,"dummy"
"139211",0,0,0,0,"dummy"
"139212",1,0,0,1,"dummy"
"139213",0,0,0,0,"dummy"
"139214",0,0,0,0,"dummy"
"139215",0,0,0,0,"dummy"
"139216",0,0,0,0,"dummy"
"139217",0,0,0,0,"dummy"
"139218",7,1,2,10,"dummy"
"139235",4,1,0,5,"dummy"
"139240",0,1,2,3,"dummy"
"139241",0,0,1,1,"dummy"
"139242",0,0,1,1,"dummy"
"139243",0,0,2,2,"dummy"
"139244",0,0,1,1,"dummy"
"139247",0,0,1,1,"dummy"
"139253",8,8,2,18,"dummy"
"139254",1,1,0,2,"dummy"
"139255",1,1,0,2,"dummy"
"139256",0,0,0,0,"dummy"
"139257",0,1,1,2,"dummy"
"139258",0,0,2,2,"dummy"
"139259",4,0,2,6,"dummy"
"139261",0,0,4,4,"dummy"
"139262",0,2,1,3,"dummy"
"139265",4,3,1,8,"dummy"
"139266",0,0,0,0,"dummy"
"139267",0,0,1,1,"dummy"
"139269",4,5,0,9,"dummy"
"139270",4,3,0,7,"dummy"
"139272",2,5,2,9,"dummy"
"139274",0,0,2,2,"dummy"
"139277",0,0,0,0,"dummy"
"139278",0,0,1,1,"dummy"
"139281",0,3,0,3,"dummy"
"139282",0,2,0,2,"dummy"
"139283",3,1,0,4,"dummy"
"139284",2,0,1,3,"dummy"
"139286",0,1,0,1,"dummy"
"139288",0,0,1,1,"dummy"
"139290",0,1,0,1,"dummy"
"139291",0,2,0,2,"dummy"
"139292",1,0,0,1,"dummy"
"139293",0,2,0,2,"dummy"
"139294",0,0,1,1,"dummy"
"139296",0,4,0,4,"dummy"
"139297",0,2,0,2,"dummy"
"139305",0,0,0,0,"dummy"
"139309",1,2,1,4,"dummy"
"139313",0,3,0,3,"dummy"
"139315",0,0,4,4,"dummy"
"139316",4,2,3,9,"dummy"
"139317",1,1,1,3,"dummy"
"139320",0,0,1,1,"dummy"
"139321",0,0,0,0,"dummy"
"139322",0,0,2,2,"dummy"
"139323",0,0,0,0,"dummy"
"139327",0,0,2,2,"dummy"
"139328",0,0,1,1,"dummy"
"139329",0,4,3,7,"dummy"
"139331",1,0,0,1,"dummy"
"139332",0,2,0,2,"dummy"
"139333",1,7,1,9,"dummy"
"139334",0,0,1,1,"dummy"
"139338",1,1,0,2,"dummy"
"139339",1,2,0,3,"dummy"
"139344",0,0,1,1,"dummy"
"139345",0,0,1,1,"dummy"
"139346",0,0,2,2,"dummy"
"139347",26,3,7,36,"dummy"
"139351",0,1,1,2,"dummy"
"139361",0,1,0,1,"dummy"
"139362",0,1,0,1,"dummy"
"139363",2,0,0,2,"dummy"
"139365",0,1,0,1,"dummy"
"139366",0,2,0,2,"dummy"
"139367",1,3,0,4,"dummy"
"139368",7,6,4,17,"dummy"
"139369",0,1,0,1,"dummy"
"139371",2,4,0,6,"dummy"
"139372",0,2,0,2,"dummy"
"139373",0,2,0,2,"dummy"
"139374",10,2,0,12,"dummy"
"139375",0,2,0,2,"dummy"
"139376",0,0,0,0,"dummy"
"139377",0,0,3,3,"dummy"
"139378",0,5,0,5,"dummy"
"139379",1,0,1,2,"dummy"
"139381",6,1,1,8,"dummy"
"139382",1,1,0,2,"dummy"
"139383",0,5,0,5,"dummy"
"139386",2,0,2,4,"dummy"
"139387",0,1,0,1,"dummy"
"139388",0,0,2,2,"dummy"
"139389",1,1,1,3,"dummy"
"139390",0,0,1,1,"dummy"
"139393",0,1,0,1,"dummy"
"139394",0,1,0,1,"dummy"
"139395",0,3,0,3,"dummy"
"139396",3,1,0,4,"dummy"
"139397",1,3,0,4,"dummy"
"139402",0,0,1,1,"dummy"
"139403",0,0,2,2,"dummy"
"139404",0,1,1,2,"dummy"
"139412",0,3,0,3,"dummy"
"139414",0,0,0,0,"dummy"
"139415",0,0,0,0,"dummy"
"139416",6,12,0,18,"dummy"
"139417",1,1,2,4,"dummy"
"139418",0,0,1,1,"dummy"
"139419",0,0,1,1,"dummy"
"139420",0,0,1,1,"dummy"
"139421",0,0,1,1,"dummy"
"139422",0,0,1,1,"dummy"
"139423",0,0,1,1,"dummy"
"139424",0,0,1,1,"dummy"
"139425",0,0,2,2,"dummy"
"139428",15,1,0,16,"dummy"
"139430",3,0,1,4,"dummy"
"139431",0,0,1,1,"dummy"
"139434",3,0,2,5,"dummy"
"139436",12,3,2,17,"dummy"
"139437",0,1,0,1,"dummy"
"139442",0,0,0,0,"dummy"
"139443",0,0,1,1,"dummy"
"139444",0,1,0,1,"dummy"
"139445",2,2,5,9,"dummy"
"139447",1,8,0,9,"dummy"
"139448",0,4,1,5,"dummy"
"139449",0,3,1,4,"dummy"
"139450",0,1,0,1,"dummy"
"139451",0,1,0,1,"dummy"
"139452",21,10,1,32,"dummy"
"139453",3,0,1,4,"dummy"
"139454",1,14,0,15,"dummy"
"139455",0,4,0,4,"dummy"
"139456",15,5,2,22,"dummy"
"139457",1,15,1,17,"dummy"
"139458",12,13,2,27,"dummy"
"139459",0,9,2,11,"dummy"
"139460",1,0,0,1,"dummy"
"139461",3,0,0,3,"dummy"
"139462",0,1,0,1,"dummy"
"139463",0,2,0,2,"dummy"
"139464",2,2,0,4,"dummy"
"139465",2,2,0,4,"dummy"
"139466",0,0,1,1,"dummy"
"139467",0,0,2,2,"dummy"
"139468",0,0,1,1,"dummy"
"139469",2,2,0,4,"dummy"
"139470",0,1,0,1,"dummy"
"139471",0,1,0,1,"dummy"
"139472",1,2,0,3,"dummy"
"139473",1,1,1,3,"dummy"
"139476",1,0,0,1,"dummy"
"139477",0,3,3,6,"dummy"
"139481",0,0,5,5,"dummy"
"139484",0,5,0,5,"dummy"
"139485",0,1,0,1,"dummy"
"139486",0,1,0,1,"dummy"
"139487",0,1,0,1,"dummy"
"139488",0,1,0,1,"dummy"
"139489",0,1,0,1,"dummy"
"139492",0,0,1,1,"dummy"
"139493",4,1,0,5,"dummy"
"139494",3,4,2,9,"dummy"
"139495",1,5,0,6,"dummy"
"139499",1,10,0,11,"dummy"
"139500",0,0,0,0,"dummy"
"139501",3,0,0,3,"dummy"
"139502",0,1,0,1,"dummy"
"139503",0,2,0,2,"dummy"
"139504",1,4,1,6,"dummy"
"139505",1,0,3,4,"dummy"
"139507",0,8,0,8,"dummy"
"139508",1,0,3,4,"dummy"
"139510",32,12,1,45,"dummy"
"139511",0,2,0,2,"dummy"
"139516",0,1,0,1,"dummy"
"139522",0,0,0,0,"dummy"
"139523",1,0,7,8,"dummy"
"139524",0,0,3,3,"dummy"
"139525",2,18,0,20,"dummy"
"139526",0,0,1,1,"dummy"
"139527",0,0,0,0,"dummy"
"139528",0,0,1,1,"dummy"
"139531",2,6,1,9,"dummy"
"139532",0,0,1,1,"dummy"
"139533",3,0,0,3,"dummy"
"139534",0,0,0,0,"dummy"
"139535",1,3,1,5,"dummy"
"139536",0,0,1,1,"dummy"
"139537",0,2,1,3,"dummy"
"139538",0,0,1,1,"dummy"
"139539",0,0,1,1,"dummy"
"139540",0,0,0,0,"dummy"
"139541",1,0,0,1,"dummy"
"139543",0,2,0,2,"dummy"
"139546",0,0,1,1,"dummy"
"139547",0,0,1,1,"dummy"
"139549",0,1,0,1,"dummy"
"139553",0,0,1,1,"dummy"
"139556",2,3,2,7,"dummy"
"139566",4,0,0,4,"dummy"
"139570",0,1,0,1,"dummy"
"139571",0,1,1,2,"dummy"
"139572",0,1,0,1,"dummy"
"139573",0,1,0,1,"dummy"
"139574",1,0,0,1,"dummy"
"139575",0,0,1,1,"dummy"
"139576",0,0,1,1,"dummy"
"139577",0,0,1,1,"dummy"
"139578",1,1,0,2,"dummy"
"139579",0,0,1,1,"dummy"
"139580",0,2,0,2,"dummy"
"139581",0,1,0,1,"dummy"
"139582",0,0,0,0,"dummy"
"139583",0,1,0,1,"dummy"
"139584",0,1,1,2,"dummy"
"139585",1,0,1,2,"dummy"
"139586",0,2,1,3,"dummy"
"139587",2,0,1,3,"dummy"
"139588",0,2,1,3,"dummy"
"139589",4,4,0,8,"dummy"
"139591",1,0,1,2,"dummy"
"139592",1,2,0,3,"dummy"
"139593",3,0,1,4,"dummy"
"139594",2,0,0,2,"dummy"
"139596",0,0,2,2,"dummy"
"139597",0,1,0,1,"dummy"
"139598",0,1,0,1,"dummy"
"139599",0,1,0,1,"dummy"
"139601",3,2,1,6,"dummy"
"139604",0,1,0,1,"dummy"
"139605",0,3,0,3,"dummy"
"139606",9,9,0,18,"dummy"
"139607",2,2,0,4,"dummy"
"139608",9,9,0,18,"dummy"
"139609",0,5,0,5,"dummy"
"139610",0,0,1,1,"dummy"
"139611",4,1,5,10,"dummy"
"139612",0,2,1,3,"dummy"
"139613",0,0,1,1,"dummy"
"139614",0,4,0,4,"dummy"
"139615",1,0,1,2,"dummy"
"139616",0,1,0,1,"dummy"
"139617",7,7,0,14,"dummy"
"139618",2,0,0,2,"dummy"
"139619",0,3,0,3,"dummy"
"139620",8,2,0,10,"dummy"
"139621",0,1,0,1,"dummy"
"139622",2,3,0,5,"dummy"
"139623",4,6,1,11,"dummy"
"139624",0,9,0,9,"dummy"
"139631",0,12,0,12,"dummy"
"139632",0,2,3,5,"dummy"
"139633",1,2,2,5,"dummy"
"139634",3,5,4,12,"dummy"
"139635",2,5,8,15,"dummy"
"139636",0,2,0,2,"dummy"
"139637",1,12,3,16,"dummy"
"139638",13,0,2,15,"dummy"
"139639",0,4,0,4,"dummy"
"139640",0,0,1,1,"dummy"
"139641",6,0,0,6,"dummy"
"139642",0,6,0,6,"dummy"
"139643",0,4,0,4,"dummy"
"139644",0,1,0,1,"dummy"
"139645",0,0,1,1,"dummy"
"139646",26,13,1,40,"dummy"
"139647",0,4,0,4,"dummy"
"139648",0,0,1,1,"dummy"
"139649",2,2,0,4,"dummy"
"139650",0,1,1,2,"dummy"
"139651",0,2,0,2,"dummy"
"139652",1,0,1,2,"dummy"
"139653",9,9,1,19,"dummy"
"139665",2,0,3,5,"dummy"
"139666",1,0,0,1,"dummy"
"139667",0,1,0,1,"dummy"
"139668",0,1,1,2,"dummy"
"139670",7,5,2,14,"dummy"
"139671",0,0,1,1,"dummy"
"139672",0,0,1,1,"dummy"
"139673",5,8,0,13,"dummy"
"139674",0,0,1,1,"dummy"
"139675",2,0,0,2,"dummy"
"139679",5,4,0,9,"dummy"
"139682",0,0,1,1,"dummy"
"139683",2,20,0,22,"dummy"
"139684",0,0,0,0,"dummy"
"139685",0,2,1,3,"dummy"
"139687",0,2,0,2,"dummy"
"139688",1,0,0,1,"dummy"
"139705",0,1,0,1,"dummy"
"139706",7,13,3,23,"dummy"
"139707",2,0,2,4,"dummy"
"139708",0,0,1,1,"dummy"
"139709",0,0,1,1,"dummy"
"139712",0,0,0,0,"dummy"
"139713",0,0,1,1,"dummy"
"139714",0,1,2,3,"dummy"
"139715",2,0,0,2,"dummy"
"139717",0,0,1,1,"dummy"
"139719",1,2,1,4,"dummy"
"139722",3,0,3,6,"dummy"
"139725",1,24,2,27,"dummy"
"139726",0,3,1,4,"dummy"
"139727",3,2,1,6,"dummy"
"139728",1,0,0,1,"dummy"
"139729",3,0,0,3,"dummy"
"139731",0,0,0,0,"dummy"
"139732",2,0,0,2,"dummy"
"139733",0,0,0,0,"dummy"
"139746",0,1,0,1,"dummy"
"139749",4,1,4,9,"dummy"
"139750",1,4,4,9,"dummy"
"139752",0,4,0,4,"dummy"
"139753",0,0,1,1,"dummy"
"139754",0,1,1,2,"dummy"
"139755",0,1,0,1,"dummy"
"139756",3,0,3,6,"dummy"
"139757",2,2,1,5,"dummy"
"139758",0,1,0,1,"dummy"
"139759",0,1,0,1,"dummy"
"139760",1,1,0,2,"dummy"
"139763",0,6,0,6,"dummy"
"139765",0,1,0,1,"dummy"
"139766",0,0,1,1,"dummy"
"139769",1,1,0,2,"dummy"
"139770",0,0,1,1,"dummy"
"139771",0,3,0,3,"dummy"
"139772",1,4,1,6,"dummy"
"139774",0,0,1,1,"dummy"
"139775",8,7,0,15,"dummy"
"139776",0,0,2,2,"dummy"
"139777",0,0,3,3,"dummy"
"139778",0,0,0,0,"dummy"
"139779",0,0,0,0,"dummy"
"139780",0,0,0,0,"dummy"
"139781",0,0,0,0,"dummy"
"139782",0,0,0,0,"dummy"
"139784",0,0,1,1,"dummy"
"139785",0,0,1,1,"dummy"
"139786",0,0,1,1,"dummy"
"139788",0,3,0,3,"dummy"
"139792",0,0,0,0,"dummy"
"139793",0,2,2,4,"dummy"
"139794",0,7,0,7,"dummy"
"139795",0,1,0,1,"dummy"
"139796",1,0,0,1,"dummy"
"139797",7,1,1,9,"dummy"
"139798",0,3,0,3,"dummy"
"139799",3,1,0,4,"dummy"
"139803",3,4,0,7,"dummy"
"139804",0,0,1,1,"dummy"
"139805",1,0,0,1,"dummy"
"139806",0,1,0,1,"dummy"
"139808",0,1,0,1,"dummy"
"139809",3,3,0,6,"dummy"
"139810",1,1,0,2,"dummy"
"139811",0,0,0,0,"dummy"
"139812",0,0,1,1,"dummy"
"139813",4,4,0,8,"dummy"
"139814",0,0,1,1,"dummy"
"139815",0,0,1,1,"dummy"
"139816",0,0,1,1,"dummy"
"139817",0,0,1,1,"dummy"
"139818",0,0,1,1,"dummy"
"139819",2,1,4,7,"dummy"
"139820",3,3,0,6,"dummy"
"139821",5,2,1,8,"dummy"
"139822",0,0,1,1,"dummy"
"139823",0,0,1,1,"dummy"
"139824",3,0,5,8,"dummy"
"139832",0,0,1,1,"dummy"
"139835",3,3,0,6,"dummy"
"139836",0,5,1,6,"dummy"
"139837",0,0,1,1,"dummy"
"139838",0,0,2,2,"dummy"
"139844",0,0,1,1,"dummy"
"139846",2,4,0,6,"dummy"
"139847",0,2,0,2,"dummy"
"139848",0,2,0,2,"dummy"
"139849",10,2,0,12,"dummy"
"139850",0,2,0,2,"dummy"
"139851",0,0,0,0,"dummy"
"139852",0,0,3,3,"dummy"
"139853",0,5,0,5,"dummy"
"139855",1,5,0,6,"dummy"
"139856",4,6,0,10,"dummy"
"139857",0,4,0,4,"dummy"
"139863",1,0,0,1,"dummy"
"139864",0,1,0,1,"dummy"
"139865",0,1,0,1,"dummy"
"139866",2,2,2,6,"dummy"
"139867",0,0,0,0,"dummy"
"139868",0,3,2,5,"dummy"
"139869",2,3,0,5,"dummy"
"139871",0,15,1,16,"dummy"
"139872",0,3,1,4,"dummy"
"139873",14,0,1,15,"dummy"
"139874",0,2,0,2,"dummy"
"139875",5,1,2,8,"dummy"
"139876",0,6,1,7,"dummy"
"139878",6,7,6,19,"dummy"
"139885",3,1,0,4,"dummy"
"139886",0,4,0,4,"dummy"
"139887",0,1,0,1,"dummy"
"139888",0,2,2,4,"dummy"
"139893",0,10,0,10,"dummy"
"139895",0,0,0,0,"dummy"
"139896",0,0,0,0,"dummy"
"139897",0,1,0,1,"dummy"
"139898",0,0,1,1,"dummy"
"139899",1,0,0,1,"dummy"
"139902",1,0,0,1,"dummy"
"139903",0,0,1,1,"dummy"
"139918",0,6,0,6,"dummy"
"139919",0,1,0,1,"dummy"
"139920",0,0,0,0,"dummy"
"139928",1,0,0,1,"dummy"
"139929",0,0,1,1,"dummy"
"139936",8,10,2,20,"dummy"
"139937",1,1,0,2,"dummy"
"139938",4,0,0,4,"dummy"
"139940",0,3,2,5,"dummy"
"139941",0,3,0,3,"dummy"
"139942",0,0,2,2,"dummy"
"139946",2,6,1,9,"dummy"
"139947",6,3,2,11,"dummy"
"139949",0,6,1,7,"dummy"
"139951",1,1,2,4,"dummy"
"139956",0,3,0,3,"dummy"
"139960",0,0,0,0,"dummy"
"139961",0,0,0,0,"dummy"
"139962",0,0,0,0,"dummy"
"139963",0,0,0,0,"dummy"
"139964",0,0,0,0,"dummy"
"139965",0,0,0,0,"dummy"
"139967",0,0,3,3,"dummy"
"139969",0,2,1,3,"dummy"
"139970",2,1,1,4,"dummy"
"139971",0,1,0,1,"dummy"
"139972",7,2,1,10,"dummy"
"139977",0,0,2,2,"dummy"
"139978",0,7,0,7,"dummy"
"139979",7,0,0,7,"dummy"
"139980",0,0,1,1,"dummy"
"139986",0,2,0,2,"dummy"
"139988",0,2,0,2,"dummy"
"139992",1,0,0,1,"dummy"
"139995",1,1,0,2,"dummy"
"139998",0,0,1,1,"dummy"
"139999",0,1,1,2,"dummy"
"140000",0,0,1,1,"dummy"
"140001",0,0,1,1,"dummy"
"140002",0,1,0,1,"dummy"
"140003",0,0,0,0,"dummy"
"140004",0,0,0,0,"dummy"
"140005",0,1,2,3,"dummy"
"140006",0,7,0,7,"dummy"
"140008",1,2,0,3,"dummy"
"140010",0,0,0,0,"dummy"
"140012",1,0,0,1,"dummy"
"140013",0,0,1,1,"dummy"
"140016",1,1,0,2,"dummy"
"140017",0,5,0,5,"dummy"
"140018",0,5,3,8,"dummy"
"140019",10,0,0,10,"dummy"
"140020",0,7,0,7,"dummy"
"140021",0,4,0,4,"dummy"
"140022",0,2,1,3,"dummy"
"140023",0,5,0,5,"dummy"
"140024",4,4,1,9,"dummy"
"140025",0,2,1,3,"dummy"
"140026",3,25,0,28,"dummy"
"140027",3,4,0,7,"dummy"
"140028",0,0,1,1,"dummy"
"140029",0,2,0,2,"dummy"
"140030",0,1,1,2,"dummy"
"140031",0,1,0,1,"dummy"
"140032",0,2,0,2,"dummy"
"140033",0,6,0,6,"dummy"
"140034",3,0,0,3,"dummy"
"140035",7,3,0,10,"dummy"
"140036",3,0,0,3,"dummy"
"140037",0,1,0,1,"dummy"
"140038",4,0,1,5,"dummy"
"140039",0,2,0,2,"dummy"
"140042",0,2,0,2,"dummy"
"140044",0,2,0,2,"dummy"
"140046",2,0,3,5,"dummy"
"140047",1,0,0,1,"dummy"
"140048",0,1,0,1,"dummy"
"140049",0,1,1,2,"dummy"
"140051",0,4,0,4,"dummy"
"140052",0,0,0,0,"dummy"
"140055",1,4,0,5,"dummy"
"140056",46,62,9,117,"dummy"
"140057",6,14,5,25,"dummy"
"140058",0,6,0,6,"dummy"
"140059",6,0,0,6,"dummy"
"140060",0,8,0,8,"dummy"
"140061",22,22,2,46,"dummy"
"140062",22,25,0,47,"dummy"
"140063",0,1,0,1,"dummy"
"140064",0,3,0,3,"dummy"
"140065",0,0,0,0,"dummy"
"140066",0,0,1,1,"dummy"
"140067",10,0,1,11,"dummy"
"140069",0,3,0,3,"dummy"
"140070",0,0,1,1,"dummy"
"140071",0,2,0,2,"dummy"
"140072",0,1,1,2,"dummy"
"140075",0,1,0,1,"dummy"
"140076",13,25,1,39,"dummy"
"140079",0,0,0,0,"dummy"
"140087",1,0,2,3,"dummy"
"140088",0,0,0,0,"dummy"
"140091",0,12,0,12,"dummy"
"140092",12,1,0,13,"dummy"
"140094",3,8,0,11,"dummy"
"140095",2,3,3,8,"dummy"
"140097",2,7,1,10,"dummy"
"140098",0,0,3,3,"dummy"
"140100",2,0,1,3,"dummy"
"140103",2,1,1,4,"dummy"
"140104",0,2,0,2,"dummy"
"140105",7,0,1,8,"dummy"
"140106",0,0,1,1,"dummy"
"140107",0,0,1,1,"dummy"
"140111",0,3,0,3,"dummy"
"140112",0,0,0,0,"dummy"
"140114",0,0,1,1,"dummy"
"140119",0,0,1,1,"dummy"
"140121",0,0,0,0,"dummy"
"140122",3,5,0,8,"dummy"
"140123",5,6,1,12,"dummy"
"140124",0,1,0,1,"dummy"
"140125",0,0,1,1,"dummy"
"140126",5,36,9,50,"dummy"
"140127",47,3,3,53,"dummy"
"140128",0,3,0,3,"dummy"
"140134",0,2,0,2,"dummy"
"140135",2,7,1,10,"dummy"
"140136",0,4,0,4,"dummy"
"140137",0,2,0,2,"dummy"
"140138",1,2,0,3,"dummy"
"140139",1,3,0,4,"dummy"
"140142",0,0,2,2,"dummy"
"140143",0,9,0,9,"dummy"
"140167",2,0,0,2,"dummy"
"140237",0,0,0,0,"dummy"
"140238",0,0,0,0,"dummy"
"140246",0,4,0,4,"dummy"
"140247",0,1,0,1,"dummy"
"140248",0,1,0,1,"dummy"
"140249",0,1,0,1,"dummy"
"140250",1,0,0,1,"dummy"
"140251",1,0,0,1,"dummy"
"140308",4,12,0,16,"dummy"
"140325",5,0,4,9,"dummy"
"140328",0,1,0,1,"dummy"
"140329",4,2,1,7,"dummy"
"140337",2,0,0,2,"dummy"
"140338",1,0,0,1,"dummy"
"140339",4,5,2,11,"dummy"
"140366",1,1,0,2,"dummy"
"140367",3,0,0,3,"dummy"
"140400",0,3,0,3,"dummy"
"140401",0,2,0,2,"dummy"
"140402",2,1,0,3,"dummy"
"140409",0,0,2,2,"dummy"
"140410",10,7,2,19,"dummy"
"140411",0,0,3,3,"dummy"
"140412",13,5,4,22,"dummy"
"140413",0,0,2,2,"dummy"
"140414",0,0,2,2,"dummy"
"140415",0,1,0,1,"dummy"
"140416",1,0,0,1,"dummy"
"140417",0,0,1,1,"dummy"
"140418",9,6,3,18,"dummy"
"140419",0,2,0,2,"dummy"
"140420",0,0,0,0,"dummy"
"140421",0,0,0,0,"dummy"
"140422",0,6,1,7,"dummy"
"140423",1,2,1,4,"dummy"
"140424",0,0,1,1,"dummy"
"140425",0,0,1,1,"dummy"
"140442",0,5,0,5,"dummy"
"140443",0,2,0,2,"dummy"
"140444",3,2,0,5,"dummy"
"140445",2,2,0,4,"dummy"
"140446",0,0,2,2,"dummy"
"140447",0,0,0,0,"dummy"
"140452",5,3,1,9,"dummy"
"140455",0,0,1,1,"dummy"
"140456",0,0,2,2,"dummy"
"140145",22,17,4,43,"dummy"
"140146",2,0,0,2,"dummy"
"140147",0,6,0,6,"dummy"
"140148",0,2,0,2,"dummy"
"140149",1,5,0,6,"dummy"
"140150",3,2,0,5,"dummy"
"140151",0,2,0,2,"dummy"
"140152",6,15,2,23,"dummy"
"140153",0,0,0,0,"dummy"
"140156",1,3,0,4,"dummy"
"140157",0,0,1,1,"dummy"
"140158",2,0,5,7,"dummy"
"140159",0,0,1,1,"dummy"
"140160",0,2,1,3,"dummy"
"140161",0,2,0,2,"dummy"
"140162",1,2,0,3,"dummy"
"140163",0,1,0,1,"dummy"
"140164",2,0,0,2,"dummy"
"140165",0,1,0,1,"dummy"
"140169",0,3,0,3,"dummy"
"140170",0,1,0,1,"dummy"
"140171",0,0,1,1,"dummy"
"140172",0,2,0,2,"dummy"
"140173",1,0,0,1,"dummy"
"140174",0,0,0,0,"dummy"
"140175",0,1,0,1,"dummy"
"140176",0,0,2,2,"dummy"
"140177",2,1,0,3,"dummy"
"140178",1,0,0,1,"dummy"
"140179",0,0,1,1,"dummy"
"140180",0,0,2,2,"dummy"
"140181",0,3,0,3,"dummy"
"140182",0,0,1,1,"dummy"
"140183",0,0,1,1,"dummy"
"140233",0,0,3,3,"dummy"
"140234",5,17,1,23,"dummy"
"140235",1,0,2,3,"dummy"
"140240",1,1,0,2,"dummy"
"140241",1,1,0,2,"dummy"
"140242",2,2,0,4,"dummy"
"140243",0,1,0,1,"dummy"
"140244",0,5,0,5,"dummy"
"140253",0,9,0,9,"dummy"
"140254",3,2,0,5,"dummy"
"140255",0,1,0,1,"dummy"
"140256",0,1,0,1,"dummy"
"140257",31,35,1,67,"dummy"
"140258",21,18,2,41,"dummy"
"140259",0,1,0,1,"dummy"
"140260",0,1,1,2,"dummy"
"140261",0,0,1,1,"dummy"
"140262",0,1,0,1,"dummy"
"140263",4,2,2,8,"dummy"
"140264",1,4,1,6,"dummy"
"140265",6,1,0,7,"dummy"
"140266",0,1,0,1,"dummy"
"140267",0,0,1,1,"dummy"
"140268",0,0,0,0,"dummy"
"140269",1,4,3,8,"dummy"
"140270",0,2,1,3,"dummy"
"140271",0,2,0,2,"dummy"
"140272",6,16,0,22,"dummy"
"140273",2,10,1,13,"dummy"
"140274",10,0,0,10,"dummy"
"140275",1,0,0,1,"dummy"
"140276",0,2,1,3,"dummy"
"140277",1,0,0,1,"dummy"
"140278",2,0,0,2,"dummy"
"140279",0,3,0,3,"dummy"
"140280",0,3,0,3,"dummy"
"140281",0,1,0,1,"dummy"
"140282",0,1,0,1,"dummy"
"140283",0,8,0,8,"dummy"
"140284",11,5,1,17,"dummy"
"140285",0,2,3,5,"dummy"
"140286",0,2,0,2,"dummy"
"140287",0,1,0,1,"dummy"
"140288",0,2,0,2,"dummy"
"140289",1,0,0,1,"dummy"
"140290",0,0,0,0,"dummy"
"140291",0,0,1,1,"dummy"
"140292",1,1,0,2,"dummy"
"140293",0,1,1,2,"dummy"
"140294",0,1,0,1,"dummy"
"140295",0,2,0,2,"dummy"
"140296",0,2,0,2,"dummy"
"140297",1,1,0,2,"dummy"
"140298",0,1,0,1,"dummy"
"140299",0,3,0,3,"dummy"
"140300",0,2,0,2,"dummy"
"140301",0,1,0,1,"dummy"
"140302",0,4,0,4,"dummy"
"140303",0,1,0,1,"dummy"
"140306",0,1,0,1,"dummy"
"140333",2,6,1,9,"dummy"
"140334",0,0,1,1,"dummy"
"140335",0,1,0,1,"dummy"
"140341",0,1,0,1,"dummy"
"140342",0,0,1,1,"dummy"
"140343",3,1,0,4,"dummy"
"140344",4,2,0,6,"dummy"
"140347",0,3,0,3,"dummy"
"140350",3,0,1,4,"dummy"
"140357",0,0,0,0,"dummy"
"140358",0,0,1,1,"dummy"
"140359",0,0,0,0,"dummy"
"140360",0,0,1,1,"dummy"
"140361",0,0,0,0,"dummy"
"140362",0,0,0,0,"dummy"
"140369",1,0,1,2,"dummy"
"140370",0,1,0,1,"dummy"
"140371",2,0,2,4,"dummy"
"140380",0,0,1,1,"dummy"
"140381",1,2,0,3,"dummy"
"140382",0,0,1,1,"dummy"
"140385",2,8,2,12,"dummy"
"140386",2,2,1,5,"dummy"
"140387",0,0,1,1,"dummy"
"140394",14,18,1,33,"dummy"
"140395",0,0,1,1,"dummy"
"140396",6,0,1,7,"dummy"
"140397",1,1,0,2,"dummy"
"140398",0,4,3,7,"dummy"
"140404",1,1,0,2,"dummy"
"140405",3,8,1,12,"dummy"
"140406",0,1,0,1,"dummy"
"140449",0,0,5,5,"dummy"
"140450",0,0,1,1,"dummy"
"140458",0,0,5,5,"dummy"
"140459",0,0,1,1,"dummy"
"140461",0,1,1,2,"dummy"
"140462",1,5,1,7,"dummy"
"140463",1,0,1,2,"dummy"
"140466",0,0,3,3,"dummy"
"140467",2,11,1,14,"dummy"
"140468",2,1,0,3,"dummy"
"140469",0,7,1,8,"dummy"
"140470",4,0,0,4,"dummy"
"140471",0,13,4,17,"dummy"
"140474",0,2,0,2,"dummy"
"140475",5,5,0,10,"dummy"
"140476",4,1,0,5,"dummy"
"140477",1,1,2,4,"dummy"
"140479",0,3,0,3,"dummy"
"140481",0,0,0,0,"dummy"
"140484",0,0,1,1,"dummy"
"140493",2,0,3,5,"dummy"
"140494",1,0,0,1,"dummy"
"140495",0,1,0,1,"dummy"
"140496",0,1,1,2,"dummy"
"140498",0,5,1,6,"dummy"
"140503",4,0,0,4,"dummy"
"140504",0,1,0,1,"dummy"
"140505",0,1,0,1,"dummy"
"140506",1,1,0,2,"dummy"
"140507",2,4,3,9,"dummy"
"140508",0,0,1,1,"dummy"
"140509",0,0,0,0,"dummy"
"140510",0,3,0,3,"dummy"
"140534",0,10,0,10,"dummy"
"140535",11,10,2,23,"dummy"
"140536",0,0,2,2,"dummy"
"140541",7,9,1,17,"dummy"
"140542",0,0,4,4,"dummy"
"140543",0,2,0,2,"dummy"
"140544",0,1,1,2,"dummy"
"140545",2,0,2,4,"dummy"
"140547",5,6,0,11,"dummy"
"140550",0,6,0,6,"dummy"
"140551",5,0,0,5,"dummy"
"140552",3,4,0,7,"dummy"
"140553",3,4,0,7,"dummy"
"140585",1,1,1,3,"dummy"
"140586",2,0,0,2,"dummy"
"140587",0,7,1,8,"dummy"
"140588",1,1,3,5,"dummy"
"140589",0,0,2,2,"dummy"
"140590",0,0,2,2,"dummy"
"140591",9,2,7,18,"dummy"
"140592",0,0,1,1,"dummy"
"140593",6,9,1,16,"dummy"
"140594",5,4,3,12,"dummy"
"140595",0,5,0,5,"dummy"
"140596",1,5,0,6,"dummy"
"140597",0,1,2,3,"dummy"
"140598",0,2,0,2,"dummy"
"140601",0,1,1,2,"dummy"
"140603",0,1,0,1,"dummy"
"140604",0,0,2,2,"dummy"
"140605",0,1,7,8,"dummy"
"140608",0,1,0,1,"dummy"
"140609",0,0,1,1,"dummy"
"140610",0,0,1,1,"dummy"
"140611",0,0,1,1,"dummy"
"140612",0,0,0,0,"dummy"
"140613",0,0,1,1,"dummy"
"140616",0,0,0,0,"dummy"
"140617",5,0,2,7,"dummy"
"140618",0,0,0,0,"dummy"
"140621",0,2,1,3,"dummy"
"140624",0,1,0,1,"dummy"
"140625",0,2,0,2,"dummy"
"140626",1,4,0,5,"dummy"
"140627",0,2,0,2,"dummy"
"140628",0,1,0,1,"dummy"
"140629",0,1,0,1,"dummy"
"140630",0,1,0,1,"dummy"
"140631",0,1,0,1,"dummy"
"140632",0,3,0,3,"dummy"
"140633",1,0,0,1,"dummy"
"140634",0,3,0,3,"dummy"
"140635",4,0,0,4,"dummy"
"140636",0,2,0,2,"dummy"
"140637",2,1,0,3,"dummy"
"140638",0,1,0,1,"dummy"
"140639",0,2,0,2,"dummy"
"140640",4,6,0,10,"dummy"
"140641",6,20,0,26,"dummy"
"140643",0,0,1,1,"dummy"
"140644",0,1,0,1,"dummy"
"140645",0,0,1,1,"dummy"
"140647",0,2,0,2,"dummy"
"140649",1,1,1,3,"dummy"
"140652",0,1,0,1,"dummy"
"140657",0,0,1,1,"dummy"
"140658",0,1,0,1,"dummy"
"140659",0,0,1,1,"dummy"
"140666",3,2,3,8,"dummy"
"140667",4,2,2,8,"dummy"
"140668",5,1,3,9,"dummy"
"140675",0,3,0,3,"dummy"
"140678",1,0,0,1,"dummy"
"140679",7,3,4,14,"dummy"
"140680",0,9,0,9,"dummy"
"140681",0,2,0,2,"dummy"
"140682",2,1,0,3,"dummy"
"140683",0,0,0,0,"dummy"
"140684",0,0,1,1,"dummy"
"140690",0,0,0,0,"dummy"
"140691",0,0,0,0,"dummy"
"140693",0,0,0,0,"dummy"
"140694",0,0,1,1,"dummy"
"140701",0,2,0,2,"dummy"
"140702",1,2,2,5,"dummy"
"140703",0,2,0,2,"dummy"
"140704",0,0,0,0,"dummy"
"140705",1,1,0,2,"dummy"
"140709",0,0,0,0,"dummy"
"140720",0,2,0,2,"dummy"
"140721",0,2,0,2,"dummy"
"140722",7,0,2,9,"dummy"
"140726",1,2,2,5,"dummy"
"140727",0,0,1,1,"dummy"
"140728",1,3,1,5,"dummy"
"140729",0,0,1,1,"dummy"
"140730",10,4,2,16,"dummy"
"140731",0,0,1,1,"dummy"
"140732",0,0,1,1,"dummy"
"140733",0,2,0,2,"dummy"
"140734",0,0,1,1,"dummy"
"140735",0,0,1,1,"dummy"
"140736",0,0,1,1,"dummy"
"140737",0,0,1,1,"dummy"
"140738",0,0,1,1,"dummy"
"140739",0,0,1,1,"dummy"
"140740",0,1,0,1,"dummy"
"140741",0,0,1,1,"dummy"
"140742",0,0,1,1,"dummy"
"140743",0,1,2,3,"dummy"
"140744",0,0,1,1,"dummy"
"140745",0,0,1,1,"dummy"
"140746",0,0,1,1,"dummy"
"140747",0,0,1,1,"dummy"
"140748",0,0,1,1,"dummy"
"140749",0,0,1,1,"dummy"
"140750",0,0,1,1,"dummy"
"140751",0,0,1,1,"dummy"
"140752",0,0,1,1,"dummy"
"140753",0,0,1,1,"dummy"
"140754",0,0,1,1,"dummy"
"140755",0,0,1,1,"dummy"
"140756",0,2,1,3,"dummy"
"140757",2,0,0,2,"dummy"
"140758",0,1,0,1,"dummy"
"140759",0,0,1,1,"dummy"
"140760",0,0,1,1,"dummy"
"140761",0,0,1,1,"dummy"
"140762",0,0,1,1,"dummy"
"140763",0,0,1,1,"dummy"
"140764",0,0,1,1,"dummy"
"140765",0,0,1,1,"dummy"
"140766",0,0,1,1,"dummy"
"140767",0,0,1,1,"dummy"
"140768",0,0,1,1,"dummy"
"140769",0,0,1,1,"dummy"
"140771",0,0,0,0,"dummy"
"140772",0,1,0,1,"dummy"
"140773",1,0,0,1,"dummy"
"140774",0,0,1,1,"dummy"
"140775",0,0,1,1,"dummy"
"140776",7,2,5,14,"dummy"
"140777",0,2,0,2,"dummy"
"140779",0,0,1,1,"dummy"
"140784",0,3,0,3,"dummy"
"140788",0,1,0,1,"dummy"
"140789",0,5,1,6,"dummy"
"140790",0,4,0,4,"dummy"
"140791",0,3,0,3,"dummy"
"140793",1,1,0,2,"dummy"
"140795",0,0,1,1,"dummy"
"140796",0,0,1,1,"dummy"
"140798",0,0,5,5,"dummy"
"140799",0,2,0,2,"dummy"
"140800",4,3,3,10,"dummy"
"140801",1,0,1,2,"dummy"
"140802",0,0,1,1,"dummy"
"140803",0,1,0,1,"dummy"
"140804",0,1,0,1,"dummy"
"140808",0,4,0,4,"dummy"
"140809",8,18,5,31,"dummy"
"140810",0,1,0,1,"dummy"
"140812",8,8,1,17,"dummy"
"140816",0,0,1,1,"dummy"
"140817",3,0,1,4,"dummy"
"140818",0,0,1,1,"dummy"
"140820",0,0,3,3,"dummy"
"140821",0,1,0,1,"dummy"
"140822",0,0,1,1,"dummy"
"140823",0,0,1,1,"dummy"
"140836",0,2,0,2,"dummy"
"140839",0,7,0,7,"dummy"
"140842",0,0,1,1,"dummy"
"140843",1,0,0,1,"dummy"
"140845",0,2,1,3,"dummy"
"140875",0,1,0,1,"dummy"
"140876",0,1,0,1,"dummy"
"140877",2,0,2,4,"dummy"
"140878",0,1,0,1,"dummy"
"140879",2,1,0,3,"dummy"
"140880",0,1,0,1,"dummy"
"140881",2,0,2,4,"dummy"
"140882",0,0,1,1,"dummy"
"140883",1,0,1,2,"dummy"
"140884",0,0,1,1,"dummy"
"140885",0,0,1,1,"dummy"
"140888",0,0,0,0,"dummy"
"140889",0,1,0,1,"dummy"
"140890",2,10,2,14,"dummy"
"140891",0,0,2,2,"dummy"
"140898",0,0,0,0,"dummy"
"140899",2,0,1,3,"dummy"
"140910",0,0,1,1,"dummy"
"140911",0,1,0,1,"dummy"
"140915",0,0,3,3,"dummy"
"140917",0,1,0,1,"dummy"
"140918",9,2,1,12,"dummy"
"140921",0,2,0,2,"dummy"
"140922",0,2,0,2,"dummy"
"140923",1,4,0,5,"dummy"
"140924",0,0,1,1,"dummy"
"140935",3,2,2,7,"dummy"
"140936",0,1,3,4,"dummy"
"140937",0,0,4,4,"dummy"
"140990",0,0,0,0,"dummy"
"140991",0,0,0,0,"dummy"
"140994",0,0,1,1,"dummy"
"141000",0,2,0,2,"dummy"
"141001",1,0,0,1,"dummy"
"141002",0,1,0,1,"dummy"
"141003",0,1,0,1,"dummy"
"141004",0,1,0,1,"dummy"
"141005",3,0,0,3,"dummy"
"141006",0,0,0,0,"dummy"
"141007",1,0,0,1,"dummy"
"141011",0,1,1,2,"dummy"
"141012",2,2,0,4,"dummy"
"141013",0,1,0,1,"dummy"
"141014",8,0,0,8,"dummy"
"141015",0,10,0,10,"dummy"
"141016",0,1,0,1,"dummy"
"141017",6,0,0,6,"dummy"
"141018",0,3,1,4,"dummy"
"141019",1,2,0,3,"dummy"
"141020",2,1,0,3,"dummy"
"141021",5,1,0,6,"dummy"
"141026",0,2,0,2,"dummy"
"141027",0,0,1,1,"dummy"
"141028",0,0,1,1,"dummy"
"141029",0,0,1,1,"dummy"
"141033",5,7,0,12,"dummy"
"141034",0,0,1,1,"dummy"
"141039",0,0,1,1,"dummy"
"141044",1,1,0,2,"dummy"
"141053",0,3,1,4,"dummy"
"141054",12,10,3,25,"dummy"
"141055",9,0,0,9,"dummy"
"141056",0,1,0,1,"dummy"
"141057",0,8,0,8,"dummy"
"141058",3,3,1,7,"dummy"
"141059",0,1,1,2,"dummy"
"141060",1,0,1,2,"dummy"
"141061",0,1,0,1,"dummy"
"141062",0,0,0,0,"dummy"
"141063",1,0,0,1,"dummy"
"141071",3,0,0,3,"dummy"
"141072",0,1,1,2,"dummy"
"141073",0,2,0,2,"dummy"
"141074",7,3,2,12,"dummy"
"141077",0,0,3,3,"dummy"
"141078",0,0,1,1,"dummy"
"141079",0,2,0,2,"dummy"
"141080",4,4,2,10,"dummy"
"141081",6,0,0,6,"dummy"
"141082",0,0,3,3,"dummy"
"141083",1,1,0,2,"dummy"
"141086",3,0,0,3,"dummy"
"141087",0,0,3,3,"dummy"
"141104",1,1,1,3,"dummy"
"141118",0,2,0,2,"dummy"
"141119",6,0,2,8,"dummy"
"141120",0,0,1,1,"dummy"
"141138",1,6,1,8,"dummy"
"141139",0,1,1,2,"dummy"
"141140",0,0,0,0,"dummy"
"141152",2,4,2,8,"dummy"
"141153",0,0,1,1,"dummy"
"141173",4,0,0,4,"dummy"
"141174",1,0,3,4,"dummy"
"141177",0,1,0,1,"dummy"
"141178",0,5,4,9,"dummy"
"141179",0,1,1,2,"dummy"
"141180",5,3,2,10,"dummy"
"141181",2,0,1,3,"dummy"
"141182",0,0,0,0,"dummy"
"140933",1,0,0,1,"dummy"
"140939",2,2,3,7,"dummy"
"140996",1,0,0,1,"dummy"
"140997",0,0,1,1,"dummy"
"140998",0,0,1,1,"dummy"
"141009",0,0,2,2,"dummy"
"141023",0,1,0,1,"dummy"
"141024",2,0,2,4,"dummy"
"141031",0,0,0,0,"dummy"
"141067",1,0,0,1,"dummy"
"141091",2,1,4,7,"dummy"
"141124",0,2,0,2,"dummy"
"141125",2,0,0,2,"dummy"
"141126",0,2,0,2,"dummy"
"141127",2,0,0,2,"dummy"
"141128",7,5,0,12,"dummy"
"141131",0,0,0,0,"dummy"
"141132",0,0,0,0,"dummy"
"141133",0,0,0,0,"dummy"
"141134",0,0,1,1,"dummy"
"141135",0,0,0,0,"dummy"
"141136",0,0,1,1,"dummy"
"141168",0,3,0,3,"dummy"
"141171",2,2,0,4,"dummy"
"141201",6,0,0,6,"dummy"
"141204",1,2,0,3,"dummy"
"141205",0,4,0,4,"dummy"
"141206",0,3,0,3,"dummy"
"141207",0,0,1,1,"dummy"
"141208",0,0,0,0,"dummy"
"141209",0,3,0,3,"dummy"
"141214",0,3,0,3,"dummy"
"141217",3,0,0,3,"dummy"
"141218",0,1,0,1,"dummy"
"141231",1,2,0,3,"dummy"
"141232",1,1,0,2,"dummy"
"141233",11,14,1,26,"dummy"
"141234",1,1,0,2,"dummy"
"141235",0,0,2,2,"dummy"
"141250",0,0,1,1,"dummy"
"141251",0,0,1,1,"dummy"
"141252",19,2,2,23,"dummy"
"141253",0,0,0,0,"dummy"
"141260",0,1,0,1,"dummy"
"141261",0,2,1,3,"dummy"
"141262",0,5,0,5,"dummy"
"141263",0,1,0,1,"dummy"
"141264",8,7,5,20,"dummy"
"141265",0,0,1,1,"dummy"
"141266",8,7,5,20,"dummy"
"141267",18,0,0,18,"dummy"
"141268",0,0,0,0,"dummy"
"141183",1,0,0,1,"dummy"
"141198",2,0,0,2,"dummy"
"141199",0,0,0,0,"dummy"
"141211",0,0,1,1,"dummy"
"141212",2,2,0,4,"dummy"
"141220",0,1,0,1,"dummy"
"141221",2,1,0,3,"dummy"
"141222",4,7,3,14,"dummy"
"141223",0,0,1,1,"dummy"
"141224",0,3,0,3,"dummy"
"141225",0,0,1,1,"dummy"
"141226",0,2,0,2,"dummy"
"141227",1,1,1,3,"dummy"
"141228",0,3,0,3,"dummy"
"141229",0,1,0,1,"dummy"
"141237",0,2,1,3,"dummy"
"141240",0,2,0,2,"dummy"
"141241",0,3,2,5,"dummy"
"141242",0,1,0,1,"dummy"
"141243",9,12,3,24,"dummy"
"141244",0,1,0,1,"dummy"
"141245",0,7,0,7,"dummy"
"141248",0,4,2,6,"dummy"
"141255",5,3,1,9,"dummy"
"141256",10,3,1,14,"dummy"
"141257",0,0,1,1,"dummy"
"141258",0,0,1,1,"dummy"
"141270",0,0,4,4,"dummy"
"141278",0,0,0,0,"dummy"
"141281",1,4,1,6,"dummy"
"141282",0,3,0,3,"dummy"
"141283",0,0,1,1,"dummy"
"141284",0,0,1,1,"dummy"
"141285",0,0,1,1,"dummy"
"141286",0,1,2,3,"dummy"
"141287",4,1,3,8,"dummy"
"141293",0,0,3,3,"dummy"
"141294",0,0,2,2,"dummy"
"141295",2,3,1,6,"dummy"
"141296",2,1,0,3,"dummy"
"141297",3,2,0,5,"dummy"
"141298",0,3,0,3,"dummy"
"141299",2,2,1,5,"dummy"
"141300",6,7,1,14,"dummy"
"141301",1,0,0,1,"dummy"
"141306",19,1,1,21,"dummy"
"141307",1,0,1,2,"dummy"
"141350",0,0,1,1,"dummy"
"141364",5,1,3,9,"dummy"
"141365",1,3,2,6,"dummy"
"141372",1,0,1,2,"dummy"
"141373",0,2,1,3,"dummy"
"141380",1,4,0,5,"dummy"
"141381",2,3,0,5,"dummy"
"141382",3,0,0,3,"dummy"
"141387",0,1,0,1,"dummy"
"141428",0,2,0,2,"dummy"
"141429",5,10,0,15,"dummy"
"141430",0,0,1,1,"dummy"
"141431",1,1,0,2,"dummy"
"141432",0,3,0,3,"dummy"
"141433",21,15,4,40,"dummy"
"141434",0,0,2,2,"dummy"
"141435",1,1,0,2,"dummy"
"141436",0,1,1,2,"dummy"
"141437",0,3,1,4,"dummy"
"141438",0,6,0,6,"dummy"
"141439",0,0,1,1,"dummy"
"141440",10,10,0,20,"dummy"
"141441",7,12,11,30,"dummy"
"141443",0,0,1,1,"dummy"
"141444",0,0,0,0,"dummy"
"141447",0,3,0,3,"dummy"
"141448",0,4,0,4,"dummy"
"141289",0,0,0,0,"dummy"
"141290",1,0,0,1,"dummy"
"141291",0,0,1,1,"dummy"
"141303",0,7,2,9,"dummy"
"141304",0,1,0,1,"dummy"
"141330",4,3,3,10,"dummy"
"141331",0,2,0,2,"dummy"
"141332",14,0,2,16,"dummy"
"141333",3,4,0,7,"dummy"
"141334",0,2,0,2,"dummy"
"141335",0,1,2,3,"dummy"
"141338",0,0,1,1,"dummy"
"141339",0,0,0,0,"dummy"
"141345",0,0,1,1,"dummy"
"141346",0,2,0,2,"dummy"
"141347",0,0,1,1,"dummy"
"141348",1,0,1,2,"dummy"
"141367",0,13,0,13,"dummy"
"141368",0,0,0,0,"dummy"
"141369",0,1,0,1,"dummy"
"141370",0,2,0,2,"dummy"
"141375",0,0,0,0,"dummy"
"141376",0,0,0,0,"dummy"
"141472",0,0,3,3,"dummy"
"141473",2,2,0,4,"dummy"
"141480",0,0,0,0,"dummy"
"141502",0,0,1,1,"dummy"
"141516",0,14,0,14,"dummy"
"141517",0,1,0,1,"dummy"
"141518",0,0,0,0,"dummy"
"141519",0,0,1,1,"dummy"
"141520",0,1,0,1,"dummy"
"141528",5,13,1,19,"dummy"
"141529",0,2,0,2,"dummy"
"141533",1,2,0,3,"dummy"
"141534",0,1,0,1,"dummy"
"141537",0,5,0,5,"dummy"
"141538",5,9,0,14,"dummy"
"141539",0,4,1,5,"dummy"
"141540",5,5,0,10,"dummy"
"141541",2,0,0,2,"dummy"
"141542",0,0,1,1,"dummy"
"141563",0,0,0,0,"dummy"
"141564",0,0,1,1,"dummy"
"141576",2,1,0,3,"dummy"
"141579",1,1,0,2,"dummy"
"141580",0,0,1,1,"dummy"
"141648",2,4,0,6,"dummy"
"141649",0,2,0,2,"dummy"
"141650",0,2,0,2,"dummy"
"141651",10,2,0,12,"dummy"
"141652",0,2,0,2,"dummy"
"141653",0,0,0,0,"dummy"
"141654",0,0,3,3,"dummy"
"141655",0,5,0,5,"dummy"
"141656",1,0,1,2,"dummy"
"141666",0,3,0,3,"dummy"
"141671",0,0,1,1,"dummy"
"141678",0,0,2,2,"dummy"
"141687",2,13,2,17,"dummy"
"141688",0,0,2,2,"dummy"
"141451",0,0,1,1,"dummy"
"141452",0,0,1,1,"dummy"
"141453",0,0,1,1,"dummy"
"141454",0,0,1,1,"dummy"
"141455",0,0,1,1,"dummy"
"141456",0,0,1,1,"dummy"
"141457",0,0,1,1,"dummy"
"141458",0,0,1,1,"dummy"
"141459",0,0,1,1,"dummy"
"141460",0,0,1,1,"dummy"
"141461",0,0,1,1,"dummy"
"141462",0,0,1,1,"dummy"
"141463",0,0,1,1,"dummy"
"141464",0,0,1,1,"dummy"
"141465",0,0,1,1,"dummy"
"141466",0,0,1,1,"dummy"
"141467",0,0,1,1,"dummy"
"141468",0,0,1,1,"dummy"
"141469",0,0,1,1,"dummy"
"141470",0,0,1,1,"dummy"
"141475",40,13,3,56,"dummy"
"141476",0,1,0,1,"dummy"
"141477",0,2,0,2,"dummy"
"141478",0,1,0,1,"dummy"
"141482",0,0,2,2,"dummy"
"141483",0,1,0,1,"dummy"
"141484",3,3,0,6,"dummy"
"141485",1,1,0,2,"dummy"
"141486",2,1,0,3,"dummy"
"141487",0,0,4,4,"dummy"
"141488",0,0,3,3,"dummy"
"141504",0,1,0,1,"dummy"
"141505",0,4,0,4,"dummy"
"141508",1,0,3,4,"dummy"
"141509",0,0,2,2,"dummy"
"141510",0,0,3,3,"dummy"
"141522",0,0,2,2,"dummy"
"141523",1,0,1,2,"dummy"
"141524",0,0,1,1,"dummy"
"141531",19,6,7,32,"dummy"
"141544",0,1,0,1,"dummy"
"141545",1,0,0,1,"dummy"
"141546",0,0,1,1,"dummy"
"141547",1,1,0,2,"dummy"
"141548",0,0,1,1,"dummy"
"141549",0,0,0,0,"dummy"
"141550",0,0,0,0,"dummy"
"141551",0,0,0,0,"dummy"
"141559",1,0,0,1,"dummy"
"141560",0,4,0,4,"dummy"
"141561",0,1,3,4,"dummy"
"141566",0,0,2,2,"dummy"
"141569",0,0,0,0,"dummy"
"141570",0,0,0,0,"dummy"
"141573",2,2,4,8,"dummy"
"141574",9,5,5,19,"dummy"
"141582",0,1,0,1,"dummy"
"141583",1,2,0,3,"dummy"
"141584",0,0,1,1,"dummy"
"141585",0,0,1,1,"dummy"
"141586",1,0,0,1,"dummy"
"141587",2,0,0,2,"dummy"
"141588",6,3,2,11,"dummy"
"141589",3,0,0,3,"dummy"
"141590",0,9,2,11,"dummy"
"141591",9,0,2,11,"dummy"
"141592",0,0,1,1,"dummy"
"141593",0,4,0,4,"dummy"
"141594",0,1,0,1,"dummy"
"141595",0,0,1,1,"dummy"
"141596",0,3,0,3,"dummy"
"141597",1,1,0,2,"dummy"
"141598",3,4,1,8,"dummy"
"141599",0,1,0,1,"dummy"
"141600",0,0,1,1,"dummy"
"141601",4,10,6,20,"dummy"
"141602",0,0,1,1,"dummy"
"141603",0,0,3,3,"dummy"
"141604",0,1,3,4,"dummy"
"141605",0,0,3,3,"dummy"
"141606",0,0,2,2,"dummy"
"141607",0,0,1,1,"dummy"
"141608",0,1,5,6,"dummy"
"141609",0,0,5,5,"dummy"
"141610",20,18,2,40,"dummy"
"141611",0,1,0,1,"dummy"
"141612",24,0,2,26,"dummy"
"141613",0,0,1,1,"dummy"
"141614",0,0,2,2,"dummy"
"141615",0,0,1,1,"dummy"
"141618",2,5,1,8,"dummy"
"141619",0,0,1,1,"dummy"
"141620",0,0,1,1,"dummy"
"141621",1,0,1,2,"dummy"
"141622",2,2,0,4,"dummy"
"141623",0,0,2,2,"dummy"
"141624",0,0,1,1,"dummy"
"141625",0,0,1,1,"dummy"
"141626",6,6,1,13,"dummy"
"141640",0,0,1,1,"dummy"
"141641",0,0,0,0,"dummy"
"141658",0,1,0,1,"dummy"
"141659",0,0,1,1,"dummy"
"141660",0,2,2,4,"dummy"
"141661",0,0,1,1,"dummy"
"141662",3,3,1,7,"dummy"
"141663",3,0,1,4,"dummy"
"141664",0,1,0,1,"dummy"
"141668",0,16,0,16,"dummy"
"141669",3,3,0,6,"dummy"
"141673",1,0,0,1,"dummy"
"141674",0,0,1,1,"dummy"
"141680",0,0,1,1,"dummy"
"141681",1,0,0,1,"dummy"
"141690",0,2,0,2,"dummy"
"141695",1,1,0,2,"dummy"
"141706",1,0,0,1,"dummy"
"141709",0,9,0,9,"dummy"
"141697",0,0,0,0,"dummy"
"141700",0,0,0,0,"dummy"
"141701",0,1,0,1,"dummy"
"141702",0,10,0,10,"dummy"
"141703",0,2,0,2,"dummy"
"141704",0,0,0,0,"dummy"
"141711",0,0,0,0,"dummy"
"141733",0,0,0,0,"dummy"
"141734",1,0,0,1,"dummy"
"141743",2,3,0,5,"dummy"
"141744",1,0,0,1,"dummy"
"141754",0,0,2,2,"dummy"
"141755",0,1,0,1,"dummy"
"141756",3,3,1,7,"dummy"
"141757",0,1,0,1,"dummy"
"141758",0,1,0,1,"dummy"
"141759",0,4,1,5,"dummy"
"141760",1,2,1,4,"dummy"
"141761",0,1,0,1,"dummy"
"141762",0,1,0,1,"dummy"
"141763",33,11,5,49,"dummy"
"141765",0,0,0,0,"dummy"
"141766",0,0,0,0,"dummy"
"141767",0,1,0,1,"dummy"
"141768",2,3,1,6,"dummy"
"141769",0,1,0,1,"dummy"
"141770",0,0,0,0,"dummy"
"141772",0,0,1,1,"dummy"
"141773",0,2,0,2,"dummy"
"141776",0,4,0,4,"dummy"
"141777",0,0,1,1,"dummy"
"141785",0,2,0,2,"dummy"
"141788",0,6,0,6,"dummy"
"141789",0,1,0,1,"dummy"
"141790",6,7,0,13,"dummy"
"141791",0,4,0,4,"dummy"
"141792",0,0,1,1,"dummy"
"141793",0,1,0,1,"dummy"
"141795",0,9,1,10,"dummy"
"141797",0,0,1,1,"dummy"
"141800",0,0,0,0,"dummy"
"141801",0,1,0,1,"dummy"
"141834",1,0,0,1,"dummy"
"141836",0,0,0,0,"dummy"
"141838",0,1,0,1,"dummy"
"141839",0,1,0,1,"dummy"
"141840",0,1,0,1,"dummy"
"141841",0,10,1,11,"dummy"
"141842",3,8,0,11,"dummy"
"141843",0,1,0,1,"dummy"
"141845",0,1,0,1,"dummy"
"141846",0,0,1,1,"dummy"
"141848",0,1,0,1,"dummy"
"141849",0,3,1,4,"dummy"
"141850",0,0,0,0,"dummy"
"141851",0,2,4,6,"dummy"
"141852",0,0,0,0,"dummy"
"141853",0,2,0,2,"dummy"
"141870",0,3,0,3,"dummy"
"141871",0,2,0,2,"dummy"
"141872",0,10,0,10,"dummy"
"141873",1,1,1,3,"dummy"
"141877",0,0,1,1,"dummy"
"141878",1,0,0,1,"dummy"
"141879",0,0,1,1,"dummy"
"141880",1,4,0,5,"dummy"
"141882",3,2,1,6,"dummy"
"141883",1,0,2,3,"dummy"
"141884",0,0,1,1,"dummy"
"141885",0,0,1,1,"dummy"
"141886",0,0,2,2,"dummy"
"141900",4,12,0,16,"dummy"
"141901",0,4,0,4,"dummy"
"141904",0,1,6,7,"dummy"
"141905",0,0,1,1,"dummy"
"141906",0,0,1,1,"dummy"
"141907",0,0,2,2,"dummy"
"141908",0,0,1,1,"dummy"
"141923",4,2,1,7,"dummy"
"141925",0,0,4,4,"dummy"
"141926",1,0,0,1,"dummy"
"141931",1,3,0,4,"dummy"
"141932",2,0,0,2,"dummy"
"141933",0,1,0,1,"dummy"
"141934",0,1,0,1,"dummy"
"141936",0,1,0,1,"dummy"
"141937",1,3,0,4,"dummy"
"141938",0,2,0,2,"dummy"
"141941",0,1,1,2,"dummy"
"141943",11,1,0,12,"dummy"
"141944",0,2,0,2,"dummy"
"141960",0,2,0,2,"dummy"
"141964",2,3,0,5,"dummy"
"141966",0,3,0,3,"dummy"
"141967",6,0,0,6,"dummy"
"141968",0,2,0,2,"dummy"
"141973",0,5,0,5,"dummy"
"141976",0,1,2,3,"dummy"
"141998",1,0,2,3,"dummy"
"141999",2,1,0,3,"dummy"
"142016",3,2,0,5,"dummy"
"142019",0,0,1,1,"dummy"
"142020",0,0,1,1,"dummy"
"142081",1,2,0,3,"dummy"
"142082",24,22,2,48,"dummy"
"142083",1,0,0,1,"dummy"
"142084",0,0,1,1,"dummy"
"142085",6,13,1,20,"dummy"
"142086",0,2,0,2,"dummy"
"142087",0,0,0,0,"dummy"
"142088",0,1,0,1,"dummy"
"142089",0,0,2,2,"dummy"
"142090",0,0,2,2,"dummy"
"142091",0,0,1,1,"dummy"
"142092",0,0,3,3,"dummy"
"142093",0,2,2,4,"dummy"
"142094",1,0,0,1,"dummy"
"142095",0,0,3,3,"dummy"
"142096",1,1,4,6,"dummy"
"142097",0,0,1,1,"dummy"
"142098",0,0,1,1,"dummy"
"142099",0,0,2,2,"dummy"
"142107",0,1,0,1,"dummy"
"142108",0,0,1,1,"dummy"
"142109",0,0,1,1,"dummy"
"142110",0,1,0,1,"dummy"
"142120",3,1,2,6,"dummy"
"142121",0,1,0,1,"dummy"
"142122",0,0,1,1,"dummy"
"142123",0,4,0,4,"dummy"
"142124",3,3,0,6,"dummy"
"142125",1,0,0,1,"dummy"
"142126",0,1,4,5,"dummy"
"142127",1,0,0,1,"dummy"
"142144",0,2,0,2,"dummy"
"142150",0,0,2,2,"dummy"
"142155",0,2,0,2,"dummy"
"142158",0,0,1,1,"dummy"
"142159",5,6,1,12,"dummy"
"142160",3,1,0,4,"dummy"
"142161",0,8,0,8,"dummy"
"142162",4,0,0,4,"dummy"
"142163",4,0,0,4,"dummy"
"142164",0,0,1,1,"dummy"
"142165",0,1,0,1,"dummy"
"142166",20,30,4,54,"dummy"
"142167",1,0,6,7,"dummy"
"142168",0,0,1,1,"dummy"
"142169",0,1,4,5,"dummy"
"142170",0,2,0,2,"dummy"
"142171",0,0,2,2,"dummy"
"142172",0,0,1,1,"dummy"
"142173",0,0,1,1,"dummy"
"142174",0,0,3,3,"dummy"
"142175",0,0,3,3,"dummy"
"142191",0,0,4,4,"dummy"
"142196",2,0,3,5,"dummy"
"142197",1,0,0,1,"dummy"
"142198",0,1,0,1,"dummy"
"142199",0,1,1,2,"dummy"
"142204",0,0,1,1,"dummy"
"142207",0,1,0,1,"dummy"
"142208",0,1,0,1,"dummy"
"142209",1,3,0,4,"dummy"
"142210",1,4,0,5,"dummy"
"142211",0,5,0,5,"dummy"
"142212",3,11,1,15,"dummy"
"142213",0,0,1,1,"dummy"
"142214",0,0,1,1,"dummy"
"142225",0,0,1,1,"dummy"
"142232",0,0,0,0,"dummy"
"142233",8,0,0,8,"dummy"
"142252",0,0,0,0,"dummy"
"142258",0,0,0,0,"dummy"
"142034",6,7,1,14,"dummy"
"142035",1,2,0,3,"dummy"
"142036",1,0,0,1,"dummy"
"142037",0,1,0,1,"dummy"
"142038",0,2,0,2,"dummy"
"142039",2,2,0,4,"dummy"
"142040",1,1,1,3,"dummy"
"142041",0,0,0,0,"dummy"
"142042",0,1,0,1,"dummy"
"142043",0,0,1,1,"dummy"
"142044",5,0,0,5,"dummy"
"142045",1,0,0,1,"dummy"
"142046",8,2,4,14,"dummy"
"142047",0,1,0,1,"dummy"
"142048",0,0,1,1,"dummy"
"142105",0,0,0,0,"dummy"
"142112",2,7,2,11,"dummy"
"142113",7,1,0,8,"dummy"
"142114",0,1,1,2,"dummy"
"142129",0,1,0,1,"dummy"
"142130",1,0,0,1,"dummy"
"142131",0,0,1,1,"dummy"
"142132",0,2,0,2,"dummy"
"142133",0,1,0,1,"dummy"
"142134",1,1,0,2,"dummy"
"142135",0,0,1,1,"dummy"
"142136",0,0,1,1,"dummy"
"142137",0,0,1,1,"dummy"
"142138",1,2,0,3,"dummy"
"142139",1,1,0,2,"dummy"
"142140",1,1,0,2,"dummy"
"142141",1,1,1,3,"dummy"
"142142",0,0,1,1,"dummy"
"142148",0,0,1,1,"dummy"
"142177",0,5,0,5,"dummy"
"142178",0,3,2,5,"dummy"
"142179",7,2,0,9,"dummy"
"142180",0,0,1,1,"dummy"
"142181",0,1,0,1,"dummy"
"142182",1,2,1,4,"dummy"
"142183",0,0,1,1,"dummy"
"142184",2,12,5,19,"dummy"
"142185",0,0,0,0,"dummy"
"142186",17,5,2,24,"dummy"
"142187",3,7,4,14,"dummy"
"142188",7,5,4,16,"dummy"
"142189",2,0,0,2,"dummy"
"142218",0,0,2,2,"dummy"
"142219",0,1,1,2,"dummy"
"142220",0,0,2,2,"dummy"
"142221",1,3,1,5,"dummy"
"142222",1,5,1,7,"dummy"
"142223",0,1,0,1,"dummy"
"142227",4,0,1,5,"dummy"
"142228",0,0,0,0,"dummy"
"142235",1,0,0,1,"dummy"
"142236",0,0,1,1,"dummy"
"142237",2,0,0,2,"dummy"
"142238",0,0,1,1,"dummy"
"142239",0,1,0,1,"dummy"
"142240",0,2,0,2,"dummy"
"142241",0,0,0,0,"dummy"
"142242",2,1,0,3,"dummy"
"142243",1,0,0,1,"dummy"
"142244",0,0,0,0,"dummy"
"142247",2,0,3,5,"dummy"
"142248",1,0,0,1,"dummy"
"142249",0,1,0,1,"dummy"
"142250",0,1,1,2,"dummy"
"142256",2,2,0,4,"dummy"
"142260",0,1,3,4,"dummy"
"142261",0,3,0,3,"dummy"
"142263",1,0,0,1,"dummy"
"142272",0,0,0,0,"dummy"
"142273",0,0,0,0,"dummy"
"142274",0,0,0,0,"dummy"
"142275",0,0,0,0,"dummy"
"142276",0,0,0,0,"dummy"
"142277",0,0,1,1,"dummy"
"142278",0,0,0,0,"dummy"
"142279",0,0,2,2,"dummy"
"142280",0,0,0,0,"dummy"
"142281",0,0,0,0,"dummy"
"142282",0,0,0,0,"dummy"
"142283",0,0,0,0,"dummy"
"142284",0,0,0,0,"dummy"
"142285",0,0,0,0,"dummy"
"142286",0,0,0,0,"dummy"
"142287",0,0,0,0,"dummy"
"142288",0,0,0,0,"dummy"
"142289",0,0,0,0,"dummy"
"142294",1,7,0,8,"dummy"
"142311",1,3,0,4,"dummy"
"142312",0,0,1,1,"dummy"
"142313",0,1,0,1,"dummy"
"142321",1,0,0,1,"dummy"
"142322",0,2,0,2,"dummy"
"142323",0,0,0,0,"dummy"
"142328",0,0,1,1,"dummy"
"142335",1,3,0,4,"dummy"
"142347",0,0,0,0,"dummy"
"142348",0,0,0,0,"dummy"
"142349",1,1,0,2,"dummy"
"142350",0,1,0,1,"dummy"
"142351",0,1,0,1,"dummy"
"142354",0,0,1,1,"dummy"
"142363",0,0,1,1,"dummy"
"142364",0,1,0,1,"dummy"
"142365",0,0,1,1,"dummy"
"142383",1,5,0,6,"dummy"
"142384",0,11,0,11,"dummy"
"142385",4,1,0,5,"dummy"
"142386",0,5,0,5,"dummy"
"142387",0,3,0,3,"dummy"
"142427",2,5,1,8,"dummy"
"142430",0,0,1,1,"dummy"
"142431",0,0,1,1,"dummy"
"142434",1,0,1,2,"dummy"
"142435",1,10,1,12,"dummy"
"142436",2,0,3,5,"dummy"
"142437",1,0,1,2,"dummy"
"142477",0,1,0,1,"dummy"
"142481",2,4,0,6,"dummy"
"142482",0,2,0,2,"dummy"
"142483",0,2,0,2,"dummy"
"142484",10,2,0,12,"dummy"
"142485",0,2,0,2,"dummy"
"142486",0,0,0,0,"dummy"
"142489",0,2,0,2,"dummy"
"142490",8,2,0,10,"dummy"
"142491",7,2,4,13,"dummy"
"142492",0,0,1,1,"dummy"
"142493",0,2,0,2,"dummy"
"142494",1,3,0,4,"dummy"
"142502",0,8,0,8,"dummy"
"142503",0,3,0,3,"dummy"
"142504",0,1,0,1,"dummy"
"142507",1,1,0,2,"dummy"
"142510",3,2,0,5,"dummy"
"142511",0,1,0,1,"dummy"
"142512",1,0,0,1,"dummy"
"142523",0,1,0,1,"dummy"
"142296",0,0,0,0,"dummy"
"142297",0,0,0,0,"dummy"
"142309",0,3,1,4,"dummy"
"142317",2,3,0,5,"dummy"
"142318",1,2,1,4,"dummy"
"142319",1,1,0,2,"dummy"
"142330",11,20,3,34,"dummy"
"142331",0,0,0,0,"dummy"
"142337",0,1,0,1,"dummy"
"142338",0,3,3,6,"dummy"
"142339",0,1,0,1,"dummy"
"142340",0,1,3,4,"dummy"
"142341",0,3,3,6,"dummy"
"142342",9,4,5,18,"dummy"
"142343",1,2,2,5,"dummy"
"142358",1,0,1,2,"dummy"
"142359",0,3,0,3,"dummy"
"142367",0,17,0,17,"dummy"
"142368",0,1,0,1,"dummy"
"142369",0,1,0,1,"dummy"
"142370",0,0,0,0,"dummy"
"142371",0,1,0,1,"dummy"
"142372",1,0,0,1,"dummy"
"142373",0,0,4,4,"dummy"
"142374",2,0,2,4,"dummy"
"142375",0,1,2,3,"dummy"
"142376",1,2,0,3,"dummy"
"142377",0,0,2,2,"dummy"
"142378",4,1,1,6,"dummy"
"142381",0,1,0,1,"dummy"
"142404",0,1,0,1,"dummy"
"142405",1,0,1,2,"dummy"
"142406",0,0,0,0,"dummy"
"142407",0,0,0,0,"dummy"
"142408",0,0,1,1,"dummy"
"142409",0,1,0,1,"dummy"
"142410",1,2,0,3,"dummy"
"142411",0,1,0,1,"dummy"
"142412",0,1,0,1,"dummy"
"142424",0,0,0,0,"dummy"
"142425",0,1,3,4,"dummy"
"142474",2,0,0,2,"dummy"
"142475",0,0,0,0,"dummy"
"142479",10,6,4,20,"dummy"
"142496",1,3,0,4,"dummy"
"142497",0,1,0,1,"dummy"
"142498",2,5,0,7,"dummy"
"142499",2,3,4,9,"dummy"
"142500",3,2,0,5,"dummy"
"142516",0,0,3,3,"dummy"
"142517",0,4,0,4,"dummy"
"142518",4,1,0,5,"dummy"
"142519",0,8,0,8,"dummy"
"142520",8,0,0,8,"dummy"
"142521",0,16,0,16,"dummy"
"142525",0,0,1,1,"dummy"
"142528",22,1,2,25,"dummy"
"142529",0,1,0,1,"dummy"
"142530",0,0,1,1,"dummy"
"142531",0,0,1,1,"dummy"
"142540",0,9,0,9,"dummy"
"142541",1,0,0,1,"dummy"
"142542",1,1,1,3,"dummy"
"142561",0,0,1,1,"dummy"
"142601",0,1,4,5,"dummy"
"142602",2,0,1,3,"dummy"
"142603",0,0,1,1,"dummy"
"142604",0,0,4,4,"dummy"
"142605",0,0,3,3,"dummy"
"142606",0,1,0,1,"dummy"
"142607",0,0,1,1,"dummy"
"142608",0,0,1,1,"dummy"
"142609",0,3,1,4,"dummy"
"142610",0,2,1,3,"dummy"
"142611",0,0,1,1,"dummy"
"142612",0,0,3,3,"dummy"
"142613",0,0,1,1,"dummy"
"142614",0,0,4,4,"dummy"
"142708",7,1,6,14,"dummy"
"142709",4,7,1,12,"dummy"
"142756",1,0,1,2,"dummy"
"142757",0,0,0,0,"dummy"
"142766",4,6,2,12,"dummy"
"142781",0,9,0,9,"dummy"
"142782",0,1,0,1,"dummy"
"142783",0,2,1,3,"dummy"
"142784",2,1,1,4,"dummy"
"142785",0,1,0,1,"dummy"
"142786",0,1,0,1,"dummy"
"142793",0,7,4,11,"dummy"
"142826",0,0,1,1,"dummy"
"142831",2,2,0,4,"dummy"
"142832",0,4,0,4,"dummy"
"142838",0,0,1,1,"dummy"
"142843",0,21,0,21,"dummy"
"142848",0,1,0,1,"dummy"
"142849",17,11,6,34,"dummy"
"142546",0,1,0,1,"dummy"
"142547",10,23,4,37,"dummy"
"142548",14,19,0,33,"dummy"
"142549",2,1,0,3,"dummy"
"142550",7,1,1,9,"dummy"
"142551",2,2,0,4,"dummy"
"142552",0,4,0,4,"dummy"
"142553",0,3,0,3,"dummy"
"142554",0,4,0,4,"dummy"
"142555",2,0,0,2,"dummy"
"142556",7,0,0,7,"dummy"
"142557",0,1,2,3,"dummy"
"142558",0,3,0,3,"dummy"
"142559",13,6,0,19,"dummy"
"142563",2,2,0,4,"dummy"
"142564",0,0,0,0,"dummy"
"142569",0,1,0,1,"dummy"
"142570",1,0,0,1,"dummy"
"142571",6,10,0,16,"dummy"
"142616",1,9,0,10,"dummy"
"142617",1,2,1,4,"dummy"
"142690",1,0,1,2,"dummy"
"142691",0,1,0,1,"dummy"
"142713",0,1,0,1,"dummy"
"142714",0,9,0,9,"dummy"
"142715",0,4,0,4,"dummy"
"142718",0,1,0,1,"dummy"
"142719",0,0,1,1,"dummy"
"142722",0,0,2,2,"dummy"
"142723",0,7,0,7,"dummy"
"142724",1,14,0,15,"dummy"
"142725",0,1,0,1,"dummy"
"142726",4,0,1,5,"dummy"
"142727",0,0,1,1,"dummy"
"142728",0,2,0,2,"dummy"
"142729",0,0,1,1,"dummy"
"142730",0,1,1,2,"dummy"
"142731",0,0,1,1,"dummy"
"142732",0,0,1,1,"dummy"
"142733",6,9,1,16,"dummy"
"142734",0,0,1,1,"dummy"
"142739",0,20,0,20,"dummy"
"142740",1,3,0,4,"dummy"
"142743",0,0,1,1,"dummy"
"142744",0,0,1,1,"dummy"
"142745",0,0,1,1,"dummy"
"142746",0,0,1,1,"dummy"
"142747",0,0,1,1,"dummy"
"142748",0,0,1,1,"dummy"
"142749",0,0,1,1,"dummy"
"142750",0,0,1,1,"dummy"
"142751",0,0,1,1,"dummy"
"142752",0,1,0,1,"dummy"
"142753",0,0,2,2,"dummy"
"142754",0,13,0,13,"dummy"
"142759",8,1,5,14,"dummy"
"142760",0,2,2,4,"dummy"
"142761",0,1,1,2,"dummy"
"142764",0,1,1,2,"dummy"
"142772",8,1,2,11,"dummy"
"142773",0,3,1,4,"dummy"
"142817",0,0,0,0,"dummy"
"142818",0,0,0,0,"dummy"
"142819",0,0,0,0,"dummy"
"142820",0,0,0,0,"dummy"
"142821",0,0,0,0,"dummy"
"142822",0,0,0,0,"dummy"
"142823",0,1,0,1,"dummy"
"142824",0,0,1,1,"dummy"
"142836",2,2,0,4,"dummy"
"142840",0,13,0,13,"dummy"
"142841",0,0,1,1,"dummy"
"142845",2,4,0,6,"dummy"
"142846",0,0,0,0,"dummy"
"142851",0,0,1,1,"dummy"
"142859",0,0,0,0,"dummy"
"142860",0,1,0,1,"dummy"
"142863",0,1,0,1,"dummy"
"142864",2,1,0,3,"dummy"
"142865",0,1,0,1,"dummy"
"142872",0,20,0,20,"dummy"
"142873",17,0,0,17,"dummy"
"142874",0,18,0,18,"dummy"
"142891",3,0,1,4,"dummy"
"142892",0,0,1,1,"dummy"
"142917",0,6,0,6,"dummy"
"142918",2,0,1,3,"dummy"
"142923",2,1,0,3,"dummy"
"142939",0,0,1,1,"dummy"
"142945",0,2,0,2,"dummy"
"142979",0,0,1,1,"dummy"
"142982",6,2,0,8,"dummy"
"142983",1,2,1,4,"dummy"
"142984",8,4,0,12,"dummy"
"142857",0,0,0,0,"dummy"
"142867",0,3,0,3,"dummy"
"142876",5,7,0,12,"dummy"
"142877",0,2,0,2,"dummy"
"142878",2,0,0,2,"dummy"
"142881",3,3,0,6,"dummy"
"142882",0,1,0,1,"dummy"
"142885",0,0,1,1,"dummy"
"142886",0,1,0,1,"dummy"
"142887",1,0,0,1,"dummy"
"142888",1,0,0,1,"dummy"
"142889",3,0,0,3,"dummy"
"142894",4,8,1,13,"dummy"
"142909",0,0,2,2,"dummy"
"142910",0,0,0,0,"dummy"
"142911",0,0,2,2,"dummy"
"142912",0,0,1,1,"dummy"
"142913",0,0,0,0,"dummy"
"142914",0,1,0,1,"dummy"
"142915",0,2,0,2,"dummy"
"142920",0,0,1,1,"dummy"
"142921",5,2,7,14,"dummy"
"142930",0,1,0,1,"dummy"
"142931",0,0,0,0,"dummy"
"142932",0,0,2,2,"dummy"
"142933",0,1,1,2,"dummy"
"142934",0,0,0,0,"dummy"
"142935",0,0,1,1,"dummy"
"142951",0,1,4,5,"dummy"
"142952",0,0,1,1,"dummy"
"142953",0,0,1,1,"dummy"
"142954",2,1,0,3,"dummy"
"142955",0,0,1,1,"dummy"
"142958",0,2,0,2,"dummy"
"142961",0,1,0,1,"dummy"
"142962",0,2,0,2,"dummy"
"142963",8,2,1,11,"dummy"
"142964",0,1,1,2,"dummy"
"142965",0,6,0,6,"dummy"
"142966",0,5,1,6,"dummy"
"142967",3,0,0,3,"dummy"
"142970",2,0,0,2,"dummy"
"142971",1,2,0,3,"dummy"
"142972",0,3,0,3,"dummy"
"142973",0,2,0,2,"dummy"
"142974",3,1,0,4,"dummy"
"142975",0,2,0,2,"dummy"
"142976",1,7,0,8,"dummy"
"142977",11,7,2,20,"dummy"
"142986",0,5,0,5,"dummy"
"142987",0,1,0,1,"dummy"
"142988",0,1,0,1,"dummy"
"142989",0,3,0,3,"dummy"
"142990",0,0,1,1,"dummy"
"142999",0,1,0,1,"dummy"
"143000",0,2,0,2,"dummy"
"143001",1,0,0,1,"dummy"
"143003",0,2,0,2,"dummy"
"143004",0,1,0,1,"dummy"
"143005",0,1,0,1,"dummy"
"143006",0,2,0,2,"dummy"
"143007",0,1,0,1,"dummy"
"143008",7,1,0,8,"dummy"
"143009",5,4,0,9,"dummy"
"143010",0,1,2,3,"dummy"
"143011",0,1,0,1,"dummy"
"143012",0,1,0,1,"dummy"
"143016",0,2,1,3,"dummy"
"143018",1,4,0,5,"dummy"
"143022",0,0,2,2,"dummy"
"143023",0,2,0,2,"dummy"
"143024",0,0,1,1,"dummy"
"143025",0,1,1,2,"dummy"
"143026",0,0,2,2,"dummy"
"143029",0,7,0,7,"dummy"
"143030",1,5,0,6,"dummy"
"143032",6,2,0,8,"dummy"
"143033",1,2,1,4,"dummy"
"143034",8,4,0,12,"dummy"
"143036",0,0,1,1,"dummy"
"143037",0,8,1,9,"dummy"
"143040",2,0,3,5,"dummy"
"143043",0,0,1,1,"dummy"
"143044",0,0,1,1,"dummy"
"143045",0,0,1,1,"dummy"
"143046",0,0,2,2,"dummy"
"143047",0,0,0,0,"dummy"
"143048",0,0,0,0,"dummy"
"143055",0,0,1,1,"dummy"
"143059",0,3,0,3,"dummy"
"143060",0,1,0,1,"dummy"
"143063",0,1,0,1,"dummy"
"143064",0,0,1,1,"dummy"
"143065",2,3,2,7,"dummy"
"143066",0,0,0,0,"dummy"
"143067",0,0,1,1,"dummy"
"143070",0,0,1,1,"dummy"
"143071",0,5,0,5,"dummy"
"143072",0,0,1,1,"dummy"
"143073",0,1,0,1,"dummy"
"143074",0,0,1,1,"dummy"
"143075",0,1,0,1,"dummy"
"143076",8,0,3,11,"dummy"
"143077",0,3,1,4,"dummy"
"143080",0,3,0,3,"dummy"
"143081",3,2,1,6,"dummy"
"143082",0,2,0,2,"dummy"
"143083",1,1,0,2,"dummy"
"143087",0,1,0,1,"dummy"
"143088",0,0,0,0,"dummy"
"143089",0,0,2,2,"dummy"
"143090",0,1,0,1,"dummy"
"143091",0,0,1,1,"dummy"
"143092",0,1,0,1,"dummy"
"143095",0,1,0,1,"dummy"
"143098",0,5,0,5,"dummy"
"143099",0,0,1,1,"dummy"
"143100",1,0,0,1,"dummy"
"143101",0,1,1,2,"dummy"
"143102",1,0,0,1,"dummy"
"143103",0,1,0,1,"dummy"
"143104",0,2,0,2,"dummy"
"143105",1,0,1,2,"dummy"
"143106",0,0,0,0,"dummy"
"143107",0,0,1,1,"dummy"
"143108",0,0,1,1,"dummy"
"143109",0,0,0,0,"dummy"
"143110",0,1,0,1,"dummy"
"143111",0,0,0,0,"dummy"
"143113",1,0,0,1,"dummy"
"143116",0,1,6,7,"dummy"
"143117",0,0,1,1,"dummy"
"143118",2,0,1,3,"dummy"
"143119",1,0,0,1,"dummy"
"143120",0,0,1,1,"dummy"
"143121",0,0,6,6,"dummy"
"143127",0,1,1,2,"dummy"
"143129",4,5,1,10,"dummy"
"143130",1,0,0,1,"dummy"
"143131",1,1,2,4,"dummy"
"143135",0,0,4,4,"dummy"
"143136",0,1,0,1,"dummy"
"143137",0,0,1,1,"dummy"
"143138",0,0,1,1,"dummy"
"143139",0,0,1,1,"dummy"
"143140",0,0,1,1,"dummy"
"143141",0,0,1,1,"dummy"
"143142",0,2,0,2,"dummy"
"143143",3,2,0,5,"dummy"
"143144",0,2,0,2,"dummy"
"143147",0,0,1,1,"dummy"
"143148",1,0,5,6,"dummy"
"143150",1,1,0,2,"dummy"
"143157",2,7,2,11,"dummy"
"143158",8,5,1,14,"dummy"
"143159",1,0,0,1,"dummy"
"143160",0,0,1,1,"dummy"
"143163",0,0,3,3,"dummy"
"143166",2,1,0,3,"dummy"
"143167",0,0,0,0,"dummy"
"143168",0,1,0,1,"dummy"
"143169",1,0,0,1,"dummy"
"143170",0,1,0,1,"dummy"
"143171",0,0,1,1,"dummy"
"143173",1,3,1,5,"dummy"
"143174",1,1,0,2,"dummy"
"143175",0,3,0,3,"dummy"
"143178",2,12,0,14,"dummy"
"143179",0,14,0,14,"dummy"
"143181",0,1,0,1,"dummy"
"143182",0,7,0,7,"dummy"
"143185",1,2,0,3,"dummy"
"143188",0,2,0,2,"dummy"
"143189",9,9,1,19,"dummy"
"143190",0,0,2,2,"dummy"
"143197",3,7,0,10,"dummy"
"143198",6,5,1,12,"dummy"
"143203",0,6,0,6,"dummy"
"143204",6,6,0,12,"dummy"
"143205",0,4,0,4,"dummy"
"143206",6,3,3,12,"dummy"
"143207",3,6,1,10,"dummy"
"143210",6,17,0,23,"dummy"
"143211",13,5,0,18,"dummy"
"143212",0,1,0,1,"dummy"
"143213",0,4,0,4,"dummy"
"143214",0,0,0,0,"dummy"
"143215",0,1,1,2,"dummy"
"143220",2,2,0,4,"dummy"
"143222",0,2,0,2,"dummy"
"143227",0,0,1,1,"dummy"
"143228",1,6,0,7,"dummy"
"143229",0,4,0,4,"dummy"
"143230",0,0,1,1,"dummy"
"143231",0,0,0,0,"dummy"
"143232",0,0,1,1,"dummy"
"143239",0,2,3,5,"dummy"
"143240",5,1,0,6,"dummy"
"143241",0,1,0,1,"dummy"
"143242",2,7,0,9,"dummy"
"143243",3,2,0,5,"dummy"
"143244",1,0,2,3,"dummy"
"143245",0,0,2,2,"dummy"
"143248",0,2,0,2,"dummy"
"143249",0,5,1,6,"dummy"
"143251",0,0,0,0,"dummy"
"143254",0,0,1,1,"dummy"
"143259",5,2,1,8,"dummy"
"143263",2,0,0,2,"dummy"
"143272",1,0,0,1,"dummy"
"143273",0,0,1,1,"dummy"
"143274",0,0,1,1,"dummy"
"143275",0,1,0,1,"dummy"
"143276",0,0,1,1,"dummy"
"143277",5,2,2,9,"dummy"
"143278",1,0,0,1,"dummy"
"143279",0,0,1,1,"dummy"
"143280",0,10,1,11,"dummy"
"143291",0,0,3,3,"dummy"
"143293",2,0,1,3,"dummy"
"143294",0,0,0,0,"dummy"
"143296",0,0,1,1,"dummy"
"143298",0,0,1,1,"dummy"
"143303",2,2,0,4,"dummy"
"143304",2,0,3,5,"dummy"
"143305",0,0,1,1,"dummy"
"143306",0,0,1,1,"dummy"
"143307",0,0,1,1,"dummy"
"143308",0,0,1,1,"dummy"
"143309",0,0,1,1,"dummy"
"143310",0,0,1,1,"dummy"
"143311",0,0,1,1,"dummy"
"143312",0,0,1,1,"dummy"
"143313",0,0,1,1,"dummy"
"143314",0,0,1,1,"dummy"
"143315",0,0,1,1,"dummy"
"143316",0,0,1,1,"dummy"
"143317",0,0,1,1,"dummy"
"143318",0,0,1,1,"dummy"
"143325",0,7,3,10,"dummy"
"143326",0,1,0,1,"dummy"
"143329",6,0,3,9,"dummy"
"143335",0,0,2,2,"dummy"
"143337",0,0,1,1,"dummy"
"143338",0,1,0,1,"dummy"
"143339",0,0,0,0,"dummy"
"143340",0,0,0,0,"dummy"
"143342",1,1,1,3,"dummy"
"143347",1,2,0,3,"dummy"
"143348",9,0,1,10,"dummy"
"143349",0,4,0,4,"dummy"
"143350",4,0,0,4,"dummy"
"143355",0,0,0,0,"dummy"
"143356",0,0,1,1,"dummy"
"143357",0,0,0,0,"dummy"
"143358",0,0,1,1,"dummy"
"143359",0,0,1,1,"dummy"
"143377",11,0,0,11,"dummy"
"143380",2,2,0,4,"dummy"
"143381",0,0,2,2,"dummy"
"143382",0,0,2,2,"dummy"
"143383",0,0,2,2,"dummy"
"143384",0,0,2,2,"dummy"
"143385",0,0,2,2,"dummy"
"143386",0,0,2,2,"dummy"
"143387",0,1,1,2,"dummy"
"143388",0,1,1,2,"dummy"
"143389",1,3,0,4,"dummy"
"143390",0,0,0,0,"dummy"
"143391",0,0,2,2,"dummy"
"143392",0,0,2,2,"dummy"
"143393",0,0,2,2,"dummy"
"143394",0,0,2,2,"dummy"
"143397",0,2,0,2,"dummy"
"143400",0,8,0,8,"dummy"
"143401",3,1,1,5,"dummy"
"143402",1,3,2,6,"dummy"
"143403",4,1,0,5,"dummy"
"143411",0,0,1,1,"dummy"
"143412",0,0,1,1,"dummy"
"143413",0,0,1,1,"dummy"
"143414",0,0,1,1,"dummy"
"143415",0,0,1,1,"dummy"
"143416",0,0,1,1,"dummy"
"143419",3,9,0,12,"dummy"
"143431",2,4,0,6,"dummy"
"143432",0,2,0,2,"dummy"
"143433",0,2,0,2,"dummy"
"143434",10,2,0,12,"dummy"
"143435",0,2,0,2,"dummy"
"143436",0,0,0,0,"dummy"
"143437",0,0,0,0,"dummy"
"143450",0,0,0,0,"dummy"
"143451",0,0,1,1,"dummy"
"143452",0,0,0,0,"dummy"
"143453",3,5,0,8,"dummy"
"143456",5,2,0,7,"dummy"
"143457",0,0,0,0,"dummy"
"143458",0,0,1,1,"dummy"
"143459",0,0,1,1,"dummy"
"143460",0,6,0,6,"dummy"
"143461",0,2,0,2,"dummy"
"143467",0,0,0,0,"dummy"
"143468",0,0,0,0,"dummy"
"143473",0,2,4,6,"dummy"
"143474",0,0,6,6,"dummy"
"143475",0,4,0,4,"dummy"
"143476",4,0,0,4,"dummy"
"143479",0,0,1,1,"dummy"
"143480",0,0,1,1,"dummy"
"143481",0,0,2,2,"dummy"
"143482",0,0,1,1,"dummy"
"143483",0,0,0,0,"dummy"
"143484",0,0,1,1,"dummy"
"143485",0,2,0,2,"dummy"
"143486",2,2,0,4,"dummy"
"143487",0,0,1,1,"dummy"
"143488",0,3,0,3,"dummy"
"143489",0,1,0,1,"dummy"
"143490",0,0,1,1,"dummy"
"143491",1,4,0,5,"dummy"
"143492",0,1,0,1,"dummy"
"143493",0,2,0,2,"dummy"
"143494",9,2,0,11,"dummy"
"143495",2,2,0,4,"dummy"
"143496",0,2,0,2,"dummy"
"143497",0,0,0,0,"dummy"
"143498",0,2,0,2,"dummy"
"143499",4,1,0,5,"dummy"
"143500",1,0,0,1,"dummy"
"143501",0,0,0,0,"dummy"
"143502",0,2,0,2,"dummy"
"143503",0,0,0,0,"dummy"
"143504",1,0,0,1,"dummy"
"143505",6,0,0,6,"dummy"
"143541",1,0,0,1,"dummy"
"143542",4,45,0,49,"dummy"
"143543",5,0,0,5,"dummy"
"143544",0,5,0,5,"dummy"
"143545",0,3,0,3,"dummy"
"143546",0,3,0,3,"dummy"
"143547",0,1,0,1,"dummy"
"143548",0,2,2,4,"dummy"
"143549",1,1,0,2,"dummy"
"143550",1,1,0,2,"dummy"
"143405",0,0,1,1,"dummy"
"143406",0,1,0,1,"dummy"
"143409",2,0,2,4,"dummy"
"143421",0,1,0,1,"dummy"
"143422",1,0,2,3,"dummy"
"143423",0,0,1,1,"dummy"
"143424",0,0,1,1,"dummy"
"143425",0,21,0,21,"dummy"
"143439",11,0,0,11,"dummy"
"143440",0,0,0,0,"dummy"
"143441",0,1,0,1,"dummy"
"143442",0,0,0,0,"dummy"
"143443",0,2,0,2,"dummy"
"143444",0,0,0,0,"dummy"
"143445",0,1,0,1,"dummy"
"143446",0,0,0,0,"dummy"
"143447",0,3,0,3,"dummy"
"143448",0,0,0,0,"dummy"
"143463",0,3,1,4,"dummy"
"143464",3,0,1,4,"dummy"
"143465",2,4,1,7,"dummy"
"143470",0,0,0,0,"dummy"
"143471",0,0,0,0,"dummy"
"143509",3,5,3,11,"dummy"
"143510",0,0,2,2,"dummy"
"143511",0,1,0,1,"dummy"
"143512",0,1,0,1,"dummy"
"143513",1,2,0,3,"dummy"
"143514",4,2,1,7,"dummy"
"143515",2,5,1,8,"dummy"
"143518",0,2,0,2,"dummy"
"143519",0,9,0,9,"dummy"
"143520",1,0,0,1,"dummy"
"143521",0,0,1,1,"dummy"
"143522",1,0,0,1,"dummy"
"143523",0,3,1,4,"dummy"
"143524",1,0,1,2,"dummy"
"143525",0,1,0,1,"dummy"
"143526",1,1,0,2,"dummy"
"143527",0,1,0,1,"dummy"
"143528",1,0,0,1,"dummy"
"143529",0,2,1,3,"dummy"
"143530",0,1,0,1,"dummy"
"143531",3,0,0,3,"dummy"
"143532",3,0,0,3,"dummy"
"143533",0,0,2,2,"dummy"
"143534",0,3,1,4,"dummy"
"143535",0,0,1,1,"dummy"
"143536",0,2,0,2,"dummy"
"143537",0,2,0,2,"dummy"
"143538",0,1,0,1,"dummy"
"143539",3,11,1,15,"dummy"
"143600",0,0,2,2,"dummy"
"143601",0,1,0,1,"dummy"
"143607",0,0,0,0,"dummy"
"143608",3,0,0,3,"dummy"
"143609",0,0,1,1,"dummy"
"143610",3,2,0,5,"dummy"
"143611",0,2,0,2,"dummy"
"143612",0,5,0,5,"dummy"
"143613",0,0,0,0,"dummy"
"143614",0,0,1,1,"dummy"
"143615",0,1,0,1,"dummy"
"143616",0,0,0,0,"dummy"
"143617",0,0,0,0,"dummy"
"143618",0,0,2,2,"dummy"
"143619",5,0,0,5,"dummy"
"143620",0,0,0,0,"dummy"
"143621",0,0,0,0,"dummy"
"143622",1,0,0,1,"dummy"
"143627",0,0,0,0,"dummy"
"143628",0,11,0,11,"dummy"
"143629",0,0,1,1,"dummy"
"143551",0,0,0,0,"dummy"
"143552",2,0,0,2,"dummy"
"143553",0,0,0,0,"dummy"
"143554",0,0,1,1,"dummy"
"143555",1,1,0,2,"dummy"
"143556",1,3,0,4,"dummy"
"143557",3,1,1,5,"dummy"
"143558",0,0,0,0,"dummy"
"143559",1,0,0,1,"dummy"
"143560",0,0,0,0,"dummy"
"143561",0,1,0,1,"dummy"
"143562",1,5,0,6,"dummy"
"143563",1,0,0,1,"dummy"
"143564",1,1,0,2,"dummy"
"143565",5,0,0,5,"dummy"
"143566",1,0,0,1,"dummy"
"143567",0,11,2,13,"dummy"
"143568",0,3,0,3,"dummy"
"143569",1,2,0,3,"dummy"
"143570",0,3,1,4,"dummy"
"143571",0,1,0,1,"dummy"
"143572",1,0,0,1,"dummy"
"143573",1,1,2,4,"dummy"
"143574",1,4,0,5,"dummy"
"143575",1,1,0,2,"dummy"
"143576",1,0,0,1,"dummy"
"143577",0,1,0,1,"dummy"
"143578",0,1,0,1,"dummy"
"143579",0,3,0,3,"dummy"
"143582",3,4,0,7,"dummy"
"143603",3,3,0,6,"dummy"
"143604",3,3,0,6,"dummy"
"143605",3,3,0,6,"dummy"
"143632",0,3,0,3,"dummy"
"143633",0,0,0,0,"dummy"
"143634",0,0,1,1,"dummy"
"143663",4,8,4,16,"dummy"
"143664",6,0,2,8,"dummy"
"143665",0,3,2,5,"dummy"
"143666",0,3,1,4,"dummy"
"143667",0,0,1,1,"dummy"
"143670",0,0,2,2,"dummy"
"143673",0,0,1,1,"dummy"
"143674",3,0,0,3,"dummy"
"143675",1,0,0,1,"dummy"
"143676",1,0,0,1,"dummy"
"143687",0,0,1,1,"dummy"
"143688",3,1,4,8,"dummy"
"143707",8,5,0,13,"dummy"
"143708",1,17,2,20,"dummy"
"143709",0,3,2,5,"dummy"
"143731",0,1,1,2,"dummy"
"143732",4,5,3,12,"dummy"
"143733",0,0,3,3,"dummy"
"143734",4,4,0,8,"dummy"
"143735",2,0,0,2,"dummy"
"143738",0,0,0,0,"dummy"
"143739",0,3,0,3,"dummy"
"143740",0,1,0,1,"dummy"
"143741",3,0,0,3,"dummy"
"143742",0,6,1,7,"dummy"
"143743",1,0,0,1,"dummy"
"143749",0,0,2,2,"dummy"
"143752",0,5,0,5,"dummy"
"143753",0,1,0,1,"dummy"
"143754",11,6,10,27,"dummy"
"143763",0,0,1,1,"dummy"
"143767",0,0,1,1,"dummy"
"143768",0,2,2,4,"dummy"
"143774",0,0,1,1,"dummy"
"143630",2,0,0,2,"dummy"
"143655",1,2,0,3,"dummy"
"143656",1,0,0,1,"dummy"
"143657",0,0,3,3,"dummy"
"143658",1,1,0,2,"dummy"
"143661",0,0,3,3,"dummy"
"143680",1,5,0,6,"dummy"
"143685",2,0,3,5,"dummy"
"143692",6,4,1,11,"dummy"
"143693",2,13,0,15,"dummy"
"143705",0,1,0,1,"dummy"
"143711",0,1,1,2,"dummy"
"143712",7,4,3,14,"dummy"
"143713",1,8,4,13,"dummy"
"143729",0,0,1,1,"dummy"
"143745",0,2,0,2,"dummy"
"143756",13,0,2,15,"dummy"
"143765",2,1,1,4,"dummy"
"143770",2,1,1,4,"dummy"
"143771",0,1,3,4,"dummy"
"143772",1,0,3,4,"dummy"
"143783",0,0,1,1,"dummy"
"143787",0,1,0,1,"dummy"
"143788",0,0,1,1,"dummy"
"143798",0,1,0,1,"dummy"
"143801",5,3,2,10,"dummy"
"143802",1,3,0,4,"dummy"
"143806",0,0,1,1,"dummy"
"143809",1,0,1,2,"dummy"
"143810",0,4,0,4,"dummy"
"143811",4,0,0,4,"dummy"
"143818",2,1,0,3,"dummy"
"143819",0,0,2,2,"dummy"
"143822",0,2,0,2,"dummy"
"143823",3,3,0,6,"dummy"
"143824",0,1,0,1,"dummy"
"143832",0,2,0,2,"dummy"
"143833",0,3,0,3,"dummy"
"143834",0,1,0,1,"dummy"
"143835",0,1,0,1,"dummy"
"143836",0,1,0,1,"dummy"
"143837",0,2,0,2,"dummy"
"143840",0,1,0,1,"dummy"
"143841",3,0,0,3,"dummy"
"143842",0,0,0,0,"dummy"
"143843",0,4,1,5,"dummy"
"143844",0,1,0,1,"dummy"
"143848",0,0,0,0,"dummy"
"143849",0,0,0,0,"dummy"
"143850",0,0,0,0,"dummy"
"143775",2,4,1,7,"dummy"
"143778",0,0,1,1,"dummy"
"143779",0,1,0,1,"dummy"
"143780",0,0,1,1,"dummy"
"143781",1,2,1,4,"dummy"
"143785",2,6,1,9,"dummy"
"143790",0,1,2,3,"dummy"
"143791",0,0,0,0,"dummy"
"143792",0,1,0,1,"dummy"
"143793",4,0,2,6,"dummy"
"143794",1,0,0,1,"dummy"
"143795",0,0,0,0,"dummy"
"143796",0,0,0,0,"dummy"
"143804",0,0,2,2,"dummy"
"143813",1,1,0,2,"dummy"
"143816",0,0,1,1,"dummy"
"143828",0,0,0,0,"dummy"
"143829",0,0,2,2,"dummy"
"143830",0,1,0,1,"dummy"
"143846",7,5,1,13,"dummy"
"143862",4,6,0,10,"dummy"
"143863",2,5,0,7,"dummy"
"143864",3,1,1,5,"dummy"
"143865",1,2,0,3,"dummy"
"143866",6,0,0,6,"dummy"
"143872",0,0,1,1,"dummy"
"143873",0,1,0,1,"dummy"
"143887",1,0,1,2,"dummy"
"143897",0,1,0,1,"dummy"
"143898",0,0,1,1,"dummy"
"143909",0,0,1,1,"dummy"
"143912",0,0,0,0,"dummy"
"143913",1,0,0,1,"dummy"
"143914",0,0,1,1,"dummy"
"143915",2,0,0,2,"dummy"
"143916",0,0,1,1,"dummy"
"143917",0,1,0,1,"dummy"
"143918",0,2,0,2,"dummy"
"143921",4,0,0,4,"dummy"
"143922",6,6,0,12,"dummy"
"143923",7,3,1,11,"dummy"
"143926",0,1,0,1,"dummy"
"143927",0,1,0,1,"dummy"
"143935",0,2,0,2,"dummy"
"143936",0,8,1,9,"dummy"
"143937",0,0,2,2,"dummy"
"143956",0,0,1,1,"dummy"
"143957",0,12,0,12,"dummy"
"143958",0,6,0,6,"dummy"
"143959",0,30,1,31,"dummy"
"143960",0,2,0,2,"dummy"
"143961",0,22,0,22,"dummy"
"143962",0,4,0,4,"dummy"
"143963",0,1,0,1,"dummy"
"143964",0,0,1,1,"dummy"
"143965",42,27,0,69,"dummy"
"143966",1,1,0,2,"dummy"
"143967",0,6,0,6,"dummy"
"143968",0,1,0,1,"dummy"
"143969",0,3,0,3,"dummy"
"143970",1,4,0,5,"dummy"
"143971",1,1,1,3,"dummy"
"143972",6,10,2,18,"dummy"
"143975",0,1,0,1,"dummy"
"143976",1,0,0,1,"dummy"
"143977",0,1,0,1,"dummy"
"143978",1,1,0,2,"dummy"
"143979",0,0,0,0,"dummy"
"143980",0,1,0,1,"dummy"
"143981",1,2,0,3,"dummy"
"143982",0,0,0,0,"dummy"
"143983",2,7,0,9,"dummy"
"143870",0,1,0,1,"dummy"
"143877",0,3,0,3,"dummy"
"143878",0,0,2,2,"dummy"
"143881",0,0,0,0,"dummy"
"143889",0,1,0,1,"dummy"
"143892",0,1,0,1,"dummy"
"143893",2,0,2,4,"dummy"
"143900",0,0,1,1,"dummy"
"143931",0,0,1,1,"dummy"
"143941",0,0,1,1,"dummy"
"143942",1,2,0,3,"dummy"
"143943",0,1,0,1,"dummy"
"143944",0,0,1,1,"dummy"
"143945",2,2,2,6,"dummy"
"143946",2,3,2,7,"dummy"
"143947",0,2,0,2,"dummy"
"143948",0,0,0,0,"dummy"
"143949",7,5,2,14,"dummy"
"143950",0,1,0,1,"dummy"
"143951",4,5,2,11,"dummy"
"143952",2,2,0,4,"dummy"
"143953",2,2,0,4,"dummy"
"143954",0,0,1,1,"dummy"
"144008",8,1,1,10,"dummy"
"144018",0,0,0,0,"dummy"
"144019",0,0,0,0,"dummy"
"144062",0,0,1,1,"dummy"
"144063",2,0,0,2,"dummy"
"144066",0,1,0,1,"dummy"
"144067",0,2,0,2,"dummy"
"144068",0,2,0,2,"dummy"
"144069",0,1,0,1,"dummy"
"144070",0,0,1,1,"dummy"
"144071",0,0,1,1,"dummy"
"144072",1,0,0,1,"dummy"
"144073",12,10,3,25,"dummy"
"144074",1,0,0,1,"dummy"
"144082",0,0,1,1,"dummy"
"144083",1,2,1,4,"dummy"
"144084",0,0,0,0,"dummy"
"144085",2,2,0,4,"dummy"
"144086",0,2,0,2,"dummy"
"144087",2,5,0,7,"dummy"
"144092",0,3,1,4,"dummy"
"144093",2,0,0,2,"dummy"
"144094",0,0,1,1,"dummy"
"144097",0,1,2,3,"dummy"
"144098",0,0,0,0,"dummy"
"144099",0,1,0,1,"dummy"
"144100",4,0,2,6,"dummy"
"144101",1,0,0,1,"dummy"
"144102",0,0,0,0,"dummy"
"144103",0,0,0,0,"dummy"
"144109",0,0,0,0,"dummy"
"144110",0,0,0,0,"dummy"
"144111",0,0,0,0,"dummy"
"144112",0,0,0,0,"dummy"
"144113",0,0,0,0,"dummy"
"144114",0,0,0,0,"dummy"
"143984",3,1,0,4,"dummy"
"143985",0,0,0,0,"dummy"
"143986",3,0,0,3,"dummy"
"143987",0,1,0,1,"dummy"
"143988",0,1,0,1,"dummy"
"143989",1,0,0,1,"dummy"
"143990",0,2,0,2,"dummy"
"143991",0,1,1,2,"dummy"
"143992",1,0,1,2,"dummy"
"143993",2,0,0,2,"dummy"
"143994",0,1,0,1,"dummy"
"143995",4,1,0,5,"dummy"
"143996",0,0,0,0,"dummy"
"143997",0,0,0,0,"dummy"
"143998",0,1,0,1,"dummy"
"143999",2,4,0,6,"dummy"
"144000",0,1,0,1,"dummy"
"144001",2,2,1,5,"dummy"
"144002",3,3,0,6,"dummy"
"144003",0,3,0,3,"dummy"
"144004",1,0,1,2,"dummy"
"144005",0,1,0,1,"dummy"
"144006",9,1,1,11,"dummy"
"144010",0,0,2,2,"dummy"
"144011",0,0,2,2,"dummy"
"144012",1,1,1,3,"dummy"
"144013",0,2,0,2,"dummy"
"144014",8,7,3,18,"dummy"
"144021",0,5,2,7,"dummy"
"144022",1,2,0,3,"dummy"
"144023",0,0,1,1,"dummy"
"144024",0,0,1,1,"dummy"
"144025",2,2,0,4,"dummy"
"144026",2,2,0,4,"dummy"
"144027",2,8,1,11,"dummy"
"144028",0,0,1,1,"dummy"
"144029",0,1,0,1,"dummy"
"144030",0,2,0,2,"dummy"
"144031",0,0,1,1,"dummy"
"144032",18,2,1,21,"dummy"
"144033",0,0,1,1,"dummy"
"144034",0,0,1,1,"dummy"
"144035",0,0,1,1,"dummy"
"144036",0,0,1,1,"dummy"
"144037",0,0,1,1,"dummy"
"144038",0,0,1,1,"dummy"
"144039",0,0,1,1,"dummy"
"144040",0,0,1,1,"dummy"
"144041",0,0,1,1,"dummy"
"144042",0,0,1,1,"dummy"
"144043",0,0,1,1,"dummy"
"144044",0,0,1,1,"dummy"
"144045",0,0,1,1,"dummy"
"144046",0,0,1,1,"dummy"
"144047",0,0,1,1,"dummy"
"144048",0,0,1,1,"dummy"
"144049",0,0,1,1,"dummy"
"144050",0,0,1,1,"dummy"
"144051",0,0,1,1,"dummy"
"144052",6,0,0,6,"dummy"
"144053",0,2,0,2,"dummy"
"144054",0,2,0,2,"dummy"
"144055",0,0,1,1,"dummy"
"144056",0,0,1,1,"dummy"
"144057",0,0,1,1,"dummy"
"144060",0,0,0,0,"dummy"
"144078",0,0,1,1,"dummy"
"144105",0,0,1,1,"dummy"
"144106",0,1,0,1,"dummy"
"144107",0,0,1,1,"dummy"
"144121",0,0,0,0,"dummy"
"144123",0,0,1,1,"dummy"
"144132",0,2,0,2,"dummy"
"144136",0,0,3,3,"dummy"
"144140",0,2,0,2,"dummy"
"144141",2,0,0,2,"dummy"
"144148",0,0,1,1,"dummy"
"144149",0,1,0,1,"dummy"
"144150",0,0,1,1,"dummy"
"144151",0,0,0,0,"dummy"
"144152",0,1,0,1,"dummy"
"144155",3,1,4,8,"dummy"
"144156",0,1,0,1,"dummy"
"144157",0,0,0,0,"dummy"
"144158",0,0,1,1,"dummy"
"144159",5,3,2,10,"dummy"
"144160",0,1,0,1,"dummy"
"144161",0,1,1,2,"dummy"
"144162",1,0,0,1,"dummy"
"144163",1,0,0,1,"dummy"
"144164",0,0,0,0,"dummy"
"144165",1,0,0,1,"dummy"
"144166",0,1,0,1,"dummy"
"144167",1,0,0,1,"dummy"
"144170",2,1,0,3,"dummy"
"144171",4,0,2,6,"dummy"
"144173",2,18,1,21,"dummy"
"144174",0,1,0,1,"dummy"
"144176",0,0,1,1,"dummy"
"144180",1,0,0,1,"dummy"
"144181",1,0,0,1,"dummy"
"144183",0,0,1,1,"dummy"
"144184",2,0,0,2,"dummy"
"144185",0,0,0,0,"dummy"
"144187",0,2,0,2,"dummy"
"144188",3,10,1,14,"dummy"
"144189",0,0,3,3,"dummy"
"144190",7,7,8,22,"dummy"
"144191",0,0,3,3,"dummy"
"144217",0,2,0,2,"dummy"
"144218",0,2,0,2,"dummy"
"144221",1,2,0,3,"dummy"
"144224",2,2,2,6,"dummy"
"144228",0,2,0,2,"dummy"
"144229",3,1,4,8,"dummy"
"144230",0,1,0,1,"dummy"
"144231",1,0,1,2,"dummy"
"144233",0,1,0,1,"dummy"
"144234",2,6,2,10,"dummy"
"144236",2,4,0,6,"dummy"
"144237",0,2,0,2,"dummy"
"144238",0,2,0,2,"dummy"
"144239",10,2,0,12,"dummy"
"144240",0,2,0,2,"dummy"
"144241",0,0,0,0,"dummy"
"144242",0,0,3,3,"dummy"
"144243",0,5,0,5,"dummy"
"144245",1,0,0,1,"dummy"
"144247",0,1,0,1,"dummy"
"144248",0,7,1,8,"dummy"
"144249",2,1,5,8,"dummy"
"144250",5,6,0,11,"dummy"
"144261",3,9,0,12,"dummy"
"144262",0,0,1,1,"dummy"
"144263",0,0,1,1,"dummy"
"144266",1,3,1,5,"dummy"
"144268",0,0,1,1,"dummy"
"144269",0,1,0,1,"dummy"
"144270",1,0,1,2,"dummy"
"144273",2,1,2,5,"dummy"
"144274",0,5,0,5,"dummy"
"144275",5,1,0,6,"dummy"
"144276",0,2,0,2,"dummy"
"144277",0,3,0,3,"dummy"
"144278",0,1,0,1,"dummy"
"144279",0,0,0,0,"dummy"
"144280",2,3,0,5,"dummy"
"144281",2,2,0,4,"dummy"
"144282",1,1,0,2,"dummy"
"144283",0,1,0,1,"dummy"
"144284",0,4,0,4,"dummy"
"144285",0,2,0,2,"dummy"
"144286",3,0,0,3,"dummy"
"144287",0,0,1,1,"dummy"
"144289",0,1,0,1,"dummy"
"144294",1,0,1,2,"dummy"
"144296",0,2,0,2,"dummy"
"144302",0,4,0,4,"dummy"
"144303",0,0,0,0,"dummy"
"144304",0,0,0,0,"dummy"
"144305",0,0,1,1,"dummy"
"144306",0,1,0,1,"dummy"
"144307",0,0,0,0,"dummy"
"144309",2,4,0,6,"dummy"
"144310",0,2,0,2,"dummy"
"144311",0,2,0,2,"dummy"
"144312",10,2,0,12,"dummy"
"144313",0,2,0,2,"dummy"
"144314",0,0,0,0,"dummy"
"144315",0,0,3,3,"dummy"
"144316",0,5,0,5,"dummy"
"144317",1,0,1,2,"dummy"
"144327",0,1,0,1,"dummy"
"144329",3,0,0,3,"dummy"
"144330",1,0,0,1,"dummy"
"144332",0,0,1,1,"dummy"
"144333",1,1,2,4,"dummy"
"144335",2,0,0,2,"dummy"
"144336",0,0,2,2,"dummy"
"144337",1,0,0,1,"dummy"
"144338",0,0,1,1,"dummy"
"144339",0,3,0,3,"dummy"
"144340",0,3,0,3,"dummy"
"144341",1,2,0,3,"dummy"
"144342",0,5,0,5,"dummy"
"144343",1,0,1,2,"dummy"
"144344",0,2,1,3,"dummy"
"144345",0,3,0,3,"dummy"
"144346",0,1,0,1,"dummy"
"144350",1,1,0,2,"dummy"
"144351",0,0,1,1,"dummy"
"144352",0,0,1,1,"dummy"
"144355",0,2,0,2,"dummy"
"144356",0,2,0,2,"dummy"
"144357",2,2,0,4,"dummy"
"144358",0,1,0,1,"dummy"
"144359",0,1,0,1,"dummy"
"144362",3,6,1,10,"dummy"
"144364",0,0,1,1,"dummy"
"144366",4,4,0,8,"dummy"
"144367",0,0,4,4,"dummy"
"144368",0,1,0,1,"dummy"
"144370",0,0,0,0,"dummy"
"144371",0,1,0,1,"dummy"
"144372",0,1,0,1,"dummy"
"144373",0,0,1,1,"dummy"
"144377",2,4,0,6,"dummy"
"144378",0,2,0,2,"dummy"
"144379",0,2,0,2,"dummy"
"144380",10,2,0,12,"dummy"
"144381",0,2,0,2,"dummy"
"144382",0,0,0,0,"dummy"
"144383",0,0,3,3,"dummy"
"144384",0,5,0,5,"dummy"
"144387",0,1,0,1,"dummy"
"144390",36,24,4,64,"dummy"
"144391",2,5,1,8,"dummy"
"144392",0,1,0,1,"dummy"
"144393",0,1,0,1,"dummy"
"144394",31,20,2,53,"dummy"
"144395",6,14,0,20,"dummy"
"144396",0,0,1,1,"dummy"
"144398",7,4,1,12,"dummy"
"144400",1,0,2,3,"dummy"
"144401",0,1,2,3,"dummy"
"144402",0,1,0,1,"dummy"
"144403",0,0,0,0,"dummy"
"144404",0,0,1,1,"dummy"
"144405",0,0,3,3,"dummy"
"144406",0,0,3,3,"dummy"
"144407",0,0,4,4,"dummy"
"144408",2,3,1,6,"dummy"
"144414",0,0,1,1,"dummy"
"144415",1,0,0,1,"dummy"
"144416",0,4,0,4,"dummy"
"144420",0,2,0,2,"dummy"
"144421",3,2,1,6,"dummy"
"144422",0,1,0,1,"dummy"
"144423",0,0,1,1,"dummy"
"144424",0,0,1,1,"dummy"
"144425",1,1,1,3,"dummy"
"144426",0,0,1,1,"dummy"
"144428",0,0,0,0,"dummy"
"144429",0,0,0,0,"dummy"
"144430",0,1,0,1,"dummy"
"144431",0,0,1,1,"dummy"
"144432",0,0,0,0,"dummy"
"144433",0,0,0,0,"dummy"
"144435",0,0,1,1,"dummy"
"144474",0,1,2,3,"dummy"
"144475",2,2,0,4,"dummy"
"144476",1,12,0,13,"dummy"
"144477",12,1,0,13,"dummy"
"144478",1,13,1,15,"dummy"
"144479",12,1,0,13,"dummy"
"144480",1,4,0,5,"dummy"
"144483",0,6,0,6,"dummy"
"144484",3,7,1,11,"dummy"
"144485",1,0,0,1,"dummy"
"144486",0,0,0,0,"dummy"
"144487",0,0,0,0,"dummy"
"144489",8,8,4,20,"dummy"
"144490",0,0,1,1,"dummy"
"144491",0,0,1,1,"dummy"
"144493",0,0,0,0,"dummy"
"144494",0,1,0,1,"dummy"
"144497",0,0,1,1,"dummy"
"144498",0,0,1,1,"dummy"
"144499",0,0,0,0,"dummy"
"144502",0,0,1,1,"dummy"
"144503",0,1,0,1,"dummy"
"144504",0,0,1,1,"dummy"
"144506",1,21,3,25,"dummy"
"144507",10,9,0,19,"dummy"
"144508",2,2,0,4,"dummy"
"144511",0,2,0,2,"dummy"
"144513",0,2,0,2,"dummy"
"144514",0,2,0,2,"dummy"
"144515",1,1,1,3,"dummy"
"144518",8,9,1,18,"dummy"
"144520",0,2,0,2,"dummy"
"144523",3,5,1,9,"dummy"
"144525",0,1,0,1,"dummy"
"144526",0,13,0,13,"dummy"
"144527",1,4,0,5,"dummy"
"144529",0,9,0,9,"dummy"
"144530",2,1,0,3,"dummy"
"144531",6,2,0,8,"dummy"
"144533",2,8,0,10,"dummy"
"144538",4,5,4,13,"dummy"
"144540",0,2,0,2,"dummy"
"144541",1,5,0,6,"dummy"
"144550",0,0,0,0,"dummy"
"144551",0,0,0,0,"dummy"
"144553",0,1,1,2,"dummy"
"144554",0,1,0,1,"dummy"
"144556",0,2,0,2,"dummy"
"144559",12,5,2,19,"dummy"
"144560",2,0,0,2,"dummy"
"144561",0,0,1,1,"dummy"
"144562",1,2,0,3,"dummy"
"144563",2,11,0,13,"dummy"
"144564",3,4,0,7,"dummy"
"144565",0,1,0,1,"dummy"
"144572",0,2,0,2,"dummy"
"144573",1,0,0,1,"dummy"
"144574",0,1,0,1,"dummy"
"144578",0,1,0,1,"dummy"
"144579",0,1,1,2,"dummy"
"144580",0,1,0,1,"dummy"
"144581",0,0,1,1,"dummy"
"144582",2,0,0,2,"dummy"
"144585",2,5,2,9,"dummy"
"144588",0,0,0,0,"dummy"
"144589",0,0,0,0,"dummy"
"144593",0,0,1,1,"dummy"
"144600",0,0,0,0,"dummy"
"144601",0,0,0,0,"dummy"
"144602",0,0,0,0,"dummy"
"144603",0,0,0,0,"dummy"
"144606",1,0,1,2,"dummy"
"144607",4,2,0,6,"dummy"
"144608",0,0,0,0,"dummy"
"144609",2,0,0,2,"dummy"
"144611",40,0,2,42,"dummy"
"144614",0,1,0,1,"dummy"
"144619",0,0,1,1,"dummy"
"144620",0,2,0,2,"dummy"
"144624",0,1,0,1,"dummy"
"144629",0,2,0,2,"dummy"
"144630",1,2,0,3,"dummy"
"144631",3,18,3,24,"dummy"
"144632",0,0,2,2,"dummy"
"144633",2,2,1,5,"dummy"
"144634",17,26,1,44,"dummy"
"144635",0,2,5,7,"dummy"
"144666",2,1,1,4,"dummy"
"144667",0,1,1,2,"dummy"
"144668",0,0,1,1,"dummy"
"144669",0,0,1,1,"dummy"
"144671",4,2,0,6,"dummy"
"144692",2,0,5,7,"dummy"
"144701",1,0,0,1,"dummy"
"144703",5,5,3,13,"dummy"
"144704",0,1,0,1,"dummy"
"144705",2,10,0,12,"dummy"
"144706",1,1,1,3,"dummy"
"144707",2,0,0,2,"dummy"
"144708",0,0,1,1,"dummy"
"144714",15,3,1,19,"dummy"
"144715",0,1,0,1,"dummy"
"144720",0,1,0,1,"dummy"
"144721",0,1,0,1,"dummy"
"144722",0,0,2,2,"dummy"
"144723",2,6,4,12,"dummy"
"144724",0,0,1,1,"dummy"
"144725",0,0,1,1,"dummy"
"144728",2,0,0,2,"dummy"
"144729",3,5,0,8,"dummy"
"144730",0,10,0,10,"dummy"
"144731",0,1,0,1,"dummy"
"144735",0,0,1,1,"dummy"
"144736",2,3,0,5,"dummy"
"144737",0,1,0,1,"dummy"
"144739",2,5,1,8,"dummy"
"144740",0,2,0,2,"dummy"
"144741",0,0,1,1,"dummy"
"144742",2,0,1,3,"dummy"
"144748",0,0,2,2,"dummy"
"144749",1,1,0,2,"dummy"
"144750",0,0,1,1,"dummy"
"144751",0,0,2,2,"dummy"
"144753",2,3,0,5,"dummy"
"144754",0,1,0,1,"dummy"
"144755",2,4,0,6,"dummy"
"144756",1,0,0,1,"dummy"
"144757",4,2,0,6,"dummy"
"144758",2,5,0,7,"dummy"
"144759",0,2,0,2,"dummy"
"144762",11,6,7,24,"dummy"
"144763",0,8,0,8,"dummy"
"144764",0,0,1,1,"dummy"
"144765",0,3,0,3,"dummy"
"144766",0,0,3,3,"dummy"
"144767",2,2,5,9,"dummy"
"144768",0,0,1,1,"dummy"
"144769",0,0,4,4,"dummy"
"144770",0,2,1,3,"dummy"
"144775",0,0,0,0,"dummy"
"144777",9,5,2,16,"dummy"
"144779",0,4,0,4,"dummy"
"144780",0,3,0,3,"dummy"
"144781",3,3,2,8,"dummy"
"144782",6,7,0,13,"dummy"
"144785",0,0,0,0,"dummy"
"144787",2,11,1,14,"dummy"
"144788",0,0,1,1,"dummy"
"144789",0,0,1,1,"dummy"
"144790",0,0,3,3,"dummy"
"144794",9,1,8,18,"dummy"
"144809",0,2,0,2,"dummy"
"144810",9,8,0,17,"dummy"
"144811",0,3,0,3,"dummy"
"144812",0,0,1,1,"dummy"
"144813",0,0,2,2,"dummy"
"144814",0,2,1,3,"dummy"
"144815",0,0,1,1,"dummy"
"144816",0,3,0,3,"dummy"
"144817",0,0,1,1,"dummy"
"144818",1,10,2,13,"dummy"
"144819",0,1,1,2,"dummy"
"144820",0,0,0,0,"dummy"
"144821",0,0,1,1,"dummy"
"144822",9,7,4,20,"dummy"
"144823",6,5,9,20,"dummy"
"144824",13,12,2,27,"dummy"
"144825",2,3,5,10,"dummy"
"144826",5,3,0,8,"dummy"
"144827",5,11,0,16,"dummy"
"144828",11,9,0,20,"dummy"
"144829",1,0,0,1,"dummy"
"144830",2,0,0,2,"dummy"
"144831",0,0,1,1,"dummy"
"144832",0,3,0,3,"dummy"
"144870",0,0,1,1,"dummy"
"144939",0,3,0,3,"dummy"
"144940",0,0,1,1,"dummy"
"144941",0,10,0,10,"dummy"
"144942",2,10,0,12,"dummy"
"144945",0,1,0,1,"dummy"
"144946",0,1,0,1,"dummy"
"144947",1,0,0,1,"dummy"
"144985",0,3,0,3,"dummy"
"144986",3,0,1,4,"dummy"
"144987",0,3,0,3,"dummy"
"144988",7,5,0,12,"dummy"
"144991",1,0,0,1,"dummy"
"144992",0,3,0,3,"dummy"
"144993",0,0,1,1,"dummy"
"145003",0,3,2,5,"dummy"
"145004",0,1,0,1,"dummy"
"145005",1,2,0,3,"dummy"
"145008",0,0,0,0,"dummy"
"145011",1,4,0,5,"dummy"
"145012",0,4,0,4,"dummy"
"145013",0,1,0,1,"dummy"
"145014",0,0,1,1,"dummy"
"145015",15,34,1,50,"dummy"
"145016",13,23,10,46,"dummy"
"145017",1,5,0,6,"dummy"
"145018",5,7,4,16,"dummy"
"145019",7,8,0,15,"dummy"
"145020",0,5,0,5,"dummy"
"145021",25,4,7,36,"dummy"
"145026",2,2,0,4,"dummy"
"145035",0,5,2,7,"dummy"
"145040",6,0,0,6,"dummy"
"144792",0,1,0,1,"dummy"
"144798",1,1,0,2,"dummy"
"144834",0,1,0,1,"dummy"
"144835",0,1,2,3,"dummy"
"144854",0,0,0,0,"dummy"
"144855",0,0,1,1,"dummy"
"144856",7,4,2,13,"dummy"
"144857",0,1,0,1,"dummy"
"144858",0,1,0,1,"dummy"
"144859",1,0,0,1,"dummy"
"144872",1,0,0,1,"dummy"
"144873",0,0,1,1,"dummy"
"144874",0,2,0,2,"dummy"
"144937",0,1,0,1,"dummy"
"144949",1,0,0,1,"dummy"
"144950",0,0,1,1,"dummy"
"144951",1,0,0,1,"dummy"
"144952",0,2,0,2,"dummy"
"144953",0,0,2,2,"dummy"
"144954",0,0,2,2,"dummy"
"144955",1,1,0,2,"dummy"
"144956",0,1,2,3,"dummy"
"144957",0,1,0,1,"dummy"
"144958",0,2,0,2,"dummy"
"144959",0,0,1,1,"dummy"
"144977",0,0,0,0,"dummy"
"144978",0,1,0,1,"dummy"
"144979",0,1,0,1,"dummy"
"144980",0,0,1,1,"dummy"
"144981",0,0,3,3,"dummy"
"144982",0,0,1,1,"dummy"
"144983",0,0,1,1,"dummy"
"145043",0,0,1,1,"dummy"
"145044",0,0,1,1,"dummy"
"145045",0,3,0,3,"dummy"
"145046",0,1,3,4,"dummy"
"145047",8,8,0,16,"dummy"
"145048",5,0,1,6,"dummy"
"145049",1,0,0,1,"dummy"
"145052",9,2,1,12,"dummy"
"145057",2,0,3,5,"dummy"
"145058",1,0,0,1,"dummy"
"145059",0,1,0,1,"dummy"
"145060",0,1,1,2,"dummy"
"145066",1,1,3,5,"dummy"
"145067",0,0,1,1,"dummy"
"145068",0,4,0,4,"dummy"
"145069",0,0,1,1,"dummy"
"145070",3,1,1,5,"dummy"
"145071",0,0,1,1,"dummy"
"145072",0,0,1,1,"dummy"
"145073",0,1,0,1,"dummy"
"145074",0,1,0,1,"dummy"
"145075",1,1,0,2,"dummy"
"145076",4,4,1,9,"dummy"
"145077",4,1,0,5,"dummy"
"145078",1,0,1,2,"dummy"
"145079",0,0,1,1,"dummy"
"145080",0,0,1,1,"dummy"
"145081",0,0,1,1,"dummy"
"145082",1,1,3,5,"dummy"
"145083",0,0,1,1,"dummy"
"145084",0,2,1,3,"dummy"
"145085",0,1,0,1,"dummy"
"145086",1,1,0,2,"dummy"
"145087",4,1,0,5,"dummy"
"145041",2,5,2,9,"dummy"
"145064",1,0,1,2,"dummy"
"145120",4,2,0,6,"dummy"
"145121",5,6,0,11,"dummy"
"145122",0,0,0,0,"dummy"
"145123",5,2,0,7,"dummy"
"145124",0,1,0,1,"dummy"
"145127",0,11,0,11,"dummy"
"145134",0,1,0,1,"dummy"
"145135",1,0,0,1,"dummy"
"145136",0,2,0,2,"dummy"
"145137",0,2,0,2,"dummy"
"145142",6,2,0,8,"dummy"
"145143",1,2,0,3,"dummy"
"145154",0,0,0,0,"dummy"
"145155",0,0,0,0,"dummy"
"145171",1,3,5,9,"dummy"
"145192",0,1,0,1,"dummy"
"145193",0,2,0,2,"dummy"
"145194",1,0,0,1,"dummy"
"145195",2,1,0,3,"dummy"
"145196",1,0,0,1,"dummy"
"145197",1,2,0,3,"dummy"
"145198",0,1,0,1,"dummy"
"145199",0,1,0,1,"dummy"
"145200",4,3,0,7,"dummy"
"145201",1,1,0,2,"dummy"
"145205",0,1,1,2,"dummy"
"145206",0,0,1,1,"dummy"
"145207",0,1,0,1,"dummy"
"145208",2,0,1,3,"dummy"
"145209",0,1,0,1,"dummy"
"145210",2,1,0,3,"dummy"
"145224",2,3,0,5,"dummy"
"145230",0,1,0,1,"dummy"
"145231",0,0,1,1,"dummy"
"145232",1,6,1,8,"dummy"
"145235",0,0,1,1,"dummy"
"145236",1,3,3,7,"dummy"
"145237",0,0,2,2,"dummy"
"145253",0,0,1,1,"dummy"
"145272",0,0,1,1,"dummy"
"145273",7,3,1,11,"dummy"
"145278",0,0,1,1,"dummy"
"145279",0,1,0,1,"dummy"
"145284",1,3,0,4,"dummy"
"145285",1,0,0,1,"dummy"
"145286",0,8,1,9,"dummy"
"145292",0,5,0,5,"dummy"
"145300",0,1,0,1,"dummy"
"145301",1,1,0,2,"dummy"
"145302",0,1,0,1,"dummy"
"145303",1,0,2,3,"dummy"
"145304",0,1,0,1,"dummy"
"145305",0,0,0,0,"dummy"
"145318",0,2,0,2,"dummy"
"145323",0,0,1,1,"dummy"
"145324",0,1,0,1,"dummy"
"145330",10,7,1,18,"dummy"
"145331",0,0,1,1,"dummy"
"145332",0,0,0,0,"dummy"
"145333",0,0,0,0,"dummy"
"145351",0,1,0,1,"dummy"
"145354",0,4,2,6,"dummy"
"145355",1,0,1,2,"dummy"
"145378",0,3,0,3,"dummy"
"145379",0,0,0,0,"dummy"
"145380",0,0,0,0,"dummy"
"145088",1,1,0,2,"dummy"
"145089",1,1,0,2,"dummy"
"145090",0,0,1,1,"dummy"
"145091",1,1,1,3,"dummy"
"145092",0,0,1,1,"dummy"
"145093",0,1,1,2,"dummy"
"145094",0,0,1,1,"dummy"
"145095",1,1,1,3,"dummy"
"145096",0,0,1,1,"dummy"
"145097",0,0,2,2,"dummy"
"145098",0,0,1,1,"dummy"
"145099",0,0,1,1,"dummy"
"145100",0,0,1,1,"dummy"
"145101",7,2,2,11,"dummy"
"145102",0,0,1,1,"dummy"
"145103",0,0,3,3,"dummy"
"145104",0,0,2,2,"dummy"
"145105",0,0,1,1,"dummy"
"145106",2,1,0,3,"dummy"
"145107",0,0,1,1,"dummy"
"145108",0,0,1,1,"dummy"
"145109",0,0,1,1,"dummy"
"145110",0,0,1,1,"dummy"
"145111",0,1,1,2,"dummy"
"145112",0,0,1,1,"dummy"
"145113",0,0,1,1,"dummy"
"145129",0,1,0,1,"dummy"
"145130",0,0,1,1,"dummy"
"145131",0,4,0,4,"dummy"
"145132",2,2,0,4,"dummy"
"145145",0,14,0,14,"dummy"
"145146",11,0,1,12,"dummy"
"145147",0,5,0,5,"dummy"
"145148",0,9,0,9,"dummy"
"145149",2,0,0,2,"dummy"
"145150",1,0,0,1,"dummy"
"145151",0,0,1,1,"dummy"
"145152",0,0,1,1,"dummy"
"145157",2,0,3,5,"dummy"
"145160",0,2,0,2,"dummy"
"145161",5,1,0,6,"dummy"
"145162",0,1,0,1,"dummy"
"145163",0,0,0,0,"dummy"
"145164",0,3,0,3,"dummy"
"145165",1,5,1,7,"dummy"
"145166",0,0,4,4,"dummy"
"145169",7,18,2,27,"dummy"
"145186",0,0,1,1,"dummy"
"145187",0,0,1,1,"dummy"
"145188",0,0,1,1,"dummy"
"145189",0,4,4,8,"dummy"
"145190",1,2,2,5,"dummy"
"145203",0,0,0,0,"dummy"
"145212",1,6,0,7,"dummy"
"145213",0,19,1,20,"dummy"
"145214",13,7,2,22,"dummy"
"145215",3,5,1,9,"dummy"
"145216",0,5,1,6,"dummy"
"145217",3,3,0,6,"dummy"
"145218",2,5,1,8,"dummy"
"145219",0,0,3,3,"dummy"
"145220",0,0,0,0,"dummy"
"145221",2,0,0,2,"dummy"
"145222",0,1,0,1,"dummy"
"145226",0,2,3,5,"dummy"
"145227",0,0,3,3,"dummy"
"145228",3,3,0,6,"dummy"
"145239",0,0,1,1,"dummy"
"145240",0,1,0,1,"dummy"
"145241",3,1,0,4,"dummy"
"145242",0,0,1,1,"dummy"
"145243",0,0,1,1,"dummy"
"145244",0,0,1,1,"dummy"
"145247",1,5,0,6,"dummy"
"145248",5,5,0,10,"dummy"
"145249",1,0,0,1,"dummy"
"145250",0,0,0,0,"dummy"
"145251",0,1,0,1,"dummy"
"145255",0,0,0,0,"dummy"
"145256",0,0,0,0,"dummy"
"145259",0,2,0,2,"dummy"
"145260",0,0,1,1,"dummy"
"145261",0,0,1,1,"dummy"
"145262",0,1,0,1,"dummy"
"145263",0,0,1,1,"dummy"
"145264",0,0,1,1,"dummy"
"145267",4,2,2,8,"dummy"
"145268",2,3,1,6,"dummy"
"145269",2,1,0,3,"dummy"
"145270",1,0,1,2,"dummy"
"145281",0,0,1,1,"dummy"
"145282",0,0,1,1,"dummy"
"145288",0,2,0,2,"dummy"
"145289",0,2,2,4,"dummy"
"145290",4,0,0,4,"dummy"
"145294",3,1,0,4,"dummy"
"145295",3,2,0,5,"dummy"
"145296",0,4,0,4,"dummy"
"145297",0,0,1,1,"dummy"
"145298",0,1,1,2,"dummy"
"145313",0,1,0,1,"dummy"
"145314",0,0,1,1,"dummy"
"145315",1,0,0,1,"dummy"
"145316",0,6,2,8,"dummy"
"145320",2,0,0,2,"dummy"
"145321",0,1,0,1,"dummy"
"145328",0,2,1,3,"dummy"
"145335",2,4,0,6,"dummy"
"145336",0,2,0,2,"dummy"
"145337",0,2,0,2,"dummy"
"145338",10,2,0,12,"dummy"
"145339",0,2,0,2,"dummy"
"145389",1,2,0,3,"dummy"
"145390",1,2,0,3,"dummy"
"145391",0,0,1,1,"dummy"
"145381",3,0,0,3,"dummy"
"145382",0,0,2,2,"dummy"
"145383",0,0,1,1,"dummy"
"145384",0,2,1,3,"dummy"
"145385",2,1,1,4,"dummy"
"145397",0,0,2,2,"dummy"
"145403",2,2,0,4,"dummy"
"145406",0,8,3,11,"dummy"
"145407",2,3,3,8,"dummy"
"145408",0,0,2,2,"dummy"
"145410",0,4,2,6,"dummy"
"145411",1,0,1,2,"dummy"
"145422",0,1,0,1,"dummy"
"145427",0,0,1,1,"dummy"
"145429",3,34,1,38,"dummy"
"145430",0,7,1,8,"dummy"
"145431",0,1,0,1,"dummy"
"145432",1,0,0,1,"dummy"
"145433",7,0,1,8,"dummy"
"145434",31,5,1,37,"dummy"
"145435",0,1,0,1,"dummy"
"145436",2,2,1,5,"dummy"
"145438",0,6,0,6,"dummy"
"145441",0,15,0,15,"dummy"
"145444",0,0,1,1,"dummy"
"145446",0,1,1,2,"dummy"
"145447",0,0,1,1,"dummy"
"145448",0,0,0,0,"dummy"
"145453",2,16,0,18,"dummy"
"145454",0,1,0,1,"dummy"
"145455",4,0,1,5,"dummy"
"145464",0,0,1,1,"dummy"
"145466",0,1,0,1,"dummy"
"145470",0,0,1,1,"dummy"
"145471",0,0,1,1,"dummy"
"145472",0,0,2,2,"dummy"
"145473",26,3,7,36,"dummy"
"145482",0,0,1,1,"dummy"
"145483",0,1,0,1,"dummy"
"145484",2,9,1,12,"dummy"
"145485",0,8,0,8,"dummy"
"145486",0,0,2,2,"dummy"
"145487",0,1,0,1,"dummy"
"145488",1,0,0,1,"dummy"
"145489",2,3,0,5,"dummy"
"145490",0,1,0,1,"dummy"
"145491",0,6,0,6,"dummy"
"145492",0,0,1,1,"dummy"
"145493",0,0,3,3,"dummy"
"145497",0,0,0,0,"dummy"
"145498",0,0,0,0,"dummy"
"145499",0,0,2,2,"dummy"
"145500",0,0,0,0,"dummy"
"145501",0,0,1,1,"dummy"
"145502",0,0,0,0,"dummy"
"145503",0,0,1,1,"dummy"
"145505",0,11,2,13,"dummy"
"145506",0,0,1,1,"dummy"
"145507",0,0,0,0,"dummy"
"145508",2,1,2,5,"dummy"
"145510",0,0,1,1,"dummy"
"145511",0,1,0,1,"dummy"
"145512",0,1,0,1,"dummy"
"145513",0,0,5,5,"dummy"
"145514",0,1,0,1,"dummy"
"145515",0,2,0,2,"dummy"
"145516",0,1,0,1,"dummy"
"145517",0,0,1,1,"dummy"
"145518",0,3,0,3,"dummy"
"145519",2,2,2,6,"dummy"
"145521",0,11,0,11,"dummy"
"145522",0,1,0,1,"dummy"
"145523",0,1,0,1,"dummy"
"145524",0,0,1,1,"dummy"
"145525",0,1,0,1,"dummy"
"145526",1,0,0,1,"dummy"
"145527",0,0,1,1,"dummy"
"145528",0,0,0,0,"dummy"
"145529",0,0,1,1,"dummy"
"145533",0,0,1,1,"dummy"
"145534",0,0,1,1,"dummy"
"145535",0,1,0,1,"dummy"
"145536",1,1,1,3,"dummy"
"145539",5,0,1,6,"dummy"
"145540",0,2,0,2,"dummy"
"145541",1,0,0,1,"dummy"
"145542",0,1,0,1,"dummy"
"145543",2,1,0,3,"dummy"
"145544",3,3,2,8,"dummy"
"145545",2,1,0,3,"dummy"
"145546",0,2,0,2,"dummy"
"145547",0,1,1,2,"dummy"
"145548",1,1,0,2,"dummy"
"145549",1,7,1,9,"dummy"
"145551",0,0,0,0,"dummy"
"145552",1,4,0,5,"dummy"
"145553",1,0,1,2,"dummy"
"145554",1,2,2,5,"dummy"
"145555",1,0,1,2,"dummy"
"145556",0,2,1,3,"dummy"
"145557",2,0,2,4,"dummy"
"145559",1,0,0,1,"dummy"
"145560",0,0,1,1,"dummy"
"145563",22,8,3,33,"dummy"
"145564",8,22,1,31,"dummy"
"145565",0,0,1,1,"dummy"
"145567",10,0,0,10,"dummy"
"145569",0,0,3,3,"dummy"
"145570",0,1,0,1,"dummy"
"145572",3,9,2,14,"dummy"
"145574",0,1,0,1,"dummy"
"145575",0,3,0,3,"dummy"
"145623",3,1,1,5,"dummy"
"145624",0,0,1,1,"dummy"
"145625",1,1,0,2,"dummy"
"145626",1,3,3,7,"dummy"
"145627",3,1,0,4,"dummy"
"145628",0,0,0,0,"dummy"
"145629",0,1,0,1,"dummy"
"145630",0,0,3,3,"dummy"
"145631",1,0,0,1,"dummy"
"145632",0,0,1,1,"dummy"
"145633",0,1,0,1,"dummy"
"145634",0,0,1,1,"dummy"
"145635",0,0,0,0,"dummy"
"145636",1,0,2,3,"dummy"
"145637",0,1,1,2,"dummy"
"145638",8,6,2,16,"dummy"
"145639",0,0,0,0,"dummy"
"145640",0,0,0,0,"dummy"
"145641",0,0,4,4,"dummy"
"145642",0,0,0,0,"dummy"
"145643",0,11,0,11,"dummy"
"145644",0,0,0,0,"dummy"
"145645",0,0,1,1,"dummy"
"145648",0,0,1,1,"dummy"
"145649",1,0,4,5,"dummy"
"145651",0,3,0,3,"dummy"
"145652",5,4,3,12,"dummy"
"145653",1,0,0,1,"dummy"
"145654",1,0,0,1,"dummy"
"145682",0,1,0,1,"dummy"
"145685",0,4,0,4,"dummy"
"145686",3,0,0,3,"dummy"
"145687",0,0,0,0,"dummy"
"145688",0,1,0,1,"dummy"
"145689",0,1,0,1,"dummy"
"145690",0,0,1,1,"dummy"
"145691",0,0,1,1,"dummy"
"145692",6,19,2,27,"dummy"
"145693",1,7,1,9,"dummy"
"145694",9,9,7,25,"dummy"
"145695",3,3,3,9,"dummy"
"145696",0,1,0,1,"dummy"
"145697",6,19,0,25,"dummy"
"145698",0,0,1,1,"dummy"
"145699",0,0,1,1,"dummy"
"145700",2,2,5,9,"dummy"
"145701",18,4,1,23,"dummy"
"145702",1,2,0,3,"dummy"
"145703",0,0,0,0,"dummy"
"145704",0,0,0,0,"dummy"
"145705",0,0,1,1,"dummy"
"145728",1,0,0,1,"dummy"
"145729",1,0,0,1,"dummy"
"145739",0,0,0,0,"dummy"
"145740",0,0,0,0,"dummy"
"145741",0,0,0,0,"dummy"
"145742",0,0,0,0,"dummy"
"145743",0,0,0,0,"dummy"
"145744",0,0,0,0,"dummy"
"145745",0,0,0,0,"dummy"
"145746",0,0,1,1,"dummy"
"145747",0,0,0,0,"dummy"
"145748",0,0,0,0,"dummy"
"145749",0,0,0,0,"dummy"
"145750",0,0,0,0,"dummy"
"145751",0,0,0,0,"dummy"
"145752",0,0,0,0,"dummy"
"145753",0,0,0,0,"dummy"
"145754",0,0,0,0,"dummy"
"145765",0,3,0,3,"dummy"
"145766",3,0,0,3,"dummy"
"145775",0,5,0,5,"dummy"
"145776",2,5,1,8,"dummy"
"145777",0,2,0,2,"dummy"
"145778",0,2,2,4,"dummy"
"145779",0,1,0,1,"dummy"
"145780",5,0,1,6,"dummy"
"145781",0,0,1,1,"dummy"
"145785",1,1,0,2,"dummy"
"145786",1,0,0,1,"dummy"
"145787",2,0,2,4,"dummy"
"145791",1,4,0,5,"dummy"
"145796",0,0,2,2,"dummy"
"145816",0,0,1,1,"dummy"
"145817",0,1,0,1,"dummy"
"145818",0,0,1,1,"dummy"
"145821",0,4,0,4,"dummy"
"145824",0,0,1,1,"dummy"
"145825",0,1,0,1,"dummy"
"145845",0,9,0,9,"dummy"
"145846",4,3,1,8,"dummy"
"145847",1,1,0,2,"dummy"
"145848",4,1,0,5,"dummy"
"145849",3,20,1,24,"dummy"
"145850",0,0,2,2,"dummy"
"145851",15,0,2,17,"dummy"
"145852",2,0,0,2,"dummy"
"145853",1,0,0,1,"dummy"
"145854",0,1,0,1,"dummy"
"145855",3,0,0,3,"dummy"
"145856",0,0,0,0,"dummy"
"145857",0,0,0,0,"dummy"
"145888",1,0,0,1,"dummy"
"145889",0,0,1,1,"dummy"
"145890",0,0,1,1,"dummy"
"145891",0,0,0,0,"dummy"
"145922",3,11,1,15,"dummy"
"145726",1,0,3,4,"dummy"
"145759",0,0,0,0,"dummy"
"145760",0,0,0,0,"dummy"
"145761",0,0,0,0,"dummy"
"145762",0,0,1,1,"dummy"
"145763",0,0,0,0,"dummy"
"145770",1,0,1,2,"dummy"
"145771",4,0,0,4,"dummy"
"145783",1,0,0,1,"dummy"
"145789",0,0,1,1,"dummy"
"145793",0,0,2,2,"dummy"
"145794",0,2,1,3,"dummy"
"145798",0,0,2,2,"dummy"
"145799",1,3,1,5,"dummy"
"145802",0,1,0,1,"dummy"
"145803",0,0,1,1,"dummy"
"145804",0,0,1,1,"dummy"
"145807",0,0,0,0,"dummy"
"145810",0,0,1,1,"dummy"
"145811",0,1,2,3,"dummy"
"145812",7,10,16,33,"dummy"
"145831",0,0,1,1,"dummy"
"145834",0,1,2,3,"dummy"
"145835",1,1,0,2,"dummy"
"145859",0,0,1,1,"dummy"
"145886",0,3,0,3,"dummy"
"145893",0,15,1,16,"dummy"
"145894",1,1,1,3,"dummy"
"145895",0,0,2,2,"dummy"
"145896",0,1,0,1,"dummy"
"145903",2,0,0,2,"dummy"
"145904",0,0,1,1,"dummy"
"145905",0,0,1,1,"dummy"
"145906",1,2,0,3,"dummy"
"145907",1,1,1,3,"dummy"
"145908",0,0,1,1,"dummy"
"145909",0,0,1,1,"dummy"
"145910",0,1,0,1,"dummy"
"145911",1,1,0,2,"dummy"
"145912",5,3,0,8,"dummy"
"145913",1,1,0,2,"dummy"
"145914",0,0,0,0,"dummy"
"145915",2,2,0,4,"dummy"
"145916",1,0,0,1,"dummy"
"145917",0,1,0,1,"dummy"
"145918",4,3,0,7,"dummy"
"145919",1,0,0,1,"dummy"
"145920",0,2,1,3,"dummy"
"145928",0,0,1,1,"dummy"
"145931",0,1,0,1,"dummy"
"145934",1,3,2,6,"dummy"
"145935",2,2,0,4,"dummy"
"145936",0,1,0,1,"dummy"
"145937",8,10,2,20,"dummy"
"145967",0,1,0,1,"dummy"
"145968",0,2,0,2,"dummy"
"145969",1,4,0,5,"dummy"
"145970",3,1,1,5,"dummy"
"145971",0,4,0,4,"dummy"
"145972",4,0,0,4,"dummy"
"145973",0,1,0,1,"dummy"
"145974",0,0,0,0,"dummy"
"145945",0,0,0,0,"dummy"
"145952",0,2,0,2,"dummy"
"145953",0,0,0,0,"dummy"
"145954",0,0,0,0,"dummy"
"145955",0,2,0,2,"dummy"
"145956",2,8,0,10,"dummy"
"145957",0,0,1,1,"dummy"
"145958",0,1,1,2,"dummy"
"145959",0,1,2,3,"dummy"
"145960",3,4,0,7,"dummy"
"145961",0,0,1,1,"dummy"
"145962",0,0,1,1,"dummy"
"145963",0,0,1,1,"dummy"
"145964",0,0,1,1,"dummy"
"145965",0,0,1,1,"dummy"
"145980",0,11,0,11,"dummy"
"145981",0,1,0,1,"dummy"
"145982",0,2,0,2,"dummy"
"145983",2,0,0,2,"dummy"
"145984",0,0,2,2,"dummy"
"145985",2,0,1,3,"dummy"
"145986",0,0,1,1,"dummy"
"145987",0,0,1,1,"dummy"
"145988",7,5,0,12,"dummy"
"145989",0,2,1,3,"dummy"
"145990",0,0,1,1,"dummy"
"146002",0,0,1,1,"dummy"
"146003",2,4,0,6,"dummy"
"146004",0,1,0,1,"dummy"
"146005",0,1,0,1,"dummy"
"146006",1,0,0,1,"dummy"
"146007",1,2,0,3,"dummy"
"146008",1,0,0,1,"dummy"
"146009",0,0,1,1,"dummy"
"146012",0,0,1,1,"dummy"
"146035",0,0,3,3,"dummy"
"146039",0,0,1,1,"dummy"
"146047",3,6,1,10,"dummy"
"146048",4,4,3,11,"dummy"
"146049",1,0,0,1,"dummy"
"146050",0,0,1,1,"dummy"
"146060",1,1,0,2,"dummy"
"146065",0,1,0,1,"dummy"
"146066",0,1,0,1,"dummy"
"146067",0,6,0,6,"dummy"
"146068",1,2,0,3,"dummy"
"146073",0,4,0,4,"dummy"
"146074",1,1,1,3,"dummy"
"146075",0,0,0,0,"dummy"
"146076",0,0,0,0,"dummy"
"146077",0,7,0,7,"dummy"
"146078",5,0,0,5,"dummy"
"146079",0,3,0,3,"dummy"
"146080",5,5,0,10,"dummy"
"146081",2,2,1,5,"dummy"
"146082",4,0,1,5,"dummy"
"146083",1,1,0,2,"dummy"
"146084",0,1,0,1,"dummy"
"146085",0,1,0,1,"dummy"
"146086",4,3,0,7,"dummy"
"146087",0,1,0,1,"dummy"
"146088",0,0,1,1,"dummy"
"146089",0,0,2,2,"dummy"
"146090",0,0,1,1,"dummy"
"146091",0,0,1,1,"dummy"
"146092",2,2,1,5,"dummy"
"146116",28,7,4,39,"dummy"
"146117",7,4,2,13,"dummy"
"146124",0,0,1,1,"dummy"
"146125",0,0,1,1,"dummy"
"146126",0,0,1,1,"dummy"
"146127",0,0,1,1,"dummy"
"146130",0,0,1,1,"dummy"
"146131",0,0,0,0,"dummy"
"146134",1,0,0,1,"dummy"
"146135",0,1,0,1,"dummy"
"146136",4,3,0,7,"dummy"
"146137",2,3,0,5,"dummy"
"146014",0,1,1,2,"dummy"
"146019",0,0,1,1,"dummy"
"146020",0,0,1,1,"dummy"
"146021",0,1,0,1,"dummy"
"146022",0,0,1,1,"dummy"
"146023",0,5,0,5,"dummy"
"146024",0,0,1,1,"dummy"
"146025",0,1,2,3,"dummy"
"146026",0,0,1,1,"dummy"
"146027",0,1,0,1,"dummy"
"146028",5,6,1,12,"dummy"
"146029",0,0,1,1,"dummy"
"146030",0,0,1,1,"dummy"
"146031",7,1,0,8,"dummy"
"146037",0,1,0,1,"dummy"
"146052",0,0,1,1,"dummy"
"146053",0,1,0,1,"dummy"
"146058",1,1,0,2,"dummy"
"146062",1,0,0,1,"dummy"
"146063",1,2,2,5,"dummy"
"146094",19,1,2,22,"dummy"
"146095",4,0,0,4,"dummy"
"146096",0,0,1,1,"dummy"
"146097",0,1,0,1,"dummy"
"146098",0,0,1,1,"dummy"
"146106",0,2,4,6,"dummy"
"146107",2,0,4,6,"dummy"
"146108",0,2,4,6,"dummy"
"146109",0,2,0,2,"dummy"
"146110",0,1,0,1,"dummy"
"146111",0,1,0,1,"dummy"
"146112",4,0,1,5,"dummy"
"146113",0,0,1,1,"dummy"
"146114",0,0,0,0,"dummy"
"146119",8,1,1,10,"dummy"
"146120",0,0,1,1,"dummy"
"146121",0,1,0,1,"dummy"
"146122",0,0,1,1,"dummy"
"146148",0,1,2,3,"dummy"
"146149",0,0,0,0,"dummy"
"146150",0,1,0,1,"dummy"
"146151",1,1,0,2,"dummy"
"146152",2,1,0,3,"dummy"
"146169",1,3,3,7,"dummy"
"146178",0,4,0,4,"dummy"
"146179",0,1,0,1,"dummy"
"146180",0,1,0,1,"dummy"
"146181",0,8,0,8,"dummy"
"146182",0,1,0,1,"dummy"
"146183",2,1,1,4,"dummy"
"146184",12,8,2,22,"dummy"
"146185",0,1,0,1,"dummy"
"146186",9,12,2,23,"dummy"
"146187",0,0,2,2,"dummy"
"146188",2,1,0,3,"dummy"
"146189",1,3,0,4,"dummy"
"146209",0,0,1,1,"dummy"
"146210",0,0,1,1,"dummy"
"146319",1,1,0,2,"dummy"
"146320",0,1,0,1,"dummy"
"146359",1,4,3,8,"dummy"
"146367",0,0,1,1,"dummy"
"146368",0,0,1,1,"dummy"
"146369",0,6,1,7,"dummy"
"146138",1,0,0,1,"dummy"
"146141",2,0,0,2,"dummy"
"146144",0,6,0,6,"dummy"
"146145",2,3,0,5,"dummy"
"146171",1,4,1,6,"dummy"
"146172",2,0,0,2,"dummy"
"146173",0,1,1,2,"dummy"
"146174",0,0,0,0,"dummy"
"146175",0,1,0,1,"dummy"
"146176",1,0,0,1,"dummy"
"146191",0,3,0,3,"dummy"
"146192",0,1,0,1,"dummy"
"146193",0,2,0,2,"dummy"
"146194",0,1,0,1,"dummy"
"146195",1,1,0,2,"dummy"
"146196",4,13,5,22,"dummy"
"146197",0,1,0,1,"dummy"
"146198",0,0,1,1,"dummy"
"146199",3,2,6,11,"dummy"
"146200",2,3,0,5,"dummy"
"146207",11,3,0,14,"dummy"
"146214",5,7,0,12,"dummy"
"146322",0,0,1,1,"dummy"
"146337",0,3,0,3,"dummy"
"146338",0,0,1,1,"dummy"
"146339",0,0,1,1,"dummy"
"146340",1,0,2,3,"dummy"
"146341",0,0,1,1,"dummy"
"146352",1,1,0,2,"dummy"
"146353",2,15,4,21,"dummy"
"146354",0,1,0,1,"dummy"
"146355",1,1,0,2,"dummy"
"146409",0,6,3,9,"dummy"
"146410",0,0,1,1,"dummy"
"146411",0,0,1,1,"dummy"
"146412",0,0,1,1,"dummy"
"146417",0,1,0,1,"dummy"
"146418",7,23,5,35,"dummy"
"146419",1,2,0,3,"dummy"
"146420",0,0,1,1,"dummy"
"146421",2,4,3,9,"dummy"
"146422",0,4,0,4,"dummy"
"146423",0,0,1,1,"dummy"
"146424",0,0,1,1,"dummy"
"146425",0,0,1,1,"dummy"
"146433",16,1,6,23,"dummy"
"146434",0,2,0,2,"dummy"
"146435",1,0,0,1,"dummy"
"146436",3,5,2,10,"dummy"
"146437",2,0,0,2,"dummy"
"146453",0,2,1,3,"dummy"
"146458",0,1,0,1,"dummy"
"146459",0,0,1,1,"dummy"
"146462",0,0,0,0,"dummy"
"146463",0,1,0,1,"dummy"
"146406",0,0,0,0,"dummy"
"146407",0,6,0,6,"dummy"
"146414",1,2,0,3,"dummy"
"146415",0,0,5,5,"dummy"
"146427",0,0,3,3,"dummy"
"146439",0,6,1,7,"dummy"
"146440",1,5,0,6,"dummy"
"146441",0,1,0,1,"dummy"
"146442",0,1,0,1,"dummy"
"146468",0,2,0,2,"dummy"
"146469",0,1,0,1,"dummy"
"146473",0,1,0,1,"dummy"
"146474",2,2,0,4,"dummy"
"146475",0,1,0,1,"dummy"
"146476",0,10,0,10,"dummy"
"146477",0,0,2,2,"dummy"
"146478",18,36,1,55,"dummy"
"146479",0,8,0,8,"dummy"
"146480",4,19,0,23,"dummy"
"146481",0,10,0,10,"dummy"
"146482",0,13,0,13,"dummy"
"146490",1,16,0,17,"dummy"
"146491",0,1,1,2,"dummy"
"146492",2,10,0,12,"dummy"
"146497",0,1,0,1,"dummy"
"146498",0,0,0,0,"dummy"
"146503",0,1,0,1,"dummy"
"146504",0,1,1,2,"dummy"
"146505",0,0,1,1,"dummy"
"146506",0,7,0,7,"dummy"
"146507",2,5,1,8,"dummy"
"146508",2,0,0,2,"dummy"
"146509",1,2,0,3,"dummy"
"146510",0,1,0,1,"dummy"
"146535",11,5,0,16,"dummy"
"146543",0,0,2,2,"dummy"
"146544",5,1,1,7,"dummy"
"146549",0,1,0,1,"dummy"
"146550",2,1,0,3,"dummy"
"146565",1,12,0,13,"dummy"
"146566",1,0,0,1,"dummy"
"146576",1,5,0,6,"dummy"
"146577",0,3,1,4,"dummy"
"146588",10,0,0,10,"dummy"
"146589",0,5,0,5,"dummy"
"146597",5,25,0,30,"dummy"
"146602",6,2,0,8,"dummy"
"146464",1,0,0,1,"dummy"
"146471",2,1,1,4,"dummy"
"146500",0,1,0,1,"dummy"
"146501",0,0,1,1,"dummy"
"146512",2,4,0,6,"dummy"
"146513",0,2,0,2,"dummy"
"146514",0,2,0,2,"dummy"
"146515",10,2,0,12,"dummy"
"146516",0,2,0,2,"dummy"
"146519",0,1,0,1,"dummy"
"146520",0,1,0,1,"dummy"
"146521",8,10,3,21,"dummy"
"146522",5,8,0,13,"dummy"
"146523",1,0,0,1,"dummy"
"146524",1,1,2,4,"dummy"
"146525",6,0,0,6,"dummy"
"146526",3,3,0,6,"dummy"
"146527",1,1,2,4,"dummy"
"146528",0,1,0,1,"dummy"
"146529",1,5,0,6,"dummy"
"146530",3,2,0,5,"dummy"
"146531",3,0,0,3,"dummy"
"146532",3,3,0,6,"dummy"
"146533",0,0,0,0,"dummy"
"146537",0,0,1,1,"dummy"
"146538",3,5,0,8,"dummy"
"146539",1,0,1,2,"dummy"
"146540",0,0,1,1,"dummy"
"146541",2,0,2,4,"dummy"
"146570",0,2,0,2,"dummy"
"146579",0,1,0,1,"dummy"
"146580",0,3,1,4,"dummy"
"146595",0,1,0,1,"dummy"
"146604",6,6,0,12,"dummy"
"146605",0,0,0,0,"dummy"
"146606",0,0,1,1,"dummy"
"146607",0,0,1,1,"dummy"
"146608",10,6,1,17,"dummy"
"146609",0,0,0,0,"dummy"
"146610",2,2,0,4,"dummy"
"146611",2,0,0,2,"dummy"
"146612",0,0,2,2,"dummy"
"146613",0,3,1,4,"dummy"
"146614",1,0,0,1,"dummy"
"146615",0,0,1,1,"dummy"
"146616",0,0,1,1,"dummy"
"146617",1,0,0,1,"dummy"
"146618",1,3,0,4,"dummy"
"146619",0,0,1,1,"dummy"
"146620",6,8,2,16,"dummy"
"146621",0,0,1,1,"dummy"
"146640",0,1,0,1,"dummy"
"146641",0,0,1,1,"dummy"
"146642",12,1,0,13,"dummy"
"146646",1,2,0,3,"dummy"
"146649",1,3,0,4,"dummy"
"146650",0,1,0,1,"dummy"
"146651",0,0,0,0,"dummy"
"146652",0,4,0,4,"dummy"
"146653",0,3,0,3,"dummy"
"146654",0,0,1,1,"dummy"
"146655",0,2,1,3,"dummy"
"146671",0,0,0,0,"dummy"
"146673",0,1,0,1,"dummy"
"146674",0,7,0,7,"dummy"
"146676",0,0,1,1,"dummy"
"146678",0,3,0,3,"dummy"
"146679",0,0,0,0,"dummy"
"146680",0,0,3,3,"dummy"
"146681",0,0,0,0,"dummy"
"146682",1,0,4,5,"dummy"
"146683",0,0,0,0,"dummy"
"146684",0,0,1,1,"dummy"
"146685",0,0,1,1,"dummy"
"146688",0,0,1,1,"dummy"
"146689",0,1,0,1,"dummy"
"146690",2,2,1,5,"dummy"
"146691",2,3,1,6,"dummy"
"146692",4,2,1,7,"dummy"
"146693",1,2,0,3,"dummy"
"146694",5,4,1,10,"dummy"
"146695",0,0,1,1,"dummy"
"146696",3,1,3,7,"dummy"
"146697",0,0,1,1,"dummy"
"146698",0,1,0,1,"dummy"
"146699",1,3,0,4,"dummy"
"146700",0,2,1,3,"dummy"
"146701",2,0,0,2,"dummy"
"146702",0,0,1,1,"dummy"
"146703",0,0,0,0,"dummy"
"146704",0,0,2,2,"dummy"
"146705",0,0,1,1,"dummy"
"146727",1,1,0,2,"dummy"
"146730",1,1,0,2,"dummy"
"146732",0,0,1,1,"dummy"
"146733",0,16,2,18,"dummy"
"146734",0,0,1,1,"dummy"
"146736",0,1,0,1,"dummy"
"146737",0,2,0,2,"dummy"
"146738",2,2,0,4,"dummy"
"146739",0,1,0,1,"dummy"
"146740",3,3,0,6,"dummy"
"146741",0,1,0,1,"dummy"
"146742",0,0,1,1,"dummy"
"146744",0,0,1,1,"dummy"
"146759",1,5,2,8,"dummy"
"146762",0,1,0,1,"dummy"
"146763",4,6,0,10,"dummy"
"146764",1,5,0,6,"dummy"
"146765",0,4,0,4,"dummy"
"146766",8,6,1,15,"dummy"
"146767",15,4,5,24,"dummy"
"146768",0,1,0,1,"dummy"
"146769",1,7,0,8,"dummy"
"146770",0,0,0,0,"dummy"
"146774",0,0,1,1,"dummy"
"146775",0,1,0,1,"dummy"
"146776",2,2,1,5,"dummy"
"146777",2,2,0,4,"dummy"
"146780",0,0,1,1,"dummy"
"146781",3,5,2,10,"dummy"
"146785",0,1,0,1,"dummy"
"146786",0,5,3,8,"dummy"
"146788",2,1,0,3,"dummy"
"146790",0,0,1,1,"dummy"
"146791",0,0,7,7,"dummy"
"146795",0,0,0,0,"dummy"
"146796",0,0,0,0,"dummy"
"146799",0,0,1,1,"dummy"
"146803",0,0,2,2,"dummy"
"146804",0,0,1,1,"dummy"
"146805",0,0,2,2,"dummy"
"146807",0,0,2,2,"dummy"
"146808",0,1,0,1,"dummy"
"146809",7,5,0,12,"dummy"
"146810",2,5,2,9,"dummy"
"146811",0,0,1,1,"dummy"
"146813",20,11,3,34,"dummy"
"146814",2,1,0,3,"dummy"
"146815",0,0,0,0,"dummy"
"146816",0,0,1,1,"dummy"
"146817",1,2,0,3,"dummy"
"146819",2,2,0,4,"dummy"
"146820",0,0,1,1,"dummy"
"146822",1,0,1,2,"dummy"
"146824",0,0,2,2,"dummy"
"146825",0,1,0,1,"dummy"
"146826",3,1,0,4,"dummy"
"146827",1,0,2,3,"dummy"
"146828",0,0,2,2,"dummy"
"146831",0,0,1,1,"dummy"
"146835",1,5,2,8,"dummy"
"146837",2,1,0,3,"dummy"
"146859",2,0,1,3,"dummy"
"146861",0,1,0,1,"dummy"
"146862",0,0,1,1,"dummy"
"146939",2,0,4,6,"dummy"
"146940",0,0,1,1,"dummy"
"146941",0,0,0,0,"dummy"
"146958",0,0,1,1,"dummy"
"146959",2,2,0,4,"dummy"
"146961",1,0,0,1,"dummy"
"146970",3,4,0,7,"dummy"
"146971",1,3,3,7,"dummy"
"146972",0,1,0,1,"dummy"
"146973",0,0,1,1,"dummy"
"146974",0,0,1,1,"dummy"
"146977",0,0,0,0,"dummy"
"146978",0,0,0,0,"dummy"
"146979",0,0,0,0,"dummy"
"146981",1,0,0,1,"dummy"
"146985",1,3,1,5,"dummy"
"146986",0,1,0,1,"dummy"
"147076",0,0,1,1,"dummy"
"147087",0,1,1,2,"dummy"
"147088",3,4,1,8,"dummy"
"147089",1,1,0,2,"dummy"
"147090",1,0,0,1,"dummy"
"147091",4,0,1,5,"dummy"
"147092",3,2,0,5,"dummy"
"147093",0,5,1,6,"dummy"
"147094",3,2,0,5,"dummy"
"147095",2,5,0,7,"dummy"
"147096",2,2,0,4,"dummy"
"147097",3,2,0,5,"dummy"
"147098",0,3,0,3,"dummy"
"147099",0,0,1,1,"dummy"
"147100",0,0,1,1,"dummy"
"147101",2,0,1,3,"dummy"
"147102",11,12,3,26,"dummy"
"147103",1,1,4,6,"dummy"
"147113",0,0,0,0,"dummy"
"147114",0,0,2,2,"dummy"
"147115",0,0,1,1,"dummy"
"147116",0,0,1,1,"dummy"
"147148",0,2,0,2,"dummy"
"147149",0,1,0,1,"dummy"
"147150",0,2,0,2,"dummy"
"147151",0,1,0,1,"dummy"
"147162",1,3,1,5,"dummy"
"147163",0,0,1,1,"dummy"
"147164",0,4,0,4,"dummy"
"147165",0,2,0,2,"dummy"
"147166",11,1,2,14,"dummy"
"147167",0,2,0,2,"dummy"
"147168",1,0,0,1,"dummy"
"147169",0,0,1,1,"dummy"
"147170",0,0,4,4,"dummy"
"147171",1,0,4,5,"dummy"
"147172",2,1,3,6,"dummy"
"147173",0,0,1,1,"dummy"
"147174",0,1,0,1,"dummy"
"147175",6,2,3,11,"dummy"
"147176",0,1,1,2,"dummy"
"147177",1,0,0,1,"dummy"
"147178",0,0,1,1,"dummy"
"147182",0,3,1,4,"dummy"
"147183",0,1,0,1,"dummy"
"147184",5,0,0,5,"dummy"
"147204",0,2,0,2,"dummy"
"147205",1,7,4,12,"dummy"
"147206",1,0,0,1,"dummy"
"147207",2,0,0,2,"dummy"
"147208",0,1,1,2,"dummy"
"147209",4,4,4,12,"dummy"
"147218",1,2,2,5,"dummy"
"147219",8,3,1,12,"dummy"
"147220",0,2,0,2,"dummy"
"147221",0,0,1,1,"dummy"
"147222",0,0,1,1,"dummy"
"147230",0,0,1,1,"dummy"
"147231",1,1,0,2,"dummy"
"147027",0,2,1,3,"dummy"
"147028",0,2,0,2,"dummy"
"147029",2,3,0,5,"dummy"
"147030",0,1,0,1,"dummy"
"147031",0,8,1,9,"dummy"
"147032",3,0,0,3,"dummy"
"147033",1,0,0,1,"dummy"
"147050",0,4,1,5,"dummy"
"147051",0,2,1,3,"dummy"
"147052",3,2,0,5,"dummy"
"147053",0,3,0,3,"dummy"
"147054",0,0,9,9,"dummy"
"147055",6,0,3,9,"dummy"
"147058",0,0,1,1,"dummy"
"147078",0,0,1,1,"dummy"
"147081",0,4,0,4,"dummy"
"147082",2,2,0,4,"dummy"
"147083",1,0,1,2,"dummy"
"147084",0,0,0,0,"dummy"
"147085",1,0,0,1,"dummy"
"147107",2,4,0,6,"dummy"
"147108",0,2,0,2,"dummy"
"147109",0,2,0,2,"dummy"
"147110",10,2,0,12,"dummy"
"147111",0,2,0,2,"dummy"
"147118",0,1,0,1,"dummy"
"147119",0,0,0,0,"dummy"
"147120",0,1,0,1,"dummy"
"147121",4,11,1,16,"dummy"
"147153",0,3,0,3,"dummy"
"147154",2,1,1,4,"dummy"
"147155",0,1,0,1,"dummy"
"147156",0,0,3,3,"dummy"
"147157",0,1,0,1,"dummy"
"147158",0,1,0,1,"dummy"
"147180",2,0,0,2,"dummy"
"147188",0,0,1,1,"dummy"
"147189",9,0,3,12,"dummy"
"147190",0,9,3,12,"dummy"
"147191",0,1,0,1,"dummy"
"147192",1,3,1,5,"dummy"
"147193",5,11,1,17,"dummy"
"147194",0,1,1,2,"dummy"
"147195",0,0,1,1,"dummy"
"147196",0,1,0,1,"dummy"
"147197",5,0,0,5,"dummy"
"147198",0,1,1,2,"dummy"
"147199",2,2,1,5,"dummy"
"147200",10,1,2,13,"dummy"
"147201",0,0,1,1,"dummy"
"147202",0,0,1,1,"dummy"
"147211",0,4,0,4,"dummy"
"147212",0,1,0,1,"dummy"
"147213",0,1,0,1,"dummy"
"147214",1,2,0,3,"dummy"
"147215",0,1,0,1,"dummy"
"147216",0,3,3,6,"dummy"
"147224",0,9,3,12,"dummy"
"147225",0,0,1,1,"dummy"
"147226",2,2,2,6,"dummy"
"147227",0,0,0,0,"dummy"
"147228",0,0,0,0,"dummy"
"147242",1,3,4,8,"dummy"
"147243",0,1,0,1,"dummy"
"147236",0,0,0,0,"dummy"
"147247",0,6,0,6,"dummy"
"147248",0,1,0,1,"dummy"
"147249",0,2,0,2,"dummy"
"147250",2,0,0,2,"dummy"
"147255",0,0,2,2,"dummy"
"147293",2,5,1,8,"dummy"
"147294",7,6,4,17,"dummy"
"147295",1,9,0,10,"dummy"
"147298",0,1,0,1,"dummy"
"147325",0,2,0,2,"dummy"
"147329",2,5,1,8,"dummy"
"147330",0,0,0,0,"dummy"
"147356",0,0,1,1,"dummy"
"147357",0,0,1,1,"dummy"
"147360",3,1,1,5,"dummy"
"147361",0,0,1,1,"dummy"
"147392",2,6,0,8,"dummy"
"147406",7,18,0,25,"dummy"
"147411",0,1,0,1,"dummy"
"147412",0,0,0,0,"dummy"
"147491",4,1,0,5,"dummy"
"147492",0,0,3,3,"dummy"
"147529",0,0,1,1,"dummy"
"147530",2,14,4,20,"dummy"
"147531",2,0,1,3,"dummy"
"147532",0,0,1,1,"dummy"
"147533",0,1,0,1,"dummy"
"147534",2,2,0,4,"dummy"
"147535",0,0,2,2,"dummy"
"147536",0,3,0,3,"dummy"
"147539",0,3,0,3,"dummy"
"147540",0,1,0,1,"dummy"
"147545",0,0,2,2,"dummy"
"147546",0,0,1,1,"dummy"
"147547",3,3,7,13,"dummy"
"147548",0,0,2,2,"dummy"
"147549",0,15,0,15,"dummy"
"147598",0,0,1,1,"dummy"
"147599",0,0,0,0,"dummy"
"147615",0,6,0,6,"dummy"
"147616",0,10,0,10,"dummy"
"147302",18,0,2,20,"dummy"
"147303",2,3,0,5,"dummy"
"147304",0,5,0,5,"dummy"
"147305",0,1,0,1,"dummy"
"147306",0,3,0,3,"dummy"
"147307",0,1,1,2,"dummy"
"147308",4,0,0,4,"dummy"
"147309",0,1,0,1,"dummy"
"147327",0,1,1,2,"dummy"
"147338",2,2,0,4,"dummy"
"147339",0,1,1,2,"dummy"
"147340",0,1,1,2,"dummy"
"147341",0,1,0,1,"dummy"
"147342",0,4,1,5,"dummy"
"147343",0,0,1,1,"dummy"
"147344",1,0,0,1,"dummy"
"147345",0,1,0,1,"dummy"
"147348",5,5,1,11,"dummy"
"147351",5,7,0,12,"dummy"
"147352",0,0,0,0,"dummy"
"147353",0,3,0,3,"dummy"
"147354",0,0,1,1,"dummy"
"147363",0,1,0,1,"dummy"
"147364",0,5,0,5,"dummy"
"147365",0,1,0,1,"dummy"
"147366",1,2,1,4,"dummy"
"147367",2,3,0,5,"dummy"
"147368",1,0,0,1,"dummy"
"147369",1,0,0,1,"dummy"
"147370",10,4,0,14,"dummy"
"147371",2,2,0,4,"dummy"
"147372",0,5,0,5,"dummy"
"147373",0,3,0,3,"dummy"
"147374",0,1,0,1,"dummy"
"147375",0,1,0,1,"dummy"
"147376",1,0,0,1,"dummy"
"147377",0,5,0,5,"dummy"
"147378",0,0,1,1,"dummy"
"147379",0,0,0,0,"dummy"
"147380",3,2,1,6,"dummy"
"147381",0,1,0,1,"dummy"
"147382",0,8,0,8,"dummy"
"147383",0,2,0,2,"dummy"
"147384",2,1,0,3,"dummy"
"147385",2,1,0,3,"dummy"
"147390",5,4,0,9,"dummy"
"147394",0,0,1,1,"dummy"
"147395",0,1,0,1,"dummy"
"147396",2,1,0,3,"dummy"
"147397",8,0,0,8,"dummy"
"147398",0,7,0,7,"dummy"
"147399",6,1,0,7,"dummy"
"147400",1,6,0,7,"dummy"
"147401",6,1,0,7,"dummy"
"147402",1,6,0,7,"dummy"
"147403",6,7,0,13,"dummy"
"147404",6,0,0,6,"dummy"
"147408",1,0,0,1,"dummy"
"147409",0,0,0,0,"dummy"
"147414",0,2,0,2,"dummy"
"147415",0,0,0,0,"dummy"
"147416",0,0,0,0,"dummy"
"147417",0,2,2,4,"dummy"
"147418",0,0,1,1,"dummy"
"147419",0,0,1,1,"dummy"
"147420",0,1,0,1,"dummy"
"147421",4,4,5,13,"dummy"
"147422",0,0,1,1,"dummy"
"147423",0,0,1,1,"dummy"
"147424",0,0,2,2,"dummy"
"147440",0,1,0,1,"dummy"
"147441",7,0,1,8,"dummy"
"147442",0,5,1,6,"dummy"
"147443",1,18,2,21,"dummy"
"147444",0,2,0,2,"dummy"
"147445",1,1,0,2,"dummy"
"147448",1,2,1,4,"dummy"
"147449",0,1,0,1,"dummy"
"147489",4,4,0,8,"dummy"
"147542",2,0,0,2,"dummy"
"147543",0,2,0,2,"dummy"
"147551",5,24,2,31,"dummy"
"147571",8,0,1,9,"dummy"
"147572",1,0,0,1,"dummy"
"147573",0,1,0,1,"dummy"
"147574",1,0,1,2,"dummy"
"147577",0,1,0,1,"dummy"
"147578",0,0,0,0,"dummy"
"147579",0,1,0,1,"dummy"
"147580",4,11,1,16,"dummy"
"147587",0,1,0,1,"dummy"
"147588",0,3,0,3,"dummy"
"147591",0,2,0,2,"dummy"
"147592",0,1,0,1,"dummy"
"147593",0,0,1,1,"dummy"
"147594",0,0,1,1,"dummy"
"147595",0,1,0,1,"dummy"
"147596",0,0,1,1,"dummy"
"147601",0,1,0,1,"dummy"
"147602",0,2,0,2,"dummy"
"147618",0,1,0,1,"dummy"
"147619",0,1,0,1,"dummy"
"147812",0,0,1,1,"dummy"
"147817",11,1,0,12,"dummy"
"147818",0,2,0,2,"dummy"
"147823",0,4,1,5,"dummy"
"147824",0,1,0,1,"dummy"
"147865",0,1,0,1,"dummy"
"147870",10,5,1,16,"dummy"
"147871",9,0,0,9,"dummy"
"147872",2,2,0,4,"dummy"
"147873",2,2,0,4,"dummy"
"147874",37,16,0,53,"dummy"
"147897",3,5,2,10,"dummy"
"147898",0,4,0,4,"dummy"
"147899",2,2,0,4,"dummy"
"147902",1,0,0,1,"dummy"
"147903",0,0,0,0,"dummy"
"147911",0,2,0,2,"dummy"
"147912",18,0,3,21,"dummy"
"147913",1,0,0,1,"dummy"
"147914",0,5,0,5,"dummy"
"147938",0,0,2,2,"dummy"
"147939",0,2,0,2,"dummy"
"147940",0,1,0,1,"dummy"
"147941",0,3,0,3,"dummy"
"147942",0,4,3,7,"dummy"
"147943",5,4,2,11,"dummy"
"147944",0,0,0,0,"dummy"
"147945",0,1,0,1,"dummy"
"147946",2,0,0,2,"dummy"
"147958",5,34,0,39,"dummy"
"147959",5,1,0,6,"dummy"
"147621",0,3,0,3,"dummy"
"147622",1,0,0,1,"dummy"
"147623",0,2,0,2,"dummy"
"147624",0,10,0,10,"dummy"
"147625",1,3,1,5,"dummy"
"147628",0,0,1,1,"dummy"
"147629",19,9,4,32,"dummy"
"147630",0,0,1,1,"dummy"
"147631",0,0,1,1,"dummy"
"147632",0,1,0,1,"dummy"
"147633",0,2,0,2,"dummy"
"147634",0,2,0,2,"dummy"
"147635",0,3,0,3,"dummy"
"147636",3,0,0,3,"dummy"
"147637",0,0,1,1,"dummy"
"147638",1,4,0,5,"dummy"
"147639",0,0,1,1,"dummy"
"147640",3,0,0,3,"dummy"
"147641",0,1,1,2,"dummy"
"147642",0,0,1,1,"dummy"
"147643",0,0,1,1,"dummy"
"147644",0,0,1,1,"dummy"
"147645",0,0,1,1,"dummy"
"147646",0,0,1,1,"dummy"
"147647",0,0,1,1,"dummy"
"147648",0,0,1,1,"dummy"
"147649",0,0,1,1,"dummy"
"147650",0,0,1,1,"dummy"
"147651",0,0,1,1,"dummy"
"147652",0,0,1,1,"dummy"
"147653",0,0,1,1,"dummy"
"147654",0,0,1,1,"dummy"
"147655",0,0,1,1,"dummy"
"147656",0,0,1,1,"dummy"
"147657",0,0,1,1,"dummy"
"147658",0,0,1,1,"dummy"
"147659",0,0,1,1,"dummy"
"147660",0,0,1,1,"dummy"
"147661",0,0,1,1,"dummy"
"147662",0,0,1,1,"dummy"
"147663",0,0,1,1,"dummy"
"147664",0,0,1,1,"dummy"
"147665",0,0,1,1,"dummy"
"147666",0,0,1,1,"dummy"
"147667",0,0,1,1,"dummy"
"147668",0,0,1,1,"dummy"
"147669",0,0,1,1,"dummy"
"147670",0,0,1,1,"dummy"
"147671",0,0,1,1,"dummy"
"147672",0,0,1,1,"dummy"
"147673",0,0,1,1,"dummy"
"147674",0,0,1,1,"dummy"
"147675",0,0,1,1,"dummy"
"147676",0,0,1,1,"dummy"
"147677",0,0,1,1,"dummy"
"147678",0,0,1,1,"dummy"
"147679",0,0,1,1,"dummy"
"147680",0,0,1,1,"dummy"
"147681",0,0,1,1,"dummy"
"147682",0,0,1,1,"dummy"
"147683",0,0,1,1,"dummy"
"147684",0,0,1,1,"dummy"
"147685",0,0,1,1,"dummy"
"147686",0,0,1,1,"dummy"
"147687",0,0,1,1,"dummy"
"147688",0,0,1,1,"dummy"
"147689",0,0,1,1,"dummy"
"147690",0,0,1,1,"dummy"
"147691",0,0,1,1,"dummy"
"147692",0,0,1,1,"dummy"
"147693",0,0,1,1,"dummy"
"147694",0,0,1,1,"dummy"
"147695",0,0,1,1,"dummy"
"147696",0,0,1,1,"dummy"
"147697",0,0,1,1,"dummy"
"147698",0,0,1,1,"dummy"
"147699",0,0,1,1,"dummy"
"147700",0,0,1,1,"dummy"
"147701",0,0,1,1,"dummy"
"147702",0,0,1,1,"dummy"
"147703",0,0,1,1,"dummy"
"147704",0,0,1,1,"dummy"
"147705",0,0,1,1,"dummy"
"147706",0,0,1,1,"dummy"
"147707",0,0,1,1,"dummy"
"147708",0,0,1,1,"dummy"
"147709",0,0,1,1,"dummy"
"147710",0,0,1,1,"dummy"
"147711",0,0,1,1,"dummy"
"147712",0,0,1,1,"dummy"
"147713",0,0,1,1,"dummy"
"147714",0,0,1,1,"dummy"
"147715",0,0,1,1,"dummy"
"147716",0,0,1,1,"dummy"
"147717",0,0,1,1,"dummy"
"147718",0,0,1,1,"dummy"
"147719",0,0,1,1,"dummy"
"147720",0,0,1,1,"dummy"
"147721",0,0,1,1,"dummy"
"147722",0,0,1,1,"dummy"
"147723",0,0,1,1,"dummy"
"147724",0,0,1,1,"dummy"
"147725",0,0,1,1,"dummy"
"147726",0,0,1,1,"dummy"
"147727",0,0,1,1,"dummy"
"147728",0,0,1,1,"dummy"
"147729",0,0,1,1,"dummy"
"147730",0,0,1,1,"dummy"
"147731",0,0,1,1,"dummy"
"147732",0,0,1,1,"dummy"
"147733",0,0,1,1,"dummy"
"147734",0,0,1,1,"dummy"
"147735",0,0,1,1,"dummy"
"147736",0,0,1,1,"dummy"
"147737",0,0,1,1,"dummy"
"147738",0,0,1,1,"dummy"
"147739",0,0,1,1,"dummy"
"147740",0,0,1,1,"dummy"
"147741",0,0,1,1,"dummy"
"147742",0,0,1,1,"dummy"
"147743",0,0,1,1,"dummy"
"147744",0,0,1,1,"dummy"
"147745",0,0,1,1,"dummy"
"147746",0,0,1,1,"dummy"
"147747",0,0,1,1,"dummy"
"147748",0,0,1,1,"dummy"
"147749",0,0,1,1,"dummy"
"147750",0,0,1,1,"dummy"
"147751",0,0,1,1,"dummy"
"147752",0,0,1,1,"dummy"
"147753",0,0,1,1,"dummy"
"147754",0,0,1,1,"dummy"
"147755",0,0,1,1,"dummy"
"147756",0,0,1,1,"dummy"
"147757",0,0,1,1,"dummy"
"147758",0,0,1,1,"dummy"
"147759",0,0,1,1,"dummy"
"147760",0,0,1,1,"dummy"
"147761",0,0,1,1,"dummy"
"147762",0,0,1,1,"dummy"
"147763",0,0,1,1,"dummy"
"147764",0,0,1,1,"dummy"
"147765",0,0,1,1,"dummy"
"147766",0,0,1,1,"dummy"
"147767",0,0,1,1,"dummy"
"147768",0,0,1,1,"dummy"
"147769",0,0,1,1,"dummy"
"147770",0,0,1,1,"dummy"
"147771",0,0,1,1,"dummy"
"147772",0,0,1,1,"dummy"
"147773",0,0,1,1,"dummy"
"147774",0,4,0,4,"dummy"
"147775",0,0,1,1,"dummy"
"147776",0,0,1,1,"dummy"
"147777",0,0,1,1,"dummy"
"147778",0,0,1,1,"dummy"
"147779",0,0,1,1,"dummy"
"147780",0,0,1,1,"dummy"
"147781",0,0,1,1,"dummy"
"147782",0,0,1,1,"dummy"
"147783",0,0,1,1,"dummy"
"147784",0,0,1,1,"dummy"
"147785",0,0,1,1,"dummy"
"147786",0,0,1,1,"dummy"
"147787",0,0,1,1,"dummy"
"147788",0,0,1,1,"dummy"
"147789",0,0,1,1,"dummy"
"147790",2,0,0,2,"dummy"
"147791",4,3,0,7,"dummy"
"147792",0,0,0,0,"dummy"
"147793",0,0,0,0,"dummy"
"147794",0,0,0,0,"dummy"
"147795",0,0,0,0,"dummy"
"147796",0,0,0,0,"dummy"
"147797",0,0,0,0,"dummy"
"147798",0,0,0,0,"dummy"
"147799",0,0,0,0,"dummy"
"147800",0,0,0,0,"dummy"
"147801",0,0,0,0,"dummy"
"147802",0,0,0,0,"dummy"
"147805",0,2,0,2,"dummy"
"147806",0,0,2,2,"dummy"
"147807",4,0,2,6,"dummy"
"147808",0,3,0,3,"dummy"
"147809",6,0,0,6,"dummy"
"147810",3,0,0,3,"dummy"
"147814",0,1,0,1,"dummy"
"147815",1,4,0,5,"dummy"
"147826",5,6,0,11,"dummy"
"147827",0,0,1,1,"dummy"
"147828",0,2,0,2,"dummy"
"147829",0,0,1,1,"dummy"
"147830",1,0,0,1,"dummy"
"147831",0,1,0,1,"dummy"
"147851",0,0,0,0,"dummy"
"147861",0,0,1,1,"dummy"
"147862",0,0,1,1,"dummy"
"147863",2,1,0,3,"dummy"
"147916",0,1,0,1,"dummy"
"147917",0,2,0,2,"dummy"
"147918",0,1,0,1,"dummy"
"147923",5,2,0,7,"dummy"
"147924",0,1,1,2,"dummy"
"147925",3,40,0,43,"dummy"
"147926",0,1,0,1,"dummy"
"147927",0,2,0,2,"dummy"
"147928",2,2,0,4,"dummy"
"147929",34,10,1,45,"dummy"
"147930",10,4,2,16,"dummy"
"147931",0,6,0,6,"dummy"
"147932",0,2,1,3,"dummy"
"147933",4,2,2,8,"dummy"
"147934",0,1,1,2,"dummy"
"147948",1,4,1,6,"dummy"
"147949",1,0,0,1,"dummy"
"147950",0,0,1,1,"dummy"
"147951",0,2,1,3,"dummy"
"147952",0,1,0,1,"dummy"
"147953",0,2,0,2,"dummy"
"147954",0,1,0,1,"dummy"
"147955",3,0,1,4,"dummy"
"147956",0,0,1,1,"dummy"
"147975",0,0,3,3,"dummy"
"147976",0,1,0,1,"dummy"
"147977",1,2,1,4,"dummy"
"147978",2,2,4,8,"dummy"
"147979",2,4,0,6,"dummy"
"147980",2,2,0,4,"dummy"
"147981",0,0,4,4,"dummy"
"147982",0,1,0,1,"dummy"
"147983",0,0,4,4,"dummy"
"147984",0,0,1,1,"dummy"
"147985",0,1,0,1,"dummy"
"147986",1,1,0,2,"dummy"
"147987",0,2,0,2,"dummy"
"147988",3,1,0,4,"dummy"
"147989",0,2,0,2,"dummy"
"147990",0,2,0,2,"dummy"
"147991",7,2,1,10,"dummy"
"147992",1,0,0,1,"dummy"
"147993",3,5,0,8,"dummy"
"147994",1,0,0,1,"dummy"
"147995",0,3,0,3,"dummy"
"147996",3,1,0,4,"dummy"
"147997",0,3,0,3,"dummy"
"147998",1,0,1,2,"dummy"
"147999",0,0,1,1,"dummy"
"148000",3,0,0,3,"dummy"
"148001",0,2,0,2,"dummy"
"148002",0,8,0,8,"dummy"
"148003",0,0,5,5,"dummy"
"148004",4,6,0,10,"dummy"
"148005",0,0,0,0,"dummy"
"148010",7,3,3,13,"dummy"
"148011",1,0,0,1,"dummy"
"148022",0,2,0,2,"dummy"
"148023",2,0,0,2,"dummy"
"148024",0,2,0,2,"dummy"
"148025",1,2,0,3,"dummy"
"148038",0,0,0,0,"dummy"
"148039",0,0,0,0,"dummy"
"148040",0,0,0,0,"dummy"
"148041",0,2,0,2,"dummy"
"148042",0,0,0,0,"dummy"
"148043",0,0,0,0,"dummy"
"148044",0,2,0,2,"dummy"
"148045",0,1,0,1,"dummy"
"148046",0,0,0,0,"dummy"
"148047",3,0,0,3,"dummy"
"148048",0,0,1,1,"dummy"
"148092",2,1,1,4,"dummy"
"148093",0,3,0,3,"dummy"
"148094",3,5,0,8,"dummy"
"148095",0,4,0,4,"dummy"
"148096",0,2,0,2,"dummy"
"148097",0,1,1,2,"dummy"
"148108",0,0,0,0,"dummy"
"148109",0,0,0,0,"dummy"
"148110",0,0,0,0,"dummy"
"148111",0,0,0,0,"dummy"
"148112",0,35,0,35,"dummy"
"148115",0,8,0,8,"dummy"
"148118",0,1,0,1,"dummy"
"148119",0,2,0,2,"dummy"
"148120",0,4,2,6,"dummy"
"148121",0,0,0,0,"dummy"
"148126",1,0,0,1,"dummy"
"148017",1,2,0,3,"dummy"
"148018",5,0,1,6,"dummy"
"148019",0,0,2,2,"dummy"
"148020",5,5,0,10,"dummy"
"148031",0,1,0,1,"dummy"
"148032",4,3,6,13,"dummy"
"148033",3,4,6,13,"dummy"
"148034",4,3,6,13,"dummy"
"148050",2,1,0,3,"dummy"
"148051",1,2,0,3,"dummy"
"148052",0,0,1,1,"dummy"
"148053",0,0,1,1,"dummy"
"148054",1,2,0,3,"dummy"
"148055",1,0,0,1,"dummy"
"148056",0,1,0,1,"dummy"
"148057",0,1,0,1,"dummy"
"148058",0,1,0,1,"dummy"
"148059",0,1,0,1,"dummy"
"148060",1,2,0,3,"dummy"
"148061",0,0,0,0,"dummy"
"148062",0,0,1,1,"dummy"
"148063",0,0,1,1,"dummy"
"148064",1,2,0,3,"dummy"
"148065",0,0,0,0,"dummy"
"148066",0,0,0,0,"dummy"
"148067",0,0,0,0,"dummy"
"148068",0,0,0,0,"dummy"
"148069",0,0,0,0,"dummy"
"148070",0,0,0,0,"dummy"
"148073",4,1,0,5,"dummy"
"148076",10,3,0,13,"dummy"
"148077",0,22,2,24,"dummy"
"148078",0,1,2,3,"dummy"
"148079",1,0,0,1,"dummy"
"148080",0,1,0,1,"dummy"
"148081",6,0,0,6,"dummy"
"148082",0,1,1,2,"dummy"
"148083",5,22,2,29,"dummy"
"148084",21,11,2,34,"dummy"
"148085",2,1,0,3,"dummy"
"148086",0,1,0,1,"dummy"
"148087",3,8,2,13,"dummy"
"148088",0,0,0,0,"dummy"
"148089",0,0,3,3,"dummy"
"148090",1,1,0,2,"dummy"
"148099",2,4,0,6,"dummy"
"148100",0,2,0,2,"dummy"
"148101",0,2,0,2,"dummy"
"148102",10,2,0,12,"dummy"
"148103",0,2,0,2,"dummy"
"148104",0,4,2,6,"dummy"
"148105",4,0,2,6,"dummy"
"148106",0,4,2,6,"dummy"
"148128",0,1,0,1,"dummy"
"148129",5,4,0,9,"dummy"
"148130",3,5,2,10,"dummy"
"148179",0,0,1,1,"dummy"
"148180",0,0,3,3,"dummy"
"148185",0,1,1,2,"dummy"
"148186",0,2,1,3,"dummy"
"148187",3,7,2,12,"dummy"
"148188",0,0,0,0,"dummy"
"148189",0,1,0,1,"dummy"
"148190",1,2,0,3,"dummy"
"148191",0,0,2,2,"dummy"
"148192",0,0,1,1,"dummy"
"148193",1,0,0,1,"dummy"
"148194",1,1,1,3,"dummy"
"148195",0,0,1,1,"dummy"
"148196",0,0,1,1,"dummy"
"148212",0,0,0,0,"dummy"
"148213",0,0,0,0,"dummy"
"148214",0,0,0,0,"dummy"
"148215",2,0,0,2,"dummy"
"148219",0,5,0,5,"dummy"
"148220",0,0,1,1,"dummy"
"148221",0,1,0,1,"dummy"
"148222",0,1,0,1,"dummy"
"148223",1,0,2,3,"dummy"
"148224",0,2,1,3,"dummy"
"148225",0,1,0,1,"dummy"
"148226",0,5,1,6,"dummy"
"148227",0,1,1,2,"dummy"
"148228",0,4,0,4,"dummy"
"148229",0,5,0,5,"dummy"
"148230",3,0,0,3,"dummy"
"148132",0,0,1,1,"dummy"
"148139",0,0,0,0,"dummy"
"148140",0,0,1,1,"dummy"
"148141",12,1,0,13,"dummy"
"148142",0,0,1,1,"dummy"
"148143",0,0,1,1,"dummy"
"148144",0,0,1,1,"dummy"
"148145",0,0,0,0,"dummy"
"148146",0,0,0,0,"dummy"
"148147",0,0,0,0,"dummy"
"148148",0,0,1,1,"dummy"
"148149",0,0,1,1,"dummy"
"148150",0,0,1,1,"dummy"
"148151",0,0,0,0,"dummy"
"148152",0,0,0,0,"dummy"
"148153",0,0,0,0,"dummy"
"148154",0,0,0,0,"dummy"
"148155",0,0,0,0,"dummy"
"148156",0,0,0,0,"dummy"
"148157",0,0,0,0,"dummy"
"148158",0,2,0,2,"dummy"
"148159",2,0,0,2,"dummy"
"148160",0,2,0,2,"dummy"
"148161",7,3,0,10,"dummy"
"148162",0,0,1,1,"dummy"
"148163",0,0,0,0,"dummy"
"148164",0,0,1,1,"dummy"
"148165",0,0,1,1,"dummy"
"148166",0,0,1,1,"dummy"
"148167",0,0,1,1,"dummy"
"148172",2,0,5,7,"dummy"
"148175",0,3,0,3,"dummy"
"148217",0,0,1,1,"dummy"
"148246",1,1,1,3,"dummy"
"148247",1,1,3,5,"dummy"
"148248",0,0,1,1,"dummy"
"148249",0,0,1,1,"dummy"
"148250",0,3,1,4,"dummy"
"148251",0,1,0,1,"dummy"
"148252",1,1,0,2,"dummy"
"148253",4,1,0,5,"dummy"
"148254",0,2,0,2,"dummy"
"148255",0,0,1,1,"dummy"
"148256",0,0,1,1,"dummy"
"148257",0,1,1,2,"dummy"
"148258",0,0,1,1,"dummy"
"148259",3,2,1,6,"dummy"
"148260",0,0,1,1,"dummy"
"148261",0,4,2,6,"dummy"
"148262",0,0,1,1,"dummy"
"148263",0,1,1,2,"dummy"
"148264",0,0,1,1,"dummy"
"148265",0,0,2,2,"dummy"
"148266",0,0,1,1,"dummy"
"148267",2,1,1,4,"dummy"
"148268",0,0,1,1,"dummy"
"148269",0,0,1,1,"dummy"
"148270",0,0,1,1,"dummy"
"148271",0,0,2,2,"dummy"
"148272",0,0,1,1,"dummy"
"148273",7,2,2,11,"dummy"
"148274",0,0,1,1,"dummy"
"148275",2,1,0,3,"dummy"
"148276",0,0,1,1,"dummy"
"148277",0,0,1,1,"dummy"
"148278",0,0,1,1,"dummy"
"148279",0,0,1,1,"dummy"
"148280",0,0,1,1,"dummy"
"148281",0,1,1,2,"dummy"
"148282",0,0,1,1,"dummy"
"148231",0,8,0,8,"dummy"
"148232",3,3,0,6,"dummy"
"148233",5,4,0,9,"dummy"
"148234",4,4,0,8,"dummy"
"148235",5,6,0,11,"dummy"
"148236",2,2,0,4,"dummy"
"148237",3,3,0,6,"dummy"
"148238",5,5,0,10,"dummy"
"148239",0,1,0,1,"dummy"
"148240",4,4,0,8,"dummy"
"148241",8,5,0,13,"dummy"
"148242",2,0,0,2,"dummy"
"148243",0,0,1,1,"dummy"
"148244",0,9,1,10,"dummy"
"148386",0,7,0,7,"dummy"
"148390",0,1,0,1,"dummy"
"148392",0,1,0,1,"dummy"
"148394",0,0,1,1,"dummy"
"148396",0,1,0,1,"dummy"
"148398",6,8,0,14,"dummy"
"148401",0,4,0,4,"dummy"
"148402",11,11,3,25,"dummy"
"148403",4,3,0,7,"dummy"
"148436",0,0,0,0,"dummy"
"148437",0,0,0,0,"dummy"
"148439",1,5,2,8,"dummy"
"148441",0,0,1,1,"dummy"
"148445",0,0,1,1,"dummy"
"148446",4,4,1,9,"dummy"
"148447",0,1,1,2,"dummy"
"148450",0,0,1,1,"dummy"
"148451",0,0,2,2,"dummy"
"148452",4,1,0,5,"dummy"
"148464",0,5,0,5,"dummy"
"148465",5,1,1,7,"dummy"
"148466",0,1,0,1,"dummy"
"148467",0,0,1,1,"dummy"
"148468",0,0,0,0,"dummy"
"148469",0,0,1,1,"dummy"
"148470",0,5,0,5,"dummy"
"148471",3,0,0,3,"dummy"
"148472",0,1,0,1,"dummy"
"148473",1,3,3,7,"dummy"
"148474",0,1,1,2,"dummy"
"148475",1,2,1,4,"dummy"
"148476",0,4,0,4,"dummy"
"148481",2,4,0,6,"dummy"
"148482",0,2,0,2,"dummy"
"148483",0,2,0,2,"dummy"
"148484",10,2,0,12,"dummy"
"148485",0,2,0,2,"dummy"
"148486",0,0,0,0,"dummy"
"148489",0,0,1,1,"dummy"
"148491",0,0,0,0,"dummy"
"148493",0,16,0,16,"dummy"
"148494",2,1,0,3,"dummy"
"148495",0,6,1,7,"dummy"
"148496",0,3,0,3,"dummy"
"148498",0,0,1,1,"dummy"
"148499",1,3,1,5,"dummy"
"148500",0,0,0,0,"dummy"
"148501",0,1,0,1,"dummy"
"148502",0,4,0,4,"dummy"
"148503",5,2,0,7,"dummy"
"148504",0,0,0,0,"dummy"
"148506",0,0,0,0,"dummy"
"148508",0,0,0,0,"dummy"
"148510",0,2,0,2,"dummy"
"148511",0,3,0,3,"dummy"
"148512",0,0,1,1,"dummy"
"148513",1,0,0,1,"dummy"
"148515",0,0,1,1,"dummy"
"148522",2,1,0,3,"dummy"
"148523",1,2,1,4,"dummy"
"148525",0,0,1,1,"dummy"
"148526",3,0,1,4,"dummy"
"148531",0,2,0,2,"dummy"
"148532",2,4,3,9,"dummy"
"148533",0,2,3,5,"dummy"
"148534",4,3,3,10,"dummy"
"148537",0,0,1,1,"dummy"
"148538",0,0,1,1,"dummy"
"148539",0,0,1,1,"dummy"
"148548",1,2,0,3,"dummy"
"148549",0,0,1,1,"dummy"
"148550",2,0,0,2,"dummy"
"148553",0,5,1,6,"dummy"
"148554",0,1,0,1,"dummy"
"148555",4,2,0,6,"dummy"
"148556",0,0,1,1,"dummy"
"148557",0,0,1,1,"dummy"
"148558",0,1,0,1,"dummy"
"148559",0,0,1,1,"dummy"
"148560",0,0,1,1,"dummy"
"148562",0,0,0,0,"dummy"
"148564",0,1,0,1,"dummy"
"148566",0,1,1,2,"dummy"
"148575",2,1,3,6,"dummy"
"148576",0,1,1,2,"dummy"
"148577",0,1,2,3,"dummy"
"148578",1,1,0,2,"dummy"
"148579",0,1,1,2,"dummy"
"148581",20,7,3,30,"dummy"
"148583",2,0,0,2,"dummy"
"148584",0,0,1,1,"dummy"
"148585",0,2,0,2,"dummy"
"148588",1,0,0,1,"dummy"
"148589",0,0,0,0,"dummy"
"148590",0,0,0,0,"dummy"
"148591",0,1,0,1,"dummy"
"148592",0,0,1,1,"dummy"
"148593",0,0,0,0,"dummy"
"148594",0,0,0,0,"dummy"
"148603",0,2,0,2,"dummy"
"148604",1,5,0,6,"dummy"
"148605",4,0,0,4,"dummy"
"148606",0,1,0,1,"dummy"
"148607",0,1,0,1,"dummy"
"148608",0,2,0,2,"dummy"
"148611",4,4,0,8,"dummy"
"148613",10,6,3,19,"dummy"
"148614",6,19,3,28,"dummy"
"148615",3,10,2,15,"dummy"
"148619",2,4,0,6,"dummy"
"148620",0,2,0,2,"dummy"
"148621",0,2,0,2,"dummy"
"148622",10,2,0,12,"dummy"
"148623",0,2,0,2,"dummy"
"148624",0,0,0,0,"dummy"
"148625",0,0,3,3,"dummy"
"148626",0,5,0,5,"dummy"
"148628",0,1,0,1,"dummy"
"148629",0,1,0,1,"dummy"
"148630",0,5,0,5,"dummy"
"148631",1,2,0,3,"dummy"
"148632",2,6,0,8,"dummy"
"148633",7,1,0,8,"dummy"
"148648",0,0,2,2,"dummy"
"148649",6,0,1,7,"dummy"
"148650",0,2,0,2,"dummy"
"148652",10,9,5,24,"dummy"
"148656",0,1,0,1,"dummy"
"148657",1,0,1,2,"dummy"
"148660",0,0,1,1,"dummy"
"148664",0,1,0,1,"dummy"
"148665",1,1,0,2,"dummy"
"148666",0,2,0,2,"dummy"
"148667",2,3,1,6,"dummy"
"148668",0,0,3,3,"dummy"
"148669",0,0,1,1,"dummy"
"148670",0,0,1,1,"dummy"
"148671",2,0,0,2,"dummy"
"148672",4,4,0,8,"dummy"
"148673",2,0,0,2,"dummy"
"148683",6,7,0,13,"dummy"
"148684",0,0,2,2,"dummy"
"148695",0,2,0,2,"dummy"
"148696",0,0,1,1,"dummy"
"148697",0,0,1,1,"dummy"
"148698",0,1,1,2,"dummy"
"148699",0,0,1,1,"dummy"
"148700",0,1,1,2,"dummy"
"148701",0,0,1,1,"dummy"
"148702",1,0,1,2,"dummy"
"148703",0,0,1,1,"dummy"
"148704",0,0,2,2,"dummy"
"148705",0,0,1,1,"dummy"
"148706",2,1,1,4,"dummy"
"148707",0,0,1,1,"dummy"
"148708",0,0,1,1,"dummy"
"148709",0,0,1,1,"dummy"
"148710",3,2,2,7,"dummy"
"148711",0,0,1,1,"dummy"
"148712",0,0,2,2,"dummy"
"148713",2,1,1,4,"dummy"
"148727",0,1,0,1,"dummy"
"148728",1,1,1,3,"dummy"
"148731",1,0,0,1,"dummy"
"148732",5,1,1,7,"dummy"
"148733",0,6,0,6,"dummy"
"148734",0,0,1,1,"dummy"
"148735",0,2,0,2,"dummy"
"148736",1,3,0,4,"dummy"
"148737",0,0,2,2,"dummy"
"148738",0,1,0,1,"dummy"
"148739",0,4,0,4,"dummy"
"148740",3,1,0,4,"dummy"
"148741",0,10,2,12,"dummy"
"148742",1,3,0,4,"dummy"
"148744",0,0,0,0,"dummy"
"148745",0,1,0,1,"dummy"
"148746",1,0,0,1,"dummy"
"148747",1,0,0,1,"dummy"
"148755",0,3,0,3,"dummy"
"148756",0,4,0,4,"dummy"
"148757",0,1,0,1,"dummy"
"148758",0,1,0,1,"dummy"
"148759",0,0,1,1,"dummy"
"148761",0,9,1,10,"dummy"
"148762",0,0,3,3,"dummy"
"148763",0,4,3,7,"dummy"
"148764",0,0,4,4,"dummy"
"148765",4,6,0,10,"dummy"
"148766",0,1,0,1,"dummy"
"148767",2,4,0,6,"dummy"
"148768",0,1,0,1,"dummy"
"148769",0,0,1,1,"dummy"
"148770",0,0,2,2,"dummy"
"148771",0,0,0,0,"dummy"
"148772",0,0,0,0,"dummy"
"148774",0,0,1,1,"dummy"
"148775",0,2,0,2,"dummy"
"148776",0,1,0,1,"dummy"
"148777",4,11,3,18,"dummy"
"148778",1,0,0,1,"dummy"
"148779",2,4,0,6,"dummy"
"148780",0,1,0,1,"dummy"
"148781",0,1,0,1,"dummy"
"148787",4,7,1,12,"dummy"
"148788",23,5,1,29,"dummy"
"148789",8,9,0,17,"dummy"
"148790",19,20,2,41,"dummy"
"148791",18,2,1,21,"dummy"
"148792",0,2,0,2,"dummy"
"148793",1,2,0,3,"dummy"
"148794",0,0,0,0,"dummy"
"148812",3,5,2,10,"dummy"
"148814",0,1,0,1,"dummy"
"148820",1,4,0,5,"dummy"
"148821",0,3,0,3,"dummy"
"148823",0,0,1,1,"dummy"
"148830",0,0,1,1,"dummy"
"148840",0,2,0,2,"dummy"
"148844",1,0,1,2,"dummy"
"148845",0,2,0,2,"dummy"
"148846",0,1,0,1,"dummy"
"148848",1,7,0,8,"dummy"
"148849",6,1,0,7,"dummy"
"148851",0,0,1,1,"dummy"
"148852",0,6,3,9,"dummy"
"148854",0,4,1,5,"dummy"
"148855",0,3,0,3,"dummy"
"148859",11,9,1,21,"dummy"
"148860",0,1,0,1,"dummy"
"148870",0,0,1,1,"dummy"
"148874",0,2,0,2,"dummy"
"148875",2,0,1,3,"dummy"
"148876",0,0,1,1,"dummy"
"148877",0,5,0,5,"dummy"
"148878",3,6,2,11,"dummy"
"148879",7,3,2,12,"dummy"
"148880",2,1,2,5,"dummy"
"148881",4,7,0,11,"dummy"
"148882",1,1,0,2,"dummy"
"148885",2,2,0,4,"dummy"
"148893",0,0,0,0,"dummy"
"148897",0,0,1,1,"dummy"
"148901",0,3,0,3,"dummy"
"148902",0,1,0,1,"dummy"
"148903",0,0,1,1,"dummy"
"148937",2,0,0,2,"dummy"
"148938",0,0,0,0,"dummy"
"148941",1,0,0,1,"dummy"
"148942",3,2,4,9,"dummy"
"148945",0,0,1,1,"dummy"
"148967",0,2,0,2,"dummy"
"148968",0,0,1,1,"dummy"
"148969",0,0,1,1,"dummy"
"148970",0,0,1,1,"dummy"
"148971",0,2,0,2,"dummy"
"148972",0,0,5,5,"dummy"
"149013",0,3,0,3,"dummy"
"149016",2,0,1,3,"dummy"
"149017",0,0,0,0,"dummy"
"149018",0,1,0,1,"dummy"
"149019",8,1,0,9,"dummy"
"149020",0,0,0,0,"dummy"
"149021",0,0,0,0,"dummy"
"149022",1,10,0,11,"dummy"
"149023",7,1,0,8,"dummy"
"149024",2,0,3,5,"dummy"
"149027",2,2,0,4,"dummy"
"149028",0,6,1,7,"dummy"
"149029",0,1,0,1,"dummy"
"149030",8,5,2,15,"dummy"
"149034",0,1,1,2,"dummy"
"149035",0,1,0,1,"dummy"
"149036",0,2,0,2,"dummy"
"149041",0,0,1,1,"dummy"
"149042",2,0,0,2,"dummy"
"149043",0,0,1,1,"dummy"
"149044",0,0,0,0,"dummy"
"149045",0,0,1,1,"dummy"
"149046",0,0,1,1,"dummy"
"149047",1,1,2,4,"dummy"
"149048",0,0,1,1,"dummy"
"149049",0,0,1,1,"dummy"
"149050",0,2,0,2,"dummy"
"149051",0,1,0,1,"dummy"
"149052",0,0,1,1,"dummy"
"149053",4,1,0,5,"dummy"
"149054",0,0,1,1,"dummy"
"149055",0,1,1,2,"dummy"
"149056",0,0,1,1,"dummy"
"149057",0,0,2,2,"dummy"
"149058",0,0,1,1,"dummy"
"149059",0,0,1,1,"dummy"
"149060",0,0,1,1,"dummy"
"149061",3,2,2,7,"dummy"
"149062",0,0,1,1,"dummy"
"149063",0,0,2,2,"dummy"
"149064",0,0,1,1,"dummy"
"149065",0,0,1,1,"dummy"
"149066",0,0,1,1,"dummy"
"149067",1,0,0,1,"dummy"
"149068",1,1,0,2,"dummy"
"149069",0,0,1,1,"dummy"
"149070",0,0,1,1,"dummy"
"149071",0,0,1,1,"dummy"
"149072",0,0,1,1,"dummy"
"149073",0,0,1,1,"dummy"
"149074",0,0,1,1,"dummy"
"149075",0,0,1,1,"dummy"
"149076",0,0,1,1,"dummy"
"149077",0,0,1,1,"dummy"
"149078",0,1,1,2,"dummy"
"149079",0,0,1,1,"dummy"
"149089",2,8,3,13,"dummy"
"149090",1,9,0,10,"dummy"
"149091",1,0,0,1,"dummy"
"149098",2,5,4,11,"dummy"
"149121",0,0,1,1,"dummy"
"149122",0,0,1,1,"dummy"
"149123",0,0,1,1,"dummy"
"149124",4,4,1,9,"dummy"
"149125",0,3,0,3,"dummy"
"148908",2,2,0,4,"dummy"
"148909",0,2,0,2,"dummy"
"148910",0,0,1,1,"dummy"
"148911",0,0,1,1,"dummy"
"148914",5,4,4,13,"dummy"
"148915",0,0,1,1,"dummy"
"148916",3,4,2,9,"dummy"
"148917",0,0,0,0,"dummy"
"148918",0,0,1,1,"dummy"
"148921",1,1,0,2,"dummy"
"148922",0,0,1,1,"dummy"
"148923",0,5,2,7,"dummy"
"148924",0,1,0,1,"dummy"
"148925",0,1,1,2,"dummy"
"148926",0,3,0,3,"dummy"
"148927",3,0,0,3,"dummy"
"148928",0,1,0,1,"dummy"
"148929",1,0,0,1,"dummy"
"148930",1,0,1,2,"dummy"
"148931",3,0,0,3,"dummy"
"148932",5,0,1,6,"dummy"
"148933",0,5,1,6,"dummy"
"148949",0,0,1,1,"dummy"
"148950",0,0,1,1,"dummy"
"148951",0,0,1,1,"dummy"
"148952",6,0,2,8,"dummy"
"148953",0,0,1,1,"dummy"
"148954",0,0,1,1,"dummy"
"148955",0,2,0,2,"dummy"
"148960",0,2,0,2,"dummy"
"148961",2,3,0,5,"dummy"
"148962",0,1,0,1,"dummy"
"148963",0,0,1,1,"dummy"
"148964",0,1,0,1,"dummy"
"148965",0,9,1,10,"dummy"
"148974",2,4,3,9,"dummy"
"148975",0,0,1,1,"dummy"
"148976",0,0,5,5,"dummy"
"148977",8,13,5,26,"dummy"
"148978",1,0,1,2,"dummy"
"148979",0,2,0,2,"dummy"
"148980",2,0,0,2,"dummy"
"148981",5,3,2,10,"dummy"
"148994",0,0,2,2,"dummy"
"148995",0,0,1,1,"dummy"
"148996",0,0,1,1,"dummy"
"149002",0,1,0,1,"dummy"
"149003",0,0,1,1,"dummy"
"149004",2,11,3,16,"dummy"
"149005",0,2,0,2,"dummy"
"149006",0,0,0,0,"dummy"
"149007",3,0,0,3,"dummy"
"149008",0,4,0,4,"dummy"
"149009",1,1,0,2,"dummy"
"149010",0,0,0,0,"dummy"
"149011",1,1,0,2,"dummy"
"149032",10,36,4,50,"dummy"
"149083",0,0,1,1,"dummy"
"149084",0,0,1,1,"dummy"
"149085",0,7,0,7,"dummy"
"149100",0,9,0,9,"dummy"
"149101",3,1,0,4,"dummy"
"149102",0,1,0,1,"dummy"
"149103",0,1,0,1,"dummy"
"149104",1,1,0,2,"dummy"
"149105",0,0,0,0,"dummy"
"149106",0,1,0,1,"dummy"
"149107",4,5,2,11,"dummy"
"149155",1,6,0,7,"dummy"
"149156",6,9,0,15,"dummy"
"149166",0,2,0,2,"dummy"
"149126",8,6,2,16,"dummy"
"149127",0,0,0,0,"dummy"
"149128",0,0,1,1,"dummy"
"149129",0,0,1,1,"dummy"
"149130",8,3,0,11,"dummy"
"149131",0,1,0,1,"dummy"
"149132",0,0,0,0,"dummy"
"149133",2,2,0,4,"dummy"
"149134",0,0,2,2,"dummy"
"149135",0,0,1,1,"dummy"
"149136",0,0,1,1,"dummy"
"149137",0,0,1,1,"dummy"
"149138",1,0,0,1,"dummy"
"149139",0,0,1,1,"dummy"
"149140",0,0,2,2,"dummy"
"149141",0,0,1,1,"dummy"
"149142",0,0,1,1,"dummy"
"149143",0,0,1,1,"dummy"
"149144",0,0,1,1,"dummy"
"149145",0,0,1,1,"dummy"
"149146",8,8,2,18,"dummy"
"149147",0,0,1,1,"dummy"
"149148",0,0,1,1,"dummy"
"149149",0,0,1,1,"dummy"
"149150",0,0,1,1,"dummy"
"149151",0,0,1,1,"dummy"
"149162",0,1,0,1,"dummy"
"149168",0,0,0,0,"dummy"
"149177",1,1,1,3,"dummy"
"149185",1,1,3,5,"dummy"
"149186",0,1,1,2,"dummy"
"149187",0,5,0,5,"dummy"
"149188",0,1,4,5,"dummy"
"149189",0,1,0,1,"dummy"
"149193",0,0,1,1,"dummy"
"149194",3,0,2,5,"dummy"
"149195",0,0,0,0,"dummy"
"149196",0,8,0,8,"dummy"
"149197",2,0,0,2,"dummy"
"149209",1,0,2,3,"dummy"
"149210",0,1,2,3,"dummy"
"149211",1,1,0,2,"dummy"
"149215",1,0,0,1,"dummy"
"149256",0,9,0,9,"dummy"
"149257",0,0,1,1,"dummy"
"149258",0,0,2,2,"dummy"
"149259",0,0,1,1,"dummy"
"149260",0,1,0,1,"dummy"
"149261",0,1,0,1,"dummy"
"149262",0,0,1,1,"dummy"
"149263",0,0,1,1,"dummy"
"149264",2,0,0,2,"dummy"
"149265",0,1,0,1,"dummy"
"149266",1,0,0,1,"dummy"
"149267",0,1,0,1,"dummy"
"149268",0,0,2,2,"dummy"
"149269",0,0,1,1,"dummy"
"149270",1,2,0,3,"dummy"
"149271",0,0,2,2,"dummy"
"149272",2,1,0,3,"dummy"
"149273",1,0,0,1,"dummy"
"149274",0,0,1,1,"dummy"
"149275",0,0,1,1,"dummy"
"149276",1,1,0,2,"dummy"
"149277",0,0,1,1,"dummy"
"149280",0,0,1,1,"dummy"
"149281",0,0,1,1,"dummy"
"149312",0,4,1,5,"dummy"
"149364",0,0,1,1,"dummy"
"149179",3,8,8,19,"dummy"
"149180",0,21,0,21,"dummy"
"149181",1,1,0,2,"dummy"
"149191",1,2,0,3,"dummy"
"149199",0,1,0,1,"dummy"
"149200",0,1,0,1,"dummy"
"149201",1,0,0,1,"dummy"
"149202",0,2,0,2,"dummy"
"149203",1,4,0,5,"dummy"
"149204",0,2,0,2,"dummy"
"149213",3,4,3,10,"dummy"
"149219",0,2,0,2,"dummy"
"149220",0,1,0,1,"dummy"
"149221",2,3,2,7,"dummy"
"149222",0,0,0,0,"dummy"
"149223",3,0,0,3,"dummy"
"149224",0,3,1,4,"dummy"
"149225",0,0,0,0,"dummy"
"149226",0,1,1,2,"dummy"
"149227",1,0,0,1,"dummy"
"149228",2,3,1,6,"dummy"
"149229",0,1,0,1,"dummy"
"149248",1,0,1,2,"dummy"
"149249",0,0,2,2,"dummy"
"149250",1,0,0,1,"dummy"
"149251",0,3,4,7,"dummy"
"149252",0,2,0,2,"dummy"
"149285",0,0,0,0,"dummy"
"149286",0,0,0,0,"dummy"
"149289",0,9,3,12,"dummy"
"149290",7,1,1,9,"dummy"
"149291",7,4,0,11,"dummy"
"149292",4,14,0,18,"dummy"
"149293",5,4,0,9,"dummy"
"149294",20,12,1,33,"dummy"
"149295",1,1,1,3,"dummy"
"149296",13,5,3,21,"dummy"
"149297",0,1,1,2,"dummy"
"149298",0,0,1,1,"dummy"
"149299",3,3,0,6,"dummy"
"149300",1,2,1,4,"dummy"
"149301",0,0,2,2,"dummy"
"149302",0,0,0,0,"dummy"
"149303",14,2,0,16,"dummy"
"149304",0,0,0,0,"dummy"
"149305",0,0,0,0,"dummy"
"149306",0,0,1,1,"dummy"
"149307",1,0,1,2,"dummy"
"149308",0,0,0,0,"dummy"
"149309",0,0,1,1,"dummy"
"149310",0,0,1,1,"dummy"
"149323",0,0,1,1,"dummy"
"149324",0,2,0,2,"dummy"
"149368",0,1,0,1,"dummy"
"149369",4,5,1,10,"dummy"
"149370",1,1,1,3,"dummy"
"149371",0,1,0,1,"dummy"
"149372",0,1,0,1,"dummy"
"149373",0,1,0,1,"dummy"
"149387",1,1,0,2,"dummy"
"149388",0,0,1,1,"dummy"
"149389",0,2,0,2,"dummy"
"149390",0,0,2,2,"dummy"
"149391",0,0,0,0,"dummy"
"149392",0,2,0,2,"dummy"
"149393",0,0,0,0,"dummy"
"149403",0,1,0,1,"dummy"
"149404",2,3,0,5,"dummy"
"149405",0,0,1,1,"dummy"
"149432",0,0,0,0,"dummy"
"149433",9,8,5,22,"dummy"
"149434",0,5,0,5,"dummy"
"149435",0,0,1,1,"dummy"
"149436",0,1,0,1,"dummy"
"149441",0,21,0,21,"dummy"
"149442",0,3,1,4,"dummy"
"149443",10,3,0,13,"dummy"
"149395",0,0,0,0,"dummy"
"149396",0,2,0,2,"dummy"
"149397",0,0,1,1,"dummy"
"149398",0,0,1,1,"dummy"
"149399",0,1,0,1,"dummy"
"149400",0,0,1,1,"dummy"
"149401",0,0,1,1,"dummy"
"149407",0,3,0,3,"dummy"
"149408",0,1,0,1,"dummy"
"149409",0,3,0,3,"dummy"
"149410",0,3,0,3,"dummy"
"149411",4,4,0,8,"dummy"
"149412",0,7,0,7,"dummy"
"149413",0,0,1,1,"dummy"
"149414",0,14,0,14,"dummy"
"149415",0,19,1,20,"dummy"
"149416",0,1,2,3,"dummy"
"149417",0,2,0,2,"dummy"
"149418",4,1,2,7,"dummy"
"149428",0,0,0,0,"dummy"
"149429",1,1,4,6,"dummy"
"149430",3,3,6,12,"dummy"
"149451",0,1,0,1,"dummy"
"149452",0,0,1,1,"dummy"
"149453",0,0,0,0,"dummy"
"149459",0,7,0,7,"dummy"
"149462",1,16,2,19,"dummy"
"149444",4,1,1,6,"dummy"
"149445",0,0,1,1,"dummy"
"149446",0,0,1,1,"dummy"
"149447",0,1,0,1,"dummy"
"149448",1,0,1,2,"dummy"
"149449",0,1,1,2,"dummy"
"149455",0,12,0,12,"dummy"
"149456",1,0,0,1,"dummy"
"149457",0,0,0,0,"dummy"
"149471",0,0,0,0,"dummy"
"149473",0,8,0,8,"dummy"
"149476",0,1,0,1,"dummy"
"149477",0,1,0,1,"dummy"
"149478",0,3,1,4,"dummy"
"149479",0,0,0,0,"dummy"
"149480",2,0,0,2,"dummy"
"149481",0,0,0,0,"dummy"
"149482",1,0,2,3,"dummy"
"149483",0,0,1,1,"dummy"
"149484",2,1,0,3,"dummy"
"149485",0,0,0,0,"dummy"
"149486",2,3,1,6,"dummy"
"149490",3,0,1,4,"dummy"
"149492",3,2,0,5,"dummy"
"149495",0,1,0,1,"dummy"
"149496",0,1,0,1,"dummy"
"149498",0,0,1,1,"dummy"
"149500",0,0,2,2,"dummy"
"149501",0,0,1,1,"dummy"
"149502",1,0,0,1,"dummy"
"149504",0,0,1,1,"dummy"
"149506",3,0,0,3,"dummy"
"149507",3,3,4,10,"dummy"
"149508",9,15,1,25,"dummy"
"149509",0,1,2,3,"dummy"
"149510",0,0,1,1,"dummy"
"149512",8,12,1,21,"dummy"
"149513",2,12,1,15,"dummy"
"149514",0,1,0,1,"dummy"
"149516",0,2,0,2,"dummy"
"149517",0,1,0,1,"dummy"
"149519",43,40,4,87,"dummy"
"149520",3,6,0,9,"dummy"
"149521",3,3,3,9,"dummy"
"149524",0,10,0,10,"dummy"
"149525",9,2,4,15,"dummy"
"149542",0,0,0,0,"dummy"
"149545",0,0,1,1,"dummy"
"149546",0,0,1,1,"dummy"
"149547",0,0,1,1,"dummy"
"149548",0,0,1,1,"dummy"
"149549",0,0,1,1,"dummy"
"149550",0,0,1,1,"dummy"
"149551",0,0,1,1,"dummy"
"149552",0,0,1,1,"dummy"
"149553",0,0,1,1,"dummy"
"149554",0,0,1,1,"dummy"
"149555",0,1,0,1,"dummy"
"149556",0,0,2,2,"dummy"
"149557",0,13,0,13,"dummy"
"149559",0,2,0,2,"dummy"
"149560",0,0,3,3,"dummy"
"149561",1,3,0,4,"dummy"
"149562",5,1,0,6,"dummy"
"149563",4,0,0,4,"dummy"
"149564",7,3,4,14,"dummy"
"149569",0,0,1,1,"dummy"
"149570",1,0,0,1,"dummy"
"149575",8,2,5,15,"dummy"
"149576",0,0,0,0,"dummy"
"149577",0,0,0,0,"dummy"
"149579",0,2,0,2,"dummy"
"149580",0,1,0,1,"dummy"
"149582",4,1,0,5,"dummy"
"149583",1,0,0,1,"dummy"
"149584",0,0,1,1,"dummy"
"149585",0,1,0,1,"dummy"
"149587",0,0,1,1,"dummy"
"149592",0,1,0,1,"dummy"
"149593",1,0,0,1,"dummy"
"149594",1,0,0,1,"dummy"
"149595",1,0,1,2,"dummy"
"149596",0,0,1,1,"dummy"
"149598",0,1,0,1,"dummy"
"149601",7,0,0,7,"dummy"
"149602",4,2,0,6,"dummy"
"149603",2,7,0,9,"dummy"
"149604",0,0,1,1,"dummy"
"149605",7,1,0,8,"dummy"
"149606",7,5,3,15,"dummy"
"149607",4,2,5,11,"dummy"
"149608",0,0,1,1,"dummy"
"149609",13,0,0,13,"dummy"
"149612",0,0,1,1,"dummy"
"149613",0,0,1,1,"dummy"
"149614",0,0,2,2,"dummy"
"149615",26,3,7,36,"dummy"
"149628",0,0,1,1,"dummy"
"149630",0,0,3,3,"dummy"
"149631",0,2,0,2,"dummy"
"149632",0,1,0,1,"dummy"
"149633",0,2,0,2,"dummy"
"149651",2,2,0,4,"dummy"
"149652",0,1,0,1,"dummy"
"149653",12,0,1,13,"dummy"
"149654",0,2,0,2,"dummy"
"149655",0,9,1,10,"dummy"
"149656",0,13,0,13,"dummy"
"149657",0,1,0,1,"dummy"
"149659",0,16,3,19,"dummy"
"149667",2,0,1,3,"dummy"
"149674",1,1,0,2,"dummy"
"149675",0,4,0,4,"dummy"
"149676",0,3,0,3,"dummy"
"149678",1,0,1,2,"dummy"
"149679",0,2,0,2,"dummy"
"149680",0,1,0,1,"dummy"
"149681",0,1,0,1,"dummy"
"149682",1,0,0,1,"dummy"
"149683",0,0,1,1,"dummy"
"149684",3,5,0,8,"dummy"
"149685",3,4,1,8,"dummy"
"149686",0,1,0,1,"dummy"
"149687",1,2,0,3,"dummy"
"149688",0,1,0,1,"dummy"
"149689",4,6,0,10,"dummy"
"149690",0,0,0,0,"dummy"
"149692",0,1,1,2,"dummy"
"149693",1,2,1,4,"dummy"
"149694",0,1,1,2,"dummy"
"149696",4,2,2,8,"dummy"
"149697",0,0,2,2,"dummy"
"149709",0,1,0,1,"dummy"
"149710",0,1,0,1,"dummy"
"149711",0,1,0,1,"dummy"
"149712",4,1,2,7,"dummy"
"149713",0,0,1,1,"dummy"
"149714",0,2,0,2,"dummy"
"149715",0,0,2,2,"dummy"
"149716",0,2,0,2,"dummy"
"149717",0,1,0,1,"dummy"
"149718",0,1,0,1,"dummy"
"149719",0,1,0,1,"dummy"
"149720",0,0,1,1,"dummy"
"149721",0,0,1,1,"dummy"
"149722",1,0,0,1,"dummy"
"149726",0,1,0,1,"dummy"
"149727",0,0,1,1,"dummy"
"149730",0,1,1,2,"dummy"
"149731",0,8,0,8,"dummy"
"149732",0,1,0,1,"dummy"
"149733",0,2,0,2,"dummy"
"149735",0,0,1,1,"dummy"
"149736",0,0,2,2,"dummy"
"149737",2,4,1,7,"dummy"
"149738",0,0,2,2,"dummy"
"149739",2,2,0,4,"dummy"
"149741",1,2,0,3,"dummy"
"149793",0,1,0,1,"dummy"
"149796",0,0,0,0,"dummy"
"149798",3,10,0,13,"dummy"
"149799",1,1,0,2,"dummy"
"149800",11,4,0,15,"dummy"
"149802",0,0,1,1,"dummy"
"149803",0,1,0,1,"dummy"
"149808",0,0,0,0,"dummy"
"149812",0,0,1,1,"dummy"
"149814",0,2,0,2,"dummy"
"149845",0,0,1,1,"dummy"
"149849",2,2,1,5,"dummy"
"149851",6,1,0,7,"dummy"
"149853",0,1,1,2,"dummy"
"149854",1,0,0,1,"dummy"
"149856",0,1,0,1,"dummy"
"149857",0,1,1,2,"dummy"
"149859",1,7,0,8,"dummy"
"149865",3,0,0,3,"dummy"
"149871",1,2,0,3,"dummy"
"149874",0,1,0,1,"dummy"
"149875",1,4,0,5,"dummy"
"149880",8,9,0,17,"dummy"
"149881",0,1,1,2,"dummy"
"149882",1,2,1,4,"dummy"
"149883",0,0,1,1,"dummy"
"149888",1,0,0,1,"dummy"
"149891",0,5,1,6,"dummy"
"149892",15,9,10,34,"dummy"
"149914",0,0,0,0,"dummy"
"149915",9,8,5,22,"dummy"
"149916",0,5,0,5,"dummy"
"149917",0,0,1,1,"dummy"
"149918",0,1,0,1,"dummy"
"149921",0,10,0,10,"dummy"
"149922",0,1,0,1,"dummy"
"149923",7,0,0,7,"dummy"
"149924",0,2,0,2,"dummy"
"149925",0,2,0,2,"dummy"
"149926",0,3,0,3,"dummy"
"149927",3,2,1,6,"dummy"
"149928",6,14,0,20,"dummy"
"149929",2,8,0,10,"dummy"
"149930",2,0,0,2,"dummy"
"149931",1,0,0,1,"dummy"
"149932",0,1,0,1,"dummy"
"149933",17,7,1,25,"dummy"
"149934",0,1,0,1,"dummy"
"149935",0,2,0,2,"dummy"
"149936",0,1,0,1,"dummy"
"149937",0,1,0,1,"dummy"
"149938",0,1,0,1,"dummy"
"149939",2,2,1,5,"dummy"
"149940",1,2,2,5,"dummy"
"149956",0,1,1,2,"dummy"
"149959",2,1,1,4,"dummy"
"149960",0,3,0,3,"dummy"
"150048",0,5,2,7,"dummy"
"150049",1,2,0,3,"dummy"
"150050",0,3,0,3,"dummy"
"150051",3,3,0,6,"dummy"
"150052",0,1,0,1,"dummy"
"150053",0,1,0,1,"dummy"
"150054",0,1,1,2,"dummy"
"150055",0,3,1,4,"dummy"
"150056",0,1,0,1,"dummy"
"150057",0,0,1,1,"dummy"
"150058",0,1,0,1,"dummy"
"150065",0,6,0,6,"dummy"
"150066",0,4,0,4,"dummy"
"150080",0,1,0,1,"dummy"
"150081",0,0,1,1,"dummy"
"150084",0,9,0,9,"dummy"
"150085",0,4,0,4,"dummy"
"150086",0,2,0,2,"dummy"
"150087",1,1,0,2,"dummy"
"150088",0,1,0,1,"dummy"
"150089",0,1,0,1,"dummy"
"150090",0,2,0,2,"dummy"
"150091",0,4,0,4,"dummy"
"150092",0,0,0,0,"dummy"
"150101",0,0,1,1,"dummy"
"150102",0,3,1,4,"dummy"
"150103",0,1,1,2,"dummy"
"150104",1,0,1,2,"dummy"
"150105",0,0,1,1,"dummy"
"150106",0,0,1,1,"dummy"
"150107",0,0,1,1,"dummy"
"150108",0,0,1,1,"dummy"
"150111",0,0,1,1,"dummy"
"150112",0,0,1,1,"dummy"
"150118",1,0,0,1,"dummy"
"150119",1,3,0,4,"dummy"
"150120",1,0,0,1,"dummy"
"150121",0,0,0,0,"dummy"
"150122",0,1,0,1,"dummy"
"150123",0,0,0,0,"dummy"
"150124",0,0,2,2,"dummy"
"149869",0,1,0,1,"dummy"
"149877",0,0,5,5,"dummy"
"149878",0,0,4,4,"dummy"
"149885",4,3,1,8,"dummy"
"149886",0,13,0,13,"dummy"
"149942",1,8,4,13,"dummy"
"149943",0,8,1,9,"dummy"
"149944",0,1,0,1,"dummy"
"149945",0,1,0,1,"dummy"
"149946",0,1,0,1,"dummy"
"149947",12,6,1,19,"dummy"
"149948",0,0,3,3,"dummy"
"149949",0,0,1,1,"dummy"
"149950",0,0,6,6,"dummy"
"149951",7,0,0,7,"dummy"
"149952",0,1,0,1,"dummy"
"149953",0,6,0,6,"dummy"
"149954",0,0,0,0,"dummy"
"149966",0,0,1,1,"dummy"
"149967",0,0,1,1,"dummy"
"149968",0,0,1,1,"dummy"
"149969",0,0,1,1,"dummy"
"149970",0,0,1,1,"dummy"
"149971",0,0,1,1,"dummy"
"149972",0,0,1,1,"dummy"
"149973",0,0,1,1,"dummy"
"149974",0,0,1,1,"dummy"
"149975",0,0,1,1,"dummy"
"149976",0,0,1,1,"dummy"
"149977",0,0,1,1,"dummy"
"149978",0,0,1,1,"dummy"
"149979",0,0,1,1,"dummy"
"149980",0,0,1,1,"dummy"
"149981",0,0,1,1,"dummy"
"149982",0,0,1,1,"dummy"
"149983",0,0,1,1,"dummy"
"149984",0,0,1,1,"dummy"
"149985",0,0,1,1,"dummy"
"149986",0,0,1,1,"dummy"
"149987",0,0,1,1,"dummy"
"149988",0,0,1,1,"dummy"
"149989",0,0,1,1,"dummy"
"149990",0,0,1,1,"dummy"
"149991",0,0,1,1,"dummy"
"149992",0,0,1,1,"dummy"
"149993",0,0,1,1,"dummy"
"149994",0,0,1,1,"dummy"
"149995",0,0,2,2,"dummy"
"149996",0,0,1,1,"dummy"
"149997",0,0,1,1,"dummy"
"149998",0,0,1,1,"dummy"
"149999",0,0,1,1,"dummy"
"150000",0,0,1,1,"dummy"
"150001",0,0,1,1,"dummy"
"150002",0,0,1,1,"dummy"
"150003",1,2,0,3,"dummy"
"150004",0,0,0,0,"dummy"
"150005",1,0,0,1,"dummy"
"150006",0,5,1,6,"dummy"
"150007",3,1,0,4,"dummy"
"150008",0,2,0,2,"dummy"
"150009",0,0,1,1,"dummy"
"150010",0,1,1,2,"dummy"
"150011",0,0,1,1,"dummy"
"150012",0,0,1,1,"dummy"
"150013",0,0,1,1,"dummy"
"150014",1,0,1,2,"dummy"
"150015",0,0,1,1,"dummy"
"150016",0,1,1,2,"dummy"
"150017",0,0,1,1,"dummy"
"150018",0,0,0,0,"dummy"
"150019",0,0,5,5,"dummy"
"150020",0,0,2,2,"dummy"
"150021",0,0,1,1,"dummy"
"150022",0,0,1,1,"dummy"
"150023",0,0,2,2,"dummy"
"150024",0,0,5,5,"dummy"
"150025",0,0,1,1,"dummy"
"150026",0,0,1,1,"dummy"
"150027",0,0,1,1,"dummy"
"150028",0,0,1,1,"dummy"
"150029",0,0,1,1,"dummy"
"150030",0,0,1,1,"dummy"
"150031",0,0,1,1,"dummy"
"150032",0,0,1,1,"dummy"
"150033",0,0,1,1,"dummy"
"150034",0,0,1,1,"dummy"
"150035",0,0,1,1,"dummy"
"150036",0,0,1,1,"dummy"
"150037",0,0,1,1,"dummy"
"150038",0,0,1,1,"dummy"
"150039",0,0,1,1,"dummy"
"150040",0,0,1,1,"dummy"
"150041",0,0,1,1,"dummy"
"150042",0,0,1,1,"dummy"
"150043",0,0,1,1,"dummy"
"150044",0,0,1,1,"dummy"
"150045",0,0,1,1,"dummy"
"150046",0,0,1,1,"dummy"
"150060",3,4,1,8,"dummy"
"150061",2,0,1,3,"dummy"
"150062",0,1,0,1,"dummy"
"150063",0,2,0,2,"dummy"
"150068",0,0,0,0,"dummy"
"150069",0,0,0,0,"dummy"
"150073",2,0,2,4,"dummy"
"150074",1,3,0,4,"dummy"
"150075",3,1,0,4,"dummy"
"150076",0,1,0,1,"dummy"
"150077",1,0,0,1,"dummy"
"150078",0,0,1,1,"dummy"
"150096",0,14,0,14,"dummy"
"150097",0,0,0,0,"dummy"
"150098",0,0,0,0,"dummy"
"150099",0,0,0,0,"dummy"
"150116",0,1,0,1,"dummy"
"150126",5,1,0,6,"dummy"
"150127",2,8,0,10,"dummy"
"150128",0,1,0,1,"dummy"
"150129",6,0,0,6,"dummy"
"150130",0,5,0,5,"dummy"
"150133",3,3,1,7,"dummy"
"150136",0,1,0,1,"dummy"
"150137",0,1,0,1,"dummy"
"150138",0,1,0,1,"dummy"
"150139",0,2,0,2,"dummy"
"150140",0,9,0,9,"dummy"
"150164",1,3,2,6,"dummy"
"150204",0,0,1,1,"dummy"
"150217",2,0,0,2,"dummy"
"150223",6,0,0,6,"dummy"
"150224",2,5,2,9,"dummy"
"150227",6,12,3,21,"dummy"
"150228",10,4,2,16,"dummy"
"150229",2,1,0,3,"dummy"
"150230",0,0,5,5,"dummy"
"150231",1,2,0,3,"dummy"
"150232",0,0,0,0,"dummy"
"150233",3,1,1,5,"dummy"
"150246",1,0,0,1,"dummy"
"150249",0,0,1,1,"dummy"
"150250",0,0,1,1,"dummy"
"150253",0,4,0,4,"dummy"
"150258",0,0,0,0,"dummy"
"150261",0,0,0,0,"dummy"
"150262",0,0,0,0,"dummy"
"150291",0,0,1,1,"dummy"
"150369",0,3,1,4,"dummy"
"150370",0,1,0,1,"dummy"
"150371",0,0,1,1,"dummy"
"150374",0,3,2,5,"dummy"
"150375",0,0,2,2,"dummy"
"150376",3,12,1,16,"dummy"
"150377",0,0,2,2,"dummy"
"150378",0,1,0,1,"dummy"
"150379",0,3,2,5,"dummy"
"150380",1,6,0,7,"dummy"
"150142",0,0,1,1,"dummy"
"150143",0,0,0,0,"dummy"
"150148",6,3,1,10,"dummy"
"150153",0,2,0,2,"dummy"
"150172",1,0,1,2,"dummy"
"150173",0,0,1,1,"dummy"
"150176",2,0,0,2,"dummy"
"150177",0,0,2,2,"dummy"
"150182",1,0,0,1,"dummy"
"150206",0,1,0,1,"dummy"
"150219",1,2,0,3,"dummy"
"150243",0,1,0,1,"dummy"
"150244",0,2,0,2,"dummy"
"150264",0,1,2,3,"dummy"
"150265",15,1,0,16,"dummy"
"150266",0,2,0,2,"dummy"
"150267",5,6,0,11,"dummy"
"150268",0,5,0,5,"dummy"
"150269",0,0,1,1,"dummy"
"150270",0,0,1,1,"dummy"
"150271",4,3,2,9,"dummy"
"150272",0,1,0,1,"dummy"
"150273",2,5,0,7,"dummy"
"150274",3,4,0,7,"dummy"
"150275",0,0,1,1,"dummy"
"150276",2,2,0,4,"dummy"
"150277",0,0,1,1,"dummy"
"150278",0,2,0,2,"dummy"
"150279",1,1,2,4,"dummy"
"150280",0,0,1,1,"dummy"
"150281",0,0,1,1,"dummy"
"150282",1,1,1,3,"dummy"
"150283",2,2,0,4,"dummy"
"150284",2,2,0,4,"dummy"
"150285",1,3,0,4,"dummy"
"150286",0,0,1,1,"dummy"
"150287",2,1,0,3,"dummy"
"150288",4,0,1,5,"dummy"
"150289",0,4,1,5,"dummy"
"150293",0,1,0,1,"dummy"
"150420",2,4,0,6,"dummy"
"150466",1,0,0,1,"dummy"
"150467",5,1,0,6,"dummy"
"150468",0,0,3,3,"dummy"
"150469",1,2,0,3,"dummy"
"150470",2,4,0,6,"dummy"
"150471",1,0,0,1,"dummy"
"150472",0,1,0,1,"dummy"
"150473",5,6,2,13,"dummy"
"150474",3,4,4,11,"dummy"
"150475",0,5,0,5,"dummy"
"150476",0,7,0,7,"dummy"
"150477",0,1,1,2,"dummy"
"150478",0,1,0,1,"dummy"
"150479",0,2,0,2,"dummy"
"150480",3,4,0,7,"dummy"
"150481",9,9,4,22,"dummy"
"150523",1,0,0,1,"dummy"
"150524",6,2,0,8,"dummy"
"150525",7,6,1,14,"dummy"
"150526",0,0,1,1,"dummy"
"150381",14,14,3,31,"dummy"
"150382",16,20,3,39,"dummy"
"150383",1,0,0,1,"dummy"
"150384",0,1,0,1,"dummy"
"150385",0,0,1,1,"dummy"
"150386",6,12,3,21,"dummy"
"150387",0,0,1,1,"dummy"
"150388",0,1,0,1,"dummy"
"150389",0,0,1,1,"dummy"
"150390",0,1,4,5,"dummy"
"150391",0,0,1,1,"dummy"
"150392",0,0,2,2,"dummy"
"150393",0,0,2,2,"dummy"
"150394",1,0,2,3,"dummy"
"150395",0,0,2,2,"dummy"
"150396",8,1,1,10,"dummy"
"150397",0,4,2,6,"dummy"
"150398",4,4,2,10,"dummy"
"150399",1,2,0,3,"dummy"
"150400",0,2,0,2,"dummy"
"150401",28,12,5,45,"dummy"
"150402",0,1,2,3,"dummy"
"150403",3,3,0,6,"dummy"
"150404",0,2,0,2,"dummy"
"150405",6,4,1,11,"dummy"
"150406",3,6,1,10,"dummy"
"150407",0,0,2,2,"dummy"
"150408",0,2,0,2,"dummy"
"150409",5,3,0,8,"dummy"
"150410",1,2,0,3,"dummy"
"150411",0,3,0,3,"dummy"
"150412",11,23,6,40,"dummy"
"150413",4,2,0,6,"dummy"
"150414",2,0,7,9,"dummy"
"150415",1,1,1,3,"dummy"
"150416",2,4,0,6,"dummy"
"150417",1,0,0,1,"dummy"
"150418",2,0,0,2,"dummy"
"150493",2,10,1,13,"dummy"
"150494",1,0,1,2,"dummy"
"150495",6,24,2,32,"dummy"
"150496",0,0,0,0,"dummy"
"150497",0,1,0,1,"dummy"
"150498",0,1,0,1,"dummy"
"150499",0,0,0,0,"dummy"
"150500",0,1,0,1,"dummy"
"150501",3,2,2,7,"dummy"
"150502",2,3,0,5,"dummy"
"150503",2,0,0,2,"dummy"
"150506",0,3,0,3,"dummy"
"150507",3,0,0,3,"dummy"
"150508",0,3,0,3,"dummy"
"150509",0,0,1,1,"dummy"
"150510",0,0,1,1,"dummy"
"150513",0,0,0,0,"dummy"
"150514",0,1,0,1,"dummy"
"150515",0,1,1,2,"dummy"
"150516",0,3,0,3,"dummy"
"150517",0,1,0,1,"dummy"
"150518",0,0,1,1,"dummy"
"150519",0,1,0,1,"dummy"
"150520",0,2,0,2,"dummy"
"150521",1,0,5,6,"dummy"
"150528",0,0,0,0,"dummy"
"150529",4,9,1,14,"dummy"
"150530",0,1,0,1,"dummy"
"150531",0,0,0,0,"dummy"
"150536",4,5,1,10,"dummy"
"150537",0,0,0,0,"dummy"
"150544",1,11,0,12,"dummy"
"150562",0,4,0,4,"dummy"
"150572",2,3,4,9,"dummy"
"150573",3,1,0,4,"dummy"
"150576",0,0,0,0,"dummy"
"150595",0,0,1,1,"dummy"
"150598",0,0,0,0,"dummy"
"150599",0,0,0,0,"dummy"
"150600",0,0,0,0,"dummy"
"150601",0,0,0,0,"dummy"
"150604",0,4,0,4,"dummy"
"150617",0,1,0,1,"dummy"
"150620",0,0,2,2,"dummy"
"150541",0,1,0,1,"dummy"
"150542",0,0,1,1,"dummy"
"150548",12,16,0,28,"dummy"
"150549",1,6,5,12,"dummy"
"150550",0,0,1,1,"dummy"
"150551",1,1,2,4,"dummy"
"150552",5,6,1,12,"dummy"
"150553",9,3,3,15,"dummy"
"150554",0,1,0,1,"dummy"
"150555",0,0,1,1,"dummy"
"150556",0,0,1,1,"dummy"
"150557",0,0,1,1,"dummy"
"150558",0,0,1,1,"dummy"
"150559",0,0,1,1,"dummy"
"150560",0,0,1,1,"dummy"
"150568",2,14,1,17,"dummy"
"150569",0,0,0,0,"dummy"
"150570",0,2,0,2,"dummy"
"150578",0,2,0,2,"dummy"
"150579",0,0,1,1,"dummy"
"150580",0,1,0,1,"dummy"
"150581",0,0,0,0,"dummy"
"150582",0,2,0,2,"dummy"
"150583",0,1,0,1,"dummy"
"150584",0,1,0,1,"dummy"
"150585",0,0,1,1,"dummy"
"150586",0,1,0,1,"dummy"
"150587",0,1,0,1,"dummy"
"150588",3,2,1,6,"dummy"
"150589",2,6,2,10,"dummy"
"150590",0,3,0,3,"dummy"
"150591",2,0,0,2,"dummy"
"150592",0,2,1,3,"dummy"
"150593",8,3,1,12,"dummy"
"150610",1,1,1,3,"dummy"
"150611",0,0,1,1,"dummy"
"150612",0,5,1,6,"dummy"
"150613",0,0,1,1,"dummy"
"150614",0,1,2,3,"dummy"
"150615",5,1,1,7,"dummy"
"150655",2,3,0,5,"dummy"
"150656",1,2,0,3,"dummy"
"150657",0,1,0,1,"dummy"
"150658",0,0,0,0,"dummy"
"150659",0,1,0,1,"dummy"
"150660",0,1,0,1,"dummy"
"150661",2,2,1,5,"dummy"
"150662",2,2,0,4,"dummy"
"150663",0,1,0,1,"dummy"
"150664",4,1,0,5,"dummy"
"150667",3,1,0,4,"dummy"
"150668",0,3,0,3,"dummy"
"150669",0,3,0,3,"dummy"
"150670",0,1,0,1,"dummy"
"150671",3,1,0,4,"dummy"
"150672",1,1,0,2,"dummy"
"150688",0,0,1,1,"dummy"
"150689",0,0,0,0,"dummy"
"150696",0,3,0,3,"dummy"
"150697",0,1,0,1,"dummy"
"150701",1,2,1,4,"dummy"
"150702",0,0,1,1,"dummy"
"150703",0,4,1,5,"dummy"
"150723",0,0,0,0,"dummy"
"150724",1,1,0,2,"dummy"
"150725",2,0,0,2,"dummy"
"150726",3,4,0,7,"dummy"
"150727",0,0,3,3,"dummy"
"150728",2,0,3,5,"dummy"
"150729",0,0,1,1,"dummy"
"150733",0,0,0,0,"dummy"
"150734",1,0,0,1,"dummy"
"150735",0,1,0,1,"dummy"
"150736",0,0,1,1,"dummy"
"150737",1,0,0,1,"dummy"
"150738",0,0,0,0,"dummy"
"150674",3,1,0,4,"dummy"
"150675",0,1,0,1,"dummy"
"150676",1,0,0,1,"dummy"
"150677",3,0,0,3,"dummy"
"150678",0,1,0,1,"dummy"
"150679",0,1,0,1,"dummy"
"150682",0,0,1,1,"dummy"
"150683",0,1,0,1,"dummy"
"150684",0,0,1,1,"dummy"
"150685",0,0,0,0,"dummy"
"150686",0,1,0,1,"dummy"
"150691",4,2,0,6,"dummy"
"150692",0,1,0,1,"dummy"
"150693",1,6,0,7,"dummy"
"150694",2,1,0,3,"dummy"
"150699",2,12,0,14,"dummy"
"150713",2,2,0,4,"dummy"
"150714",0,1,0,1,"dummy"
"150715",0,2,0,2,"dummy"
"150716",0,2,0,2,"dummy"
"150717",0,0,0,0,"dummy"
"150718",0,1,0,1,"dummy"
"150719",0,3,0,3,"dummy"
"150731",0,0,1,1,"dummy"
"150754",0,1,0,1,"dummy"
"150755",0,2,0,2,"dummy"
"150756",1,1,1,3,"dummy"
"150758",0,0,1,1,"dummy"
"150759",3,1,0,4,"dummy"
"150760",0,0,2,2,"dummy"
"150761",0,1,0,1,"dummy"
"150762",1,1,0,2,"dummy"
"150763",0,0,2,2,"dummy"
"150764",0,0,2,2,"dummy"
"150765",0,0,2,2,"dummy"
"150766",0,0,2,2,"dummy"
"150767",0,0,2,2,"dummy"
"150768",0,0,2,2,"dummy"
"150769",0,0,2,2,"dummy"
"150770",0,0,2,2,"dummy"
"150771",0,0,2,2,"dummy"
"150772",0,0,2,2,"dummy"
"150773",0,2,2,4,"dummy"
"150774",0,0,2,2,"dummy"
"150775",0,0,1,1,"dummy"
"150776",0,0,1,1,"dummy"
"150777",0,0,2,2,"dummy"
"150795",0,1,0,1,"dummy"
"150805",0,0,2,2,"dummy"
"150806",0,3,1,4,"dummy"
"150807",1,0,0,1,"dummy"
"150808",0,1,0,1,"dummy"
"150819",0,13,1,14,"dummy"
"150820",0,5,1,6,"dummy"
"150821",2,1,3,6,"dummy"
"150822",4,6,2,12,"dummy"
"150831",1,8,0,9,"dummy"
"150834",0,2,0,2,"dummy"
"150835",0,0,1,1,"dummy"
"150854",0,0,2,2,"dummy"
"150855",0,0,1,1,"dummy"
"150745",0,3,3,6,"dummy"
"150746",1,2,1,4,"dummy"
"150747",3,5,1,9,"dummy"
"150748",0,3,1,4,"dummy"
"150749",0,0,0,0,"dummy"
"150750",0,11,0,11,"dummy"
"150797",0,1,0,1,"dummy"
"150798",1,2,0,3,"dummy"
"150801",0,0,1,1,"dummy"
"150802",0,0,1,1,"dummy"
"150803",0,2,0,2,"dummy"
"150810",1,2,1,4,"dummy"
"150811",9,3,1,13,"dummy"
"150812",1,6,0,7,"dummy"
"150813",0,0,1,1,"dummy"
"150814",0,1,1,2,"dummy"
"150815",1,0,0,1,"dummy"
"150816",0,1,0,1,"dummy"
"150817",0,1,0,1,"dummy"
"150839",0,5,0,5,"dummy"
"150840",0,8,1,9,"dummy"
"150892",0,0,0,0,"dummy"
"150893",0,2,0,2,"dummy"
"150895",1,0,0,1,"dummy"
"150897",0,2,0,2,"dummy"
"150898",0,0,0,0,"dummy"
"150899",2,5,0,7,"dummy"
"150900",0,0,1,1,"dummy"
"150901",13,9,1,23,"dummy"
"150902",2,8,2,12,"dummy"
"150903",0,0,1,1,"dummy"
"150904",6,6,0,12,"dummy"
"150907",0,4,0,4,"dummy"
"150908",7,1,3,11,"dummy"
"150910",0,5,0,5,"dummy"
"150911",0,8,1,9,"dummy"
"150913",0,0,1,1,"dummy"
"150914",3,0,0,3,"dummy"
"150917",0,0,1,1,"dummy"
"150925",1,2,2,5,"dummy"
"150935",0,1,3,4,"dummy"
"150953",0,15,1,16,"dummy"
"150954",1,1,1,3,"dummy"
"150955",0,0,2,2,"dummy"
"150956",0,1,0,1,"dummy"
"150959",5,2,5,12,"dummy"
"150960",0,0,1,1,"dummy"
"150963",0,0,1,1,"dummy"
"150964",0,0,0,0,"dummy"
"150965",2,1,0,3,"dummy"
"150966",1,0,0,1,"dummy"
"150967",0,0,0,0,"dummy"
"150993",0,2,0,2,"dummy"
"150994",1,9,0,10,"dummy"
"150997",3,0,0,3,"dummy"
"151000",0,3,0,3,"dummy"
"151001",0,1,0,1,"dummy"
"151004",7,3,3,13,"dummy"
"151006",0,0,0,0,"dummy"
"151007",0,0,1,1,"dummy"
"151008",0,0,1,1,"dummy"
"151009",0,2,3,5,"dummy"
"151011",0,0,2,2,"dummy"
"151012",0,0,1,1,"dummy"
"151013",1,27,2,30,"dummy"
"151014",6,11,0,17,"dummy"
"151015",0,1,0,1,"dummy"
"151016",0,3,0,3,"dummy"
"151017",7,25,0,32,"dummy"
"151018",3,6,0,9,"dummy"
"151019",28,5,1,34,"dummy"
"151021",1,0,0,1,"dummy"
"151022",0,0,1,1,"dummy"
"151023",1,1,0,2,"dummy"
"151024",0,0,1,1,"dummy"
"151025",0,1,0,1,"dummy"
"151026",0,2,0,2,"dummy"
"151027",0,0,2,2,"dummy"
"151028",0,2,0,2,"dummy"
"151029",2,0,0,2,"dummy"
"151030",0,2,0,2,"dummy"
"151031",4,1,0,5,"dummy"
"151032",1,0,0,1,"dummy"
"151033",0,2,0,2,"dummy"
"151034",0,0,0,0,"dummy"
"151035",0,0,0,0,"dummy"
"151039",0,2,0,2,"dummy"
"151040",0,6,0,6,"dummy"
"151041",1,0,2,3,"dummy"
"151042",1,1,0,2,"dummy"
"151050",0,0,1,1,"dummy"
"151051",0,0,1,1,"dummy"
"151052",0,0,1,1,"dummy"
"151053",0,0,1,1,"dummy"
"151054",0,0,2,2,"dummy"
"151055",0,0,1,1,"dummy"
"151056",0,0,1,1,"dummy"
"151057",0,0,1,1,"dummy"
"151058",0,0,1,1,"dummy"
"151059",0,0,1,1,"dummy"
"151060",0,0,1,1,"dummy"
"151061",0,0,1,1,"dummy"
"151062",0,0,1,1,"dummy"
"151063",0,0,1,1,"dummy"
"151064",0,0,1,1,"dummy"
"151065",0,0,1,1,"dummy"
"151066",0,0,1,1,"dummy"
"151067",0,0,1,1,"dummy"
"151068",0,0,1,1,"dummy"
"151069",0,0,1,1,"dummy"
"151070",0,0,1,1,"dummy"
"151071",0,0,1,1,"dummy"
"151072",0,0,1,1,"dummy"
"151073",0,0,1,1,"dummy"
"151074",0,0,1,1,"dummy"
"151075",0,0,1,1,"dummy"
"151076",0,0,1,1,"dummy"
"151077",0,0,1,1,"dummy"
"151078",0,0,1,1,"dummy"
"151079",0,0,1,1,"dummy"
"151083",1,1,0,2,"dummy"
"151084",0,0,1,1,"dummy"
"151086",0,2,0,2,"dummy"
"151087",0,0,1,1,"dummy"
"151088",0,0,1,1,"dummy"
"151089",0,3,0,3,"dummy"
"151090",0,0,1,1,"dummy"
"151099",2,1,2,5,"dummy"
"151100",1,3,3,7,"dummy"
"151102",0,0,1,1,"dummy"
"151103",0,0,0,0,"dummy"
"151104",0,0,1,1,"dummy"
"151105",0,0,0,0,"dummy"
"151108",0,0,1,1,"dummy"
"151109",0,0,1,1,"dummy"
"151110",0,0,1,1,"dummy"
"151124",0,0,2,2,"dummy"
"151125",0,0,1,1,"dummy"
"151126",0,0,1,1,"dummy"
"151127",1,0,0,1,"dummy"
"151130",0,3,0,3,"dummy"
"151131",0,1,0,1,"dummy"
"151133",1,7,0,8,"dummy"
"151135",0,0,2,2,"dummy"
"151138",2,0,2,4,"dummy"
"151140",0,0,1,1,"dummy"
"151141",2,3,3,8,"dummy"
"151142",0,1,0,1,"dummy"
"151144",0,4,1,5,"dummy"
"151145",0,0,1,1,"dummy"
"151147",2,4,0,6,"dummy"
"151148",0,2,0,2,"dummy"
"151149",0,2,0,2,"dummy"
"151150",10,2,0,12,"dummy"
"151151",0,2,0,2,"dummy"
"151152",0,0,0,0,"dummy"
"151153",0,0,3,3,"dummy"
"151154",0,5,0,5,"dummy"
"151156",1,1,2,4,"dummy"
"151157",0,1,0,1,"dummy"
"151159",0,4,1,5,"dummy"
"151160",0,1,0,1,"dummy"
"151161",0,10,1,11,"dummy"
"151162",2,4,0,6,"dummy"
"151163",0,1,0,1,"dummy"
"151164",0,0,1,1,"dummy"
"151165",5,6,3,14,"dummy"
"151166",2,5,0,7,"dummy"
"151167",1,2,0,3,"dummy"
"151168",0,1,0,1,"dummy"
"151169",9,0,0,9,"dummy"
"151170",0,0,2,2,"dummy"
"151171",0,0,2,2,"dummy"
"151174",0,0,1,1,"dummy"
"151175",4,7,1,12,"dummy"
"151176",0,0,1,1,"dummy"
"151181",0,0,3,3,"dummy"
"151199",0,0,2,2,"dummy"
"151203",0,4,1,5,"dummy"
"151204",0,0,1,1,"dummy"
"151205",0,1,0,1,"dummy"
"151206",0,6,0,6,"dummy"
"151207",0,1,0,1,"dummy"
"151208",1,2,1,4,"dummy"
"151209",0,0,3,3,"dummy"
"151211",10,3,2,15,"dummy"
"151212",0,3,0,3,"dummy"
"151215",0,7,0,7,"dummy"
"151216",3,10,5,18,"dummy"
"151217",1,2,0,3,"dummy"
"151218",0,0,0,0,"dummy"
"151219",0,1,1,2,"dummy"
"151220",0,1,0,1,"dummy"
"151221",0,1,0,1,"dummy"
"151225",0,0,1,1,"dummy"
"151233",0,2,1,3,"dummy"
"151234",0,0,0,0,"dummy"
"151236",3,0,2,5,"dummy"
"151237",0,0,2,2,"dummy"
"151238",1,1,3,5,"dummy"
"151239",0,1,2,3,"dummy"
"151240",0,3,2,5,"dummy"
"151241",0,0,0,0,"dummy"
"151242",7,2,4,13,"dummy"
"151243",0,2,0,2,"dummy"
"151244",1,2,4,7,"dummy"
"151247",0,0,1,1,"dummy"
"151248",0,0,0,0,"dummy"
"151251",1,4,0,5,"dummy"
"151252",0,1,0,1,"dummy"
"151253",24,9,1,34,"dummy"
"151255",0,0,1,1,"dummy"
"151256",3,3,3,9,"dummy"
"151258",1,2,2,5,"dummy"
"151260",1,4,0,5,"dummy"
"151265",5,7,4,16,"dummy"
"151266",5,6,5,16,"dummy"
"151267",1,0,0,1,"dummy"
"151272",1,1,0,2,"dummy"
"151274",1,0,0,1,"dummy"
"151275",0,0,2,2,"dummy"
"151276",0,5,3,8,"dummy"
"151277",2,1,1,4,"dummy"
"151278",11,1,2,14,"dummy"
"151279",0,2,2,4,"dummy"
"151280",0,0,1,1,"dummy"
"151281",0,0,3,3,"dummy"
"151282",7,0,2,9,"dummy"
"151283",0,0,1,1,"dummy"
"151284",0,1,0,1,"dummy"
"151285",0,0,1,1,"dummy"
"151287",2,2,0,4,"dummy"
"151288",0,2,0,2,"dummy"
"151289",7,4,2,13,"dummy"
"151290",1,7,1,9,"dummy"
"151291",0,1,0,1,"dummy"
"151293",0,1,2,3,"dummy"
"151294",0,1,0,1,"dummy"
"151295",2,5,0,7,"dummy"
"151297",0,2,0,2,"dummy"
"151299",5,15,2,22,"dummy"
"151302",2,0,1,3,"dummy"
"151303",0,0,1,1,"dummy"
"151304",1,2,2,5,"dummy"
"151313",2,4,0,6,"dummy"
"151314",0,2,0,2,"dummy"
"151315",0,2,0,2,"dummy"
"151316",10,2,0,12,"dummy"
"151317",0,2,0,2,"dummy"
"151321",1,0,1,2,"dummy"
"151322",0,9,3,12,"dummy"
"151323",9,0,3,12,"dummy"
"151324",0,9,3,12,"dummy"
"151325",0,0,0,0,"dummy"
"151326",9,0,3,12,"dummy"
"151327",0,10,3,13,"dummy"
"151328",10,0,3,13,"dummy"
"151329",0,11,1,12,"dummy"
"151330",0,5,2,7,"dummy"
"151331",8,7,1,16,"dummy"
"151332",0,0,2,2,"dummy"
"151333",7,0,0,7,"dummy"
"151334",9,0,1,10,"dummy"
"151335",0,9,2,11,"dummy"
"151336",9,0,1,10,"dummy"
"151337",0,0,1,1,"dummy"
"151338",0,1,0,1,"dummy"
"151339",0,0,1,1,"dummy"
"151340",0,1,0,1,"dummy"
"151341",0,1,1,2,"dummy"
"151342",0,2,1,3,"dummy"
"151343",3,3,0,6,"dummy"
"151344",3,3,1,7,"dummy"
"151345",0,1,1,2,"dummy"
"151346",0,0,1,1,"dummy"
"151350",0,0,1,1,"dummy"
"151354",0,0,1,1,"dummy"
"151356",1,1,2,4,"dummy"
"151357",0,0,0,0,"dummy"
"151368",0,0,2,2,"dummy"
"151369",4,2,0,6,"dummy"
"151370",1,0,0,1,"dummy"
"151371",2,4,0,6,"dummy"
"151372",0,10,1,11,"dummy"
"151373",0,1,0,1,"dummy"
"151375",0,0,1,1,"dummy"
"151376",0,0,0,0,"dummy"
"151377",0,1,0,1,"dummy"
"151378",1,2,0,3,"dummy"
"151379",0,1,0,1,"dummy"
"151380",1,10,1,12,"dummy"
"151381",1,1,0,2,"dummy"
"151382",0,1,0,1,"dummy"
"151383",7,2,0,9,"dummy"
"151384",0,1,0,1,"dummy"
"151385",0,0,1,1,"dummy"
"151386",0,0,2,2,"dummy"
"151387",0,0,1,1,"dummy"
"151388",0,0,1,1,"dummy"
"151389",0,0,1,1,"dummy"
"151390",0,0,1,1,"dummy"
"151391",0,0,1,1,"dummy"
"151392",0,0,4,4,"dummy"
"151393",0,0,0,0,"dummy"
"151394",0,2,1,3,"dummy"
"151395",2,0,2,4,"dummy"
"151396",0,2,1,3,"dummy"
"151397",0,0,1,1,"dummy"
"151398",0,0,1,1,"dummy"
"151399",0,2,0,2,"dummy"
"151400",4,2,0,6,"dummy"
"151401",0,2,0,2,"dummy"
"151402",0,0,1,1,"dummy"
"151403",0,0,1,1,"dummy"
"151404",0,0,1,1,"dummy"
"151405",0,0,1,1,"dummy"
"151406",5,2,1,8,"dummy"
"151407",0,4,1,5,"dummy"
"151408",3,1,0,4,"dummy"
"151411",1,3,0,4,"dummy"
"151412",0,1,0,1,"dummy"
"151413",0,0,1,1,"dummy"
"151414",0,1,0,1,"dummy"
"151419",0,0,0,0,"dummy"
"151420",0,0,0,0,"dummy"
"151423",1,1,0,2,"dummy"
"151427",1,1,0,2,"dummy"
"151428",0,0,1,1,"dummy"
"151429",0,0,1,1,"dummy"
"151431",0,1,2,3,"dummy"
"151432",0,0,1,1,"dummy"
"151433",0,0,2,2,"dummy"
"151436",2,0,1,3,"dummy"
"151448",0,0,0,0,"dummy"
"151449",11,4,2,17,"dummy"
"151450",1,0,2,3,"dummy"
"151455",0,0,1,1,"dummy"
"151457",0,0,1,1,"dummy"
"151464",0,3,1,4,"dummy"
"151465",22,22,1,45,"dummy"
"151466",6,10,0,16,"dummy"
"151467",2,0,0,2,"dummy"
"151468",0,2,0,2,"dummy"
"151469",0,2,0,2,"dummy"
"151470",0,0,0,0,"dummy"
"151471",10,5,0,15,"dummy"
"151472",0,0,0,0,"dummy"
"151476",0,0,1,1,"dummy"
"151478",0,2,0,2,"dummy"
"151479",0,0,1,1,"dummy"
"151480",0,0,1,1,"dummy"
"151481",2,0,2,4,"dummy"
"151482",0,0,1,1,"dummy"
"151483",0,0,2,2,"dummy"
"151486",0,0,0,0,"dummy"
"151487",1,0,0,1,"dummy"
"151488",0,0,0,0,"dummy"
"151489",5,4,2,11,"dummy"
"151490",0,0,1,1,"dummy"
"151495",0,0,1,1,"dummy"
"151515",0,0,0,0,"dummy"
"151516",0,1,0,1,"dummy"
"151517",0,0,2,2,"dummy"
"151518",0,0,1,1,"dummy"
"151519",0,2,0,2,"dummy"
"151524",12,24,1,37,"dummy"
"151526",0,0,2,2,"dummy"
"151527",0,0,2,2,"dummy"
"151528",7,3,3,13,"dummy"
"151529",0,0,1,1,"dummy"
"151530",0,0,1,1,"dummy"
"151531",0,17,1,18,"dummy"
"151532",0,1,0,1,"dummy"
"151533",0,0,1,1,"dummy"
"151534",0,0,2,2,"dummy"
"151535",0,1,4,5,"dummy"
"151537",0,3,0,3,"dummy"
"151538",0,2,0,2,"dummy"
"151540",0,0,1,1,"dummy"
"151541",1,5,3,9,"dummy"
"151543",0,3,0,3,"dummy"
"151549",0,1,0,1,"dummy"
"151550",1,1,2,4,"dummy"
"151557",0,1,3,4,"dummy"
"151558",2,7,3,12,"dummy"
"151560",0,0,0,0,"dummy"
"151561",0,0,0,0,"dummy"
"151562",0,0,0,0,"dummy"
"151563",0,0,0,0,"dummy"
"151565",0,6,1,7,"dummy"
"151566",0,0,1,1,"dummy"
"151567",1,20,0,21,"dummy"
"151568",21,4,0,25,"dummy"
"151569",2,0,0,2,"dummy"
"151570",1,21,0,22,"dummy"
"151571",0,1,1,2,"dummy"
"151572",0,1,0,1,"dummy"
"151575",0,0,0,0,"dummy"
"151590",0,4,0,4,"dummy"
"151591",0,0,1,1,"dummy"
"151592",0,0,1,1,"dummy"
"151593",6,10,0,16,"dummy"
"151596",1,13,0,14,"dummy"
"151597",0,0,1,1,"dummy"
"151598",4,1,1,6,"dummy"
"151599",0,4,0,4,"dummy"
"151600",3,12,1,16,"dummy"
"151602",1,0,0,1,"dummy"
"151605",1,3,1,5,"dummy"
"151607",0,1,0,1,"dummy"
"151608",1,1,1,3,"dummy"
"151609",0,2,0,2,"dummy"
"151610",0,0,0,0,"dummy"
"151612",0,0,2,2,"dummy"
"151660",0,0,0,0,"dummy"
"151662",0,1,0,1,"dummy"
"151663",1,4,0,5,"dummy"
"151664",6,2,3,11,"dummy"
"151665",2,0,0,2,"dummy"
"151667",0,2,1,3,"dummy"
"151668",3,7,2,12,"dummy"
"151669",1,2,0,3,"dummy"
"151672",0,0,0,0,"dummy"
"151673",0,1,0,1,"dummy"
"151674",0,2,2,4,"dummy"
"151675",0,1,0,1,"dummy"
"151677",0,1,0,1,"dummy"
"151678",0,2,0,2,"dummy"
"151683",2,3,2,7,"dummy"
"151685",0,5,0,5,"dummy"
"151686",0,2,0,2,"dummy"
"151687",0,2,1,3,"dummy"
"151688",1,2,1,4,"dummy"
"151689",2,5,1,8,"dummy"
"151690",0,0,0,0,"dummy"
"151693",0,0,0,0,"dummy"
"151694",0,0,0,0,"dummy"
"151695",0,0,0,0,"dummy"
"151696",0,0,0,0,"dummy"
"151698",0,0,2,2,"dummy"
"151699",0,0,2,2,"dummy"
"151702",12,8,2,22,"dummy"
"151703",3,1,0,4,"dummy"
"151705",0,0,1,1,"dummy"
"151706",0,0,1,1,"dummy"
"151707",0,0,1,1,"dummy"
"151710",0,1,2,3,"dummy"
"151711",3,4,2,9,"dummy"
"151712",1,1,1,3,"dummy"
"151719",0,4,0,4,"dummy"
"151720",0,0,1,1,"dummy"
"151721",0,0,1,1,"dummy"
"151722",1,6,1,8,"dummy"
"151723",1,2,3,6,"dummy"
"151724",2,2,0,4,"dummy"
"151725",4,1,0,5,"dummy"
"151726",36,12,3,51,"dummy"
"151727",0,2,0,2,"dummy"
"151731",1,1,0,2,"dummy"
"151732",0,0,0,0,"dummy"
"151733",0,1,0,1,"dummy"
"151734",1,1,0,2,"dummy"
"151735",0,0,2,2,"dummy"
"151736",0,0,1,1,"dummy"
"151742",0,4,0,4,"dummy"
"151743",0,2,0,2,"dummy"
"151754",0,0,1,1,"dummy"
"151763",0,3,1,4,"dummy"
"151765",0,0,1,1,"dummy"
"151766",30,74,5,109,"dummy"
"151767",3,5,4,12,"dummy"
"151768",0,0,0,0,"dummy"
"151770",0,1,0,1,"dummy"
"151773",0,0,1,1,"dummy"
"151774",22,8,7,37,"dummy"
"151775",0,0,1,1,"dummy"
"151779",0,1,0,1,"dummy"
"151782",0,4,0,4,"dummy"
"151783",5,2,0,7,"dummy"
"151786",0,0,1,1,"dummy"
"151787",0,1,1,2,"dummy"
"151788",0,1,0,1,"dummy"
"151789",1,0,1,2,"dummy"
"151790",0,0,1,1,"dummy"
"151800",0,4,0,4,"dummy"
"151801",3,0,1,4,"dummy"
"151803",2,0,3,5,"dummy"
"151804",1,0,0,1,"dummy"
"151805",0,1,0,1,"dummy"
"151806",0,1,1,2,"dummy"
"151813",0,0,0,0,"dummy"
"151814",2,0,0,2,"dummy"
"151815",0,1,0,1,"dummy"
"151820",0,2,1,3,"dummy"
"151824",0,0,0,0,"dummy"
"151825",0,0,0,0,"dummy"
"151826",0,0,0,0,"dummy"
"151827",0,0,0,0,"dummy"
"151828",0,0,0,0,"dummy"
"151829",0,0,0,0,"dummy"
"151831",0,0,0,0,"dummy"
"151832",1,4,1,6,"dummy"
"151833",8,5,3,16,"dummy"
"151834",2,5,2,9,"dummy"
"151835",0,1,0,1,"dummy"
"151836",3,9,0,12,"dummy"
"151837",1,0,0,1,"dummy"
"151839",0,0,1,1,"dummy"
"151841",1,0,0,1,"dummy"
"151842",11,37,4,52,"dummy"
"151844",14,13,1,28,"dummy"
"151845",0,3,0,3,"dummy"
"151846",0,0,3,3,"dummy"
"151847",0,0,2,2,"dummy"
"151848",0,0,0,0,"dummy"
"151849",0,1,0,1,"dummy"
"151850",7,0,0,7,"dummy"
"151851",0,1,0,1,"dummy"
"151853",0,4,0,4,"dummy"
"151854",2,7,0,9,"dummy"
"151855",0,1,0,1,"dummy"
"151856",0,1,0,1,"dummy"
"151857",0,1,0,1,"dummy"
"151867",0,0,2,2,"dummy"
"151868",0,0,1,1,"dummy"
"151869",0,7,2,9,"dummy"
"151870",0,0,2,2,"dummy"
"151871",0,0,1,1,"dummy"
"151872",3,5,2,10,"dummy"
"151873",0,0,2,2,"dummy"
"151874",0,0,1,1,"dummy"
"151875",2,2,2,6,"dummy"
"151876",0,0,2,2,"dummy"
"151877",0,0,1,1,"dummy"
"151878",0,2,2,4,"dummy"
"151879",1,1,2,4,"dummy"
"151880",0,0,1,1,"dummy"
"151881",0,0,2,2,"dummy"
"151882",0,0,1,1,"dummy"
"151883",0,0,1,1,"dummy"
"151884",1,2,2,5,"dummy"
"151885",1,1,2,4,"dummy"
"151886",0,0,2,2,"dummy"
"151887",0,0,1,1,"dummy"
"151896",0,0,0,0,"dummy"
"151903",0,0,1,1,"dummy"
"151908",0,1,0,1,"dummy"
"151909",0,0,1,1,"dummy"
"151910",0,0,1,1,"dummy"
"151911",0,0,1,1,"dummy"
"151912",0,0,1,1,"dummy"
"151913",0,0,1,1,"dummy"
"151922",5,9,0,14,"dummy"
"151925",0,0,2,2,"dummy"
"151926",8,1,2,11,"dummy"
"151927",0,0,1,1,"dummy"
"151928",0,4,3,7,"dummy"
"151929",0,0,0,0,"dummy"
"151930",1,1,0,2,"dummy"
"151959",0,2,1,3,"dummy"
"151960",3,3,0,6,"dummy"
"151963",0,3,0,3,"dummy"
"151969",0,2,0,2,"dummy"
"151979",4,1,1,6,"dummy"
"151980",0,3,0,3,"dummy"
"151981",0,0,0,0,"dummy"
"152005",0,2,0,2,"dummy"
"152006",0,0,1,1,"dummy"
"152007",0,2,1,3,"dummy"
"152008",0,1,0,1,"dummy"
"152009",1,0,0,1,"dummy"
"152010",0,1,0,1,"dummy"
"152011",0,0,1,1,"dummy"
"152012",0,2,0,2,"dummy"
"152013",0,1,0,1,"dummy"
"152014",1,0,0,1,"dummy"
"152015",2,0,7,9,"dummy"
"151891",0,1,0,1,"dummy"
"151892",0,0,0,0,"dummy"
"151900",0,1,0,1,"dummy"
"151901",0,0,1,1,"dummy"
"151915",4,0,2,6,"dummy"
"151916",0,2,0,2,"dummy"
"151917",2,4,2,8,"dummy"
"151918",4,2,2,8,"dummy"
"151919",5,3,1,9,"dummy"
"151920",0,2,0,2,"dummy"
"151934",4,9,1,14,"dummy"
"151935",9,4,1,14,"dummy"
"151936",0,1,0,1,"dummy"
"151937",3,3,0,6,"dummy"
"151938",0,1,1,2,"dummy"
"151939",0,0,1,1,"dummy"
"151940",0,0,0,0,"dummy"
"151941",3,4,0,7,"dummy"
"151942",2,2,1,5,"dummy"
"151943",0,1,0,1,"dummy"
"151944",0,0,1,1,"dummy"
"151945",0,6,2,8,"dummy"
"151946",0,0,0,0,"dummy"
"151947",0,0,0,0,"dummy"
"151948",0,0,4,4,"dummy"
"151951",1,4,2,7,"dummy"
"151952",0,1,0,1,"dummy"
"151953",11,4,1,16,"dummy"
"151954",0,0,1,1,"dummy"
"151955",2,2,1,5,"dummy"
"151956",0,0,1,1,"dummy"
"151957",0,0,0,0,"dummy"
"151967",3,0,0,3,"dummy"
"151971",1,2,2,5,"dummy"
"151972",1,1,0,2,"dummy"
"151973",2,3,0,5,"dummy"
"151974",0,0,0,0,"dummy"
"151975",0,1,0,1,"dummy"
"151987",0,1,0,1,"dummy"
"151995",0,0,1,1,"dummy"
"151998",2,4,0,6,"dummy"
"151999",0,2,0,2,"dummy"
"152000",0,2,0,2,"dummy"
"152001",10,2,0,12,"dummy"
"152002",0,2,0,2,"dummy"
"152003",0,0,0,0,"dummy"
"152017",3,0,0,3,"dummy"
"152018",0,0,0,0,"dummy"
"152021",2,2,0,4,"dummy"
"152024",0,2,5,7,"dummy"
"152025",11,9,1,21,"dummy"
"152030",0,0,1,1,"dummy"
"152031",1,0,0,1,"dummy"
"152032",0,0,1,1,"dummy"
"152033",0,0,0,0,"dummy"
"152034",0,0,0,0,"dummy"
"152036",0,11,0,11,"dummy"
"152037",1,0,2,3,"dummy"
"152038",0,0,2,2,"dummy"
"152040",1,19,1,21,"dummy"
"152041",15,4,0,19,"dummy"
"152042",0,0,2,2,"dummy"
"152043",1,1,0,2,"dummy"
"152044",3,9,0,12,"dummy"
"152046",4,0,1,5,"dummy"
"152047",1,2,0,3,"dummy"
"152048",3,5,1,9,"dummy"
"152049",6,3,0,9,"dummy"
"152052",0,1,0,1,"dummy"
"152060",0,0,0,0,"dummy"
"152062",0,0,1,1,"dummy"
"152066",0,4,0,4,"dummy"
"152067",4,3,1,8,"dummy"
"152068",0,4,0,4,"dummy"
"152069",0,0,0,0,"dummy"
"152070",8,9,0,17,"dummy"
"152071",0,0,9,9,"dummy"
"152072",0,0,0,0,"dummy"
"152087",4,14,3,21,"dummy"
"152094",15,3,3,21,"dummy"
"152097",0,4,0,4,"dummy"
"152098",0,0,0,0,"dummy"
"152099",0,1,0,1,"dummy"
"152101",0,1,0,1,"dummy"
"152102",0,0,1,1,"dummy"
"152103",4,6,0,10,"dummy"
"152104",0,6,0,6,"dummy"
"152105",3,0,0,3,"dummy"
"152106",0,0,1,1,"dummy"
"152107",0,0,1,1,"dummy"
"152108",0,0,3,3,"dummy"
"152110",0,0,1,1,"dummy"
"152111",0,1,1,2,"dummy"
"152112",0,1,0,1,"dummy"
"152113",9,1,1,11,"dummy"
"152114",0,1,5,6,"dummy"
"152115",1,20,2,23,"dummy"
"152116",7,2,3,12,"dummy"
"152117",0,1,0,1,"dummy"
"152120",0,1,0,1,"dummy"
"152121",0,1,0,1,"dummy"
"152122",1,2,0,3,"dummy"
"152123",1,0,0,1,"dummy"
"152125",0,0,1,1,"dummy"
"152126",4,2,1,7,"dummy"
"152127",8,21,3,32,"dummy"
"152128",1,1,0,2,"dummy"
"152129",0,1,0,1,"dummy"
"152130",13,2,2,17,"dummy"
"152131",2,1,0,3,"dummy"
"152132",0,1,0,1,"dummy"
"152133",0,0,0,0,"dummy"
"152134",1,6,1,8,"dummy"
"152135",1,1,0,2,"dummy"
"152136",0,1,0,1,"dummy"
"152137",1,2,0,3,"dummy"
"152138",0,1,0,1,"dummy"
"152139",4,4,1,9,"dummy"
"152140",1,0,0,1,"dummy"
"152141",1,0,0,1,"dummy"
"152142",0,1,1,2,"dummy"
"152143",0,0,2,2,"dummy"
"152144",0,0,0,0,"dummy"
"152146",0,0,1,1,"dummy"
"152148",5,2,1,8,"dummy"
"152149",1,3,2,6,"dummy"
"152154",8,1,1,10,"dummy"
"152155",0,0,1,1,"dummy"
"152156",0,1,0,1,"dummy"
"152157",0,0,1,1,"dummy"
"152164",0,4,0,4,"dummy"
"152165",0,1,1,2,"dummy"
"152166",0,0,1,1,"dummy"
"152167",0,1,2,3,"dummy"
"152168",0,1,0,1,"dummy"
"152169",0,1,0,1,"dummy"
"152170",0,1,0,1,"dummy"
"152171",0,1,1,2,"dummy"
"152172",11,7,4,22,"dummy"
"152173",0,0,1,1,"dummy"
"152174",0,2,0,2,"dummy"
"152175",0,1,0,1,"dummy"
"152176",0,1,1,2,"dummy"
"152183",13,2,3,18,"dummy"
"152184",0,1,0,1,"dummy"
"152187",12,5,2,19,"dummy"
"152188",0,0,1,1,"dummy"
"152190",0,0,1,1,"dummy"
"152191",0,3,0,3,"dummy"
"152192",7,5,2,14,"dummy"
"152193",0,0,1,1,"dummy"
"152194",2,4,0,6,"dummy"
"152195",4,2,0,6,"dummy"
"152196",0,0,1,1,"dummy"
"152197",0,0,1,1,"dummy"
"152198",0,0,1,1,"dummy"
"152199",0,0,1,1,"dummy"
"152200",0,0,1,1,"dummy"
"152205",0,0,2,2,"dummy"
"152206",0,0,1,1,"dummy"
"152207",0,0,2,2,"dummy"
"152208",0,0,2,2,"dummy"
"152209",0,0,2,2,"dummy"
"152210",0,0,1,1,"dummy"
"152211",0,0,2,2,"dummy"
"152248",0,0,1,1,"dummy"
"152250",2,0,3,5,"dummy"
"152251",1,0,0,1,"dummy"
"152252",0,1,0,1,"dummy"
"152253",0,1,1,2,"dummy"
"152256",0,1,3,4,"dummy"
"152257",0,0,2,2,"dummy"
"152263",0,0,3,3,"dummy"
"152264",0,0,1,1,"dummy"
"152265",0,1,0,1,"dummy"
"152266",2,1,0,3,"dummy"
"152267",1,2,0,3,"dummy"
"152268",1,0,0,1,"dummy"
"152270",0,0,4,4,"dummy"
"152271",2,10,0,12,"dummy"
"152274",1,0,5,6,"dummy"
"152275",0,0,1,1,"dummy"
"152276",0,3,0,3,"dummy"
"152281",0,0,0,0,"dummy"
"152286",0,0,0,0,"dummy"
"152287",2,9,2,13,"dummy"
"152288",0,0,1,1,"dummy"
"152289",0,0,1,1,"dummy"
"152292",1,0,1,2,"dummy"
"152293",1,0,0,1,"dummy"
"152295",0,15,0,15,"dummy"
"152297",0,0,0,0,"dummy"
"152298",0,0,0,0,"dummy"
"152310",4,3,0,7,"dummy"
"152311",0,0,0,0,"dummy"
"152333",0,0,1,1,"dummy"
"152334",0,1,4,5,"dummy"
"152335",0,0,1,1,"dummy"
"152336",0,0,1,1,"dummy"
"152337",0,0,1,1,"dummy"
"152338",0,0,1,1,"dummy"
"152360",0,0,2,2,"dummy"
"152382",0,0,0,0,"dummy"
"152383",0,0,1,1,"dummy"
"152384",3,0,0,3,"dummy"
"152385",0,0,1,1,"dummy"
"152386",0,1,0,1,"dummy"
"152387",0,2,0,2,"dummy"
"152388",0,0,0,0,"dummy"
"152389",0,0,0,0,"dummy"
"152390",4,1,0,5,"dummy"
"152391",1,0,0,1,"dummy"
"152392",0,0,0,0,"dummy"
"152393",0,0,0,0,"dummy"
"152400",0,0,0,0,"dummy"
"152403",0,0,1,1,"dummy"
"152404",0,0,1,1,"dummy"
"152405",0,0,1,1,"dummy"
"152406",0,0,1,1,"dummy"
"152407",0,0,1,1,"dummy"
"152410",0,4,0,4,"dummy"
"152411",3,0,0,3,"dummy"
"152412",0,0,1,1,"dummy"
"152413",0,8,2,10,"dummy"
"152414",0,10,0,10,"dummy"
"152415",5,0,2,7,"dummy"
"152416",0,0,1,1,"dummy"
"152417",0,0,0,0,"dummy"
"152418",0,0,3,3,"dummy"
"152421",6,0,0,6,"dummy"
"152422",2,5,2,9,"dummy"
"152438",0,0,1,1,"dummy"
"152444",0,12,0,12,"dummy"
"152465",0,2,0,2,"dummy"
"152466",0,2,0,2,"dummy"
"152467",0,1,0,1,"dummy"
"152468",1,1,0,2,"dummy"
"152469",0,1,0,1,"dummy"
"152492",6,0,0,6,"dummy"
"152493",2,5,2,9,"dummy"
"152511",0,1,0,1,"dummy"
"152512",0,0,1,1,"dummy"
"152515",0,1,0,1,"dummy"
"152521",0,3,0,3,"dummy"
"152522",0,0,2,2,"dummy"
"152523",1,4,2,7,"dummy"
"152524",2,3,0,5,"dummy"
"152525",2,2,0,4,"dummy"
"152526",0,0,1,1,"dummy"
"152527",8,11,0,19,"dummy"
"152535",0,3,0,3,"dummy"
"152536",0,4,0,4,"dummy"
"152537",8,1,4,13,"dummy"
"152582",0,0,1,1,"dummy"
"152604",1,1,0,2,"dummy"
"152605",1,4,0,5,"dummy"
"152308",0,0,1,1,"dummy"
"152313",0,2,0,2,"dummy"
"152314",0,1,1,2,"dummy"
"152319",0,8,0,8,"dummy"
"152322",0,1,0,1,"dummy"
"152327",3,3,1,7,"dummy"
"152328",0,5,1,6,"dummy"
"152329",0,0,1,1,"dummy"
"152330",3,0,2,5,"dummy"
"152331",0,3,0,3,"dummy"
"152395",0,0,2,2,"dummy"
"152398",0,0,2,2,"dummy"
"152424",0,1,0,1,"dummy"
"152425",0,0,1,1,"dummy"
"152426",1,0,0,1,"dummy"
"152429",0,1,0,1,"dummy"
"152435",9,9,2,20,"dummy"
"152436",0,0,0,0,"dummy"
"152440",3,2,1,6,"dummy"
"152446",0,9,0,9,"dummy"
"152447",0,0,0,0,"dummy"
"152448",0,0,0,0,"dummy"
"152449",0,1,0,1,"dummy"
"152450",0,0,0,0,"dummy"
"152451",0,0,1,1,"dummy"
"152452",0,0,1,1,"dummy"
"152453",0,0,1,1,"dummy"
"152454",0,1,0,1,"dummy"
"152455",0,0,0,0,"dummy"
"152460",0,1,0,1,"dummy"
"152461",8,46,0,54,"dummy"
"152462",5,5,0,10,"dummy"
"152463",1,0,2,3,"dummy"
"152473",5,1,1,7,"dummy"
"152485",0,7,0,7,"dummy"
"152486",0,0,1,1,"dummy"
"152487",0,10,0,10,"dummy"
"152488",6,5,1,12,"dummy"
"152489",2,2,0,4,"dummy"
"152490",0,1,0,1,"dummy"
"152495",7,0,0,7,"dummy"
"152496",5,9,5,19,"dummy"
"152519",0,2,0,2,"dummy"
"152531",0,4,0,4,"dummy"
"152532",1,0,0,1,"dummy"
"152533",0,0,0,0,"dummy"
"152543",0,0,1,1,"dummy"
"152584",10,0,0,10,"dummy"
"152585",0,6,0,6,"dummy"
"152586",6,1,0,7,"dummy"
"152587",0,6,0,6,"dummy"
"152588",0,4,0,4,"dummy"
"152589",7,19,2,28,"dummy"
"152590",7,10,1,18,"dummy"
"152591",0,1,1,2,"dummy"
"152592",0,0,2,2,"dummy"
"152593",0,1,0,1,"dummy"
"152594",0,6,2,8,"dummy"
"152595",0,1,0,1,"dummy"
"152602",2,2,3,7,"dummy"
"152616",1,0,1,2,"dummy"
"152617",2,9,0,11,"dummy"
"152606",0,0,1,1,"dummy"
"152607",0,0,1,1,"dummy"
"152608",0,0,1,1,"dummy"
"152609",0,2,1,3,"dummy"
"152610",0,0,1,1,"dummy"
"152611",0,0,1,1,"dummy"
"152612",0,0,1,1,"dummy"
"152613",0,0,1,1,"dummy"
"152614",4,6,2,12,"dummy"
"152641",0,15,0,15,"dummy"
"152688",0,0,0,0,"dummy"
"152689",0,0,0,0,"dummy"
"152690",0,0,0,0,"dummy"
"152691",0,0,0,0,"dummy"
"152711",0,0,2,2,"dummy"
"152720",0,0,1,1,"dummy"
"152721",0,1,1,2,"dummy"
"152722",0,1,0,1,"dummy"
"152723",0,2,1,3,"dummy"
"152724",1,2,0,3,"dummy"
"152725",0,3,1,4,"dummy"
"152726",2,0,0,2,"dummy"
"152727",0,1,1,2,"dummy"
"152728",1,0,0,1,"dummy"
"152729",0,0,1,1,"dummy"
"152730",7,5,1,13,"dummy"
"152731",0,1,0,1,"dummy"
"152732",0,2,0,2,"dummy"
"152733",0,2,1,3,"dummy"
"152734",17,14,3,34,"dummy"
"152735",1,0,0,1,"dummy"
"152771",7,4,1,12,"dummy"
"152772",1,1,0,2,"dummy"
"152773",6,1,2,9,"dummy"
"152774",0,1,1,2,"dummy"
"152775",0,0,1,1,"dummy"
"152776",2,7,1,10,"dummy"
"152777",0,1,2,3,"dummy"
"152778",0,0,1,1,"dummy"
"152779",0,1,1,2,"dummy"
"152780",1,0,0,1,"dummy"
"152781",7,1,1,9,"dummy"
"152786",0,1,1,2,"dummy"
"152787",2,2,0,4,"dummy"
"152791",0,0,0,0,"dummy"
"152792",5,0,2,7,"dummy"
"152793",0,0,0,0,"dummy"
"152824",0,0,0,0,"dummy"
"152825",0,0,0,0,"dummy"
"152826",0,0,1,1,"dummy"
"152827",1,0,0,1,"dummy"
"152828",0,0,0,0,"dummy"
"152829",0,0,0,0,"dummy"
"152830",0,0,0,0,"dummy"
"152831",0,0,0,0,"dummy"
"152832",0,0,1,1,"dummy"
"152833",0,0,0,0,"dummy"
"152834",0,0,0,0,"dummy"
"152847",0,1,0,1,"dummy"
"152848",2,1,0,3,"dummy"
"152849",0,0,1,1,"dummy"
"152618",2,0,1,3,"dummy"
"152653",0,0,1,1,"dummy"
"152654",0,1,0,1,"dummy"
"152655",0,0,1,1,"dummy"
"152656",0,0,1,1,"dummy"
"152657",0,0,1,1,"dummy"
"152658",0,0,1,1,"dummy"
"152659",0,0,1,1,"dummy"
"152660",0,0,1,1,"dummy"
"152661",0,0,1,1,"dummy"
"152662",0,0,1,1,"dummy"
"152663",0,0,1,1,"dummy"
"152664",0,3,0,3,"dummy"
"152665",0,0,1,1,"dummy"
"152666",0,0,1,1,"dummy"
"152667",0,0,1,1,"dummy"
"152668",0,0,1,1,"dummy"
"152669",0,0,1,1,"dummy"
"152670",0,0,1,1,"dummy"
"152671",0,0,1,1,"dummy"
"152672",0,0,1,1,"dummy"
"152673",0,0,1,1,"dummy"
"152674",0,0,1,1,"dummy"
"152675",0,0,1,1,"dummy"
"152676",0,0,1,1,"dummy"
"152677",0,0,1,1,"dummy"
"152678",0,0,1,1,"dummy"
"152679",0,0,1,1,"dummy"
"152680",0,0,1,1,"dummy"
"152681",0,0,1,1,"dummy"
"152682",0,0,1,1,"dummy"
"152683",0,0,1,1,"dummy"
"152684",0,0,1,1,"dummy"
"152685",0,0,1,1,"dummy"
"152686",0,0,1,1,"dummy"
"152693",0,0,5,5,"dummy"
"152694",0,2,0,2,"dummy"
"152695",3,0,0,3,"dummy"
"152696",0,2,0,2,"dummy"
"152697",1,2,1,4,"dummy"
"152698",0,3,0,3,"dummy"
"152699",4,2,0,6,"dummy"
"152700",0,1,0,1,"dummy"
"152701",2,2,0,4,"dummy"
"152702",0,0,1,1,"dummy"
"152703",0,0,1,1,"dummy"
"152704",0,0,1,1,"dummy"
"152705",0,0,3,3,"dummy"
"152706",0,0,3,3,"dummy"
"152707",0,1,0,1,"dummy"
"152708",2,5,0,7,"dummy"
"152709",0,2,0,2,"dummy"
"152713",0,0,2,2,"dummy"
"152714",1,0,0,1,"dummy"
"152737",0,0,1,1,"dummy"
"152738",0,0,0,0,"dummy"
"152739",0,0,0,0,"dummy"
"152740",0,0,0,0,"dummy"
"152741",0,0,1,1,"dummy"
"152742",0,0,0,0,"dummy"
"152743",1,0,1,2,"dummy"
"152744",0,1,0,1,"dummy"
"152745",0,0,2,2,"dummy"
"152768",0,4,2,6,"dummy"
"152769",0,1,0,1,"dummy"
"152789",0,1,2,3,"dummy"
"152795",1,6,0,7,"dummy"
"152796",23,24,9,56,"dummy"
"152797",0,1,1,2,"dummy"
"152798",3,0,0,3,"dummy"
"152799",1,0,0,1,"dummy"
"152800",0,1,0,1,"dummy"
"152801",2,2,0,4,"dummy"
"152802",0,10,1,11,"dummy"
"152803",15,13,0,28,"dummy"
"152804",7,2,2,11,"dummy"
"152805",0,0,0,0,"dummy"
"152806",0,8,0,8,"dummy"
"152809",0,1,0,1,"dummy"
"152810",0,1,0,1,"dummy"
"152811",0,1,0,1,"dummy"
"152812",0,1,0,1,"dummy"
"152813",0,0,0,0,"dummy"
"152814",0,1,0,1,"dummy"
"152815",0,0,0,0,"dummy"
"152816",4,1,0,5,"dummy"
"152850",0,2,0,2,"dummy"
"152851",0,1,0,1,"dummy"
"152852",3,3,1,7,"dummy"
"152853",2,0,0,2,"dummy"
"152854",1,4,1,6,"dummy"
"152855",1,4,0,5,"dummy"
"152856",0,1,0,1,"dummy"
"152857",1,0,0,1,"dummy"
"152866",0,1,0,1,"dummy"
"152867",1,3,1,5,"dummy"
"152882",0,0,1,1,"dummy"
"152883",0,2,0,2,"dummy"
"152884",0,1,0,1,"dummy"
"152885",2,5,0,7,"dummy"
"152900",6,4,4,14,"dummy"
"152901",0,0,0,0,"dummy"
"152905",0,0,1,1,"dummy"
"152906",0,0,0,0,"dummy"
"152907",0,1,0,1,"dummy"
"152908",1,2,0,3,"dummy"
"152909",0,1,0,1,"dummy"
"152910",1,10,1,12,"dummy"
"152911",1,1,0,2,"dummy"
"152912",0,1,0,1,"dummy"
"152913",7,2,0,9,"dummy"
"152914",0,1,0,1,"dummy"
"152915",0,0,1,1,"dummy"
"152916",0,0,2,2,"dummy"
"152917",0,0,1,1,"dummy"
"152922",0,0,1,1,"dummy"
"152943",0,0,3,3,"dummy"
"152944",0,0,3,3,"dummy"
"152945",0,0,1,1,"dummy"
"152946",0,0,1,1,"dummy"
"152952",0,0,1,1,"dummy"
"152953",2,7,1,10,"dummy"
"152954",11,2,1,14,"dummy"
"152955",0,0,1,1,"dummy"
"152956",2,8,1,11,"dummy"
"152957",21,12,0,33,"dummy"
"152958",1,3,1,5,"dummy"
"152959",2,2,3,7,"dummy"
"152962",8,0,4,12,"dummy"
"152963",2,4,3,9,"dummy"
"152964",0,0,1,1,"dummy"
"152967",0,2,0,2,"dummy"
"152968",0,2,0,2,"dummy"
"152969",2,3,2,7,"dummy"
"152970",6,0,0,6,"dummy"
"152971",0,8,0,8,"dummy"
"152972",0,1,0,1,"dummy"
"152973",9,0,0,9,"dummy"
"152985",0,0,0,0,"dummy"
"152986",0,0,0,0,"dummy"
"153009",0,1,0,1,"dummy"
"153010",0,0,0,0,"dummy"
"153011",3,1,0,4,"dummy"
"153012",0,1,1,2,"dummy"
"153013",1,0,0,1,"dummy"
"153020",0,0,2,2,"dummy"
"153021",0,0,1,1,"dummy"
"153022",0,0,1,1,"dummy"
"153023",0,1,0,1,"dummy"
"153024",0,0,1,1,"dummy"
"153025",0,0,0,0,"dummy"
"153026",0,0,1,1,"dummy"
"153027",0,0,0,0,"dummy"
"153035",2,1,1,4,"dummy"
"153036",0,0,1,1,"dummy"
"153037",0,0,1,1,"dummy"
"153038",0,0,1,1,"dummy"
"153039",0,0,1,1,"dummy"
"153049",0,1,0,1,"dummy"
"153052",1,0,1,2,"dummy"
"153053",0,0,1,1,"dummy"
"153054",0,4,1,5,"dummy"
"153055",0,2,0,2,"dummy"
"152869",2,2,3,7,"dummy"
"152872",0,1,1,2,"dummy"
"152873",0,1,0,1,"dummy"
"152874",2,2,0,4,"dummy"
"152875",0,0,0,0,"dummy"
"152876",1,0,1,2,"dummy"
"152893",2,0,0,2,"dummy"
"152894",0,0,0,0,"dummy"
"152903",3,3,1,7,"dummy"
"152924",0,0,1,1,"dummy"
"152948",0,7,0,7,"dummy"
"152949",0,0,0,0,"dummy"
"152950",0,0,0,0,"dummy"
"152975",0,0,1,1,"dummy"
"152976",0,0,1,1,"dummy"
"152977",1,0,0,1,"dummy"
"152978",0,1,0,1,"dummy"
"152979",0,1,1,2,"dummy"
"152980",0,0,1,1,"dummy"
"152981",0,0,1,1,"dummy"
"152982",0,1,0,1,"dummy"
"152983",0,0,1,1,"dummy"
"152992",0,21,0,21,"dummy"
"153031",5,3,2,10,"dummy"
"153032",0,2,1,3,"dummy"
"153033",1,0,1,2,"dummy"
"153041",2,0,0,2,"dummy"
"153042",0,0,1,1,"dummy"
"153043",0,0,3,3,"dummy"
"153044",0,0,2,2,"dummy"
"153045",4,0,0,4,"dummy"
"153065",0,2,0,2,"dummy"
"153093",11,9,1,21,"dummy"
"153094",0,0,0,0,"dummy"
"153102",0,0,1,1,"dummy"
"153111",1,1,1,3,"dummy"
"153112",18,3,1,22,"dummy"
"153118",0,1,0,1,"dummy"
"153119",0,0,1,1,"dummy"
"153120",0,3,1,4,"dummy"
"153121",4,4,0,8,"dummy"
"153122",3,5,1,9,"dummy"
"153123",2,0,4,6,"dummy"
"153124",6,0,0,6,"dummy"
"153125",4,4,0,8,"dummy"
"153126",0,1,0,1,"dummy"
"153127",1,0,1,2,"dummy"
"153128",0,1,1,2,"dummy"
"153129",1,0,1,2,"dummy"
"153130",0,0,1,1,"dummy"
"153183",0,0,0,0,"dummy"
"153184",0,0,0,0,"dummy"
"153209",0,0,1,1,"dummy"
"153210",0,1,0,1,"dummy"
"153211",0,0,0,0,"dummy"
"153212",0,0,1,1,"dummy"
"153056",7,2,1,10,"dummy"
"153057",2,1,1,4,"dummy"
"153060",0,0,2,2,"dummy"
"153061",0,4,0,4,"dummy"
"153062",0,0,1,1,"dummy"
"153063",0,0,1,1,"dummy"
"153104",0,14,0,14,"dummy"
"153105",0,0,1,1,"dummy"
"153106",13,71,3,87,"dummy"
"153107",0,4,0,4,"dummy"
"153108",15,1,0,16,"dummy"
"153109",34,8,3,45,"dummy"
"153114",0,1,0,1,"dummy"
"153115",0,3,0,3,"dummy"
"153116",3,0,0,3,"dummy"
"153154",4,1,0,5,"dummy"
"153155",1,0,0,1,"dummy"
"153156",0,0,1,1,"dummy"
"153157",0,1,0,1,"dummy"
"153169",0,0,1,1,"dummy"
"153170",0,0,0,0,"dummy"
"153171",0,0,0,0,"dummy"
"153172",0,0,0,0,"dummy"
"153173",0,0,1,1,"dummy"
"153174",0,0,0,0,"dummy"
"153175",1,0,1,2,"dummy"
"153176",0,1,0,1,"dummy"
"153177",1,0,0,1,"dummy"
"153178",0,0,0,0,"dummy"
"153179",0,2,0,2,"dummy"
"153180",0,0,0,0,"dummy"
"153181",0,0,0,0,"dummy"
"153190",0,8,0,8,"dummy"
"153191",1,2,0,3,"dummy"
"153192",5,2,1,8,"dummy"
"153193",1,0,0,1,"dummy"
"153196",1,2,1,4,"dummy"
"153197",1,0,0,1,"dummy"
"153198",0,0,0,0,"dummy"
"153199",0,0,0,0,"dummy"
"153206",0,2,0,2,"dummy"
"153207",0,0,1,1,"dummy"
"153214",0,2,0,2,"dummy"
"153215",0,1,4,5,"dummy"
"153216",0,0,2,2,"dummy"
"153217",2,0,0,2,"dummy"
"153218",0,0,2,2,"dummy"
"153219",3,0,2,5,"dummy"
"153226",0,4,0,4,"dummy"
"153227",0,1,0,1,"dummy"
"153251",9,1,0,10,"dummy"
"153252",0,2,1,3,"dummy"
"153253",0,1,0,1,"dummy"
"153254",1,3,0,4,"dummy"
"153257",0,0,2,2,"dummy"
"153258",2,8,0,10,"dummy"
"153292",11,12,2,25,"dummy"
"153295",0,2,0,2,"dummy"
"153296",0,0,0,0,"dummy"
"153297",0,0,0,0,"dummy"
"153308",0,0,1,1,"dummy"
"153229",0,0,0,0,"dummy"
"153230",5,0,2,7,"dummy"
"153231",0,0,0,0,"dummy"
"153236",0,2,0,2,"dummy"
"153237",0,3,0,3,"dummy"
"153238",1,0,0,1,"dummy"
"153239",0,2,0,2,"dummy"
"153240",4,0,0,4,"dummy"
"153248",0,3,1,4,"dummy"
"153249",0,0,2,2,"dummy"
"153260",0,4,0,4,"dummy"
"153261",0,1,0,1,"dummy"
"153262",0,1,0,1,"dummy"
"153263",1,1,0,2,"dummy"
"153284",0,4,0,4,"dummy"
"153285",0,0,1,1,"dummy"
"153286",0,3,0,3,"dummy"
"153287",1,6,4,11,"dummy"
"153288",0,2,0,2,"dummy"
"153289",6,5,3,14,"dummy"
"153290",0,1,0,1,"dummy"
"153299",1,3,0,4,"dummy"
"153300",3,7,1,11,"dummy"
"153301",4,2,1,7,"dummy"
"153302",1,3,0,4,"dummy"
"153303",1,1,0,2,"dummy"
"153304",1,4,0,5,"dummy"
"153305",2,2,0,4,"dummy"
"153306",0,5,0,5,"dummy"
"153310",0,0,0,0,"dummy"
"153311",0,3,0,3,"dummy"
"153312",0,1,0,1,"dummy"
"153313",0,0,0,0,"dummy"
"153314",2,8,0,10,"dummy"
"153315",1,2,0,3,"dummy"
"153316",0,0,1,1,"dummy"
"153317",0,0,0,0,"dummy"
"153320",18,12,2,32,"dummy"
"153321",8,9,2,19,"dummy"
"153340",0,1,0,1,"dummy"
"153341",5,17,4,26,"dummy"
"153357",0,3,1,4,"dummy"
"153358",0,5,0,5,"dummy"
"153359",0,6,0,6,"dummy"
"153360",0,1,0,1,"dummy"
"153361",0,3,0,3,"dummy"
"153362",0,3,0,3,"dummy"
"153363",2,3,0,5,"dummy"
"153364",10,17,3,30,"dummy"
"153365",21,18,1,40,"dummy"
"153366",2,4,0,6,"dummy"
"153367",8,3,3,14,"dummy"
"153368",0,3,0,3,"dummy"
"153369",2,0,1,3,"dummy"
"153370",0,2,0,2,"dummy"
"153371",3,0,0,3,"dummy"
"153372",0,3,0,3,"dummy"
"153373",25,5,0,30,"dummy"
"153374",0,5,1,6,"dummy"
"153375",1,4,0,5,"dummy"
"153376",3,0,4,7,"dummy"
"153377",43,21,4,68,"dummy"
"153378",4,4,4,12,"dummy"
"153379",1,3,1,5,"dummy"
"153380",0,0,1,1,"dummy"
"153381",0,1,1,2,"dummy"
"153382",0,0,1,1,"dummy"
"153385",0,2,1,3,"dummy"
"153386",0,4,0,4,"dummy"
"153387",3,0,2,5,"dummy"
"153388",0,0,1,1,"dummy"
"153391",0,1,1,2,"dummy"
"153392",0,0,1,1,"dummy"
"153393",0,0,1,1,"dummy"
"153394",0,1,0,1,"dummy"
"153395",0,1,0,1,"dummy"
"153396",0,1,0,1,"dummy"
"153397",2,0,1,3,"dummy"
"153398",0,1,0,1,"dummy"
"153399",0,0,1,1,"dummy"
"153400",0,0,1,1,"dummy"
"153327",1,3,0,4,"dummy"
"153328",7,8,2,17,"dummy"
"153329",0,0,1,1,"dummy"
"153330",8,10,0,18,"dummy"
"153331",0,3,0,3,"dummy"
"153332",0,5,1,6,"dummy"
"153333",0,2,0,2,"dummy"
"153334",0,1,0,1,"dummy"
"153335",3,0,0,3,"dummy"
"153338",0,1,1,2,"dummy"
"153343",1,0,0,1,"dummy"
"153344",0,0,1,1,"dummy"
"153345",2,0,0,2,"dummy"
"153346",0,0,1,1,"dummy"
"153347",0,1,0,1,"dummy"
"153348",0,2,0,2,"dummy"
"153349",0,2,0,2,"dummy"
"153350",2,0,0,2,"dummy"
"153351",0,2,0,2,"dummy"
"153352",4,1,0,5,"dummy"
"153353",1,0,0,1,"dummy"
"153354",0,0,0,0,"dummy"
"153355",0,0,0,0,"dummy"
"153401",0,1,1,2,"dummy"
"153402",2,0,0,2,"dummy"
"153403",0,0,1,1,"dummy"
"153404",6,0,1,7,"dummy"
"153405",1,0,1,2,"dummy"
"153406",0,0,0,0,"dummy"
"153407",2,1,1,4,"dummy"
"153410",0,0,0,0,"dummy"
"153411",0,1,0,1,"dummy"
"153412",0,3,0,3,"dummy"
"153413",0,8,0,8,"dummy"
"153415",6,16,1,23,"dummy"
"153417",0,0,2,2,"dummy"
"153420",0,0,3,3,"dummy"
"153421",1,3,0,4,"dummy"
"153422",1,0,0,1,"dummy"
"153424",0,0,1,1,"dummy"
"153426",0,2,0,2,"dummy"
"153427",0,1,0,1,"dummy"
"153434",2,0,0,2,"dummy"
"153435",0,2,0,2,"dummy"
"153451",0,1,0,1,"dummy"
"153452",0,0,1,1,"dummy"
"153455",0,0,0,0,"dummy"
"153457",0,3,0,3,"dummy"
"153458",0,1,0,1,"dummy"
"153459",0,0,0,0,"dummy"
"153460",0,0,1,1,"dummy"
"153463",30,2,0,32,"dummy"
"153464",2,0,0,2,"dummy"
"153465",0,2,0,2,"dummy"
"153466",14,50,4,68,"dummy"
"153467",9,5,0,14,"dummy"
"153468",0,0,1,1,"dummy"
"153469",0,0,2,2,"dummy"
"153470",0,13,2,15,"dummy"
"153474",0,0,1,1,"dummy"
"153486",6,0,0,6,"dummy"
"153488",0,0,1,1,"dummy"
"153491",10,1,0,11,"dummy"
"153492",0,1,0,1,"dummy"
"153493",2,0,0,2,"dummy"
"153495",0,5,4,9,"dummy"
"153496",0,1,2,3,"dummy"
"153497",0,0,1,1,"dummy"
"153498",0,0,1,1,"dummy"
"153499",0,0,1,1,"dummy"
"153500",0,0,1,1,"dummy"
"153501",0,0,1,1,"dummy"
"153502",0,0,1,1,"dummy"
"153503",0,0,1,1,"dummy"
"153504",0,0,3,3,"dummy"
"153505",0,0,1,1,"dummy"
"153514",0,1,0,1,"dummy"
"153515",3,2,0,5,"dummy"
"153516",0,0,3,3,"dummy"
"153517",0,0,0,0,"dummy"
"153518",0,0,4,4,"dummy"
"153519",0,0,3,3,"dummy"
"153521",3,1,0,4,"dummy"
"153522",2,2,0,4,"dummy"
"153523",1,1,0,2,"dummy"
"153524",0,2,0,2,"dummy"
"153531",0,0,1,1,"dummy"
"153532",0,3,0,3,"dummy"
"153533",0,0,1,1,"dummy"
"153535",0,2,1,3,"dummy"
"153536",0,2,0,2,"dummy"
"153537",3,2,0,5,"dummy"
"153538",0,1,0,1,"dummy"
"153539",0,3,0,3,"dummy"
"153540",0,1,0,1,"dummy"
"153541",0,1,0,1,"dummy"
"153542",0,3,0,3,"dummy"
"153543",0,1,0,1,"dummy"
"153544",0,2,0,2,"dummy"
"153545",0,0,1,1,"dummy"
"153546",3,0,0,3,"dummy"
"153547",2,0,1,3,"dummy"
"153548",6,1,0,7,"dummy"
"153549",0,0,1,1,"dummy"
"153550",3,3,0,6,"dummy"
"153551",0,0,1,1,"dummy"
"153552",1,0,0,1,"dummy"
"153555",1,0,0,1,"dummy"
"153557",0,0,0,0,"dummy"
"153558",0,0,0,0,"dummy"
"153561",0,0,3,3,"dummy"
"153567",0,1,0,1,"dummy"
"153568",0,0,2,2,"dummy"
"153569",0,0,0,0,"dummy"
"153573",27,2,2,31,"dummy"
"153574",1,0,0,1,"dummy"
"153575",0,1,0,1,"dummy"
"153577",0,0,0,0,"dummy"
"153578",0,0,1,1,"dummy"
"153579",0,1,0,1,"dummy"
"153580",3,1,5,9,"dummy"
"153581",1,0,0,1,"dummy"
"153582",0,0,0,0,"dummy"
"153583",1,0,0,1,"dummy"
"153584",0,0,1,1,"dummy"
"153586",0,11,0,11,"dummy"
"153588",1,0,1,2,"dummy"
"153589",0,1,1,2,"dummy"
"153590",3,0,0,3,"dummy"
"153591",0,1,0,1,"dummy"
"153592",0,0,0,0,"dummy"
"153593",0,1,0,1,"dummy"
"153594",3,5,0,8,"dummy"
"153596",0,1,0,1,"dummy"
"153597",0,0,1,1,"dummy"
"153598",0,1,0,1,"dummy"
"153599",0,0,0,0,"dummy"
"153601",0,1,0,1,"dummy"
"153602",0,2,0,2,"dummy"
"153603",6,21,2,29,"dummy"
"153604",0,0,1,1,"dummy"
"153605",0,0,1,1,"dummy"
"153607",0,0,1,1,"dummy"
"153608",0,0,1,1,"dummy"
"153609",0,0,1,1,"dummy"
"153610",0,0,1,1,"dummy"
"153613",0,1,1,2,"dummy"
"153614",1,0,2,3,"dummy"
"153615",0,0,0,0,"dummy"
"153616",2,13,0,15,"dummy"
"153617",0,4,0,4,"dummy"
"153620",0,1,0,1,"dummy"
"153623",0,1,0,1,"dummy"
"153624",0,4,0,4,"dummy"
"153625",3,0,0,3,"dummy"
"153629",0,5,0,5,"dummy"
"153630",1,1,0,2,"dummy"
"153631",2,0,0,2,"dummy"
"153632",2,1,0,3,"dummy"
"153633",0,2,0,2,"dummy"
"153637",2,0,0,2,"dummy"
"153638",0,1,0,1,"dummy"
"153639",0,0,1,1,"dummy"
"153640",0,0,0,0,"dummy"
"153641",1,0,0,1,"dummy"
"153642",0,0,0,0,"dummy"
"153643",0,0,0,0,"dummy"
"153644",0,1,0,1,"dummy"
"153645",0,0,0,0,"dummy"
"153646",0,0,0,0,"dummy"
"153647",0,0,2,2,"dummy"
"153648",0,0,0,0,"dummy"
"153649",0,0,2,2,"dummy"
"153650",0,0,0,0,"dummy"
"153651",1,0,1,2,"dummy"
"153652",1,2,0,3,"dummy"
"153689",0,0,1,1,"dummy"
"153690",0,0,1,1,"dummy"
"153691",0,0,1,1,"dummy"
"153693",0,3,0,3,"dummy"
"153694",2,2,1,5,"dummy"
"153695",0,1,0,1,"dummy"
"153696",4,0,0,4,"dummy"
"153697",0,1,0,1,"dummy"
"153698",2,2,0,4,"dummy"
"153699",1,0,0,1,"dummy"
"153700",1,5,0,6,"dummy"
"153701",3,2,1,6,"dummy"
"153702",0,0,1,1,"dummy"
"153703",4,1,0,5,"dummy"
"153704",1,1,0,2,"dummy"
"153707",6,0,2,8,"dummy"
"153708",1,1,0,2,"dummy"
"153709",0,1,0,1,"dummy"
"153710",2,2,0,4,"dummy"
"153711",2,0,0,2,"dummy"
"153712",0,4,1,5,"dummy"
"153713",3,0,0,3,"dummy"
"153714",0,1,4,5,"dummy"
"153715",1,0,4,5,"dummy"
"153716",0,1,4,5,"dummy"
"153717",0,0,5,5,"dummy"
"153734",2,13,3,18,"dummy"
"153735",1,8,0,9,"dummy"
"153736",2,3,1,6,"dummy"
"153737",23,9,4,36,"dummy"
"153739",2,2,0,4,"dummy"
"153742",0,2,2,4,"dummy"
"153743",2,6,3,11,"dummy"
"153744",9,5,6,20,"dummy"
"153745",0,0,2,2,"dummy"
"153748",4,5,3,12,"dummy"
"153749",3,10,1,14,"dummy"
"153750",1,1,0,2,"dummy"
"153753",0,0,1,1,"dummy"
"153754",2,6,0,8,"dummy"
"153755",0,0,0,0,"dummy"
"153756",0,14,0,14,"dummy"
"153758",15,0,0,15,"dummy"
"153765",0,0,1,1,"dummy"
"153766",0,0,1,1,"dummy"
"153768",0,0,1,1,"dummy"
"153769",0,0,1,1,"dummy"
"153770",0,0,1,1,"dummy"
"153771",0,0,1,1,"dummy"
"153772",0,14,1,15,"dummy"
"153773",0,0,1,1,"dummy"
"153774",0,0,1,1,"dummy"
"153775",3,3,4,10,"dummy"
"153776",0,0,1,1,"dummy"
"153777",0,0,1,1,"dummy"
"153778",0,0,1,1,"dummy"
"153779",0,0,2,2,"dummy"
"153780",0,0,1,1,"dummy"
"153781",0,0,1,1,"dummy"
"153782",0,0,1,1,"dummy"
"153783",0,0,1,1,"dummy"
"153784",0,0,1,1,"dummy"
"153785",0,0,1,1,"dummy"
"153786",3,0,1,4,"dummy"
"153787",0,0,1,1,"dummy"
"153788",0,0,1,1,"dummy"
"153789",0,1,1,2,"dummy"
"153790",0,0,1,1,"dummy"
"153791",0,0,1,1,"dummy"
"153792",0,1,1,2,"dummy"
"153793",0,0,2,2,"dummy"
"153794",0,1,1,2,"dummy"
"153795",0,0,1,1,"dummy"
"153796",0,0,1,1,"dummy"
"153797",0,0,1,1,"dummy"
"153798",0,0,1,1,"dummy"
"153799",0,1,1,2,"dummy"
"153800",0,1,1,2,"dummy"
"153801",0,0,1,1,"dummy"
"153802",0,0,2,2,"dummy"
"153803",0,0,1,1,"dummy"
"153804",1,2,1,4,"dummy"
"153805",0,0,1,1,"dummy"
"153806",0,0,1,1,"dummy"
"153807",0,1,0,1,"dummy"
"153808",1,0,0,1,"dummy"
"153809",0,1,0,1,"dummy"
"153810",0,0,1,1,"dummy"
"153811",0,1,1,2,"dummy"
"153812",0,0,1,1,"dummy"
"153813",0,0,1,1,"dummy"
"153814",5,0,1,6,"dummy"
"153815",9,0,1,10,"dummy"
"153816",0,0,1,1,"dummy"
"153817",0,0,1,1,"dummy"
"153818",0,0,1,1,"dummy"
"153819",0,0,1,1,"dummy"
"153820",0,0,1,1,"dummy"
"153821",0,7,2,9,"dummy"
"153822",0,0,1,1,"dummy"
"153823",0,2,1,3,"dummy"
"153824",0,0,2,2,"dummy"
"153825",0,0,2,2,"dummy"
"153826",0,0,2,2,"dummy"
"153827",1,0,1,2,"dummy"
"153828",0,0,1,1,"dummy"
"153829",0,2,1,3,"dummy"
"153830",0,0,1,1,"dummy"
"153831",0,0,2,2,"dummy"
"153832",0,0,2,2,"dummy"
"153833",0,0,2,2,"dummy"
"153834",0,1,0,1,"dummy"
"153835",0,0,1,1,"dummy"
"153836",0,0,1,1,"dummy"
"153837",13,0,3,16,"dummy"
"153838",0,0,1,1,"dummy"
"153839",0,0,1,1,"dummy"
"153840",0,0,1,1,"dummy"
"153841",0,0,1,1,"dummy"
"153842",0,0,1,1,"dummy"
"153843",0,0,2,2,"dummy"
"153844",0,0,1,1,"dummy"
"153845",0,0,1,1,"dummy"
"153846",0,0,1,1,"dummy"
"153849",1,1,0,2,"dummy"
"153850",0,0,1,1,"dummy"
"153851",0,0,0,0,"dummy"
"153852",0,0,1,1,"dummy"
"153853",0,2,1,3,"dummy"
"153854",0,1,0,1,"dummy"
"153855",0,1,0,1,"dummy"
"153856",0,0,0,0,"dummy"
"153869",1,7,3,11,"dummy"
"153871",0,0,0,0,"dummy"
"153886",0,1,0,1,"dummy"
"153887",0,1,0,1,"dummy"
"153888",0,2,0,2,"dummy"
"153889",0,0,1,1,"dummy"
"153890",0,2,0,2,"dummy"
"153891",0,3,0,3,"dummy"
"153892",0,2,0,2,"dummy"
"153893",0,2,0,2,"dummy"
"153894",0,1,0,1,"dummy"
"153898",0,0,1,1,"dummy"
"153899",0,0,0,0,"dummy"
"153901",0,0,1,1,"dummy"
"153904",0,1,0,1,"dummy"
"153905",0,2,1,3,"dummy"
"153906",0,2,0,2,"dummy"
"153907",0,1,0,1,"dummy"
"153908",1,0,0,1,"dummy"
"153909",0,2,3,5,"dummy"
"153912",1,4,0,5,"dummy"
"153916",0,2,2,4,"dummy"
"153917",1,2,2,5,"dummy"
"153918",0,0,1,1,"dummy"
"153922",0,0,1,1,"dummy"
"153923",12,10,2,24,"dummy"
"153924",0,0,0,0,"dummy"
"153925",3,9,3,15,"dummy"
"153926",2,0,0,2,"dummy"
"153927",4,7,2,13,"dummy"
"153929",3,0,0,3,"dummy"
"153931",1,3,3,7,"dummy"
"153932",0,0,1,1,"dummy"
"153933",2,1,1,4,"dummy"
"153934",1,0,0,1,"dummy"
"153938",0,1,0,1,"dummy"
"153939",0,0,0,0,"dummy"
"153940",0,0,0,0,"dummy"
"153941",0,2,0,2,"dummy"
"153942",1,0,0,1,"dummy"
"153943",0,1,0,1,"dummy"
"153944",1,0,0,1,"dummy"
"153945",1,0,0,1,"dummy"
"153946",0,0,1,1,"dummy"
"153947",0,0,1,1,"dummy"
"153948",4,2,1,7,"dummy"
"153949",4,3,0,7,"dummy"
"153950",4,9,0,13,"dummy"
"153951",0,1,0,1,"dummy"
"153952",2,4,1,7,"dummy"
"153953",0,0,0,0,"dummy"
"153954",3,2,0,5,"dummy"
"153955",0,0,0,0,"dummy"
"153956",1,2,0,3,"dummy"
"153957",1,0,2,3,"dummy"
"153958",0,0,1,1,"dummy"
"153959",1,0,0,1,"dummy"
"153960",0,0,1,1,"dummy"
"153961",0,0,1,1,"dummy"
"153962",0,0,1,1,"dummy"
"153963",0,2,0,2,"dummy"
"153964",9,0,0,9,"dummy"
"153965",0,0,0,0,"dummy"
"153968",0,1,0,1,"dummy"
"153969",0,13,0,13,"dummy"
"153971",1,2,0,3,"dummy"
"153972",0,0,5,5,"dummy"
"153973",2,2,0,4,"dummy"
"153974",0,0,1,1,"dummy"
"153975",2,4,1,7,"dummy"
"153976",1,4,1,6,"dummy"
"153977",0,0,1,1,"dummy"
"153978",4,2,0,6,"dummy"
"153979",6,6,0,12,"dummy"
"153980",4,4,0,8,"dummy"
"153981",2,2,0,4,"dummy"
"153982",2,4,2,8,"dummy"
"153983",0,4,0,4,"dummy"
"153984",2,4,1,7,"dummy"
"153985",0,0,1,1,"dummy"
"153986",0,0,1,1,"dummy"
"153987",0,0,1,1,"dummy"
"153988",0,0,1,1,"dummy"
"153989",0,0,1,1,"dummy"
"153997",0,1,0,1,"dummy"
"154005",0,1,0,1,"dummy"
"154006",2,0,0,2,"dummy"
"154007",2,0,0,2,"dummy"
"154011",7,7,0,14,"dummy"
"154012",0,0,0,0,"dummy"
"154013",0,0,0,0,"dummy"
"154014",1,0,0,1,"dummy"
"154015",1,0,0,1,"dummy"
"154016",9,0,3,12,"dummy"
"154018",0,1,0,1,"dummy"
"154019",0,0,1,1,"dummy"
"154022",0,0,1,1,"dummy"
"154023",0,0,1,1,"dummy"
"154024",0,0,1,1,"dummy"
"154025",3,3,1,7,"dummy"
"154026",0,0,1,1,"dummy"
"154027",0,0,1,1,"dummy"
"154028",0,0,1,1,"dummy"
"154029",0,0,1,1,"dummy"
"154030",0,0,1,1,"dummy"
"154031",0,7,1,8,"dummy"
"154032",0,0,1,1,"dummy"
"154033",0,0,1,1,"dummy"
"154034",3,5,1,9,"dummy"
"154035",0,0,1,1,"dummy"
"154036",0,0,1,1,"dummy"
"154037",3,3,1,7,"dummy"
"154038",0,0,1,1,"dummy"
"154039",0,0,1,1,"dummy"
"154040",0,2,1,3,"dummy"
"154041",0,0,2,2,"dummy"
"154042",0,0,1,1,"dummy"
"154043",0,0,1,1,"dummy"
"154044",0,1,2,3,"dummy"
"154045",0,0,2,2,"dummy"
"154046",0,0,1,1,"dummy"
"154047",0,0,1,1,"dummy"
"154065",0,7,0,7,"dummy"
"154068",1,3,1,5,"dummy"
"154069",0,0,0,0,"dummy"
"154070",0,3,1,4,"dummy"
"154071",1,4,0,5,"dummy"
"154073",0,0,1,1,"dummy"
"154080",2,4,1,7,"dummy"
"154081",2,2,0,4,"dummy"
"154082",7,0,0,7,"dummy"
"154083",1,5,1,7,"dummy"
"154084",0,0,1,1,"dummy"
"154085",3,3,0,6,"dummy"
"154086",0,1,2,3,"dummy"
"154117",34,0,1,35,"dummy"
"154118",0,2,0,2,"dummy"
"154119",0,0,1,1,"dummy"
"154125",0,1,1,2,"dummy"
"154131",1,3,1,5,"dummy"
"154132",0,1,0,1,"dummy"
"154133",0,6,0,6,"dummy"
"154134",0,1,0,1,"dummy"
"154135",0,0,0,0,"dummy"
"154136",0,0,2,2,"dummy"
"154137",0,0,2,2,"dummy"
"154138",0,0,2,2,"dummy"
"154139",0,0,2,2,"dummy"
"154146",0,0,1,1,"dummy"
"154153",1,0,2,3,"dummy"
"154155",1,3,1,5,"dummy"
"154156",0,2,0,2,"dummy"
"154160",0,0,0,0,"dummy"
"154162",0,14,1,15,"dummy"
"154170",0,0,1,1,"dummy"
"154172",0,1,0,1,"dummy"
"154173",0,0,1,1,"dummy"
"154174",0,2,0,2,"dummy"
"154175",0,1,0,1,"dummy"
"154176",0,0,1,1,"dummy"
"154178",0,14,0,14,"dummy"
"154179",3,1,2,6,"dummy"
"154180",0,0,1,1,"dummy"
"154181",0,2,3,5,"dummy"
"154182",0,0,2,2,"dummy"
"154184",4,1,0,5,"dummy"
"154186",0,0,0,0,"dummy"
"154188",0,1,1,2,"dummy"
"154189",0,0,1,1,"dummy"
"154190",0,0,0,0,"dummy"
"154191",0,1,0,1,"dummy"
"154192",2,0,1,3,"dummy"
"154193",0,1,0,1,"dummy"
"154194",1,0,0,1,"dummy"
"154195",2,6,1,9,"dummy"
"154196",2,1,0,3,"dummy"
"154201",0,0,0,0,"dummy"
"154202",0,2,0,2,"dummy"
"154204",2,1,0,3,"dummy"
"154205",0,0,1,1,"dummy"
"154206",0,0,1,1,"dummy"
"154207",0,2,0,2,"dummy"
"154208",0,0,1,1,"dummy"
"154209",0,1,1,2,"dummy"
"154210",5,1,0,6,"dummy"
"154211",0,0,1,1,"dummy"
"154215",0,0,1,1,"dummy"
"154223",0,0,2,2,"dummy"
"154224",0,0,2,2,"dummy"
"154225",2,0,2,4,"dummy"
"154226",0,3,0,3,"dummy"
"154227",1,0,1,2,"dummy"
"154228",0,7,0,7,"dummy"
"154229",2,4,1,7,"dummy"
"154230",0,0,1,1,"dummy"
"154231",0,3,0,3,"dummy"
"154232",0,2,0,2,"dummy"
"154233",0,0,1,1,"dummy"
"154234",0,1,0,1,"dummy"
"154235",1,0,0,1,"dummy"
"154236",0,1,0,1,"dummy"
"154237",3,24,2,29,"dummy"
"154238",0,0,0,0,"dummy"
"154239",1,0,0,1,"dummy"
"154240",0,2,0,2,"dummy"
"154241",0,1,0,1,"dummy"
"154242",2,2,0,4,"dummy"
"154244",0,1,0,1,"dummy"
"154245",0,15,0,15,"dummy"
"154246",1,3,1,5,"dummy"
"154247",10,0,0,10,"dummy"
"154253",0,1,0,1,"dummy"
"154254",0,1,0,1,"dummy"
"154255",0,2,0,2,"dummy"
"154257",0,0,4,4,"dummy"
"154258",0,6,3,9,"dummy"
"154259",2,2,1,5,"dummy"
"154260",2,2,1,5,"dummy"
"154261",3,3,0,6,"dummy"
"154262",3,0,1,4,"dummy"
"154272",0,39,0,39,"dummy"
"154273",0,1,0,1,"dummy"
"154274",0,1,0,1,"dummy"
"154275",0,3,0,3,"dummy"
"154276",0,0,0,0,"dummy"
"154277",0,1,0,1,"dummy"
"154278",0,10,0,10,"dummy"
"154279",1,10,0,11,"dummy"
"154280",0,2,0,2,"dummy"
"154281",0,2,0,2,"dummy"
"154282",0,1,0,1,"dummy"
"154283",1,0,0,1,"dummy"
"154285",0,4,0,4,"dummy"
"154286",0,0,2,2,"dummy"
"154287",0,0,0,0,"dummy"
"154288",1,1,1,3,"dummy"
"154289",2,1,0,3,"dummy"
"154290",0,0,1,1,"dummy"
"154292",3,3,2,8,"dummy"
"154293",3,1,1,5,"dummy"
"154294",0,2,0,2,"dummy"
"154295",0,8,0,8,"dummy"
"154296",6,0,0,6,"dummy"
"154297",2,0,2,4,"dummy"
"154299",6,17,0,23,"dummy"
"154300",13,5,0,18,"dummy"
"154301",0,1,0,1,"dummy"
"154302",0,4,0,4,"dummy"
"154303",0,0,0,0,"dummy"
"154304",0,1,1,2,"dummy"
"154306",0,3,0,3,"dummy"
"154309",0,1,0,1,"dummy"
"154310",0,0,0,0,"dummy"
"154311",0,0,1,1,"dummy"
"154312",0,2,0,2,"dummy"
"154313",4,2,0,6,"dummy"
"154314",0,2,0,2,"dummy"
"154315",2,2,0,4,"dummy"
"154316",0,0,2,2,"dummy"
"154317",2,0,0,2,"dummy"
"154318",0,2,0,2,"dummy"
"154319",0,11,4,15,"dummy"
"154320",9,0,0,9,"dummy"
"154321",0,4,0,4,"dummy"
"154322",0,0,1,1,"dummy"
"154323",0,0,2,2,"dummy"
"154324",2,0,0,2,"dummy"
"154325",0,1,0,1,"dummy"
"154326",0,4,0,4,"dummy"
"154327",0,2,0,2,"dummy"
"154331",0,0,1,1,"dummy"
"154335",1,0,0,1,"dummy"
"154336",0,4,0,4,"dummy"
"154337",4,5,0,9,"dummy"
"154339",0,1,0,1,"dummy"
"154340",2,2,0,4,"dummy"
"154341",0,0,2,2,"dummy"
"154343",0,0,1,1,"dummy"
"154344",2,2,8,12,"dummy"
"154345",0,1,0,1,"dummy"
"154346",0,0,1,1,"dummy"
"154347",0,0,1,1,"dummy"
"154349",0,0,0,0,"dummy"
"154351",0,2,0,2,"dummy"
"154354",2,0,2,4,"dummy"
"154360",0,0,2,2,"dummy"
"154363",0,0,1,1,"dummy"
"154364",0,0,0,0,"dummy"
"154365",7,2,1,10,"dummy"
"154367",0,0,0,0,"dummy"
"154375",0,1,0,1,"dummy"
"154376",2,2,0,4,"dummy"
"154377",0,1,0,1,"dummy"
"154380",0,0,3,3,"dummy"
"154382",0,7,0,7,"dummy"
"154383",3,2,0,5,"dummy"
"154384",0,1,0,1,"dummy"
"154385",0,0,1,1,"dummy"
"154386",2,2,1,5,"dummy"
"154387",4,5,0,9,"dummy"
"154389",0,0,0,0,"dummy"
"154397",0,0,1,1,"dummy"
"154398",0,0,1,1,"dummy"
"154400",4,5,1,10,"dummy"
"154401",0,2,1,3,"dummy"
"154402",0,1,0,1,"dummy"
"154403",0,2,1,3,"dummy"
"154404",1,1,0,2,"dummy"
"154405",3,1,1,5,"dummy"
"154406",1,1,0,2,"dummy"
"154407",4,10,3,17,"dummy"
"154408",2,2,0,4,"dummy"
"154409",5,10,0,15,"dummy"
"154410",1,5,3,9,"dummy"
"154411",0,0,0,0,"dummy"
"154412",1,3,0,4,"dummy"
"154413",0,1,0,1,"dummy"
"154425",3,11,7,21,"dummy"
"154426",4,5,2,11,"dummy"
"154433",4,0,0,4,"dummy"
"154440",2,1,0,3,"dummy"
"154441",0,0,1,1,"dummy"
"154442",0,0,1,1,"dummy"
"154443",0,0,2,2,"dummy"
"154444",0,0,1,1,"dummy"
"154445",0,0,1,1,"dummy"
"154446",0,0,1,1,"dummy"
"154447",0,0,1,1,"dummy"
"154448",0,0,1,1,"dummy"
"154449",0,0,1,1,"dummy"
"154452",0,0,1,1,"dummy"
"154454",4,0,1,5,"dummy"
"154455",0,1,1,2,"dummy"
"154456",2,2,0,4,"dummy"
"154457",0,1,1,2,"dummy"
"154458",1,1,0,2,"dummy"
"154459",0,0,1,1,"dummy"
"154460",2,1,0,3,"dummy"
"154463",3,2,0,5,"dummy"
"154464",0,0,1,1,"dummy"
"154465",0,0,3,3,"dummy"
"154466",0,0,1,1,"dummy"
"154467",0,0,1,1,"dummy"
"154469",2,4,4,10,"dummy"
"154471",1,0,0,1,"dummy"
"154474",0,1,0,1,"dummy"
"154506",0,1,0,1,"dummy"
"154509",1,2,2,5,"dummy"
"154510",1,0,2,3,"dummy"
"154511",3,0,3,6,"dummy"
"154512",0,0,2,2,"dummy"
"154514",0,0,1,1,"dummy"
"154523",0,0,0,0,"dummy"
"154524",0,0,0,0,"dummy"
"154525",0,0,0,0,"dummy"
"154526",0,0,1,1,"dummy"
"154527",0,0,0,0,"dummy"
"154528",0,0,0,0,"dummy"
"154529",1,0,0,1,"dummy"
"154530",0,0,0,0,"dummy"
"154531",0,0,0,0,"dummy"
"154532",0,0,0,0,"dummy"
"154533",0,0,0,0,"dummy"
"154534",0,1,0,1,"dummy"
"154535",0,0,0,0,"dummy"
"154536",0,0,1,1,"dummy"
"154537",0,0,0,0,"dummy"
"154538",0,0,0,0,"dummy"
"154539",0,0,0,0,"dummy"
"154540",0,0,0,0,"dummy"
"154541",0,0,0,0,"dummy"
"154542",0,0,0,0,"dummy"
"154545",0,0,1,1,"dummy"
"154547",0,0,1,1,"dummy"
"154549",0,1,0,1,"dummy"
"154551",4,2,4,10,"dummy"
"154552",0,0,1,1,"dummy"
"154553",1,0,0,1,"dummy"
"154558",0,0,0,0,"dummy"
"154559",0,0,0,0,"dummy"
"154560",0,0,0,0,"dummy"
"154561",0,1,0,1,"dummy"
"154562",0,0,0,0,"dummy"
"154563",0,0,0,0,"dummy"
"154564",0,3,0,3,"dummy"
"154565",0,1,1,2,"dummy"
"154566",0,0,1,1,"dummy"
"154567",0,0,1,1,"dummy"
"154568",0,0,1,1,"dummy"
"154569",0,0,1,1,"dummy"
"154570",0,0,1,1,"dummy"
"154571",0,0,1,1,"dummy"
"154572",0,0,1,1,"dummy"
"154573",0,1,0,1,"dummy"
"154574",0,0,1,1,"dummy"
"154575",0,1,0,1,"dummy"
"154576",0,0,1,1,"dummy"
"154577",1,1,0,2,"dummy"
"154583",2,5,0,7,"dummy"
"154584",0,2,1,3,"dummy"
"154586",0,0,1,1,"dummy"
"154589",1,1,2,4,"dummy"
"154599",2,0,3,5,"dummy"
"154600",0,3,4,7,"dummy"
"154601",0,0,3,3,"dummy"
"154603",0,0,2,2,"dummy"
"154604",0,0,1,1,"dummy"
"154605",4,0,0,4,"dummy"
"154606",24,0,0,24,"dummy"
"154607",0,0,0,0,"dummy"
"154608",0,3,0,3,"dummy"
"154611",4,1,0,5,"dummy"
"154615",0,0,0,0,"dummy"
"154616",0,0,3,3,"dummy"
"154619",0,0,1,1,"dummy"
"154621",0,1,0,1,"dummy"
"154623",0,2,1,3,"dummy"
"154624",0,2,1,3,"dummy"
"154625",0,1,1,2,"dummy"
"154626",0,3,0,3,"dummy"
"154627",0,0,1,1,"dummy"
"154628",0,3,0,3,"dummy"
"154629",0,1,0,1,"dummy"
"154630",1,0,0,1,"dummy"
"154631",0,1,1,2,"dummy"
"154632",0,0,0,0,"dummy"
"154633",1,0,1,2,"dummy"
"154634",0,0,1,1,"dummy"
"154635",0,1,0,1,"dummy"
"154636",3,0,0,3,"dummy"
"154637",0,1,1,2,"dummy"
"154638",1,0,1,2,"dummy"
"154639",0,1,0,1,"dummy"
"154640",0,0,1,1,"dummy"
"154642",0,17,0,17,"dummy"
"154643",0,1,0,1,"dummy"
"154644",0,1,0,1,"dummy"
"154645",0,0,0,0,"dummy"
"154646",0,1,0,1,"dummy"
"154647",2,0,0,2,"dummy"
"154648",3,3,0,6,"dummy"
"154649",0,2,0,2,"dummy"
"154650",0,2,0,2,"dummy"
"154653",0,2,0,2,"dummy"
"154654",0,0,3,3,"dummy"
"154655",0,0,1,1,"dummy"
"154656",0,3,3,6,"dummy"
"154657",0,2,0,2,"dummy"
"154660",0,0,1,1,"dummy"
"154661",2,0,1,3,"dummy"
"154662",0,0,1,1,"dummy"
"154666",0,1,1,2,"dummy"
"154672",0,2,0,2,"dummy"
"154673",2,0,0,2,"dummy"
"154674",0,0,2,2,"dummy"
"154676",0,2,0,2,"dummy"
"154677",1,0,0,1,"dummy"
"154682",0,1,0,1,"dummy"
"154683",0,0,1,1,"dummy"
"154684",1,2,0,3,"dummy"
"154685",0,1,1,2,"dummy"
"154689",0,1,0,1,"dummy"
"154690",1,10,0,11,"dummy"
"154692",0,0,0,0,"dummy"
"154693",0,0,0,0,"dummy"
"154694",0,0,0,0,"dummy"
"154695",0,1,0,1,"dummy"
"154697",0,3,0,3,"dummy"
"154698",0,1,0,1,"dummy"
"154699",0,0,1,1,"dummy"
"154700",0,3,0,3,"dummy"
"154701",0,2,0,2,"dummy"
"154702",0,12,0,12,"dummy"
"154704",1,0,0,1,"dummy"
"154705",1,2,0,3,"dummy"
"154706",0,1,0,1,"dummy"
"154708",0,1,1,2,"dummy"
"154710",0,0,2,2,"dummy"
"154711",0,0,2,2,"dummy"
"154712",0,0,1,1,"dummy"
"154713",0,0,2,2,"dummy"
"154714",0,0,1,1,"dummy"
"154715",0,0,1,1,"dummy"
"154716",0,0,1,1,"dummy"
"154718",1,5,0,6,"dummy"
"154720",0,1,0,1,"dummy"
"154721",0,0,1,1,"dummy"
"154723",7,0,3,10,"dummy"
"154724",0,2,0,2,"dummy"
"154727",2,4,1,7,"dummy"
"154728",4,2,0,6,"dummy"
"154729",2,2,0,4,"dummy"
"154731",0,1,0,1,"dummy"
"154732",0,1,0,1,"dummy"
"154733",0,1,0,1,"dummy"
"154734",0,1,0,1,"dummy"
"154735",0,1,0,1,"dummy"
"154736",1,0,0,1,"dummy"
"154737",1,1,0,2,"dummy"
"154738",1,2,1,4,"dummy"
"154740",0,0,1,1,"dummy"
"154741",0,6,0,6,"dummy"
"154742",0,1,0,1,"dummy"
"154743",0,0,1,1,"dummy"
"154744",3,1,1,5,"dummy"
"154745",0,3,0,3,"dummy"
"154746",0,0,0,0,"dummy"
"154747",0,0,1,1,"dummy"
"154748",0,0,1,1,"dummy"
"154749",0,0,1,1,"dummy"
"154773",6,6,2,14,"dummy"
"154774",1,2,0,3,"dummy"
"154775",0,0,0,0,"dummy"
"154777",0,0,2,2,"dummy"
"154778",0,0,2,2,"dummy"
"154779",0,0,1,1,"dummy"
"154789",0,0,2,2,"dummy"
"154791",0,2,0,2,"dummy"
"154793",4,6,0,10,"dummy"
"154795",0,0,1,1,"dummy"
"154796",0,1,0,1,"dummy"
"154797",0,0,1,1,"dummy"
"154801",0,1,0,1,"dummy"
"154802",0,0,1,1,"dummy"
"154803",0,0,0,0,"dummy"
"154804",0,1,0,1,"dummy"
"154805",1,0,0,1,"dummy"
"154806",1,0,0,1,"dummy"
"154808",0,1,1,2,"dummy"
"154812",0,7,1,8,"dummy"
"154813",0,1,1,2,"dummy"
"154814",0,5,0,5,"dummy"
"154815",0,5,0,5,"dummy"
"154817",0,0,1,1,"dummy"
"154818",5,0,2,7,"dummy"
"154819",1,2,0,3,"dummy"
"154820",1,0,0,1,"dummy"
"154821",0,0,0,0,"dummy"
"154822",0,1,1,2,"dummy"
"154825",0,1,0,1,"dummy"
"154826",1,0,1,2,"dummy"
"154827",0,2,1,3,"dummy"
"154828",1,5,0,6,"dummy"
"154829",0,7,0,7,"dummy"
"154836",1,3,0,4,"dummy"
"154837",0,1,0,1,"dummy"
"154838",3,6,3,12,"dummy"
"154841",2,4,1,7,"dummy"
"154842",0,0,0,0,"dummy"
"154843",0,2,2,4,"dummy"
"154846",0,2,0,2,"dummy"
"154847",0,0,2,2,"dummy"
"154848",0,1,0,1,"dummy"
"154849",0,0,1,1,"dummy"
"154850",0,1,0,1,"dummy"
"154851",0,0,1,1,"dummy"
"154852",1,0,0,1,"dummy"
"154853",0,0,1,1,"dummy"
"154854",9,5,2,16,"dummy"
"154855",1,1,0,2,"dummy"
"154856",1,3,1,5,"dummy"
"154858",0,9,0,9,"dummy"
"154859",0,0,2,2,"dummy"
"154860",0,2,0,2,"dummy"
"154861",2,1,0,3,"dummy"
"154862",11,0,0,11,"dummy"
"154866",0,5,1,6,"dummy"
"154867",0,1,1,2,"dummy"
"154868",10,22,1,33,"dummy"
"154869",0,3,0,3,"dummy"
"154870",0,0,1,1,"dummy"
"154871",0,0,1,1,"dummy"
"154872",0,0,2,2,"dummy"
"154873",26,3,7,36,"dummy"
"154875",0,7,1,8,"dummy"
"154876",2,2,1,5,"dummy"
"154880",2,9,0,11,"dummy"
"154881",17,3,4,24,"dummy"
"154882",0,0,1,1,"dummy"
"154883",0,0,2,2,"dummy"
"154884",0,0,1,1,"dummy"
"154885",0,0,1,1,"dummy"
"154886",0,0,1,1,"dummy"
"154887",1,1,0,2,"dummy"
"154888",0,0,2,2,"dummy"
"154889",1,1,2,4,"dummy"
"154890",0,1,0,1,"dummy"
"154891",0,0,1,1,"dummy"
"154892",0,0,1,1,"dummy"
"154893",0,0,1,1,"dummy"
"154894",1,0,0,1,"dummy"
"154895",0,0,1,1,"dummy"
"154896",0,0,1,1,"dummy"
"154913",0,0,0,0,"dummy"
"154914",0,0,0,0,"dummy"
"154915",0,0,0,0,"dummy"
"154916",0,0,0,0,"dummy"
"154917",0,0,0,0,"dummy"
"154919",1,12,0,13,"dummy"
"154924",0,2,0,2,"dummy"
"154925",2,0,0,2,"dummy"
"154927",0,1,1,2,"dummy"
"154928",0,1,0,1,"dummy"
"154938",0,2,0,2,"dummy"
"154940",4,7,2,13,"dummy"
"154941",0,0,1,1,"dummy"
"154942",0,1,0,1,"dummy"
"154943",17,9,9,35,"dummy"
"154944",1,1,0,2,"dummy"
"154948",0,6,0,6,"dummy"
"154949",0,0,2,2,"dummy"
"154950",0,0,1,1,"dummy"
"154952",4,0,0,4,"dummy"
"154953",0,0,2,2,"dummy"
"154954",0,0,2,2,"dummy"
"154956",0,1,0,1,"dummy"
"154967",0,0,1,1,"dummy"
"154968",0,0,1,1,"dummy"
"154969",0,0,1,1,"dummy"
"154970",1,0,0,1,"dummy"
"154971",0,5,2,7,"dummy"
"154972",0,1,0,1,"dummy"
"154974",0,5,0,5,"dummy"
"154975",4,2,0,6,"dummy"
"154976",0,0,1,1,"dummy"
"154977",0,0,1,1,"dummy"
"154978",1,2,0,3,"dummy"
"154979",6,0,1,7,"dummy"
"154980",2,1,1,4,"dummy"
"154981",1,1,0,2,"dummy"
"154982",0,1,1,2,"dummy"
"154983",0,1,0,1,"dummy"
"154984",1,0,2,3,"dummy"
"154985",1,7,1,9,"dummy"
"154986",2,0,2,4,"dummy"
"154987",0,2,0,2,"dummy"
"154988",0,1,0,1,"dummy"
"154989",0,6,0,6,"dummy"
"154990",0,3,0,3,"dummy"
"155001",1,0,0,1,"dummy"
"155002",0,1,0,1,"dummy"
"155003",2,5,1,8,"dummy"
"155004",1,0,0,1,"dummy"
"155005",0,1,1,2,"dummy"
"155006",2,0,0,2,"dummy"
"155007",1,0,2,3,"dummy"
"155008",3,3,2,8,"dummy"
"155010",0,12,0,12,"dummy"
"155011",0,2,0,2,"dummy"
"155013",0,0,1,1,"dummy"
"155015",0,0,1,1,"dummy"
"155022",4,8,0,12,"dummy"
"155024",0,1,1,2,"dummy"
"155025",1,0,0,1,"dummy"
"155027",0,1,0,1,"dummy"
"155028",1,0,0,1,"dummy"
"155029",4,7,2,13,"dummy"
"155030",0,0,1,1,"dummy"
"155031",1,0,0,1,"dummy"
"155033",0,0,3,3,"dummy"
"155034",7,0,3,10,"dummy"
"155040",1,0,0,1,"dummy"
"155041",0,0,0,0,"dummy"
"155042",0,19,2,21,"dummy"
"155044",5,2,1,8,"dummy"
"155045",2,2,0,4,"dummy"
"155046",0,2,0,2,"dummy"
"155047",0,6,0,6,"dummy"
"155048",0,2,0,2,"dummy"
"155049",0,2,0,2,"dummy"
"155050",0,2,0,2,"dummy"
"155051",4,7,0,11,"dummy"
"155052",0,4,0,4,"dummy"
"155053",0,2,0,2,"dummy"
"155054",6,0,0,6,"dummy"
"155055",0,3,0,3,"dummy"
"155056",0,0,2,2,"dummy"
"155057",1,3,0,4,"dummy"
"155058",0,0,1,1,"dummy"
"155059",7,0,3,10,"dummy"
"155060",0,0,1,1,"dummy"
"155061",0,0,1,1,"dummy"
"155062",0,0,1,1,"dummy"
"155063",0,0,1,1,"dummy"
"155064",0,0,1,1,"dummy"
"155065",0,0,1,1,"dummy"
"155066",0,0,1,1,"dummy"
"155067",10,17,0,27,"dummy"
"155076",0,1,0,1,"dummy"
"155077",1,0,0,1,"dummy"
"155078",0,1,0,1,"dummy"
"155090",1,4,1,6,"dummy"
"155091",0,1,3,4,"dummy"
"155092",0,0,1,1,"dummy"
"155093",3,2,2,7,"dummy"
"155094",0,2,0,2,"dummy"
"155095",3,2,1,6,"dummy"
"155096",0,0,2,2,"dummy"
"155098",2,5,0,7,"dummy"
"155100",0,2,0,2,"dummy"
"155105",1,2,0,3,"dummy"
"155106",5,2,1,8,"dummy"
"155107",2,9,0,11,"dummy"
"155108",0,3,0,3,"dummy"
"155109",0,1,1,2,"dummy"
"155110",0,3,0,3,"dummy"
"155111",0,1,0,1,"dummy"
"155112",0,0,1,1,"dummy"
"155113",3,0,0,3,"dummy"
"155114",3,2,0,5,"dummy"
"155115",0,0,1,1,"dummy"
"155116",0,1,0,1,"dummy"
"155117",0,2,0,2,"dummy"
"155118",1,6,0,7,"dummy"
"155119",0,0,1,1,"dummy"
"155120",1,0,0,1,"dummy"
"155121",3,3,2,8,"dummy"
"155122",1,2,1,4,"dummy"
"155123",15,0,3,18,"dummy"
"155124",0,0,0,0,"dummy"
"155125",0,0,0,0,"dummy"
"155126",0,0,0,0,"dummy"
"155127",0,0,1,1,"dummy"
"155128",2,3,0,5,"dummy"
"155129",0,1,0,1,"dummy"
"155130",0,1,0,1,"dummy"
"155131",0,1,0,1,"dummy"
"155132",0,0,0,0,"dummy"
"155133",1,0,0,1,"dummy"
"155134",1,0,1,2,"dummy"
"155135",0,0,0,0,"dummy"
"155136",0,1,0,1,"dummy"
"155137",3,0,0,3,"dummy"
"155138",0,0,2,2,"dummy"
"155139",0,0,1,1,"dummy"
"155140",0,0,1,1,"dummy"
"155141",0,0,0,0,"dummy"
"155142",0,1,0,1,"dummy"
"155143",0,0,1,1,"dummy"
"155144",2,0,0,2,"dummy"
"155145",0,0,1,1,"dummy"
"155146",0,0,1,1,"dummy"
"155147",0,1,0,1,"dummy"
"155148",1,0,0,1,"dummy"
"155149",0,2,0,2,"dummy"
"155150",0,0,2,2,"dummy"
"155151",0,2,0,2,"dummy"
"155152",0,2,0,2,"dummy"
"155153",1,0,0,1,"dummy"
"155154",0,2,0,2,"dummy"
"155155",0,2,2,4,"dummy"
"155156",0,0,0,0,"dummy"
"155157",9,9,0,18,"dummy"
"155158",2,0,0,2,"dummy"
"155159",0,0,1,1,"dummy"
"155160",4,2,1,7,"dummy"
"155161",0,2,0,2,"dummy"
"155162",0,0,1,1,"dummy"
"155163",0,0,1,1,"dummy"
"155164",0,0,1,1,"dummy"
"155165",0,0,1,1,"dummy"
"155166",0,0,2,2,"dummy"
"155167",0,0,2,2,"dummy"
"155168",0,0,2,2,"dummy"
"155169",0,0,2,2,"dummy"
"155170",0,0,2,2,"dummy"
"155171",0,1,2,3,"dummy"
"155172",3,4,0,7,"dummy"
"155173",1,1,0,2,"dummy"
"155174",1,0,0,1,"dummy"
"155175",1,0,0,1,"dummy"
"155176",0,0,2,2,"dummy"
"155177",0,0,0,0,"dummy"
"155178",1,0,0,1,"dummy"
"155179",2,0,0,2,"dummy"
"155180",1,1,1,3,"dummy"
"155181",2,1,0,3,"dummy"
"155182",0,0,2,2,"dummy"
"155183",0,1,0,1,"dummy"
"155184",0,0,0,0,"dummy"
"155185",1,0,0,1,"dummy"
"155186",0,0,0,0,"dummy"
"155187",0,0,2,2,"dummy"
"155188",0,0,1,1,"dummy"
"155189",1,1,0,2,"dummy"
"155190",0,0,1,1,"dummy"
"155191",0,0,0,0,"dummy"
"155192",0,0,0,0,"dummy"
"155193",0,0,1,1,"dummy"
"155194",0,0,1,1,"dummy"
"155195",0,0,1,1,"dummy"
"155196",0,1,0,1,"dummy"
"155197",0,1,1,2,"dummy"
"155198",0,0,1,1,"dummy"
"155199",0,0,1,1,"dummy"
"155200",0,0,1,1,"dummy"
"155201",0,0,1,1,"dummy"
"155202",0,0,1,1,"dummy"
"155203",0,0,1,1,"dummy"
"155204",0,0,1,1,"dummy"
"155205",0,0,1,1,"dummy"
"155206",0,0,0,0,"dummy"
"155207",0,0,0,0,"dummy"
"155208",3,0,0,3,"dummy"
"155209",0,0,0,0,"dummy"
"155210",0,3,1,4,"dummy"
"155211",0,0,1,1,"dummy"
"155212",0,0,1,1,"dummy"
"155213",0,0,1,1,"dummy"
"155214",0,0,1,1,"dummy"
"155215",0,0,1,1,"dummy"
"155216",0,0,1,1,"dummy"
"155217",3,0,0,3,"dummy"
"155218",0,0,0,0,"dummy"
"155219",0,0,0,0,"dummy"
"155220",0,0,0,0,"dummy"
"155221",0,0,1,1,"dummy"
"155222",0,0,0,0,"dummy"
"155223",0,0,0,0,"dummy"
"155224",0,0,0,0,"dummy"
"155225",0,0,0,0,"dummy"
"155226",0,0,0,0,"dummy"
"155227",0,0,1,1,"dummy"
"155228",0,0,1,1,"dummy"
"155229",0,0,0,0,"dummy"
"155230",0,0,1,1,"dummy"
"155231",0,0,1,1,"dummy"
"155232",0,0,1,1,"dummy"
"155233",0,0,0,0,"dummy"
"155234",0,0,0,0,"dummy"
"155235",0,0,0,0,"dummy"
"155236",0,0,1,1,"dummy"
"155237",0,0,0,0,"dummy"
"155238",0,0,0,0,"dummy"
"155239",0,0,1,1,"dummy"
"155241",0,7,0,7,"dummy"
"155243",3,0,0,3,"dummy"
"155244",0,0,1,1,"dummy"
"155247",2,0,1,3,"dummy"
"155250",0,2,0,2,"dummy"
"155251",1,0,0,1,"dummy"
"155252",0,2,0,2,"dummy"
"155253",0,2,0,2,"dummy"
"155254",1,0,0,1,"dummy"
"155255",0,1,0,1,"dummy"
"155256",0,3,0,3,"dummy"
"155257",0,0,1,1,"dummy"
"155258",0,1,1,2,"dummy"
"155260",1,4,0,5,"dummy"
"155262",0,0,0,0,"dummy"
"155263",0,1,0,1,"dummy"
"155264",0,0,2,2,"dummy"
"155268",4,1,2,7,"dummy"
"155269",0,0,1,1,"dummy"
"155270",0,0,1,1,"dummy"
"155271",0,0,1,1,"dummy"
"155272",0,0,1,1,"dummy"
"155276",0,1,0,1,"dummy"
"155278",0,0,0,0,"dummy"
"155279",0,6,0,6,"dummy"
"155281",1,3,1,5,"dummy"
"155282",0,2,0,2,"dummy"
"155283",0,1,1,2,"dummy"
"155284",1,2,1,4,"dummy"
"155285",1,1,0,2,"dummy"
"155286",0,0,1,1,"dummy"
"155287",0,0,1,1,"dummy"
"155288",3,0,1,4,"dummy"
"155289",0,1,1,2,"dummy"
"155290",0,0,1,1,"dummy"
"155296",0,0,1,1,"dummy"
"155298",0,4,0,4,"dummy"
"155300",0,1,0,1,"dummy"
"155303",0,2,1,3,"dummy"
"155304",4,6,0,10,"dummy"
"155306",2,2,3,7,"dummy"
"155312",0,1,1,2,"dummy"
"155313",0,2,0,2,"dummy"
"155314",4,2,3,9,"dummy"
"155323",0,2,1,3,"dummy"
"155324",0,1,1,2,"dummy"
"155325",0,0,1,1,"dummy"
"155326",3,3,0,6,"dummy"
"155328",2,2,0,4,"dummy"
"155329",0,4,0,4,"dummy"
"155330",4,0,0,4,"dummy"
"155331",1,0,0,1,"dummy"
"155332",1,6,1,8,"dummy"
"155333",1,1,0,2,"dummy"
"155334",0,0,0,0,"dummy"
"155335",0,1,0,1,"dummy"
"155336",2,0,4,6,"dummy"
"155340",0,0,1,1,"dummy"
"155343",0,0,1,1,"dummy"
"155346",0,0,1,1,"dummy"
"155347",0,3,0,3,"dummy"
"155348",0,2,0,2,"dummy"
"155349",0,1,0,1,"dummy"
"155350",0,0,1,1,"dummy"
"155352",1,2,0,3,"dummy"
"155353",0,8,0,8,"dummy"
"155354",0,0,0,0,"dummy"
"155361",2,4,0,6,"dummy"
"155362",0,2,0,2,"dummy"
"155363",0,2,0,2,"dummy"
"155364",10,2,0,12,"dummy"
"155365",0,2,0,2,"dummy"
"155366",0,0,0,0,"dummy"
"155370",2,0,4,6,"dummy"
"155371",1,8,3,12,"dummy"
"155372",2,0,1,3,"dummy"
"155373",1,0,0,1,"dummy"
"155374",1,2,0,3,"dummy"
"155375",1,1,0,2,"dummy"
"155376",0,2,0,2,"dummy"
"155377",0,0,1,1,"dummy"
"155378",7,0,1,8,"dummy"
"155379",0,0,1,1,"dummy"
"155381",0,4,0,4,"dummy"
"155382",0,1,3,4,"dummy"
"155383",0,0,0,0,"dummy"
"155384",1,0,1,2,"dummy"
"155385",0,1,0,1,"dummy"
"155386",3,2,3,8,"dummy"
"155387",0,1,0,1,"dummy"
"155388",0,2,0,2,"dummy"
"155389",2,2,0,4,"dummy"
"155390",6,0,1,7,"dummy"
"155391",0,0,1,1,"dummy"
"155393",10,0,1,11,"dummy"
"155394",0,1,0,1,"dummy"
"155401",0,0,2,2,"dummy"
"155404",0,0,0,0,"dummy"
"155405",0,0,2,2,"dummy"
"155406",0,0,2,2,"dummy"
"155408",0,0,1,1,"dummy"
"155410",0,0,3,3,"dummy"
"155412",2,0,0,2,"dummy"
"155413",3,5,1,9,"dummy"
"155419",0,3,2,5,"dummy"
"155420",0,0,1,1,"dummy"
"155421",0,1,0,1,"dummy"
"155424",0,3,0,3,"dummy"
"155425",1,0,1,2,"dummy"
"155428",8,25,2,35,"dummy"
"155429",9,2,5,16,"dummy"
"155430",3,6,1,10,"dummy"
"155431",1,2,0,3,"dummy"
"155432",1,2,0,3,"dummy"
"155437",1,0,0,1,"dummy"
"155438",0,2,0,2,"dummy"
"155439",2,0,1,3,"dummy"
"155440",0,2,0,2,"dummy"
"155441",2,0,0,2,"dummy"
"155442",3,7,1,11,"dummy"
"155443",0,0,0,0,"dummy"
"155444",0,0,1,1,"dummy"
"155445",0,0,1,1,"dummy"
"155446",0,0,2,2,"dummy"
"155447",0,3,0,3,"dummy"
"155448",0,0,1,1,"dummy"
"155449",0,1,0,1,"dummy"
"155450",0,0,1,1,"dummy"
"155451",0,0,1,1,"dummy"
"155452",0,1,1,2,"dummy"
"155453",0,0,1,1,"dummy"
"155454",0,7,0,7,"dummy"
"155455",0,0,1,1,"dummy"
"155456",0,0,1,1,"dummy"
"155457",0,0,1,1,"dummy"
"155458",0,0,2,2,"dummy"
"155459",0,0,1,1,"dummy"
"155460",3,0,0,3,"dummy"
"155461",0,0,1,1,"dummy"
"155462",0,0,1,1,"dummy"
"155463",0,0,1,1,"dummy"
"155464",0,0,1,1,"dummy"
"155465",0,0,1,1,"dummy"
"155466",0,0,1,1,"dummy"
"155468",0,0,2,2,"dummy"
"155470",0,2,0,2,"dummy"
"155473",1,2,0,3,"dummy"
"155474",0,1,0,1,"dummy"
"155475",0,1,0,1,"dummy"
"155476",0,2,0,2,"dummy"
"155477",2,0,1,3,"dummy"
"155479",0,2,0,2,"dummy"
"155484",0,0,0,0,"dummy"
"155485",0,0,0,0,"dummy"
"155488",2,0,0,2,"dummy"
"155490",0,2,1,3,"dummy"
"155492",0,0,1,1,"dummy"
"155493",1,0,0,1,"dummy"
"155495",0,0,1,1,"dummy"
"155496",0,1,0,1,"dummy"
"155499",2,3,0,5,"dummy"
"155500",1,3,0,4,"dummy"
"155501",1,1,0,2,"dummy"
"155502",2,3,0,5,"dummy"
"155503",0,1,0,1,"dummy"
"155504",6,14,4,24,"dummy"
"155505",0,1,0,1,"dummy"
"155508",3,0,1,4,"dummy"
"155511",0,0,1,1,"dummy"
"155513",0,1,0,1,"dummy"
"155514",0,15,0,15,"dummy"
"155515",11,18,2,31,"dummy"
"155516",14,25,6,45,"dummy"
"155517",0,1,0,1,"dummy"
"155518",1,2,0,3,"dummy"
"155519",0,3,0,3,"dummy"
"155522",1,0,0,1,"dummy"
"155523",0,1,0,1,"dummy"
"155524",1,0,0,1,"dummy"
"155527",0,0,1,1,"dummy"
"155528",0,1,0,1,"dummy"
"155534",0,0,2,2,"dummy"
"155535",0,0,2,2,"dummy"
"155536",0,0,2,2,"dummy"
"155537",0,1,0,1,"dummy"
"155538",0,0,3,3,"dummy"
"155539",0,0,3,3,"dummy"
"155540",0,0,2,2,"dummy"
"155541",0,1,3,4,"dummy"
"155542",1,0,0,1,"dummy"
"155543",0,1,0,1,"dummy"
"155560",0,0,0,0,"dummy"
"155561",2,1,0,3,"dummy"
"155562",0,1,0,1,"dummy"
"155563",4,4,0,8,"dummy"
"155564",0,2,0,2,"dummy"
"155565",1,0,1,2,"dummy"
"155566",1,11,0,12,"dummy"
"155568",6,0,0,6,"dummy"
"155569",0,0,1,1,"dummy"
"155570",0,1,0,1,"dummy"
"155571",0,0,0,0,"dummy"
"155572",0,0,3,3,"dummy"
"155573",5,0,1,6,"dummy"
"155574",0,0,0,0,"dummy"
"155576",0,0,0,0,"dummy"
"155577",0,0,3,3,"dummy"
"155579",0,0,0,0,"dummy"
"155580",0,4,0,4,"dummy"
"155581",0,3,0,3,"dummy"
"155582",0,7,0,7,"dummy"
"155583",0,2,0,2,"dummy"
"155584",0,2,0,2,"dummy"
"155585",0,2,0,2,"dummy"
"155586",0,0,1,1,"dummy"
"155587",0,1,0,1,"dummy"
"155588",1,1,0,2,"dummy"
"155589",1,0,0,1,"dummy"
"155590",0,0,1,1,"dummy"
"155591",0,1,0,1,"dummy"
"155592",0,0,2,2,"dummy"
"155594",0,6,2,8,"dummy"
"155595",0,0,1,1,"dummy"
"155596",0,0,2,2,"dummy"
"155597",7,12,2,21,"dummy"
"155598",0,0,1,1,"dummy"
"155599",0,0,1,1,"dummy"
"155601",0,0,2,2,"dummy"
"155602",0,1,0,1,"dummy"
"155604",1,4,0,5,"dummy"
"155606",0,1,1,2,"dummy"
"155607",1,0,0,1,"dummy"
"155634",0,0,1,1,"dummy"
"155635",0,0,0,0,"dummy"
"155637",0,2,2,4,"dummy"
"155638",0,1,0,1,"dummy"
"155641",0,1,0,1,"dummy"
"155642",1,0,0,1,"dummy"
"155645",1,4,0,5,"dummy"
"155646",4,0,0,4,"dummy"
"155647",0,0,0,0,"dummy"
"155650",3,1,1,5,"dummy"
"155651",0,1,0,1,"dummy"
"155652",0,1,0,1,"dummy"
"155653",0,1,0,1,"dummy"
"155654",1,0,0,1,"dummy"
"155656",0,0,3,3,"dummy"
"155657",0,4,0,4,"dummy"
"155658",0,0,1,1,"dummy"
"155659",1,0,0,1,"dummy"
"155660",2,0,0,2,"dummy"
"155662",0,15,0,15,"dummy"
"155663",0,4,0,4,"dummy"
"155664",0,1,0,1,"dummy"
"155665",0,2,0,2,"dummy"
"155667",0,0,2,2,"dummy"
"155671",0,1,0,1,"dummy"
"155674",0,1,0,1,"dummy"
"155675",0,1,0,1,"dummy"
"155676",0,1,0,1,"dummy"
"155677",1,0,0,1,"dummy"
"155678",1,0,1,2,"dummy"
"155681",7,3,1,11,"dummy"
"155682",2,2,3,7,"dummy"
"155683",0,10,1,11,"dummy"
"155686",2,2,1,5,"dummy"
"155687",0,0,1,1,"dummy"
"155688",0,1,0,1,"dummy"
"155689",0,1,0,1,"dummy"
"155690",6,2,2,10,"dummy"
"155691",4,1,3,8,"dummy"
"155693",1,4,1,6,"dummy"
"155694",0,0,0,0,"dummy"
"155696",1,1,0,2,"dummy"
"155697",9,17,3,29,"dummy"
"155698",0,0,0,0,"dummy"
"155700",0,1,0,1,"dummy"
"155702",2,6,1,9,"dummy"
"155703",2,2,1,5,"dummy"
"155706",0,0,0,0,"dummy"
"155707",0,1,0,1,"dummy"
"155708",0,0,1,1,"dummy"
"155709",7,0,2,9,"dummy"
"155710",0,0,3,3,"dummy"
"155711",0,0,1,1,"dummy"
"155713",0,1,0,1,"dummy"
"155715",2,4,0,6,"dummy"
"155716",1,2,0,3,"dummy"
"155717",0,1,0,1,"dummy"
"155718",0,0,1,1,"dummy"
"155719",2,5,1,8,"dummy"
"155720",0,0,6,6,"dummy"
"155721",5,4,0,9,"dummy"
"155725",0,0,0,0,"dummy"
"155726",0,2,0,2,"dummy"
"155727",0,0,0,0,"dummy"
"155728",0,1,1,2,"dummy"
"155729",0,1,0,1,"dummy"
"155739",0,10,0,10,"dummy"
"155740",0,25,0,25,"dummy"
"155741",2,0,0,2,"dummy"
"155742",0,16,0,16,"dummy"
"155743",1,5,1,7,"dummy"
"155744",0,10,0,10,"dummy"
"155746",1,0,0,1,"dummy"
"155747",2,1,1,4,"dummy"
"155748",1,5,1,7,"dummy"
"155749",1,0,0,1,"dummy"
"155750",1,0,3,4,"dummy"
"155754",2,16,0,18,"dummy"
"155755",0,1,0,1,"dummy"
"155759",1,1,1,3,"dummy"
"155760",12,8,2,22,"dummy"
"155761",5,2,2,9,"dummy"
"155762",2,2,0,4,"dummy"
"155763",0,3,1,4,"dummy"
"155764",0,0,1,1,"dummy"
"155768",0,3,0,3,"dummy"
"155769",0,1,0,1,"dummy"
"155770",10,12,0,22,"dummy"
"155771",0,0,1,1,"dummy"
"155772",10,0,1,11,"dummy"
"155773",0,0,1,1,"dummy"
"155774",1,10,0,11,"dummy"
"155775",0,2,0,2,"dummy"
"155776",2,0,0,2,"dummy"
"155777",0,1,0,1,"dummy"
"155778",0,2,0,2,"dummy"
"155779",0,2,0,2,"dummy"
"155780",4,1,0,5,"dummy"
"155781",1,4,0,5,"dummy"
"155782",5,2,2,9,"dummy"
"155784",0,0,1,1,"dummy"
"155785",2,4,3,9,"dummy"
"155788",0,1,0,1,"dummy"
"155791",1,0,0,1,"dummy"
"155792",0,0,2,2,"dummy"
"155793",1,8,6,15,"dummy"
"155794",0,2,0,2,"dummy"
"155795",0,1,0,1,"dummy"
"155796",1,1,0,2,"dummy"
"155797",0,1,0,1,"dummy"
"155799",0,0,0,0,"dummy"
"155800",0,1,0,1,"dummy"
"155801",1,2,1,4,"dummy"
"155804",0,3,0,3,"dummy"
"155805",0,1,0,1,"dummy"
"155806",2,0,0,2,"dummy"
"155807",0,1,0,1,"dummy"
"155808",0,0,0,0,"dummy"
"155809",0,1,0,1,"dummy"
"155810",0,1,0,1,"dummy"
"155812",0,4,0,4,"dummy"
"155813",1,2,1,4,"dummy"
"155814",1,0,0,1,"dummy"
"155815",0,4,0,4,"dummy"
"155816",0,2,0,2,"dummy"
"155817",0,1,0,1,"dummy"
"155818",2,1,0,3,"dummy"
"155819",0,1,0,1,"dummy"
"155820",0,0,0,0,"dummy"
"155821",0,0,0,0,"dummy"
"155822",1,0,1,2,"dummy"
"155823",0,2,0,2,"dummy"
"155824",0,1,0,1,"dummy"
"155825",0,1,0,1,"dummy"
"155826",0,2,1,3,"dummy"
"155827",3,1,1,5,"dummy"
"155828",0,0,0,0,"dummy"
"155829",0,2,0,2,"dummy"
"155830",0,1,0,1,"dummy"
"155831",0,1,0,1,"dummy"
"155832",4,0,0,4,"dummy"
"155833",0,0,0,0,"dummy"
"155834",0,0,0,0,"dummy"
"155835",0,0,0,0,"dummy"
"155838",0,5,0,5,"dummy"
"155839",0,10,0,10,"dummy"
"155840",0,6,0,6,"dummy"
"155841",0,4,0,4,"dummy"
"155842",11,9,9,29,"dummy"
"155843",0,1,0,1,"dummy"
"155844",0,1,0,1,"dummy"
"155845",0,4,0,4,"dummy"
"155846",0,1,1,2,"dummy"
"155847",0,2,0,2,"dummy"
"155848",1,1,0,2,"dummy"
"155849",0,0,0,0,"dummy"
"155850",0,0,0,0,"dummy"
"155851",0,2,0,2,"dummy"
"155852",0,6,0,6,"dummy"
"155853",0,2,0,2,"dummy"
"155854",1,2,0,3,"dummy"
"155855",1,2,1,4,"dummy"
"155856",1,0,0,1,"dummy"
"155857",0,0,0,0,"dummy"
"155858",0,0,2,2,"dummy"
"155859",3,0,1,4,"dummy"
"155860",0,0,2,2,"dummy"
"155861",0,1,0,1,"dummy"
"155862",0,0,1,1,"dummy"
"155863",5,1,0,6,"dummy"
"155864",1,6,0,7,"dummy"
"155865",5,1,0,6,"dummy"
"155866",0,5,1,6,"dummy"
"155867",8,0,0,8,"dummy"
"155868",0,8,0,8,"dummy"
"155869",0,2,0,2,"dummy"
"155870",0,0,0,0,"dummy"
"155871",0,1,0,1,"dummy"
"155872",10,6,0,16,"dummy"
"155873",6,10,0,16,"dummy"
"155874",10,6,0,16,"dummy"
"155875",1,0,0,1,"dummy"
"155876",0,2,0,2,"dummy"
"155877",0,1,0,1,"dummy"
"155878",0,1,1,2,"dummy"
"155879",0,5,0,5,"dummy"
"155881",9,9,7,25,"dummy"
"155889",1,0,1,2,"dummy"
"155890",0,0,0,0,"dummy"
"155891",0,1,0,1,"dummy"
"155892",0,0,1,1,"dummy"
"155895",0,1,0,1,"dummy"
"155896",0,0,0,0,"dummy"
"155897",2,2,0,4,"dummy"
"155914",0,1,0,1,"dummy"
"155923",5,0,1,6,"dummy"
"155925",0,0,1,1,"dummy"
"155927",1,3,0,4,"dummy"
"155933",5,0,0,5,"dummy"
"155934",1,0,2,3,"dummy"
"155935",0,0,2,2,"dummy"
"155937",0,5,0,5,"dummy"
"155938",10,1,0,11,"dummy"
"155948",0,0,0,0,"dummy"
"155950",0,0,2,2,"dummy"
"155961",3,3,0,6,"dummy"
"155962",0,0,3,3,"dummy"
"155964",2,0,0,2,"dummy"
"155965",0,0,0,0,"dummy"
"155967",0,0,2,2,"dummy"
"155968",0,0,0,0,"dummy"
"155969",2,1,0,3,"dummy"
"155970",11,1,2,14,"dummy"
"155971",0,8,0,8,"dummy"
"155972",0,1,0,1,"dummy"
"155973",2,0,1,3,"dummy"
"155974",2,3,2,7,"dummy"
"155975",3,2,2,7,"dummy"
"155976",2,1,2,5,"dummy"
"155977",1,0,0,1,"dummy"
"155979",0,2,0,2,"dummy"
"155989",1,5,1,7,"dummy"
"155994",0,4,0,4,"dummy"
"155995",0,1,0,1,"dummy"
"155996",0,0,1,1,"dummy"
"155997",0,0,1,1,"dummy"
"156004",0,2,0,2,"dummy"
"156011",1,3,0,4,"dummy"
"156015",0,0,0,0,"dummy"
"156016",2,7,5,14,"dummy"
"156021",0,1,0,1,"dummy"
"156022",2,1,4,7,"dummy"
"156023",1,2,4,7,"dummy"
"156024",2,1,4,7,"dummy"
"156037",0,1,0,1,"dummy"
"156038",0,0,0,0,"dummy"
"156039",0,1,0,1,"dummy"
"156040",0,0,2,2,"dummy"
"156041",0,0,1,1,"dummy"
"156044",0,0,1,1,"dummy"
"156045",0,0,0,0,"dummy"
"156046",0,0,0,0,"dummy"
"156047",0,0,0,0,"dummy"
"156062",0,1,0,1,"dummy"
"156063",0,1,0,1,"dummy"
"156083",1,0,1,2,"dummy"
"156086",0,1,1,2,"dummy"
"156087",1,3,2,6,"dummy"
"156088",2,0,0,2,"dummy"
"156091",0,2,1,3,"dummy"
"156143",0,0,2,2,"dummy"
"156144",11,10,5,26,"dummy"
"156151",0,23,1,24,"dummy"
"156164",0,4,0,4,"dummy"
"156165",0,5,0,5,"dummy"
"156166",4,1,0,5,"dummy"
"156167",0,0,1,1,"dummy"
"156168",0,0,0,0,"dummy"
"156169",0,0,1,1,"dummy"
"156170",0,0,1,1,"dummy"
"156171",0,0,1,1,"dummy"
"156172",0,1,1,2,"dummy"
"156173",0,0,1,1,"dummy"
"156174",0,0,1,1,"dummy"
"156175",0,0,1,1,"dummy"
"156176",0,0,1,1,"dummy"
"156177",0,0,1,1,"dummy"
"156178",0,0,1,1,"dummy"
"156179",0,0,1,1,"dummy"
"156180",0,0,1,1,"dummy"
"156181",0,0,1,1,"dummy"
"156182",0,0,1,1,"dummy"
"156183",0,0,1,1,"dummy"
"156184",0,0,1,1,"dummy"
"156185",0,0,2,2,"dummy"
"156186",0,0,1,1,"dummy"
"156206",0,2,0,2,"dummy"
"156210",0,0,1,1,"dummy"
"156211",0,0,0,0,"dummy"
"156212",0,0,1,1,"dummy"
"156213",0,0,1,1,"dummy"
"156218",0,1,1,2,"dummy"
"156219",0,0,1,1,"dummy"
"156220",0,0,2,2,"dummy"
"155983",0,2,0,2,"dummy"
"155984",0,3,0,3,"dummy"
"155987",0,1,0,1,"dummy"
"156008",1,0,1,2,"dummy"
"156009",0,0,2,2,"dummy"
"156013",0,0,1,1,"dummy"
"156026",0,7,1,8,"dummy"
"156027",2,0,0,2,"dummy"
"156032",1,1,2,4,"dummy"
"156035",0,0,1,1,"dummy"
"156065",6,2,3,11,"dummy"
"156066",9,7,4,20,"dummy"
"156067",0,0,1,1,"dummy"
"156068",0,0,2,2,"dummy"
"156069",0,3,1,4,"dummy"
"156070",3,3,3,9,"dummy"
"156075",0,0,1,1,"dummy"
"156076",0,0,1,1,"dummy"
"156077",0,1,0,1,"dummy"
"156078",13,6,3,22,"dummy"
"156079",1,0,0,1,"dummy"
"156107",1,4,2,7,"dummy"
"156108",2,10,2,14,"dummy"
"156109",8,10,2,20,"dummy"
"156110",0,4,1,5,"dummy"
"156113",7,0,3,10,"dummy"
"156118",0,11,0,11,"dummy"
"156119",0,0,1,1,"dummy"
"156120",0,0,0,0,"dummy"
"156121",4,0,0,4,"dummy"
"156122",0,1,0,1,"dummy"
"156123",1,1,0,2,"dummy"
"156124",0,0,1,1,"dummy"
"156125",0,1,0,1,"dummy"
"156126",0,3,1,4,"dummy"
"156127",0,1,1,2,"dummy"
"156128",1,1,0,2,"dummy"
"156129",22,3,4,29,"dummy"
"156130",0,4,0,4,"dummy"
"156131",6,1,0,7,"dummy"
"156132",0,1,0,1,"dummy"
"156133",8,16,5,29,"dummy"
"156134",14,17,7,38,"dummy"
"156135",0,2,1,3,"dummy"
"156136",2,0,0,2,"dummy"
"156137",0,5,0,5,"dummy"
"156138",25,9,5,39,"dummy"
"156139",0,2,0,2,"dummy"
"156140",11,23,5,39,"dummy"
"156141",12,0,1,13,"dummy"
"156146",0,0,1,1,"dummy"
"156147",0,0,2,2,"dummy"
"156148",0,0,1,1,"dummy"
"156149",0,1,1,2,"dummy"
"156155",2,2,2,6,"dummy"
"156156",1,0,0,1,"dummy"
"156157",5,2,2,9,"dummy"
"156158",1,1,0,2,"dummy"
"156159",0,0,1,1,"dummy"
"156162",0,1,0,1,"dummy"
"156190",1,0,0,1,"dummy"
"156191",2,4,1,7,"dummy"
"156192",0,0,1,1,"dummy"
"156208",1,0,4,5,"dummy"
"156215",2,1,0,3,"dummy"
"156216",2,2,1,5,"dummy"
"156226",0,2,0,2,"dummy"
"156227",6,6,1,13,"dummy"
"156221",0,1,0,1,"dummy"
"156222",0,1,0,1,"dummy"
"156223",3,2,1,6,"dummy"
"156224",0,0,2,2,"dummy"
"156241",0,0,1,1,"dummy"
"156242",0,1,0,1,"dummy"
"156243",0,0,0,0,"dummy"
"156244",0,0,0,0,"dummy"
"156251",0,0,1,1,"dummy"
"156254",0,1,0,1,"dummy"
"156255",0,0,1,1,"dummy"
"156258",4,2,3,9,"dummy"
"156259",1,0,1,2,"dummy"
"156261",2,0,0,2,"dummy"
"156272",0,0,3,3,"dummy"
"156277",1,4,0,5,"dummy"
"156278",0,0,1,1,"dummy"
"156279",2,3,2,7,"dummy"
"156282",0,5,0,5,"dummy"
"156283",0,0,0,0,"dummy"
"156288",0,1,0,1,"dummy"
"156290",0,0,1,1,"dummy"
"156291",0,0,1,1,"dummy"
"156292",0,0,1,1,"dummy"
"156293",0,0,1,1,"dummy"
"156294",1,0,0,1,"dummy"
"156295",0,0,1,1,"dummy"
"156315",3,3,1,7,"dummy"
"156317",8,5,0,13,"dummy"
"156318",0,1,0,1,"dummy"
"156321",0,1,0,1,"dummy"
"156322",2,0,0,2,"dummy"
"156323",0,0,1,1,"dummy"
"156324",0,0,0,0,"dummy"
"156325",0,0,0,0,"dummy"
"156326",0,0,0,0,"dummy"
"156327",0,0,0,0,"dummy"
"156331",0,0,1,1,"dummy"
"156332",0,4,1,5,"dummy"
"156333",1,3,4,8,"dummy"
"156335",0,1,0,1,"dummy"
"156336",0,3,0,3,"dummy"
"156340",1,13,0,14,"dummy"
"156341",1,5,1,7,"dummy"
"156342",0,2,0,2,"dummy"
"156344",0,0,0,0,"dummy"
"156348",2,1,1,4,"dummy"
"156353",4,5,3,12,"dummy"
"156354",5,0,0,5,"dummy"
"156355",3,1,0,4,"dummy"
"156356",0,1,0,1,"dummy"
"156357",0,1,0,1,"dummy"
"156364",0,4,3,7,"dummy"
"156365",0,0,1,1,"dummy"
"156367",0,0,0,0,"dummy"
"156369",0,1,0,1,"dummy"
"156370",0,0,1,1,"dummy"
"156374",0,0,0,0,"dummy"
"156375",0,3,0,3,"dummy"
"156376",2,2,0,4,"dummy"
"156377",0,1,0,1,"dummy"
"156378",0,0,0,0,"dummy"
"156379",0,4,0,4,"dummy"
"156380",0,4,0,4,"dummy"
"156381",0,7,0,7,"dummy"
"156382",1,1,0,2,"dummy"
"156383",2,1,0,3,"dummy"
"156384",0,1,0,1,"dummy"
"156385",0,1,0,1,"dummy"
"156386",0,1,1,2,"dummy"
"156387",0,0,0,0,"dummy"
"156390",0,1,1,2,"dummy"
"156391",0,2,0,2,"dummy"
"156393",0,1,0,1,"dummy"
"156394",0,0,1,1,"dummy"
"156395",0,0,1,1,"dummy"
"156396",0,0,0,0,"dummy"
"156397",1,3,2,6,"dummy"
"156398",0,4,0,4,"dummy"
"156399",1,1,0,2,"dummy"
"156400",0,0,1,1,"dummy"
"156401",0,0,0,0,"dummy"
"156402",7,8,1,16,"dummy"
"156403",0,0,0,0,"dummy"
"156404",0,0,0,0,"dummy"
"156405",0,1,2,3,"dummy"
"156406",1,0,0,1,"dummy"
"156407",0,0,2,2,"dummy"
"156410",6,0,0,6,"dummy"
"156411",2,5,2,9,"dummy"
"156413",0,1,1,2,"dummy"
"156420",0,0,1,1,"dummy"
"156421",0,0,1,1,"dummy"
"156422",0,0,1,1,"dummy"
"156423",0,0,1,1,"dummy"
"156424",0,0,1,1,"dummy"
"156425",0,0,1,1,"dummy"
"156426",0,0,1,1,"dummy"
"156427",0,0,1,1,"dummy"
"156428",0,0,1,1,"dummy"
"156429",0,0,1,1,"dummy"
"156430",0,0,1,1,"dummy"
"156431",0,0,1,1,"dummy"
"156432",1,3,0,4,"dummy"
"156433",0,0,1,1,"dummy"
"156434",0,0,1,1,"dummy"
"156437",0,2,1,3,"dummy"
"156439",0,0,1,1,"dummy"
"156440",2,0,0,2,"dummy"
"156441",0,0,0,0,"dummy"
"156442",1,0,0,1,"dummy"
"156443",0,3,0,3,"dummy"
"156444",3,0,0,3,"dummy"
"156449",0,0,0,0,"dummy"
"156450",0,0,0,0,"dummy"
"156452",0,0,1,1,"dummy"
"156456",0,3,0,3,"dummy"
"156457",0,9,0,9,"dummy"
"156458",0,9,0,9,"dummy"
"156460",3,3,1,7,"dummy"
"156463",0,0,1,1,"dummy"
"156464",0,0,3,3,"dummy"
"156466",3,4,2,9,"dummy"
"156469",0,0,0,0,"dummy"
"156471",0,4,4,8,"dummy"
"156473",0,2,1,3,"dummy"
"156474",0,0,1,1,"dummy"
"156477",0,16,0,16,"dummy"
"156485",0,3,0,3,"dummy"
"156486",0,13,0,13,"dummy"
"156487",1,14,0,15,"dummy"
"156488",0,0,0,0,"dummy"
"156489",0,2,1,3,"dummy"
"156490",4,0,0,4,"dummy"
"156491",2,3,0,5,"dummy"
"156492",1,6,0,7,"dummy"
"156493",0,0,0,0,"dummy"
"156494",0,1,1,2,"dummy"
"156495",0,0,1,1,"dummy"
"156496",0,1,0,1,"dummy"
"156497",0,0,0,0,"dummy"
"156498",0,1,0,1,"dummy"
"156499",5,7,0,12,"dummy"
"156500",0,0,0,0,"dummy"
"156501",0,0,0,0,"dummy"
"156502",0,2,0,2,"dummy"
"156503",0,0,1,1,"dummy"
"156504",0,0,0,0,"dummy"
"156505",2,0,0,2,"dummy"
"156507",1,3,3,7,"dummy"
"156508",1,0,0,1,"dummy"
"156515",0,0,1,1,"dummy"
"156516",0,0,0,0,"dummy"
"156519",3,1,2,6,"dummy"
"156520",0,0,2,2,"dummy"
"156521",0,0,1,1,"dummy"
"156522",0,0,3,3,"dummy"
"156527",0,0,0,0,"dummy"
"156528",0,0,1,1,"dummy"
"156529",0,2,0,2,"dummy"
"156530",0,0,1,1,"dummy"
"156531",0,0,1,1,"dummy"
"156532",0,0,1,1,"dummy"
"156533",0,0,0,0,"dummy"
"156534",0,0,1,1,"dummy"
"156535",6,4,2,12,"dummy"
"156536",0,6,9,15,"dummy"
"156537",0,0,1,1,"dummy"
"156538",0,0,2,2,"dummy"
"156539",0,0,3,3,"dummy"
"156540",0,0,2,2,"dummy"
"156542",0,1,0,1,"dummy"
"156581",1,3,0,4,"dummy"
"156583",3,11,4,18,"dummy"
"156584",2,2,0,4,"dummy"
"156586",0,1,0,1,"dummy"
"156588",0,0,0,0,"dummy"
"156603",1,0,0,1,"dummy"
"156609",0,0,2,2,"dummy"
"156610",0,0,1,1,"dummy"
"156612",1,11,3,15,"dummy"
"156613",3,2,3,8,"dummy"
"156615",2,2,1,5,"dummy"
"156616",0,1,0,1,"dummy"
"156617",0,0,1,1,"dummy"
"156618",0,0,1,1,"dummy"
"156619",0,1,0,1,"dummy"
"156620",0,0,0,0,"dummy"
"156621",3,5,1,9,"dummy"
"156622",1,0,0,1,"dummy"
"156625",0,1,0,1,"dummy"
"156626",0,1,0,1,"dummy"
"156630",0,1,0,1,"dummy"
"156631",0,4,2,6,"dummy"
"156632",4,1,1,6,"dummy"
"156633",0,1,0,1,"dummy"
"156634",0,1,0,1,"dummy"
"156635",0,1,0,1,"dummy"
"156636",0,1,0,1,"dummy"
"156637",0,1,0,1,"dummy"
"156638",1,0,0,1,"dummy"
"156642",0,3,0,3,"dummy"
"156658",4,3,2,9,"dummy"
"156659",4,0,0,4,"dummy"
"156660",22,35,0,57,"dummy"
"156661",0,1,0,1,"dummy"
"156664",0,1,0,1,"dummy"
"156665",0,1,0,1,"dummy"
"156666",0,1,0,1,"dummy"
"156667",1,2,0,3,"dummy"
"156668",3,1,0,4,"dummy"
"156669",3,2,0,5,"dummy"
"156670",0,2,0,2,"dummy"
"156671",6,10,5,21,"dummy"
"156672",0,1,0,1,"dummy"
"156673",7,3,0,10,"dummy"
"156674",1,3,1,5,"dummy"
"156675",0,0,0,0,"dummy"
"156676",3,7,0,10,"dummy"
"156677",3,1,1,5,"dummy"
"156678",0,1,0,1,"dummy"
"156681",0,0,3,3,"dummy"
"156684",0,1,0,1,"dummy"
"156691",1,3,0,4,"dummy"
"156695",0,1,0,1,"dummy"
"156719",0,0,1,1,"dummy"
"156720",0,0,1,1,"dummy"
"156721",0,1,0,1,"dummy"
"156722",0,0,1,1,"dummy"
"156723",0,0,1,1,"dummy"
"156724",0,0,1,1,"dummy"
"156725",0,0,1,1,"dummy"
"156726",1,0,0,1,"dummy"
"156727",2,1,0,3,"dummy"
"156728",2,11,1,14,"dummy"
"156729",0,0,1,1,"dummy"
"156730",0,0,1,1,"dummy"
"156731",0,0,1,1,"dummy"
"156732",0,0,1,1,"dummy"
"156754",1,1,1,3,"dummy"
"156755",2,3,1,6,"dummy"
"156760",0,1,0,1,"dummy"
"156773",6,5,2,13,"dummy"
"156628",0,0,0,0,"dummy"
"156640",0,0,1,1,"dummy"
"156644",0,0,2,2,"dummy"
"156645",0,12,0,12,"dummy"
"156646",1,0,0,1,"dummy"
"156649",0,0,1,1,"dummy"
"156650",0,0,1,1,"dummy"
"156651",0,1,0,1,"dummy"
"156656",0,2,0,2,"dummy"
"156686",0,0,1,1,"dummy"
"156689",0,0,1,1,"dummy"
"156693",0,1,0,1,"dummy"
"156697",0,0,1,1,"dummy"
"156698",0,0,1,1,"dummy"
"156709",2,5,2,9,"dummy"
"156714",2,6,0,8,"dummy"
"156715",0,0,3,3,"dummy"
"156734",0,15,4,19,"dummy"
"156735",0,2,4,6,"dummy"
"156736",0,0,0,0,"dummy"
"156737",0,1,0,1,"dummy"
"156738",0,1,6,7,"dummy"
"156739",0,0,1,1,"dummy"
"156749",0,0,0,0,"dummy"
"156750",0,0,0,0,"dummy"
"156757",2,1,0,3,"dummy"
"156758",0,0,0,0,"dummy"
"156764",0,1,0,1,"dummy"
"156765",2,0,2,4,"dummy"
"156770",0,0,1,1,"dummy"
"156771",0,0,0,0,"dummy"
"156805",0,0,1,1,"dummy"
"156833",0,0,0,0,"dummy"
"156834",0,0,0,0,"dummy"
"156835",0,0,0,0,"dummy"
"156842",0,0,1,1,"dummy"
"156843",0,0,0,0,"dummy"
"156844",0,0,0,0,"dummy"
"156872",1,1,1,3,"dummy"
"156873",0,8,1,9,"dummy"
"156874",2,1,3,6,"dummy"
"156875",0,0,1,1,"dummy"
"156876",2,0,6,8,"dummy"
"156877",0,0,1,1,"dummy"
"156878",0,0,4,4,"dummy"
"156879",3,2,1,6,"dummy"
"156880",0,2,0,2,"dummy"
"156881",1,0,1,2,"dummy"
"156882",0,1,0,1,"dummy"
"156897",0,0,1,1,"dummy"
"156898",0,0,2,2,"dummy"
"156899",0,0,1,1,"dummy"
"156900",0,1,0,1,"dummy"
"156901",0,8,0,8,"dummy"
"156902",0,0,7,7,"dummy"
"156903",0,0,7,7,"dummy"
"156904",0,6,0,6,"dummy"
"156905",3,3,4,10,"dummy"
"156906",0,1,0,1,"dummy"
"156907",0,21,0,21,"dummy"
"156908",0,0,0,0,"dummy"
"156797",1,7,2,10,"dummy"
"156798",0,5,3,8,"dummy"
"156799",0,1,0,1,"dummy"
"156800",0,0,1,1,"dummy"
"156801",1,0,0,1,"dummy"
"156807",0,2,0,2,"dummy"
"156808",0,2,0,2,"dummy"
"156811",0,0,1,1,"dummy"
"156812",1,0,0,1,"dummy"
"156815",0,0,0,0,"dummy"
"156818",0,0,1,1,"dummy"
"156819",0,0,3,3,"dummy"
"156820",0,2,0,2,"dummy"
"156821",2,8,0,10,"dummy"
"156822",6,7,1,14,"dummy"
"156823",0,0,0,0,"dummy"
"156824",0,1,1,2,"dummy"
"156825",1,5,0,6,"dummy"
"156828",2,0,1,3,"dummy"
"156829",0,0,0,0,"dummy"
"156837",0,1,0,1,"dummy"
"156838",0,1,0,1,"dummy"
"156839",1,3,1,5,"dummy"
"156840",0,1,0,1,"dummy"
"156846",0,2,0,2,"dummy"
"156847",0,0,1,1,"dummy"
"156848",0,0,1,1,"dummy"
"156851",4,2,3,9,"dummy"
"156852",1,0,0,1,"dummy"
"156860",3,5,1,9,"dummy"
"156861",0,2,0,2,"dummy"
"156862",3,3,0,6,"dummy"
"156863",0,4,1,5,"dummy"
"156864",1,1,1,3,"dummy"
"156865",2,0,0,2,"dummy"
"156866",8,1,3,12,"dummy"
"156890",0,0,0,0,"dummy"
"156891",0,0,0,0,"dummy"
"156892",0,0,0,0,"dummy"
"156895",5,5,0,10,"dummy"
"156955",0,4,2,6,"dummy"
"156958",0,1,0,1,"dummy"
"156959",0,2,0,2,"dummy"
"156960",0,0,0,0,"dummy"
"156961",0,0,1,1,"dummy"
"156962",0,1,0,1,"dummy"
"156968",0,0,1,1,"dummy"
"156969",2,2,0,4,"dummy"
"156972",1,0,0,1,"dummy"
"157012",0,1,0,1,"dummy"
"157013",0,0,1,1,"dummy"
"157014",0,10,0,10,"dummy"
"157015",0,0,0,0,"dummy"
"157016",2,1,0,3,"dummy"
"157017",0,0,1,1,"dummy"
"157024",0,0,1,1,"dummy"
"157025",0,1,0,1,"dummy"
"157026",0,0,1,1,"dummy"
"157027",0,0,1,1,"dummy"
"157028",2,5,2,9,"dummy"
"157029",0,1,0,1,"dummy"
"157030",5,8,1,14,"dummy"
"157031",0,1,0,1,"dummy"
"157032",0,1,0,1,"dummy"
"157033",2,3,0,5,"dummy"
"157034",0,1,0,1,"dummy"
"157035",12,10,1,23,"dummy"
"157036",7,8,0,15,"dummy"
"157060",0,0,0,0,"dummy"
"156909",0,2,0,2,"dummy"
"156910",1,0,1,2,"dummy"
"156911",0,2,0,2,"dummy"
"156922",0,3,3,6,"dummy"
"156923",0,6,1,7,"dummy"
"156924",12,14,2,28,"dummy"
"156927",1,2,0,3,"dummy"
"156928",0,2,0,2,"dummy"
"156929",0,1,0,1,"dummy"
"156932",0,0,1,1,"dummy"
"156935",4,10,1,15,"dummy"
"156936",0,2,2,4,"dummy"
"156937",2,4,2,8,"dummy"
"156938",0,2,2,4,"dummy"
"156939",4,1,0,5,"dummy"
"156940",0,0,1,1,"dummy"
"156941",1,0,0,1,"dummy"
"156942",0,1,0,1,"dummy"
"156943",1,0,0,1,"dummy"
"156944",0,1,0,1,"dummy"
"156947",6,0,0,6,"dummy"
"156948",2,5,2,9,"dummy"
"156953",9,3,1,13,"dummy"
"156978",0,0,0,0,"dummy"
"156979",0,0,0,0,"dummy"
"156980",0,0,0,0,"dummy"
"156981",0,0,0,0,"dummy"
"156982",0,0,0,0,"dummy"
"156983",0,0,0,0,"dummy"
"156984",1,2,0,3,"dummy"
"156985",2,1,0,3,"dummy"
"156986",0,0,0,0,"dummy"
"156987",0,0,0,0,"dummy"
"156988",0,0,0,0,"dummy"
"156989",0,0,0,0,"dummy"
"156990",0,0,1,1,"dummy"
"156991",0,0,0,0,"dummy"
"156996",0,0,1,1,"dummy"
"156997",0,6,0,6,"dummy"
"156998",6,20,0,26,"dummy"
"156999",0,0,2,2,"dummy"
"157000",1,0,0,1,"dummy"
"157001",9,16,4,29,"dummy"
"157002",10,1,0,11,"dummy"
"157003",2,0,0,2,"dummy"
"157004",0,2,0,2,"dummy"
"157005",0,1,0,1,"dummy"
"157006",0,14,0,14,"dummy"
"157007",0,1,0,1,"dummy"
"157008",0,0,1,1,"dummy"
"157021",0,0,1,1,"dummy"
"157022",0,2,0,2,"dummy"
"157038",2,0,3,5,"dummy"
"157039",0,0,1,1,"dummy"
"157040",0,0,0,0,"dummy"
"157041",0,0,1,1,"dummy"
"157042",0,0,0,0,"dummy"
"157043",0,0,1,1,"dummy"
"157044",0,0,0,0,"dummy"
"157045",0,0,0,0,"dummy"
"157046",0,1,0,1,"dummy"
"157047",0,0,1,1,"dummy"
"157048",0,0,1,1,"dummy"
"157049",0,0,0,0,"dummy"
"157050",0,0,0,0,"dummy"
"157051",3,1,1,5,"dummy"
"157052",0,0,0,0,"dummy"
"157053",0,0,0,0,"dummy"
"157054",0,0,1,1,"dummy"
"157055",0,0,0,0,"dummy"
"157056",0,0,0,0,"dummy"
"157057",0,0,0,0,"dummy"
"157058",0,0,1,1,"dummy"
"157062",0,0,1,1,"dummy"
"157063",4,1,0,5,"dummy"
"157064",0,0,1,1,"dummy"
"157065",0,1,0,1,"dummy"
"157066",0,0,1,1,"dummy"
"157067",0,1,0,1,"dummy"
"157068",0,1,2,3,"dummy"
"157069",0,1,0,1,"dummy"
"157089",0,1,0,1,"dummy"
"157090",0,2,0,2,"dummy"
"157091",0,0,0,0,"dummy"
"157097",0,0,0,0,"dummy"
"157095",0,0,1,1,"dummy"
"157099",2,2,0,4,"dummy"
"157100",0,1,0,1,"dummy"
"157101",0,1,0,1,"dummy"
"157114",0,3,0,3,"dummy"
"157115",0,1,0,1,"dummy"
"157116",0,10,0,10,"dummy"
"157117",9,2,2,13,"dummy"
"157118",0,1,0,1,"dummy"
"157119",0,1,0,1,"dummy"
"157159",1,2,0,3,"dummy"
"157178",0,1,0,1,"dummy"
"157179",0,2,0,2,"dummy"
"157183",1,0,0,1,"dummy"
"157184",2,2,1,5,"dummy"
"157207",0,0,1,1,"dummy"
"157223",0,1,1,2,"dummy"
"157224",1,2,0,3,"dummy"
"157225",0,0,1,1,"dummy"
"157226",0,0,3,3,"dummy"
"157254",0,0,1,1,"dummy"
"157255",0,0,1,1,"dummy"
"157256",0,0,0,0,"dummy"
"157257",0,0,0,0,"dummy"
"157258",1,1,2,4,"dummy"
"157266",0,0,1,1,"dummy"
"157267",0,0,1,1,"dummy"
"157268",0,0,1,1,"dummy"
"157269",0,0,1,1,"dummy"
"157270",1,1,0,2,"dummy"
"157271",1,4,1,6,"dummy"
"157105",0,3,1,4,"dummy"
"157108",1,1,0,2,"dummy"
"157109",7,0,0,7,"dummy"
"157112",1,0,0,1,"dummy"
"157121",0,1,0,1,"dummy"
"157124",0,0,1,1,"dummy"
"157127",4,2,1,7,"dummy"
"157128",5,2,0,7,"dummy"
"157129",1,2,0,3,"dummy"
"157130",2,1,0,3,"dummy"
"157133",3,2,0,5,"dummy"
"157151",6,4,4,14,"dummy"
"157154",0,2,0,2,"dummy"
"157155",0,0,2,2,"dummy"
"157156",2,21,1,24,"dummy"
"157157",0,0,1,1,"dummy"
"157161",1,1,0,2,"dummy"
"157164",0,1,0,1,"dummy"
"157165",2,0,2,4,"dummy"
"157173",0,0,2,2,"dummy"
"157174",0,2,0,2,"dummy"
"157175",0,1,0,1,"dummy"
"157176",0,2,1,3,"dummy"
"157181",0,0,3,3,"dummy"
"157186",2,4,0,6,"dummy"
"157187",0,2,0,2,"dummy"
"157188",0,2,0,2,"dummy"
"157189",10,2,0,12,"dummy"
"157190",0,2,0,2,"dummy"
"157191",0,0,0,0,"dummy"
"157192",0,0,3,3,"dummy"
"157193",0,5,0,5,"dummy"
"157196",2,4,0,6,"dummy"
"157197",0,2,0,2,"dummy"
"157198",0,2,0,2,"dummy"
"157199",10,2,0,12,"dummy"
"157200",0,2,0,2,"dummy"
"157201",0,0,0,0,"dummy"
"157204",5,0,3,8,"dummy"
"157205",0,0,0,0,"dummy"
"157211",0,0,1,1,"dummy"
"157212",0,0,1,1,"dummy"
"157213",0,1,0,1,"dummy"
"157214",2,1,1,4,"dummy"
"157215",0,0,1,1,"dummy"
"157218",0,1,2,3,"dummy"
"157219",0,0,2,2,"dummy"
"157230",0,0,1,1,"dummy"
"157239",0,0,0,0,"dummy"
"157240",3,2,1,6,"dummy"
"157241",0,1,1,2,"dummy"
"157249",0,0,1,1,"dummy"
"157250",0,0,1,1,"dummy"
"157277",8,7,1,16,"dummy"
"157279",0,2,3,5,"dummy"
"157280",0,0,1,1,"dummy"
"157282",0,1,0,1,"dummy"
"157283",0,1,0,1,"dummy"
"157286",4,15,2,21,"dummy"
"157288",1,0,0,1,"dummy"
"157289",0,0,0,0,"dummy"
"157290",0,0,0,0,"dummy"
"157291",0,0,0,0,"dummy"
"157292",0,0,0,0,"dummy"
"157311",1,0,0,1,"dummy"
"157312",0,1,1,2,"dummy"
"157313",0,0,1,1,"dummy"
"157314",1,0,0,1,"dummy"
"157323",1,0,1,2,"dummy"
"157324",2,7,0,9,"dummy"
"157326",0,1,0,1,"dummy"
"157327",2,3,0,5,"dummy"
"157328",0,1,0,1,"dummy"
"157331",0,9,0,9,"dummy"
"157332",0,0,1,1,"dummy"
"157333",6,0,0,6,"dummy"
"157334",0,0,0,0,"dummy"
"157335",0,1,0,1,"dummy"
"157338",0,12,0,12,"dummy"
"157341",3,2,1,6,"dummy"
"157343",1,1,0,2,"dummy"
"157346",0,1,0,1,"dummy"
"157352",0,8,0,8,"dummy"
"157353",0,0,1,1,"dummy"
"157354",0,9,0,9,"dummy"
"157358",0,0,3,3,"dummy"
"157359",0,0,3,3,"dummy"
"157362",0,1,0,1,"dummy"
"157364",1,1,1,3,"dummy"
"157365",0,1,0,1,"dummy"
"157366",3,2,2,7,"dummy"
"157367",0,2,0,2,"dummy"
"157368",4,0,0,4,"dummy"
"157370",0,0,1,1,"dummy"
"157371",0,1,4,5,"dummy"
"157372",3,0,4,7,"dummy"
"157373",0,1,0,1,"dummy"
"157374",0,0,1,1,"dummy"
"157375",0,0,1,1,"dummy"
"157376",0,2,0,2,"dummy"
"157377",0,0,1,1,"dummy"
"157378",2,2,2,6,"dummy"
"157379",0,0,1,1,"dummy"
"157380",0,0,1,1,"dummy"
"157381",0,0,1,1,"dummy"
"157382",0,0,1,1,"dummy"
"157384",0,0,1,1,"dummy"
"157385",0,0,0,0,"dummy"
"157388",0,1,0,1,"dummy"
"157389",1,1,0,2,"dummy"
"157390",0,1,0,1,"dummy"
"157396",0,0,1,1,"dummy"
"157397",0,0,1,1,"dummy"
"157398",0,0,1,1,"dummy"
"157399",0,0,1,1,"dummy"
"157400",0,0,1,1,"dummy"
"157401",0,0,1,1,"dummy"
"157402",0,0,1,1,"dummy"
"157403",0,0,1,1,"dummy"
"157404",0,0,1,1,"dummy"
"157405",0,0,1,1,"dummy"
"157406",0,0,1,1,"dummy"
"157407",0,0,1,1,"dummy"
"157408",0,0,1,1,"dummy"
"157409",0,0,1,1,"dummy"
"157410",0,0,1,1,"dummy"
"157411",0,0,1,1,"dummy"
"157412",0,0,2,2,"dummy"
"157413",0,0,1,1,"dummy"
"157414",6,0,2,8,"dummy"
"157415",0,0,2,2,"dummy"
"157416",0,13,0,13,"dummy"
"157417",0,0,1,1,"dummy"
"157418",0,0,0,0,"dummy"
"157419",11,12,0,23,"dummy"
"157420",0,0,1,1,"dummy"
"157421",0,0,1,1,"dummy"
"157422",0,0,1,1,"dummy"
"157423",0,0,1,1,"dummy"
"157424",0,0,1,1,"dummy"
"157425",0,0,1,1,"dummy"
"157426",0,0,1,1,"dummy"
"157427",0,0,1,1,"dummy"
"157428",0,0,1,1,"dummy"
"157429",0,0,1,1,"dummy"
"157430",0,0,1,1,"dummy"
"157431",0,0,1,1,"dummy"
"157432",0,0,1,1,"dummy"
"157433",0,0,1,1,"dummy"
"157434",0,0,1,1,"dummy"
"157435",0,0,1,1,"dummy"
"157436",0,0,1,1,"dummy"
"157439",0,0,1,1,"dummy"
"157440",0,1,1,2,"dummy"
"157441",1,0,1,2,"dummy"
"157443",0,2,1,3,"dummy"
"157445",0,10,3,13,"dummy"
"157446",0,0,1,1,"dummy"
"157447",9,7,1,17,"dummy"
"157448",1,0,0,1,"dummy"
"157449",0,0,1,1,"dummy"
"157450",0,2,0,2,"dummy"
"157451",8,13,7,28,"dummy"
"157452",8,6,1,15,"dummy"
"157453",1,0,0,1,"dummy"
"157454",0,2,0,2,"dummy"
"157455",0,2,0,2,"dummy"
"157456",0,0,1,1,"dummy"
"157457",1,0,0,1,"dummy"
"157458",1,0,0,1,"dummy"
"157459",0,0,0,0,"dummy"
"157460",0,1,0,1,"dummy"
"157461",3,4,0,7,"dummy"
"157462",1,0,0,1,"dummy"
"157464",0,0,1,1,"dummy"
"157465",0,2,1,3,"dummy"
"157466",1,1,0,2,"dummy"
"157467",0,0,1,1,"dummy"
"157468",0,0,1,1,"dummy"
"157470",1,4,1,6,"dummy"
"157471",1,2,0,3,"dummy"
"157474",0,1,0,1,"dummy"
"157479",1,1,0,2,"dummy"
"157480",0,3,2,5,"dummy"
"157481",1,0,4,5,"dummy"
"157485",0,8,0,8,"dummy"
"157487",0,0,1,1,"dummy"
"157491",3,10,1,14,"dummy"
"157492",0,0,1,1,"dummy"
"157495",0,0,1,1,"dummy"
"157498",0,2,0,2,"dummy"
"157499",0,1,0,1,"dummy"
"157500",0,0,1,1,"dummy"
"157501",0,1,1,2,"dummy"
"157502",0,0,1,1,"dummy"
"157503",0,0,3,3,"dummy"
"157504",0,0,1,1,"dummy"
"157506",5,1,3,9,"dummy"
"157507",0,0,1,1,"dummy"
"157508",5,0,2,7,"dummy"
"157509",1,0,3,4,"dummy"
"157510",0,0,0,0,"dummy"
"157511",0,0,0,0,"dummy"
"157512",0,0,1,1,"dummy"
"157513",0,0,0,0,"dummy"
"157514",0,0,0,0,"dummy"
"157516",1,0,0,1,"dummy"
"157517",0,0,0,0,"dummy"
"157518",0,0,0,0,"dummy"
"157519",0,0,0,0,"dummy"
"157520",0,0,0,0,"dummy"
"157521",4,0,0,4,"dummy"
"157523",6,11,1,18,"dummy"
"157524",0,1,0,1,"dummy"
"157525",0,0,0,0,"dummy"
"157526",8,8,0,16,"dummy"
"157527",0,1,0,1,"dummy"
"157528",0,0,0,0,"dummy"
"157531",0,0,1,1,"dummy"
"157532",0,0,3,3,"dummy"
"157533",0,0,1,1,"dummy"
"157534",0,0,1,1,"dummy"
"157535",0,0,1,1,"dummy"
"157536",0,0,1,1,"dummy"
"157537",0,0,1,1,"dummy"
"157538",0,0,4,4,"dummy"
"157539",0,0,1,1,"dummy"
"157542",0,1,0,1,"dummy"
"157543",0,2,0,2,"dummy"
"157546",0,1,0,1,"dummy"
"157547",6,11,0,17,"dummy"
"157548",0,5,0,5,"dummy"
"157549",7,2,0,9,"dummy"
"157550",0,0,1,1,"dummy"
"157553",4,0,0,4,"dummy"
"157554",3,4,0,7,"dummy"
"157555",22,11,2,35,"dummy"
"157556",0,1,1,2,"dummy"
"157557",8,24,3,35,"dummy"
"157558",9,0,0,9,"dummy"
"157559",1,0,0,1,"dummy"
"157560",10,15,5,30,"dummy"
"157561",10,7,2,19,"dummy"
"157562",4,10,1,15,"dummy"
"157563",9,3,2,14,"dummy"
"157564",9,6,4,19,"dummy"
"157565",4,0,0,4,"dummy"
"157566",2,7,1,10,"dummy"
"157567",0,0,1,1,"dummy"
"157568",0,0,1,1,"dummy"
"157569",0,0,1,1,"dummy"
"157570",1,1,0,2,"dummy"
"157572",1,0,0,1,"dummy"
"157573",0,1,0,1,"dummy"
"157574",2,0,0,2,"dummy"
"157575",17,0,4,21,"dummy"
"157576",2,4,0,6,"dummy"
"157577",0,1,0,1,"dummy"
"157578",0,0,0,0,"dummy"
"157579",0,0,0,0,"dummy"
"157580",0,0,0,0,"dummy"
"157581",0,2,0,2,"dummy"
"157582",0,0,1,1,"dummy"
"157583",0,1,0,1,"dummy"
"157584",0,2,0,2,"dummy"
"157585",10,6,1,17,"dummy"
"157586",0,1,0,1,"dummy"
"157588",2,2,0,4,"dummy"
"157589",2,6,2,10,"dummy"
"157591",0,6,0,6,"dummy"
"157592",0,3,0,3,"dummy"
"157593",1,16,0,17,"dummy"
"157594",0,6,0,6,"dummy"
"157595",2,2,0,4,"dummy"
"157596",0,0,1,1,"dummy"
"157598",2,1,0,3,"dummy"
"157599",0,0,1,1,"dummy"
"157600",0,0,1,1,"dummy"
"157601",0,0,1,1,"dummy"
"157602",0,0,1,1,"dummy"
"157603",0,0,1,1,"dummy"
"157604",0,0,1,1,"dummy"
"157605",0,0,1,1,"dummy"
"157606",0,0,1,1,"dummy"
"157607",0,0,1,1,"dummy"
"157610",0,0,1,1,"dummy"
"157611",1,2,2,5,"dummy"
"157612",0,1,0,1,"dummy"
"157613",1,1,1,3,"dummy"
"157625",0,2,0,2,"dummy"
"157626",1,0,0,1,"dummy"
"157628",1,0,0,1,"dummy"
"157629",1,4,0,5,"dummy"
"157630",1,0,2,3,"dummy"
"157631",1,2,0,3,"dummy"
"157632",8,0,0,8,"dummy"
"157638",0,7,0,7,"dummy"
"157640",1,0,2,3,"dummy"
"157641",1,4,0,5,"dummy"
"157642",0,2,0,2,"dummy"
"157643",0,6,1,7,"dummy"
"157644",0,2,0,2,"dummy"
"157648",1,2,0,3,"dummy"
"157651",0,0,0,0,"dummy"
"157652",1,0,0,1,"dummy"
"157710",1,1,2,4,"dummy"
"157711",1,2,0,3,"dummy"
"157714",0,2,0,2,"dummy"
"157715",0,0,1,1,"dummy"
"157718",0,0,5,5,"dummy"
"157719",0,0,1,1,"dummy"
"157720",0,0,5,5,"dummy"
"157721",0,0,1,1,"dummy"
"157722",0,0,1,1,"dummy"
"157723",2,1,0,3,"dummy"
"157724",0,0,1,1,"dummy"
"157727",0,2,0,2,"dummy"
"157728",0,1,0,1,"dummy"
"157729",0,0,1,1,"dummy"
"157731",0,3,0,3,"dummy"
"157732",0,4,0,4,"dummy"
"157733",0,0,1,1,"dummy"
"157735",0,0,1,1,"dummy"
"157736",2,0,0,2,"dummy"
"157737",3,0,1,4,"dummy"
"157738",0,0,1,1,"dummy"
"157739",0,0,1,1,"dummy"
"157740",0,0,2,2,"dummy"
"157741",0,0,4,4,"dummy"
"157742",0,0,1,1,"dummy"
"157743",2,2,3,7,"dummy"
"157745",0,4,0,4,"dummy"
"157748",0,0,1,1,"dummy"
"157750",0,1,0,1,"dummy"
"157836",0,1,0,1,"dummy"
"157837",0,0,0,0,"dummy"
"157838",0,1,0,1,"dummy"
"157839",0,0,0,0,"dummy"
"157840",4,2,1,7,"dummy"
"157841",0,1,0,1,"dummy"
"157842",0,0,1,1,"dummy"
"157843",0,1,0,1,"dummy"
"157845",0,2,0,2,"dummy"
"157846",0,4,0,4,"dummy"
"157847",0,6,1,7,"dummy"
"157848",7,2,0,9,"dummy"
"157849",0,1,0,1,"dummy"
"157850",0,1,1,2,"dummy"
"157851",0,0,0,0,"dummy"
"157852",14,0,0,14,"dummy"
"157860",0,0,1,1,"dummy"
"157862",0,7,1,8,"dummy"
"157865",1,11,1,13,"dummy"
"157867",3,4,3,10,"dummy"
"157868",17,0,0,17,"dummy"
"157869",0,18,0,18,"dummy"
"157870",0,0,0,0,"dummy"
"157871",0,0,4,4,"dummy"
"157872",3,2,0,5,"dummy"
"157874",0,0,1,1,"dummy"
"157877",3,0,1,4,"dummy"
"157878",0,3,0,3,"dummy"
"157879",0,2,1,3,"dummy"
"157881",0,0,0,0,"dummy"
"157885",0,0,0,0,"dummy"
"157886",5,0,2,7,"dummy"
"157887",0,0,0,0,"dummy"
"157905",0,0,0,0,"dummy"
"157908",2,4,2,8,"dummy"
"157909",0,2,1,3,"dummy"
"157911",4,2,0,6,"dummy"
"157917",0,0,1,1,"dummy"
"157923",3,1,3,7,"dummy"
"157924",0,17,0,17,"dummy"
"157925",2,1,3,6,"dummy"
"157941",0,0,1,1,"dummy"
"157942",0,0,1,1,"dummy"
"157943",1,0,0,1,"dummy"
"157944",0,1,0,1,"dummy"
"157945",0,0,1,1,"dummy"
"157947",0,0,1,1,"dummy"
"157954",2,2,0,4,"dummy"
"157957",0,0,2,2,"dummy"
"157958",0,5,0,5,"dummy"
"157959",0,4,1,5,"dummy"
"157960",0,5,0,5,"dummy"
"157962",0,2,0,2,"dummy"
"158027",0,0,0,0,"dummy"
"158030",0,2,0,2,"dummy"
"158031",12,2,0,14,"dummy"
"158033",0,0,0,0,"dummy"
"158034",5,0,2,7,"dummy"
"158035",0,0,0,0,"dummy"
"158037",2,5,0,7,"dummy"
"158038",5,0,0,5,"dummy"
"158039",1,8,0,9,"dummy"
"158040",2,2,0,4,"dummy"
"158041",0,0,0,0,"dummy"
"158042",8,4,0,12,"dummy"
"158043",3,8,0,11,"dummy"
"158044",1,1,0,2,"dummy"
"158045",1,1,0,2,"dummy"
"158046",0,2,0,2,"dummy"
"158047",2,0,0,2,"dummy"
"158051",0,0,1,1,"dummy"
"158052",1,4,0,5,"dummy"
"158053",0,1,0,1,"dummy"
"158054",2,9,2,13,"dummy"
"158056",0,0,2,2,"dummy"
"158057",0,0,1,1,"dummy"
"158059",0,0,0,0,"dummy"
"158071",1,0,0,1,"dummy"
"158076",0,0,1,1,"dummy"
"158077",4,0,0,4,"dummy"
"158078",1,4,0,5,"dummy"
"158080",0,8,0,8,"dummy"
"158082",1,3,0,4,"dummy"
"158084",0,1,1,2,"dummy"
"158085",0,7,0,7,"dummy"
"158086",0,0,0,0,"dummy"
"158087",0,0,0,0,"dummy"
"158088",0,0,0,0,"dummy"
"158089",0,1,0,1,"dummy"
"158090",0,0,0,0,"dummy"
"158091",0,1,0,1,"dummy"
"158098",0,0,2,2,"dummy"
"158101",0,5,0,5,"dummy"
"158102",4,2,0,6,"dummy"
"158104",1,0,0,1,"dummy"
"158105",3,3,0,6,"dummy"
"158106",2,5,0,7,"dummy"
"158107",0,1,0,1,"dummy"
"158108",0,0,1,1,"dummy"
"158109",3,6,2,11,"dummy"
"158110",0,1,0,1,"dummy"
"158111",1,10,0,11,"dummy"
"158112",1,0,0,1,"dummy"
"158113",1,1,0,2,"dummy"
"158114",0,1,0,1,"dummy"
"158115",1,0,0,1,"dummy"
"158116",2,2,0,4,"dummy"
"158117",0,1,0,1,"dummy"
"158120",0,2,0,2,"dummy"
"158121",0,3,0,3,"dummy"
"158132",2,3,1,6,"dummy"
"158133",0,1,0,1,"dummy"
"158144",0,1,0,1,"dummy"
"158145",0,1,0,1,"dummy"
"158146",0,1,0,1,"dummy"
"158147",0,1,0,1,"dummy"
"158148",0,1,0,1,"dummy"
"158149",2,1,1,4,"dummy"
"158150",0,1,0,1,"dummy"
"158152",1,0,0,1,"dummy"
"158154",1,0,1,2,"dummy"
"158155",0,0,1,1,"dummy"
"158156",0,2,2,4,"dummy"
"158161",0,0,1,1,"dummy"
"158164",4,6,2,12,"dummy"
"158165",2,5,1,8,"dummy"
"158167",0,0,1,1,"dummy"
"158170",0,2,0,2,"dummy"
"158175",0,11,0,11,"dummy"
"158176",0,2,1,3,"dummy"
"158177",0,0,0,0,"dummy"
"158179",0,3,0,3,"dummy"
"158180",0,3,1,4,"dummy"
"158181",1,4,3,8,"dummy"
"158216",8,4,1,13,"dummy"
"158217",1,1,0,2,"dummy"
"158218",1,1,3,5,"dummy"
"158219",0,1,0,1,"dummy"
"158220",2,5,1,8,"dummy"
"158221",1,1,0,2,"dummy"
"158222",1,1,0,2,"dummy"
"158223",2,0,0,2,"dummy"
"158224",1,1,0,2,"dummy"
"158228",0,1,0,1,"dummy"
"158229",0,1,0,1,"dummy"
"158230",0,0,1,1,"dummy"
"158231",0,1,1,2,"dummy"
"158232",0,0,1,1,"dummy"
"158233",0,1,0,1,"dummy"
"158234",1,0,0,1,"dummy"
"158235",0,0,1,1,"dummy"
"158236",1,0,0,1,"dummy"
"158237",0,2,0,2,"dummy"
"158238",0,2,0,2,"dummy"
"158239",0,2,0,2,"dummy"
"158246",0,6,2,8,"dummy"
"158247",2,5,0,7,"dummy"
"158250",0,6,0,6,"dummy"
"158251",0,0,3,3,"dummy"
"158257",15,4,5,24,"dummy"
"158258",0,0,3,3,"dummy"
"158261",0,4,1,5,"dummy"
"158264",0,1,0,1,"dummy"
"158265",3,8,0,11,"dummy"
"158266",0,1,0,1,"dummy"
"158267",0,0,1,1,"dummy"
"158268",0,0,2,2,"dummy"
"158271",0,1,0,1,"dummy"
"158286",0,9,3,12,"dummy"
"158287",2,5,1,8,"dummy"
"158288",0,0,0,0,"dummy"
"158289",0,1,1,2,"dummy"
"158290",1,0,0,1,"dummy"
"158315",2,4,3,9,"dummy"
"158316",0,0,0,0,"dummy"
"158325",1,0,1,2,"dummy"
"158326",0,0,2,2,"dummy"
"158331",0,0,0,0,"dummy"
"158241",1,2,1,4,"dummy"
"158242",0,1,0,1,"dummy"
"158243",0,1,0,1,"dummy"
"158244",0,1,0,1,"dummy"
"158255",3,4,1,8,"dummy"
"158300",0,0,2,2,"dummy"
"158301",0,0,1,1,"dummy"
"158302",0,0,1,1,"dummy"
"158303",0,0,1,1,"dummy"
"158304",0,0,1,1,"dummy"
"158305",0,0,1,1,"dummy"
"158333",0,0,2,2,"dummy"
"158334",0,0,1,1,"dummy"
"158335",0,3,0,3,"dummy"
"158336",13,12,0,25,"dummy"
"158337",0,0,0,0,"dummy"
"158338",5,3,2,10,"dummy"
"158339",0,0,1,1,"dummy"
"158340",0,0,2,2,"dummy"
"158343",0,0,4,4,"dummy"
"158344",0,0,3,3,"dummy"
"158345",0,0,7,7,"dummy"
"158346",7,45,5,57,"dummy"
"158347",0,0,5,5,"dummy"
"158348",38,38,0,76,"dummy"
"158349",38,38,5,81,"dummy"
"158350",38,38,0,76,"dummy"
"158351",2,0,0,2,"dummy"
"158352",37,39,5,81,"dummy"
"158353",0,2,1,3,"dummy"
"158354",3,1,5,9,"dummy"
"158355",35,36,5,76,"dummy"
"158356",0,1,0,1,"dummy"
"158357",4,0,0,4,"dummy"
"158358",1,0,0,1,"dummy"
"158359",0,0,1,1,"dummy"
"158360",6,0,0,6,"dummy"
"158361",1,0,0,1,"dummy"
"158362",1,0,0,1,"dummy"
"158363",1,3,0,4,"dummy"
"158364",2,0,0,2,"dummy"
"158365",0,1,0,1,"dummy"
"158366",1,0,0,1,"dummy"
"158367",7,0,0,7,"dummy"
"158368",0,2,0,2,"dummy"
"158369",0,0,1,1,"dummy"
"158372",0,1,0,1,"dummy"
"158373",0,1,0,1,"dummy"
"158374",1,0,0,1,"dummy"
"158376",3,3,1,7,"dummy"
"158377",0,1,0,1,"dummy"
"158378",0,0,0,0,"dummy"
"158379",2,7,5,14,"dummy"
"158382",5,7,1,13,"dummy"
"158383",1,4,1,6,"dummy"
"158384",4,1,1,6,"dummy"
"158385",0,0,1,1,"dummy"
"158387",2,2,0,4,"dummy"
"158389",0,0,0,0,"dummy"
"158390",0,0,0,0,"dummy"
"158391",0,2,0,2,"dummy"
"158392",2,1,0,3,"dummy"
"158393",0,1,0,1,"dummy"
"158394",0,1,0,1,"dummy"
"158395",1,0,1,2,"dummy"
"158396",0,1,0,1,"dummy"
"158397",1,2,0,3,"dummy"
"158400",2,3,0,5,"dummy"
"158401",2,3,0,5,"dummy"
"158402",2,2,0,4,"dummy"
"158403",1,0,0,1,"dummy"
"158404",0,0,2,2,"dummy"
"158405",0,0,1,1,"dummy"
"158410",3,0,2,5,"dummy"
"158428",0,0,1,1,"dummy"
"158429",0,0,1,1,"dummy"
"158430",0,0,1,1,"dummy"
"158434",1,0,1,2,"dummy"
"158435",0,2,0,2,"dummy"
"158436",1,1,0,2,"dummy"
"158441",0,1,0,1,"dummy"
"158442",0,1,0,1,"dummy"
"158443",1,2,0,3,"dummy"
"158444",0,0,2,2,"dummy"
"158445",0,1,0,1,"dummy"
"158450",10,11,0,21,"dummy"
"158451",22,3,1,26,"dummy"
"158452",0,0,0,0,"dummy"
"158454",0,0,1,1,"dummy"
"158455",0,0,1,1,"dummy"
"158456",0,0,1,1,"dummy"
"158457",0,0,1,1,"dummy"
"158459",1,0,0,1,"dummy"
"158460",0,0,1,1,"dummy"
"158461",0,0,1,1,"dummy"
"158463",4,4,0,8,"dummy"
"158464",7,19,1,27,"dummy"
"158465",2,2,1,5,"dummy"
"158466",2,2,1,5,"dummy"
"158467",0,0,1,1,"dummy"
"158468",10,8,4,22,"dummy"
"158469",3,3,4,10,"dummy"
"158470",3,6,4,13,"dummy"
"158471",3,3,1,7,"dummy"
"158472",0,2,0,2,"dummy"
"158474",3,1,0,4,"dummy"
"158475",0,0,0,0,"dummy"
"158476",0,4,0,4,"dummy"
"158477",0,1,0,1,"dummy"
"158478",0,2,2,4,"dummy"
"158483",0,0,0,0,"dummy"
"158484",5,1,2,8,"dummy"
"158485",0,0,1,1,"dummy"
"158486",0,0,1,1,"dummy"
"158490",0,0,0,0,"dummy"
"158493",0,1,1,2,"dummy"
"158494",0,1,0,1,"dummy"
"158495",0,2,0,2,"dummy"
"158497",0,1,0,1,"dummy"
"158505",0,0,0,0,"dummy"
"158506",0,0,0,0,"dummy"
"158507",1,0,0,1,"dummy"
"158508",0,3,0,3,"dummy"
"158510",0,0,1,1,"dummy"
"158512",0,1,0,1,"dummy"
"158513",0,2,0,2,"dummy"
"158514",0,2,0,2,"dummy"
"158515",0,1,0,1,"dummy"
"158516",0,1,0,1,"dummy"
"158517",0,2,0,2,"dummy"
"158518",0,1,0,1,"dummy"
"158519",0,1,0,1,"dummy"
"158520",0,6,0,6,"dummy"
"158521",0,2,0,2,"dummy"
"158524",0,4,0,4,"dummy"
"158525",1,1,0,2,"dummy"
"158526",1,5,1,7,"dummy"
"158527",0,6,0,6,"dummy"
"158528",4,11,2,17,"dummy"
"158529",26,2,2,30,"dummy"
"158531",1,6,6,13,"dummy"
"158541",0,0,3,3,"dummy"
"158542",0,1,4,5,"dummy"
"158544",0,0,4,4,"dummy"
"158547",0,0,1,1,"dummy"
"158548",0,0,0,0,"dummy"
"158560",0,0,1,1,"dummy"
"158561",1,0,2,3,"dummy"
"158562",0,0,2,2,"dummy"
"158575",3,3,1,7,"dummy"
"158589",0,2,0,2,"dummy"
"158590",0,3,0,3,"dummy"
"158591",0,0,0,0,"dummy"
"158592",0,1,0,1,"dummy"
"158593",1,1,2,4,"dummy"
"158594",0,2,0,2,"dummy"
"158595",0,1,0,1,"dummy"
"158602",14,9,8,31,"dummy"
"158603",0,0,1,1,"dummy"
"158604",0,0,1,1,"dummy"
"158605",0,0,1,1,"dummy"
"158606",0,1,0,1,"dummy"
"158609",2,1,2,5,"dummy"
"158612",3,1,1,5,"dummy"
"158613",1,4,0,5,"dummy"
"158614",0,0,1,1,"dummy"
"158615",3,9,2,14,"dummy"
"158616",0,0,1,1,"dummy"
"158617",2,3,0,5,"dummy"
"158618",4,4,1,9,"dummy"
"158620",0,0,1,1,"dummy"
"158625",0,0,1,1,"dummy"
"158633",1,1,0,2,"dummy"
"158636",0,1,0,1,"dummy"
"158637",0,2,0,2,"dummy"
"158638",0,2,0,2,"dummy"
"158644",0,3,0,3,"dummy"
"158645",2,2,0,4,"dummy"
"158646",3,0,0,3,"dummy"
"158648",0,1,0,1,"dummy"
"158649",0,1,0,1,"dummy"
"158651",0,0,1,1,"dummy"
"158652",0,0,1,1,"dummy"
"158653",0,0,1,1,"dummy"
"158654",11,0,2,13,"dummy"
"158664",0,3,0,3,"dummy"
"158679",0,0,1,1,"dummy"
"158680",0,1,0,1,"dummy"
"158681",2,1,1,4,"dummy"
"158682",2,1,1,4,"dummy"
"158685",0,0,0,0,"dummy"
"158686",0,1,0,1,"dummy"
"158689",1,0,0,1,"dummy"
"158690",2,2,0,4,"dummy"
"158691",0,2,1,3,"dummy"
"158703",0,0,1,1,"dummy"
"158707",2,4,0,6,"dummy"
"158708",0,2,0,2,"dummy"
"158709",0,2,0,2,"dummy"
"158710",10,2,0,12,"dummy"
"158711",0,2,0,2,"dummy"
"158712",0,0,0,0,"dummy"
"158713",0,0,3,3,"dummy"
"158714",0,5,0,5,"dummy"
"158715",1,0,1,2,"dummy"
"158719",0,10,0,10,"dummy"
"158720",0,3,0,3,"dummy"
"158722",2,0,1,3,"dummy"
"158723",1,2,0,3,"dummy"
"158724",2,10,0,12,"dummy"
"158725",3,0,0,3,"dummy"
"158726",0,1,0,1,"dummy"
"158727",0,2,0,2,"dummy"
"158728",0,0,1,1,"dummy"
"158730",0,0,0,0,"dummy"
"158731",1,0,0,1,"dummy"
"158737",0,2,0,2,"dummy"
"158739",0,0,1,1,"dummy"
"158740",5,3,2,10,"dummy"
"158744",0,1,0,1,"dummy"
"158745",0,8,3,11,"dummy"
"158748",0,0,0,0,"dummy"
"158749",0,2,0,2,"dummy"
"158750",1,0,3,4,"dummy"
"158751",0,0,0,0,"dummy"
"158752",5,4,1,10,"dummy"
"158755",0,1,0,1,"dummy"
"158756",1,2,1,4,"dummy"
"158757",0,0,1,1,"dummy"
"158764",1,1,0,2,"dummy"
"158765",0,1,0,1,"dummy"
"158766",0,1,0,1,"dummy"
"158767",0,0,1,1,"dummy"
"158768",0,0,1,1,"dummy"
"158769",0,1,0,1,"dummy"
"158770",0,1,0,1,"dummy"
"158771",0,0,1,1,"dummy"
"158786",1,0,0,1,"dummy"
"158795",3,1,0,4,"dummy"
"158796",0,0,1,1,"dummy"
"158798",10,4,1,15,"dummy"
"158800",0,20,3,23,"dummy"
"158801",1,5,2,8,"dummy"
"158802",0,0,1,1,"dummy"
"158803",0,1,2,3,"dummy"
"158804",1,2,1,4,"dummy"
"158806",3,2,0,5,"dummy"
"158807",0,6,2,8,"dummy"
"158809",1,0,0,1,"dummy"
"158813",2,4,1,7,"dummy"
"158814",8,1,6,15,"dummy"
"158816",2,4,0,6,"dummy"
"158817",2,2,1,5,"dummy"
"158818",2,0,0,2,"dummy"
"158819",2,3,0,5,"dummy"
"158820",2,5,0,7,"dummy"
"158821",0,1,0,1,"dummy"
"158822",3,0,1,4,"dummy"
"158823",0,2,0,2,"dummy"
"158824",5,11,0,16,"dummy"
"158825",0,4,0,4,"dummy"
"158826",8,6,0,14,"dummy"
"158828",1,0,0,1,"dummy"
"158829",1,1,2,4,"dummy"
"158830",1,0,2,3,"dummy"
"158831",0,0,0,0,"dummy"
"158832",1,0,0,1,"dummy"
"158833",1,3,1,5,"dummy"
"158834",1,0,0,1,"dummy"
"158835",0,1,0,1,"dummy"
"158836",0,0,0,0,"dummy"
"158837",0,1,0,1,"dummy"
"158840",0,0,1,1,"dummy"
"158841",4,11,1,16,"dummy"
"158844",3,0,0,3,"dummy"
"158847",0,0,1,1,"dummy"
"158848",4,3,0,7,"dummy"
"158869",0,2,1,3,"dummy"
"158870",0,0,1,1,"dummy"
"158879",0,3,1,4,"dummy"
"158881",0,4,0,4,"dummy"
"158884",0,0,1,1,"dummy"
"158886",0,3,0,3,"dummy"
"158887",3,1,0,4,"dummy"
"158888",0,2,0,2,"dummy"
"158892",2,3,3,8,"dummy"
"158894",0,2,0,2,"dummy"
"158895",2,0,0,2,"dummy"
"158896",0,2,1,3,"dummy"
"158897",0,0,1,1,"dummy"
"158898",0,1,1,2,"dummy"
"158899",1,0,1,2,"dummy"
"158900",2,0,0,2,"dummy"
"158901",0,0,1,1,"dummy"
"158902",0,0,1,1,"dummy"
"158903",0,0,1,1,"dummy"
"158904",0,0,1,1,"dummy"
"158906",0,2,0,2,"dummy"
"158909",0,0,1,1,"dummy"
"158910",0,0,2,2,"dummy"
"158914",0,0,0,0,"dummy"
"158915",0,0,0,0,"dummy"
"158916",1,0,1,2,"dummy"
"158917",0,1,1,2,"dummy"
"158918",1,0,1,2,"dummy"
"158919",0,2,1,3,"dummy"
"158920",0,0,0,0,"dummy"
"158921",0,0,1,1,"dummy"
"158927",1,2,1,4,"dummy"
"158928",1,0,1,2,"dummy"
"158931",0,0,2,2,"dummy"
"158935",1,10,0,11,"dummy"
"158936",10,7,1,18,"dummy"
"158937",5,2,1,8,"dummy"
"158938",0,1,0,1,"dummy"
"158939",0,2,0,2,"dummy"
"158940",2,0,0,2,"dummy"
"158941",0,1,0,1,"dummy"
"158942",1,1,0,2,"dummy"
"158945",1,0,0,1,"dummy"
"158946",0,0,1,1,"dummy"
"158947",3,0,0,3,"dummy"
"158949",15,4,1,20,"dummy"
"158950",1,4,0,5,"dummy"
"158951",2,1,0,3,"dummy"
"158953",0,0,1,1,"dummy"
"158954",0,2,1,3,"dummy"
"158956",0,1,0,1,"dummy"
"158959",0,0,2,2,"dummy"
"158960",0,1,0,1,"dummy"
"158962",0,5,0,5,"dummy"
"158965",1,0,0,1,"dummy"
"158966",0,0,1,1,"dummy"
"158969",6,0,2,8,"dummy"
"158970",1,2,2,5,"dummy"
"158971",3,0,3,6,"dummy"
"158972",0,0,2,2,"dummy"
"158974",1,3,5,9,"dummy"
"158976",0,2,0,2,"dummy"
"158977",0,2,0,2,"dummy"
"158978",0,0,0,0,"dummy"
"158979",0,1,0,1,"dummy"
"158980",0,0,0,0,"dummy"
"158981",0,0,0,0,"dummy"
"158983",0,1,0,1,"dummy"
"158985",0,1,0,1,"dummy"
"158986",0,1,0,1,"dummy"
"158988",0,0,0,0,"dummy"
"158989",1,0,1,2,"dummy"
"158993",4,2,2,8,"dummy"
"158994",0,1,0,1,"dummy"
"158995",0,1,0,1,"dummy"
"158996",0,4,0,4,"dummy"
"158997",0,1,0,1,"dummy"
"158998",6,1,1,8,"dummy"
"159007",6,0,0,6,"dummy"
"159008",2,5,2,9,"dummy"
"159010",1,0,0,1,"dummy"
"159014",0,3,1,4,"dummy"
"159015",0,1,0,1,"dummy"
"159017",0,1,0,1,"dummy"
"159018",0,0,1,1,"dummy"
"159020",0,0,1,1,"dummy"
"159021",0,0,1,1,"dummy"
"159022",0,0,1,1,"dummy"
"159023",0,0,1,1,"dummy"
"159025",1,0,0,1,"dummy"
"159026",0,3,0,3,"dummy"
"159027",3,0,0,3,"dummy"
"159028",0,2,0,2,"dummy"
"159032",1,2,0,3,"dummy"
"159046",1,2,0,3,"dummy"
"159047",4,0,0,4,"dummy"
"159048",3,1,0,4,"dummy"
"159049",1,3,0,4,"dummy"
"159053",1,0,0,1,"dummy"
"159056",7,10,2,19,"dummy"
"159057",0,14,0,14,"dummy"
"159058",0,1,0,1,"dummy"
"159059",1,5,0,6,"dummy"
"159060",0,0,0,0,"dummy"
"159061",3,6,1,10,"dummy"
"159062",6,7,0,13,"dummy"
"159063",29,8,1,38,"dummy"
"159064",0,4,0,4,"dummy"
"159065",0,2,0,2,"dummy"
"159066",1,10,1,12,"dummy"
"159067",9,1,1,11,"dummy"
"159068",0,5,0,5,"dummy"
"159069",4,8,0,12,"dummy"
"159070",10,0,0,10,"dummy"
"159071",0,4,0,4,"dummy"
"159072",4,0,0,4,"dummy"
"159073",2,2,1,5,"dummy"
"159074",1,2,1,4,"dummy"
"159075",1,4,0,5,"dummy"
"159076",0,1,0,1,"dummy"
"159079",2,5,2,9,"dummy"
"159083",0,0,1,1,"dummy"
"159084",0,2,0,2,"dummy"
"159085",3,0,0,3,"dummy"
"159086",0,1,0,1,"dummy"
"159087",0,0,0,0,"dummy"
"159088",0,0,1,1,"dummy"
"159089",2,3,1,6,"dummy"
"159090",0,0,0,0,"dummy"
"159091",1,0,0,1,"dummy"
"159092",0,3,0,3,"dummy"
"159093",0,1,0,1,"dummy"
"159094",0,1,0,1,"dummy"
"159095",0,0,1,1,"dummy"
"159096",1,1,0,2,"dummy"
"159097",1,1,1,3,"dummy"
"159098",2,0,1,3,"dummy"
"159099",1,1,0,2,"dummy"
"159100",0,2,0,2,"dummy"
"159101",0,1,0,1,"dummy"
"159102",1,0,0,1,"dummy"
"159103",1,0,0,1,"dummy"
"159106",0,1,1,2,"dummy"
"159107",1,1,0,2,"dummy"
"159108",0,1,0,1,"dummy"
"159109",0,0,2,2,"dummy"
"159110",0,0,2,2,"dummy"
"159114",2,0,0,2,"dummy"
"159115",0,2,0,2,"dummy"
"159116",1,1,0,2,"dummy"
"159117",1,1,0,2,"dummy"
"159118",8,9,1,18,"dummy"
"159119",5,0,0,5,"dummy"
"159120",1,0,0,1,"dummy"
"159126",0,1,0,1,"dummy"
"159127",0,1,1,2,"dummy"
"159129",23,8,4,35,"dummy"
"159130",0,1,0,1,"dummy"
"159131",0,0,1,1,"dummy"
"159135",0,2,0,2,"dummy"
"159136",0,1,0,1,"dummy"
"159137",0,0,1,1,"dummy"
"159138",1,0,0,1,"dummy"
"159141",4,0,1,5,"dummy"
"159151",9,0,5,14,"dummy"
"159156",0,0,1,1,"dummy"
"159157",3,0,0,3,"dummy"
"159158",0,0,2,2,"dummy"
"159159",5,5,0,10,"dummy"
"159162",1,1,0,2,"dummy"
"159166",0,1,0,1,"dummy"
"159167",18,3,2,23,"dummy"
"159168",0,0,2,2,"dummy"
"159170",0,0,0,0,"dummy"
"159171",1,0,0,1,"dummy"
"159172",0,3,0,3,"dummy"
"159173",1,0,2,3,"dummy"
"159174",4,0,0,4,"dummy"
"159175",1,0,0,1,"dummy"
"159176",0,1,0,1,"dummy"
"159177",2,3,1,6,"dummy"
"159179",4,20,3,27,"dummy"
"159180",0,2,0,2,"dummy"
"159181",0,5,2,7,"dummy"
"159182",0,0,1,1,"dummy"
"159185",1,0,0,1,"dummy"
"159186",0,0,1,1,"dummy"
"159187",0,1,0,1,"dummy"
"159188",0,2,0,2,"dummy"
"159189",0,1,0,1,"dummy"
"159190",1,0,0,1,"dummy"
"159204",11,3,0,14,"dummy"
"159212",0,1,0,1,"dummy"
"159213",1,0,0,1,"dummy"
"159218",0,1,0,1,"dummy"
"159234",2,1,0,3,"dummy"
"159235",0,2,0,2,"dummy"
"159240",1,1,0,2,"dummy"
"159241",0,1,0,1,"dummy"
"159245",0,1,1,2,"dummy"
"159255",0,0,1,1,"dummy"
"159256",0,2,1,3,"dummy"
"159257",0,0,2,2,"dummy"
"159258",0,0,1,1,"dummy"
"159259",0,0,0,0,"dummy"
"159260",0,1,0,1,"dummy"
"159261",1,2,0,3,"dummy"
"159262",0,1,0,1,"dummy"
"159263",1,10,1,12,"dummy"
"159264",1,1,0,2,"dummy"
"159265",0,1,0,1,"dummy"
"159266",7,2,0,9,"dummy"
"159267",0,1,0,1,"dummy"
"159268",0,0,1,1,"dummy"
"159269",0,0,1,1,"dummy"
"159270",0,0,2,2,"dummy"
"159271",0,0,1,1,"dummy"
"159272",0,0,1,1,"dummy"
"159273",0,0,1,1,"dummy"
"159274",0,0,1,1,"dummy"
"159275",0,0,1,1,"dummy"
"159276",0,0,4,4,"dummy"
"159277",0,0,0,0,"dummy"
"159278",0,2,1,3,"dummy"
"159279",2,0,2,4,"dummy"
"159280",0,2,1,3,"dummy"
"159281",0,0,1,1,"dummy"
"159282",0,0,1,1,"dummy"
"159283",0,2,0,2,"dummy"
"159284",4,2,0,6,"dummy"
"159285",0,2,0,2,"dummy"
"159286",0,0,1,1,"dummy"
"159287",0,0,1,1,"dummy"
"159288",0,0,1,1,"dummy"
"159289",0,0,1,1,"dummy"
"159290",5,2,1,8,"dummy"
"159291",0,4,1,5,"dummy"
"159292",3,1,0,4,"dummy"
"159295",0,1,0,1,"dummy"
"159298",2,7,3,12,"dummy"
"159299",0,0,0,0,"dummy"
"159300",2,6,2,10,"dummy"
"159301",2,8,2,12,"dummy"
"159302",0,1,0,1,"dummy"
"159303",0,0,1,1,"dummy"
"159304",0,0,1,1,"dummy"
"159305",0,0,1,1,"dummy"
"159313",0,0,1,1,"dummy"
"159314",0,0,1,1,"dummy"
"159315",0,1,0,1,"dummy"
"159318",12,1,0,13,"dummy"
"159319",0,0,1,1,"dummy"
"159320",0,3,0,3,"dummy"
"159321",0,3,0,3,"dummy"
"159322",5,9,1,15,"dummy"
"159323",0,0,1,1,"dummy"
"159324",9,0,0,9,"dummy"
"159351",0,0,0,0,"dummy"
"159354",2,0,1,3,"dummy"
"159355",3,2,1,6,"dummy"
"159367",0,0,1,1,"dummy"
"159368",0,0,1,1,"dummy"
"159369",0,0,1,1,"dummy"
"159370",0,0,1,1,"dummy"
"159194",1,0,0,1,"dummy"
"159195",0,5,0,5,"dummy"
"159196",3,2,0,5,"dummy"
"159200",0,1,0,1,"dummy"
"159201",0,4,0,4,"dummy"
"159202",3,0,0,3,"dummy"
"159206",0,0,0,0,"dummy"
"159207",1,0,0,1,"dummy"
"159208",0,1,0,1,"dummy"
"159209",0,0,1,1,"dummy"
"159210",2,3,0,5,"dummy"
"159215",2,1,1,4,"dummy"
"159216",4,9,1,14,"dummy"
"159220",2,0,3,5,"dummy"
"159223",0,0,1,1,"dummy"
"159224",0,0,1,1,"dummy"
"159229",0,0,1,1,"dummy"
"159230",35,2,4,41,"dummy"
"159231",0,2,0,2,"dummy"
"159232",0,0,1,1,"dummy"
"159243",0,0,0,0,"dummy"
"159249",0,1,0,1,"dummy"
"159250",1,0,1,2,"dummy"
"159251",0,1,0,1,"dummy"
"159252",9,25,1,35,"dummy"
"159253",0,2,0,2,"dummy"
"159307",0,0,0,0,"dummy"
"159310",1,1,0,2,"dummy"
"159311",0,0,2,2,"dummy"
"159335",0,1,0,1,"dummy"
"159338",0,0,2,2,"dummy"
"159339",0,4,0,4,"dummy"
"159340",3,0,0,3,"dummy"
"159346",0,0,0,0,"dummy"
"159347",0,0,0,0,"dummy"
"159348",0,1,0,1,"dummy"
"159349",0,1,1,2,"dummy"
"159357",0,9,0,9,"dummy"
"159358",0,1,0,1,"dummy"
"159359",1,1,1,3,"dummy"
"159360",0,2,9,11,"dummy"
"159361",0,0,1,1,"dummy"
"159362",1,0,0,1,"dummy"
"159363",0,0,1,1,"dummy"
"159364",2,0,0,2,"dummy"
"159365",20,2,1,23,"dummy"
"159382",0,1,0,1,"dummy"
"159383",0,2,0,2,"dummy"
"159384",2,0,0,2,"dummy"
"159387",0,1,0,1,"dummy"
"159388",0,0,1,1,"dummy"
"159389",0,2,2,4,"dummy"
"159390",0,0,1,1,"dummy"
"159391",0,0,1,1,"dummy"
"159392",3,0,1,4,"dummy"
"159393",0,1,0,1,"dummy"
"159394",0,2,1,3,"dummy"
"159395",3,0,2,5,"dummy"
"159396",0,3,1,4,"dummy"
"159397",0,0,1,1,"dummy"
"159398",0,0,1,1,"dummy"
"159408",0,0,1,1,"dummy"
"159409",0,1,0,1,"dummy"
"159410",0,2,0,2,"dummy"
"159411",0,1,2,3,"dummy"
"159412",0,1,0,1,"dummy"
"159413",0,0,1,1,"dummy"
"159417",40,9,2,51,"dummy"
"159418",9,5,0,14,"dummy"
"159419",0,1,0,1,"dummy"
"159426",0,1,0,1,"dummy"
"159427",0,1,0,1,"dummy"
"159431",0,12,0,12,"dummy"
"159432",0,2,0,2,"dummy"
"159433",0,0,0,0,"dummy"
"159371",0,0,1,1,"dummy"
"159372",0,1,0,1,"dummy"
"159373",0,0,1,1,"dummy"
"159374",0,0,1,1,"dummy"
"159415",19,7,2,28,"dummy"
"159423",7,7,7,21,"dummy"
"159424",11,0,2,13,"dummy"
"159429",2,5,2,9,"dummy"
"159437",0,2,0,2,"dummy"
"159440",0,1,0,1,"dummy"
"159445",0,0,0,0,"dummy"
"159458",0,0,1,1,"dummy"
"159463",0,1,0,1,"dummy"
"159464",0,3,0,3,"dummy"
"159473",0,1,0,1,"dummy"
"159474",0,0,2,2,"dummy"
"159475",0,1,1,2,"dummy"
"159479",0,1,4,5,"dummy"
"159480",1,0,0,1,"dummy"
"159481",2,7,0,9,"dummy"
"159482",2,0,0,2,"dummy"
"159483",0,1,0,1,"dummy"
"159484",0,1,0,1,"dummy"
"159485",0,0,1,1,"dummy"
"159486",15,24,3,42,"dummy"
"159487",2,2,0,4,"dummy"
"159488",13,13,0,26,"dummy"
"159489",0,1,2,3,"dummy"
"159490",0,0,1,1,"dummy"
"159491",2,4,0,6,"dummy"
"159492",3,3,1,7,"dummy"
"159493",3,0,2,5,"dummy"
"159494",1,2,1,4,"dummy"
"159519",16,22,2,40,"dummy"
"159520",2,3,6,11,"dummy"
"159521",0,1,0,1,"dummy"
"159524",0,1,0,1,"dummy"
"159555",0,0,1,1,"dummy"
"159556",0,0,0,0,"dummy"
"159557",0,4,1,5,"dummy"
"159558",0,0,0,0,"dummy"
"159559",0,2,0,2,"dummy"
"159560",0,0,1,1,"dummy"
"159561",0,0,1,1,"dummy"
"159562",0,1,1,2,"dummy"
"159563",0,0,0,0,"dummy"
"159564",0,0,1,1,"dummy"
"159565",0,0,1,1,"dummy"
"159566",0,1,0,1,"dummy"
"159567",2,2,0,4,"dummy"
"159568",4,5,2,11,"dummy"
"159569",0,0,1,1,"dummy"
"159570",1,0,0,1,"dummy"
"159571",0,0,1,1,"dummy"
"159572",3,6,0,9,"dummy"
"159573",0,0,1,1,"dummy"
"159574",0,0,1,1,"dummy"
"159575",3,2,0,5,"dummy"
"159576",0,1,0,1,"dummy"
"159577",5,1,1,7,"dummy"
"159580",0,0,1,1,"dummy"
"159581",0,0,1,1,"dummy"
"159582",0,0,2,2,"dummy"
"159583",0,0,2,2,"dummy"
"159584",0,0,1,1,"dummy"
"159585",0,0,2,2,"dummy"
"159586",0,0,2,2,"dummy"
"159587",0,0,1,1,"dummy"
"159588",0,0,2,2,"dummy"
"159589",0,0,2,2,"dummy"
"159590",0,0,2,2,"dummy"
"159591",0,0,2,2,"dummy"
"159602",5,8,2,15,"dummy"
"159603",1,6,0,7,"dummy"
"159612",1,1,0,2,"dummy"
"159613",1,1,0,2,"dummy"
"159434",0,3,0,3,"dummy"
"159435",19,8,2,29,"dummy"
"159449",0,1,0,1,"dummy"
"159450",1,5,0,6,"dummy"
"159451",5,1,0,6,"dummy"
"159452",0,5,0,5,"dummy"
"159453",1,0,0,1,"dummy"
"159454",0,1,0,1,"dummy"
"159455",2,1,0,3,"dummy"
"159456",0,0,1,1,"dummy"
"159468",0,1,0,1,"dummy"
"159469",0,3,0,3,"dummy"
"159470",1,1,0,2,"dummy"
"159471",0,1,0,1,"dummy"
"159477",2,3,2,7,"dummy"
"159498",0,0,1,1,"dummy"
"159499",0,0,0,0,"dummy"
"159514",0,0,0,0,"dummy"
"159515",0,0,0,0,"dummy"
"159516",0,0,0,0,"dummy"
"159517",0,0,0,0,"dummy"
"159526",0,0,1,1,"dummy"
"159527",0,0,1,1,"dummy"
"159528",0,0,2,2,"dummy"
"159529",0,0,2,2,"dummy"
"159530",0,2,2,4,"dummy"
"159607",1,0,0,1,"dummy"
"159608",0,3,0,3,"dummy"
"159609",0,0,1,1,"dummy"
"159610",0,0,1,1,"dummy"
"159638",0,1,2,3,"dummy"
"159639",0,0,0,0,"dummy"
"159640",0,1,0,1,"dummy"
"159641",4,0,2,6,"dummy"
"159642",1,0,0,1,"dummy"
"159643",0,0,0,0,"dummy"
"159644",0,0,0,0,"dummy"
"159648",0,0,1,1,"dummy"
"159663",6,9,2,17,"dummy"
"159664",3,5,1,9,"dummy"
"159670",0,0,4,4,"dummy"
"159678",3,2,0,5,"dummy"
"159679",1,0,1,2,"dummy"
"159825",0,0,1,1,"dummy"
"159829",0,0,0,0,"dummy"
"159840",0,0,1,1,"dummy"
"159841",0,0,1,1,"dummy"
"159842",8,1,5,14,"dummy"
"159847",2,4,0,6,"dummy"
"159848",0,2,0,2,"dummy"
"159849",0,2,0,2,"dummy"
"159850",10,2,0,12,"dummy"
"159851",0,2,0,2,"dummy"
"159852",0,0,0,0,"dummy"
"159855",0,1,2,3,"dummy"
"159856",3,0,5,8,"dummy"
"159859",0,2,0,2,"dummy"
"159860",0,0,2,2,"dummy"
"159861",2,2,0,4,"dummy"
"159862",0,2,2,4,"dummy"
"159614",6,6,1,13,"dummy"
"159615",0,2,0,2,"dummy"
"159616",2,0,0,2,"dummy"
"159617",0,0,0,0,"dummy"
"159618",0,0,0,0,"dummy"
"159619",0,0,1,1,"dummy"
"159620",0,0,0,0,"dummy"
"159621",0,0,0,0,"dummy"
"159622",0,3,0,3,"dummy"
"159623",4,3,0,7,"dummy"
"159624",2,0,0,2,"dummy"
"159625",4,5,1,10,"dummy"
"159626",1,0,0,1,"dummy"
"159627",1,0,0,1,"dummy"
"159628",0,0,0,0,"dummy"
"159629",0,0,1,1,"dummy"
"159630",0,0,0,0,"dummy"
"159631",0,1,0,1,"dummy"
"159632",1,0,0,1,"dummy"
"159635",1,0,1,2,"dummy"
"159636",0,1,0,1,"dummy"
"159646",0,1,0,1,"dummy"
"159660",0,8,5,13,"dummy"
"159661",0,1,0,1,"dummy"
"159666",6,0,0,6,"dummy"
"159676",0,1,0,1,"dummy"
"159827",0,1,1,2,"dummy"
"159831",0,0,0,0,"dummy"
"159832",0,0,0,0,"dummy"
"159833",0,0,0,0,"dummy"
"159834",0,0,0,0,"dummy"
"159844",0,0,0,0,"dummy"
"159845",0,0,0,0,"dummy"
"159864",1,1,0,2,"dummy"
"159865",1,2,1,4,"dummy"
"159866",0,0,1,1,"dummy"
"159867",0,0,2,2,"dummy"
"159872",0,1,0,1,"dummy"
"159873",9,5,0,14,"dummy"
"159874",0,0,0,0,"dummy"
"159875",0,1,0,1,"dummy"
"159876",0,0,1,1,"dummy"
"159877",0,1,0,1,"dummy"
"159878",0,5,0,5,"dummy"
"159879",0,2,0,2,"dummy"
"159880",0,0,1,1,"dummy"
"159883",0,0,1,1,"dummy"
"159884",0,0,1,1,"dummy"
"159887",8,3,1,12,"dummy"
"159888",1,8,1,10,"dummy"
"159889",0,0,1,1,"dummy"
"159901",2,1,0,3,"dummy"
"159902",0,2,0,2,"dummy"
"159903",0,16,1,17,"dummy"
"159904",0,0,1,1,"dummy"
"159905",0,1,0,1,"dummy"
"159906",1,0,0,1,"dummy"
"159907",0,1,0,1,"dummy"
"159908",18,21,4,43,"dummy"
"159909",1,1,0,2,"dummy"
"159910",0,3,1,4,"dummy"
"159911",3,13,0,16,"dummy"
"159912",7,1,0,8,"dummy"
"159913",0,2,0,2,"dummy"
"159914",0,1,0,1,"dummy"
"159921",0,0,0,0,"dummy"
"159922",2,2,0,4,"dummy"
"159923",0,1,1,2,"dummy"
"159924",0,6,0,6,"dummy"
"159927",6,7,3,16,"dummy"
"159930",2,1,1,4,"dummy"
"159951",2,15,4,21,"dummy"
"159963",0,0,2,2,"dummy"
"159964",0,4,0,4,"dummy"
"159974",1,0,0,1,"dummy"
"159975",0,0,0,0,"dummy"
"159978",5,5,0,10,"dummy"
"159979",0,0,1,1,"dummy"
"159980",9,2,0,11,"dummy"
"159996",0,1,0,1,"dummy"
"159997",0,0,0,0,"dummy"
"160000",0,1,2,3,"dummy"
"160001",1,0,2,3,"dummy"
"160002",1,0,1,2,"dummy"
"160003",0,1,0,1,"dummy"
"160004",0,0,1,1,"dummy"
"160005",3,1,0,4,"dummy"
"160006",0,4,0,4,"dummy"
"160007",0,0,1,1,"dummy"
"160008",0,0,2,2,"dummy"
"159932",2,0,3,5,"dummy"
"159933",1,0,0,1,"dummy"
"159934",0,1,0,1,"dummy"
"159935",0,1,1,2,"dummy"
"159938",4,1,1,6,"dummy"
"159939",1,1,2,4,"dummy"
"159940",6,0,0,6,"dummy"
"159941",0,0,1,1,"dummy"
"159942",2,0,0,2,"dummy"
"159943",0,0,1,1,"dummy"
"159944",2,2,0,4,"dummy"
"159945",2,0,0,2,"dummy"
"159946",0,1,0,1,"dummy"
"159947",1,0,0,1,"dummy"
"159948",2,0,0,2,"dummy"
"159949",0,2,0,2,"dummy"
"159955",0,1,0,1,"dummy"
"159956",4,3,0,7,"dummy"
"159957",0,1,0,1,"dummy"
"159958",2,0,0,2,"dummy"
"159959",2,20,0,22,"dummy"
"159966",0,0,0,0,"dummy"
"159967",0,0,0,0,"dummy"
"159970",0,1,0,1,"dummy"
"160010",0,1,2,3,"dummy"
"160011",0,4,0,4,"dummy"
"160012",0,2,0,2,"dummy"
"160013",0,1,0,1,"dummy"
"160014",1,0,0,1,"dummy"
"160015",14,1,0,15,"dummy"
"160016",0,0,1,1,"dummy"
"160017",0,0,4,4,"dummy"
"160022",0,0,3,3,"dummy"
"160023",0,1,0,1,"dummy"
"160031",0,1,0,1,"dummy"
"160039",2,0,0,2,"dummy"
"160064",0,4,0,4,"dummy"
"160065",0,2,0,2,"dummy"
"160066",0,1,0,1,"dummy"
"160067",0,8,0,8,"dummy"
"160068",1,1,0,2,"dummy"
"160090",0,0,1,1,"dummy"
"160103",0,6,2,8,"dummy"
"160104",0,2,0,2,"dummy"
"160184",2,4,1,7,"dummy"
"160185",5,2,1,8,"dummy"
"160186",3,2,3,8,"dummy"
"160187",2,5,3,10,"dummy"
"160188",0,0,1,1,"dummy"
"160189",0,0,0,0,"dummy"
"160190",0,1,1,2,"dummy"
"160191",0,0,1,1,"dummy"
"160192",0,0,0,0,"dummy"
"160193",1,2,0,3,"dummy"
"160194",0,0,1,1,"dummy"
"160195",0,0,1,1,"dummy"
"160196",0,0,1,1,"dummy"
"160197",10,2,2,14,"dummy"
"160198",0,0,0,0,"dummy"
"160199",0,0,1,1,"dummy"
"160200",0,0,1,1,"dummy"
"160203",0,0,0,0,"dummy"
"160033",0,0,1,1,"dummy"
"160034",0,3,1,4,"dummy"
"160035",0,0,1,1,"dummy"
"160036",0,2,0,2,"dummy"
"160037",2,2,1,5,"dummy"
"160051",1,5,0,6,"dummy"
"160054",0,1,0,1,"dummy"
"160055",0,2,0,2,"dummy"
"160056",0,2,0,2,"dummy"
"160057",0,1,0,1,"dummy"
"160058",0,0,1,1,"dummy"
"160059",0,0,1,1,"dummy"
"160060",1,0,0,1,"dummy"
"160061",12,10,3,25,"dummy"
"160062",1,0,0,1,"dummy"
"160072",2,7,0,9,"dummy"
"160073",1,0,0,1,"dummy"
"160074",2,4,1,7,"dummy"
"160075",8,0,1,9,"dummy"
"160165",0,0,1,1,"dummy"
"160166",0,0,0,0,"dummy"
"160167",0,0,1,1,"dummy"
"160168",0,3,1,4,"dummy"
"160169",0,1,0,1,"dummy"
"160170",1,1,0,2,"dummy"
"160171",4,3,1,8,"dummy"
"160172",0,0,1,1,"dummy"
"160173",0,4,2,6,"dummy"
"160174",0,0,1,1,"dummy"
"160175",0,1,1,2,"dummy"
"160176",0,0,1,1,"dummy"
"160177",0,0,2,2,"dummy"
"160178",0,0,1,1,"dummy"
"160179",2,1,1,4,"dummy"
"160180",0,0,1,1,"dummy"
"160181",0,0,1,1,"dummy"
"160182",0,0,1,1,"dummy"
"160206",0,1,0,1,"dummy"
"160207",3,4,0,7,"dummy"
"160208",5,2,0,7,"dummy"
"160209",1,0,0,1,"dummy"
"160210",2,0,0,2,"dummy"
"160211",1,1,0,2,"dummy"
"160212",1,6,0,7,"dummy"
"160213",1,3,0,4,"dummy"
"160214",1,1,0,2,"dummy"
"160215",5,0,0,5,"dummy"
"160216",5,1,0,6,"dummy"
"160217",1,1,0,2,"dummy"
"160218",2,0,0,2,"dummy"
"160219",1,0,0,1,"dummy"
"160220",0,1,0,1,"dummy"
"160221",1,0,0,1,"dummy"
"160222",4,0,0,4,"dummy"
"160223",3,5,0,8,"dummy"
"160224",0,0,2,2,"dummy"
"160225",0,0,2,2,"dummy"
"160226",0,0,1,1,"dummy"
"160227",0,2,0,2,"dummy"
"160228",2,0,0,2,"dummy"
"160229",0,0,1,1,"dummy"
"160204",0,0,0,0,"dummy"
"160235",0,0,1,1,"dummy"
"160239",1,2,0,3,"dummy"
"160240",0,4,2,6,"dummy"
"160241",0,0,1,1,"dummy"
"160243",0,3,0,3,"dummy"
"160244",3,1,0,4,"dummy"
"160246",1,0,0,1,"dummy"
"160247",0,1,0,1,"dummy"
"160248",0,6,0,6,"dummy"
"160253",0,4,2,6,"dummy"
"160259",0,0,1,1,"dummy"
"160262",0,2,0,2,"dummy"
"160263",1,5,0,6,"dummy"
"160264",0,2,0,2,"dummy"
"160265",1,2,1,4,"dummy"
"160266",4,10,2,16,"dummy"
"160267",2,0,0,2,"dummy"
"160270",0,1,0,1,"dummy"
"160271",1,2,0,3,"dummy"
"160276",0,0,0,0,"dummy"
"160277",6,6,0,12,"dummy"
"160278",6,7,0,13,"dummy"
"160279",0,1,0,1,"dummy"
"160280",6,6,0,12,"dummy"
"160281",0,0,2,2,"dummy"
"160282",19,26,0,45,"dummy"
"160283",61,60,0,121,"dummy"
"160284",71,67,0,138,"dummy"
"160285",0,1,0,1,"dummy"
"160286",0,1,0,1,"dummy"
"160288",1,2,0,3,"dummy"
"160289",14,14,2,30,"dummy"
"160290",9,9,0,18,"dummy"
"160291",1,1,0,2,"dummy"
"160292",1,1,0,2,"dummy"
"160293",1,1,0,2,"dummy"
"160294",1,1,0,2,"dummy"
"160295",1,1,0,2,"dummy"
"160296",1,1,0,2,"dummy"
"160297",1,1,0,2,"dummy"
"160298",2,6,0,8,"dummy"
"160299",7,3,0,10,"dummy"
"160300",2,6,0,8,"dummy"
"160301",0,1,0,1,"dummy"
"160303",4,0,3,7,"dummy"
"160309",0,2,0,2,"dummy"
"160314",2,5,2,9,"dummy"
"160316",0,0,1,1,"dummy"
"160317",1,2,0,3,"dummy"
"160319",3,6,0,9,"dummy"
"160320",0,0,1,1,"dummy"
"160321",0,0,1,1,"dummy"
"160322",2,0,0,2,"dummy"
"160323",0,0,1,1,"dummy"
"160324",0,3,0,3,"dummy"
"160325",1,1,0,2,"dummy"
"160326",24,0,0,24,"dummy"
"160327",0,0,0,0,"dummy"
"160330",1,2,0,3,"dummy"
"160331",0,2,0,2,"dummy"
"160332",0,2,0,2,"dummy"
"160339",0,0,1,1,"dummy"
"160340",1,3,2,6,"dummy"
"160341",3,3,0,6,"dummy"
"160344",0,0,1,1,"dummy"
"160345",0,0,1,1,"dummy"
"160346",0,0,2,2,"dummy"
"160347",26,3,7,36,"dummy"
"160350",4,1,2,7,"dummy"
"160351",1,2,0,3,"dummy"
"160352",3,5,0,8,"dummy"
"160353",1,0,0,1,"dummy"
"160354",3,5,0,8,"dummy"
"160355",0,0,0,0,"dummy"
"160356",5,3,0,8,"dummy"
"160357",0,5,0,5,"dummy"
"160358",2,2,4,8,"dummy"
"160359",0,4,1,5,"dummy"
"160360",2,0,1,3,"dummy"
"160361",0,5,0,5,"dummy"
"160362",0,0,0,0,"dummy"
"160363",0,1,0,1,"dummy"
"160364",0,0,1,1,"dummy"
"160365",0,0,0,0,"dummy"
"160366",0,0,1,1,"dummy"
"160367",4,0,0,4,"dummy"
"160368",6,0,0,6,"dummy"
"160437",0,4,1,5,"dummy"
"160439",1,3,0,4,"dummy"
"160440",0,0,1,1,"dummy"
"160441",0,1,0,1,"dummy"
"160443",7,6,0,13,"dummy"
"160446",0,0,1,1,"dummy"
"160448",1,0,0,1,"dummy"
"160449",4,0,1,5,"dummy"
"160450",0,3,1,4,"dummy"
"160451",2,9,4,15,"dummy"
"160452",4,3,1,8,"dummy"
"160455",0,0,0,0,"dummy"
"160456",0,1,0,1,"dummy"
"160457",0,0,0,0,"dummy"
"160458",0,0,1,1,"dummy"
"160461",1,1,0,2,"dummy"
"160462",1,1,0,2,"dummy"
"160463",14,11,3,28,"dummy"
"160464",0,0,1,1,"dummy"
"160465",0,0,1,1,"dummy"
"160466",1,0,1,2,"dummy"
"160467",2,2,3,7,"dummy"
"160468",0,2,4,6,"dummy"
"160469",9,0,1,10,"dummy"
"160470",0,0,1,1,"dummy"
"160472",0,1,1,2,"dummy"
"160473",1,0,0,1,"dummy"
"160474",0,0,1,1,"dummy"
"160475",0,0,1,1,"dummy"
"160476",0,0,1,1,"dummy"
"160477",0,0,1,1,"dummy"
"160478",0,0,1,1,"dummy"
"160480",0,0,2,2,"dummy"
"160481",3,4,2,9,"dummy"
"160482",0,0,2,2,"dummy"
"160484",0,0,1,1,"dummy"
"160485",0,3,0,3,"dummy"
"160492",0,0,3,3,"dummy"
"160496",0,0,1,1,"dummy"
"160500",0,2,0,2,"dummy"
"160501",0,0,1,1,"dummy"
"160502",1,3,0,4,"dummy"
"160503",0,0,1,1,"dummy"
"160504",0,3,1,4,"dummy"
"160505",0,0,1,1,"dummy"
"160506",2,8,0,10,"dummy"
"160507",8,14,0,22,"dummy"
"160508",0,1,0,1,"dummy"
"160509",2,2,1,5,"dummy"
"160510",0,1,0,1,"dummy"
"160511",0,1,1,2,"dummy"
"160512",0,0,2,2,"dummy"
"160513",0,6,0,6,"dummy"
"160514",3,3,0,6,"dummy"
"160515",0,0,1,1,"dummy"
"160516",7,0,1,8,"dummy"
"160517",1,1,0,2,"dummy"
"160518",0,1,1,2,"dummy"
"160519",1,1,0,2,"dummy"
"160520",1,0,0,1,"dummy"
"160521",1,0,0,1,"dummy"
"160522",0,0,1,1,"dummy"
"160523",0,1,0,1,"dummy"
"160524",1,1,1,3,"dummy"
"160526",0,2,0,2,"dummy"
"160527",2,0,0,2,"dummy"
"160528",0,1,0,1,"dummy"
"160529",0,1,0,1,"dummy"
"160532",0,0,0,0,"dummy"
"160533",0,0,0,0,"dummy"
"160536",2,0,0,2,"dummy"
"160538",0,5,0,5,"dummy"
"160539",6,2,5,13,"dummy"
"160541",1,17,0,18,"dummy"
"160542",0,3,0,3,"dummy"
"160544",0,0,1,1,"dummy"
"160548",0,1,0,1,"dummy"
"160550",4,5,3,12,"dummy"
"160551",0,1,0,1,"dummy"
"160552",0,1,0,1,"dummy"
"160553",2,0,3,5,"dummy"
"160554",3,0,1,4,"dummy"
"160556",0,2,0,2,"dummy"
"160557",6,3,0,9,"dummy"
"160558",3,3,0,6,"dummy"
"160560",4,6,0,10,"dummy"
"160561",1,0,0,1,"dummy"
"160562",0,1,0,1,"dummy"
"160563",0,0,1,1,"dummy"
"160564",0,3,0,3,"dummy"
"160565",3,7,0,10,"dummy"
"160566",0,1,0,1,"dummy"
"160567",0,1,0,1,"dummy"
"160568",1,0,0,1,"dummy"
"160569",0,0,0,0,"dummy"
"160571",0,0,0,0,"dummy"
"160572",0,1,0,1,"dummy"
"160573",0,0,1,1,"dummy"
"160574",0,0,1,1,"dummy"
"160576",2,3,1,6,"dummy"
"160577",6,0,0,6,"dummy"
"160578",4,11,1,16,"dummy"
"160579",17,15,3,35,"dummy"
"160580",15,17,3,35,"dummy"
"160581",0,1,0,1,"dummy"
"160582",0,1,0,1,"dummy"
"160583",0,0,0,0,"dummy"
"160584",1,0,0,1,"dummy"
"160585",3,0,0,3,"dummy"
"160586",0,0,1,1,"dummy"
"160587",0,0,1,1,"dummy"
"160588",6,0,0,6,"dummy"
"160589",1,0,0,1,"dummy"
"160590",0,9,0,9,"dummy"
"160591",0,1,0,1,"dummy"
"160592",0,1,0,1,"dummy"
"160593",4,6,2,12,"dummy"
"160594",0,3,0,3,"dummy"
"160595",1,1,0,2,"dummy"
"160596",4,1,0,5,"dummy"
"160597",5,0,1,6,"dummy"
"160598",0,1,1,2,"dummy"
"160599",0,2,0,2,"dummy"
"160600",2,4,0,6,"dummy"
"160601",0,2,1,3,"dummy"
"160602",3,3,0,6,"dummy"
"160603",0,1,0,1,"dummy"
"160604",1,0,0,1,"dummy"
"160605",16,5,3,24,"dummy"
"160606",0,1,0,1,"dummy"
"160607",0,1,0,1,"dummy"
"160608",1,0,0,1,"dummy"
"160609",4,0,0,4,"dummy"
"160610",6,6,0,12,"dummy"
"160611",0,0,0,0,"dummy"
"160612",0,1,0,1,"dummy"
"160613",0,0,1,1,"dummy"
"160614",0,1,0,1,"dummy"
"160623",0,0,1,1,"dummy"
"160625",1,3,0,4,"dummy"
"160626",0,1,2,3,"dummy"
"160627",0,1,0,1,"dummy"
"160629",0,1,4,5,"dummy"
"160630",0,0,2,2,"dummy"
"160641",0,0,4,4,"dummy"
"160753",0,1,0,1,"dummy"
"160755",2,4,0,6,"dummy"
"160756",0,1,1,2,"dummy"
"160757",4,6,0,10,"dummy"
"160758",2,2,0,4,"dummy"
"160759",0,0,0,0,"dummy"
"160762",0,5,1,6,"dummy"
"160763",0,0,3,3,"dummy"
"160765",5,1,1,7,"dummy"
"160770",2,10,0,12,"dummy"
"160771",0,1,0,1,"dummy"
"160772",0,0,1,1,"dummy"
"160773",7,0,0,7,"dummy"
"160774",0,2,0,2,"dummy"
"160777",2,0,0,2,"dummy"
"160778",0,2,0,2,"dummy"
"160780",0,0,1,1,"dummy"
"160781",1,1,0,2,"dummy"
"160782",0,0,1,1,"dummy"
"160783",3,4,0,7,"dummy"
"160784",1,0,0,1,"dummy"
"160785",0,0,1,1,"dummy"
"160786",0,1,0,1,"dummy"
"160787",3,1,1,5,"dummy"
"160788",0,1,0,1,"dummy"
"160790",0,0,3,3,"dummy"
"160791",0,0,3,3,"dummy"
"160801",3,0,0,3,"dummy"
"160802",0,3,0,3,"dummy"
"160803",4,0,0,4,"dummy"
"160804",3,0,0,3,"dummy"
"160805",0,5,0,5,"dummy"
"160806",0,4,0,4,"dummy"
"160808",0,1,0,1,"dummy"
"160809",0,0,5,5,"dummy"
"160810",0,0,1,1,"dummy"
"160811",0,0,2,2,"dummy"
"160814",0,0,2,2,"dummy"
"160817",4,0,2,6,"dummy"
"160818",5,2,2,9,"dummy"
"160819",0,0,0,0,"dummy"
"160820",0,0,1,1,"dummy"
"160821",0,0,1,1,"dummy"
"160822",0,0,1,1,"dummy"
"160824",1,0,0,1,"dummy"
"160832",6,15,4,25,"dummy"
"160833",0,0,1,1,"dummy"
"160834",0,4,0,4,"dummy"
"160835",0,0,0,0,"dummy"
"160836",0,0,0,0,"dummy"
"160843",0,2,1,3,"dummy"
"160844",0,1,0,1,"dummy"
"160845",1,0,0,1,"dummy"
"160848",0,0,1,1,"dummy"
"160850",0,0,1,1,"dummy"
"160852",0,4,0,4,"dummy"
"160855",0,1,0,1,"dummy"
"160857",0,0,1,1,"dummy"
"160859",5,6,3,14,"dummy"
"160861",0,3,0,3,"dummy"
"160863",0,0,1,1,"dummy"
"160864",0,0,0,0,"dummy"
"160867",0,0,1,1,"dummy"
"160880",0,0,1,1,"dummy"
"160881",0,0,1,1,"dummy"
"160882",0,0,1,1,"dummy"
"160883",0,0,1,1,"dummy"
"160884",0,0,1,1,"dummy"
"160885",0,0,1,1,"dummy"
"160886",0,0,1,1,"dummy"
"160887",0,0,1,1,"dummy"
"160888",0,0,1,1,"dummy"
"160889",0,0,1,1,"dummy"
"160890",0,0,1,1,"dummy"
"160891",0,0,1,1,"dummy"
"160892",0,0,1,1,"dummy"
"160893",0,0,1,1,"dummy"
"160894",0,0,1,1,"dummy"
"160895",0,0,1,1,"dummy"
"160896",0,0,1,1,"dummy"
"160897",0,0,1,1,"dummy"
"160898",0,0,1,1,"dummy"
"160899",0,0,1,1,"dummy"
"160900",0,0,1,1,"dummy"
"160901",0,0,1,1,"dummy"
"160902",0,0,1,1,"dummy"
"160903",0,0,1,1,"dummy"
"160904",0,0,1,1,"dummy"
"160905",0,0,1,1,"dummy"
"160906",0,0,1,1,"dummy"
"160907",0,0,1,1,"dummy"
"160908",0,0,1,1,"dummy"
"160909",0,0,1,1,"dummy"
"160910",0,0,1,1,"dummy"
"160911",0,0,1,1,"dummy"
"160912",0,0,1,1,"dummy"
"160913",0,0,1,1,"dummy"
"160914",0,0,1,1,"dummy"
"160915",0,0,1,1,"dummy"
"160916",0,0,1,1,"dummy"
"160917",0,0,1,1,"dummy"
"160918",0,0,1,1,"dummy"
"160919",0,0,1,1,"dummy"
"160920",0,0,1,1,"dummy"
"160921",0,0,1,1,"dummy"
"160922",0,0,1,1,"dummy"
"160923",0,0,1,1,"dummy"
"160924",0,0,1,1,"dummy"
"160925",0,0,1,1,"dummy"
"160926",0,0,1,1,"dummy"
"160927",0,0,1,1,"dummy"
"160928",0,0,1,1,"dummy"
"160929",0,0,1,1,"dummy"
"160930",0,0,1,1,"dummy"
"160931",0,0,1,1,"dummy"
"160932",0,0,1,1,"dummy"
"160933",0,0,1,1,"dummy"
"160934",0,2,1,3,"dummy"
"160935",0,0,1,1,"dummy"
"160936",0,0,1,1,"dummy"
"160937",0,0,1,1,"dummy"
"160938",0,0,1,1,"dummy"
"160939",0,0,1,1,"dummy"
"160940",0,0,1,1,"dummy"
"160941",0,0,1,1,"dummy"
"160942",0,0,1,1,"dummy"
"160943",0,0,1,1,"dummy"
"160944",0,0,1,1,"dummy"
"160945",0,0,1,1,"dummy"
"160946",0,0,1,1,"dummy"
"160947",0,0,1,1,"dummy"
"160948",0,0,1,1,"dummy"
"160949",0,0,1,1,"dummy"
"160950",0,0,1,1,"dummy"
"160951",0,0,1,1,"dummy"
"160952",0,0,1,1,"dummy"
"160953",0,0,1,1,"dummy"
"160954",0,0,1,1,"dummy"
"160955",0,0,1,1,"dummy"
"160956",0,0,1,1,"dummy"
"160957",0,0,1,1,"dummy"
"160958",0,0,1,1,"dummy"
"160959",0,0,1,1,"dummy"
"160960",0,0,1,1,"dummy"
"160961",0,0,1,1,"dummy"
"160962",0,0,1,1,"dummy"
"160963",0,0,1,1,"dummy"
"160964",0,0,1,1,"dummy"
"160965",0,0,1,1,"dummy"
"160966",0,0,1,1,"dummy"
"160967",0,0,1,1,"dummy"
"160968",0,0,1,1,"dummy"
"160969",0,0,1,1,"dummy"
"160970",0,0,1,1,"dummy"
"160971",0,0,1,1,"dummy"
"160972",0,0,1,1,"dummy"
"160973",0,2,0,2,"dummy"
"160974",0,0,1,1,"dummy"
"160975",0,0,1,1,"dummy"
"160976",0,0,1,1,"dummy"
"160977",0,0,1,1,"dummy"
"160978",0,0,1,1,"dummy"
"160979",0,0,1,1,"dummy"
"160983",0,0,1,1,"dummy"
"160984",0,2,0,2,"dummy"
"160985",7,3,0,10,"dummy"
"160986",2,0,0,2,"dummy"
"160987",0,1,0,1,"dummy"
"160988",1,0,0,1,"dummy"
"160989",0,2,0,2,"dummy"
"160990",0,0,0,0,"dummy"
"160997",0,3,0,3,"dummy"
"160998",0,0,1,1,"dummy"
"161008",6,1,1,8,"dummy"
"161009",0,0,0,0,"dummy"
"161041",2,0,3,5,"dummy"
"161049",4,8,1,13,"dummy"
"161050",0,0,1,1,"dummy"
"161051",0,0,1,1,"dummy"
"161052",0,1,0,1,"dummy"
"161053",0,0,1,1,"dummy"
"161054",1,4,0,5,"dummy"
"161055",0,0,1,1,"dummy"
"161058",0,0,0,0,"dummy"
"161066",0,1,0,1,"dummy"
"161084",0,4,1,5,"dummy"
"161085",1,2,0,3,"dummy"
"161086",0,0,1,1,"dummy"
"161087",0,0,1,1,"dummy"
"161088",0,0,1,1,"dummy"
"161089",0,0,1,1,"dummy"
"161090",0,0,1,1,"dummy"
"161091",0,0,1,1,"dummy"
"161092",0,0,1,1,"dummy"
"161093",0,0,1,1,"dummy"
"161094",0,0,1,1,"dummy"
"161095",0,0,1,1,"dummy"
"161096",0,0,1,1,"dummy"
"161097",0,2,0,2,"dummy"
"161098",2,0,1,3,"dummy"
"161099",0,0,1,1,"dummy"
"161100",0,0,1,1,"dummy"
"161101",0,0,1,1,"dummy"
"161102",0,0,1,1,"dummy"
"161103",0,0,1,1,"dummy"
"161104",0,0,1,1,"dummy"
"161105",0,2,0,2,"dummy"
"161106",1,0,1,2,"dummy"
"161107",0,0,1,1,"dummy"
"161108",0,0,1,1,"dummy"
"161109",0,0,1,1,"dummy"
"161110",0,0,1,1,"dummy"
"161111",0,0,1,1,"dummy"
"161112",0,0,1,1,"dummy"
"161113",0,0,1,1,"dummy"
"161114",0,0,1,1,"dummy"
"161115",0,0,1,1,"dummy"
"161116",0,1,2,3,"dummy"
"161117",3,8,1,12,"dummy"
"161118",3,14,2,19,"dummy"
"161157",0,0,1,1,"dummy"
"161158",0,3,0,3,"dummy"
"161163",3,5,0,8,"dummy"
"161164",4,3,0,7,"dummy"
"161165",3,4,0,7,"dummy"
"161206",0,4,0,4,"dummy"
"161281",0,1,0,1,"dummy"
"161282",0,3,0,3,"dummy"
"161285",0,1,0,1,"dummy"
"161286",0,0,1,1,"dummy"
"161287",0,0,1,1,"dummy"
"161288",0,4,3,7,"dummy"
"160981",1,2,0,3,"dummy"
"161000",0,0,1,1,"dummy"
"161001",0,1,0,1,"dummy"
"161002",0,3,0,3,"dummy"
"161003",0,6,0,6,"dummy"
"161004",2,5,0,7,"dummy"
"161005",0,1,0,1,"dummy"
"161006",0,0,1,1,"dummy"
"161011",6,0,0,6,"dummy"
"161012",0,1,0,1,"dummy"
"161013",0,1,0,1,"dummy"
"161014",1,1,0,2,"dummy"
"161015",0,1,0,1,"dummy"
"161016",0,1,0,1,"dummy"
"161017",4,0,1,5,"dummy"
"161018",1,1,3,5,"dummy"
"161032",0,0,1,1,"dummy"
"161033",1,1,0,2,"dummy"
"161036",0,4,0,4,"dummy"
"161037",2,4,0,6,"dummy"
"161038",4,2,0,6,"dummy"
"161039",0,1,0,1,"dummy"
"161043",17,30,3,50,"dummy"
"161044",0,0,2,2,"dummy"
"161045",0,2,0,2,"dummy"
"161070",0,0,0,0,"dummy"
"161071",0,1,0,1,"dummy"
"161072",0,0,1,1,"dummy"
"161073",1,0,1,2,"dummy"
"161074",0,1,0,1,"dummy"
"161075",0,0,1,1,"dummy"
"161076",0,0,0,0,"dummy"
"161079",0,0,0,0,"dummy"
"161080",0,0,1,1,"dummy"
"161120",2,13,1,16,"dummy"
"161121",5,2,2,9,"dummy"
"161122",0,0,1,1,"dummy"
"161123",2,0,0,2,"dummy"
"161124",4,0,1,5,"dummy"
"161125",0,0,1,1,"dummy"
"161126",0,0,1,1,"dummy"
"161127",3,7,4,14,"dummy"
"161146",0,35,1,36,"dummy"
"161147",1,7,0,8,"dummy"
"161148",1,2,0,3,"dummy"
"161149",0,0,1,1,"dummy"
"161150",1,6,0,7,"dummy"
"161151",1,2,0,3,"dummy"
"161152",3,5,1,9,"dummy"
"161153",0,0,1,1,"dummy"
"161170",1,3,0,4,"dummy"
"161171",0,0,1,1,"dummy"
"161172",2,1,1,4,"dummy"
"161173",0,0,1,1,"dummy"
"161174",0,3,0,3,"dummy"
"161175",4,5,0,9,"dummy"
"161176",0,0,1,1,"dummy"
"161177",1,2,0,3,"dummy"
"161178",0,0,1,1,"dummy"
"161179",0,0,1,1,"dummy"
"161180",0,0,1,1,"dummy"
"161181",0,4,1,5,"dummy"
"161182",0,0,1,1,"dummy"
"161183",1,0,0,1,"dummy"
"161184",0,2,0,2,"dummy"
"161185",0,1,0,1,"dummy"
"161186",2,3,1,6,"dummy"
"161187",0,0,1,1,"dummy"
"161188",0,2,0,2,"dummy"
"161189",0,0,1,1,"dummy"
"161190",0,0,1,1,"dummy"
"161191",0,0,2,2,"dummy"
"161194",0,0,3,3,"dummy"
"161197",0,0,1,1,"dummy"
"161212",0,8,1,9,"dummy"
"161213",1,3,0,4,"dummy"
"161216",0,3,0,3,"dummy"
"161217",0,1,0,1,"dummy"
"161218",0,4,0,4,"dummy"
"161219",0,3,1,4,"dummy"
"161220",0,1,0,1,"dummy"
"161221",0,2,0,2,"dummy"
"161222",0,1,0,1,"dummy"
"161223",0,1,1,2,"dummy"
"161224",2,8,0,10,"dummy"
"161225",0,1,0,1,"dummy"
"161226",0,3,0,3,"dummy"
"161227",0,2,0,2,"dummy"
"161228",0,0,1,1,"dummy"
"161229",0,2,0,2,"dummy"
"161230",0,0,1,1,"dummy"
"161231",0,0,1,1,"dummy"
"161232",1,3,0,4,"dummy"
"161233",0,3,0,3,"dummy"
"161234",0,1,0,1,"dummy"
"161235",0,2,0,2,"dummy"
"161236",0,14,0,14,"dummy"
"161237",0,0,0,0,"dummy"
"161238",14,0,0,14,"dummy"
"161239",0,1,0,1,"dummy"
"161240",0,3,0,3,"dummy"
"161241",0,1,0,1,"dummy"
"161242",2,0,4,6,"dummy"
"161243",0,1,0,1,"dummy"
"161244",3,3,0,6,"dummy"
"161245",0,1,0,1,"dummy"
"161246",0,2,0,2,"dummy"
"161247",0,0,4,4,"dummy"
"161248",0,0,1,1,"dummy"
"161249",0,1,0,1,"dummy"
"161250",2,5,1,8,"dummy"
"161251",0,0,1,1,"dummy"
"161252",3,4,1,8,"dummy"
"161253",3,0,0,3,"dummy"
"161254",0,6,0,6,"dummy"
"161255",0,3,0,3,"dummy"
"161256",3,0,0,3,"dummy"
"161257",0,2,0,2,"dummy"
"161258",0,0,1,1,"dummy"
"161259",0,0,1,1,"dummy"
"161260",6,7,4,17,"dummy"
"161261",0,0,1,1,"dummy"
"161262",3,0,0,3,"dummy"
"161263",0,5,0,5,"dummy"
"161264",0,4,0,4,"dummy"
"161265",0,0,1,1,"dummy"
"161266",0,1,0,1,"dummy"
"161267",0,1,0,1,"dummy"
"161268",0,0,1,1,"dummy"
"161269",0,1,0,1,"dummy"
"161270",0,0,1,1,"dummy"
"161271",4,4,0,8,"dummy"
"161272",1,1,2,4,"dummy"
"161273",1,2,0,3,"dummy"
"161274",0,1,0,1,"dummy"
"161275",0,0,1,1,"dummy"
"161276",0,0,1,1,"dummy"
"161277",0,0,1,1,"dummy"
"161278",0,2,0,2,"dummy"
"161279",0,1,0,1,"dummy"
"161310",1,9,0,10,"dummy"
"161311",1,2,2,5,"dummy"
"161312",2,1,3,6,"dummy"
"161313",0,4,0,4,"dummy"
"161314",0,0,2,2,"dummy"
"161315",0,0,1,1,"dummy"
"161329",0,0,1,1,"dummy"
"161330",7,6,0,13,"dummy"
"161331",0,1,0,1,"dummy"
"161332",1,13,0,14,"dummy"
"161333",0,0,2,2,"dummy"
"161334",0,4,0,4,"dummy"
"161335",0,1,0,1,"dummy"
"161336",2,6,0,8,"dummy"
"161337",0,5,0,5,"dummy"
"161338",3,3,0,6,"dummy"
"161339",0,0,0,0,"dummy"
"161340",17,24,2,43,"dummy"
"161341",4,1,0,5,"dummy"
"161363",0,2,0,2,"dummy"
"161364",1,8,1,10,"dummy"
"161365",0,0,1,1,"dummy"
"161366",1,3,0,4,"dummy"
"161367",0,0,2,2,"dummy"
"161368",1,0,0,1,"dummy"
"161369",0,0,0,0,"dummy"
"161370",9,2,0,11,"dummy"
"161373",1,0,0,1,"dummy"
"161394",2,0,3,5,"dummy"
"161552",0,0,3,3,"dummy"
"161553",0,1,0,1,"dummy"
"161556",1,4,1,6,"dummy"
"161289",4,5,0,9,"dummy"
"161290",0,6,1,7,"dummy"
"161291",0,1,0,1,"dummy"
"161292",0,0,1,1,"dummy"
"161293",1,7,0,8,"dummy"
"161294",0,0,1,1,"dummy"
"161295",0,1,0,1,"dummy"
"161296",0,0,1,1,"dummy"
"161297",0,1,0,1,"dummy"
"161298",0,0,1,1,"dummy"
"161299",0,0,0,0,"dummy"
"161300",0,0,0,0,"dummy"
"161301",1,3,0,4,"dummy"
"161302",0,0,0,0,"dummy"
"161303",0,3,0,3,"dummy"
"161304",0,1,1,2,"dummy"
"161305",0,0,0,0,"dummy"
"161306",0,0,1,1,"dummy"
"161307",0,0,0,0,"dummy"
"161308",0,0,1,1,"dummy"
"161317",0,5,0,5,"dummy"
"161318",0,0,1,1,"dummy"
"161319",6,4,2,12,"dummy"
"161320",0,1,0,1,"dummy"
"161321",0,1,0,1,"dummy"
"161322",0,1,0,1,"dummy"
"161323",1,0,0,1,"dummy"
"161324",0,0,1,1,"dummy"
"161325",2,4,6,12,"dummy"
"161326",0,1,0,1,"dummy"
"161327",5,10,3,18,"dummy"
"161352",0,0,0,0,"dummy"
"161353",2,3,0,5,"dummy"
"161354",0,2,0,2,"dummy"
"161355",3,0,0,3,"dummy"
"161356",0,0,0,0,"dummy"
"161357",2,0,0,2,"dummy"
"161358",0,0,2,2,"dummy"
"161359",0,0,1,1,"dummy"
"161360",1,0,0,1,"dummy"
"161361",0,0,0,0,"dummy"
"161375",3,2,1,6,"dummy"
"161376",2,0,0,2,"dummy"
"161377",6,4,3,13,"dummy"
"161378",2,8,0,10,"dummy"
"161379",1,2,1,4,"dummy"
"161380",0,1,0,1,"dummy"
"161381",0,1,0,1,"dummy"
"161382",1,0,0,1,"dummy"
"161548",2,3,1,6,"dummy"
"161549",0,1,0,1,"dummy"
"161550",0,0,1,1,"dummy"
"161564",1,0,0,1,"dummy"
"161565",2,0,1,3,"dummy"
"161566",0,0,0,0,"dummy"
"161567",0,1,0,1,"dummy"
"161568",8,1,0,9,"dummy"
"161569",0,0,0,0,"dummy"
"161570",0,0,0,0,"dummy"
"161571",1,10,0,11,"dummy"
"161572",7,1,0,8,"dummy"
"161573",0,0,1,1,"dummy"
"161574",2,0,3,5,"dummy"
"161583",0,2,0,2,"dummy"
"161602",0,1,0,1,"dummy"
"161603",0,2,0,2,"dummy"
"161617",8,16,4,28,"dummy"
"161618",11,3,3,17,"dummy"
"161621",0,1,0,1,"dummy"
"161642",0,0,0,0,"dummy"
"161650",0,1,0,1,"dummy"
"161651",0,4,0,4,"dummy"
"161652",1,1,0,2,"dummy"
"161656",3,46,5,54,"dummy"
"161657",3,18,6,27,"dummy"
"161557",25,3,5,33,"dummy"
"161558",0,0,1,1,"dummy"
"161559",0,0,1,1,"dummy"
"161560",1,0,0,1,"dummy"
"161561",0,1,0,1,"dummy"
"161562",0,0,1,1,"dummy"
"161576",0,1,0,1,"dummy"
"161577",0,1,0,1,"dummy"
"161578",0,1,0,1,"dummy"
"161579",0,1,1,2,"dummy"
"161580",0,0,1,1,"dummy"
"161581",2,5,3,10,"dummy"
"161605",0,0,1,1,"dummy"
"161613",0,0,1,1,"dummy"
"161614",0,0,1,1,"dummy"
"161615",0,0,1,1,"dummy"
"161648",0,0,4,4,"dummy"
"161654",0,4,0,4,"dummy"
"161659",0,3,0,3,"dummy"
"161660",0,1,0,1,"dummy"
"161661",4,20,0,24,"dummy"
"161662",1,3,0,4,"dummy"
"161663",16,0,2,18,"dummy"
"161664",0,1,0,1,"dummy"
"161665",0,8,2,10,"dummy"
"161666",0,0,1,1,"dummy"
"161667",0,0,1,1,"dummy"
"161670",0,3,0,3,"dummy"
"161671",0,0,2,2,"dummy"
"161681",0,2,0,2,"dummy"
"161698",0,1,0,1,"dummy"
"161699",0,2,0,2,"dummy"
"161700",0,0,2,2,"dummy"
"161701",0,1,0,1,"dummy"
"161726",0,0,2,2,"dummy"
"161735",1,1,2,4,"dummy"
"161738",1,0,0,1,"dummy"
"161759",8,3,0,11,"dummy"
"161764",0,0,1,1,"dummy"
"161783",0,1,4,5,"dummy"
"161799",0,1,0,1,"dummy"
"161800",0,0,1,1,"dummy"
"161801",0,0,3,3,"dummy"
"161802",0,0,1,1,"dummy"
"161803",0,0,1,1,"dummy"
"161804",0,0,2,2,"dummy"
"161805",0,0,1,1,"dummy"
"161806",0,0,1,1,"dummy"
"161815",1,0,0,1,"dummy"
"161820",0,1,0,1,"dummy"
"161821",0,1,2,3,"dummy"
"161822",0,1,1,2,"dummy"
"161823",2,2,0,4,"dummy"
"161824",0,2,0,2,"dummy"
"161825",0,0,1,1,"dummy"
"161826",1,0,1,2,"dummy"
"161832",0,0,1,1,"dummy"
"161673",14,12,1,27,"dummy"
"161674",0,0,1,1,"dummy"
"161675",0,0,2,2,"dummy"
"161676",6,7,0,13,"dummy"
"161677",4,0,1,5,"dummy"
"161678",0,0,0,0,"dummy"
"161679",0,2,0,2,"dummy"
"161683",0,1,0,1,"dummy"
"161684",0,3,0,3,"dummy"
"161687",1,0,0,1,"dummy"
"161688",0,2,0,2,"dummy"
"161703",7,17,0,24,"dummy"
"161722",0,2,1,3,"dummy"
"161723",0,4,0,4,"dummy"
"161724",0,1,0,1,"dummy"
"161728",0,0,0,0,"dummy"
"161729",0,16,0,16,"dummy"
"161730",0,0,0,0,"dummy"
"161731",5,5,2,12,"dummy"
"161732",21,3,0,24,"dummy"
"161733",1,0,0,1,"dummy"
"161740",0,2,0,2,"dummy"
"161741",3,8,2,13,"dummy"
"161742",0,0,1,1,"dummy"
"161743",2,1,0,3,"dummy"
"161744",0,1,1,2,"dummy"
"161745",1,0,4,5,"dummy"
"161750",0,4,0,4,"dummy"
"161751",0,0,3,3,"dummy"
"161752",0,2,3,5,"dummy"
"161753",0,1,1,2,"dummy"
"161754",3,8,0,11,"dummy"
"161755",3,1,0,4,"dummy"
"161761",1,0,0,1,"dummy"
"161762",1,6,0,7,"dummy"
"161766",0,0,1,1,"dummy"
"161769",1,0,0,1,"dummy"
"161785",0,0,3,3,"dummy"
"161786",0,3,0,3,"dummy"
"161787",0,0,0,0,"dummy"
"161788",0,0,4,4,"dummy"
"161791",4,9,3,16,"dummy"
"161792",1,0,0,1,"dummy"
"161793",1,0,0,1,"dummy"
"161796",0,0,0,0,"dummy"
"161797",0,0,0,0,"dummy"
"161808",0,16,0,16,"dummy"
"161809",2,1,0,3,"dummy"
"161810",0,5,1,6,"dummy"
"161811",0,3,0,3,"dummy"
"161830",1,0,0,1,"dummy"
"161870",0,0,0,0,"dummy"
"161871",0,0,1,1,"dummy"
"161872",0,0,0,0,"dummy"
"161833",1,9,1,11,"dummy"
"161834",0,0,1,1,"dummy"
"161835",1,0,0,1,"dummy"
"161839",0,1,1,2,"dummy"
"161840",1,1,2,4,"dummy"
"161841",1,1,1,3,"dummy"
"161842",13,5,0,18,"dummy"
"161843",0,1,0,1,"dummy"
"161846",0,1,2,3,"dummy"
"161847",0,0,0,0,"dummy"
"161848",0,2,0,2,"dummy"
"161849",5,0,2,7,"dummy"
"161850",1,0,0,1,"dummy"
"161874",0,1,0,1,"dummy"
"161877",0,1,0,1,"dummy"
"161878",1,1,0,2,"dummy"
"161883",0,0,2,2,"dummy"
"161885",0,1,0,1,"dummy"
"161888",1,1,0,2,"dummy"
"161889",0,0,1,1,"dummy"
"161891",2,1,0,3,"dummy"
"161892",1,0,0,1,"dummy"
"161893",1,0,0,1,"dummy"
"161894",0,0,1,1,"dummy"
"161906",1,1,0,2,"dummy"
"161907",1,1,0,2,"dummy"
"161908",0,1,0,1,"dummy"
"161910",0,4,0,4,"dummy"
"161911",0,0,1,1,"dummy"
"161914",0,0,1,1,"dummy"
"161916",0,0,2,2,"dummy"
"161917",1,6,0,7,"dummy"
"161922",0,19,0,19,"dummy"
"161923",17,1,0,18,"dummy"
"161929",0,0,1,1,"dummy"
"161930",0,0,1,1,"dummy"
"161931",0,0,1,1,"dummy"
"161932",0,3,0,3,"dummy"
"161933",5,1,1,7,"dummy"
"161934",0,0,1,1,"dummy"
"161959",7,3,2,12,"dummy"
"161960",0,0,0,0,"dummy"
"161963",0,0,1,1,"dummy"
"161964",0,0,0,0,"dummy"
"161965",0,0,1,1,"dummy"
"161979",4,5,3,12,"dummy"
"161980",2,0,3,5,"dummy"
"161981",3,0,1,4,"dummy"
"161985",1,0,0,1,"dummy"
"161986",1,0,0,1,"dummy"
"161987",0,0,1,1,"dummy"
"161989",3,3,0,6,"dummy"
"161990",0,0,1,1,"dummy"
"161991",0,0,1,1,"dummy"
"161992",0,0,1,1,"dummy"
"161993",0,1,0,1,"dummy"
"161994",5,9,3,17,"dummy"
"161995",0,2,1,3,"dummy"
"161998",1,0,0,1,"dummy"
"162002",0,1,0,1,"dummy"
"162003",1,4,1,6,"dummy"
"162004",7,7,0,14,"dummy"
"162005",1,3,0,4,"dummy"
"162009",0,0,1,1,"dummy"
"162011",0,3,0,3,"dummy"
"162013",0,1,0,1,"dummy"
"162017",2,2,0,4,"dummy"
"162050",0,3,0,3,"dummy"
"162051",3,2,0,5,"dummy"
"162054",1,6,0,7,"dummy"
"162055",0,4,4,8,"dummy"
"162057",0,0,1,1,"dummy"
"162062",2,5,2,9,"dummy"
"162064",4,0,0,4,"dummy"
"162068",0,1,1,2,"dummy"
"162069",2,0,0,2,"dummy"
"162071",1,0,0,1,"dummy"
"162080",2,4,1,7,"dummy"
"162106",8,9,1,18,"dummy"
"162107",0,2,0,2,"dummy"
"162108",0,1,0,1,"dummy"
"162109",1,2,0,3,"dummy"
"162112",0,0,1,1,"dummy"
"162113",0,0,0,0,"dummy"
"162116",1,4,0,5,"dummy"
"162117",0,0,0,0,"dummy"
"162119",1,0,0,1,"dummy"
"162120",1,0,0,1,"dummy"
"162121",6,7,10,23,"dummy"
"162122",3,1,5,9,"dummy"
"162124",0,0,1,1,"dummy"
"162125",1,2,0,3,"dummy"
"162126",0,1,0,1,"dummy"
"162127",1,7,0,8,"dummy"
"162128",5,0,0,5,"dummy"
"162129",0,2,0,2,"dummy"
"162130",0,1,0,1,"dummy"
"162131",0,2,0,2,"dummy"
"162132",0,0,0,0,"dummy"
"162133",0,0,0,0,"dummy"
"162134",0,0,0,0,"dummy"
"162136",1,8,0,9,"dummy"
"162164",0,4,1,5,"dummy"
"162166",1,2,0,3,"dummy"
"162167",2,2,0,4,"dummy"
"162168",3,3,2,8,"dummy"
"162169",0,0,1,1,"dummy"
"162170",0,0,0,0,"dummy"
"162171",0,0,0,0,"dummy"
"162174",0,0,1,1,"dummy"
"162175",0,0,1,1,"dummy"
"162176",0,2,1,3,"dummy"
"162177",0,0,1,1,"dummy"
"162178",0,2,0,2,"dummy"
"162179",0,4,0,4,"dummy"
"162180",7,2,5,14,"dummy"
"162181",2,0,0,2,"dummy"
"162182",4,10,1,15,"dummy"
"162185",0,0,2,2,"dummy"
"162188",0,0,1,1,"dummy"
"162191",0,4,0,4,"dummy"
"162192",0,4,0,4,"dummy"
"162193",0,3,4,7,"dummy"
"162194",0,0,0,0,"dummy"
"162195",0,0,0,0,"dummy"
"162196",0,8,0,8,"dummy"
"162197",8,0,0,8,"dummy"
"162199",1,0,0,1,"dummy"
"162200",2,12,0,14,"dummy"
"162203",10,1,1,12,"dummy"
"162204",1,10,0,11,"dummy"
"162208",4,7,0,11,"dummy"
"162209",2,2,0,4,"dummy"
"162210",0,1,0,1,"dummy"
"162211",0,1,0,1,"dummy"
"162212",1,2,0,3,"dummy"
"162213",0,1,0,1,"dummy"
"162214",0,1,0,1,"dummy"
"162215",0,0,0,0,"dummy"
"162225",0,0,2,2,"dummy"
"162226",0,0,1,1,"dummy"
"162220",3,1,1,5,"dummy"
"162221",0,1,0,1,"dummy"
"162222",0,0,1,1,"dummy"
"162223",0,6,0,6,"dummy"
"162229",3,1,3,7,"dummy"
"162231",0,0,0,0,"dummy"
"162232",9,13,3,25,"dummy"
"162233",12,4,3,19,"dummy"
"162235",0,1,1,2,"dummy"
"162236",0,1,0,1,"dummy"
"162237",0,0,2,2,"dummy"
"162239",0,0,1,1,"dummy"
"162241",3,0,3,6,"dummy"
"162242",0,4,3,7,"dummy"
"162243",0,1,0,1,"dummy"
"162246",1,0,0,1,"dummy"
"162249",4,0,2,6,"dummy"
"162250",5,0,1,6,"dummy"
"162251",0,0,1,1,"dummy"
"162252",0,0,1,1,"dummy"
"162253",0,0,1,1,"dummy"
"162257",0,1,0,1,"dummy"
"162258",0,1,0,1,"dummy"
"162259",0,4,0,4,"dummy"
"162260",0,2,0,2,"dummy"
"162261",5,5,0,10,"dummy"
"162286",2,0,1,3,"dummy"
"162287",0,2,1,3,"dummy"
"162288",2,0,1,3,"dummy"
"162298",1,0,0,1,"dummy"
"162443",7,7,1,15,"dummy"
"162444",0,1,0,1,"dummy"
"162452",0,2,0,2,"dummy"
"162453",0,1,0,1,"dummy"
"162463",0,0,5,5,"dummy"
"162487",0,2,0,2,"dummy"
"162488",0,1,0,1,"dummy"
"162489",1,0,0,1,"dummy"
"162496",0,0,0,0,"dummy"
"162497",0,1,0,1,"dummy"
"162498",3,2,0,5,"dummy"
"162499",0,13,0,13,"dummy"
"162500",0,0,7,7,"dummy"
"162501",0,0,1,1,"dummy"
"162502",0,0,1,1,"dummy"
"162503",0,0,1,1,"dummy"
"162504",37,22,0,59,"dummy"
"162505",4,1,0,5,"dummy"
"162506",0,1,0,1,"dummy"
"162511",0,1,0,1,"dummy"
"162512",1,0,0,1,"dummy"
"162513",1,2,0,3,"dummy"
"162514",1,0,0,1,"dummy"
"162515",3,8,2,13,"dummy"
"162516",1,0,0,1,"dummy"
"162517",0,5,1,6,"dummy"
"162518",4,9,2,15,"dummy"
"162519",4,3,1,8,"dummy"
"162520",2,2,0,4,"dummy"
"162526",0,0,1,1,"dummy"
"162532",0,5,0,5,"dummy"
"162533",0,1,0,1,"dummy"
"162565",0,5,0,5,"dummy"
"162566",1,3,0,4,"dummy"
"162567",1,0,0,1,"dummy"
"162568",3,0,0,3,"dummy"
"162576",0,0,1,1,"dummy"
"162577",0,2,1,3,"dummy"
"162602",2,1,0,3,"dummy"
"162603",1,2,1,4,"dummy"
"162604",0,0,0,0,"dummy"
"162605",0,2,1,3,"dummy"
"162606",0,1,0,1,"dummy"
"162607",1,0,1,2,"dummy"
"162608",4,10,1,15,"dummy"
"162609",0,3,0,3,"dummy"
"162610",0,1,0,1,"dummy"
"162611",2,0,0,2,"dummy"
"162615",2,4,0,6,"dummy"
"162616",0,2,0,2,"dummy"
"162617",0,2,0,2,"dummy"
"162618",10,2,0,12,"dummy"
"162619",0,2,0,2,"dummy"
"162620",0,0,0,0,"dummy"
"162621",0,0,3,3,"dummy"
"162263",0,1,1,2,"dummy"
"162266",0,1,0,1,"dummy"
"162267",0,3,0,3,"dummy"
"162268",0,1,0,1,"dummy"
"162271",0,1,0,1,"dummy"
"162272",0,2,0,2,"dummy"
"162273",0,0,0,0,"dummy"
"162290",1,0,0,1,"dummy"
"162434",0,0,0,0,"dummy"
"162437",0,6,0,6,"dummy"
"162438",0,2,0,2,"dummy"
"162439",16,4,3,23,"dummy"
"162440",0,2,0,2,"dummy"
"162441",0,4,1,5,"dummy"
"162446",0,1,0,1,"dummy"
"162447",0,0,1,1,"dummy"
"162448",1,5,0,6,"dummy"
"162449",1,3,0,4,"dummy"
"162450",0,2,0,2,"dummy"
"162457",0,1,0,1,"dummy"
"162458",0,0,1,1,"dummy"
"162461",1,0,0,1,"dummy"
"162475",1,6,7,14,"dummy"
"162476",0,0,2,2,"dummy"
"162477",0,0,2,2,"dummy"
"162478",0,2,2,4,"dummy"
"162481",0,0,3,3,"dummy"
"162482",0,0,3,3,"dummy"
"162483",0,0,2,2,"dummy"
"162494",0,0,0,0,"dummy"
"162508",0,1,0,1,"dummy"
"162509",0,2,0,2,"dummy"
"162524",0,0,0,0,"dummy"
"162528",0,0,1,1,"dummy"
"162535",3,5,0,8,"dummy"
"162561",7,15,3,25,"dummy"
"162562",0,1,0,1,"dummy"
"162563",17,5,6,28,"dummy"
"162597",0,2,0,2,"dummy"
"162598",7,7,7,21,"dummy"
"162599",9,18,0,27,"dummy"
"162600",0,2,0,2,"dummy"
"162613",0,1,0,1,"dummy"
"162625",3,0,2,5,"dummy"
"162632",0,1,0,1,"dummy"
"162647",0,2,0,2,"dummy"
"162648",1,2,1,4,"dummy"
"162670",13,2,1,16,"dummy"
"162681",0,0,1,1,"dummy"
"162682",0,1,0,1,"dummy"
"162683",11,1,1,13,"dummy"
"162687",0,0,2,2,"dummy"
"162688",0,0,1,1,"dummy"
"162689",0,0,2,2,"dummy"
"162690",0,2,1,3,"dummy"
"162691",1,2,0,3,"dummy"
"162692",12,39,0,51,"dummy"
"162693",2,3,0,5,"dummy"
"162700",0,0,1,1,"dummy"
"162701",0,0,1,1,"dummy"
"162702",0,0,1,1,"dummy"
"162706",2,5,1,8,"dummy"
"162707",0,1,1,2,"dummy"
"162708",4,3,2,9,"dummy"
"162709",2,3,4,9,"dummy"
"162710",3,3,3,9,"dummy"
"162711",0,1,2,3,"dummy"
"162714",0,1,0,1,"dummy"
"162715",0,4,1,5,"dummy"
"162716",1,1,1,3,"dummy"
"162719",0,0,1,1,"dummy"
"162720",0,4,0,4,"dummy"
"162721",0,3,2,5,"dummy"
"162724",0,0,1,1,"dummy"
"162735",1,0,0,1,"dummy"
"162738",0,0,0,0,"dummy"
"162776",0,0,1,1,"dummy"
"162781",0,0,4,4,"dummy"
"162782",0,0,4,4,"dummy"
"162783",0,0,4,4,"dummy"
"162784",0,0,4,4,"dummy"
"162785",0,0,4,4,"dummy"
"162786",0,0,4,4,"dummy"
"162787",0,0,4,4,"dummy"
"162788",0,0,4,4,"dummy"
"162791",0,1,0,1,"dummy"
"162808",0,1,1,2,"dummy"
"162809",1,1,2,4,"dummy"
"162810",0,0,1,1,"dummy"
"162819",1,1,0,2,"dummy"
"162820",2,3,1,6,"dummy"
"162826",2,0,1,3,"dummy"
"162827",0,0,1,1,"dummy"
"162840",0,2,0,2,"dummy"
"162870",0,0,0,0,"dummy"
"162873",0,0,1,1,"dummy"
"162878",0,1,3,4,"dummy"
"162622",0,5,0,5,"dummy"
"162623",1,0,1,2,"dummy"
"162627",0,0,1,1,"dummy"
"162628",0,0,1,1,"dummy"
"162629",7,1,0,8,"dummy"
"162630",0,0,0,0,"dummy"
"162634",1,0,0,1,"dummy"
"162635",0,0,1,1,"dummy"
"162638",1,0,0,1,"dummy"
"162652",0,1,0,1,"dummy"
"162653",0,2,0,2,"dummy"
"162654",0,0,1,1,"dummy"
"162655",0,1,0,1,"dummy"
"162656",4,3,0,7,"dummy"
"162657",0,2,2,4,"dummy"
"162660",0,0,1,1,"dummy"
"162667",8,2,1,11,"dummy"
"162668",0,1,0,1,"dummy"
"162726",0,44,0,44,"dummy"
"162727",34,68,0,102,"dummy"
"162728",0,2,1,3,"dummy"
"162729",34,4,1,39,"dummy"
"162730",2,5,0,7,"dummy"
"162731",4,1,0,5,"dummy"
"162732",51,9,2,62,"dummy"
"162733",15,5,3,23,"dummy"
"162742",0,0,1,1,"dummy"
"162743",0,2,1,3,"dummy"
"162744",0,5,1,6,"dummy"
"162745",0,0,1,1,"dummy"
"162746",0,0,0,0,"dummy"
"162747",0,2,1,3,"dummy"
"162748",16,1,3,20,"dummy"
"162749",1,18,3,22,"dummy"
"162750",0,0,1,1,"dummy"
"162751",0,1,0,1,"dummy"
"162752",0,0,1,1,"dummy"
"162753",4,0,0,4,"dummy"
"162754",0,1,0,1,"dummy"
"162755",0,1,0,1,"dummy"
"162756",3,3,1,7,"dummy"
"162757",7,6,2,15,"dummy"
"162758",4,2,1,7,"dummy"
"162759",3,3,1,7,"dummy"
"162760",2,2,1,5,"dummy"
"162761",0,5,0,5,"dummy"
"162762",0,1,0,1,"dummy"
"162763",5,0,1,6,"dummy"
"162764",0,6,1,7,"dummy"
"162765",8,2,2,12,"dummy"
"162766",0,1,0,1,"dummy"
"162767",1,0,0,1,"dummy"
"162768",16,1,1,18,"dummy"
"162769",0,0,1,1,"dummy"
"162770",0,0,1,1,"dummy"
"162771",0,0,1,1,"dummy"
"162772",0,0,1,1,"dummy"
"162773",0,0,2,2,"dummy"
"162774",0,0,1,1,"dummy"
"162793",0,0,2,2,"dummy"
"162794",0,2,2,4,"dummy"
"162797",19,2,0,21,"dummy"
"162798",0,0,2,2,"dummy"
"162799",0,4,0,4,"dummy"
"162800",0,2,0,2,"dummy"
"162801",0,9,0,9,"dummy"
"162802",0,2,4,6,"dummy"
"162803",0,0,0,0,"dummy"
"162804",5,9,1,15,"dummy"
"162805",0,2,0,2,"dummy"
"162806",0,2,0,2,"dummy"
"162812",0,2,0,2,"dummy"
"162815",0,2,0,2,"dummy"
"162816",0,2,0,2,"dummy"
"162817",0,0,0,0,"dummy"
"162822",4,21,3,28,"dummy"
"162829",0,1,0,1,"dummy"
"162834",0,0,0,0,"dummy"
"162835",5,0,2,7,"dummy"
"162836",0,0,0,0,"dummy"
"162842",1,1,0,2,"dummy"
"162843",0,0,0,0,"dummy"
"162844",0,1,0,1,"dummy"
"162845",3,1,5,9,"dummy"
"162853",1,1,1,3,"dummy"
"162863",34,26,5,65,"dummy"
"162868",1,4,1,6,"dummy"
"162880",1,1,1,3,"dummy"
"162881",12,0,1,13,"dummy"
"162890",0,0,1,1,"dummy"
"162903",0,0,1,1,"dummy"
"162904",0,0,1,1,"dummy"
"162905",0,0,1,1,"dummy"
"162906",0,1,1,2,"dummy"
"162907",0,0,1,1,"dummy"
"162908",0,1,0,1,"dummy"
"162911",0,1,0,1,"dummy"
"162912",0,0,0,0,"dummy"
"162913",4,4,0,8,"dummy"
"162923",1,0,0,1,"dummy"
"162924",1,4,0,5,"dummy"
"162930",2,0,0,2,"dummy"
"162933",0,1,0,1,"dummy"
"162947",0,0,0,0,"dummy"
"162950",0,0,0,0,"dummy"
"162953",3,2,2,7,"dummy"
"162954",0,0,1,1,"dummy"
"162955",0,1,0,1,"dummy"
"162956",1,0,0,1,"dummy"
"162957",0,1,0,1,"dummy"
"162958",1,1,0,2,"dummy"
"163015",2,15,1,18,"dummy"
"163016",4,4,1,9,"dummy"
"163017",0,1,0,1,"dummy"
"163018",0,0,2,2,"dummy"
"163019",2,0,2,4,"dummy"
"163020",0,0,1,1,"dummy"
"163021",0,0,1,1,"dummy"
"163022",1,4,0,5,"dummy"
"162915",0,0,0,0,"dummy"
"162916",0,1,0,1,"dummy"
"162917",0,0,1,1,"dummy"
"162918",0,0,1,1,"dummy"
"162919",0,0,0,0,"dummy"
"162920",0,0,0,0,"dummy"
"162921",0,2,1,3,"dummy"
"162928",0,1,0,1,"dummy"
"162960",2,2,1,5,"dummy"
"162961",3,3,0,6,"dummy"
"162988",0,2,0,2,"dummy"
"163027",0,0,0,0,"dummy"
"163028",5,3,1,9,"dummy"
"163029",2,2,1,5,"dummy"
"163030",2,2,1,5,"dummy"
"163032",0,4,0,4,"dummy"
"163033",0,1,0,1,"dummy"
"163037",0,0,1,1,"dummy"
"163038",0,0,0,0,"dummy"
"163039",0,0,0,0,"dummy"
"163040",0,1,0,1,"dummy"
"163042",0,25,1,26,"dummy"
"163043",2,2,0,4,"dummy"
"163044",0,1,2,3,"dummy"
"163047",0,0,1,1,"dummy"
"163051",4,6,0,10,"dummy"
"163052",0,1,1,2,"dummy"
"163053",2,3,2,7,"dummy"
"163054",0,1,0,1,"dummy"
"163055",0,0,1,1,"dummy"
"163056",0,0,1,1,"dummy"
"163061",0,1,0,1,"dummy"
"163062",0,0,1,1,"dummy"
"163063",1,0,1,2,"dummy"
"163064",0,0,1,1,"dummy"
"163075",0,0,1,1,"dummy"
"163076",0,0,1,1,"dummy"
"163077",0,0,1,1,"dummy"
"163078",0,0,1,1,"dummy"
"163082",0,2,0,2,"dummy"
"163085",0,0,0,0,"dummy"
"163087",0,0,2,2,"dummy"
"163089",0,0,0,0,"dummy"
"163090",0,0,0,0,"dummy"
"163098",0,0,1,1,"dummy"
"163099",0,0,2,2,"dummy"
"163100",0,0,1,1,"dummy"
"163101",15,25,3,43,"dummy"
"163102",0,0,1,1,"dummy"
"163103",0,0,2,2,"dummy"
"163104",4,0,3,7,"dummy"
"163106",1,2,0,3,"dummy"
"163107",0,1,0,1,"dummy"
"163108",0,1,1,2,"dummy"
"163112",2,0,0,2,"dummy"
"163125",0,0,1,1,"dummy"
"163126",1,2,1,4,"dummy"
"163127",3,3,7,13,"dummy"
"163129",0,0,0,0,"dummy"
"163130",0,14,1,15,"dummy"
"163191",0,0,2,2,"dummy"
"163192",1,4,2,7,"dummy"
"163193",1,0,2,3,"dummy"
"163194",1,3,0,4,"dummy"
"163195",1,8,0,9,"dummy"
"163196",1,5,4,10,"dummy"
"163197",3,3,0,6,"dummy"
"163198",0,1,0,1,"dummy"
"163199",0,1,0,1,"dummy"
"163201",30,0,2,32,"dummy"
"163202",0,3,0,3,"dummy"
"163203",2,0,1,3,"dummy"
"163204",1,0,0,1,"dummy"
"163205",0,1,1,2,"dummy"
"163233",6,0,0,6,"dummy"
"163234",2,5,2,9,"dummy"
"163236",3,2,2,7,"dummy"
"163237",1,2,0,3,"dummy"
"163238",0,2,0,2,"dummy"
"163239",0,0,2,2,"dummy"
"163240",0,0,1,1,"dummy"
"163241",0,0,0,0,"dummy"
"163242",2,4,0,6,"dummy"
"163243",0,11,3,14,"dummy"
"163244",0,1,1,2,"dummy"
"163245",0,0,1,1,"dummy"
"163246",11,0,1,12,"dummy"
"163248",0,1,0,1,"dummy"
"163249",0,0,4,4,"dummy"
"163252",0,8,2,10,"dummy"
"163254",0,6,0,6,"dummy"
"163256",1,0,1,2,"dummy"
"163257",0,0,3,3,"dummy"
"163258",0,0,1,1,"dummy"
"163259",0,0,2,2,"dummy"
"163260",1,0,0,1,"dummy"
"163262",1,2,0,3,"dummy"
"163263",0,1,0,1,"dummy"
"163264",2,1,1,4,"dummy"
"163265",1,3,0,4,"dummy"
"163266",3,19,0,22,"dummy"
"163267",0,1,0,1,"dummy"
"163268",12,0,2,14,"dummy"
"163269",2,3,0,5,"dummy"
"163270",4,3,0,7,"dummy"
"163271",1,1,0,2,"dummy"
"163272",0,0,1,1,"dummy"
"163273",0,2,0,2,"dummy"
"163274",0,0,1,1,"dummy"
"163275",0,1,0,1,"dummy"
"163276",0,1,0,1,"dummy"
"163286",0,0,1,1,"dummy"
"163287",0,1,0,1,"dummy"
"163288",0,0,1,1,"dummy"
"163290",1,0,0,1,"dummy"
"163291",0,1,2,3,"dummy"
"163293",0,2,0,2,"dummy"
"163296",0,2,0,2,"dummy"
"163297",2,5,0,7,"dummy"
"163298",0,1,0,1,"dummy"
"163299",0,1,1,2,"dummy"
"163302",1,1,0,2,"dummy"
"163303",0,0,0,0,"dummy"
"163306",2,1,5,8,"dummy"
"163307",0,1,1,2,"dummy"
"163311",0,0,0,0,"dummy"
"163314",0,6,2,8,"dummy"
"163315",0,0,1,1,"dummy"
"163316",0,0,1,1,"dummy"
"163317",5,0,0,5,"dummy"
"163318",0,0,1,1,"dummy"
"163319",0,0,1,1,"dummy"
"163323",1,3,1,5,"dummy"
"163325",6,0,1,7,"dummy"
"163326",3,12,1,16,"dummy"
"163327",0,0,1,1,"dummy"
"163328",2,1,0,3,"dummy"
"163330",0,1,0,1,"dummy"
"163332",0,0,1,1,"dummy"
"163335",0,3,0,3,"dummy"
"163336",0,1,0,1,"dummy"
"163337",0,1,0,1,"dummy"
"163340",13,0,1,14,"dummy"
"163341",0,2,0,2,"dummy"
"163342",0,2,0,2,"dummy"
"163343",0,4,0,4,"dummy"
"163344",0,0,1,1,"dummy"
"163345",0,1,0,1,"dummy"
"163346",0,0,0,0,"dummy"
"163347",0,2,0,2,"dummy"
"163348",1,0,0,1,"dummy"
"163349",0,3,0,3,"dummy"
"163351",0,4,0,4,"dummy"
"163352",2,2,0,4,"dummy"
"163353",0,8,0,8,"dummy"
"163354",0,1,1,2,"dummy"
"163355",0,1,0,1,"dummy"
"163356",0,0,1,1,"dummy"
"163358",0,12,0,12,"dummy"
"163360",6,6,2,14,"dummy"
"163361",0,0,1,1,"dummy"
"163363",0,0,1,1,"dummy"
"163364",3,4,0,7,"dummy"
"163365",0,2,0,2,"dummy"
"163366",0,1,0,1,"dummy"
"163367",0,2,0,2,"dummy"
"163368",0,0,0,0,"dummy"
"163369",0,0,0,0,"dummy"
"163371",0,0,0,0,"dummy"
"163373",5,4,5,14,"dummy"
"163376",4,0,0,4,"dummy"
"163379",0,1,0,1,"dummy"
"163380",0,14,1,15,"dummy"
"163381",0,1,0,1,"dummy"
"163382",9,4,7,20,"dummy"
"163383",3,1,1,5,"dummy"
"163384",3,0,0,3,"dummy"
"163386",0,1,0,1,"dummy"
"163388",0,1,1,2,"dummy"
"163389",0,1,0,1,"dummy"
"163394",0,3,1,4,"dummy"
"163395",8,18,2,28,"dummy"
"163396",0,0,1,1,"dummy"
"163401",0,1,0,1,"dummy"
"163402",0,0,1,1,"dummy"
"163404",2,0,0,2,"dummy"
"163405",3,4,2,9,"dummy"
"163406",0,1,0,1,"dummy"
"163407",0,0,1,1,"dummy"
"163423",0,0,2,2,"dummy"
"163424",0,3,0,3,"dummy"
"163425",3,0,0,3,"dummy"
"163426",8,2,0,10,"dummy"
"163430",0,0,2,2,"dummy"
"163431",0,3,0,3,"dummy"
"163432",3,1,0,4,"dummy"
"163437",1,0,1,2,"dummy"
"163438",0,0,1,1,"dummy"
"163447",0,1,0,1,"dummy"
"163448",0,2,0,2,"dummy"
"163449",0,2,2,4,"dummy"
"163452",0,2,0,2,"dummy"
"163455",0,0,3,3,"dummy"
"163456",0,0,1,1,"dummy"
"163457",0,3,1,4,"dummy"
"163458",2,2,0,4,"dummy"
"163459",2,3,0,5,"dummy"
"163460",2,2,0,4,"dummy"
"163461",2,0,1,3,"dummy"
"163462",21,0,0,21,"dummy"
"163464",2,12,0,14,"dummy"
"163465",0,1,0,1,"dummy"
"163470",1,0,0,1,"dummy"
"163471",0,1,1,2,"dummy"
"163473",0,2,0,2,"dummy"
"163474",0,1,0,1,"dummy"
"163475",0,0,1,1,"dummy"
"163480",0,10,2,12,"dummy"
"163481",1,0,0,1,"dummy"
"163482",18,8,5,31,"dummy"
"163510",0,0,1,1,"dummy"
"163511",0,0,1,1,"dummy"
"163512",0,0,0,0,"dummy"
"163513",2,0,0,2,"dummy"
"163517",22,0,2,24,"dummy"
"163518",0,2,0,2,"dummy"
"163519",0,1,0,1,"dummy"
"163521",2,1,0,3,"dummy"
"163522",2,6,3,11,"dummy"
"163523",3,5,2,10,"dummy"
"163524",1,0,0,1,"dummy"
"163528",0,0,0,0,"dummy"
"163529",0,0,0,0,"dummy"
"163530",0,0,0,0,"dummy"
"163531",0,7,0,7,"dummy"
"163532",0,0,0,0,"dummy"
"163534",0,1,0,1,"dummy"
"163540",0,0,0,0,"dummy"
"163542",1,4,0,5,"dummy"
"163544",0,0,0,0,"dummy"
"163546",0,0,1,1,"dummy"
"163548",0,0,2,2,"dummy"
"163554",0,1,0,1,"dummy"
"163555",2,0,0,2,"dummy"
"163556",0,0,1,1,"dummy"
"163557",3,4,3,10,"dummy"
"163562",0,5,1,6,"dummy"
"163563",0,1,0,1,"dummy"
"163565",5,7,0,12,"dummy"
"163566",0,1,0,1,"dummy"
"163567",0,1,0,1,"dummy"
"163568",0,0,1,1,"dummy"
"163570",0,2,0,2,"dummy"
"163571",0,2,0,2,"dummy"
"163572",0,0,1,1,"dummy"
"163573",0,0,1,1,"dummy"
"163574",0,0,1,1,"dummy"
"163577",11,4,5,20,"dummy"
"163579",0,1,1,2,"dummy"
"163580",4,3,5,12,"dummy"
"163581",0,5,0,5,"dummy"
"163585",0,1,1,2,"dummy"
"163587",0,1,0,1,"dummy"
"163588",14,15,7,36,"dummy"
"163589",0,0,1,1,"dummy"
"163590",8,5,4,17,"dummy"
"163621",0,0,1,1,"dummy"
"163622",0,0,1,1,"dummy"
"163623",0,0,2,2,"dummy"
"163624",26,3,7,36,"dummy"
"163626",0,2,0,2,"dummy"
"163627",3,3,0,6,"dummy"
"163629",0,0,0,0,"dummy"
"163630",11,0,0,11,"dummy"
"163631",1,8,0,9,"dummy"
"163632",4,11,0,15,"dummy"
"163633",7,0,0,7,"dummy"
"163635",2,2,2,6,"dummy"
"163636",4,6,2,12,"dummy"
"163637",0,3,0,3,"dummy"
"163638",3,3,0,6,"dummy"
"163639",5,1,0,6,"dummy"
"163640",1,0,0,1,"dummy"
"163642",0,2,0,2,"dummy"
"163643",0,1,0,1,"dummy"
"163645",0,1,0,1,"dummy"
"163646",0,2,0,2,"dummy"
"163647",0,1,0,1,"dummy"
"163648",1,0,0,1,"dummy"
"163651",12,10,1,23,"dummy"
"163652",0,1,0,1,"dummy"
"163653",1,3,0,4,"dummy"
"163654",0,2,3,5,"dummy"
"163655",0,1,0,1,"dummy"
"163656",0,1,0,1,"dummy"
"163657",0,1,0,1,"dummy"
"163658",0,1,0,1,"dummy"
"163659",0,1,0,1,"dummy"
"163660",0,1,0,1,"dummy"
"163661",0,5,0,5,"dummy"
"163662",0,5,0,5,"dummy"
"163663",0,2,0,2,"dummy"
"163664",0,1,0,1,"dummy"
"163665",0,2,2,4,"dummy"
"163666",0,1,0,1,"dummy"
"163667",0,0,0,0,"dummy"
"163668",3,4,0,7,"dummy"
"163669",6,4,9,19,"dummy"
"163670",0,7,0,7,"dummy"
"163671",1,0,4,5,"dummy"
"163672",0,1,1,2,"dummy"
"163673",0,1,0,1,"dummy"
"163693",0,1,1,2,"dummy"
"163694",1,12,1,14,"dummy"
"163697",0,0,0,0,"dummy"
"163698",3,14,0,17,"dummy"
"163699",14,3,0,17,"dummy"
"163700",0,0,0,0,"dummy"
"163701",1,0,0,1,"dummy"
"163726",0,0,1,1,"dummy"
"163727",0,1,0,1,"dummy"
"163733",0,0,2,2,"dummy"
"163734",0,2,0,2,"dummy"
"163735",1,0,0,1,"dummy"
"163741",2,1,1,4,"dummy"
"163742",0,0,2,2,"dummy"
"163743",1,0,0,1,"dummy"
"163755",0,3,0,3,"dummy"
"163761",0,1,1,2,"dummy"
"163762",0,0,0,0,"dummy"
"163763",0,0,1,1,"dummy"
"163777",1,0,0,1,"dummy"
"163778",3,5,0,8,"dummy"
"163779",0,0,0,0,"dummy"
"163807",6,0,3,9,"dummy"
"163810",6,0,0,6,"dummy"
"163811",2,5,2,9,"dummy"
"163814",2,2,1,5,"dummy"
"163815",0,2,0,2,"dummy"
"163816",4,4,2,10,"dummy"
"163866",0,0,1,1,"dummy"
"163873",8,14,2,24,"dummy"
"163874",4,0,0,4,"dummy"
"163890",6,7,2,15,"dummy"
"163891",0,1,0,1,"dummy"
"163892",0,0,0,0,"dummy"
"163893",2,3,0,5,"dummy"
"163894",1,0,0,1,"dummy"
"163897",0,0,1,1,"dummy"
"163898",2,0,0,2,"dummy"
"163899",0,0,1,1,"dummy"
"163900",2,4,0,6,"dummy"
"163901",0,7,0,7,"dummy"
"163902",8,0,0,8,"dummy"
"163903",0,0,1,1,"dummy"
"163904",0,0,1,1,"dummy"
"163905",0,1,0,1,"dummy"
"163906",0,0,1,1,"dummy"
"163907",0,0,1,1,"dummy"
"163690",6,0,1,7,"dummy"
"163691",0,0,0,0,"dummy"
"163729",2,0,3,5,"dummy"
"163737",6,3,0,9,"dummy"
"163745",0,1,0,1,"dummy"
"163752",2,2,0,4,"dummy"
"163753",0,2,0,2,"dummy"
"163767",1,0,0,1,"dummy"
"163768",0,0,1,1,"dummy"
"163769",0,0,2,2,"dummy"
"163770",1,1,1,3,"dummy"
"163771",0,0,1,1,"dummy"
"163772",5,5,1,11,"dummy"
"163773",0,1,0,1,"dummy"
"163774",0,0,1,1,"dummy"
"163775",0,2,0,2,"dummy"
"163781",0,3,1,4,"dummy"
"163782",3,1,0,4,"dummy"
"163783",0,0,1,1,"dummy"
"163784",1,0,0,1,"dummy"
"163789",0,0,1,1,"dummy"
"163790",0,0,1,1,"dummy"
"163791",0,0,2,2,"dummy"
"163792",0,0,2,2,"dummy"
"163793",0,2,2,4,"dummy"
"163798",0,1,0,1,"dummy"
"163799",0,1,0,1,"dummy"
"163800",0,1,0,1,"dummy"
"163801",0,1,0,1,"dummy"
"163802",0,0,0,0,"dummy"
"163803",0,1,0,1,"dummy"
"163804",0,0,0,0,"dummy"
"163805",4,1,0,5,"dummy"
"163818",0,2,1,3,"dummy"
"163821",0,3,1,4,"dummy"
"163822",0,0,1,1,"dummy"
"163823",0,0,0,0,"dummy"
"163824",3,0,1,4,"dummy"
"163825",0,0,1,1,"dummy"
"163826",0,0,1,1,"dummy"
"163829",0,0,1,1,"dummy"
"163838",0,0,0,0,"dummy"
"163839",0,0,0,0,"dummy"
"163842",2,1,0,3,"dummy"
"163843",1,2,0,3,"dummy"
"163844",2,1,0,3,"dummy"
"163845",1,2,0,3,"dummy"
"163868",1,13,0,14,"dummy"
"163869",0,0,1,1,"dummy"
"163870",0,1,0,1,"dummy"
"163871",0,1,0,1,"dummy"
"163876",0,1,0,1,"dummy"
"163877",0,0,0,0,"dummy"
"163878",1,4,0,5,"dummy"
"163879",0,1,1,2,"dummy"
"163880",0,0,1,1,"dummy"
"163881",0,2,0,2,"dummy"
"163882",0,1,0,1,"dummy"
"163885",0,0,1,1,"dummy"
"163886",5,8,4,17,"dummy"
"163887",0,0,0,0,"dummy"
"163888",0,0,0,0,"dummy"
"163920",3,4,2,9,"dummy"
"163928",0,0,0,0,"dummy"
"163929",0,0,0,0,"dummy"
"163930",0,9,0,9,"dummy"
"163922",1,0,0,1,"dummy"
"163923",0,1,0,1,"dummy"
"163926",0,0,0,0,"dummy"
"163935",4,6,2,12,"dummy"
"163942",0,0,1,1,"dummy"
"163943",0,0,1,1,"dummy"
"163944",0,0,1,1,"dummy"
"163945",0,0,1,1,"dummy"
"163946",0,0,1,1,"dummy"
"163947",0,5,1,6,"dummy"
"163948",1,2,1,4,"dummy"
"163949",1,0,0,1,"dummy"
"163950",0,0,1,1,"dummy"
"163951",0,0,1,1,"dummy"
"163952",0,1,0,1,"dummy"
"163953",0,0,1,1,"dummy"
"163954",0,1,0,1,"dummy"
"163955",1,0,0,1,"dummy"
"163956",0,1,0,1,"dummy"
"163957",0,1,0,1,"dummy"
"163958",0,0,2,2,"dummy"
"163959",0,0,1,1,"dummy"
"163960",2,6,1,9,"dummy"
"163963",0,0,2,2,"dummy"
"163964",0,0,2,2,"dummy"
"163990",0,1,0,1,"dummy"
"163991",0,0,0,0,"dummy"
"163992",0,1,1,2,"dummy"
"163993",0,1,0,1,"dummy"
"163994",0,0,0,0,"dummy"
"164006",1,0,2,3,"dummy"
"164053",0,2,0,2,"dummy"
"164061",0,0,4,4,"dummy"
"164066",2,16,2,20,"dummy"
"164067",2,2,0,4,"dummy"
"164068",0,2,0,2,"dummy"
"164094",0,2,0,2,"dummy"
"164095",5,1,0,6,"dummy"
"164096",2,0,0,2,"dummy"
"164099",0,1,0,1,"dummy"
"164100",0,4,0,4,"dummy"
"164101",0,4,1,5,"dummy"
"164102",0,1,0,1,"dummy"
"164103",0,0,1,1,"dummy"
"164104",1,1,0,2,"dummy"
"164105",0,1,2,3,"dummy"
"164114",0,1,0,1,"dummy"
"164115",0,1,0,1,"dummy"
"164116",0,3,0,3,"dummy"
"164117",0,0,1,1,"dummy"
"164118",0,0,1,1,"dummy"
"164121",0,0,0,0,"dummy"
"164122",2,2,0,4,"dummy"
"164123",1,0,0,1,"dummy"
"164124",0,1,1,2,"dummy"
"164125",2,2,0,4,"dummy"
"164133",0,0,0,0,"dummy"
"164136",0,0,1,1,"dummy"
"164137",0,1,0,1,"dummy"
"164138",0,1,0,1,"dummy"
"164139",2,4,0,6,"dummy"
"164140",0,1,0,1,"dummy"
"164141",0,0,1,1,"dummy"
"164142",4,0,0,4,"dummy"
"164143",1,1,1,3,"dummy"
"164144",0,0,1,1,"dummy"
"164145",0,0,1,1,"dummy"
"164164",0,0,1,1,"dummy"
"164179",4,1,0,5,"dummy"
"164180",2,3,0,5,"dummy"
"164185",3,3,1,7,"dummy"
"164186",0,1,0,1,"dummy"
"163933",0,2,0,2,"dummy"
"163966",0,4,0,4,"dummy"
"163967",0,3,0,3,"dummy"
"163970",0,2,0,2,"dummy"
"163971",0,3,1,4,"dummy"
"163972",0,5,0,5,"dummy"
"163973",0,1,0,1,"dummy"
"163974",1,12,0,13,"dummy"
"163975",0,2,0,2,"dummy"
"163976",0,0,0,0,"dummy"
"163977",0,1,0,1,"dummy"
"163978",0,4,0,4,"dummy"
"163979",0,1,0,1,"dummy"
"163980",0,0,0,0,"dummy"
"163981",4,18,1,23,"dummy"
"163982",0,0,3,3,"dummy"
"163983",4,5,0,9,"dummy"
"163984",0,1,1,2,"dummy"
"163985",3,3,0,6,"dummy"
"163986",14,12,3,29,"dummy"
"163987",0,1,0,1,"dummy"
"163988",0,1,0,1,"dummy"
"163998",1,6,0,7,"dummy"
"163999",0,0,1,1,"dummy"
"164000",1,0,0,1,"dummy"
"164001",0,2,0,2,"dummy"
"164002",1,3,1,5,"dummy"
"164003",5,0,4,9,"dummy"
"164004",0,0,1,1,"dummy"
"164008",5,4,0,9,"dummy"
"164009",0,0,0,0,"dummy"
"164010",0,0,2,2,"dummy"
"164011",4,4,0,8,"dummy"
"164012",0,0,1,1,"dummy"
"164013",0,0,1,1,"dummy"
"164014",1,1,2,4,"dummy"
"164015",0,0,1,1,"dummy"
"164035",3,1,1,5,"dummy"
"164036",1,0,0,1,"dummy"
"164037",0,1,0,1,"dummy"
"164038",0,1,0,1,"dummy"
"164039",0,0,0,0,"dummy"
"164040",0,0,2,2,"dummy"
"164041",2,2,0,4,"dummy"
"164042",0,0,6,6,"dummy"
"164043",0,0,3,3,"dummy"
"164044",0,0,0,0,"dummy"
"164051",0,0,1,1,"dummy"
"164070",0,2,0,2,"dummy"
"164071",2,0,0,2,"dummy"
"164072",0,7,0,7,"dummy"
"164073",0,1,0,1,"dummy"
"164074",0,1,0,1,"dummy"
"164075",0,1,0,1,"dummy"
"164076",1,0,0,1,"dummy"
"164077",0,1,0,1,"dummy"
"164078",1,0,0,1,"dummy"
"164079",0,1,0,1,"dummy"
"164080",1,0,0,1,"dummy"
"164081",0,1,0,1,"dummy"
"164082",1,0,0,1,"dummy"
"164083",1,3,0,4,"dummy"
"164084",7,1,0,8,"dummy"
"164085",0,0,3,3,"dummy"
"164086",0,1,0,1,"dummy"
"164087",1,2,0,3,"dummy"
"164088",1,0,0,1,"dummy"
"164089",0,0,0,0,"dummy"
"164090",2,2,1,5,"dummy"
"164091",0,0,2,2,"dummy"
"164092",0,0,1,1,"dummy"
"164127",0,3,0,3,"dummy"
"164128",0,1,1,2,"dummy"
"164129",0,1,0,1,"dummy"
"164147",3,0,0,3,"dummy"
"164148",0,1,0,1,"dummy"
"164166",1,1,0,2,"dummy"
"164169",0,7,0,7,"dummy"
"164170",0,0,1,1,"dummy"
"164171",0,4,0,4,"dummy"
"164182",0,0,1,1,"dummy"
"164183",0,0,1,1,"dummy"
"164196",0,4,0,4,"dummy"
"164197",1,10,0,11,"dummy"
"164198",0,1,0,1,"dummy"
"164205",3,4,0,7,"dummy"
"164206",13,3,0,16,"dummy"
"164211",5,1,0,6,"dummy"
"164221",0,0,1,1,"dummy"
"164222",2,12,2,16,"dummy"
"164223",0,0,1,1,"dummy"
"164224",0,6,0,6,"dummy"
"164229",0,0,1,1,"dummy"
"164230",0,2,0,2,"dummy"
"164231",0,3,0,3,"dummy"
"164232",0,0,0,0,"dummy"
"164233",0,4,0,4,"dummy"
"164234",0,0,1,1,"dummy"
"164235",2,0,0,2,"dummy"
"164236",8,0,0,8,"dummy"
"164237",2,0,0,2,"dummy"
"164238",0,2,0,2,"dummy"
"164245",21,11,0,32,"dummy"
"164246",0,1,0,1,"dummy"
"164247",0,1,0,1,"dummy"
"164294",1,1,0,2,"dummy"
"164295",0,0,1,1,"dummy"
"164191",0,1,0,1,"dummy"
"164192",2,1,1,4,"dummy"
"164213",0,1,0,1,"dummy"
"164214",0,0,1,1,"dummy"
"164215",0,0,0,0,"dummy"
"164226",1,2,1,4,"dummy"
"164227",1,2,1,4,"dummy"
"164240",0,0,1,1,"dummy"
"164241",3,2,1,6,"dummy"
"164242",10,9,2,21,"dummy"
"164243",2,1,1,4,"dummy"
"164271",1,0,0,1,"dummy"
"164272",0,0,1,1,"dummy"
"164273",2,0,0,2,"dummy"
"164274",0,0,1,1,"dummy"
"164275",0,1,0,1,"dummy"
"164276",0,2,0,2,"dummy"
"164277",0,0,0,0,"dummy"
"164278",2,1,0,3,"dummy"
"164279",1,0,0,1,"dummy"
"164280",0,0,0,0,"dummy"
"164281",0,0,0,0,"dummy"
"164282",0,0,0,0,"dummy"
"164301",0,1,0,1,"dummy"
"164303",0,9,2,11,"dummy"
"164304",0,0,1,1,"dummy"
"164306",0,2,4,6,"dummy"
"164307",0,0,2,2,"dummy"
"164309",0,0,1,1,"dummy"
"164310",0,0,1,1,"dummy"
"164311",0,0,1,1,"dummy"
"164313",2,0,0,2,"dummy"
"164314",1,0,0,1,"dummy"
"164315",0,0,1,1,"dummy"
"164319",1,0,1,2,"dummy"
"164324",0,8,0,8,"dummy"
"164325",0,1,1,2,"dummy"
"164328",2,3,3,8,"dummy"
"164329",1,0,0,1,"dummy"
"164335",0,0,0,0,"dummy"
"164339",1,5,2,8,"dummy"
"164343",0,0,1,1,"dummy"
"164344",0,1,0,1,"dummy"
"164345",1,1,0,2,"dummy"
"164346",4,9,0,13,"dummy"
"164347",0,1,0,1,"dummy"
"164348",3,3,0,6,"dummy"
"164349",12,2,2,16,"dummy"
"164351",0,22,0,22,"dummy"
"164352",0,2,0,2,"dummy"
"164353",0,0,1,1,"dummy"
"164354",0,0,1,1,"dummy"
"164355",0,2,0,2,"dummy"
"164357",1,0,0,1,"dummy"
"164359",0,0,1,1,"dummy"
"164361",0,0,2,2,"dummy"
"164362",0,0,1,1,"dummy"
"164363",0,0,2,2,"dummy"
"164364",0,0,1,1,"dummy"
"164365",0,0,2,2,"dummy"
"164366",0,0,1,1,"dummy"
"164367",6,3,1,10,"dummy"
"164368",0,0,2,2,"dummy"
"164370",0,1,0,1,"dummy"
"164371",0,1,0,1,"dummy"
"164372",1,0,0,1,"dummy"
"164398",1,0,2,3,"dummy"
"164400",0,1,0,1,"dummy"
"164402",0,3,0,3,"dummy"
"164403",0,0,1,1,"dummy"
"164404",3,2,5,10,"dummy"
"164406",2,2,2,6,"dummy"
"164407",7,3,5,15,"dummy"
"164409",0,0,1,1,"dummy"
"164411",0,2,0,2,"dummy"
"164412",0,0,1,1,"dummy"
"164413",0,0,1,1,"dummy"
"164414",0,2,1,3,"dummy"
"164415",7,2,2,11,"dummy"
"164418",0,1,0,1,"dummy"
"164419",3,3,2,8,"dummy"
"164423",0,1,1,2,"dummy"
"164424",1,6,0,7,"dummy"
"164426",0,0,2,2,"dummy"
"164430",0,0,0,0,"dummy"
"164431",0,0,1,1,"dummy"
"164472",0,0,0,0,"dummy"
"164473",0,0,0,0,"dummy"
"164474",0,0,0,0,"dummy"
"164475",0,0,0,0,"dummy"
"164476",0,0,0,0,"dummy"
"164477",0,0,0,0,"dummy"
"164479",0,0,0,0,"dummy"
"164480",0,0,0,0,"dummy"
"164482",0,3,1,4,"dummy"
"164483",0,1,0,1,"dummy"
"164486",1,4,0,5,"dummy"
"164487",4,9,3,16,"dummy"
"164490",0,0,2,2,"dummy"
"164491",0,0,1,1,"dummy"
"164495",2,5,2,9,"dummy"
"164499",1,2,0,3,"dummy"
"164501",3,3,1,7,"dummy"
"164503",0,5,0,5,"dummy"
"164505",2,0,3,5,"dummy"
"164506",1,0,0,1,"dummy"
"164507",0,1,0,1,"dummy"
"164508",0,1,1,2,"dummy"
"164516",0,1,0,1,"dummy"
"164519",0,0,1,1,"dummy"
"164520",0,0,1,1,"dummy"
"164521",0,0,2,2,"dummy"
"164522",0,1,0,1,"dummy"
"164523",0,0,1,1,"dummy"
"164524",0,0,1,1,"dummy"
"164525",0,0,1,1,"dummy"
"164526",0,0,1,1,"dummy"
"164527",0,0,1,1,"dummy"
"164528",0,0,1,1,"dummy"
"164529",0,0,1,1,"dummy"
"164532",0,1,0,1,"dummy"
"164535",0,0,1,1,"dummy"
"164538",0,1,0,1,"dummy"
"164540",0,0,1,1,"dummy"
"164543",2,2,4,8,"dummy"
"164545",0,2,0,2,"dummy"
"164546",0,2,0,2,"dummy"
"164547",0,1,0,1,"dummy"
"164551",6,4,2,12,"dummy"
"164554",2,0,3,5,"dummy"
"164557",0,0,1,1,"dummy"
"164561",0,3,2,5,"dummy"
"164562",3,1,1,5,"dummy"
"164563",0,0,2,2,"dummy"
"164564",1,0,2,3,"dummy"
"164567",0,0,1,1,"dummy"
"164568",0,0,2,2,"dummy"
"164569",0,4,1,5,"dummy"
"164570",0,3,0,3,"dummy"
"164571",1,4,1,6,"dummy"
"164572",6,0,0,6,"dummy"
"164573",4,10,2,16,"dummy"
"164574",0,2,0,2,"dummy"
"164575",0,0,1,1,"dummy"
"164576",0,6,0,6,"dummy"
"164577",0,1,0,1,"dummy"
"164578",1,2,0,3,"dummy"
"164579",0,2,0,2,"dummy"
"164580",0,0,2,2,"dummy"
"164581",20,2,3,25,"dummy"
"164582",0,1,0,1,"dummy"
"164584",0,0,1,1,"dummy"
"164586",22,5,2,29,"dummy"
"164587",5,22,2,29,"dummy"
"164588",3,1,0,4,"dummy"
"164589",19,4,2,25,"dummy"
"164592",0,1,0,1,"dummy"
"164593",0,0,1,1,"dummy"
"164594",1,0,0,1,"dummy"
"164596",2,0,0,2,"dummy"
"164597",0,0,3,3,"dummy"
"164598",12,18,4,34,"dummy"
"164602",0,7,0,7,"dummy"
"164604",0,1,0,1,"dummy"
"164605",0,0,1,1,"dummy"
"164608",2,2,2,6,"dummy"
"164609",1,1,0,2,"dummy"
"164610",4,4,0,8,"dummy"
"164611",7,3,0,10,"dummy"
"164612",1,1,0,2,"dummy"
"164613",0,0,1,1,"dummy"
"164614",1,1,0,2,"dummy"
"164615",1,1,0,2,"dummy"
"164616",1,0,1,2,"dummy"
"164617",1,0,1,2,"dummy"
"164618",0,0,1,1,"dummy"
"164621",0,0,1,1,"dummy"
"164623",2,0,0,2,"dummy"
"164624",0,0,3,3,"dummy"
"164626",1,0,2,3,"dummy"
"164627",9,0,0,9,"dummy"
"164628",0,3,0,3,"dummy"
"164629",1,0,0,1,"dummy"
"164630",0,1,0,1,"dummy"
"164631",1,1,0,2,"dummy"
"164632",1,0,1,2,"dummy"
"164637",0,0,0,0,"dummy"
"164638",0,0,0,0,"dummy"
"164639",0,0,0,0,"dummy"
"164640",0,0,0,0,"dummy"
"164641",0,0,1,1,"dummy"
"164643",0,1,0,1,"dummy"
"164646",0,2,0,2,"dummy"
"164647",1,5,0,6,"dummy"
"164648",0,2,0,2,"dummy"
"164649",0,0,1,1,"dummy"
"164650",1,10,0,11,"dummy"
"164652",0,2,0,2,"dummy"
"164653",2,4,0,6,"dummy"
"164654",0,2,0,2,"dummy"
"164656",0,0,4,4,"dummy"
"164658",0,1,1,2,"dummy"
"164660",0,0,1,1,"dummy"
"164661",0,0,1,1,"dummy"
"164662",0,0,1,1,"dummy"
"164663",0,0,1,1,"dummy"
"164735",0,0,1,1,"dummy"
"164737",0,0,0,0,"dummy"
"164738",0,0,0,0,"dummy"
"164739",0,0,0,0,"dummy"
"164741",0,4,4,8,"dummy"
"164742",4,2,1,7,"dummy"
"164743",0,0,1,1,"dummy"
"164744",0,0,2,2,"dummy"
"164745",0,0,1,1,"dummy"
"164746",0,0,1,1,"dummy"
"164747",0,0,1,1,"dummy"
"164748",0,0,6,6,"dummy"
"164749",0,1,1,2,"dummy"
"164750",0,0,1,1,"dummy"
"164751",0,0,2,2,"dummy"
"164752",0,0,1,1,"dummy"
"164753",0,0,1,1,"dummy"
"164754",0,0,1,1,"dummy"
"164756",0,0,1,1,"dummy"
"164757",7,11,4,22,"dummy"
"164758",0,0,2,2,"dummy"
"164759",5,0,4,9,"dummy"
"164760",0,5,6,11,"dummy"
"164761",5,0,4,9,"dummy"
"164762",0,2,1,3,"dummy"
"164766",2,0,3,5,"dummy"
"164767",1,0,0,1,"dummy"
"164768",0,1,0,1,"dummy"
"164769",0,1,1,2,"dummy"
"164771",0,1,0,1,"dummy"
"164776",0,0,2,2,"dummy"
"164778",0,0,0,0,"dummy"
"164779",0,0,0,0,"dummy"
"164780",0,0,1,1,"dummy"
"164781",0,0,1,1,"dummy"
"164787",0,0,1,1,"dummy"
"164789",6,0,0,6,"dummy"
"164790",2,5,2,9,"dummy"
"164792",1,0,2,3,"dummy"
"164793",1,3,1,5,"dummy"
"164794",0,2,1,3,"dummy"
"164795",1,0,0,1,"dummy"
"164796",3,0,0,3,"dummy"
"164803",2,0,2,4,"dummy"
"164812",10,10,2,22,"dummy"
"164813",0,2,0,2,"dummy"
"164814",3,6,1,10,"dummy"
"164816",0,0,0,0,"dummy"
"164817",0,0,0,0,"dummy"
"164818",0,0,0,0,"dummy"
"164819",0,0,0,0,"dummy"
"164820",0,0,0,0,"dummy"
"164821",0,0,0,0,"dummy"
"164823",0,0,1,1,"dummy"
"164826",0,0,1,1,"dummy"
"164830",0,3,0,3,"dummy"
"164831",0,0,1,1,"dummy"
"164834",0,1,1,2,"dummy"
"164835",0,0,1,1,"dummy"
"164838",0,4,1,5,"dummy"
"164839",0,1,0,1,"dummy"
"164841",0,1,0,1,"dummy"
"164843",4,2,1,7,"dummy"
"164867",0,0,1,1,"dummy"
"164868",0,0,1,1,"dummy"
"164869",0,0,1,1,"dummy"
"164870",2,4,1,7,"dummy"
"164871",0,0,1,1,"dummy"
"164872",0,0,1,1,"dummy"
"164873",0,0,1,1,"dummy"
"164874",0,0,1,1,"dummy"
"164875",0,0,1,1,"dummy"
"164876",8,8,1,17,"dummy"
"164877",0,0,1,1,"dummy"
"164878",0,0,1,1,"dummy"
"164879",0,0,1,1,"dummy"
"164881",0,15,1,16,"dummy"
"164884",0,0,0,0,"dummy"
"164885",0,0,0,0,"dummy"
"164886",0,0,0,0,"dummy"
"164887",0,0,0,0,"dummy"
"164888",0,2,0,2,"dummy"
"164889",1,0,0,1,"dummy"
"164890",0,0,0,0,"dummy"
"164891",0,5,0,5,"dummy"
"164893",0,1,0,1,"dummy"
"164894",0,0,1,1,"dummy"
"164895",0,0,1,1,"dummy"
"164896",0,4,3,7,"dummy"
"164897",4,5,0,9,"dummy"
"164898",0,6,1,7,"dummy"
"164899",0,1,0,1,"dummy"
"164900",0,0,1,1,"dummy"
"164901",1,7,0,8,"dummy"
"164902",0,0,1,1,"dummy"
"164903",0,1,0,1,"dummy"
"164904",0,0,1,1,"dummy"
"164905",0,1,0,1,"dummy"
"164915",2,1,0,3,"dummy"
"164916",0,0,1,1,"dummy"
"164917",0,5,0,5,"dummy"
"164919",0,0,1,1,"dummy"
"164920",0,0,1,1,"dummy"
"164922",0,0,1,1,"dummy"
"164923",0,0,1,1,"dummy"
"164924",0,0,2,2,"dummy"
"164925",26,3,7,36,"dummy"
"164927",0,1,0,1,"dummy"
"164928",1,0,0,1,"dummy"
"164929",0,2,0,2,"dummy"
"164930",0,0,1,1,"dummy"
"164931",4,4,0,8,"dummy"
"164933",9,0,5,14,"dummy"
"164935",4,0,0,4,"dummy"
"164960",4,2,0,6,"dummy"
"164961",0,0,1,1,"dummy"
"164967",10,0,0,10,"dummy"
"164968",3,2,1,6,"dummy"
"164969",0,1,0,1,"dummy"
"164972",0,4,2,6,"dummy"
"164973",0,5,1,6,"dummy"
"164974",1,0,0,1,"dummy"
"164975",0,15,0,15,"dummy"
"164983",0,1,0,1,"dummy"
"164984",0,2,0,2,"dummy"
"164985",0,0,1,1,"dummy"
"164986",4,3,0,7,"dummy"
"164992",0,9,3,12,"dummy"
"164993",0,0,1,1,"dummy"
"164994",2,2,2,6,"dummy"
"164995",0,0,0,0,"dummy"
"164996",0,0,0,0,"dummy"
"165000",0,0,1,1,"dummy"
"165003",0,1,0,1,"dummy"
"165004",0,0,1,1,"dummy"
"165016",2,10,1,13,"dummy"
"165017",4,8,4,16,"dummy"
"165018",0,1,1,2,"dummy"
"165019",0,4,0,4,"dummy"
"165020",19,4,1,24,"dummy"
"165021",0,0,1,1,"dummy"
"165022",16,3,1,20,"dummy"
"165029",29,21,5,55,"dummy"
"165030",0,1,0,1,"dummy"
"165031",0,0,2,2,"dummy"
"165032",0,0,1,1,"dummy"
"165033",3,13,3,19,"dummy"
"165034",6,1,0,7,"dummy"
"165035",0,0,1,1,"dummy"
"165036",1,0,0,1,"dummy"
"165040",0,0,0,0,"dummy"
"165041",1,0,0,1,"dummy"
"165042",0,0,1,1,"dummy"
"165043",2,3,0,5,"dummy"
"165044",0,0,1,1,"dummy"
"165045",0,0,0,0,"dummy"
"165046",4,1,0,5,"dummy"
"165047",1,0,0,1,"dummy"
"165048",0,0,0,0,"dummy"
"165049",0,0,0,0,"dummy"
"165073",7,0,2,9,"dummy"
"165075",0,0,3,3,"dummy"
"165076",1,1,0,2,"dummy"
"165077",0,1,0,1,"dummy"
"165078",1,0,0,1,"dummy"
"165087",0,0,1,1,"dummy"
"165088",2,2,1,5,"dummy"
"165089",1,0,2,3,"dummy"
"165090",0,0,1,1,"dummy"
"165091",0,0,1,1,"dummy"
"165092",0,0,1,1,"dummy"
"165093",0,0,1,1,"dummy"
"165094",0,0,1,1,"dummy"
"165095",0,0,0,0,"dummy"
"165097",0,2,0,2,"dummy"
"165098",0,0,3,3,"dummy"
"165099",0,1,0,1,"dummy"
"165101",0,3,0,3,"dummy"
"165102",0,0,0,0,"dummy"
"165104",1,14,0,15,"dummy"
"165105",7,8,0,15,"dummy"
"165106",0,3,0,3,"dummy"
"165107",1,1,0,2,"dummy"
"165108",4,9,1,14,"dummy"
"165109",14,10,7,31,"dummy"
"165111",0,0,1,1,"dummy"
"165112",1,6,2,9,"dummy"
"165113",1,0,0,1,"dummy"
"165114",0,4,2,6,"dummy"
"165115",6,10,3,19,"dummy"
"165119",8,2,2,12,"dummy"
"165120",4,19,0,23,"dummy"
"165122",0,3,3,6,"dummy"
"165124",0,1,0,1,"dummy"
"165129",0,2,1,3,"dummy"
"165130",0,4,0,4,"dummy"
"165132",1,4,2,7,"dummy"
"165133",0,0,0,0,"dummy"
"165134",2,6,1,9,"dummy"
"165135",1,1,1,3,"dummy"
"165136",0,1,0,1,"dummy"
"165137",1,4,1,6,"dummy"
"165138",0,1,4,5,"dummy"
"165140",1,0,0,1,"dummy"
"165141",1,1,0,2,"dummy"
"165142",0,1,0,1,"dummy"
"165143",0,1,0,1,"dummy"
"165144",0,0,1,1,"dummy"
"165145",0,1,1,2,"dummy"
"165146",0,0,1,1,"dummy"
"165147",0,0,3,3,"dummy"
"165148",0,0,1,1,"dummy"
"165150",0,2,0,2,"dummy"
"165151",0,0,1,1,"dummy"
"165152",0,0,1,1,"dummy"
"165158",0,1,2,3,"dummy"
"165169",2,0,1,3,"dummy"
"165170",0,0,0,0,"dummy"
"165171",8,1,1,10,"dummy"
"165174",5,4,6,15,"dummy"
"165175",1,0,2,3,"dummy"
"165176",2,0,1,3,"dummy"
"165177",0,0,1,1,"dummy"
"165178",4,8,8,20,"dummy"
"165179",0,0,0,0,"dummy"
"165180",9,2,1,12,"dummy"
"165181",0,0,1,1,"dummy"
"165182",0,3,0,3,"dummy"
"165183",0,3,0,3,"dummy"
"165184",12,14,1,27,"dummy"
"165185",0,0,1,1,"dummy"
"165186",0,0,1,1,"dummy"
"165187",1,2,0,3,"dummy"
"165188",3,2,2,7,"dummy"
"165189",0,6,0,6,"dummy"
"165190",0,2,0,2,"dummy"
"165191",0,0,0,0,"dummy"
"165192",1,0,1,2,"dummy"
"165193",0,4,0,4,"dummy"
"165194",0,3,0,3,"dummy"
"165197",5,2,1,8,"dummy"
"165198",0,0,1,1,"dummy"
"165199",4,6,0,10,"dummy"
"165200",0,0,1,1,"dummy"
"165201",2,2,0,4,"dummy"
"165204",0,3,0,3,"dummy"
"165205",0,0,1,1,"dummy"
"165206",6,6,0,12,"dummy"
"165210",0,1,0,1,"dummy"
"165211",0,0,1,1,"dummy"
"165218",0,0,4,4,"dummy"
"165221",0,2,0,2,"dummy"
"165222",3,1,0,4,"dummy"
"165223",3,0,0,3,"dummy"
"165228",0,0,1,1,"dummy"
"165229",0,2,1,3,"dummy"
"165230",0,0,1,1,"dummy"
"165231",0,0,2,2,"dummy"
"165232",0,0,0,0,"dummy"
"165233",0,0,1,1,"dummy"
"165234",0,0,0,0,"dummy"
"165235",0,0,4,4,"dummy"
"165236",0,1,0,1,"dummy"
"165237",11,3,0,14,"dummy"
"165238",0,0,1,1,"dummy"
"165239",1,0,0,1,"dummy"
"165240",3,12,3,18,"dummy"
"165251",0,1,0,1,"dummy"
"165252",1,5,0,6,"dummy"
"165253",0,1,0,1,"dummy"
"165255",0,0,1,1,"dummy"
"165268",0,0,1,1,"dummy"
"165269",0,0,1,1,"dummy"
"165270",0,3,0,3,"dummy"
"165272",0,0,0,0,"dummy"
"165274",0,2,0,2,"dummy"
"165275",0,1,0,1,"dummy"
"165276",0,4,0,4,"dummy"
"165277",0,1,0,1,"dummy"
"165278",0,5,0,5,"dummy"
"165279",0,1,0,1,"dummy"
"165280",0,1,0,1,"dummy"
"165281",7,0,0,7,"dummy"
"165282",0,1,0,1,"dummy"
"165284",0,0,0,0,"dummy"
"165285",0,0,0,0,"dummy"
"165287",0,2,0,2,"dummy"
"165289",18,1,0,19,"dummy"
"165290",0,0,1,1,"dummy"
"165293",0,0,1,1,"dummy"
"165294",0,0,1,1,"dummy"
"165296",0,1,0,1,"dummy"
"165298",0,1,0,1,"dummy"
"165299",2,3,1,6,"dummy"
"165300",7,0,0,7,"dummy"
"165301",1,1,0,2,"dummy"
"165302",0,0,1,1,"dummy"
"165303",0,0,1,1,"dummy"
"165304",0,2,1,3,"dummy"
"165305",0,1,0,1,"dummy"
"165306",0,1,0,1,"dummy"
"165307",0,0,0,0,"dummy"
"165310",8,1,0,9,"dummy"
"165312",0,0,0,0,"dummy"
"165316",3,0,0,3,"dummy"
"165317",0,0,0,0,"dummy"
"165318",6,3,1,10,"dummy"
"165319",0,5,0,5,"dummy"
"165320",2,0,0,2,"dummy"
"165321",4,0,0,4,"dummy"
"165322",0,0,0,0,"dummy"
"165323",2,3,0,5,"dummy"
"165324",1,0,0,1,"dummy"
"165343",0,0,2,2,"dummy"
"165344",0,0,1,1,"dummy"
"165346",1,0,0,1,"dummy"
"165348",1,2,0,3,"dummy"
"165349",1,1,0,2,"dummy"
"165351",0,0,0,0,"dummy"
"165352",0,0,1,1,"dummy"
"165354",3,3,0,6,"dummy"
"165355",3,5,0,8,"dummy"
"165368",0,1,0,1,"dummy"
"165371",0,1,1,2,"dummy"
"165372",7,4,3,14,"dummy"
"165373",1,8,4,13,"dummy"
"165374",0,0,6,6,"dummy"
"165375",3,5,0,8,"dummy"
"165382",0,0,1,1,"dummy"
"165383",0,2,0,2,"dummy"
"165385",0,0,1,1,"dummy"
"165386",0,0,1,1,"dummy"
"165387",0,1,0,1,"dummy"
"165388",1,0,0,1,"dummy"
"165389",0,0,1,1,"dummy"
"165391",0,6,0,6,"dummy"
"165392",4,13,2,19,"dummy"
"165395",0,1,2,3,"dummy"
"165397",1,0,4,5,"dummy"
"165398",3,4,1,8,"dummy"
"165411",0,0,2,2,"dummy"
"165412",1,0,0,1,"dummy"
"165413",0,1,0,1,"dummy"
"165414",0,0,1,1,"dummy"
"165415",0,1,0,1,"dummy"
"165416",0,1,0,1,"dummy"
"165418",0,0,0,0,"dummy"
"165419",0,0,0,0,"dummy"
"165424",0,0,0,0,"dummy"
"165425",0,1,0,1,"dummy"
"165427",0,0,1,1,"dummy"
"165428",0,2,0,2,"dummy"
"165429",2,1,0,3,"dummy"
"165430",1,1,3,5,"dummy"
"165431",0,0,1,1,"dummy"
"165432",0,1,0,1,"dummy"
"165433",0,0,2,2,"dummy"
"165434",1,0,1,2,"dummy"
"165436",0,1,0,1,"dummy"
"165437",0,1,0,1,"dummy"
"165438",0,1,0,1,"dummy"
"165445",3,4,4,11,"dummy"
"165446",0,0,1,1,"dummy"
"165447",1,8,4,13,"dummy"
"165448",33,0,2,35,"dummy"
"165449",0,2,0,2,"dummy"
"165450",0,0,1,1,"dummy"
"165452",8,6,0,14,"dummy"
"165453",1,0,0,1,"dummy"
"165454",4,1,0,5,"dummy"
"165455",11,2,3,16,"dummy"
"165456",0,3,0,3,"dummy"
"165458",3,3,2,8,"dummy"
"165460",4,4,1,9,"dummy"
"165461",0,3,0,3,"dummy"
"165462",4,1,0,5,"dummy"
"165463",0,0,0,0,"dummy"
"165465",0,1,0,1,"dummy"
"165466",4,5,0,9,"dummy"
"165467",0,1,0,1,"dummy"
"165468",0,7,0,7,"dummy"
"165471",0,1,0,1,"dummy"
"165472",0,0,1,1,"dummy"
"165474",0,1,0,1,"dummy"
"165475",6,2,1,9,"dummy"
"165476",1,0,0,1,"dummy"
"165477",1,0,0,1,"dummy"
"165478",0,0,3,3,"dummy"
"165479",1,0,2,3,"dummy"
"165480",0,0,1,1,"dummy"
"165482",0,3,0,3,"dummy"
"165483",0,0,0,0,"dummy"
"165484",0,1,0,1,"dummy"
"165485",0,1,1,2,"dummy"
"165486",1,0,0,1,"dummy"
"165487",1,0,0,1,"dummy"
"165490",0,3,0,3,"dummy"
"165491",0,2,0,2,"dummy"
"165492",0,2,0,2,"dummy"
"165494",2,0,0,2,"dummy"
"165495",2,1,0,3,"dummy"
"165520",0,0,0,0,"dummy"
"165521",1,0,0,1,"dummy"
"165522",0,0,1,1,"dummy"
"165523",2,0,0,2,"dummy"
"165524",0,0,1,1,"dummy"
"165525",0,1,0,1,"dummy"
"165526",0,2,0,2,"dummy"
"165530",1,3,0,4,"dummy"
"165531",1,1,0,2,"dummy"
"165532",0,4,1,5,"dummy"
"165533",0,0,1,1,"dummy"
"165534",4,0,1,5,"dummy"
"165535",1,4,0,5,"dummy"
"165537",0,1,0,1,"dummy"
"165544",1,0,1,2,"dummy"
"165545",0,2,1,3,"dummy"
"165546",0,0,0,0,"dummy"
"165547",0,0,1,1,"dummy"
"165550",0,4,0,4,"dummy"
"165552",0,0,1,1,"dummy"
"165553",0,3,0,3,"dummy"
"165554",0,0,1,1,"dummy"
"165555",0,0,1,1,"dummy"
"165556",0,0,1,1,"dummy"
"165557",0,0,1,1,"dummy"
"165577",0,0,1,1,"dummy"
"165578",0,0,1,1,"dummy"
"165580",0,0,0,0,"dummy"
"165581",0,1,0,1,"dummy"
"165582",1,0,0,1,"dummy"
"165583",0,0,0,0,"dummy"
"165584",0,0,0,0,"dummy"
"165585",0,1,0,1,"dummy"
"165586",0,1,0,1,"dummy"
"165587",0,0,0,0,"dummy"
"165588",0,0,0,0,"dummy"
"165589",0,0,0,0,"dummy"
"165590",0,1,0,1,"dummy"
"165591",0,0,0,0,"dummy"
"165592",0,0,0,0,"dummy"
"165593",0,0,0,0,"dummy"
"165601",0,7,1,8,"dummy"
"165603",3,3,1,7,"dummy"
"165604",3,3,0,6,"dummy"
"165605",0,0,3,3,"dummy"
"165608",0,0,2,2,"dummy"
"165611",0,2,0,2,"dummy"
"165612",0,11,2,13,"dummy"
"165616",1,17,0,18,"dummy"
"165639",0,1,0,1,"dummy"
"165640",1,3,1,5,"dummy"
"165642",2,0,0,2,"dummy"
"165670",0,0,1,1,"dummy"
"165671",0,0,1,1,"dummy"
"165673",0,0,2,2,"dummy"
"165675",0,0,2,2,"dummy"
"165676",2,2,0,4,"dummy"
"165677",2,4,1,7,"dummy"
"165678",4,0,3,7,"dummy"
"165684",2,7,0,9,"dummy"
"165687",2,2,0,4,"dummy"
"165688",0,0,0,0,"dummy"
"165694",0,1,0,1,"dummy"
"165695",0,0,1,1,"dummy"
"165696",0,0,1,1,"dummy"
"165699",1,2,0,3,"dummy"
"165700",3,9,0,12,"dummy"
"165701",17,1,0,18,"dummy"
"165702",1,18,0,19,"dummy"
"165703",0,1,1,2,"dummy"
"165704",0,0,0,0,"dummy"
"165705",17,1,0,18,"dummy"
"165706",1,0,0,1,"dummy"
"165707",0,0,0,0,"dummy"
"165708",0,1,1,2,"dummy"
"165709",2,2,0,4,"dummy"
"165710",2,3,0,5,"dummy"
"165711",0,0,1,1,"dummy"
"165712",2,2,0,4,"dummy"
"165713",0,1,0,1,"dummy"
"165714",0,3,1,4,"dummy"
"165715",3,5,2,10,"dummy"
"165716",2,2,1,5,"dummy"
"165717",0,1,0,1,"dummy"
"165718",0,1,0,1,"dummy"
"165719",4,1,0,5,"dummy"
"165720",1,1,1,3,"dummy"
"165721",2,5,2,9,"dummy"
"165722",0,0,1,1,"dummy"
"165723",5,2,1,8,"dummy"
"165724",5,2,1,8,"dummy"
"165725",12,6,0,18,"dummy"
"165726",0,0,0,0,"dummy"
"165727",0,0,0,0,"dummy"
"165728",0,0,0,0,"dummy"
"165729",0,11,0,11,"dummy"
"165730",0,1,0,1,"dummy"
"165731",3,6,0,9,"dummy"
"165732",0,1,0,1,"dummy"
"165733",0,2,0,2,"dummy"
"165734",0,0,1,1,"dummy"
"165735",0,1,0,1,"dummy"
"165736",0,1,0,1,"dummy"
"165737",0,4,0,4,"dummy"
"165738",3,4,0,7,"dummy"
"165743",1,4,1,6,"dummy"
"165746",0,0,0,0,"dummy"
"165747",8,1,1,10,"dummy"
"165748",0,1,0,1,"dummy"
"165749",0,2,0,2,"dummy"
"165750",0,2,0,2,"dummy"
"165751",5,5,0,10,"dummy"
"165752",1,0,0,1,"dummy"
"165753",0,3,0,3,"dummy"
"165754",1,0,1,2,"dummy"
"165755",0,5,0,5,"dummy"
"165756",3,0,0,3,"dummy"
"165757",0,1,0,1,"dummy"
"165758",1,0,1,2,"dummy"
"165759",0,3,0,3,"dummy"
"165760",0,0,1,1,"dummy"
"165761",3,3,4,10,"dummy"
"165762",18,15,4,37,"dummy"
"165763",2,0,0,2,"dummy"
"165764",2,2,0,4,"dummy"
"165765",0,1,1,2,"dummy"
"165766",0,1,0,1,"dummy"
"165768",7,2,1,10,"dummy"
"165770",2,2,2,6,"dummy"
"165771",0,2,0,2,"dummy"
"165773",0,2,0,2,"dummy"
"165774",0,0,0,0,"dummy"
"165775",0,0,0,0,"dummy"
"165776",0,0,1,1,"dummy"
"165777",0,0,1,1,"dummy"
"165779",3,1,1,5,"dummy"
"165780",1,0,0,1,"dummy"
"165782",2,0,1,3,"dummy"
"165793",0,0,2,2,"dummy"
"165794",7,6,0,13,"dummy"
"165796",6,1,0,7,"dummy"
"165797",2,2,0,4,"dummy"
"165800",0,1,0,1,"dummy"
"165802",0,0,0,0,"dummy"
"165803",0,0,0,0,"dummy"
"165804",0,0,0,0,"dummy"
"165805",0,0,0,0,"dummy"
"165809",2,8,1,11,"dummy"
"165810",1,0,0,1,"dummy"
"165811",0,2,1,3,"dummy"
"165812",0,3,0,3,"dummy"
"165813",0,1,2,3,"dummy"
"165814",0,1,0,1,"dummy"
"165815",0,0,3,3,"dummy"
"165816",0,3,0,3,"dummy"
"165817",4,0,0,4,"dummy"
"165818",0,2,0,2,"dummy"
"165819",2,4,1,7,"dummy"
"165820",1,0,0,1,"dummy"
"165821",1,2,0,3,"dummy"
"165822",1,2,0,3,"dummy"
"165823",0,2,0,2,"dummy"
"165824",12,14,2,28,"dummy"
"165825",0,3,0,3,"dummy"
"165826",0,2,0,2,"dummy"
"165827",0,2,0,2,"dummy"
"165828",0,1,0,1,"dummy"
"165833",1,2,1,4,"dummy"
"165834",0,0,1,1,"dummy"
"165836",0,5,0,5,"dummy"
"165839",0,0,1,1,"dummy"
"165840",0,0,2,2,"dummy"
"165841",0,0,1,1,"dummy"
"165843",0,0,1,1,"dummy"
"165845",6,13,3,22,"dummy"
"165850",0,1,0,1,"dummy"
"165852",3,2,0,5,"dummy"
"165853",0,0,1,1,"dummy"
"165855",4,0,0,4,"dummy"
"165856",0,2,0,2,"dummy"
"165857",0,0,1,1,"dummy"
"165858",1,1,0,2,"dummy"
"165859",0,3,0,3,"dummy"
"165860",5,0,0,5,"dummy"
"165861",0,6,0,6,"dummy"
"165862",1,0,1,2,"dummy"
"165863",0,1,0,1,"dummy"
"165865",1,2,2,5,"dummy"
"165871",1,3,0,4,"dummy"
"165872",0,2,0,2,"dummy"
"165873",2,8,2,12,"dummy"
"165874",2,3,1,6,"dummy"
"165875",0,0,2,2,"dummy"
"165876",1,2,0,3,"dummy"
"165877",3,0,2,5,"dummy"
"165878",3,2,2,7,"dummy"
"165879",0,1,0,1,"dummy"
"165880",2,3,0,5,"dummy"
"165885",0,1,0,1,"dummy"
"165888",16,0,2,18,"dummy"
"165889",0,7,0,7,"dummy"
"165890",0,1,1,2,"dummy"
"165891",4,1,0,5,"dummy"
"165892",1,0,1,2,"dummy"
"165893",0,1,0,1,"dummy"
"165894",0,1,0,1,"dummy"
"165895",1,1,0,2,"dummy"
"165896",0,0,1,1,"dummy"
"165897",0,2,1,3,"dummy"
"165898",0,1,0,1,"dummy"
"165899",5,2,0,7,"dummy"
"165900",4,2,1,7,"dummy"
"165901",0,0,1,1,"dummy"
"165902",2,3,2,7,"dummy"
"165903",1,1,0,2,"dummy"
"165905",0,2,0,2,"dummy"
"165906",0,0,0,0,"dummy"
"165907",0,0,1,1,"dummy"
"165908",11,1,0,12,"dummy"
"165909",0,0,1,1,"dummy"
"165910",0,0,1,1,"dummy"
"165911",0,0,0,0,"dummy"
"165912",0,0,0,0,"dummy"
"165913",0,0,1,1,"dummy"
"165914",0,0,1,1,"dummy"
"165915",0,0,1,1,"dummy"
"165916",0,0,0,0,"dummy"
"165917",0,0,0,0,"dummy"
"165918",0,0,0,0,"dummy"
"165919",0,0,0,0,"dummy"
"165920",0,2,0,2,"dummy"
"165921",2,0,0,2,"dummy"
"165922",0,2,0,2,"dummy"
"165923",1,3,0,4,"dummy"
"165924",3,1,0,4,"dummy"
"165925",1,3,0,4,"dummy"
"165926",0,0,1,1,"dummy"
"165927",0,0,1,1,"dummy"
"165928",0,0,1,1,"dummy"
"165929",0,0,1,1,"dummy"
"165930",0,0,1,1,"dummy"
"165935",0,2,3,5,"dummy"
"165936",0,2,0,2,"dummy"
"165939",2,0,0,2,"dummy"
"165940",0,0,1,1,"dummy"
"165945",0,1,1,2,"dummy"
"165948",0,1,0,1,"dummy"
"165949",0,1,0,1,"dummy"
"165950",0,0,1,1,"dummy"
"165951",0,1,1,2,"dummy"
"165952",0,0,1,1,"dummy"
"165953",0,0,3,3,"dummy"
"165954",0,0,1,1,"dummy"
"165957",0,0,0,0,"dummy"
"165958",0,2,0,2,"dummy"
"165959",31,59,4,94,"dummy"
"165960",0,7,0,7,"dummy"
"165971",2,1,1,4,"dummy"
"165972",3,0,2,5,"dummy"
"165973",2,0,0,2,"dummy"
"165974",2,1,0,3,"dummy"
"165975",2,0,0,2,"dummy"
"165976",3,2,1,6,"dummy"
"165977",0,0,1,1,"dummy"
"165978",0,0,1,1,"dummy"
"165979",1,0,0,1,"dummy"
"165980",0,2,0,2,"dummy"
"165981",0,0,0,0,"dummy"
"165982",1,0,0,1,"dummy"
"165983",0,2,0,2,"dummy"
"165984",1,0,0,1,"dummy"
"165985",2,0,0,2,"dummy"
"165986",0,0,0,0,"dummy"
"165987",0,0,0,0,"dummy"
"165993",0,0,0,0,"dummy"
"165994",1,15,0,16,"dummy"
"166009",0,27,0,27,"dummy"
"166025",0,0,0,0,"dummy"
"166026",0,0,0,0,"dummy"
"166039",0,8,0,8,"dummy"
"166042",0,0,1,1,"dummy"
"166043",0,0,1,1,"dummy"
"166044",4,6,2,12,"dummy"
"166045",6,3,0,9,"dummy"
"166046",0,2,0,2,"dummy"
"166047",1,0,0,1,"dummy"
"166048",0,0,1,1,"dummy"
"166049",1,3,0,4,"dummy"
"166050",1,3,0,4,"dummy"
"166051",0,0,0,0,"dummy"
"166052",0,0,0,0,"dummy"
"166053",1,2,0,3,"dummy"
"166054",0,2,0,2,"dummy"
"166055",0,0,0,0,"dummy"
"166056",0,1,1,2,"dummy"
"166057",0,1,1,2,"dummy"
"166058",5,0,0,5,"dummy"
"166059",0,2,0,2,"dummy"
"166060",1,1,0,2,"dummy"
"166061",6,16,1,23,"dummy"
"166062",10,17,2,29,"dummy"
"166063",0,1,1,2,"dummy"
"166064",2,8,0,10,"dummy"
"166065",0,1,0,1,"dummy"
"166066",0,5,0,5,"dummy"
"166067",4,2,0,6,"dummy"
"166068",8,3,0,11,"dummy"
"166069",0,1,0,1,"dummy"
"166070",0,2,0,2,"dummy"
"166071",0,1,0,1,"dummy"
"166072",1,0,2,3,"dummy"
"166073",1,0,0,1,"dummy"
"166074",0,0,1,1,"dummy"
"166075",4,0,0,4,"dummy"
"166076",0,6,1,7,"dummy"
"166077",0,2,0,2,"dummy"
"166078",1,0,0,1,"dummy"
"166079",0,2,1,3,"dummy"
"166090",0,0,3,3,"dummy"
"166091",3,2,0,5,"dummy"
"166092",0,2,0,2,"dummy"
"166093",0,1,0,1,"dummy"
"166094",1,2,0,3,"dummy"
"166095",0,1,0,1,"dummy"
"166098",19,1,3,23,"dummy"
"166099",0,7,3,10,"dummy"
"166100",5,14,0,19,"dummy"
"166109",0,0,1,1,"dummy"
"165942",1,3,3,7,"dummy"
"165943",1,0,0,1,"dummy"
"165989",0,2,0,2,"dummy"
"165990",0,0,2,2,"dummy"
"165991",0,3,0,3,"dummy"
"166001",0,0,1,1,"dummy"
"166002",0,1,2,3,"dummy"
"166003",3,1,0,4,"dummy"
"166004",0,0,1,1,"dummy"
"166005",0,0,1,1,"dummy"
"166006",3,2,1,6,"dummy"
"166007",0,0,1,1,"dummy"
"166032",0,0,0,0,"dummy"
"166033",0,0,0,0,"dummy"
"166034",0,1,0,1,"dummy"
"166035",0,0,1,1,"dummy"
"166102",0,0,1,1,"dummy"
"166105",1,13,0,14,"dummy"
"166106",1,1,1,3,"dummy"
"166107",11,1,2,14,"dummy"
"166115",0,1,0,1,"dummy"
"166116",5,0,2,7,"dummy"
"166117",0,0,1,1,"dummy"
"166120",2,4,0,6,"dummy"
"166121",0,1,1,2,"dummy"
"166122",0,6,0,6,"dummy"
"166130",0,8,0,8,"dummy"
"166131",1,1,0,2,"dummy"
"166132",1,0,0,1,"dummy"
"166133",0,0,2,2,"dummy"
"166134",0,0,1,1,"dummy"
"166141",4,7,0,11,"dummy"
"166158",0,1,0,1,"dummy"
"166159",2,0,0,2,"dummy"
"166166",1,0,0,1,"dummy"
"166167",0,4,0,4,"dummy"
"166170",0,3,0,3,"dummy"
"166171",0,2,1,3,"dummy"
"166172",0,0,0,0,"dummy"
"166173",0,0,0,0,"dummy"
"166196",0,0,0,0,"dummy"
"166197",5,11,1,17,"dummy"
"166198",5,5,1,11,"dummy"
"166199",0,3,1,4,"dummy"
"166200",1,0,1,2,"dummy"
"166201",2,2,1,5,"dummy"
"166202",2,2,1,5,"dummy"
"166203",6,0,1,7,"dummy"
"166204",2,2,0,4,"dummy"
"166205",2,7,0,9,"dummy"
"166206",0,1,4,5,"dummy"
"166207",1,0,1,2,"dummy"
"166208",0,0,2,2,"dummy"
"166209",0,0,2,2,"dummy"
"166210",3,0,0,3,"dummy"
"166211",0,1,0,1,"dummy"
"166212",0,0,1,1,"dummy"
"166213",0,0,1,1,"dummy"
"166214",0,0,1,1,"dummy"
"166215",0,0,6,6,"dummy"
"166216",0,0,7,7,"dummy"
"166217",0,0,1,1,"dummy"
"166218",0,0,2,2,"dummy"
"166219",0,0,0,0,"dummy"
"166220",0,0,0,0,"dummy"
"166365",8,3,3,14,"dummy"
"166110",0,0,1,1,"dummy"
"166111",1,1,3,5,"dummy"
"166112",1,1,3,5,"dummy"
"166113",1,3,3,7,"dummy"
"166138",0,1,0,1,"dummy"
"166139",0,1,0,1,"dummy"
"166161",0,4,0,4,"dummy"
"166162",0,0,1,1,"dummy"
"166175",0,3,1,4,"dummy"
"166176",2,0,1,3,"dummy"
"166177",0,5,1,6,"dummy"
"166178",3,1,0,4,"dummy"
"166179",0,2,1,3,"dummy"
"166182",0,0,1,1,"dummy"
"166187",3,8,2,13,"dummy"
"166188",0,4,2,6,"dummy"
"166189",5,19,0,24,"dummy"
"166190",23,1,0,24,"dummy"
"166191",0,3,3,6,"dummy"
"166192",1,0,0,1,"dummy"
"166193",0,1,0,1,"dummy"
"166194",4,0,2,6,"dummy"
"166361",0,1,1,2,"dummy"
"166383",1,0,1,2,"dummy"
"166384",1,2,0,3,"dummy"
"166385",0,0,1,1,"dummy"
"166390",0,3,0,3,"dummy"
"166391",2,3,1,6,"dummy"
"166392",0,1,0,1,"dummy"
"166393",0,1,0,1,"dummy"
"166408",0,1,0,1,"dummy"
"166409",0,0,1,1,"dummy"
"166419",0,2,0,2,"dummy"
"166420",0,2,0,2,"dummy"
"166421",16,19,2,37,"dummy"
"166422",0,0,1,1,"dummy"
"166423",0,0,2,2,"dummy"
"166424",2,0,2,4,"dummy"
"166425",0,11,3,14,"dummy"
"166426",0,3,2,5,"dummy"
"166431",1,0,2,3,"dummy"
"166432",0,1,2,3,"dummy"
"166433",0,1,0,1,"dummy"
"166434",0,0,1,1,"dummy"
"166435",0,0,3,3,"dummy"
"166436",0,0,2,2,"dummy"
"166437",0,0,5,5,"dummy"
"166438",2,3,1,6,"dummy"
"166462",0,3,0,3,"dummy"
"166463",0,1,0,1,"dummy"
"166507",0,1,0,1,"dummy"
"166510",1,0,0,1,"dummy"
"166511",3,2,1,6,"dummy"
"166512",0,0,1,1,"dummy"
"166569",0,0,1,1,"dummy"
"166570",0,0,1,1,"dummy"
"166571",0,0,1,1,"dummy"
"166577",3,0,0,3,"dummy"
"166578",2,2,0,4,"dummy"
"166579",0,0,1,1,"dummy"
"166589",0,0,1,1,"dummy"
"166590",0,0,3,3,"dummy"
"166594",0,8,0,8,"dummy"
"166595",0,0,1,1,"dummy"
"166603",0,1,0,1,"dummy"
"166604",0,1,0,1,"dummy"
"166366",0,1,0,1,"dummy"
"166367",7,5,1,13,"dummy"
"166368",12,9,2,23,"dummy"
"166369",0,1,1,2,"dummy"
"166370",0,1,1,2,"dummy"
"166371",1,0,0,1,"dummy"
"166372",0,2,0,2,"dummy"
"166373",0,0,2,2,"dummy"
"166376",0,0,0,0,"dummy"
"166377",2,0,2,4,"dummy"
"166378",4,6,2,12,"dummy"
"166379",0,0,0,0,"dummy"
"166380",0,2,0,2,"dummy"
"166381",0,3,0,3,"dummy"
"166387",0,1,0,1,"dummy"
"166388",0,0,1,1,"dummy"
"166397",0,1,0,1,"dummy"
"166398",2,2,1,5,"dummy"
"166399",0,2,0,2,"dummy"
"166402",4,12,2,18,"dummy"
"166403",1,2,0,3,"dummy"
"166404",2,6,0,8,"dummy"
"166405",0,0,1,1,"dummy"
"166406",5,5,0,10,"dummy"
"166411",0,1,0,1,"dummy"
"166412",1,1,0,2,"dummy"
"166415",5,4,3,12,"dummy"
"166416",0,0,2,2,"dummy"
"166417",0,0,2,2,"dummy"
"166428",2,8,2,12,"dummy"
"166429",2,2,1,5,"dummy"
"166440",0,0,2,2,"dummy"
"166441",0,0,0,0,"dummy"
"166442",0,0,0,0,"dummy"
"166443",0,0,2,2,"dummy"
"166444",0,0,2,2,"dummy"
"166445",0,0,1,1,"dummy"
"166446",0,0,2,2,"dummy"
"166470",0,1,0,1,"dummy"
"166471",0,1,1,2,"dummy"
"166472",0,1,0,1,"dummy"
"166473",0,2,0,2,"dummy"
"166474",0,3,0,3,"dummy"
"166475",0,18,0,18,"dummy"
"166476",3,3,0,6,"dummy"
"166477",4,5,0,9,"dummy"
"166478",2,2,0,4,"dummy"
"166479",3,3,1,7,"dummy"
"166480",0,0,1,1,"dummy"
"166481",2,2,0,4,"dummy"
"166482",2,2,0,4,"dummy"
"166483",3,3,1,7,"dummy"
"166484",4,8,0,12,"dummy"
"166485",0,0,1,1,"dummy"
"166486",0,0,1,1,"dummy"
"166487",0,0,1,1,"dummy"
"166488",0,0,1,1,"dummy"
"166489",0,0,1,1,"dummy"
"166494",0,1,0,1,"dummy"
"166499",0,2,0,2,"dummy"
"166504",0,0,1,1,"dummy"
"166505",1,0,0,1,"dummy"
"166522",0,1,0,1,"dummy"
"166523",1,5,0,6,"dummy"
"166524",0,2,0,2,"dummy"
"166525",2,2,2,6,"dummy"
"166539",0,2,0,2,"dummy"
"166540",3,3,2,8,"dummy"
"166541",0,0,0,0,"dummy"
"166542",0,2,0,2,"dummy"
"166543",1,0,0,1,"dummy"
"166546",0,0,0,0,"dummy"
"166547",0,0,1,1,"dummy"
"166548",1,2,0,3,"dummy"
"166549",3,1,0,4,"dummy"
"166550",0,0,0,0,"dummy"
"166555",0,0,1,1,"dummy"
"166556",0,0,3,3,"dummy"
"166557",4,10,0,14,"dummy"
"166560",0,7,0,7,"dummy"
"166575",2,1,0,3,"dummy"
"166583",0,7,0,7,"dummy"
"166584",1,10,3,14,"dummy"
"166585",0,1,0,1,"dummy"
"166586",0,6,0,6,"dummy"
"166587",7,0,0,7,"dummy"
"166592",0,0,0,0,"dummy"
"166606",0,1,0,1,"dummy"
"166607",0,0,1,1,"dummy"
"166608",0,2,0,2,"dummy"
"166609",0,0,1,1,"dummy"
"166610",0,1,0,1,"dummy"
"166611",0,0,1,1,"dummy"
"166616",0,0,1,1,"dummy"
"166617",1,0,1,2,"dummy"
"166618",0,1,0,1,"dummy"
"166632",12,2,2,16,"dummy"
"166633",0,1,0,1,"dummy"
"166638",0,0,3,3,"dummy"
"166686",0,0,1,1,"dummy"
"166689",3,0,1,4,"dummy"
"166692",0,0,2,2,"dummy"
"166699",0,0,1,1,"dummy"
"166702",0,1,0,1,"dummy"
"166703",0,1,0,1,"dummy"
"166704",0,0,1,1,"dummy"
"166705",0,0,1,1,"dummy"
"166710",0,0,0,0,"dummy"
"166714",0,0,1,1,"dummy"
"166715",0,0,1,1,"dummy"
"166716",0,0,1,1,"dummy"
"166721",0,0,1,1,"dummy"
"166742",0,3,0,3,"dummy"
"166743",0,7,0,7,"dummy"
"166744",12,15,0,27,"dummy"
"166745",0,1,0,1,"dummy"
"166752",0,6,0,6,"dummy"
"166753",1,0,0,1,"dummy"
"166754",6,0,1,7,"dummy"
"166755",1,0,0,1,"dummy"
"166756",0,0,0,0,"dummy"
"166757",0,0,1,1,"dummy"
"166779",27,12,3,42,"dummy"
"166780",0,1,0,1,"dummy"
"166620",0,1,0,1,"dummy"
"166630",3,6,2,11,"dummy"
"166635",2,11,0,13,"dummy"
"166636",1,1,1,3,"dummy"
"166640",0,8,0,8,"dummy"
"166645",0,0,1,1,"dummy"
"166648",0,2,0,2,"dummy"
"166649",1,5,0,6,"dummy"
"166655",0,9,0,9,"dummy"
"166656",0,1,0,1,"dummy"
"166672",0,2,0,2,"dummy"
"166673",0,0,1,1,"dummy"
"166674",0,1,0,1,"dummy"
"166675",0,0,1,1,"dummy"
"166676",0,1,0,1,"dummy"
"166677",0,0,0,0,"dummy"
"166678",1,0,0,1,"dummy"
"166679",0,1,0,1,"dummy"
"166680",0,1,0,1,"dummy"
"166681",0,1,0,1,"dummy"
"166682",0,2,0,2,"dummy"
"166712",0,0,1,1,"dummy"
"166723",1,3,0,4,"dummy"
"166724",7,5,1,13,"dummy"
"166725",1,3,0,4,"dummy"
"166736",0,1,0,1,"dummy"
"166737",0,1,0,1,"dummy"
"166738",0,1,0,1,"dummy"
"166739",0,0,2,2,"dummy"
"166740",0,0,1,1,"dummy"
"166761",0,0,1,1,"dummy"
"166839",0,1,0,1,"dummy"
"166856",0,1,0,1,"dummy"
"166857",0,15,1,16,"dummy"
"166858",0,0,0,0,"dummy"
"166859",3,5,2,10,"dummy"
"166860",3,8,4,15,"dummy"
"166861",0,0,1,1,"dummy"
"166862",0,0,1,1,"dummy"
"166863",0,4,1,5,"dummy"
"166869",0,1,0,1,"dummy"
"166870",0,1,0,1,"dummy"
"166871",0,2,0,2,"dummy"
"166873",1,1,0,2,"dummy"
"166874",0,1,0,1,"dummy"
"166875",1,0,0,1,"dummy"
"166878",2,3,0,5,"dummy"
"166879",0,1,0,1,"dummy"
"166881",0,3,0,3,"dummy"
"166883",1,0,0,1,"dummy"
"166886",0,0,1,1,"dummy"
"166887",1,8,2,11,"dummy"
"166888",0,6,0,6,"dummy"
"166889",0,2,0,2,"dummy"
"166890",1,7,1,9,"dummy"
"166891",0,1,1,2,"dummy"
"166892",1,4,2,7,"dummy"
"166894",0,0,2,2,"dummy"
"166895",0,0,1,1,"dummy"
"166898",2,9,1,12,"dummy"
"166899",2,0,1,3,"dummy"
"166900",1,0,0,1,"dummy"
"166909",3,4,3,10,"dummy"
"166911",3,0,0,3,"dummy"
"166913",4,0,0,4,"dummy"
"166914",7,3,0,10,"dummy"
"166915",0,0,1,1,"dummy"
"166916",0,0,1,1,"dummy"
"166917",1,0,1,2,"dummy"
"166920",0,1,0,1,"dummy"
"166927",0,1,0,1,"dummy"
"166928",0,2,0,2,"dummy"
"166929",0,2,0,2,"dummy"
"166930",0,1,0,1,"dummy"
"166931",0,0,1,1,"dummy"
"166932",1,0,0,1,"dummy"
"166933",12,10,3,25,"dummy"
"166934",1,0,0,1,"dummy"
"166936",0,4,0,4,"dummy"
"166937",1,2,0,3,"dummy"
"166938",0,1,0,1,"dummy"
"166939",0,0,1,1,"dummy"
"166940",9,0,0,9,"dummy"
"166944",0,0,1,1,"dummy"
"166945",0,1,0,1,"dummy"
"166946",9,4,5,18,"dummy"
"166949",0,0,0,0,"dummy"
"166950",0,0,0,0,"dummy"
"166952",0,3,0,3,"dummy"
"166953",1,0,0,1,"dummy"
"166955",5,3,2,10,"dummy"
"166956",3,4,1,8,"dummy"
"166957",0,6,0,6,"dummy"
"166958",1,0,0,1,"dummy"
"166959",7,1,1,9,"dummy"
"166961",0,2,0,2,"dummy"
"166962",1,1,0,2,"dummy"
"166963",0,1,0,1,"dummy"
"166965",0,1,0,1,"dummy"
"166966",0,1,0,1,"dummy"
"166967",3,2,1,6,"dummy"
"166972",0,1,0,1,"dummy"
"166973",0,1,0,1,"dummy"
"166974",2,2,0,4,"dummy"
"166975",0,2,1,3,"dummy"
"166976",1,0,0,1,"dummy"
"166977",0,0,0,0,"dummy"
"166978",0,1,0,1,"dummy"
"166979",0,1,0,1,"dummy"
"166980",1,0,0,1,"dummy"
"166981",0,1,0,1,"dummy"
"166985",0,0,1,1,"dummy"
"166990",1,0,0,1,"dummy"
"166991",2,0,1,3,"dummy"
"166992",0,0,0,0,"dummy"
"166993",0,1,0,1,"dummy"
"166994",8,1,0,9,"dummy"
"166995",0,0,0,0,"dummy"
"166996",0,0,0,0,"dummy"
"166997",1,10,0,11,"dummy"
"166998",7,1,0,8,"dummy"
"166999",2,0,3,5,"dummy"
"167002",0,1,0,1,"dummy"
"167003",0,1,0,1,"dummy"
"167004",1,9,0,10,"dummy"
"167005",0,0,1,1,"dummy"
"167006",2,2,1,5,"dummy"
"167007",0,1,0,1,"dummy"
"167008",0,0,0,0,"dummy"
"167010",1,3,0,4,"dummy"
"167011",3,0,0,3,"dummy"
"167014",11,18,4,33,"dummy"
"167015",3,0,0,3,"dummy"
"167016",3,1,3,7,"dummy"
"167017",0,0,2,2,"dummy"
"167018",0,0,0,0,"dummy"
"167019",2,50,1,53,"dummy"
"167020",18,14,13,45,"dummy"
"167021",14,6,1,21,"dummy"
"167022",0,1,0,1,"dummy"
"167023",0,0,0,0,"dummy"
"167024",0,0,0,0,"dummy"
"167025",0,2,0,2,"dummy"
"167026",0,0,1,1,"dummy"
"167027",0,1,0,1,"dummy"
"167028",0,0,0,0,"dummy"
"167029",0,1,0,1,"dummy"
"167030",0,0,0,0,"dummy"
"167032",6,0,0,6,"dummy"
"167034",0,1,3,4,"dummy"
"167035",0,0,1,1,"dummy"
"167036",0,0,0,0,"dummy"
"167037",0,1,3,4,"dummy"
"167038",0,0,3,3,"dummy"
"167039",0,1,0,1,"dummy"
"167041",0,0,2,2,"dummy"
"167042",0,1,0,1,"dummy"
"167043",3,3,1,7,"dummy"
"167044",0,1,0,1,"dummy"
"167045",0,1,0,1,"dummy"
"167046",0,4,1,5,"dummy"
"167047",1,2,1,4,"dummy"
"167048",0,1,0,1,"dummy"
"167049",0,1,0,1,"dummy"
"167050",33,11,5,49,"dummy"
"167054",0,1,1,2,"dummy"
"167055",2,1,1,4,"dummy"
"167056",1,2,2,5,"dummy"
"167057",0,0,1,1,"dummy"
"167058",1,2,1,4,"dummy"
"167059",1,0,0,1,"dummy"
"167060",0,2,0,2,"dummy"
"167061",3,1,0,4,"dummy"
"167062",0,1,0,1,"dummy"
"167063",1,1,1,3,"dummy"
"167065",0,0,1,1,"dummy"
"167066",0,0,0,0,"dummy"
"167068",0,1,0,1,"dummy"
"167070",5,0,2,7,"dummy"
"167071",0,0,1,1,"dummy"
"167073",5,6,0,11,"dummy"
"167077",0,0,0,0,"dummy"
"167080",0,0,1,1,"dummy"
"167082",2,0,0,2,"dummy"
"167083",0,0,0,0,"dummy"
"167086",0,0,1,1,"dummy"
"167087",0,7,0,7,"dummy"
"167088",5,0,0,5,"dummy"
"167089",1,13,0,14,"dummy"
"167090",13,6,0,19,"dummy"
"167091",1,13,0,14,"dummy"
"167092",0,0,1,1,"dummy"
"167093",0,5,0,5,"dummy"
"167094",5,0,1,6,"dummy"
"167095",0,0,1,1,"dummy"
"167096",0,0,1,1,"dummy"
"167097",0,5,0,5,"dummy"
"167098",1,1,1,3,"dummy"
"167099",0,0,3,3,"dummy"
"167100",4,5,3,12,"dummy"
"167101",0,0,3,3,"dummy"
"167102",17,16,1,34,"dummy"
"167103",0,0,2,2,"dummy"
"167104",0,0,1,1,"dummy"
"167105",0,0,1,1,"dummy"
"167106",1,0,0,1,"dummy"
"167107",0,0,1,1,"dummy"
"167108",0,0,3,3,"dummy"
"167109",7,4,0,11,"dummy"
"167110",1,3,0,4,"dummy"
"167111",0,0,1,1,"dummy"
"167112",7,1,0,8,"dummy"
"167113",0,0,0,0,"dummy"
"167114",6,8,2,16,"dummy"
"167115",0,0,0,0,"dummy"
"167116",0,0,1,1,"dummy"
"167117",0,0,0,0,"dummy"
"167118",8,6,0,14,"dummy"
"167119",12,12,0,24,"dummy"
"167120",0,0,0,0,"dummy"
"167121",0,1,0,1,"dummy"
"167122",17,17,0,34,"dummy"
"167123",0,0,0,0,"dummy"
"167124",0,0,0,0,"dummy"
"167125",0,0,0,0,"dummy"
"167126",0,3,1,4,"dummy"
"167139",0,2,0,2,"dummy"
"167140",0,1,0,1,"dummy"
"167141",1,0,0,1,"dummy"
"167142",0,0,1,1,"dummy"
"167143",3,0,0,3,"dummy"
"167144",6,3,0,9,"dummy"
"167145",0,2,0,2,"dummy"
"167146",1,1,0,2,"dummy"
"167147",0,0,0,0,"dummy"
"167148",0,0,1,1,"dummy"
"167149",0,0,0,0,"dummy"
"167150",0,0,1,1,"dummy"
"167151",0,0,0,0,"dummy"
"167152",0,2,0,2,"dummy"
"167153",0,0,1,1,"dummy"
"167154",0,0,1,1,"dummy"
"167155",0,0,1,1,"dummy"
"167156",0,0,0,0,"dummy"
"167157",0,0,1,1,"dummy"
"167158",0,0,1,1,"dummy"
"167159",0,0,1,1,"dummy"
"167160",0,0,0,0,"dummy"
"167165",0,0,1,1,"dummy"
"167166",0,2,0,2,"dummy"
"167167",2,1,0,3,"dummy"
"167168",1,3,1,5,"dummy"
"167169",1,1,0,2,"dummy"
"167170",1,1,0,2,"dummy"
"167171",0,2,0,2,"dummy"
"167217",0,9,0,9,"dummy"
"167218",0,1,0,1,"dummy"
"167219",4,4,0,8,"dummy"
"167228",0,3,1,4,"dummy"
"167229",1,1,0,2,"dummy"
"167230",1,2,1,4,"dummy"
"167231",0,1,0,1,"dummy"
"167232",0,4,0,4,"dummy"
"167233",0,0,1,1,"dummy"
"167234",2,9,0,11,"dummy"
"167235",0,5,0,5,"dummy"
"167236",0,2,0,2,"dummy"
"167237",2,4,0,6,"dummy"
"167238",0,0,0,0,"dummy"
"167241",0,1,0,1,"dummy"
"167242",0,0,0,0,"dummy"
"167249",3,1,6,10,"dummy"
"167250",2,0,0,2,"dummy"
"167253",1,0,0,1,"dummy"
"167254",2,3,0,5,"dummy"
"167255",3,2,0,5,"dummy"
"167256",0,1,0,1,"dummy"
"167257",2,1,0,3,"dummy"
"167258",0,1,0,1,"dummy"
"167266",0,0,0,0,"dummy"
"167267",0,1,3,4,"dummy"
"167270",1,0,0,1,"dummy"
"167274",0,0,1,1,"dummy"
"167275",0,0,1,1,"dummy"
"167276",0,0,1,1,"dummy"
"167277",0,0,1,1,"dummy"
"167278",0,0,1,1,"dummy"
"167279",0,0,1,1,"dummy"
"167280",0,0,1,1,"dummy"
"167281",0,0,1,1,"dummy"
"167282",0,0,1,1,"dummy"
"167283",0,0,1,1,"dummy"
"167162",2,2,1,5,"dummy"
"167163",3,4,0,7,"dummy"
"167183",0,0,1,1,"dummy"
"167184",0,0,1,1,"dummy"
"167185",0,0,1,1,"dummy"
"167214",0,2,0,2,"dummy"
"167215",0,0,0,0,"dummy"
"167221",0,5,2,7,"dummy"
"167222",4,3,0,7,"dummy"
"167223",0,1,0,1,"dummy"
"167224",3,5,5,13,"dummy"
"167225",0,1,0,1,"dummy"
"167226",1,0,0,1,"dummy"
"167246",0,0,0,0,"dummy"
"167247",0,0,0,0,"dummy"
"167260",0,3,0,3,"dummy"
"167261",10,3,3,16,"dummy"
"167262",4,2,2,8,"dummy"
"167272",0,1,0,1,"dummy"
"167449",0,0,3,3,"dummy"
"167452",0,0,2,2,"dummy"
"167453",0,0,2,2,"dummy"
"167454",0,0,1,1,"dummy"
"167483",0,1,0,1,"dummy"
"167484",1,1,0,2,"dummy"
"167485",0,1,0,1,"dummy"
"167492",0,0,1,1,"dummy"
"167500",0,1,0,1,"dummy"
"167501",2,7,2,11,"dummy"
"167502",0,1,1,2,"dummy"
"167503",1,0,1,2,"dummy"
"167507",0,1,0,1,"dummy"
"167546",0,0,3,3,"dummy"
"167547",2,8,3,13,"dummy"
"167548",0,4,0,4,"dummy"
"167549",1,1,0,2,"dummy"
"167550",0,1,0,1,"dummy"
"167551",1,4,0,5,"dummy"
"167573",2,7,0,9,"dummy"
"167574",1,1,0,2,"dummy"
"167575",7,3,0,10,"dummy"
"167576",0,0,1,1,"dummy"
"167577",4,17,1,22,"dummy"
"167578",0,0,2,2,"dummy"
"167579",0,0,1,1,"dummy"
"167580",0,7,0,7,"dummy"
"167588",1,0,0,1,"dummy"
"167608",6,1,1,8,"dummy"
"167609",2,2,0,4,"dummy"
"167624",1,0,1,2,"dummy"
"167284",0,0,1,1,"dummy"
"167285",0,0,1,1,"dummy"
"167286",0,0,1,1,"dummy"
"167287",0,0,1,1,"dummy"
"167288",0,0,1,1,"dummy"
"167289",0,0,1,1,"dummy"
"167290",0,0,1,1,"dummy"
"167291",0,0,1,1,"dummy"
"167292",0,0,1,1,"dummy"
"167293",0,0,1,1,"dummy"
"167294",0,0,1,1,"dummy"
"167295",0,0,1,1,"dummy"
"167296",0,0,1,1,"dummy"
"167297",0,0,1,1,"dummy"
"167298",0,0,1,1,"dummy"
"167299",0,0,1,1,"dummy"
"167300",0,0,1,1,"dummy"
"167301",0,0,1,1,"dummy"
"167302",0,0,1,1,"dummy"
"167303",0,0,1,1,"dummy"
"167304",0,0,1,1,"dummy"
"167305",0,0,1,1,"dummy"
"167306",0,0,1,1,"dummy"
"167307",0,0,1,1,"dummy"
"167308",0,0,1,1,"dummy"
"167309",0,0,1,1,"dummy"
"167310",0,0,1,1,"dummy"
"167311",0,0,1,1,"dummy"
"167312",0,0,1,1,"dummy"
"167313",0,0,1,1,"dummy"
"167314",0,0,1,1,"dummy"
"167315",0,0,1,1,"dummy"
"167316",0,0,1,1,"dummy"
"167317",0,0,1,1,"dummy"
"167318",0,0,1,1,"dummy"
"167319",0,0,1,1,"dummy"
"167320",0,0,1,1,"dummy"
"167321",0,0,1,1,"dummy"
"167322",0,0,1,1,"dummy"
"167323",0,0,1,1,"dummy"
"167324",0,0,1,1,"dummy"
"167325",0,0,1,1,"dummy"
"167326",0,0,1,1,"dummy"
"167327",0,0,1,1,"dummy"
"167328",0,0,1,1,"dummy"
"167329",0,0,1,1,"dummy"
"167330",0,0,1,1,"dummy"
"167331",0,0,1,1,"dummy"
"167332",0,0,1,1,"dummy"
"167333",0,0,1,1,"dummy"
"167334",0,0,1,1,"dummy"
"167335",0,0,1,1,"dummy"
"167336",0,0,1,1,"dummy"
"167337",0,0,1,1,"dummy"
"167338",0,0,1,1,"dummy"
"167339",0,0,1,1,"dummy"
"167340",0,0,1,1,"dummy"
"167341",0,0,1,1,"dummy"
"167342",0,0,1,1,"dummy"
"167343",0,0,1,1,"dummy"
"167344",0,0,1,1,"dummy"
"167345",0,0,1,1,"dummy"
"167346",0,0,1,1,"dummy"
"167347",0,0,1,1,"dummy"
"167348",0,0,1,1,"dummy"
"167349",0,0,1,1,"dummy"
"167350",0,0,1,1,"dummy"
"167351",0,0,1,1,"dummy"
"167352",0,0,1,1,"dummy"
"167353",0,0,1,1,"dummy"
"167354",0,0,1,1,"dummy"
"167355",0,0,1,1,"dummy"
"167356",0,0,1,1,"dummy"
"167357",0,0,1,1,"dummy"
"167358",0,0,1,1,"dummy"
"167359",0,0,1,1,"dummy"
"167360",0,0,1,1,"dummy"
"167361",0,0,1,1,"dummy"
"167362",0,0,1,1,"dummy"
"167363",0,0,1,1,"dummy"
"167364",0,0,1,1,"dummy"
"167365",0,0,1,1,"dummy"
"167366",0,0,1,1,"dummy"
"167367",0,0,1,1,"dummy"
"167368",0,0,1,1,"dummy"
"167369",0,0,1,1,"dummy"
"167370",0,0,1,1,"dummy"
"167371",0,0,1,1,"dummy"
"167372",0,0,1,1,"dummy"
"167373",0,0,1,1,"dummy"
"167374",0,0,1,1,"dummy"
"167375",0,0,1,1,"dummy"
"167376",0,0,1,1,"dummy"
"167377",0,0,1,1,"dummy"
"167378",0,0,1,1,"dummy"
"167379",0,0,1,1,"dummy"
"167380",0,0,1,1,"dummy"
"167381",0,0,1,1,"dummy"
"167382",0,0,1,1,"dummy"
"167383",0,0,1,1,"dummy"
"167384",0,0,1,1,"dummy"
"167385",0,0,1,1,"dummy"
"167386",0,0,1,1,"dummy"
"167387",0,0,1,1,"dummy"
"167388",0,0,1,1,"dummy"
"167389",0,0,1,1,"dummy"
"167390",0,0,1,1,"dummy"
"167391",0,0,1,1,"dummy"
"167392",0,0,1,1,"dummy"
"167393",0,0,1,1,"dummy"
"167394",0,0,1,1,"dummy"
"167395",0,2,0,2,"dummy"
"167396",2,0,2,4,"dummy"
"167397",0,0,1,1,"dummy"
"167400",0,2,0,2,"dummy"
"167401",0,2,0,2,"dummy"
"167402",0,1,0,1,"dummy"
"167403",0,3,0,3,"dummy"
"167404",4,8,0,12,"dummy"
"167405",1,0,1,2,"dummy"
"167406",0,1,0,1,"dummy"
"167407",0,1,0,1,"dummy"
"167408",0,9,0,9,"dummy"
"167409",0,1,0,1,"dummy"
"167410",0,2,0,2,"dummy"
"167411",0,1,0,1,"dummy"
"167412",4,1,0,5,"dummy"
"167431",1,2,1,4,"dummy"
"167432",1,6,3,10,"dummy"
"167433",0,1,0,1,"dummy"
"167438",1,0,0,1,"dummy"
"167441",4,11,3,18,"dummy"
"167442",10,0,2,12,"dummy"
"167447",0,0,0,0,"dummy"
"167462",0,0,1,1,"dummy"
"167463",0,0,2,2,"dummy"
"167464",0,0,2,2,"dummy"
"167465",2,0,4,6,"dummy"
"167466",0,0,4,4,"dummy"
"167467",0,0,1,1,"dummy"
"167478",0,7,0,7,"dummy"
"167481",0,0,1,1,"dummy"
"167505",0,0,0,0,"dummy"
"167532",1,0,0,1,"dummy"
"167533",0,1,0,1,"dummy"
"167534",0,1,1,2,"dummy"
"167535",0,8,1,9,"dummy"
"167536",0,2,1,3,"dummy"
"167537",2,5,0,7,"dummy"
"167538",0,0,1,1,"dummy"
"167539",1,0,0,1,"dummy"
"167540",0,1,0,1,"dummy"
"167541",4,2,0,6,"dummy"
"167542",0,1,2,3,"dummy"
"167543",1,2,0,3,"dummy"
"167544",0,1,1,2,"dummy"
"167553",0,0,1,1,"dummy"
"167554",0,0,1,1,"dummy"
"167555",0,0,1,1,"dummy"
"167556",0,0,1,1,"dummy"
"167582",3,0,0,3,"dummy"
"167592",0,1,0,1,"dummy"
"167593",1,4,3,8,"dummy"
"167594",0,1,0,1,"dummy"
"167595",0,1,0,1,"dummy"
"167596",0,1,1,2,"dummy"
"167597",0,1,1,2,"dummy"
"167598",0,1,0,1,"dummy"
"167601",0,3,1,4,"dummy"
"167602",0,1,0,1,"dummy"
"167603",2,0,0,2,"dummy"
"167604",0,2,0,2,"dummy"
"167611",0,4,0,4,"dummy"
"167612",0,2,0,2,"dummy"
"167613",1,0,0,1,"dummy"
"167620",0,0,0,0,"dummy"
"167621",2,0,0,2,"dummy"
"167622",0,0,1,1,"dummy"
"167626",0,2,0,2,"dummy"
"167627",0,10,0,10,"dummy"
"167633",0,0,0,0,"dummy"
"167634",11,4,2,17,"dummy"
"167635",1,0,2,3,"dummy"
"167641",0,0,1,1,"dummy"
"167642",0,13,0,13,"dummy"
"167643",0,1,0,1,"dummy"
"167649",1,1,0,2,"dummy"
"167659",0,2,2,4,"dummy"
"167660",2,0,2,4,"dummy"
"167661",0,0,0,0,"dummy"
"167662",0,2,0,2,"dummy"
"167663",0,0,2,2,"dummy"
"167664",0,0,1,1,"dummy"
"167665",0,0,1,1,"dummy"
"167668",7,1,0,8,"dummy"
"167712",0,2,2,4,"dummy"
"167713",1,3,0,4,"dummy"
"167758",1,86,3,90,"dummy"
"167764",2,0,3,5,"dummy"
"167765",0,0,3,3,"dummy"
"167766",2,1,5,8,"dummy"
"167767",1,5,0,6,"dummy"
"167768",2,4,1,7,"dummy"
"167769",0,0,3,3,"dummy"
"167770",3,0,1,4,"dummy"
"167771",0,0,0,0,"dummy"
"167772",4,1,3,8,"dummy"
"167773",0,1,0,1,"dummy"
"167774",0,1,0,1,"dummy"
"167775",0,0,1,1,"dummy"
"167776",0,0,3,3,"dummy"
"167777",0,0,4,4,"dummy"
"167778",0,3,1,4,"dummy"
"167779",1,0,0,1,"dummy"
"167780",0,3,0,3,"dummy"
"167781",10,11,0,21,"dummy"
"167782",0,0,0,0,"dummy"
"167783",3,3,0,6,"dummy"
"167784",0,0,3,3,"dummy"
"167785",0,1,0,1,"dummy"
"167786",1,3,0,4,"dummy"
"167787",0,1,0,1,"dummy"
"167788",3,7,0,10,"dummy"
"167789",0,1,0,1,"dummy"
"167790",1,2,0,3,"dummy"
"167791",1,1,1,3,"dummy"
"167792",1,1,0,2,"dummy"
"167793",0,0,1,1,"dummy"
"167794",0,0,1,1,"dummy"
"167795",2,2,0,4,"dummy"
"167796",0,1,0,1,"dummy"
"167797",0,1,0,1,"dummy"
"167798",1,7,2,10,"dummy"
"167799",0,0,0,0,"dummy"
"167800",1,4,1,6,"dummy"
"167801",3,0,0,3,"dummy"
"167802",5,5,0,10,"dummy"
"167803",0,0,1,1,"dummy"
"167804",0,0,7,7,"dummy"
"167805",0,0,3,3,"dummy"
"167806",0,0,3,3,"dummy"
"167814",2,1,0,3,"dummy"
"167815",0,0,0,0,"dummy"
"167816",1,0,1,2,"dummy"
"167819",0,0,1,1,"dummy"
"167631",0,0,2,2,"dummy"
"167639",2,5,2,9,"dummy"
"167647",6,3,1,10,"dummy"
"167670",0,0,1,1,"dummy"
"167671",1,8,3,12,"dummy"
"167676",5,7,0,12,"dummy"
"167677",2,3,2,7,"dummy"
"167680",0,0,2,2,"dummy"
"167681",0,0,2,2,"dummy"
"167696",0,0,0,0,"dummy"
"167709",0,0,1,1,"dummy"
"167710",0,4,3,7,"dummy"
"167715",0,2,0,2,"dummy"
"167716",0,1,2,3,"dummy"
"167717",0,8,1,9,"dummy"
"167718",0,2,0,2,"dummy"
"167719",2,0,0,2,"dummy"
"167720",0,2,0,2,"dummy"
"167721",0,2,0,2,"dummy"
"167722",0,1,0,1,"dummy"
"167723",1,0,0,1,"dummy"
"167724",12,4,1,17,"dummy"
"167725",0,0,4,4,"dummy"
"167726",2,8,2,12,"dummy"
"167727",1,0,0,1,"dummy"
"167728",0,0,0,0,"dummy"
"167729",1,1,0,2,"dummy"
"167730",1,0,0,1,"dummy"
"167731",0,0,4,4,"dummy"
"167732",0,0,4,4,"dummy"
"167733",0,0,4,4,"dummy"
"167734",0,0,4,4,"dummy"
"167735",0,6,0,6,"dummy"
"167738",4,4,0,8,"dummy"
"167739",0,4,0,4,"dummy"
"167740",0,0,1,1,"dummy"
"167741",3,1,0,4,"dummy"
"167742",0,1,1,2,"dummy"
"167743",4,6,1,11,"dummy"
"167744",0,5,0,5,"dummy"
"167745",0,0,1,1,"dummy"
"167746",0,0,1,1,"dummy"
"167747",0,1,0,1,"dummy"
"167760",2,6,0,8,"dummy"
"167761",20,0,0,20,"dummy"
"167762",0,20,0,20,"dummy"
"167810",0,1,0,1,"dummy"
"167891",4,0,0,4,"dummy"
"167892",0,2,0,2,"dummy"
"167893",0,0,1,1,"dummy"
"167894",0,0,1,1,"dummy"
"167895",0,0,1,1,"dummy"
"167896",0,2,0,2,"dummy"
"167897",2,0,0,2,"dummy"
"167898",0,0,1,1,"dummy"
"167899",2,7,0,9,"dummy"
"167900",0,0,1,1,"dummy"
"167901",1,0,0,1,"dummy"
"167902",2,13,0,15,"dummy"
"167903",4,2,0,6,"dummy"
"167904",2,1,0,3,"dummy"
"167905",10,2,0,12,"dummy"
"167906",3,4,0,7,"dummy"
"167907",2,1,0,3,"dummy"
"167908",3,4,0,7,"dummy"
"167909",0,2,0,2,"dummy"
"167910",1,1,0,2,"dummy"
"167911",2,0,1,3,"dummy"
"167912",0,1,0,1,"dummy"
"167913",0,1,0,1,"dummy"
"167914",1,3,0,4,"dummy"
"167915",0,1,0,1,"dummy"
"167916",0,1,0,1,"dummy"
"167920",2,0,0,2,"dummy"
"167921",0,0,1,1,"dummy"
"167922",0,0,1,1,"dummy"
"167925",0,7,0,7,"dummy"
"167824",0,0,1,1,"dummy"
"167825",0,7,3,10,"dummy"
"167828",0,0,1,1,"dummy"
"167829",0,0,1,1,"dummy"
"167832",2,1,0,3,"dummy"
"167833",0,2,0,2,"dummy"
"167834",0,0,1,1,"dummy"
"167835",0,2,0,2,"dummy"
"167836",1,1,0,2,"dummy"
"167837",0,0,1,1,"dummy"
"167838",0,1,0,1,"dummy"
"167839",0,1,0,1,"dummy"
"167840",0,3,0,3,"dummy"
"167841",2,2,0,4,"dummy"
"167842",0,1,0,1,"dummy"
"167843",0,0,0,0,"dummy"
"167844",0,1,0,1,"dummy"
"167845",0,2,0,2,"dummy"
"167846",4,4,0,8,"dummy"
"167847",0,1,0,1,"dummy"
"167848",0,8,0,8,"dummy"
"167849",0,1,0,1,"dummy"
"167850",1,7,0,8,"dummy"
"167851",7,7,8,22,"dummy"
"167852",0,7,0,7,"dummy"
"167853",0,3,0,3,"dummy"
"167854",1,0,0,1,"dummy"
"167855",0,1,0,1,"dummy"
"167856",0,2,0,2,"dummy"
"167857",1,1,0,2,"dummy"
"167858",0,6,0,6,"dummy"
"167859",1,6,3,10,"dummy"
"167860",10,4,0,14,"dummy"
"167861",0,0,0,0,"dummy"
"167862",0,1,0,1,"dummy"
"167863",2,3,0,5,"dummy"
"167864",2,0,0,2,"dummy"
"167865",0,0,0,0,"dummy"
"167866",14,13,2,29,"dummy"
"167867",1,1,0,2,"dummy"
"167868",0,3,0,3,"dummy"
"167869",1,0,1,2,"dummy"
"167870",0,0,0,0,"dummy"
"167871",0,0,1,1,"dummy"
"167872",0,0,1,1,"dummy"
"167873",0,1,0,1,"dummy"
"167874",0,2,0,2,"dummy"
"167875",0,0,1,1,"dummy"
"167876",2,0,1,3,"dummy"
"167877",0,0,0,0,"dummy"
"167888",6,0,0,6,"dummy"
"167889",2,5,2,9,"dummy"
"167918",0,0,2,2,"dummy"
"167927",5,0,1,6,"dummy"
"167930",0,0,1,1,"dummy"
"167931",0,1,0,1,"dummy"
"167932",0,1,0,1,"dummy"
"167933",0,0,1,1,"dummy"
"167996",6,0,1,7,"dummy"
"168004",0,14,0,14,"dummy"
"168005",3,1,2,6,"dummy"
"168006",0,0,1,1,"dummy"
"168007",0,2,3,5,"dummy"
"168008",0,0,2,2,"dummy"
"168017",0,0,0,0,"dummy"
"168018",0,0,6,6,"dummy"
"168035",0,1,0,1,"dummy"
"168036",1,1,5,7,"dummy"
"168037",8,0,2,10,"dummy"
"168038",0,0,1,1,"dummy"
"168041",2,2,3,7,"dummy"
"168042",4,9,4,17,"dummy"
"168043",0,0,3,3,"dummy"
"168000",0,1,0,1,"dummy"
"168020",0,0,0,0,"dummy"
"168021",0,2,0,2,"dummy"
"168022",0,1,0,1,"dummy"
"168023",0,1,0,1,"dummy"
"168024",4,4,0,8,"dummy"
"168025",0,5,0,5,"dummy"
"168026",5,3,1,9,"dummy"
"168027",0,5,0,5,"dummy"
"168028",4,0,0,4,"dummy"
"168029",0,0,2,2,"dummy"
"168030",0,1,0,1,"dummy"
"168033",0,4,0,4,"dummy"
"168045",0,0,1,1,"dummy"
"168046",0,0,1,1,"dummy"
"168052",0,3,1,4,"dummy"
"168055",4,1,0,5,"dummy"
"168056",4,2,0,6,"dummy"
"168057",2,0,0,2,"dummy"
"168062",0,0,0,0,"dummy"
"168069",4,0,2,6,"dummy"
"168077",0,1,0,1,"dummy"
"168078",1,0,1,2,"dummy"
"168084",0,0,1,1,"dummy"
"168085",0,0,3,3,"dummy"
"168086",0,0,1,1,"dummy"
"168087",0,0,1,1,"dummy"
"168108",2,4,0,6,"dummy"
"168109",0,1,0,1,"dummy"
"168135",1,0,3,4,"dummy"
"168147",0,0,0,0,"dummy"
"168148",0,0,1,1,"dummy"
"168149",1,0,1,2,"dummy"
"168153",1,2,0,3,"dummy"
"168154",0,0,1,1,"dummy"
"168157",0,8,0,8,"dummy"
"168158",0,3,0,3,"dummy"
"168159",0,1,0,1,"dummy"
"168176",12,0,0,12,"dummy"
"168177",0,0,0,0,"dummy"
"168178",1,1,1,3,"dummy"
"168212",1,1,0,2,"dummy"
"168305",0,2,0,2,"dummy"
"168309",0,1,0,1,"dummy"
"168310",0,15,0,15,"dummy"
"168311",0,1,0,1,"dummy"
"168312",0,0,1,1,"dummy"
"168315",0,0,1,1,"dummy"
"168316",0,0,1,1,"dummy"
"168317",0,0,2,2,"dummy"
"168318",26,3,7,36,"dummy"
"168333",0,0,0,0,"dummy"
"168334",0,0,0,0,"dummy"
"168354",0,1,1,2,"dummy"
"168355",1,0,0,1,"dummy"
"168356",0,0,1,1,"dummy"
"168357",0,0,1,1,"dummy"
"168358",0,0,1,1,"dummy"
"168359",0,0,1,1,"dummy"
"168360",0,0,1,1,"dummy"
"168048",1,6,2,9,"dummy"
"168049",6,4,0,10,"dummy"
"168050",1,0,1,2,"dummy"
"168059",0,1,0,1,"dummy"
"168060",0,1,0,1,"dummy"
"168066",0,0,1,1,"dummy"
"168067",0,1,2,3,"dummy"
"168071",0,1,0,1,"dummy"
"168074",1,0,0,1,"dummy"
"168075",9,6,0,15,"dummy"
"168091",0,1,0,1,"dummy"
"168092",0,2,0,2,"dummy"
"168093",1,0,0,1,"dummy"
"168094",4,17,0,21,"dummy"
"168095",12,6,0,18,"dummy"
"168096",0,1,0,1,"dummy"
"168097",0,0,1,1,"dummy"
"168098",0,0,2,2,"dummy"
"168099",1,3,0,4,"dummy"
"168100",8,7,0,15,"dummy"
"168101",0,1,0,1,"dummy"
"168102",0,0,1,1,"dummy"
"168103",0,1,0,1,"dummy"
"168104",0,1,0,1,"dummy"
"168105",3,0,0,3,"dummy"
"168106",0,5,0,5,"dummy"
"168111",0,5,0,5,"dummy"
"168112",0,0,1,1,"dummy"
"168113",0,1,1,2,"dummy"
"168114",2,3,1,6,"dummy"
"168115",0,0,1,1,"dummy"
"168116",2,1,0,3,"dummy"
"168117",0,1,0,1,"dummy"
"168118",2,2,1,5,"dummy"
"168119",4,5,0,9,"dummy"
"168120",0,0,1,1,"dummy"
"168121",2,2,1,5,"dummy"
"168122",2,2,0,4,"dummy"
"168123",0,0,1,1,"dummy"
"168124",0,0,1,1,"dummy"
"168125",0,1,2,3,"dummy"
"168126",0,0,2,2,"dummy"
"168127",0,0,2,2,"dummy"
"168132",0,4,4,8,"dummy"
"168133",2,2,1,5,"dummy"
"168137",12,12,5,29,"dummy"
"168138",1,0,3,4,"dummy"
"168139",0,3,0,3,"dummy"
"168140",1,2,0,3,"dummy"
"168141",0,0,2,2,"dummy"
"168142",0,0,1,1,"dummy"
"168143",2,11,5,18,"dummy"
"168144",1,2,0,3,"dummy"
"168145",1,2,0,3,"dummy"
"168151",0,1,3,4,"dummy"
"168161",1,1,0,2,"dummy"
"168182",1,1,0,2,"dummy"
"168183",1,1,0,2,"dummy"
"168184",1,1,0,2,"dummy"
"168185",0,1,0,1,"dummy"
"168188",0,4,0,4,"dummy"
"168189",0,0,1,1,"dummy"
"168190",5,6,2,13,"dummy"
"168191",0,0,1,1,"dummy"
"168207",0,1,0,1,"dummy"
"168208",1,0,0,1,"dummy"
"168290",0,0,1,1,"dummy"
"168291",0,1,1,2,"dummy"
"168292",0,0,1,1,"dummy"
"168293",0,0,1,1,"dummy"
"168294",0,0,1,1,"dummy"
"168295",1,1,0,2,"dummy"
"168296",0,1,2,3,"dummy"
"168297",0,0,1,1,"dummy"
"168298",0,1,0,1,"dummy"
"168299",0,0,1,1,"dummy"
"168300",0,0,1,1,"dummy"
"168303",0,1,1,2,"dummy"
"168307",2,2,0,4,"dummy"
"168320",0,0,1,1,"dummy"
"168321",0,0,1,1,"dummy"
"168322",0,0,1,1,"dummy"
"168323",0,0,1,1,"dummy"
"168324",0,0,1,1,"dummy"
"168325",0,0,1,1,"dummy"
"168326",0,0,1,1,"dummy"
"168327",0,0,1,1,"dummy"
"168328",0,0,1,1,"dummy"
"168329",0,0,1,1,"dummy"
"168344",0,1,2,3,"dummy"
"168345",3,4,4,11,"dummy"
"168346",0,2,0,2,"dummy"
"168347",0,0,3,3,"dummy"
"168348",0,1,3,4,"dummy"
"168349",0,2,0,2,"dummy"
"168350",0,2,0,2,"dummy"
"168403",4,3,0,7,"dummy"
"168404",0,0,1,1,"dummy"
"168361",0,1,0,1,"dummy"
"168362",0,2,0,2,"dummy"
"168363",0,1,3,4,"dummy"
"168364",0,0,1,1,"dummy"
"168365",0,2,0,2,"dummy"
"168366",0,0,1,1,"dummy"
"168367",0,0,1,1,"dummy"
"168368",0,0,1,1,"dummy"
"168369",0,0,1,1,"dummy"
"168370",0,0,1,1,"dummy"
"168371",0,0,1,1,"dummy"
"168372",0,0,1,1,"dummy"
"168373",0,0,1,1,"dummy"
"168374",0,0,1,1,"dummy"
"168375",0,0,1,1,"dummy"
"168376",0,0,1,1,"dummy"
"168377",0,0,1,1,"dummy"
"168378",0,0,1,1,"dummy"
"168379",1,4,2,7,"dummy"
"168380",5,1,4,10,"dummy"
"168381",0,0,1,1,"dummy"
"168382",0,0,1,1,"dummy"
"168383",3,0,0,3,"dummy"
"168384",0,1,0,1,"dummy"
"168385",0,0,1,1,"dummy"
"168386",0,0,1,1,"dummy"
"168387",0,0,1,1,"dummy"
"168388",0,0,1,1,"dummy"
"168389",0,0,1,1,"dummy"
"168390",0,0,1,1,"dummy"
"168391",0,0,1,1,"dummy"
"168392",2,1,1,4,"dummy"
"168393",0,0,1,1,"dummy"
"168394",0,0,1,1,"dummy"
"168395",0,0,1,1,"dummy"
"168396",0,0,1,1,"dummy"
"168397",0,0,1,1,"dummy"
"168423",2,4,2,8,"dummy"
"168427",1,0,0,1,"dummy"
"168428",7,9,2,18,"dummy"
"168429",0,1,0,1,"dummy"
"168430",0,1,0,1,"dummy"
"168432",0,1,0,1,"dummy"
"168433",0,1,0,1,"dummy"
"168434",2,2,0,4,"dummy"
"168435",2,2,0,4,"dummy"
"168436",0,0,1,1,"dummy"
"168440",1,0,0,1,"dummy"
"168442",1,1,0,2,"dummy"
"168444",0,0,0,0,"dummy"
"168446",0,3,0,3,"dummy"
"168447",3,0,1,4,"dummy"
"168452",1,1,0,2,"dummy"
"168454",4,6,2,12,"dummy"
"168455",7,11,1,19,"dummy"
"168458",0,1,0,1,"dummy"
"168459",1,4,0,5,"dummy"
"168460",0,0,1,1,"dummy"
"168461",1,1,0,2,"dummy"
"168464",1,7,0,8,"dummy"
"168467",0,0,1,1,"dummy"
"168468",0,0,1,1,"dummy"
"168469",0,0,2,2,"dummy"
"168470",0,0,1,1,"dummy"
"168473",16,3,0,19,"dummy"
"168475",0,0,1,1,"dummy"
"168477",4,0,0,4,"dummy"
"168478",0,0,0,0,"dummy"
"168479",0,0,1,1,"dummy"
"168490",2,9,0,11,"dummy"
"168491",2,2,0,4,"dummy"
"168492",0,0,0,0,"dummy"
"168493",0,0,2,2,"dummy"
"168494",0,0,0,0,"dummy"
"168495",0,0,0,0,"dummy"
"168497",0,1,2,3,"dummy"
"168498",0,0,0,0,"dummy"
"168499",0,1,0,1,"dummy"
"168500",4,0,2,6,"dummy"
"168501",1,0,0,1,"dummy"
"168502",0,0,0,0,"dummy"
"168503",0,0,0,0,"dummy"
"168506",2,3,1,6,"dummy"
"168507",3,2,0,5,"dummy"
"168508",2,0,0,2,"dummy"
"168510",6,0,0,6,"dummy"
"168511",2,5,2,9,"dummy"
"168514",0,2,0,2,"dummy"
"168515",0,0,0,0,"dummy"
"168516",1,0,0,1,"dummy"
"168517",5,5,0,10,"dummy"
"168518",0,0,0,0,"dummy"
"168521",0,0,0,0,"dummy"
"168522",0,0,2,2,"dummy"
"168528",0,0,1,1,"dummy"
"168529",0,2,0,2,"dummy"
"168530",0,1,0,1,"dummy"
"168534",0,3,0,3,"dummy"
"168535",0,0,1,1,"dummy"
"168536",2,10,1,13,"dummy"
"168537",1,1,0,2,"dummy"
"168538",5,8,1,14,"dummy"
"168539",6,5,3,14,"dummy"
"168540",0,3,0,3,"dummy"
"168541",3,0,0,3,"dummy"
"168542",0,4,3,7,"dummy"
"168543",14,1,1,16,"dummy"
"168544",12,7,1,20,"dummy"
"168545",0,0,1,1,"dummy"
"168546",0,0,1,1,"dummy"
"168547",0,0,1,1,"dummy"
"168548",1,0,0,1,"dummy"
"168549",8,1,1,10,"dummy"
"168550",2,12,1,15,"dummy"
"168551",0,1,0,1,"dummy"
"168552",3,1,1,5,"dummy"
"168553",0,1,0,1,"dummy"
"168554",4,7,0,11,"dummy"
"168555",1,2,1,4,"dummy"
"168557",1,0,1,2,"dummy"
"168558",2,0,0,2,"dummy"
"168562",4,0,0,4,"dummy"
"168619",0,0,1,1,"dummy"
"168621",0,1,0,1,"dummy"
"168623",0,0,0,0,"dummy"
"168631",1,0,0,1,"dummy"
"168632",0,7,0,7,"dummy"
"168633",0,0,0,0,"dummy"
"168634",0,1,0,1,"dummy"
"168635",0,0,1,1,"dummy"
"168636",0,0,1,1,"dummy"
"168637",4,1,0,5,"dummy"
"168639",9,6,1,16,"dummy"
"168641",0,2,0,2,"dummy"
"168642",0,3,0,3,"dummy"
"168643",6,2,0,8,"dummy"
"168645",0,1,0,1,"dummy"
"168647",0,5,2,7,"dummy"
"168649",6,0,0,6,"dummy"
"168650",2,5,2,9,"dummy"
"168656",0,4,0,4,"dummy"
"168663",0,0,0,0,"dummy"
"168666",5,6,1,12,"dummy"
"168667",0,1,0,1,"dummy"
"168668",0,0,1,1,"dummy"
"168669",5,19,0,24,"dummy"
"168670",6,0,0,6,"dummy"
"168671",0,0,1,1,"dummy"
"168672",0,0,1,1,"dummy"
"168673",3,5,0,8,"dummy"
"168674",0,0,1,1,"dummy"
"168675",1,0,0,1,"dummy"
"168676",3,0,0,3,"dummy"
"168680",0,2,2,4,"dummy"
"168681",1,0,0,1,"dummy"
"168682",0,0,1,1,"dummy"
"168683",0,0,1,1,"dummy"
"168684",0,0,1,1,"dummy"
"168685",8,0,2,10,"dummy"
"168687",1,3,0,4,"dummy"
"168691",0,0,0,0,"dummy"
"168695",6,7,0,13,"dummy"
"168696",0,0,1,1,"dummy"
"168697",2,3,1,6,"dummy"
"168699",5,2,6,13,"dummy"
"168700",0,0,1,1,"dummy"
"168702",0,1,0,1,"dummy"
"168703",4,5,1,10,"dummy"
"168704",1,2,0,3,"dummy"
"168705",0,1,0,1,"dummy"
"168707",0,1,0,1,"dummy"
"168709",0,0,1,1,"dummy"
"168712",0,1,4,5,"dummy"
"168713",0,1,0,1,"dummy"
"168714",7,16,3,26,"dummy"
"168715",0,5,0,5,"dummy"
"168716",0,1,0,1,"dummy"
"168717",0,7,1,8,"dummy"
"168718",0,2,1,3,"dummy"
"168719",1,4,0,5,"dummy"
"168720",0,2,0,2,"dummy"
"168721",0,2,0,2,"dummy"
"168722",0,2,1,3,"dummy"
"168723",0,0,1,1,"dummy"
"168724",0,0,1,1,"dummy"
"168725",2,2,1,5,"dummy"
"168726",0,0,1,1,"dummy"
"168727",0,0,1,1,"dummy"
"168729",0,0,1,1,"dummy"
"168731",0,0,2,2,"dummy"
"168732",0,0,1,1,"dummy"
"168733",1,4,1,6,"dummy"
"168734",4,1,2,7,"dummy"
"168735",2,8,1,11,"dummy"
"168736",0,0,1,1,"dummy"
"168738",9,8,1,18,"dummy"
"168739",0,1,0,1,"dummy"
"168740",0,0,1,1,"dummy"
"168742",0,0,2,2,"dummy"
"168743",0,0,1,1,"dummy"
"168747",0,2,0,2,"dummy"
"168749",0,0,1,1,"dummy"
"168750",0,2,0,2,"dummy"
"168751",0,0,1,1,"dummy"
"168752",0,0,1,1,"dummy"
"168753",3,0,1,4,"dummy"
"168756",0,15,0,15,"dummy"
"168757",0,1,0,1,"dummy"
"168759",8,1,0,9,"dummy"
"168760",3,2,0,5,"dummy"
"168761",0,0,3,3,"dummy"
"168763",2,4,0,6,"dummy"
"168764",0,2,0,2,"dummy"
"168765",0,2,0,2,"dummy"
"168766",10,2,0,12,"dummy"
"168767",0,2,0,2,"dummy"
"168768",0,0,2,2,"dummy"
"168770",0,7,0,7,"dummy"
"168771",0,8,0,8,"dummy"
"168772",0,5,0,5,"dummy"
"168773",0,1,0,1,"dummy"
"168774",0,0,0,0,"dummy"
"168775",0,1,0,1,"dummy"
"168776",0,0,1,1,"dummy"
"168777",4,5,1,10,"dummy"
"168778",2,0,2,4,"dummy"
"168779",1,0,0,1,"dummy"
"168780",0,0,1,1,"dummy"
"168787",1,2,1,4,"dummy"
"168788",0,1,0,1,"dummy"
"168789",1,2,0,3,"dummy"
"168791",0,3,0,3,"dummy"
"168792",0,1,1,2,"dummy"
"168794",3,7,0,10,"dummy"
"168795",4,20,1,25,"dummy"
"168796",1,11,0,12,"dummy"
"168798",1,1,2,4,"dummy"
"168799",1,0,1,2,"dummy"
"168800",0,0,1,1,"dummy"
"168801",0,0,2,2,"dummy"
"168802",0,0,1,1,"dummy"
"168803",0,0,1,1,"dummy"
"168804",0,0,1,1,"dummy"
"168805",0,1,0,1,"dummy"
"168806",0,0,1,1,"dummy"
"168807",0,0,1,1,"dummy"
"168808",0,0,1,1,"dummy"
"168809",0,0,1,1,"dummy"
"168810",0,0,1,1,"dummy"
"168811",0,0,1,1,"dummy"
"168812",0,0,1,1,"dummy"
"168813",0,0,1,1,"dummy"
"168814",0,0,1,1,"dummy"
"168815",0,0,1,1,"dummy"
"168816",0,0,1,1,"dummy"
"168817",0,0,1,1,"dummy"
"168818",0,0,1,1,"dummy"
"168819",0,0,1,1,"dummy"
"168820",0,0,1,1,"dummy"
"168821",0,0,1,1,"dummy"
"168822",0,0,1,1,"dummy"
"168823",0,0,1,1,"dummy"
"168824",0,0,1,1,"dummy"
"168825",0,0,1,1,"dummy"
"168826",0,0,1,1,"dummy"
"168827",0,0,1,1,"dummy"
"168828",0,0,1,1,"dummy"
"168829",1,19,2,22,"dummy"
"168830",1,2,0,3,"dummy"
"168832",0,2,0,2,"dummy"
"168833",0,0,1,1,"dummy"
"168834",0,2,0,2,"dummy"
"168836",0,2,3,5,"dummy"
"168838",0,0,0,0,"dummy"
"168839",0,0,0,0,"dummy"
"168840",0,0,0,0,"dummy"
"168841",0,0,0,0,"dummy"
"168842",0,0,0,0,"dummy"
"168843",0,0,0,0,"dummy"
"168846",3,10,4,17,"dummy"
"168847",0,1,0,1,"dummy"
"168850",0,1,0,1,"dummy"
"168851",0,0,2,2,"dummy"
"168852",0,0,1,1,"dummy"
"168853",0,1,0,1,"dummy"
"168854",4,4,2,10,"dummy"
"168855",0,2,0,2,"dummy"
"168856",18,2,0,20,"dummy"
"168858",0,2,0,2,"dummy"
"168860",0,2,0,2,"dummy"
"168863",0,0,0,0,"dummy"
"168866",0,0,2,2,"dummy"
"168868",0,1,0,1,"dummy"
"168869",0,1,0,1,"dummy"
"168870",0,1,0,1,"dummy"
"168871",14,0,1,15,"dummy"
"168874",0,1,0,1,"dummy"
"168875",1,0,0,1,"dummy"
"168876",0,0,1,1,"dummy"
"168879",1,0,2,3,"dummy"
"168880",0,0,1,1,"dummy"
"168892",2,6,3,11,"dummy"
"168893",0,0,1,1,"dummy"
"168895",0,0,0,0,"dummy"
"168897",3,5,6,14,"dummy"
"168898",0,0,0,0,"dummy"
"168899",0,0,2,2,"dummy"
"168900",12,20,1,33,"dummy"
"168902",2,2,0,4,"dummy"
"168903",0,2,0,2,"dummy"
"168904",0,2,0,2,"dummy"
"168906",2,0,0,2,"dummy"
"168907",4,0,0,4,"dummy"
"168908",0,4,1,5,"dummy"
"168910",0,0,1,1,"dummy"
"168913",0,0,0,0,"dummy"
"168914",0,0,0,0,"dummy"
"168915",0,1,0,1,"dummy"
"168921",0,1,0,1,"dummy"
"168924",0,0,1,1,"dummy"
"168925",0,0,0,0,"dummy"
"168926",0,0,0,0,"dummy"
"168927",0,0,2,2,"dummy"
"168930",2,1,0,3,"dummy"
"168931",1,0,0,1,"dummy"
"168938",0,0,0,0,"dummy"
"168940",1,0,0,1,"dummy"
"168941",1,4,0,5,"dummy"
"168967",13,8,2,23,"dummy"
"168968",0,2,0,2,"dummy"
"168969",3,4,1,8,"dummy"
"168970",0,1,0,1,"dummy"
"168971",0,0,1,1,"dummy"
"168980",0,2,0,2,"dummy"
"168981",0,1,0,1,"dummy"
"168982",2,1,0,3,"dummy"
"168983",3,2,0,5,"dummy"
"168984",2,1,0,3,"dummy"
"168985",1,1,0,2,"dummy"
"168991",1,2,0,3,"dummy"
"168992",3,0,0,3,"dummy"
"168993",0,2,0,2,"dummy"
"168994",2,1,0,3,"dummy"
"168995",0,0,1,1,"dummy"
"169002",0,0,3,3,"dummy"
"169003",0,0,3,3,"dummy"
"169004",0,0,0,0,"dummy"
"169007",4,11,5,20,"dummy"
"169008",2,2,3,7,"dummy"
"169009",0,0,1,1,"dummy"
"169010",2,3,0,5,"dummy"
"169011",2,1,0,3,"dummy"
"169012",0,0,2,2,"dummy"
"169017",0,0,0,0,"dummy"
"169018",0,0,0,0,"dummy"
"169019",0,1,0,1,"dummy"
"169021",5,10,0,15,"dummy"
"169023",0,0,1,1,"dummy"
"169024",0,0,1,1,"dummy"
"169027",0,2,3,5,"dummy"
"169036",0,0,0,0,"dummy"
"169037",0,0,1,1,"dummy"
"169043",0,0,1,1,"dummy"
"169044",0,1,1,2,"dummy"
"169045",0,2,1,3,"dummy"
"169048",0,0,0,0,"dummy"
"169052",0,1,0,1,"dummy"
"169054",0,0,0,0,"dummy"
"169058",0,0,0,0,"dummy"
"169064",0,0,1,1,"dummy"
"169066",0,0,2,2,"dummy"
"169069",2,1,0,3,"dummy"
"169077",20,8,7,35,"dummy"
"169090",1,1,1,3,"dummy"
"169094",0,2,0,2,"dummy"
"169095",9,3,2,14,"dummy"
"169096",0,0,1,1,"dummy"
"169099",0,0,0,0,"dummy"
"169100",0,2,0,2,"dummy"
"169104",0,2,0,2,"dummy"
"169105",4,2,0,6,"dummy"
"169106",0,0,0,0,"dummy"
"169107",3,2,0,5,"dummy"
"169108",2,0,0,2,"dummy"
"169109",0,0,1,1,"dummy"
"169110",0,0,0,0,"dummy"
"169121",0,1,0,1,"dummy"
"169123",2,1,1,4,"dummy"
"169125",0,1,0,1,"dummy"
"169126",0,2,0,2,"dummy"
"169155",2,0,3,5,"dummy"
"169158",2,4,0,6,"dummy"
"169159",0,2,0,2,"dummy"
"169160",0,2,0,2,"dummy"
"169161",10,2,0,12,"dummy"
"169162",0,2,0,2,"dummy"
"169163",0,0,0,0,"dummy"
"169233",3,4,1,8,"dummy"
"169234",0,0,1,1,"dummy"
"169235",0,0,1,1,"dummy"
"169236",2,5,0,7,"dummy"
"169237",0,0,1,1,"dummy"
"169238",0,0,1,1,"dummy"
"169239",0,0,1,1,"dummy"
"169245",0,0,0,0,"dummy"
"169247",0,1,0,1,"dummy"
"169248",2,1,0,3,"dummy"
"169249",1,3,0,4,"dummy"
"169250",2,0,0,2,"dummy"
"169251",0,3,0,3,"dummy"
"169252",0,10,0,10,"dummy"
"169253",0,0,2,2,"dummy"
"169254",5,3,0,8,"dummy"
"169255",0,3,0,3,"dummy"
"169256",3,0,0,3,"dummy"
"169257",0,0,3,3,"dummy"
"169258",0,3,0,3,"dummy"
"169260",0,0,0,0,"dummy"
"169261",0,0,0,0,"dummy"
"169262",0,0,0,0,"dummy"
"169266",0,0,1,1,"dummy"
"169267",0,0,1,1,"dummy"
"169268",0,0,1,1,"dummy"
"169269",0,0,1,1,"dummy"
"169270",0,0,1,1,"dummy"
"169271",0,0,2,2,"dummy"
"169276",0,2,1,3,"dummy"
"169279",0,2,0,2,"dummy"
"169281",0,0,3,3,"dummy"
"169282",0,0,1,1,"dummy"
"169283",0,3,1,4,"dummy"
"169284",2,2,0,4,"dummy"
"169285",2,3,0,5,"dummy"
"169286",2,2,0,4,"dummy"
"169288",0,0,1,1,"dummy"
"169289",0,0,0,0,"dummy"
"169290",5,15,4,24,"dummy"
"169291",15,5,4,24,"dummy"
"169292",1,0,0,1,"dummy"
"169293",0,1,0,1,"dummy"
"169294",0,0,3,3,"dummy"
"169295",0,1,0,1,"dummy"
"169296",0,0,0,0,"dummy"
"169297",0,0,0,0,"dummy"
"169298",1,3,0,4,"dummy"
"169299",0,0,2,2,"dummy"
"169300",0,0,2,2,"dummy"
"169301",0,1,0,1,"dummy"
"169302",2,2,0,4,"dummy"
"169303",0,0,0,0,"dummy"
"169304",0,0,3,3,"dummy"
"169305",0,3,1,4,"dummy"
"169306",0,0,2,2,"dummy"
"169307",0,0,2,2,"dummy"
"169308",0,1,0,1,"dummy"
"169309",0,0,2,2,"dummy"
"169310",0,0,2,2,"dummy"
"169311",0,0,2,2,"dummy"
"169312",0,0,2,2,"dummy"
"169313",0,0,2,2,"dummy"
"169314",0,0,2,2,"dummy"
"169315",0,0,2,2,"dummy"
"169316",2,2,0,4,"dummy"
"169317",0,0,2,2,"dummy"
"169318",0,0,2,2,"dummy"
"169319",0,0,2,2,"dummy"
"169320",0,0,2,2,"dummy"
"169321",0,0,1,1,"dummy"
"169322",0,0,2,2,"dummy"
"169323",0,0,2,2,"dummy"
"169324",0,0,2,2,"dummy"
"169325",0,0,2,2,"dummy"
"169326",0,0,2,2,"dummy"
"169327",0,0,2,2,"dummy"
"169328",0,0,2,2,"dummy"
"169329",0,0,2,2,"dummy"
"169330",0,1,1,2,"dummy"
"169331",4,5,0,9,"dummy"
"169332",1,1,4,6,"dummy"
"169333",0,0,4,4,"dummy"
"169334",0,0,2,2,"dummy"
"169335",0,0,1,1,"dummy"
"169336",0,0,2,2,"dummy"
"169337",0,0,2,2,"dummy"
"169338",0,0,2,2,"dummy"
"169340",0,0,0,0,"dummy"
"169341",0,0,0,0,"dummy"
"169343",0,2,0,2,"dummy"
"169363",0,1,0,1,"dummy"
"169364",2,0,2,4,"dummy"
"169366",0,1,0,1,"dummy"
"169367",0,0,0,0,"dummy"
"169368",0,0,0,0,"dummy"
"169399",0,2,3,5,"dummy"
"169400",0,0,1,1,"dummy"
"169401",0,0,2,2,"dummy"
"169402",3,28,1,32,"dummy"
"169403",0,0,0,0,"dummy"
"169407",0,0,1,1,"dummy"
"169408",15,0,1,16,"dummy"
"169409",0,0,2,2,"dummy"
"169411",0,0,0,0,"dummy"
"169415",0,0,1,1,"dummy"
"169416",2,10,0,12,"dummy"
"169417",1,0,1,2,"dummy"
"169419",0,0,0,0,"dummy"
"169420",1,0,0,1,"dummy"
"169421",0,0,1,1,"dummy"
"169432",1,18,1,20,"dummy"
"169433",0,0,1,1,"dummy"
"169440",2,2,2,6,"dummy"
"169441",3,2,7,12,"dummy"
"169442",1,0,4,5,"dummy"
"169443",0,1,2,3,"dummy"
"169444",7,11,1,19,"dummy"
"169445",2,2,1,5,"dummy"
"169446",0,1,1,2,"dummy"
"169447",6,7,1,14,"dummy"
"169448",17,8,11,36,"dummy"
"169449",0,4,0,4,"dummy"
"169450",0,0,1,1,"dummy"
"169451",2,1,8,11,"dummy"
"169455",0,1,0,1,"dummy"
"169456",1,0,0,1,"dummy"
"169457",0,0,0,0,"dummy"
"169458",6,16,8,30,"dummy"
"169459",16,6,8,30,"dummy"
"169460",0,1,0,1,"dummy"
"169465",9,6,3,18,"dummy"
"169466",3,4,0,7,"dummy"
"169469",1,4,2,7,"dummy"
"169471",2,2,0,4,"dummy"
"169472",0,1,0,1,"dummy"
"169473",1,0,0,1,"dummy"
"169474",0,1,0,1,"dummy"
"169475",0,0,1,1,"dummy"
"169476",0,2,0,2,"dummy"
"169477",0,0,1,1,"dummy"
"169478",0,1,0,1,"dummy"
"169479",0,1,0,1,"dummy"
"169480",1,0,1,2,"dummy"
"169481",0,1,0,1,"dummy"
"169483",0,0,4,4,"dummy"
"169484",0,2,0,2,"dummy"
"169485",3,4,0,7,"dummy"
"169486",3,3,4,10,"dummy"
"169487",0,1,0,1,"dummy"
"169488",0,2,0,2,"dummy"
"169489",0,1,0,1,"dummy"
"169490",1,2,0,3,"dummy"
"169491",0,2,0,2,"dummy"
"169492",0,1,0,1,"dummy"
"169499",0,0,2,2,"dummy"
"169500",0,8,0,8,"dummy"
"169508",0,0,1,1,"dummy"
"169509",0,2,0,2,"dummy"
"169510",0,0,1,1,"dummy"
"169513",4,8,10,22,"dummy"
"169514",0,0,1,1,"dummy"
"169517",3,0,0,3,"dummy"
"169518",3,3,0,6,"dummy"
"169519",0,0,3,3,"dummy"
"169520",0,0,4,4,"dummy"
"169521",2,0,0,2,"dummy"
"169523",1,0,0,1,"dummy"
"169525",6,2,3,11,"dummy"
"169527",0,3,0,3,"dummy"
"169528",0,1,0,1,"dummy"
"169529",2,23,1,26,"dummy"
"169530",6,0,0,6,"dummy"
"169531",0,0,1,1,"dummy"
"169532",0,1,0,1,"dummy"
"169533",0,1,0,1,"dummy"
"169535",0,0,3,3,"dummy"
"169539",1,6,2,9,"dummy"
"169544",1,0,0,1,"dummy"
"169545",0,0,0,0,"dummy"
"169547",0,0,1,1,"dummy"
"169553",0,1,0,1,"dummy"
"169554",0,1,0,1,"dummy"
"169555",0,0,1,1,"dummy"
"169556",0,0,0,0,"dummy"
"169557",0,4,0,4,"dummy"
"169561",0,2,0,2,"dummy"
"169562",2,1,0,3,"dummy"
"169570",0,4,1,5,"dummy"
"169571",0,0,1,1,"dummy"
"169579",1,1,1,3,"dummy"
"169580",0,1,0,1,"dummy"
"169581",6,4,2,12,"dummy"
"169585",1,2,0,3,"dummy"
"169586",0,2,0,2,"dummy"
"169591",6,3,1,10,"dummy"
"169592",0,4,0,4,"dummy"
"169593",1,0,0,1,"dummy"
"169595",2,2,1,5,"dummy"
"169601",0,2,0,2,"dummy"
"169604",12,12,2,26,"dummy"
"169605",0,0,9,9,"dummy"
"169607",0,1,1,2,"dummy"
"169608",0,2,0,2,"dummy"
"169609",0,0,0,0,"dummy"
"169610",0,1,0,1,"dummy"
"169611",0,1,0,1,"dummy"
"169613",1,0,0,1,"dummy"
"169615",0,1,0,1,"dummy"
"169618",0,1,0,1,"dummy"
"169620",3,7,3,13,"dummy"
"169621",0,0,1,1,"dummy"
"169622",0,0,2,2,"dummy"
"169623",1,9,4,14,"dummy"
"169624",0,0,1,1,"dummy"
"169625",0,0,1,1,"dummy"
"169628",0,2,0,2,"dummy"
"169629",0,1,0,1,"dummy"
"169630",0,1,0,1,"dummy"
"169631",0,0,1,1,"dummy"
"169632",0,0,1,1,"dummy"
"169633",0,1,0,1,"dummy"
"169634",0,0,1,1,"dummy"
"169635",0,0,1,1,"dummy"
"169636",0,1,0,1,"dummy"
"169637",0,1,0,1,"dummy"
"169638",0,1,0,1,"dummy"
"169639",0,0,1,1,"dummy"
"169640",0,0,3,3,"dummy"
"169641",0,1,1,2,"dummy"
"169642",2,0,0,2,"dummy"
"169652",0,0,0,0,"dummy"
"169653",0,0,1,1,"dummy"
"169654",0,0,1,1,"dummy"
"169655",1,2,1,4,"dummy"
"169656",0,1,0,1,"dummy"
"169657",0,1,0,1,"dummy"
"169658",0,0,0,0,"dummy"
"169659",0,2,2,4,"dummy"
"169660",0,3,0,3,"dummy"
"169661",3,0,1,4,"dummy"
"169662",0,3,0,3,"dummy"
"169663",0,0,1,1,"dummy"
"169664",0,0,1,1,"dummy"
"169665",0,0,4,4,"dummy"
"169666",0,0,1,1,"dummy"
"169667",0,0,1,1,"dummy"
"169668",0,0,2,2,"dummy"
"169669",0,0,2,2,"dummy"
"169670",0,0,4,4,"dummy"
"169671",0,0,2,2,"dummy"
"169682",0,0,1,1,"dummy"
"169688",0,0,1,1,"dummy"
"169695",0,2,0,2,"dummy"
"169696",1,11,2,14,"dummy"
"169697",0,6,0,6,"dummy"
"169703",0,0,1,1,"dummy"
"169704",0,0,1,1,"dummy"
"169705",0,0,1,1,"dummy"
"169706",0,0,2,2,"dummy"
"169707",0,0,1,1,"dummy"
"169708",0,0,1,1,"dummy"
"169709",0,0,0,0,"dummy"
"169710",0,0,1,1,"dummy"
"169711",0,0,1,1,"dummy"
"169712",0,0,1,1,"dummy"
"169713",0,0,2,2,"dummy"
"169714",0,0,1,1,"dummy"
"169717",0,2,0,2,"dummy"
"169718",0,1,0,1,"dummy"
"169719",0,1,0,1,"dummy"
"169720",0,0,1,1,"dummy"
"169721",0,0,1,1,"dummy"
"169722",0,1,0,1,"dummy"
"169723",0,0,1,1,"dummy"
"169724",0,0,1,1,"dummy"
"169725",0,1,0,1,"dummy"
"169726",0,1,0,1,"dummy"
"169727",0,1,0,1,"dummy"
"169728",0,0,1,1,"dummy"
"169729",0,0,3,3,"dummy"
"169730",0,1,1,2,"dummy"
"169731",2,0,0,2,"dummy"
"169733",3,4,3,10,"dummy"
"169736",2,4,0,6,"dummy"
"169737",5,23,0,28,"dummy"
"169738",7,5,0,12,"dummy"
"169739",2,0,4,6,"dummy"
"169740",0,0,0,0,"dummy"
"169741",3,3,0,6,"dummy"
"169742",3,5,5,13,"dummy"
"169743",0,1,0,1,"dummy"
"169750",0,1,1,2,"dummy"
"169751",0,1,0,1,"dummy"
"169753",1,0,0,1,"dummy"
"169754",1,2,0,3,"dummy"
"169755",3,2,0,5,"dummy"
"169756",0,2,0,2,"dummy"
"169757",0,1,0,1,"dummy"
"169759",1,2,0,3,"dummy"
"169764",0,0,0,0,"dummy"
"169766",0,0,0,0,"dummy"
"169767",6,8,6,20,"dummy"
"169768",9,11,2,22,"dummy"
"169769",0,0,1,1,"dummy"
"169770",0,0,1,1,"dummy"
"169771",0,0,1,1,"dummy"
"169773",23,2,2,27,"dummy"
"169774",0,0,1,1,"dummy"
"169775",0,1,0,1,"dummy"
"169778",0,0,1,1,"dummy"
"169780",0,0,0,0,"dummy"
"169781",0,0,0,0,"dummy"
"169784",0,1,0,1,"dummy"
"169785",1,0,0,1,"dummy"
"169787",0,1,1,2,"dummy"
"169788",5,16,2,23,"dummy"
"169789",3,1,3,7,"dummy"
"169790",0,0,1,1,"dummy"
"169792",2,3,0,5,"dummy"
"169793",2,0,0,2,"dummy"
"169794",7,0,0,7,"dummy"
"169795",1,0,0,1,"dummy"
"169796",0,0,0,0,"dummy"
"169797",0,0,0,0,"dummy"
"169799",1,0,1,2,"dummy"
"169801",0,2,0,2,"dummy"
"169804",0,1,0,1,"dummy"
"169805",1,0,1,2,"dummy"
"169806",0,0,1,1,"dummy"
"169810",0,0,1,1,"dummy"
"169811",1,2,0,3,"dummy"
"169814",0,0,1,1,"dummy"
"169815",3,0,0,3,"dummy"
"169816",0,3,2,5,"dummy"
"169840",3,0,0,3,"dummy"
"169842",1,2,0,3,"dummy"
"169843",0,1,0,1,"dummy"
"169873",0,0,0,0,"dummy"
"169875",0,1,0,1,"dummy"
"169876",0,0,1,1,"dummy"
"169877",0,0,1,1,"dummy"
"169878",0,0,0,0,"dummy"
"169879",0,0,0,0,"dummy"
"169880",0,0,1,1,"dummy"
"169881",0,0,1,1,"dummy"
"169882",0,0,1,1,"dummy"
"169883",0,0,1,1,"dummy"
"169884",0,0,0,0,"dummy"
"169885",0,0,0,0,"dummy"
"169886",0,0,0,0,"dummy"
"169887",0,0,0,0,"dummy"
"169888",0,0,2,2,"dummy"
"169891",0,1,0,1,"dummy"
"169892",0,2,0,2,"dummy"
"169893",0,1,0,1,"dummy"
"169894",8,8,4,20,"dummy"
"169895",0,0,0,0,"dummy"
"169896",0,0,1,1,"dummy"
"169898",0,0,2,2,"dummy"
"169900",1,0,1,2,"dummy"
"169905",0,0,4,4,"dummy"
"169906",0,0,1,1,"dummy"
"169907",0,5,1,6,"dummy"
"169908",0,1,0,1,"dummy"
"169909",0,0,0,0,"dummy"
"169910",3,1,0,4,"dummy"
"169911",0,0,1,1,"dummy"
"169912",0,3,0,3,"dummy"
"169913",4,0,0,4,"dummy"
"169915",0,0,1,1,"dummy"
"169917",0,0,1,1,"dummy"
"169918",0,0,1,1,"dummy"
"169919",0,1,0,1,"dummy"
"169921",0,2,0,2,"dummy"
"169937",0,4,0,4,"dummy"
"169940",0,4,0,4,"dummy"
"169941",0,0,1,1,"dummy"
"169942",0,0,0,0,"dummy"
"169943",0,0,1,1,"dummy"
"169944",3,2,0,5,"dummy"
"169945",0,1,0,1,"dummy"
"169946",1,0,0,1,"dummy"
"169947",0,2,1,3,"dummy"
"169948",0,1,0,1,"dummy"
"169949",0,0,1,1,"dummy"
"169950",0,0,1,1,"dummy"
"169951",0,0,0,0,"dummy"
"169952",0,2,0,2,"dummy"
"169953",0,0,0,0,"dummy"
"169954",0,0,0,0,"dummy"
"169955",0,0,1,1,"dummy"
"169956",0,0,1,1,"dummy"
"169958",0,3,0,3,"dummy"
"169959",0,2,0,2,"dummy"
"169960",0,1,0,1,"dummy"
"169961",0,0,1,1,"dummy"
"169963",3,3,0,6,"dummy"
"169964",0,0,3,3,"dummy"
"169966",0,0,1,1,"dummy"
"169970",0,0,1,1,"dummy"
"169971",0,0,1,1,"dummy"
"169972",0,0,4,4,"dummy"
"169973",0,1,0,1,"dummy"
"169974",1,5,0,6,"dummy"
"169975",0,0,4,4,"dummy"
"169976",0,0,4,4,"dummy"
"169977",0,0,8,8,"dummy"
"169978",0,0,4,4,"dummy"
"169979",0,1,0,1,"dummy"
"169980",0,0,4,4,"dummy"
"169981",0,0,4,4,"dummy"
"169983",0,1,0,1,"dummy"
"169984",0,0,1,1,"dummy"
"169985",0,0,3,3,"dummy"
"169986",0,0,2,2,"dummy"
"169987",0,2,0,2,"dummy"
"169989",0,1,0,1,"dummy"
"169994",3,6,0,9,"dummy"
"169995",0,0,2,2,"dummy"
"169996",0,0,0,0,"dummy"
"169997",0,1,0,1,"dummy"
"169998",0,1,0,1,"dummy"
"170019",5,13,2,20,"dummy"
"170020",10,0,3,13,"dummy"
"170021",3,0,1,4,"dummy"
"170022",0,5,3,8,"dummy"
"170023",1,0,0,1,"dummy"
"170024",3,0,0,3,"dummy"
"170025",0,0,1,1,"dummy"
"170026",1,0,1,2,"dummy"
"170031",0,0,0,0,"dummy"
"170032",0,0,1,1,"dummy"
"170033",0,0,0,0,"dummy"
"170034",0,0,0,0,"dummy"
"170035",1,2,0,3,"dummy"
"170036",2,1,0,3,"dummy"
"170037",0,0,0,0,"dummy"
"170038",0,0,0,0,"dummy"
"170039",0,0,1,1,"dummy"
"170040",0,0,0,0,"dummy"
"170041",0,0,1,1,"dummy"
"170042",0,0,0,0,"dummy"
"170046",0,4,0,4,"dummy"
"170047",9,11,0,20,"dummy"
"170048",0,0,1,1,"dummy"
"170049",0,0,1,1,"dummy"
"170050",0,0,1,1,"dummy"
"170053",2,3,0,5,"dummy"
"170055",0,1,0,1,"dummy"
"170056",6,0,0,6,"dummy"
"170057",0,0,1,1,"dummy"
"170064",2,0,1,3,"dummy"
"170067",0,4,0,4,"dummy"
"170068",4,13,1,18,"dummy"
"170069",4,5,3,12,"dummy"
"170070",2,2,2,6,"dummy"
"170071",2,0,1,3,"dummy"
"170072",0,1,0,1,"dummy"
"170073",0,0,1,1,"dummy"
"170077",0,0,1,1,"dummy"
"170079",0,3,0,3,"dummy"
"170080",0,2,0,2,"dummy"
"170081",2,0,0,2,"dummy"
"170082",0,1,0,1,"dummy"
"170083",4,1,1,6,"dummy"
"170084",0,1,0,1,"dummy"
"170085",0,2,0,2,"dummy"
"170086",0,1,0,1,"dummy"
"170092",13,0,4,17,"dummy"
"170093",3,6,2,11,"dummy"
"170094",8,1,3,12,"dummy"
"170095",0,1,1,2,"dummy"
"170096",1,0,1,2,"dummy"
"170097",0,1,0,1,"dummy"
"170098",0,0,1,1,"dummy"
"170106",0,2,0,2,"dummy"
"170108",4,5,0,9,"dummy"
"170110",0,3,2,5,"dummy"
"170111",0,0,0,0,"dummy"
"170112",0,1,0,1,"dummy"
"170113",1,0,0,1,"dummy"
"170114",3,0,0,3,"dummy"
"170115",0,3,0,3,"dummy"
"170116",0,0,1,1,"dummy"
"170118",0,0,1,1,"dummy"
"170119",0,0,0,0,"dummy"
"170121",0,1,2,3,"dummy"
"170122",0,0,1,1,"dummy"
"170126",2,4,0,6,"dummy"
"170127",0,2,0,2,"dummy"
"170128",0,2,0,2,"dummy"
"170129",10,2,0,12,"dummy"
"170130",0,2,0,2,"dummy"
"170131",0,0,0,0,"dummy"
"170133",0,0,0,0,"dummy"
"170134",0,0,2,2,"dummy"
"170136",0,0,2,2,"dummy"
"170139",0,0,2,2,"dummy"
"170140",0,0,2,2,"dummy"
"170141",0,2,0,2,"dummy"
"170142",0,1,1,2,"dummy"
"170149",0,0,3,3,"dummy"
"170150",0,0,4,4,"dummy"
"170151",0,0,0,0,"dummy"
"170152",0,0,0,0,"dummy"
"170153",0,0,1,1,"dummy"
"170154",0,0,1,1,"dummy"
"170155",0,0,2,2,"dummy"
"170160",0,0,1,1,"dummy"
"170161",0,0,3,3,"dummy"
"170162",6,8,2,16,"dummy"
"170163",3,3,2,8,"dummy"
"170164",4,1,1,6,"dummy"
"170165",0,4,0,4,"dummy"
"170166",0,0,0,0,"dummy"
"170167",0,1,0,1,"dummy"
"170168",0,0,1,1,"dummy"
"170169",0,1,0,1,"dummy"
"170170",2,0,0,2,"dummy"
"170171",0,2,0,2,"dummy"
"170201",0,1,4,5,"dummy"
"170202",1,0,0,1,"dummy"
"170203",2,7,0,9,"dummy"
"170204",2,0,0,2,"dummy"
"170205",0,1,0,1,"dummy"
"170206",0,1,0,1,"dummy"
"170207",0,0,1,1,"dummy"
"170208",15,24,3,42,"dummy"
"170209",2,2,0,4,"dummy"
"170210",13,13,0,26,"dummy"
"170211",0,1,2,3,"dummy"
"170212",0,0,1,1,"dummy"
"170213",2,4,0,6,"dummy"
"170214",3,3,1,7,"dummy"
"170215",3,0,2,5,"dummy"
"170216",1,2,1,4,"dummy"
"170219",0,1,0,1,"dummy"
"170232",0,1,4,5,"dummy"
"170240",3,1,1,5,"dummy"
"170242",6,3,0,9,"dummy"
"170243",2,1,0,3,"dummy"
"170244",5,4,1,10,"dummy"
"170245",0,1,0,1,"dummy"
"170246",5,2,1,8,"dummy"
"170250",0,0,1,1,"dummy"
"170252",0,0,1,1,"dummy"
"170253",0,0,1,1,"dummy"
"170263",6,0,0,6,"dummy"
"170264",2,5,2,9,"dummy"
"170267",0,5,1,6,"dummy"
"170268",2,5,1,8,"dummy"
"170269",7,4,4,15,"dummy"
"170270",13,9,3,25,"dummy"
"170271",4,1,0,5,"dummy"
"170272",0,3,0,3,"dummy"
"170274",9,5,1,15,"dummy"
"170277",0,0,1,1,"dummy"
"170278",2,0,3,5,"dummy"
"170282",2,4,0,6,"dummy"
"170283",0,1,0,1,"dummy"
"170284",0,0,1,1,"dummy"
"170285",0,4,1,5,"dummy"
"170286",1,1,1,3,"dummy"
"170287",0,0,1,1,"dummy"
"170288",4,4,2,10,"dummy"
"170289",0,3,0,3,"dummy"
"170290",0,1,0,1,"dummy"
"170293",1,0,4,5,"dummy"
"170294",0,2,0,2,"dummy"
"170297",1,0,0,1,"dummy"
"170300",1,5,1,7,"dummy"
"170301",2,4,1,7,"dummy"
"170302",4,2,1,7,"dummy"
"170303",0,1,0,1,"dummy"
"170304",0,2,0,2,"dummy"
"170305",1,0,0,1,"dummy"
"170340",3,7,0,10,"dummy"
"170341",0,0,1,1,"dummy"
"170342",1,1,0,2,"dummy"
"170343",0,0,1,1,"dummy"
"170344",0,0,0,0,"dummy"
"170345",4,3,3,10,"dummy"
"170359",3,3,1,7,"dummy"
"170360",1,0,0,1,"dummy"
"170361",0,0,2,2,"dummy"
"170362",0,1,0,1,"dummy"
"170363",0,1,0,1,"dummy"
"170364",0,0,2,2,"dummy"
"170365",0,0,1,1,"dummy"
"170366",0,0,1,1,"dummy"
"170367",0,0,2,2,"dummy"
"170368",0,2,3,5,"dummy"
"170369",2,1,0,3,"dummy"
"170370",0,1,2,3,"dummy"
"170371",2,2,0,4,"dummy"
"170377",0,0,0,0,"dummy"
"170378",0,0,1,1,"dummy"
"170385",0,0,1,1,"dummy"
"170394",13,5,4,22,"dummy"
"170395",4,7,1,12,"dummy"
"170401",0,0,1,1,"dummy"
"170402",0,0,1,1,"dummy"
"170403",5,0,3,8,"dummy"
"170406",0,15,0,15,"dummy"
"170407",1,0,1,2,"dummy"
"170410",0,0,0,0,"dummy"
"170411",5,2,0,7,"dummy"
"170412",1,0,0,1,"dummy"
"170413",0,0,1,1,"dummy"
"170414",2,0,0,2,"dummy"
"170415",0,0,1,1,"dummy"
"170416",0,0,1,1,"dummy"
"170417",0,2,0,2,"dummy"
"170418",3,0,0,3,"dummy"
"170419",0,1,0,1,"dummy"
"170420",1,0,0,1,"dummy"
"170421",0,0,0,0,"dummy"
"170422",0,0,0,0,"dummy"
"170423",5,0,0,5,"dummy"
"170424",0,0,0,0,"dummy"
"170425",0,0,0,0,"dummy"
"170428",6,5,2,13,"dummy"
"170429",3,6,3,12,"dummy"
"170430",0,0,1,1,"dummy"
"170431",2,0,0,2,"dummy"
"170432",2,4,5,11,"dummy"
"170433",2,2,4,8,"dummy"
"170434",5,0,1,6,"dummy"
"170435",0,2,0,2,"dummy"
"170436",0,1,0,1,"dummy"
"170437",1,0,0,1,"dummy"
"170438",0,1,1,2,"dummy"
"170439",1,0,0,1,"dummy"
"170440",1,1,1,3,"dummy"
"170441",0,0,1,1,"dummy"
"170444",0,3,0,3,"dummy"
"170445",2,6,6,14,"dummy"
"170446",0,7,0,7,"dummy"
"170451",0,1,0,1,"dummy"
"170452",0,0,0,0,"dummy"
"170453",0,0,0,0,"dummy"
"170454",0,0,0,0,"dummy"
"170455",2,0,0,2,"dummy"
"170456",0,0,0,0,"dummy"
"170457",2,4,0,6,"dummy"
"170458",0,0,2,2,"dummy"
"170468",0,1,0,1,"dummy"
"170483",2,2,0,4,"dummy"
"170484",0,0,1,1,"dummy"
"170485",0,0,6,6,"dummy"
"170488",0,1,1,2,"dummy"
"170489",0,0,3,3,"dummy"
"170490",0,1,0,1,"dummy"
"170501",1,1,0,2,"dummy"
"170515",0,6,0,6,"dummy"
"170516",3,0,0,3,"dummy"
"170517",0,1,1,2,"dummy"
"170518",1,3,1,5,"dummy"
"170519",0,0,0,0,"dummy"
"170351",0,6,0,6,"dummy"
"170352",0,4,0,4,"dummy"
"170353",0,0,1,1,"dummy"
"170354",0,0,1,1,"dummy"
"170355",0,1,0,1,"dummy"
"170356",6,7,4,17,"dummy"
"170357",0,2,0,2,"dummy"
"170373",6,0,2,8,"dummy"
"170374",0,2,3,5,"dummy"
"170375",1,1,0,2,"dummy"
"170380",0,0,1,1,"dummy"
"170381",0,1,0,1,"dummy"
"170397",0,3,0,3,"dummy"
"170398",0,0,3,3,"dummy"
"170399",0,1,0,1,"dummy"
"170462",0,2,0,2,"dummy"
"170463",5,5,3,13,"dummy"
"170464",0,1,0,1,"dummy"
"170465",2,0,3,5,"dummy"
"170466",3,0,1,4,"dummy"
"170470",0,1,0,1,"dummy"
"170471",0,0,0,0,"dummy"
"170472",1,1,2,4,"dummy"
"170473",0,2,0,2,"dummy"
"170474",0,4,2,6,"dummy"
"170475",0,2,0,2,"dummy"
"170498",0,1,0,1,"dummy"
"170499",0,0,1,1,"dummy"
"170505",1,3,0,4,"dummy"
"170506",1,2,0,3,"dummy"
"170507",0,0,0,0,"dummy"
"170508",0,1,0,1,"dummy"
"170509",1,6,1,8,"dummy"
"170510",1,0,0,1,"dummy"
"170511",0,0,1,1,"dummy"
"170512",0,0,1,1,"dummy"
"170513",0,1,0,1,"dummy"
"170521",0,2,1,3,"dummy"
"170522",1,2,0,3,"dummy"
"170523",0,1,0,1,"dummy"
"170524",1,1,0,2,"dummy"
"170525",4,15,2,21,"dummy"
"170526",0,0,0,0,"dummy"
"170535",0,1,0,1,"dummy"
"170536",0,0,0,0,"dummy"
"170537",3,5,5,13,"dummy"
"170538",2,0,0,2,"dummy"
"170539",0,0,1,1,"dummy"
"170550",0,0,1,1,"dummy"
"170554",0,0,3,3,"dummy"
"170555",2,2,0,4,"dummy"
"170556",0,0,2,2,"dummy"
"170557",2,4,0,6,"dummy"
"170564",0,0,1,1,"dummy"
"170567",0,1,0,1,"dummy"
"170568",4,4,1,9,"dummy"
"170572",2,2,2,6,"dummy"
"170575",10,14,3,27,"dummy"
"170576",0,7,0,7,"dummy"
"170577",1,2,0,3,"dummy"
"170578",0,0,0,0,"dummy"
"170579",0,4,1,5,"dummy"
"170580",2,1,3,6,"dummy"
"170581",0,0,2,2,"dummy"
"170541",0,7,0,7,"dummy"
"170552",13,0,3,16,"dummy"
"170570",0,0,1,1,"dummy"
"170602",2,4,3,9,"dummy"
"170603",2,0,0,2,"dummy"
"170604",6,3,3,12,"dummy"
"170607",3,1,5,9,"dummy"
"170608",1,3,5,9,"dummy"
"170609",4,5,3,12,"dummy"
"170610",1,2,0,3,"dummy"
"170611",3,0,3,6,"dummy"
"170612",0,1,0,1,"dummy"
"170613",3,0,0,3,"dummy"
"170614",0,0,3,3,"dummy"
"170615",0,0,3,3,"dummy"
"170626",0,0,1,1,"dummy"
"170627",0,1,1,2,"dummy"
"170628",0,1,0,1,"dummy"
"170629",0,1,0,1,"dummy"
"170630",0,1,0,1,"dummy"
"170631",2,2,0,4,"dummy"
"170632",0,1,0,1,"dummy"
"170635",0,0,1,1,"dummy"
"170636",1,0,2,3,"dummy"
"170637",0,0,1,1,"dummy"
"170638",0,2,2,4,"dummy"
"170654",0,0,1,1,"dummy"
"170655",0,1,0,1,"dummy"
"170656",0,0,1,1,"dummy"
"170657",0,0,1,1,"dummy"
"170661",0,3,0,3,"dummy"
"170670",0,0,0,0,"dummy"
"170679",0,0,1,1,"dummy"
"170680",0,2,0,2,"dummy"
"170681",1,0,0,1,"dummy"
"170682",0,1,0,1,"dummy"
"170683",1,0,0,1,"dummy"
"170706",0,3,0,3,"dummy"
"170726",0,0,2,2,"dummy"
"170729",0,1,0,1,"dummy"
"170730",3,1,0,4,"dummy"
"170731",0,0,0,0,"dummy"
"170737",0,0,1,1,"dummy"
"170742",0,0,1,1,"dummy"
"170743",0,1,1,2,"dummy"
"170744",0,0,1,1,"dummy"
"170745",0,0,1,1,"dummy"
"170746",0,0,0,0,"dummy"
"170749",2,0,0,2,"dummy"
"170750",0,2,0,2,"dummy"
"170755",0,0,0,0,"dummy"
"170756",0,0,1,1,"dummy"
"170827",0,0,2,2,"dummy"
"170843",7,8,0,15,"dummy"
"170844",0,1,0,1,"dummy"
"170582",0,1,0,1,"dummy"
"170583",1,1,2,4,"dummy"
"170584",5,3,4,12,"dummy"
"170585",1,0,0,1,"dummy"
"170588",0,0,0,0,"dummy"
"170589",0,5,0,5,"dummy"
"170590",1,2,1,4,"dummy"
"170591",4,12,0,16,"dummy"
"170594",0,1,2,3,"dummy"
"170595",2,4,1,7,"dummy"
"170617",0,0,1,1,"dummy"
"170618",0,0,1,1,"dummy"
"170623",0,0,1,1,"dummy"
"170624",0,8,0,8,"dummy"
"170640",1,1,0,2,"dummy"
"170645",0,2,0,2,"dummy"
"170646",0,0,0,0,"dummy"
"170647",0,1,0,1,"dummy"
"170648",0,2,1,3,"dummy"
"170649",1,0,0,1,"dummy"
"170650",0,0,0,0,"dummy"
"170659",0,1,1,2,"dummy"
"170663",1,2,3,6,"dummy"
"170664",0,1,1,2,"dummy"
"170672",3,14,10,27,"dummy"
"170673",0,1,0,1,"dummy"
"170674",17,1,3,21,"dummy"
"170675",0,0,1,1,"dummy"
"170697",0,1,0,1,"dummy"
"170698",0,1,0,1,"dummy"
"170701",0,2,1,3,"dummy"
"170702",1,0,0,1,"dummy"
"170703",0,2,0,2,"dummy"
"170704",2,0,0,2,"dummy"
"170708",2,0,0,2,"dummy"
"170709",1,0,0,1,"dummy"
"170733",0,0,1,1,"dummy"
"170734",0,0,1,1,"dummy"
"170735",0,0,1,1,"dummy"
"170739",3,3,0,6,"dummy"
"170740",0,2,0,2,"dummy"
"170752",0,1,0,1,"dummy"
"170753",2,1,0,3,"dummy"
"170773",0,4,0,4,"dummy"
"170774",0,0,1,1,"dummy"
"170775",0,2,0,2,"dummy"
"170776",0,0,0,0,"dummy"
"170777",0,0,1,1,"dummy"
"170778",0,0,0,0,"dummy"
"170779",0,0,0,0,"dummy"
"170780",0,0,1,1,"dummy"
"170781",0,0,0,0,"dummy"
"170782",1,2,0,3,"dummy"
"170783",0,0,1,1,"dummy"
"170784",0,0,1,1,"dummy"
"170785",0,0,1,1,"dummy"
"170786",0,0,0,0,"dummy"
"170787",0,0,0,0,"dummy"
"170788",0,0,0,0,"dummy"
"170789",0,0,0,0,"dummy"
"170790",0,0,0,0,"dummy"
"170791",0,0,1,1,"dummy"
"170792",0,0,1,1,"dummy"
"170793",0,0,1,1,"dummy"
"170794",0,0,1,1,"dummy"
"170795",0,0,0,0,"dummy"
"170796",0,0,0,0,"dummy"
"170797",1,14,0,15,"dummy"
"170798",0,0,0,0,"dummy"
"170799",0,0,1,1,"dummy"
"170800",13,1,0,14,"dummy"
"170801",0,0,1,1,"dummy"
"170802",0,0,1,1,"dummy"
"170803",0,0,1,1,"dummy"
"170804",0,0,0,0,"dummy"
"170805",0,0,0,0,"dummy"
"170806",0,0,0,0,"dummy"
"170807",0,0,1,1,"dummy"
"170808",0,0,1,1,"dummy"
"170809",0,0,0,0,"dummy"
"170810",0,0,0,0,"dummy"
"170811",0,0,0,0,"dummy"
"170812",0,0,0,0,"dummy"
"170813",0,0,0,0,"dummy"
"170814",0,0,0,0,"dummy"
"170815",2,0,0,2,"dummy"
"170816",0,2,0,2,"dummy"
"170817",0,0,0,0,"dummy"
"170818",8,8,1,17,"dummy"
"170819",0,0,1,1,"dummy"
"170820",0,1,0,1,"dummy"
"170821",0,1,0,1,"dummy"
"170822",0,0,1,1,"dummy"
"170823",0,0,1,1,"dummy"
"170831",0,0,1,1,"dummy"
"170832",0,0,1,1,"dummy"
"170833",0,0,1,1,"dummy"
"170834",0,0,1,1,"dummy"
"170837",2,0,0,2,"dummy"
"170838",0,0,1,1,"dummy"
"170839",0,4,1,5,"dummy"
"170887",0,0,1,1,"dummy"
"170888",0,0,1,1,"dummy"
"170891",2,1,0,3,"dummy"
"170847",1,0,0,1,"dummy"
"170848",0,0,1,1,"dummy"
"170849",0,0,0,0,"dummy"
"170850",0,0,0,0,"dummy"
"170893",18,32,1,51,"dummy"
"170894",9,4,0,13,"dummy"
"170895",3,12,0,15,"dummy"
"170896",41,25,5,71,"dummy"
"170920",0,1,0,1,"dummy"
"170921",1,0,0,1,"dummy"
"170922",0,2,0,2,"dummy"
"170927",13,0,0,13,"dummy"
"170928",0,0,1,1,"dummy"
"170929",0,0,1,1,"dummy"
"170925",0,0,1,1,"dummy"
"170924",0,21,0,21,"dummy"
"170931",0,0,1,1,"dummy"
"170951",0,0,1,1,"dummy"
"170952",0,1,0,1,"dummy"
"170954",0,0,1,1,"dummy"
"170955",0,0,3,3,"dummy"
"170956",1,4,1,6,"dummy"
"170958",1,0,0,1,"dummy"
"170959",0,1,0,1,"dummy"
"170965",1,4,4,9,"dummy"
"170966",0,1,0,1,"dummy"
"170967",0,1,0,1,"dummy"
"170968",3,13,3,19,"dummy"
"170969",2,2,0,4,"dummy"
"170970",9,23,3,35,"dummy"
"170971",0,0,2,2,"dummy"
"170972",0,0,1,1,"dummy"
"170973",0,2,0,2,"dummy"
"170975",0,0,0,0,"dummy"
"170976",5,0,2,7,"dummy"
"170977",0,0,0,0,"dummy"
"170979",0,1,2,3,"dummy"
"170980",0,0,0,0,"dummy"
"170981",0,2,0,2,"dummy"
"170982",5,0,2,7,"dummy"
"170983",1,0,0,1,"dummy"
"170985",0,1,0,1,"dummy"
"170986",0,0,0,0,"dummy"
"170987",0,0,2,2,"dummy"
"170988",0,1,1,2,"dummy"
"170989",0,0,0,0,"dummy"
"170990",0,0,1,1,"dummy"
"170992",2,5,1,8,"dummy"
"170993",1,0,0,1,"dummy"
"170994",2,3,0,5,"dummy"
"170995",0,0,1,1,"dummy"
"170996",0,2,0,2,"dummy"
"170997",0,0,0,0,"dummy"
"170998",1,0,1,2,"dummy"
"171000",0,0,1,1,"dummy"
"171001",0,0,1,1,"dummy"
"171002",0,0,1,1,"dummy"
"171005",0,2,0,2,"dummy"
"171006",0,2,1,3,"dummy"
"171007",1,0,0,1,"dummy"
"171008",0,0,1,1,"dummy"
"171009",4,5,0,9,"dummy"
"171010",2,4,0,6,"dummy"
"171011",3,14,2,19,"dummy"
"171012",5,5,0,10,"dummy"
"171013",4,6,0,10,"dummy"
"171014",0,5,0,5,"dummy"
"171024",0,0,2,2,"dummy"
"171026",0,0,1,1,"dummy"
"171028",6,0,0,6,"dummy"
"171029",2,5,2,9,"dummy"
"171032",0,0,1,1,"dummy"
"171033",0,0,1,1,"dummy"
"171035",0,1,1,2,"dummy"
"171036",0,0,1,1,"dummy"
"171040",0,0,1,1,"dummy"
"171048",0,19,4,23,"dummy"
"171049",0,0,0,0,"dummy"
"171050",12,6,4,22,"dummy"
"171054",0,0,3,3,"dummy"
"171055",14,8,3,25,"dummy"
"171056",0,0,1,1,"dummy"
"171057",0,1,1,2,"dummy"
"171058",0,0,0,0,"dummy"
"171059",0,0,1,1,"dummy"
"171060",0,0,0,0,"dummy"
"171061",0,0,0,0,"dummy"
"171062",0,1,0,1,"dummy"
"171063",0,0,1,1,"dummy"
"171064",0,0,1,1,"dummy"
"171065",0,6,1,7,"dummy"
"171066",6,0,1,7,"dummy"
"171067",0,1,0,1,"dummy"
"171068",0,3,1,4,"dummy"
"171069",0,0,0,0,"dummy"
"171070",0,1,0,1,"dummy"
"171071",2,2,2,6,"dummy"
"171072",0,7,2,9,"dummy"
"171074",0,0,1,1,"dummy"
"171087",4,21,2,27,"dummy"
"171089",0,0,3,3,"dummy"
"171099",0,1,0,1,"dummy"
"171100",0,0,2,2,"dummy"
"171101",0,0,2,2,"dummy"
"171106",12,1,0,13,"dummy"
"171107",0,0,1,1,"dummy"
"171109",1,1,0,2,"dummy"
"171119",0,1,0,1,"dummy"
"171120",0,0,1,1,"dummy"
"171126",1,2,0,3,"dummy"
"171127",0,1,3,4,"dummy"
"171128",0,0,3,3,"dummy"
"171129",0,3,0,3,"dummy"
"171130",2,2,1,5,"dummy"
"171131",0,4,1,5,"dummy"
"171132",4,0,0,4,"dummy"
"171134",2,0,4,6,"dummy"
"171137",0,2,0,2,"dummy"
"171138",0,1,0,1,"dummy"
"171139",0,1,0,1,"dummy"
"171141",0,1,2,3,"dummy"
"171142",0,0,0,0,"dummy"
"171143",0,1,0,1,"dummy"
"171144",4,0,2,6,"dummy"
"171145",1,0,0,1,"dummy"
"171146",0,0,0,0,"dummy"
"171151",0,4,0,4,"dummy"
"171152",1,9,1,11,"dummy"
"171153",0,0,0,0,"dummy"
"171154",0,0,1,1,"dummy"
"171155",0,0,3,3,"dummy"
"171157",0,0,1,1,"dummy"
"171158",1,0,1,2,"dummy"
"171159",0,0,1,1,"dummy"
"171160",0,0,3,3,"dummy"
"171161",0,9,4,13,"dummy"
"171162",0,0,3,3,"dummy"
"171163",4,0,0,4,"dummy"
"171164",1,7,5,13,"dummy"
"171165",0,0,2,2,"dummy"
"171166",0,0,1,1,"dummy"
"171167",0,0,2,2,"dummy"
"171168",0,1,0,1,"dummy"
"171169",1,0,1,2,"dummy"
"171170",6,0,0,6,"dummy"
"171171",0,0,1,1,"dummy"
"171172",0,0,1,1,"dummy"
"171173",0,0,3,3,"dummy"
"171174",5,2,1,8,"dummy"
"171175",0,0,1,1,"dummy"
"171176",0,1,0,1,"dummy"
"171183",0,0,1,1,"dummy"
"171185",33,0,2,35,"dummy"
"171186",2,0,0,2,"dummy"
"171187",0,0,1,1,"dummy"
"171188",0,1,0,1,"dummy"
"171189",5,4,1,10,"dummy"
"171190",0,0,1,1,"dummy"
"171191",2,1,0,3,"dummy"
"171192",0,1,0,1,"dummy"
"171193",0,0,0,0,"dummy"
"171194",0,1,0,1,"dummy"
"171195",0,0,0,0,"dummy"
"171196",13,5,0,18,"dummy"
"171197",0,0,1,1,"dummy"
"171198",0,0,1,1,"dummy"
"171199",0,0,1,1,"dummy"
"171200",2,2,0,4,"dummy"
"171201",0,0,0,0,"dummy"
"171202",0,3,0,3,"dummy"
"171204",0,1,0,1,"dummy"
"171208",0,1,0,1,"dummy"
"171211",0,1,0,1,"dummy"
"171212",17,0,3,20,"dummy"
"171213",0,0,1,1,"dummy"
"171214",0,0,0,0,"dummy"
"171215",1,0,0,1,"dummy"
"171216",0,0,1,1,"dummy"
"171217",1,0,1,2,"dummy"
"171218",2,0,0,2,"dummy"
"171219",0,0,2,2,"dummy"
"171220",0,0,0,0,"dummy"
"171221",0,0,2,2,"dummy"
"171222",0,0,0,0,"dummy"
"171223",0,0,1,1,"dummy"
"171224",0,0,1,1,"dummy"
"171225",0,1,0,1,"dummy"
"171226",1,0,0,1,"dummy"
"171227",0,3,0,3,"dummy"
"171228",0,1,0,1,"dummy"
"171229",0,0,0,0,"dummy"
"171230",0,0,0,0,"dummy"
"171231",0,0,1,1,"dummy"
"171232",0,1,0,1,"dummy"
"171233",1,0,2,3,"dummy"
"171234",0,0,1,1,"dummy"
"171235",0,0,1,1,"dummy"
"171236",0,0,1,1,"dummy"
"171237",0,4,0,4,"dummy"
"171238",0,0,2,2,"dummy"
"171242",0,0,0,0,"dummy"
"171244",0,3,0,3,"dummy"
"171245",2,2,4,8,"dummy"
"171247",2,3,0,5,"dummy"
"171248",1,3,0,4,"dummy"
"171249",0,0,0,0,"dummy"
"171250",0,1,0,1,"dummy"
"171251",1,0,1,2,"dummy"
"171252",3,1,0,4,"dummy"
"171253",1,3,0,4,"dummy"
"171254",0,1,0,1,"dummy"
"171255",0,0,0,0,"dummy"
"171268",0,1,0,1,"dummy"
"171269",0,0,1,1,"dummy"
"171270",0,0,1,1,"dummy"
"171271",0,1,0,1,"dummy"
"171272",0,0,1,1,"dummy"
"171273",3,2,0,5,"dummy"
"171295",0,2,1,3,"dummy"
"171296",2,33,2,37,"dummy"
"171297",0,0,3,3,"dummy"
"171298",0,2,1,3,"dummy"
"171299",0,3,2,5,"dummy"
"171300",0,3,0,3,"dummy"
"171301",0,0,2,2,"dummy"
"171310",1,0,0,1,"dummy"
"171311",0,1,0,1,"dummy"
"171312",0,1,0,1,"dummy"
"171313",1,1,0,2,"dummy"
"171314",0,21,1,22,"dummy"
"171315",0,6,0,6,"dummy"
"171316",1,3,0,4,"dummy"
"171317",0,3,0,3,"dummy"
"171318",2,5,0,7,"dummy"
"171319",0,2,0,2,"dummy"
"171320",1,0,0,1,"dummy"
"171321",0,1,0,1,"dummy"
"171322",0,8,1,9,"dummy"
"171323",0,2,0,2,"dummy"
"171324",0,1,0,1,"dummy"
"171325",0,1,0,1,"dummy"
"171326",0,0,1,1,"dummy"
"171327",0,0,0,0,"dummy"
"171328",0,1,0,1,"dummy"
"171329",0,3,0,3,"dummy"
"171330",2,1,1,4,"dummy"
"171331",5,3,0,8,"dummy"
"171332",0,2,2,4,"dummy"
"171333",0,2,0,2,"dummy"
"171334",0,4,0,4,"dummy"
"171335",2,2,0,4,"dummy"
"171336",0,1,0,1,"dummy"
"171337",0,1,0,1,"dummy"
"171338",1,2,1,4,"dummy"
"171339",0,3,0,3,"dummy"
"171341",3,1,2,6,"dummy"
"171342",0,1,0,1,"dummy"
"171347",4,22,1,27,"dummy"
"171352",5,5,0,10,"dummy"
"171353",0,2,0,2,"dummy"
"171354",0,1,0,1,"dummy"
"171355",0,1,0,1,"dummy"
"171356",0,5,0,5,"dummy"
"171357",2,0,1,3,"dummy"
"171358",0,0,1,1,"dummy"
"171359",0,0,1,1,"dummy"
"171361",0,1,0,1,"dummy"
"171363",0,2,1,3,"dummy"
"171368",0,0,0,0,"dummy"
"171369",0,0,0,0,"dummy"
"171370",0,0,0,0,"dummy"
"171381",1,1,0,2,"dummy"
"171382",0,1,0,1,"dummy"
"171383",0,1,0,1,"dummy"
"171384",0,0,1,1,"dummy"
"171385",0,0,1,1,"dummy"
"171386",0,1,1,2,"dummy"
"171387",0,0,1,1,"dummy"
"171388",0,0,3,3,"dummy"
"171389",0,0,1,1,"dummy"
"171391",1,1,0,2,"dummy"
"171392",0,0,2,2,"dummy"
"171393",1,0,0,1,"dummy"
"171395",1,9,0,10,"dummy"
"171397",7,0,3,10,"dummy"
"171398",8,1,0,9,"dummy"
"171399",0,1,0,1,"dummy"
"171400",10,3,0,13,"dummy"
"171401",0,1,0,1,"dummy"
"171402",0,1,0,1,"dummy"
"171403",1,0,0,1,"dummy"
"171404",2,14,0,16,"dummy"
"171409",3,3,0,6,"dummy"
"171410",0,1,0,1,"dummy"
"171411",0,1,0,1,"dummy"
"171412",0,0,2,2,"dummy"
"171413",0,0,0,0,"dummy"
"171414",0,0,0,0,"dummy"
"171415",7,13,1,21,"dummy"
"171416",10,2,1,13,"dummy"
"171417",0,1,0,1,"dummy"
"171422",0,0,1,1,"dummy"
"171423",0,0,1,1,"dummy"
"171424",0,1,1,2,"dummy"
"171425",0,0,1,1,"dummy"
"171426",0,0,2,2,"dummy"
"171427",0,0,1,1,"dummy"
"171428",0,0,2,2,"dummy"
"171429",0,0,1,1,"dummy"
"171430",0,0,1,1,"dummy"
"171431",0,0,1,1,"dummy"
"171433",0,1,0,1,"dummy"
"171434",0,0,0,0,"dummy"
"171441",1,2,1,4,"dummy"
"171442",0,1,0,1,"dummy"
"171443",0,0,1,1,"dummy"
"171445",1,0,0,1,"dummy"
"171447",2,5,0,7,"dummy"
"171448",0,0,2,2,"dummy"
"171451",0,10,0,10,"dummy"
"171452",0,3,0,3,"dummy"
"171453",1,3,1,5,"dummy"
"171455",11,6,3,20,"dummy"
"171456",6,15,3,24,"dummy"
"171458",0,0,0,0,"dummy"
"171459",0,0,1,1,"dummy"
"171464",1,2,1,4,"dummy"
"171465",0,0,0,0,"dummy"
"171466",0,0,0,0,"dummy"
"171467",0,0,0,0,"dummy"
"171468",0,0,0,0,"dummy"
"171469",1,0,0,1,"dummy"
"171470",0,0,0,0,"dummy"
"171471",0,0,0,0,"dummy"
"171472",0,0,0,0,"dummy"
"171473",0,0,0,0,"dummy"
"171474",0,0,0,0,"dummy"
"171475",0,0,0,0,"dummy"
"171476",0,0,0,0,"dummy"
"171477",0,0,0,0,"dummy"
"171478",0,0,0,0,"dummy"
"171479",0,0,0,0,"dummy"
"171480",0,0,0,0,"dummy"
"171481",0,0,0,0,"dummy"
"171482",0,0,0,0,"dummy"
"171484",0,0,1,1,"dummy"
"171485",0,0,0,0,"dummy"
"171489",0,0,1,1,"dummy"
"171493",1,19,5,25,"dummy"
"171496",0,0,1,1,"dummy"
"171497",0,2,0,2,"dummy"
"171499",4,5,2,11,"dummy"
"171500",0,1,0,1,"dummy"
"171501",1,0,0,1,"dummy"
"171502",0,3,0,3,"dummy"
"171503",0,0,1,1,"dummy"
"171504",0,3,0,3,"dummy"
"171505",0,0,2,2,"dummy"
"171509",0,0,1,1,"dummy"
"171510",1,1,0,2,"dummy"
"171511",0,1,0,1,"dummy"
"171512",0,1,0,1,"dummy"
"171513",0,2,0,2,"dummy"
"171514",1,0,1,2,"dummy"
"171515",1,2,1,4,"dummy"
"171516",0,0,2,2,"dummy"
"171518",0,2,0,2,"dummy"
"171519",2,2,0,4,"dummy"
"171520",0,1,0,1,"dummy"
"171521",0,1,0,1,"dummy"
"171522",0,1,0,1,"dummy"
"171524",0,1,0,1,"dummy"
"171527",0,0,1,1,"dummy"
"171528",7,2,1,10,"dummy"
"171529",0,1,1,2,"dummy"
"171530",1,5,2,8,"dummy"
"171531",6,4,0,10,"dummy"
"171532",0,0,1,1,"dummy"
"171533",3,1,0,4,"dummy"
"171534",0,0,0,0,"dummy"
"171535",0,1,0,1,"dummy"
"171536",0,0,1,1,"dummy"
"171537",0,0,0,0,"dummy"
"171539",13,1,0,14,"dummy"
"171540",2,0,0,2,"dummy"
"171541",1,2,0,3,"dummy"
"171545",0,0,1,1,"dummy"
"171552",0,1,0,1,"dummy"
"171553",0,2,1,3,"dummy"
"171554",1,0,0,1,"dummy"
"171555",0,0,1,1,"dummy"
"171556",1,1,0,2,"dummy"
"171557",1,0,1,2,"dummy"
"171558",17,4,0,21,"dummy"
"171559",1,0,1,2,"dummy"
"171560",2,5,2,9,"dummy"
"171565",24,6,2,32,"dummy"
"171591",0,1,1,2,"dummy"
"171592",0,0,1,1,"dummy"
"171596",0,0,1,1,"dummy"
"171604",0,1,0,1,"dummy"
"171613",0,0,1,1,"dummy"
"171614",0,0,1,1,"dummy"
"171615",0,0,1,1,"dummy"
"171619",0,0,1,1,"dummy"
"171621",0,1,0,1,"dummy"
"171622",2,12,0,14,"dummy"
"171624",0,3,0,3,"dummy"
"171625",1,2,0,3,"dummy"
"171627",0,1,0,1,"dummy"
"171629",0,2,0,2,"dummy"
"171630",0,5,0,5,"dummy"
"171631",3,0,0,3,"dummy"
"171634",0,2,1,3,"dummy"
"171638",0,3,0,3,"dummy"
"171639",1,5,1,7,"dummy"
"171642",0,0,0,0,"dummy"
"171643",0,0,1,1,"dummy"
"171644",3,2,0,5,"dummy"
"171645",0,0,1,1,"dummy"
"171646",3,10,0,13,"dummy"
"171647",0,0,0,0,"dummy"
"171648",0,0,0,0,"dummy"
"171649",0,0,2,2,"dummy"
"171650",4,1,0,5,"dummy"
"171651",1,0,0,1,"dummy"
"171652",0,0,0,0,"dummy"
"171653",0,0,0,0,"dummy"
"171654",3,0,0,3,"dummy"
"171656",0,3,2,5,"dummy"
"171657",0,6,0,6,"dummy"
"171661",2,6,7,15,"dummy"
"171662",3,2,1,6,"dummy"
"171663",0,1,0,1,"dummy"
"171664",0,11,0,11,"dummy"
"171665",2,0,2,4,"dummy"
"171666",0,0,0,0,"dummy"
"171673",0,0,3,3,"dummy"
"171674",0,0,3,3,"dummy"
"171675",0,0,0,0,"dummy"
"171676",0,0,0,0,"dummy"
"171681",0,2,0,2,"dummy"
"171682",0,0,1,1,"dummy"
"171683",0,1,0,1,"dummy"
"171684",0,3,0,3,"dummy"
"171685",0,0,1,1,"dummy"
"171686",0,1,0,1,"dummy"
"171689",2,6,2,10,"dummy"
"171690",0,15,3,18,"dummy"
"171691",0,4,7,11,"dummy"
"171692",5,34,3,42,"dummy"
"171693",4,0,3,7,"dummy"
"171694",0,0,1,1,"dummy"
"171695",3,10,1,14,"dummy"
"171696",0,0,1,1,"dummy"
"171697",0,0,0,0,"dummy"
"171698",0,1,1,2,"dummy"
"171699",0,0,1,1,"dummy"
"171700",3,15,3,21,"dummy"
"171701",25,12,7,44,"dummy"
"171702",0,4,3,7,"dummy"
"171703",5,3,0,8,"dummy"
"171704",1,0,0,1,"dummy"
"171705",0,1,0,1,"dummy"
"171706",0,2,0,2,"dummy"
"171707",0,5,1,6,"dummy"
"171708",7,2,0,9,"dummy"
"171709",0,2,0,2,"dummy"
"171710",4,3,1,8,"dummy"
"171711",1,0,0,1,"dummy"
"171712",23,4,1,28,"dummy"
"171713",0,7,0,7,"dummy"
"171714",1,0,0,1,"dummy"
"171715",6,0,0,6,"dummy"
"171716",4,4,7,15,"dummy"
"171717",4,10,7,21,"dummy"
"171718",7,4,11,22,"dummy"
"171719",2,2,0,4,"dummy"
"171720",2,5,6,13,"dummy"
"171721",0,0,1,1,"dummy"
"171722",0,0,0,0,"dummy"
"171723",1,0,0,1,"dummy"
"171724",0,2,1,3,"dummy"
"171725",2,2,0,4,"dummy"
"171726",3,2,0,5,"dummy"
"171727",0,1,1,2,"dummy"
"171728",1,0,0,1,"dummy"
"171729",2,3,0,5,"dummy"
"171730",0,0,1,1,"dummy"
"171731",0,0,1,1,"dummy"
"171732",0,0,1,1,"dummy"
"171733",1,0,0,1,"dummy"
"171734",0,0,0,0,"dummy"
"171735",0,1,0,1,"dummy"
"171736",0,4,0,4,"dummy"
"171739",2,4,2,8,"dummy"
"171741",0,1,0,1,"dummy"
"171744",0,0,0,0,"dummy"
"171745",2,5,0,7,"dummy"
"171746",0,0,1,1,"dummy"
"171752",0,13,0,13,"dummy"
"171753",0,0,1,1,"dummy"
"171754",0,2,1,3,"dummy"
"171755",0,23,0,23,"dummy"
"171756",0,1,0,1,"dummy"
"171757",0,2,0,2,"dummy"
"171758",1,4,0,5,"dummy"
"171759",0,2,0,2,"dummy"
"171760",0,7,0,7,"dummy"
"171761",3,4,1,8,"dummy"
"171762",2,0,0,2,"dummy"
"171763",2,6,0,8,"dummy"
"171764",0,0,1,1,"dummy"
"171765",3,0,0,3,"dummy"
"171766",39,0,0,39,"dummy"
"171771",6,5,1,12,"dummy"
"171772",0,0,1,1,"dummy"
"171775",11,30,4,45,"dummy"
"171776",0,0,2,2,"dummy"
"171777",0,0,2,2,"dummy"
"171779",0,1,1,2,"dummy"
"171780",1,1,0,2,"dummy"
"171781",0,0,0,0,"dummy"
"171784",1,1,0,2,"dummy"
"171788",0,6,0,6,"dummy"
"171792",0,0,1,1,"dummy"
"171794",0,0,0,0,"dummy"
"171795",4,6,1,11,"dummy"
"171798",8,0,0,8,"dummy"
"171799",4,2,0,6,"dummy"
"171800",0,0,1,1,"dummy"
"171801",0,2,0,2,"dummy"
"171802",1,1,1,3,"dummy"
"171803",0,2,0,2,"dummy"
"171804",0,0,1,1,"dummy"
"171805",0,1,2,3,"dummy"
"171806",0,2,2,4,"dummy"
"171807",0,0,1,1,"dummy"
"171808",0,0,1,1,"dummy"
"171809",6,0,0,6,"dummy"
"171810",5,4,1,10,"dummy"
"171813",0,1,2,3,"dummy"
"171816",3,4,0,7,"dummy"
"171817",0,1,0,1,"dummy"
"171818",0,1,0,1,"dummy"
"171819",0,2,0,2,"dummy"
"171820",2,0,0,2,"dummy"
"171821",8,23,1,32,"dummy"
"171822",0,1,1,2,"dummy"
"171823",0,0,0,0,"dummy"
"171824",4,1,0,5,"dummy"
"171828",0,10,0,10,"dummy"
"171829",2,10,3,15,"dummy"
"171830",0,1,0,1,"dummy"
"171831",6,6,2,14,"dummy"
"171832",0,1,0,1,"dummy"
"171834",4,0,0,4,"dummy"
"171836",0,0,0,0,"dummy"
"171837",5,0,2,7,"dummy"
"171838",0,0,0,0,"dummy"
"171847",0,3,0,3,"dummy"
"171848",0,0,1,1,"dummy"
"171849",0,4,0,4,"dummy"
"171850",1,0,0,1,"dummy"
"171852",0,0,1,1,"dummy"
"171853",0,0,0,0,"dummy"
"171854",0,0,0,0,"dummy"
"171855",0,0,1,1,"dummy"
"171858",0,1,0,1,"dummy"
"171859",0,0,0,0,"dummy"
"171860",0,0,0,0,"dummy"
"171861",0,0,0,0,"dummy"
"171862",0,0,0,0,"dummy"
"171863",0,0,0,0,"dummy"
"171864",0,0,0,0,"dummy"
"171865",0,0,0,0,"dummy"
"171866",0,0,0,0,"dummy"
"171867",0,0,0,0,"dummy"
"171868",0,0,0,0,"dummy"
"171869",0,1,3,4,"dummy"
"171870",2,3,0,5,"dummy"
"171871",0,0,1,1,"dummy"
"171873",0,1,3,4,"dummy"
"171879",4,4,0,8,"dummy"
"171880",0,0,3,3,"dummy"
"171881",0,0,2,2,"dummy"
"171882",0,0,2,2,"dummy"
"171883",0,0,2,2,"dummy"
"171884",0,0,2,2,"dummy"
"171885",0,0,2,2,"dummy"
"171886",10,14,7,31,"dummy"
"171900",0,0,1,1,"dummy"
"171901",0,0,1,1,"dummy"
"171911",0,0,1,1,"dummy"
"171914",0,7,2,9,"dummy"
"171915",0,0,1,1,"dummy"
"171916",0,0,1,1,"dummy"
"171919",6,0,0,6,"dummy"
"171920",2,5,2,9,"dummy"
"171938",0,2,3,5,"dummy"
"171939",1,4,1,6,"dummy"
"171941",10,8,3,21,"dummy"
"171942",0,0,1,1,"dummy"
"171944",5,6,0,11,"dummy"
"171948",0,7,0,7,"dummy"
"171949",0,1,0,1,"dummy"
"171950",1,4,1,6,"dummy"
"171951",0,0,1,1,"dummy"
"171952",0,1,0,1,"dummy"
"171953",0,1,0,1,"dummy"
"171954",0,4,0,4,"dummy"
"171958",0,2,0,2,"dummy"
"171959",0,1,0,1,"dummy"
"171960",1,0,0,1,"dummy"
"171961",0,0,2,2,"dummy"
"171962",6,12,3,21,"dummy"
"171963",0,3,1,4,"dummy"
"171964",2,2,0,4,"dummy"
"171965",8,1,5,14,"dummy"
"171966",0,0,1,1,"dummy"
"171967",0,0,0,0,"dummy"
"171968",8,5,0,13,"dummy"
"171969",0,0,0,0,"dummy"
"171970",0,0,0,0,"dummy"
"171971",0,0,0,0,"dummy"
"171972",0,0,0,0,"dummy"
"171973",2,2,0,4,"dummy"
"171974",0,0,0,0,"dummy"
"171975",0,1,0,1,"dummy"
"171976",0,1,0,1,"dummy"
"171977",0,0,1,1,"dummy"
"171978",7,1,0,8,"dummy"
"171979",2,0,0,2,"dummy"
"171980",2,1,0,3,"dummy"
"171981",0,0,1,1,"dummy"
"171982",2,2,0,4,"dummy"
"171983",0,0,1,1,"dummy"
"171984",0,0,2,2,"dummy"
"171985",0,0,1,1,"dummy"
"171986",2,2,1,5,"dummy"
"171987",2,2,1,5,"dummy"
"171988",0,0,0,0,"dummy"
"171989",0,0,1,1,"dummy"
"171990",0,0,1,1,"dummy"
"171991",0,0,1,1,"dummy"
"171992",0,0,1,1,"dummy"
"171993",2,2,0,4,"dummy"
"171994",0,2,0,2,"dummy"
"171995",0,4,1,5,"dummy"
"171996",0,0,1,1,"dummy"
"171997",0,0,1,1,"dummy"
"171998",0,9,0,9,"dummy"
"171999",9,0,0,9,"dummy"
"172000",0,0,1,1,"dummy"
"172001",1,3,0,4,"dummy"
"172002",0,0,1,1,"dummy"
"172003",0,1,0,1,"dummy"
"172006",0,0,1,1,"dummy"
"172007",1,1,0,2,"dummy"
"172008",1,0,1,2,"dummy"
"172009",0,0,1,1,"dummy"
"172010",0,4,2,6,"dummy"
"172011",4,0,2,6,"dummy"
"172012",0,1,0,1,"dummy"
"172013",0,4,2,6,"dummy"
"172014",0,0,1,1,"dummy"
"172015",0,0,0,0,"dummy"
"172016",7,6,0,13,"dummy"
"172017",1,0,0,1,"dummy"
"172018",1,0,0,1,"dummy"
"172019",0,0,0,0,"dummy"
"172020",0,0,0,0,"dummy"
"172027",0,2,0,2,"dummy"
"172028",0,1,0,1,"dummy"
"172029",3,2,1,6,"dummy"
"172031",0,0,0,0,"dummy"
"172032",0,3,0,3,"dummy"
"172033",0,0,1,1,"dummy"
"172034",0,0,0,0,"dummy"
"172036",0,0,1,1,"dummy"
"172038",0,0,3,3,"dummy"
"172040",0,0,0,0,"dummy"
"172044",12,15,3,30,"dummy"
"172048",0,0,1,1,"dummy"
"172049",0,0,1,1,"dummy"
"172050",0,0,1,1,"dummy"
"172052",3,3,1,7,"dummy"
"172053",0,3,0,3,"dummy"
"172056",0,0,1,1,"dummy"
"172070",0,2,0,2,"dummy"
"172071",0,0,1,1,"dummy"
"172075",0,0,1,1,"dummy"
"172080",0,0,1,1,"dummy"
"172081",0,15,0,15,"dummy"
"172082",0,0,2,2,"dummy"
"172083",2,2,1,5,"dummy"
"172084",0,0,1,1,"dummy"
"172086",2,0,3,5,"dummy"
"172088",0,0,1,1,"dummy"
"172090",15,16,1,32,"dummy"
"172091",0,0,0,0,"dummy"
"172093",0,7,0,7,"dummy"
"172094",2,2,0,4,"dummy"
"172095",0,0,5,5,"dummy"
"172096",0,0,0,0,"dummy"
"172097",0,0,0,0,"dummy"
"172098",0,0,0,0,"dummy"
"172099",0,0,0,0,"dummy"
"172100",0,1,0,1,"dummy"
"172101",0,2,4,6,"dummy"
"172102",1,0,0,1,"dummy"
"172105",2,0,2,4,"dummy"
"172107",5,3,0,8,"dummy"
"172109",0,2,1,3,"dummy"
"172111",0,2,0,2,"dummy"
"172112",0,1,0,1,"dummy"
"172114",1,0,0,1,"dummy"
"172115",0,0,0,0,"dummy"
"172116",0,0,0,0,"dummy"
"172124",0,4,0,4,"dummy"
"172125",13,6,0,19,"dummy"
"172126",0,4,0,4,"dummy"
"172128",0,0,1,1,"dummy"
"172129",1,0,0,1,"dummy"
"172130",0,0,1,1,"dummy"
"172131",0,0,1,1,"dummy"
"172132",0,0,1,1,"dummy"
"172133",0,3,0,3,"dummy"
"172134",0,1,0,1,"dummy"
"172135",0,0,1,1,"dummy"
"172136",0,0,1,1,"dummy"
"172139",2,0,1,3,"dummy"
"172140",0,0,1,1,"dummy"
"172142",0,1,0,1,"dummy"
"172144",2,2,0,4,"dummy"
"172145",0,1,0,1,"dummy"
"172146",0,1,0,1,"dummy"
"172147",0,3,0,3,"dummy"
"172148",7,0,0,7,"dummy"
"172149",0,7,0,7,"dummy"
"172150",0,0,1,1,"dummy"
"172151",0,2,0,2,"dummy"
"172152",1,0,0,1,"dummy"
"172153",7,0,3,10,"dummy"
"172154",1,0,0,1,"dummy"
"172156",0,3,1,4,"dummy"
"172157",4,1,3,8,"dummy"
"172158",1,0,0,1,"dummy"
"172159",0,2,0,2,"dummy"
"172160",0,3,1,4,"dummy"
"172161",3,1,0,4,"dummy"
"172162",0,8,0,8,"dummy"
"172163",0,1,0,1,"dummy"
"172164",2,0,1,3,"dummy"
"172165",6,1,3,10,"dummy"
"172166",0,1,0,1,"dummy"
"172168",0,0,1,1,"dummy"
"172169",0,0,1,1,"dummy"
"172170",1,2,0,3,"dummy"
"172171",0,0,2,2,"dummy"
"172173",0,0,0,0,"dummy"
"172180",0,0,2,2,"dummy"
"172184",0,2,0,2,"dummy"
"172185",0,4,0,4,"dummy"
"172186",0,0,0,0,"dummy"
"172187",2,1,0,3,"dummy"
"172188",0,7,0,7,"dummy"
"172189",6,8,1,15,"dummy"
"172190",0,1,0,1,"dummy"
"172192",0,0,1,1,"dummy"
"172193",4,4,0,8,"dummy"
"172195",0,0,1,1,"dummy"
"172196",0,0,1,1,"dummy"
"172197",0,0,1,1,"dummy"
"172198",1,2,0,3,"dummy"
"172199",0,0,1,1,"dummy"
"172200",0,0,1,1,"dummy"
"172201",1,2,0,3,"dummy"
"172202",2,1,1,4,"dummy"
"172203",1,2,0,3,"dummy"
"172204",0,0,1,1,"dummy"
"172205",0,1,0,1,"dummy"
"172206",0,1,0,1,"dummy"
"172207",2,0,1,3,"dummy"
"172208",1,1,0,2,"dummy"
"172209",0,0,1,1,"dummy"
"172210",0,0,1,1,"dummy"
"172211",0,0,1,1,"dummy"
"172212",0,0,1,1,"dummy"
"172213",0,0,0,0,"dummy"
"172214",0,1,0,1,"dummy"
"172215",0,1,0,1,"dummy"
"172217",0,2,0,2,"dummy"
"172218",0,3,0,3,"dummy"
"172219",0,0,0,0,"dummy"
"172220",0,1,0,1,"dummy"
"172221",0,1,0,1,"dummy"
"172222",0,0,0,0,"dummy"
"172223",0,5,0,5,"dummy"
"172224",0,8,0,8,"dummy"
"172225",7,0,1,8,"dummy"
"172226",0,2,0,2,"dummy"
"172227",13,1,2,16,"dummy"
"172228",0,1,0,1,"dummy"
"172229",0,1,0,1,"dummy"
"172230",0,3,0,3,"dummy"
"172231",1,3,1,5,"dummy"
"172232",0,4,0,4,"dummy"
"172251",0,0,1,1,"dummy"
"172252",0,5,0,5,"dummy"
"172253",0,3,0,3,"dummy"
"172254",5,0,0,5,"dummy"
"172257",0,1,0,1,"dummy"
"172258",0,3,0,3,"dummy"
"172259",16,16,1,33,"dummy"
"172260",2,13,0,15,"dummy"
"172261",15,15,1,31,"dummy"
"172262",0,1,0,1,"dummy"
"172263",0,2,3,5,"dummy"
"172264",0,1,0,1,"dummy"
"172268",0,1,0,1,"dummy"
"172292",3,12,0,15,"dummy"
"172293",5,3,3,11,"dummy"
"172294",0,1,0,1,"dummy"
"172295",2,3,0,5,"dummy"
"172298",0,0,0,0,"dummy"
"172299",0,0,3,3,"dummy"
"172302",0,1,0,1,"dummy"
"172303",3,0,0,3,"dummy"
"172304",0,0,1,1,"dummy"
"172306",0,2,0,2,"dummy"
"172307",0,1,0,1,"dummy"
"172310",4,5,3,12,"dummy"
"172311",2,1,1,4,"dummy"
"172312",7,0,1,8,"dummy"
"172313",0,3,0,3,"dummy"
"172315",0,1,0,1,"dummy"
"172330",0,0,0,0,"dummy"
"172335",0,0,0,0,"dummy"
"172336",0,0,1,1,"dummy"
"172337",0,0,0,0,"dummy"
"172338",0,0,1,1,"dummy"
"172339",0,0,0,0,"dummy"
"172340",0,0,0,0,"dummy"
"172343",0,1,0,1,"dummy"
"172344",0,0,0,0,"dummy"
"172345",0,0,1,1,"dummy"
"172355",1,9,1,11,"dummy"
"172356",0,1,0,1,"dummy"
"172357",0,2,0,2,"dummy"
"172358",0,0,1,1,"dummy"
"172359",0,0,3,3,"dummy"
"172360",2,0,0,2,"dummy"
"172361",0,1,0,1,"dummy"
"172362",0,1,0,1,"dummy"
"172363",1,2,0,3,"dummy"
"172364",1,0,0,1,"dummy"
"172365",0,0,1,1,"dummy"
"172366",2,2,0,4,"dummy"
"172369",0,0,3,3,"dummy"
"172370",0,0,3,3,"dummy"
"172371",0,0,1,1,"dummy"
"172372",0,2,1,3,"dummy"
"172373",0,0,1,1,"dummy"
"172374",0,0,4,4,"dummy"
"172375",0,0,4,4,"dummy"
"172382",0,3,0,3,"dummy"
"172383",0,0,1,1,"dummy"
"172384",0,0,1,1,"dummy"
"172385",0,2,0,2,"dummy"
"172386",0,6,0,6,"dummy"
"172388",0,0,1,1,"dummy"
"172396",4,7,9,20,"dummy"
"172397",0,0,0,0,"dummy"
"172398",0,4,0,4,"dummy"
"172399",0,5,0,5,"dummy"
"172400",0,2,0,2,"dummy"
"172401",1,3,2,6,"dummy"
"172405",0,2,0,2,"dummy"
"172406",0,0,0,0,"dummy"
"172411",11,29,6,46,"dummy"
"172412",1,0,1,2,"dummy"
"172413",4,21,1,26,"dummy"
"172414",29,7,4,40,"dummy"
"172415",0,1,0,1,"dummy"
"172417",0,6,3,9,"dummy"
"172418",0,3,0,3,"dummy"
"172434",4,9,0,13,"dummy"
"172436",2,0,3,5,"dummy"
"172439",1,8,0,9,"dummy"
"172444",1,5,1,7,"dummy"
"172446",0,0,0,0,"dummy"
"172447",0,0,0,0,"dummy"
"172448",0,0,0,0,"dummy"
"172449",0,0,0,0,"dummy"
"172450",0,0,0,0,"dummy"
"172451",0,0,1,1,"dummy"
"172452",0,0,0,0,"dummy"
"172453",0,0,2,2,"dummy"
"172454",0,0,0,0,"dummy"
"172455",0,0,0,0,"dummy"
"172456",0,0,0,0,"dummy"
"172457",0,0,0,0,"dummy"
"172458",0,0,0,0,"dummy"
"172459",0,0,0,0,"dummy"
"172460",0,0,0,0,"dummy"
"172461",0,0,0,0,"dummy"
"172462",0,0,0,0,"dummy"
"172463",0,0,0,0,"dummy"
"172466",5,4,2,11,"dummy"
"172467",0,0,0,0,"dummy"
"172468",0,0,1,1,"dummy"
"172470",0,1,0,1,"dummy"
"172475",1,0,2,3,"dummy"
"172476",0,1,0,1,"dummy"
"172477",0,2,0,2,"dummy"
"172478",1,1,0,2,"dummy"
"172479",1,0,0,1,"dummy"
"172484",0,1,0,1,"dummy"
"172485",0,0,1,1,"dummy"
"172486",0,1,0,1,"dummy"
"172487",0,0,1,1,"dummy"
"172488",0,2,1,3,"dummy"
"172489",0,1,0,1,"dummy"
"172490",2,0,1,3,"dummy"
"172491",0,0,1,1,"dummy"
"172492",0,0,1,1,"dummy"
"172573",1,4,0,5,"dummy"
"172574",0,1,0,1,"dummy"
"172575",1,0,0,1,"dummy"
"172576",0,0,1,1,"dummy"
"172577",0,0,1,1,"dummy"
"172578",0,2,0,2,"dummy"
"172579",0,1,1,2,"dummy"
"172580",2,5,0,7,"dummy"
"172583",0,0,1,1,"dummy"
"172584",0,0,1,1,"dummy"
"172585",0,1,0,1,"dummy"
"172589",0,0,1,1,"dummy"
"172591",5,3,2,10,"dummy"
"172593",0,2,0,2,"dummy"
"172595",0,0,1,1,"dummy"
"172596",0,0,1,1,"dummy"
"172597",1,1,0,2,"dummy"
"172598",1,1,0,2,"dummy"
"172599",8,2,1,11,"dummy"
"172600",0,1,0,1,"dummy"
"172601",9,10,0,19,"dummy"
"172602",0,1,0,1,"dummy"
"172603",0,1,0,1,"dummy"
"172604",2,1,0,3,"dummy"
"172605",0,0,1,1,"dummy"
"172606",0,2,0,2,"dummy"
"172607",4,0,1,5,"dummy"
"172608",0,0,1,1,"dummy"
"172609",2,0,0,2,"dummy"
"172610",11,2,1,14,"dummy"
"172611",0,1,0,1,"dummy"
"172612",0,1,0,1,"dummy"
"172613",0,0,1,1,"dummy"
"172614",1,0,1,2,"dummy"
"172615",0,0,0,0,"dummy"
"172617",4,5,3,12,"dummy"
"172618",0,0,0,0,"dummy"
"172620",0,0,3,3,"dummy"
"172621",2,2,1,5,"dummy"
"172627",3,2,0,5,"dummy"
"172628",0,1,0,1,"dummy"
"172629",0,1,1,2,"dummy"
"172630",0,3,1,4,"dummy"
"172631",0,0,3,3,"dummy"
"172632",0,0,3,3,"dummy"
"172637",18,1,1,20,"dummy"
"172639",0,1,1,2,"dummy"
"172640",0,1,0,1,"dummy"
"172643",0,3,3,6,"dummy"
"172644",3,1,2,6,"dummy"
"172645",6,6,0,12,"dummy"
"172646",0,3,0,3,"dummy"
"172647",16,2,3,21,"dummy"
"172648",0,0,0,0,"dummy"
"172649",1,0,0,1,"dummy"
"172651",0,0,2,2,"dummy"
"172656",0,0,1,1,"dummy"
"172657",1,3,1,5,"dummy"
"172658",39,5,0,44,"dummy"
"172660",3,4,0,7,"dummy"
"172661",1,3,3,7,"dummy"
"172662",0,1,0,1,"dummy"
"172663",0,0,1,1,"dummy"
"172664",0,0,1,1,"dummy"
"172666",0,0,0,0,"dummy"
"172667",0,0,1,1,"dummy"
"172668",0,1,0,1,"dummy"
"172669",17,0,3,20,"dummy"
"172671",2,9,0,11,"dummy"
"172672",2,2,0,4,"dummy"
"172673",0,1,0,1,"dummy"
"172674",0,1,0,1,"dummy"
"172675",4,0,0,4,"dummy"
"172678",0,1,0,1,"dummy"
"172679",1,0,0,1,"dummy"
"172680",0,0,0,0,"dummy"
"172681",0,0,1,1,"dummy"
"172682",0,0,2,2,"dummy"
"172683",1,5,2,8,"dummy"
"172684",4,8,0,12,"dummy"
"172685",1,1,0,2,"dummy"
"172686",0,1,1,2,"dummy"
"172687",1,2,1,4,"dummy"
"172688",3,14,1,18,"dummy"
"172689",0,1,0,1,"dummy"
"172694",5,16,2,23,"dummy"
"172695",0,2,1,3,"dummy"
"172696",3,1,2,6,"dummy"
"172697",0,0,2,2,"dummy"
"172698",0,0,1,1,"dummy"
"172712",1,0,4,5,"dummy"
"172713",1,1,0,2,"dummy"
"172714",0,1,0,1,"dummy"
"172715",0,2,0,2,"dummy"
"172716",0,0,1,1,"dummy"
"172768",1,0,3,4,"dummy"
"172769",0,3,0,3,"dummy"
"172772",0,3,0,3,"dummy"
"172786",0,1,0,1,"dummy"
"172787",4,8,0,12,"dummy"
"172788",2,6,0,8,"dummy"
"172789",2,3,0,5,"dummy"
"172790",6,7,2,15,"dummy"
"172791",2,1,0,3,"dummy"
"172792",0,0,1,1,"dummy"
"172793",1,0,0,1,"dummy"
"172794",0,0,0,0,"dummy"
"172799",0,0,1,1,"dummy"
"172803",0,0,1,1,"dummy"
"172804",1,5,1,7,"dummy"
"172805",0,0,0,0,"dummy"
"172806",0,2,0,2,"dummy"
"172807",0,0,1,1,"dummy"
"172808",4,4,0,8,"dummy"
"172809",10,12,0,22,"dummy"
"172810",0,0,6,6,"dummy"
"172811",0,0,0,0,"dummy"
"172812",1,2,0,3,"dummy"
"172813",0,4,0,4,"dummy"
"172814",0,0,0,0,"dummy"
"172844",0,0,0,0,"dummy"
"172864",0,0,1,1,"dummy"
"172871",0,0,0,0,"dummy"
"172872",0,0,1,1,"dummy"
"172873",0,0,1,1,"dummy"
"172878",0,0,0,0,"dummy"
"172879",0,2,0,2,"dummy"
"172880",0,1,2,3,"dummy"
"172881",1,0,0,1,"dummy"
"172882",0,1,0,1,"dummy"
"172883",3,0,0,3,"dummy"
"172884",0,0,3,3,"dummy"
"172888",1,3,0,4,"dummy"
"172889",7,7,0,14,"dummy"
"172893",0,2,0,2,"dummy"
"172894",4,0,0,4,"dummy"
"172899",0,0,0,0,"dummy"
"172900",0,4,1,5,"dummy"
"172901",0,0,0,0,"dummy"
"172902",0,0,0,0,"dummy"
"172903",0,3,1,4,"dummy"
"172914",0,0,2,2,"dummy"
"172915",3,1,1,5,"dummy"
"172916",0,0,2,2,"dummy"
"172917",0,0,1,1,"dummy"
"172706",0,0,1,1,"dummy"
"172718",0,2,0,2,"dummy"
"172719",0,1,0,1,"dummy"
"172722",2,2,1,5,"dummy"
"172753",8,6,1,15,"dummy"
"172756",2,2,0,4,"dummy"
"172757",0,0,1,1,"dummy"
"172758",0,3,0,3,"dummy"
"172759",1,0,0,1,"dummy"
"172760",0,2,0,2,"dummy"
"172761",0,0,1,1,"dummy"
"172762",0,1,0,1,"dummy"
"172763",0,1,0,1,"dummy"
"172764",0,0,1,1,"dummy"
"172765",0,1,1,2,"dummy"
"172766",1,1,0,2,"dummy"
"172774",2,0,0,2,"dummy"
"172775",0,0,1,1,"dummy"
"172776",1,3,0,4,"dummy"
"172777",2,2,1,5,"dummy"
"172778",1,2,0,3,"dummy"
"172779",1,1,0,2,"dummy"
"172780",0,2,1,3,"dummy"
"172781",1,0,0,1,"dummy"
"172784",0,0,1,1,"dummy"
"172801",11,17,5,33,"dummy"
"172816",0,1,0,1,"dummy"
"172817",0,1,1,2,"dummy"
"172818",1,0,0,1,"dummy"
"172819",0,1,0,1,"dummy"
"172820",2,0,0,2,"dummy"
"172821",0,3,0,3,"dummy"
"172822",1,2,0,3,"dummy"
"172823",8,1,1,10,"dummy"
"172824",3,1,0,4,"dummy"
"172825",7,2,1,10,"dummy"
"172826",0,2,0,2,"dummy"
"172837",1,0,0,1,"dummy"
"172846",0,0,4,4,"dummy"
"172847",0,0,4,4,"dummy"
"172848",0,0,1,1,"dummy"
"172849",0,0,1,1,"dummy"
"172850",0,0,2,2,"dummy"
"172853",3,11,2,16,"dummy"
"172866",1,1,1,3,"dummy"
"172867",4,5,4,13,"dummy"
"172875",0,1,0,1,"dummy"
"172876",1,1,0,2,"dummy"
"172886",0,5,3,8,"dummy"
"172891",0,0,1,1,"dummy"
"172896",5,5,1,11,"dummy"
"172897",1,0,0,1,"dummy"
"172905",3,0,0,3,"dummy"
"172906",0,1,0,1,"dummy"
"172907",0,2,0,2,"dummy"
"172908",0,1,1,2,"dummy"
"172909",0,1,0,1,"dummy"
"172910",0,0,1,1,"dummy"
"172919",0,6,2,8,"dummy"
"172920",0,1,0,1,"dummy"
"172921",0,0,4,4,"dummy"
"172922",0,1,0,1,"dummy"
"172923",0,0,1,1,"dummy"
"172924",0,0,1,1,"dummy"
"172925",0,0,1,1,"dummy"
"172926",0,0,1,1,"dummy"
"172929",2,2,0,4,"dummy"
"172930",0,0,1,1,"dummy"
"172931",0,1,0,1,"dummy"
"172932",0,0,2,2,"dummy"
"172933",0,0,1,1,"dummy"
"172960",11,17,1,29,"dummy"
"172961",14,5,0,19,"dummy"
"172962",0,1,3,4,"dummy"
"172963",1,0,3,4,"dummy"
"172964",0,0,3,3,"dummy"
"172965",0,0,3,3,"dummy"
"172966",0,36,0,36,"dummy"
"172967",36,0,0,36,"dummy"
"172968",0,2,0,2,"dummy"
"172969",0,0,1,1,"dummy"
"172970",2,0,0,2,"dummy"
"172971",1,0,1,2,"dummy"
"172972",2,2,3,7,"dummy"
"172973",0,1,1,2,"dummy"
"172974",0,0,3,3,"dummy"
"172975",2,2,3,7,"dummy"
"172976",0,1,0,1,"dummy"
"172977",0,0,0,0,"dummy"
"172978",1,0,2,3,"dummy"
"172979",0,0,2,2,"dummy"
"172980",0,1,3,4,"dummy"
"172981",0,1,0,1,"dummy"
"172984",2,2,0,4,"dummy"
"172985",3,3,0,6,"dummy"
"173014",0,0,1,1,"dummy"
"173017",0,0,1,1,"dummy"
"173018",0,1,0,1,"dummy"
"173019",0,0,1,1,"dummy"
"173029",0,2,0,2,"dummy"
"173030",0,1,0,1,"dummy"
"173035",0,3,0,3,"dummy"
"173036",0,2,0,2,"dummy"
"173042",0,0,1,1,"dummy"
"173043",0,0,0,0,"dummy"
"173047",0,0,1,1,"dummy"
"173080",2,1,0,3,"dummy"
"173081",6,0,3,9,"dummy"
"173082",0,2,0,2,"dummy"
"173083",1,5,0,6,"dummy"
"173084",2,0,0,2,"dummy"
"173085",0,1,0,1,"dummy"
"173093",2,3,1,6,"dummy"
"173094",0,1,0,1,"dummy"
"173095",0,0,0,0,"dummy"
"173096",0,0,0,0,"dummy"
"173097",0,2,0,2,"dummy"
"173098",0,0,1,1,"dummy"
"173099",0,0,1,1,"dummy"
"173102",2,4,0,6,"dummy"
"173103",0,2,0,2,"dummy"
"173104",0,2,0,2,"dummy"
"173105",10,2,0,12,"dummy"
"173106",0,2,0,2,"dummy"
"173107",0,0,0,0,"dummy"
"173110",2,2,0,4,"dummy"
"173111",0,0,1,1,"dummy"
"173123",5,2,0,7,"dummy"
"173131",0,2,1,3,"dummy"
"173135",0,0,1,1,"dummy"
"173142",1,0,0,1,"dummy"
"173148",0,6,1,7,"dummy"
"173154",0,1,0,1,"dummy"
"173157",5,0,1,6,"dummy"
"173158",0,5,0,5,"dummy"
"173159",4,0,1,5,"dummy"
"173160",0,2,0,2,"dummy"
"173161",0,0,1,1,"dummy"
"173162",0,3,0,3,"dummy"
"173163",5,1,3,9,"dummy"
"173164",3,7,1,11,"dummy"
"173165",0,2,0,2,"dummy"
"173166",0,1,0,1,"dummy"
"173167",2,0,0,2,"dummy"
"172934",0,0,1,1,"dummy"
"172935",0,0,1,1,"dummy"
"172936",0,1,0,1,"dummy"
"172937",6,6,1,13,"dummy"
"172938",0,0,1,1,"dummy"
"172941",0,0,0,0,"dummy"
"172942",0,0,1,1,"dummy"
"172943",4,8,0,12,"dummy"
"172944",1,1,0,2,"dummy"
"172945",8,3,0,11,"dummy"
"172946",0,0,1,1,"dummy"
"172947",0,1,0,1,"dummy"
"172948",0,2,0,2,"dummy"
"172949",0,0,0,0,"dummy"
"172950",0,0,0,0,"dummy"
"172951",4,0,0,4,"dummy"
"172952",0,0,0,0,"dummy"
"172953",0,0,0,0,"dummy"
"172954",0,0,2,2,"dummy"
"172955",0,0,0,0,"dummy"
"172958",0,0,1,1,"dummy"
"172987",1,0,1,2,"dummy"
"172988",0,0,2,2,"dummy"
"172989",0,0,2,2,"dummy"
"173011",0,10,0,10,"dummy"
"173012",3,8,1,12,"dummy"
"173021",1,1,0,2,"dummy"
"173024",0,3,0,3,"dummy"
"173025",0,1,0,1,"dummy"
"173026",3,2,4,9,"dummy"
"173027",2,5,0,7,"dummy"
"173063",0,0,1,1,"dummy"
"173064",4,8,5,17,"dummy"
"173067",0,7,0,7,"dummy"
"173068",0,1,1,2,"dummy"
"173071",2,0,0,2,"dummy"
"173091",3,4,1,8,"dummy"
"173127",0,5,0,5,"dummy"
"173128",0,1,0,1,"dummy"
"173129",0,1,0,1,"dummy"
"173133",0,0,2,2,"dummy"
"173137",1,0,1,2,"dummy"
"173138",0,0,1,1,"dummy"
"173144",1,1,1,3,"dummy"
"173152",0,0,1,1,"dummy"
"173171",0,0,1,1,"dummy"
"173188",0,3,2,5,"dummy"
"173191",0,4,0,4,"dummy"
"173192",0,1,3,4,"dummy"
"173193",0,0,0,0,"dummy"
"173194",1,0,1,2,"dummy"
"173195",0,1,0,1,"dummy"
"173196",3,2,3,8,"dummy"
"173197",0,1,0,1,"dummy"
"173198",0,2,0,2,"dummy"
"173199",2,2,0,4,"dummy"
"173200",6,0,1,7,"dummy"
"173201",0,0,1,1,"dummy"
"173249",0,2,0,2,"dummy"
"173250",2,0,0,2,"dummy"
"173251",0,2,0,2,"dummy"
"173257",6,0,0,6,"dummy"
"173258",2,5,2,9,"dummy"
"173276",0,37,2,39,"dummy"
"173277",1,0,3,4,"dummy"
"173278",0,1,0,1,"dummy"
"173168",0,0,2,2,"dummy"
"173169",0,1,0,1,"dummy"
"173173",6,6,0,12,"dummy"
"173174",5,10,5,20,"dummy"
"173175",5,2,0,7,"dummy"
"173176",1,0,0,1,"dummy"
"173177",1,0,1,2,"dummy"
"173178",1,2,0,3,"dummy"
"173179",1,0,0,1,"dummy"
"173180",5,2,6,13,"dummy"
"173181",0,0,0,0,"dummy"
"173184",2,3,2,7,"dummy"
"173247",3,2,1,6,"dummy"
"173260",0,0,1,1,"dummy"
"173261",0,0,1,1,"dummy"
"173262",0,0,1,1,"dummy"
"173263",0,0,1,1,"dummy"
"173264",0,0,1,1,"dummy"
"173265",0,0,1,1,"dummy"
"173266",0,1,0,1,"dummy"
"173267",0,2,0,2,"dummy"
"173268",0,0,0,0,"dummy"
"173269",0,2,0,2,"dummy"
"173270",0,0,0,0,"dummy"
"173271",0,0,1,1,"dummy"
"173272",0,0,1,1,"dummy"
"173273",0,0,1,1,"dummy"
"173274",0,0,1,1,"dummy"
"173281",0,0,1,1,"dummy"
"173282",0,0,1,1,"dummy"
"173283",2,3,0,5,"dummy"
"173284",0,0,1,1,"dummy"
"173285",0,0,2,2,"dummy"
"173286",0,0,2,2,"dummy"
"173287",0,0,2,2,"dummy"
"173292",0,0,3,3,"dummy"
"173293",0,1,0,1,"dummy"
"173294",1,1,1,3,"dummy"
"173295",0,1,0,1,"dummy"
"173296",0,0,1,1,"dummy"
"173316",0,6,0,6,"dummy"
"173317",3,3,0,6,"dummy"
"173318",3,4,0,7,"dummy"
"173344",0,5,0,5,"dummy"
"173345",0,4,0,4,"dummy"
"173346",0,0,1,1,"dummy"
"173347",0,1,0,1,"dummy"
"173348",0,1,0,1,"dummy"
"173349",2,0,0,2,"dummy"
"173350",5,0,0,5,"dummy"
"173351",3,4,0,7,"dummy"
"173352",3,4,0,7,"dummy"
"173353",0,0,2,2,"dummy"
"173354",0,0,4,4,"dummy"
"173355",0,0,4,4,"dummy"
"173356",2,0,0,2,"dummy"
"173359",0,0,1,1,"dummy"
"173360",8,2,0,10,"dummy"
"173361",0,0,1,1,"dummy"
"173362",0,0,1,1,"dummy"
"173363",0,0,1,1,"dummy"
"173382",0,0,1,1,"dummy"
"173383",0,0,1,1,"dummy"
"173384",0,4,1,5,"dummy"
"173385",0,0,1,1,"dummy"
"173386",0,1,3,4,"dummy"
"173387",0,0,1,1,"dummy"
"173392",2,4,0,6,"dummy"
"173393",0,2,0,2,"dummy"
"173394",0,2,0,2,"dummy"
"173395",10,2,0,12,"dummy"
"173396",0,2,0,2,"dummy"
"173397",0,0,0,0,"dummy"
"173398",0,0,3,3,"dummy"
"173399",0,5,0,5,"dummy"
"173400",1,0,1,2,"dummy"
"173279",0,0,3,3,"dummy"
"173311",0,9,0,9,"dummy"
"173312",0,5,0,5,"dummy"
"173313",0,4,0,4,"dummy"
"173314",0,0,1,1,"dummy"
"173322",6,2,0,8,"dummy"
"173323",0,0,0,0,"dummy"
"173324",3,4,1,8,"dummy"
"173325",0,35,0,35,"dummy"
"173326",0,0,0,0,"dummy"
"173331",7,3,2,12,"dummy"
"173332",3,1,2,6,"dummy"
"173333",0,1,4,5,"dummy"
"173334",0,4,6,10,"dummy"
"173335",4,0,5,9,"dummy"
"173336",0,1,5,6,"dummy"
"173337",0,1,0,1,"dummy"
"173338",1,0,2,3,"dummy"
"173369",0,0,0,0,"dummy"
"173370",0,0,5,5,"dummy"
"173373",1,2,0,3,"dummy"
"173380",0,1,0,1,"dummy"
"173404",14,5,0,19,"dummy"
"173405",0,4,1,5,"dummy"
"173440",0,3,0,3,"dummy"
"173441",0,0,1,1,"dummy"
"173457",0,2,0,2,"dummy"
"173458",0,0,1,1,"dummy"
"173459",0,1,0,1,"dummy"
"173460",0,1,0,1,"dummy"
"173407",2,3,1,6,"dummy"
"173408",0,8,1,9,"dummy"
"173409",0,2,0,2,"dummy"
"173410",0,0,1,1,"dummy"
"173411",0,0,1,1,"dummy"
"173412",0,0,1,1,"dummy"
"173413",0,4,1,5,"dummy"
"173422",8,9,0,17,"dummy"
"173423",0,1,0,1,"dummy"
"173424",0,1,0,1,"dummy"
"173425",0,1,0,1,"dummy"
"173426",2,2,0,4,"dummy"
"173427",0,1,0,1,"dummy"
"173428",1,1,0,2,"dummy"
"173429",0,1,0,1,"dummy"
"173434",0,0,0,0,"dummy"
"173435",0,0,0,0,"dummy"
"173443",5,0,0,5,"dummy"
"173444",0,2,1,3,"dummy"
"173445",3,4,0,7,"dummy"
"173446",0,0,1,1,"dummy"
"173447",0,0,0,0,"dummy"
"173448",0,0,0,0,"dummy"
"173449",2,1,0,3,"dummy"
"173450",0,0,0,0,"dummy"
"173451",1,1,0,2,"dummy"
"173452",0,0,0,0,"dummy"
"173453",0,0,0,0,"dummy"
"173454",0,0,0,0,"dummy"
"173455",0,1,1,2,"dummy"
"173465",0,0,1,1,"dummy"
"173469",0,0,0,0,"dummy"
"173470",0,0,1,1,"dummy"
"173471",0,0,1,1,"dummy"
"173475",0,1,2,3,"dummy"
"173476",0,1,0,1,"dummy"
"173477",7,2,3,12,"dummy"
"173479",2,3,1,6,"dummy"
"173481",2,3,1,6,"dummy"
"173482",1,0,0,1,"dummy"
"173485",0,0,1,1,"dummy"
"173488",0,1,0,1,"dummy"
"173489",1,1,0,2,"dummy"
"173490",2,2,0,4,"dummy"
"173491",1,0,3,4,"dummy"
"173492",0,0,4,4,"dummy"
"173495",0,0,0,0,"dummy"
"173498",1,2,0,3,"dummy"
"173499",0,0,1,1,"dummy"
"173500",0,0,1,1,"dummy"
"173530",0,2,1,3,"dummy"
"173531",0,0,1,1,"dummy"
"173534",25,3,1,29,"dummy"
"173535",0,2,0,2,"dummy"
"173536",0,1,0,1,"dummy"
"173537",0,1,0,1,"dummy"
"173538",1,0,0,1,"dummy"
"173539",0,1,0,1,"dummy"
"173540",1,1,0,2,"dummy"
"173541",0,2,0,2,"dummy"
"173542",0,10,0,10,"dummy"
"173543",0,2,1,3,"dummy"
"173544",1,3,0,4,"dummy"
"173545",23,2,2,27,"dummy"
"173548",0,1,0,1,"dummy"
"173549",0,1,0,1,"dummy"
"173550",3,4,0,7,"dummy"
"173552",0,1,2,3,"dummy"
"173553",0,0,0,0,"dummy"
"173554",0,1,0,1,"dummy"
"173555",4,0,2,6,"dummy"
"173556",1,0,0,1,"dummy"
"173557",0,0,0,0,"dummy"
"173558",0,0,0,0,"dummy"
"173562",8,2,0,10,"dummy"
"173563",0,2,0,2,"dummy"
"173566",0,3,0,3,"dummy"
"173567",3,1,1,5,"dummy"
"173568",0,0,1,1,"dummy"
"173574",8,1,4,13,"dummy"
"173576",5,2,0,7,"dummy"
"173577",4,0,0,4,"dummy"
"173578",0,1,0,1,"dummy"
"173579",0,1,1,2,"dummy"
"173580",0,5,0,5,"dummy"
"173581",0,1,0,1,"dummy"
"173582",0,5,0,5,"dummy"
"173584",0,1,1,2,"dummy"
"173586",0,1,0,1,"dummy"
"173587",1,3,0,4,"dummy"
"173588",2,3,0,5,"dummy"
"173589",3,1,1,5,"dummy"
"173592",0,3,0,3,"dummy"
"173593",3,1,0,4,"dummy"
"173596",0,6,0,6,"dummy"
"173597",1,5,0,6,"dummy"
"173598",14,29,4,47,"dummy"
"173599",0,5,0,5,"dummy"
"173600",2,1,0,3,"dummy"
"173601",1,0,0,1,"dummy"
"173602",0,5,0,5,"dummy"
"173603",0,1,1,2,"dummy"
"173604",0,0,1,1,"dummy"
"173605",0,8,1,9,"dummy"
"173606",0,0,1,1,"dummy"
"173607",4,7,3,14,"dummy"
"173608",2,2,1,5,"dummy"
"173609",2,2,1,5,"dummy"
"173610",1,2,0,3,"dummy"
"173611",0,0,3,3,"dummy"
"173612",0,1,0,1,"dummy"
"173614",0,1,0,1,"dummy"
"173616",0,0,0,0,"dummy"
"173617",0,0,0,0,"dummy"
"173620",0,0,1,1,"dummy"
"173623",1,3,1,5,"dummy"
"173624",0,3,0,3,"dummy"
"173625",1,0,0,1,"dummy"
"173626",1,9,0,10,"dummy"
"173627",3,4,0,7,"dummy"
"173628",0,0,1,1,"dummy"
"173630",2,1,0,3,"dummy"
"173631",10,7,1,18,"dummy"
"173634",2,5,0,7,"dummy"
"173635",3,4,0,7,"dummy"
"173636",0,4,0,4,"dummy"
"173637",2,3,0,5,"dummy"
"173638",5,0,0,5,"dummy"
"173639",0,15,0,15,"dummy"
"173640",0,0,1,1,"dummy"
"173641",1,0,0,1,"dummy"
"173642",0,0,1,1,"dummy"
"173643",0,2,0,2,"dummy"
"173644",16,18,1,35,"dummy"
"173645",0,0,1,1,"dummy"
"173646",0,0,5,5,"dummy"
"173647",0,0,1,1,"dummy"
"173648",0,0,2,2,"dummy"
"173649",0,0,1,1,"dummy"
"173650",0,0,3,3,"dummy"
"173651",2,1,0,3,"dummy"
"173652",4,3,0,7,"dummy"
"173653",0,1,0,1,"dummy"
"173703",1,2,0,3,"dummy"
"173704",0,2,0,2,"dummy"
"173705",0,1,0,1,"dummy"
"173707",0,0,1,1,"dummy"
"173709",0,3,0,3,"dummy"
"173711",0,0,0,0,"dummy"
"173712",0,0,2,2,"dummy"
"173713",0,0,2,2,"dummy"
"173714",0,1,0,1,"dummy"
"173715",0,1,4,5,"dummy"
"173716",0,1,0,1,"dummy"
"173717",1,1,0,2,"dummy"
"173718",3,0,3,6,"dummy"
"173719",0,0,0,0,"dummy"
"173720",0,1,0,1,"dummy"
"173721",0,1,0,1,"dummy"
"173722",0,0,0,0,"dummy"
"173723",3,0,0,3,"dummy"
"173724",0,1,0,1,"dummy"
"173725",0,0,1,1,"dummy"
"173726",0,1,0,1,"dummy"
"173727",1,1,0,2,"dummy"
"173728",1,0,0,1,"dummy"
"173729",1,0,0,1,"dummy"
"173730",0,0,0,0,"dummy"
"173731",0,0,0,0,"dummy"
"173733",0,5,0,5,"dummy"
"173734",0,0,2,2,"dummy"
"173735",0,2,0,2,"dummy"
"173736",2,4,0,6,"dummy"
"173737",0,2,0,2,"dummy"
"173738",0,0,1,1,"dummy"
"173739",2,1,2,5,"dummy"
"173745",0,1,0,1,"dummy"
"173748",0,0,1,1,"dummy"
"173753",0,1,0,1,"dummy"
"173754",0,1,0,1,"dummy"
"173755",0,5,0,5,"dummy"
"173756",0,9,1,10,"dummy"
"173757",0,0,0,0,"dummy"
"173758",3,1,0,4,"dummy"
"173759",1,0,0,1,"dummy"
"173760",0,2,0,2,"dummy"
"173761",0,0,1,1,"dummy"
"173762",0,1,0,1,"dummy"
"173763",2,0,0,2,"dummy"
"173764",0,0,2,2,"dummy"
"173765",0,1,0,1,"dummy"
"173766",0,1,0,1,"dummy"
"173767",2,0,0,2,"dummy"
"173768",0,1,0,1,"dummy"
"173769",2,1,0,3,"dummy"
"173770",0,0,2,2,"dummy"
"173771",0,1,2,3,"dummy"
"173773",2,1,1,4,"dummy"
"173774",0,0,1,1,"dummy"
"173775",0,0,1,1,"dummy"
"173776",0,0,1,1,"dummy"
"173781",0,0,2,2,"dummy"
"173782",0,0,0,0,"dummy"
"173783",0,0,0,0,"dummy"
"173784",0,0,0,0,"dummy"
"173785",0,0,0,0,"dummy"
"173786",0,0,2,2,"dummy"
"173787",0,0,2,2,"dummy"
"173788",0,0,1,1,"dummy"
"173789",0,0,2,2,"dummy"
"173794",0,9,0,9,"dummy"
"173795",8,2,1,11,"dummy"
"173796",0,0,0,0,"dummy"
"173797",0,0,0,0,"dummy"
"173798",0,0,0,0,"dummy"
"173800",0,1,0,1,"dummy"
"173801",0,1,0,1,"dummy"
"173802",0,0,1,1,"dummy"
"173803",0,1,0,1,"dummy"
"173804",0,0,1,1,"dummy"
"173806",0,2,0,2,"dummy"
"173809",0,1,0,1,"dummy"
"173810",1,2,1,4,"dummy"
"173811",0,2,1,3,"dummy"
"173812",2,1,0,3,"dummy"
"173813",2,15,1,18,"dummy"
"173814",1,2,0,3,"dummy"
"173815",0,1,0,1,"dummy"
"173816",0,13,0,13,"dummy"
"173817",0,0,0,0,"dummy"
"173818",3,0,0,3,"dummy"
"173819",2,2,0,4,"dummy"
"173820",2,2,0,4,"dummy"
"173821",2,2,0,4,"dummy"
"173823",0,0,1,1,"dummy"
"173831",0,1,0,1,"dummy"
"173832",0,1,0,1,"dummy"
"173833",0,0,0,0,"dummy"
"173834",0,4,0,4,"dummy"
"173835",0,1,0,1,"dummy"
"173836",1,0,0,1,"dummy"
"173837",0,0,0,0,"dummy"
"173842",6,2,0,8,"dummy"
"173843",3,4,0,7,"dummy"
"173844",0,0,0,0,"dummy"
"173845",1,1,1,3,"dummy"
"173846",0,0,0,0,"dummy"
"173847",0,0,0,0,"dummy"
"173848",0,2,1,3,"dummy"
"173849",0,1,0,1,"dummy"
"173850",0,0,1,1,"dummy"
"173851",8,12,3,23,"dummy"
"173852",0,0,1,1,"dummy"
"173853",0,0,1,1,"dummy"
"173854",0,0,1,1,"dummy"
"173855",0,0,1,1,"dummy"
"173859",0,2,0,2,"dummy"
"173860",0,2,0,2,"dummy"
"173863",2,0,1,3,"dummy"
"173864",1,2,0,3,"dummy"
"173865",2,10,0,12,"dummy"
"173866",2,0,0,2,"dummy"
"173867",0,2,0,2,"dummy"
"173868",0,0,1,1,"dummy"
"173872",0,0,2,2,"dummy"
"173873",0,1,0,1,"dummy"
"173874",6,1,1,8,"dummy"
"173875",3,1,0,4,"dummy"
"173876",0,1,0,1,"dummy"
"173877",2,3,1,6,"dummy"
"173878",0,1,0,1,"dummy"
"173879",1,9,1,11,"dummy"
"173881",0,0,1,1,"dummy"
"173882",15,0,0,15,"dummy"
"173883",0,24,0,24,"dummy"
"173884",7,4,0,11,"dummy"
"173885",0,3,0,3,"dummy"
"173886",3,0,0,3,"dummy"
"173887",8,0,0,8,"dummy"
"173889",3,1,0,4,"dummy"
"173900",4,2,3,9,"dummy"
"173901",0,0,1,1,"dummy"
"173903",0,2,0,2,"dummy"
"173904",0,0,0,0,"dummy"
"173905",0,1,0,1,"dummy"
"173906",1,0,1,2,"dummy"
"173907",0,1,0,1,"dummy"
"173908",0,0,0,0,"dummy"
"173909",0,1,1,2,"dummy"
"173910",2,0,1,3,"dummy"
"173911",0,1,1,2,"dummy"
"173912",0,0,1,1,"dummy"
"173913",1,0,1,2,"dummy"
"173914",0,1,1,2,"dummy"
"173915",0,0,0,0,"dummy"
"173916",5,5,7,17,"dummy"
"173917",0,0,1,1,"dummy"
"173918",0,0,0,0,"dummy"
"173928",0,0,1,1,"dummy"
"173937",0,0,1,1,"dummy"
"173946",0,5,0,5,"dummy"
"173947",0,0,0,0,"dummy"
"173951",0,1,2,3,"dummy"
"173952",1,2,2,5,"dummy"
"173953",0,1,2,3,"dummy"
"173954",0,0,2,2,"dummy"
"173956",0,0,0,0,"dummy"
"173957",0,0,0,0,"dummy"
"173962",0,0,1,1,"dummy"
"173964",0,1,0,1,"dummy"
"173965",0,0,1,1,"dummy"
"173969",2,0,3,5,"dummy"
"174054",0,0,1,1,"dummy"
"174055",2,1,0,3,"dummy"
"174058",0,0,1,1,"dummy"
"174059",6,17,2,25,"dummy"
"174060",1,2,0,3,"dummy"
"174061",0,1,0,1,"dummy"
"174062",1,1,0,2,"dummy"
"174063",0,0,1,1,"dummy"
"174064",0,1,0,1,"dummy"
"174066",0,0,1,1,"dummy"
"174067",1,0,0,1,"dummy"
"174069",0,0,1,1,"dummy"
"174070",0,0,0,0,"dummy"
"174072",0,1,0,1,"dummy"
"174073",0,1,2,3,"dummy"
"174074",0,1,1,2,"dummy"
"174075",2,2,0,4,"dummy"
"174076",0,2,0,2,"dummy"
"174077",0,0,1,1,"dummy"
"174078",1,0,1,2,"dummy"
"174080",0,1,0,1,"dummy"
"174081",3,1,0,4,"dummy"
"174082",0,0,1,1,"dummy"
"174086",1,0,0,1,"dummy"
"174150",0,7,2,9,"dummy"
"174155",0,0,1,1,"dummy"
"174156",1,3,1,5,"dummy"
"174157",39,5,0,44,"dummy"
"174161",0,2,0,2,"dummy"
"174162",1,1,1,3,"dummy"
"174163",0,2,0,2,"dummy"
"174164",0,2,0,2,"dummy"
"174165",0,1,1,2,"dummy"
"174166",0,1,0,1,"dummy"
"174167",0,0,1,1,"dummy"
"174168",2,1,4,7,"dummy"
"174170",0,19,0,19,"dummy"
"174171",1,2,0,3,"dummy"
"174172",0,0,0,0,"dummy"
"174173",10,4,3,17,"dummy"
"174174",3,8,4,15,"dummy"
"174175",0,1,0,1,"dummy"
"174176",0,1,0,1,"dummy"
"174177",9,2,2,13,"dummy"
"174180",0,0,1,1,"dummy"
"174186",0,0,2,2,"dummy"
"174189",0,0,1,1,"dummy"
"174191",0,2,0,2,"dummy"
"174192",1,0,0,1,"dummy"
"174201",0,4,0,4,"dummy"
"174202",0,0,1,1,"dummy"
"174203",0,0,1,1,"dummy"
"174204",2,2,1,5,"dummy"
"174205",0,0,3,3,"dummy"
"174206",0,0,2,2,"dummy"
"174208",6,0,0,6,"dummy"
"174209",2,5,2,9,"dummy"
"174214",12,3,2,17,"dummy"
"174216",0,0,1,1,"dummy"
"174217",0,0,1,1,"dummy"
"174225",0,0,1,1,"dummy"
"174228",0,0,1,1,"dummy"
"174229",1,6,1,8,"dummy"
"174234",3,2,1,6,"dummy"
"174235",6,1,0,7,"dummy"
"174236",0,1,0,1,"dummy"
"174237",0,0,1,1,"dummy"
"174238",0,1,0,1,"dummy"
"174240",3,3,1,7,"dummy"
"174241",0,0,1,1,"dummy"
"174250",0,0,3,3,"dummy"
"174253",0,1,0,1,"dummy"
"174254",0,0,1,1,"dummy"
"174255",12,0,1,13,"dummy"
"174260",0,0,1,1,"dummy"
"174262",1,2,0,3,"dummy"
"174264",0,0,0,0,"dummy"
"174265",0,0,2,2,"dummy"
"174266",0,2,2,4,"dummy"
"174267",0,0,3,3,"dummy"
"174268",0,0,1,1,"dummy"
"174269",0,0,0,0,"dummy"
"174270",0,0,1,1,"dummy"
"174271",2,1,2,5,"dummy"
"174272",0,0,1,1,"dummy"
"174273",0,0,3,3,"dummy"
"174279",0,0,0,0,"dummy"
"174280",0,1,0,1,"dummy"
"174282",0,2,0,2,"dummy"
"174286",1,0,1,2,"dummy"
"174287",0,0,1,1,"dummy"
"174288",0,1,0,1,"dummy"
"174289",2,5,0,7,"dummy"
"174290",1,0,0,1,"dummy"
"174291",0,2,0,2,"dummy"
"174292",0,0,0,0,"dummy"
"174293",0,0,0,0,"dummy"
"174294",0,2,1,3,"dummy"
"174295",0,1,0,1,"dummy"
"174296",0,0,1,1,"dummy"
"174297",1,4,0,5,"dummy"
"174298",0,1,0,1,"dummy"
"174299",0,1,0,1,"dummy"
"174300",2,1,0,3,"dummy"
"174301",0,1,0,1,"dummy"
"174302",1,0,0,1,"dummy"
"174303",0,1,0,1,"dummy"
"174304",0,1,0,1,"dummy"
"174307",0,1,0,1,"dummy"
"174309",2,9,3,14,"dummy"
"174310",2,13,1,16,"dummy"
"174313",0,0,1,1,"dummy"
"174314",1,1,1,3,"dummy"
"174315",0,0,1,1,"dummy"
"174316",0,0,3,3,"dummy"
"174317",0,2,1,3,"dummy"
"174318",0,0,2,2,"dummy"
"174319",0,0,1,1,"dummy"
"174320",0,0,1,1,"dummy"
"174321",0,0,3,3,"dummy"
"174322",0,0,1,1,"dummy"
"174323",0,0,2,2,"dummy"
"174324",0,0,2,2,"dummy"
"174325",0,0,1,1,"dummy"
"174326",0,0,1,1,"dummy"
"174327",0,0,1,1,"dummy"
"174332",0,0,1,1,"dummy"
"174333",1,6,3,10,"dummy"
"174334",0,1,0,1,"dummy"
"174335",0,1,0,1,"dummy"
"174336",0,2,1,3,"dummy"
"174337",0,0,0,0,"dummy"
"174338",1,1,0,2,"dummy"
"174339",0,1,0,1,"dummy"
"174340",6,10,6,22,"dummy"
"174341",0,0,1,1,"dummy"
"174342",0,2,0,2,"dummy"
"174343",0,1,0,1,"dummy"
"174344",0,1,0,1,"dummy"
"174345",1,2,1,4,"dummy"
"174346",2,0,0,2,"dummy"
"174347",17,11,5,33,"dummy"
"174348",1,0,0,1,"dummy"
"174349",0,0,0,0,"dummy"
"174350",1,0,1,2,"dummy"
"174351",0,0,0,0,"dummy"
"174352",0,0,3,3,"dummy"
"174353",0,0,0,0,"dummy"
"174354",0,0,0,0,"dummy"
"174355",0,0,0,0,"dummy"
"174356",2,9,3,14,"dummy"
"174357",2,2,0,4,"dummy"
"174358",2,5,1,8,"dummy"
"174359",11,5,1,17,"dummy"
"174360",0,0,1,1,"dummy"
"174361",0,0,2,2,"dummy"
"174362",2,3,2,7,"dummy"
"174364",1,2,0,3,"dummy"
"174365",1,4,1,6,"dummy"
"174366",1,2,0,3,"dummy"
"174367",2,4,0,6,"dummy"
"174368",2,2,0,4,"dummy"
"174369",1,1,0,2,"dummy"
"174370",2,8,2,12,"dummy"
"174371",2,0,0,2,"dummy"
"174372",0,1,0,1,"dummy"
"174374",0,0,0,0,"dummy"
"174375",0,0,1,1,"dummy"
"174376",4,4,3,11,"dummy"
"174377",0,0,1,1,"dummy"
"174378",0,0,1,1,"dummy"
"174379",0,0,0,0,"dummy"
"174383",8,2,0,10,"dummy"
"174384",0,4,1,5,"dummy"
"174385",2,1,0,3,"dummy"
"174386",0,0,0,0,"dummy"
"174387",0,2,0,2,"dummy"
"174395",0,1,0,1,"dummy"
"174398",0,1,0,1,"dummy"
"174399",0,1,0,1,"dummy"
"174400",0,1,0,1,"dummy"
"174401",0,2,0,2,"dummy"
"174404",6,0,0,6,"dummy"
"174405",2,5,2,9,"dummy"
"174410",0,0,1,1,"dummy"
"174416",0,1,0,1,"dummy"
"174419",0,1,0,1,"dummy"
"174420",4,5,1,10,"dummy"
"174423",3,1,0,4,"dummy"
"174426",0,2,0,2,"dummy"
"174427",0,1,0,1,"dummy"
"174430",0,0,0,0,"dummy"
"174431",2,5,0,7,"dummy"
"174432",2,2,0,4,"dummy"
"174433",0,1,0,1,"dummy"
"174434",0,1,0,1,"dummy"
"174435",0,0,1,1,"dummy"
"174436",0,1,0,1,"dummy"
"174437",5,6,3,14,"dummy"
"174438",2,0,6,8,"dummy"
"174439",1,0,0,1,"dummy"
"174440",4,0,0,4,"dummy"
"174441",2,0,0,2,"dummy"
"174442",0,0,0,0,"dummy"
"174443",24,20,1,45,"dummy"
"174444",0,2,3,5,"dummy"
"174447",0,0,0,0,"dummy"
"174448",0,0,0,0,"dummy"
"174451",2,1,0,3,"dummy"
"174454",1,2,0,3,"dummy"
"174455",1,0,0,1,"dummy"
"174461",0,0,3,3,"dummy"
"174462",0,1,0,1,"dummy"
"174463",0,0,0,0,"dummy"
"174464",0,0,1,1,"dummy"
"174465",0,1,1,2,"dummy"
"174474",3,0,0,3,"dummy"
"174475",0,0,0,0,"dummy"
"174476",0,0,0,0,"dummy"
"174477",0,0,0,0,"dummy"
"174478",0,0,1,1,"dummy"
"174479",0,0,1,1,"dummy"
"174480",1,0,0,1,"dummy"
"174483",1,3,3,7,"dummy"
"174484",0,1,0,1,"dummy"
"174485",0,0,1,1,"dummy"
"174486",0,0,1,1,"dummy"
"174492",3,2,0,5,"dummy"
"174497",0,0,1,1,"dummy"
"174512",9,13,0,22,"dummy"
"174521",0,0,1,1,"dummy"
"174522",0,1,0,1,"dummy"
"174548",0,2,1,3,"dummy"
"174574",0,0,0,0,"dummy"
"174575",0,0,1,1,"dummy"
"174576",0,0,3,3,"dummy"
"174577",1,2,1,4,"dummy"
"174578",0,1,1,2,"dummy"
"174579",0,0,2,2,"dummy"
"174580",0,0,2,2,"dummy"
"174581",0,0,1,1,"dummy"
"174582",0,0,2,2,"dummy"
"174583",0,0,2,2,"dummy"
"174584",0,1,4,5,"dummy"
"174585",0,0,2,2,"dummy"
"174586",0,0,2,2,"dummy"
"174587",0,0,2,2,"dummy"
"174588",0,0,2,2,"dummy"
"174589",0,0,2,2,"dummy"
"174590",0,0,2,2,"dummy"
"174414",0,0,0,0,"dummy"
"174457",6,0,2,8,"dummy"
"174458",0,1,1,2,"dummy"
"174459",0,6,0,6,"dummy"
"174467",0,1,0,1,"dummy"
"174470",2,2,1,5,"dummy"
"174488",0,1,0,1,"dummy"
"174489",1,0,0,1,"dummy"
"174490",0,1,0,1,"dummy"
"174494",1,0,0,1,"dummy"
"174495",0,2,0,2,"dummy"
"174504",3,15,0,18,"dummy"
"174514",0,1,0,1,"dummy"
"174517",0,3,0,3,"dummy"
"174524",0,0,1,1,"dummy"
"174525",0,1,0,1,"dummy"
"174526",0,0,1,1,"dummy"
"174529",0,0,1,1,"dummy"
"174534",0,0,1,1,"dummy"
"174539",13,18,1,32,"dummy"
"174542",0,1,0,1,"dummy"
"174556",0,0,1,1,"dummy"
"174557",0,0,1,1,"dummy"
"174558",0,0,4,4,"dummy"
"174559",2,6,0,8,"dummy"
"174560",0,1,0,1,"dummy"
"174561",0,1,0,1,"dummy"
"174562",0,1,0,1,"dummy"
"174563",0,0,4,4,"dummy"
"174564",0,12,3,15,"dummy"
"174565",0,0,1,1,"dummy"
"174566",1,3,3,7,"dummy"
"174567",0,0,1,1,"dummy"
"174572",2,2,0,4,"dummy"
"174633",3,4,0,7,"dummy"
"174651",1,0,0,1,"dummy"
"174652",0,2,0,2,"dummy"
"174653",1,0,0,1,"dummy"
"174654",1,3,0,4,"dummy"
"174655",0,1,0,1,"dummy"
"174656",4,2,0,6,"dummy"
"174665",0,0,1,1,"dummy"
"174666",0,1,0,1,"dummy"
"174667",0,0,0,0,"dummy"
"174668",0,0,1,1,"dummy"
"174669",0,1,0,1,"dummy"
"174670",0,0,1,1,"dummy"
"174671",6,0,0,6,"dummy"
"174705",1,8,5,14,"dummy"
"174706",0,0,0,0,"dummy"
"174707",2,7,4,13,"dummy"
"174732",0,2,0,2,"dummy"
"174735",0,1,0,1,"dummy"
"174591",0,0,2,2,"dummy"
"174592",0,0,2,2,"dummy"
"174593",0,0,2,2,"dummy"
"174635",0,1,0,1,"dummy"
"174636",0,0,0,0,"dummy"
"174637",1,1,0,2,"dummy"
"174638",1,4,0,5,"dummy"
"174639",0,1,0,1,"dummy"
"174640",0,0,2,2,"dummy"
"174641",0,1,0,1,"dummy"
"174642",0,1,0,1,"dummy"
"174643",1,1,0,2,"dummy"
"174644",0,0,1,1,"dummy"
"174645",0,0,1,1,"dummy"
"174646",0,0,1,1,"dummy"
"174647",0,0,1,1,"dummy"
"174648",0,0,1,1,"dummy"
"174649",0,1,0,1,"dummy"
"174673",4,1,1,6,"dummy"
"174674",0,0,1,1,"dummy"
"174675",16,8,1,25,"dummy"
"174676",0,2,1,3,"dummy"
"174677",1,0,1,2,"dummy"
"174678",0,3,0,3,"dummy"
"174679",0,2,0,2,"dummy"
"174680",0,4,0,4,"dummy"
"174681",3,4,0,7,"dummy"
"174682",0,1,0,1,"dummy"
"174683",0,1,0,1,"dummy"
"174684",1,1,1,3,"dummy"
"174713",0,0,2,2,"dummy"
"174714",2,2,0,4,"dummy"
"174715",0,1,0,1,"dummy"
"174716",1,0,0,1,"dummy"
"174717",0,2,0,2,"dummy"
"174720",0,5,0,5,"dummy"
"174721",0,0,5,5,"dummy"
"174722",0,2,0,2,"dummy"
"174723",15,2,3,20,"dummy"
"174724",0,0,2,2,"dummy"
"174725",0,0,0,0,"dummy"
"174726",0,0,1,1,"dummy"
"174727",0,3,1,4,"dummy"
"174728",4,0,1,5,"dummy"
"174736",10,2,1,13,"dummy"
"174748",2,0,3,5,"dummy"
"174749",1,0,0,1,"dummy"
"174750",0,1,0,1,"dummy"
"174751",0,1,1,2,"dummy"
"174754",0,2,0,2,"dummy"
"174755",0,0,1,1,"dummy"
"174757",1,0,0,1,"dummy"
"174758",0,2,0,2,"dummy"
"174759",1,0,0,1,"dummy"
"174760",1,1,0,2,"dummy"
"174779",3,0,0,3,"dummy"
"174780",0,0,1,1,"dummy"
"174781",1,0,0,1,"dummy"
"174782",4,4,1,9,"dummy"
"174783",1,0,0,1,"dummy"
"174789",1,2,0,3,"dummy"
"174790",0,1,0,1,"dummy"
"174791",1,0,0,1,"dummy"
"174792",1,0,1,2,"dummy"
"174796",0,1,0,1,"dummy"
"174797",0,1,1,2,"dummy"
"174798",0,1,0,1,"dummy"
"174800",0,0,1,1,"dummy"
"174801",0,0,1,1,"dummy"
"174805",0,0,1,1,"dummy"
"174806",0,0,0,0,"dummy"
"174808",8,2,2,12,"dummy"
"174809",2,0,0,2,"dummy"
"174810",0,5,0,5,"dummy"
"174811",2,9,3,14,"dummy"
"174812",1,2,0,3,"dummy"
"174813",0,2,0,2,"dummy"
"174814",0,1,0,1,"dummy"
"174816",0,1,2,3,"dummy"
"174817",0,0,3,3,"dummy"
"174818",7,7,2,16,"dummy"
"174819",0,1,1,2,"dummy"
"174820",0,0,1,1,"dummy"
"174821",10,9,1,20,"dummy"
"174822",0,0,1,1,"dummy"
"174823",0,1,2,3,"dummy"
"174824",3,11,3,17,"dummy"
"174825",0,0,0,0,"dummy"
"174827",2,3,2,7,"dummy"
"174828",1,2,0,3,"dummy"
"174829",0,0,0,0,"dummy"
"174831",0,2,2,4,"dummy"
"174832",0,0,1,1,"dummy"
"174834",0,0,1,1,"dummy"
"174838",1,0,0,1,"dummy"
"174841",13,2,0,15,"dummy"
"174842",10,6,0,16,"dummy"
"174843",5,20,1,26,"dummy"
"174844",0,8,0,8,"dummy"
"174845",5,10,4,19,"dummy"
"174846",9,12,0,21,"dummy"
"174847",0,1,0,1,"dummy"
"174848",0,2,0,2,"dummy"
"174851",2,0,0,2,"dummy"
"174852",0,2,0,2,"dummy"
"174853",0,1,0,1,"dummy"
"174854",1,0,0,1,"dummy"
"174855",0,1,0,1,"dummy"
"174856",1,2,0,3,"dummy"
"174857",0,0,0,0,"dummy"
"174858",0,0,0,0,"dummy"
"174859",0,1,0,1,"dummy"
"174860",0,0,0,0,"dummy"
"174861",0,0,1,1,"dummy"
"174862",2,2,0,4,"dummy"
"174863",2,4,0,6,"dummy"
"174864",0,0,0,0,"dummy"
"174865",2,0,0,2,"dummy"
"174866",0,1,0,1,"dummy"
"174867",0,0,0,0,"dummy"
"174868",0,0,0,0,"dummy"
"174869",0,0,0,0,"dummy"
"174870",0,0,0,0,"dummy"
"174871",0,0,0,0,"dummy"
"174872",0,0,0,0,"dummy"
"174873",0,0,0,0,"dummy"
"174874",0,0,1,1,"dummy"
"174875",0,0,0,0,"dummy"
"174876",0,0,0,0,"dummy"
"174879",0,2,0,2,"dummy"
"174880",7,1,1,9,"dummy"
"174881",0,6,0,6,"dummy"
"174882",0,5,0,5,"dummy"
"174883",0,1,0,1,"dummy"
"174886",1,2,0,3,"dummy"
"174888",0,0,1,1,"dummy"
"174889",1,1,0,2,"dummy"
"174890",0,0,0,0,"dummy"
"174891",0,0,0,0,"dummy"
"174892",0,0,1,1,"dummy"
"174894",0,1,0,1,"dummy"
"174895",0,2,0,2,"dummy"
"174898",0,3,0,3,"dummy"
"174900",0,0,1,1,"dummy"
"174915",10,9,0,19,"dummy"
"174916",1,0,0,1,"dummy"
"174917",0,0,1,1,"dummy"
"174919",0,1,0,1,"dummy"
"174920",1,0,0,1,"dummy"
"174922",0,6,0,6,"dummy"
"174923",0,6,0,6,"dummy"
"174924",0,0,0,0,"dummy"
"174925",0,1,0,1,"dummy"
"174926",0,3,0,3,"dummy"
"174928",0,1,0,1,"dummy"
"174929",3,4,0,7,"dummy"
"174933",2,0,0,2,"dummy"
"174934",3,1,1,5,"dummy"
"174935",0,0,1,1,"dummy"
"174936",1,2,0,3,"dummy"
"174937",0,0,1,1,"dummy"
"174938",0,1,0,1,"dummy"
"174949",0,0,1,1,"dummy"
"174953",0,0,1,1,"dummy"
"174954",7,7,4,18,"dummy"
"174955",19,3,2,24,"dummy"
"174956",0,0,1,1,"dummy"
"174957",0,0,1,1,"dummy"
"174961",0,0,1,1,"dummy"
"174965",0,0,1,1,"dummy"
"174966",1,2,0,3,"dummy"
"174967",0,2,0,2,"dummy"
"174969",0,0,2,2,"dummy"
"174970",0,1,0,1,"dummy"
"174971",1,7,0,8,"dummy"
"174972",0,2,1,3,"dummy"
"174975",0,0,1,1,"dummy"
"174982",1,1,0,2,"dummy"
"174983",1,0,2,3,"dummy"
"174984",0,1,1,2,"dummy"
"174985",0,0,1,1,"dummy"
"174986",0,1,0,1,"dummy"
"174987",0,1,1,2,"dummy"
"174989",0,0,0,0,"dummy"
"174990",1,5,0,6,"dummy"
"174993",0,0,0,0,"dummy"
"174994",0,7,1,8,"dummy"
"174995",2,0,1,3,"dummy"
"174996",5,6,1,12,"dummy"
"174997",0,0,0,0,"dummy"
"174998",0,5,1,6,"dummy"
"175000",0,0,1,1,"dummy"
"175001",0,1,0,1,"dummy"
"175002",0,0,1,1,"dummy"
"175003",0,1,0,1,"dummy"
"175006",0,0,1,1,"dummy"
"175007",0,2,0,2,"dummy"
"175009",0,1,0,1,"dummy"
"175010",0,0,1,1,"dummy"
"175011",0,0,1,1,"dummy"
"175012",0,0,1,1,"dummy"
"175013",0,0,1,1,"dummy"
"175014",0,0,1,1,"dummy"
"175015",0,0,1,1,"dummy"
"175016",0,0,1,1,"dummy"
"175017",0,0,1,1,"dummy"
"175018",0,0,1,1,"dummy"
"175019",0,0,1,1,"dummy"
"175020",0,0,1,1,"dummy"
"175022",28,11,4,43,"dummy"
"175023",0,0,1,1,"dummy"
"175025",2,1,1,4,"dummy"
"175041",0,0,0,0,"dummy"
"175042",0,0,0,0,"dummy"
"175043",0,0,0,0,"dummy"
"175044",0,0,1,1,"dummy"
"175047",0,2,0,2,"dummy"
"175048",0,1,0,1,"dummy"
"175049",0,0,1,1,"dummy"
"175050",0,1,0,1,"dummy"
"175051",0,3,0,3,"dummy"
"175052",0,1,0,1,"dummy"
"175053",0,3,0,3,"dummy"
"175054",2,2,0,4,"dummy"
"175055",0,2,0,2,"dummy"
"175056",6,0,1,7,"dummy"
"175057",0,3,0,3,"dummy"
"175058",0,3,2,5,"dummy"
"175059",0,0,2,2,"dummy"
"175060",2,2,0,4,"dummy"
"175061",11,7,1,19,"dummy"
"175062",1,1,0,2,"dummy"
"175064",0,0,1,1,"dummy"
"175066",1,1,0,2,"dummy"
"175069",1,1,0,2,"dummy"
"175070",0,1,0,1,"dummy"
"175071",0,2,0,2,"dummy"
"175072",0,1,0,1,"dummy"
"175075",1,1,4,6,"dummy"
"175077",0,1,2,3,"dummy"
"175079",0,0,2,2,"dummy"
"175083",3,11,2,16,"dummy"
"175084",1,1,0,2,"dummy"
"175085",2,0,1,3,"dummy"
"175086",0,1,1,2,"dummy"
"175087",1,2,0,3,"dummy"
"175088",0,1,0,1,"dummy"
"175092",0,1,0,1,"dummy"
"175110",0,0,2,2,"dummy"
"175113",0,1,2,3,"dummy"
"175114",0,0,0,0,"dummy"
"175115",0,2,0,2,"dummy"
"175116",5,0,2,7,"dummy"
"175117",1,0,0,1,"dummy"
"175118",0,0,0,0,"dummy"
"175124",1,15,0,16,"dummy"
"175139",0,0,1,1,"dummy"
"175140",0,0,1,1,"dummy"
"175142",3,6,0,9,"dummy"
"175143",0,0,1,1,"dummy"
"175144",0,0,1,1,"dummy"
"175145",2,0,0,2,"dummy"
"175146",0,0,1,1,"dummy"
"175147",0,3,0,3,"dummy"
"175148",1,1,0,2,"dummy"
"175149",24,0,0,24,"dummy"
"175150",0,0,0,0,"dummy"
"175152",0,2,0,2,"dummy"
"175153",0,1,0,1,"dummy"
"175156",0,3,0,3,"dummy"
"175157",0,6,0,6,"dummy"
"175158",3,0,0,3,"dummy"
"175160",9,1,1,11,"dummy"
"175164",4,4,0,8,"dummy"
"175165",0,4,0,4,"dummy"
"175166",0,0,0,0,"dummy"
"175167",1,4,1,6,"dummy"
"175174",0,3,2,5,"dummy"
"175175",0,0,0,0,"dummy"
"175176",0,1,0,1,"dummy"
"175177",1,0,0,1,"dummy"
"175178",3,0,0,3,"dummy"
"175179",0,3,0,3,"dummy"
"175180",0,0,1,1,"dummy"
"175181",2,0,4,6,"dummy"
"175225",1,0,0,1,"dummy"
"175226",1,0,0,1,"dummy"
"175227",0,1,0,1,"dummy"
"175228",1,0,0,1,"dummy"
"175268",1,0,2,3,"dummy"
"175316",0,0,1,1,"dummy"
"175317",0,1,0,1,"dummy"
"175318",0,0,3,3,"dummy"
"175319",0,0,1,1,"dummy"
"175325",0,3,1,4,"dummy"
"175326",0,1,0,1,"dummy"
"175327",0,2,0,2,"dummy"
"175328",0,3,0,3,"dummy"
"175329",1,1,0,2,"dummy"
"175330",0,0,1,1,"dummy"
"175331",0,0,1,1,"dummy"
"175344",0,1,0,1,"dummy"
"175345",0,1,0,1,"dummy"
"175346",0,1,0,1,"dummy"
"175356",2,2,1,5,"dummy"
"175357",0,2,0,2,"dummy"
"175379",0,0,1,1,"dummy"
"175380",0,0,1,1,"dummy"
"175381",0,0,1,1,"dummy"
"175390",0,0,4,4,"dummy"
"175391",8,0,0,8,"dummy"
"175398",1,3,1,5,"dummy"
"175399",1,2,1,4,"dummy"
"175400",4,0,2,6,"dummy"
"175404",6,2,1,9,"dummy"
"175405",0,2,1,3,"dummy"
"175406",0,0,1,1,"dummy"
"175413",0,0,1,1,"dummy"
"175414",0,6,0,6,"dummy"
"175415",0,2,0,2,"dummy"
"175416",1,0,0,1,"dummy"
"175417",1,2,0,3,"dummy"
"175418",1,6,4,11,"dummy"
"175434",4,3,0,7,"dummy"
"175435",2,4,1,7,"dummy"
"175438",0,0,2,2,"dummy"
"175439",0,0,1,1,"dummy"
"175440",0,0,1,1,"dummy"
"175441",0,0,2,2,"dummy"
"175442",0,0,1,1,"dummy"
"175443",0,0,1,1,"dummy"
"175444",0,0,1,1,"dummy"
"175445",0,0,2,2,"dummy"
"175446",0,0,1,1,"dummy"
"175447",0,2,0,2,"dummy"
"175448",0,0,1,1,"dummy"
"175449",0,0,1,1,"dummy"
"175450",0,1,0,1,"dummy"
"175451",0,1,0,1,"dummy"
"175471",0,0,2,2,"dummy"
"175474",0,1,0,1,"dummy"
"175475",8,4,2,14,"dummy"
"175476",5,8,0,13,"dummy"
"175477",0,1,0,1,"dummy"
"175478",0,2,0,2,"dummy"
"175484",20,0,1,21,"dummy"
"175492",0,3,1,4,"dummy"
"175493",0,2,0,2,"dummy"
"175498",3,4,1,8,"dummy"
"175249",0,1,0,1,"dummy"
"175250",0,1,0,1,"dummy"
"175251",0,0,1,1,"dummy"
"175252",1,1,0,2,"dummy"
"175253",0,1,0,1,"dummy"
"175254",0,6,1,7,"dummy"
"175255",2,2,0,4,"dummy"
"175256",0,1,0,1,"dummy"
"175257",0,1,0,1,"dummy"
"175258",0,2,0,2,"dummy"
"175259",0,3,0,3,"dummy"
"175260",0,1,0,1,"dummy"
"175261",0,1,0,1,"dummy"
"175266",0,0,1,1,"dummy"
"175323",0,0,1,1,"dummy"
"175335",0,0,1,1,"dummy"
"175336",3,0,0,3,"dummy"
"175337",0,0,0,0,"dummy"
"175348",0,3,0,3,"dummy"
"175349",0,0,1,1,"dummy"
"175354",1,1,1,3,"dummy"
"175359",0,0,0,0,"dummy"
"175360",0,0,1,1,"dummy"
"175361",3,0,0,3,"dummy"
"175362",0,1,1,2,"dummy"
"175363",0,0,1,1,"dummy"
"175364",0,1,0,1,"dummy"
"175365",0,0,0,0,"dummy"
"175366",0,0,1,1,"dummy"
"175367",0,2,0,2,"dummy"
"175368",0,0,0,0,"dummy"
"175369",0,0,0,0,"dummy"
"175370",4,2,0,6,"dummy"
"175371",2,0,0,2,"dummy"
"175372",0,0,0,0,"dummy"
"175373",0,0,0,0,"dummy"
"175374",0,0,0,0,"dummy"
"175375",2,8,0,10,"dummy"
"175383",0,0,0,0,"dummy"
"175402",2,17,1,20,"dummy"
"175408",7,1,0,8,"dummy"
"175409",0,0,2,2,"dummy"
"175426",2,8,2,12,"dummy"
"175427",2,2,1,5,"dummy"
"175428",0,0,1,1,"dummy"
"175468",0,2,0,2,"dummy"
"175469",0,4,0,4,"dummy"
"175486",1,4,0,5,"dummy"
"175502",0,1,0,1,"dummy"
"175505",0,0,0,0,"dummy"
"175511",0,0,1,1,"dummy"
"175512",0,1,0,1,"dummy"
"175513",0,3,0,3,"dummy"
"175514",0,1,1,2,"dummy"
"175515",3,1,0,4,"dummy"
"175522",1,0,0,1,"dummy"
"175523",1,0,1,2,"dummy"
"175524",2,3,1,6,"dummy"
"175525",2,0,1,3,"dummy"
"175526",2,2,2,6,"dummy"
"175539",0,1,0,1,"dummy"
"175540",6,6,4,16,"dummy"
"175541",0,2,0,2,"dummy"
"175542",0,1,0,1,"dummy"
"175499",5,12,3,20,"dummy"
"175500",0,1,0,1,"dummy"
"175507",0,6,0,6,"dummy"
"175508",0,0,0,0,"dummy"
"175509",3,0,1,4,"dummy"
"175528",1,8,0,9,"dummy"
"175529",8,14,2,24,"dummy"
"175532",0,1,0,1,"dummy"
"175533",37,10,6,53,"dummy"
"175534",0,2,0,2,"dummy"
"175535",1,8,0,9,"dummy"
"175536",7,6,0,13,"dummy"
"175537",2,3,0,5,"dummy"
"175544",0,2,0,2,"dummy"
"175545",0,0,0,0,"dummy"
"175550",4,6,2,12,"dummy"
"175553",0,0,1,1,"dummy"
"175556",0,2,0,2,"dummy"
"175557",5,3,0,8,"dummy"
"175558",0,0,1,1,"dummy"
"175559",0,0,1,1,"dummy"
"175560",0,0,1,1,"dummy"
"175561",0,0,1,1,"dummy"
"175562",0,0,1,1,"dummy"
"175563",0,0,1,1,"dummy"
"175564",0,0,1,1,"dummy"
"175565",6,4,2,12,"dummy"
"175566",0,0,1,1,"dummy"
"175567",0,0,1,1,"dummy"
"175568",0,0,1,1,"dummy"
"175569",0,0,1,1,"dummy"
"175570",0,0,1,1,"dummy"
"175571",0,0,1,1,"dummy"
"175572",0,0,1,1,"dummy"
"175575",2,11,0,13,"dummy"
"175581",0,2,1,3,"dummy"
"175582",3,1,1,5,"dummy"
"175590",0,0,2,2,"dummy"
"175596",0,4,0,4,"dummy"
"175597",2,1,0,3,"dummy"
"175598",0,1,0,1,"dummy"
"175599",0,0,1,1,"dummy"
"175606",0,0,1,1,"dummy"
"175609",0,0,1,1,"dummy"
"175610",0,1,0,1,"dummy"
"175611",2,6,0,8,"dummy"
"175612",0,1,0,1,"dummy"
"175613",4,0,0,4,"dummy"
"175614",0,1,0,1,"dummy"
"175615",0,0,0,0,"dummy"
"175616",2,2,1,5,"dummy"
"175617",0,1,1,2,"dummy"
"175618",1,3,1,5,"dummy"
"175627",0,2,0,2,"dummy"
"175628",0,3,0,3,"dummy"
"175637",9,6,4,19,"dummy"
"175638",4,6,2,12,"dummy"
"175639",6,0,3,9,"dummy"
"175643",0,1,0,1,"dummy"
"175653",1,0,0,1,"dummy"
"175692",0,1,0,1,"dummy"
"175693",0,0,1,1,"dummy"
"175694",10,43,4,57,"dummy"
"175697",0,0,0,0,"dummy"
"175698",0,0,0,0,"dummy"
"175709",0,1,0,1,"dummy"
"175710",0,1,0,1,"dummy"
"175714",0,12,0,12,"dummy"
"175731",0,0,2,2,"dummy"
"175732",0,0,6,6,"dummy"
"175733",2,0,1,3,"dummy"
"175734",0,1,0,1,"dummy"
"175735",0,4,1,5,"dummy"
"175736",0,0,2,2,"dummy"
"175547",6,0,0,6,"dummy"
"175548",2,5,2,9,"dummy"
"175577",0,0,0,0,"dummy"
"175592",0,1,0,1,"dummy"
"175593",2,3,0,5,"dummy"
"175594",0,1,0,1,"dummy"
"175601",0,3,1,4,"dummy"
"175602",0,6,1,7,"dummy"
"175620",0,2,0,2,"dummy"
"175621",0,3,0,3,"dummy"
"175624",0,0,0,0,"dummy"
"175625",0,0,0,0,"dummy"
"175641",0,0,0,0,"dummy"
"175645",0,13,0,13,"dummy"
"175646",0,1,0,1,"dummy"
"175647",3,3,1,7,"dummy"
"175648",7,1,2,10,"dummy"
"175649",1,2,2,5,"dummy"
"175650",0,1,0,1,"dummy"
"175651",0,2,0,2,"dummy"
"175655",0,0,1,1,"dummy"
"175656",0,0,1,1,"dummy"
"175683",0,1,0,1,"dummy"
"175684",1,2,1,4,"dummy"
"175685",3,0,0,3,"dummy"
"175686",1,0,0,1,"dummy"
"175687",1,3,0,4,"dummy"
"175688",3,1,0,4,"dummy"
"175689",1,0,1,2,"dummy"
"175690",1,2,1,4,"dummy"
"175702",3,1,1,5,"dummy"
"175703",0,0,1,1,"dummy"
"175704",0,3,0,3,"dummy"
"175705",0,1,0,1,"dummy"
"175706",0,1,0,1,"dummy"
"175707",1,0,0,1,"dummy"
"175712",0,0,0,0,"dummy"
"175718",0,0,1,1,"dummy"
"175726",1,0,0,1,"dummy"
"175727",0,0,1,1,"dummy"
"175728",0,1,0,1,"dummy"
"175729",1,3,0,4,"dummy"
"175739",4,0,2,6,"dummy"
"175740",0,0,1,1,"dummy"
"175745",0,13,1,14,"dummy"
"175746",0,3,0,3,"dummy"
"175747",1,0,0,1,"dummy"
"175748",0,1,0,1,"dummy"
"175749",0,1,0,1,"dummy"
"175750",0,1,0,1,"dummy"
"175751",0,2,0,2,"dummy"
"175754",0,1,0,1,"dummy"
"175755",6,38,4,48,"dummy"
"175756",0,0,1,1,"dummy"
"175757",0,3,0,3,"dummy"
"175777",2,0,3,5,"dummy"
"175780",0,8,1,9,"dummy"
"175786",3,0,0,3,"dummy"
"175800",0,0,1,1,"dummy"
"175801",0,1,1,2,"dummy"
"175802",1,2,0,3,"dummy"
"175837",3,1,0,4,"dummy"
"175838",0,0,1,1,"dummy"
"175843",0,0,1,1,"dummy"
"175737",1,1,0,2,"dummy"
"175742",0,0,0,0,"dummy"
"175743",0,0,0,0,"dummy"
"175782",1,11,0,12,"dummy"
"175783",0,4,0,4,"dummy"
"175784",0,2,0,2,"dummy"
"175804",0,2,0,2,"dummy"
"175805",1,2,0,3,"dummy"
"175815",2,4,0,6,"dummy"
"175816",0,2,0,2,"dummy"
"175817",0,2,0,2,"dummy"
"175818",10,2,0,12,"dummy"
"175819",0,2,0,2,"dummy"
"175820",0,0,0,0,"dummy"
"175821",0,0,3,3,"dummy"
"175822",0,0,0,0,"dummy"
"175825",0,0,1,1,"dummy"
"175826",0,1,0,1,"dummy"
"175827",0,0,1,1,"dummy"
"175828",0,0,1,1,"dummy"
"175829",0,0,1,1,"dummy"
"175830",0,0,1,1,"dummy"
"175831",0,0,1,1,"dummy"
"175832",0,0,1,1,"dummy"
"175833",0,0,1,1,"dummy"
"175845",0,0,0,0,"dummy"
"175846",0,0,0,0,"dummy"
"175854",0,2,0,2,"dummy"
"175855",5,7,5,17,"dummy"
"175856",0,1,0,1,"dummy"
"175863",0,0,0,0,"dummy"
"175864",0,0,0,0,"dummy"
"175870",1,3,1,5,"dummy"
"175871",0,0,1,1,"dummy"
"175872",0,2,0,2,"dummy"
"175873",5,1,0,6,"dummy"
"175874",1,4,0,5,"dummy"
"175875",3,2,2,7,"dummy"
"175876",0,0,1,1,"dummy"
"175877",0,0,0,0,"dummy"
"175905",0,0,1,1,"dummy"
"175906",0,0,0,0,"dummy"
"175907",0,1,1,2,"dummy"
"175908",2,1,0,3,"dummy"
"175913",0,0,1,1,"dummy"
"175916",0,0,1,1,"dummy"
"175917",0,0,0,0,"dummy"
"175931",0,0,1,1,"dummy"
"175932",0,3,0,3,"dummy"
"175933",0,0,0,0,"dummy"
"175934",0,0,2,2,"dummy"
"175935",0,0,1,1,"dummy"
"175936",0,0,1,1,"dummy"
"175937",0,0,1,1,"dummy"
"175938",0,0,1,1,"dummy"
"175939",0,0,1,1,"dummy"
"175940",0,0,1,1,"dummy"
"175941",0,0,1,1,"dummy"
"175942",0,0,1,1,"dummy"
"175943",0,0,1,1,"dummy"
"175944",0,0,1,1,"dummy"
"175945",0,0,1,1,"dummy"
"175946",0,0,1,1,"dummy"
"175947",0,0,1,1,"dummy"
"175948",0,0,1,1,"dummy"
"175949",0,0,2,2,"dummy"
"175950",0,0,1,1,"dummy"
"175951",0,0,1,1,"dummy"
"175952",1,1,1,3,"dummy"
"175953",3,2,0,5,"dummy"
"175954",3,3,1,7,"dummy"
"175955",0,1,0,1,"dummy"
"175956",0,1,0,1,"dummy"
"175957",6,7,2,15,"dummy"
"175958",11,17,1,29,"dummy"
"175959",0,0,1,1,"dummy"
"175960",0,0,1,1,"dummy"
"175961",0,1,0,1,"dummy"
"175962",0,0,2,2,"dummy"
"175848",0,1,0,1,"dummy"
"175849",0,1,0,1,"dummy"
"175850",5,4,0,9,"dummy"
"175858",4,5,1,10,"dummy"
"175859",0,2,0,2,"dummy"
"175860",0,4,0,4,"dummy"
"175861",0,1,0,1,"dummy"
"175866",0,1,0,1,"dummy"
"175867",1,0,0,1,"dummy"
"175868",0,1,0,1,"dummy"
"175884",0,21,0,21,"dummy"
"175885",0,1,0,1,"dummy"
"175886",0,6,0,6,"dummy"
"175887",7,0,0,7,"dummy"
"175888",0,6,1,7,"dummy"
"175889",0,1,2,3,"dummy"
"175890",0,0,1,1,"dummy"
"175891",2,1,1,4,"dummy"
"175892",0,0,1,1,"dummy"
"175895",1,2,1,4,"dummy"
"175896",9,0,1,10,"dummy"
"175897",0,3,0,3,"dummy"
"175898",2,0,1,3,"dummy"
"175899",0,1,0,1,"dummy"
"175900",0,0,0,0,"dummy"
"175901",0,8,0,8,"dummy"
"175902",0,1,0,1,"dummy"
"175903",0,6,0,6,"dummy"
"175910",2,2,4,8,"dummy"
"175911",1,2,4,7,"dummy"
"175919",2,3,1,6,"dummy"
"175920",1,0,2,3,"dummy"
"175921",0,0,3,3,"dummy"
"175922",2,2,1,5,"dummy"
"175923",0,2,1,3,"dummy"
"175924",2,0,1,3,"dummy"
"175927",0,0,0,0,"dummy"
"175966",3,9,3,15,"dummy"
"175967",3,2,0,5,"dummy"
"175968",0,1,1,2,"dummy"
"175971",2,3,2,7,"dummy"
"175972",3,2,2,7,"dummy"
"175973",0,1,0,1,"dummy"
"175974",2,0,0,2,"dummy"
"175975",0,1,0,1,"dummy"
"175977",0,2,1,3,"dummy"
"175978",0,2,0,2,"dummy"
"175979",0,0,1,1,"dummy"
"175980",0,0,1,1,"dummy"
"175981",0,0,1,1,"dummy"
"175985",0,0,1,1,"dummy"
"175986",0,0,1,1,"dummy"
"175987",1,1,0,2,"dummy"
"175995",0,0,0,0,"dummy"
"176001",8,0,3,11,"dummy"
"176002",0,0,2,2,"dummy"
"176003",0,1,0,1,"dummy"
"176004",0,2,1,3,"dummy"
"176005",2,2,2,6,"dummy"
"176006",0,2,0,2,"dummy"
"176016",0,0,1,1,"dummy"
"176017",3,0,2,5,"dummy"
"176018",0,4,1,5,"dummy"
"176019",0,1,0,1,"dummy"
"176020",0,0,0,0,"dummy"
"176022",0,0,1,1,"dummy"
"176025",0,0,1,1,"dummy"
"176028",0,5,2,7,"dummy"
"176029",0,4,0,4,"dummy"
"176030",4,6,0,10,"dummy"
"176031",9,0,3,12,"dummy"
"176033",0,0,0,0,"dummy"
"176035",0,1,0,1,"dummy"
"176036",8,19,1,28,"dummy"
"176039",1,6,0,7,"dummy"
"176040",5,0,0,5,"dummy"
"176041",5,2,0,7,"dummy"
"176042",2,4,0,6,"dummy"
"176043",0,1,0,1,"dummy"
"176044",0,0,2,2,"dummy"
"176045",8,18,5,31,"dummy"
"176046",0,0,1,1,"dummy"
"176047",2,0,0,2,"dummy"
"176048",0,2,0,2,"dummy"
"176049",0,0,2,2,"dummy"
"176050",3,2,0,5,"dummy"
"176055",1,3,0,4,"dummy"
"176056",0,6,0,6,"dummy"
"176058",0,0,0,0,"dummy"
"176059",0,0,0,0,"dummy"
"176060",0,0,0,0,"dummy"
"176064",0,1,0,1,"dummy"
"176065",0,1,0,1,"dummy"
"176066",1,0,0,1,"dummy"
"176070",0,0,2,2,"dummy"
"176072",0,0,1,1,"dummy"
"176073",14,17,3,34,"dummy"
"176074",0,1,1,2,"dummy"
"176077",0,3,1,4,"dummy"
"176081",0,7,2,9,"dummy"
"176083",6,0,1,7,"dummy"
"176085",0,0,1,1,"dummy"
"176089",0,3,0,3,"dummy"
"176090",0,1,0,1,"dummy"
"176092",0,5,0,5,"dummy"
"176093",0,4,0,4,"dummy"
"176094",1,1,3,5,"dummy"
"176095",0,0,2,2,"dummy"
"176107",1,4,1,6,"dummy"
"176108",4,1,2,7,"dummy"
"176109",1,4,1,6,"dummy"
"176110",1,0,0,1,"dummy"
"176111",2,1,2,5,"dummy"
"176113",3,1,0,4,"dummy"
"176114",1,1,1,3,"dummy"
"176115",4,3,4,11,"dummy"
"176116",0,0,1,1,"dummy"
"176117",0,1,0,1,"dummy"
"176118",0,0,2,2,"dummy"
"176121",0,0,1,1,"dummy"
"176122",2,0,1,3,"dummy"
"176123",0,2,0,2,"dummy"
"176125",6,7,2,15,"dummy"
"176126",1,0,0,1,"dummy"
"176129",0,0,1,1,"dummy"
"176130",0,1,0,1,"dummy"
"176131",0,1,0,1,"dummy"
"176132",2,1,1,4,"dummy"
"176133",0,1,0,1,"dummy"
"176135",0,3,2,5,"dummy"
"176138",0,0,0,0,"dummy"
"176140",0,0,2,2,"dummy"
"176141",0,0,1,1,"dummy"
"176142",1,0,0,1,"dummy"
"176145",0,1,0,1,"dummy"
"176146",0,2,0,2,"dummy"
"176147",0,2,0,2,"dummy"
"176149",40,13,3,56,"dummy"
"176150",0,1,0,1,"dummy"
"176151",0,2,0,2,"dummy"
"176152",0,2,0,2,"dummy"
"176156",1,16,0,17,"dummy"
"176175",0,1,0,1,"dummy"
"176177",0,1,0,1,"dummy"
"176178",1,5,2,8,"dummy"
"176179",0,1,0,1,"dummy"
"176183",0,0,0,0,"dummy"
"176185",0,1,0,1,"dummy"
"176187",0,1,0,1,"dummy"
"176188",0,0,1,1,"dummy"
"176189",0,0,1,1,"dummy"
"176192",0,0,2,2,"dummy"
"176212",0,0,1,1,"dummy"
"176214",0,0,1,1,"dummy"
"176215",0,0,5,5,"dummy"
"176216",0,0,1,1,"dummy"
"176217",0,0,2,2,"dummy"
"176218",0,1,5,6,"dummy"
"176221",6,1,1,8,"dummy"
"176222",0,0,0,0,"dummy"
"176249",0,11,0,11,"dummy"
"176253",0,0,2,2,"dummy"
"176254",1,4,0,5,"dummy"
"176255",15,11,4,30,"dummy"
"176256",2,2,3,7,"dummy"
"176257",0,2,4,6,"dummy"
"176258",9,0,1,10,"dummy"
"176259",0,0,1,1,"dummy"
"176260",0,0,3,3,"dummy"
"176270",0,17,1,18,"dummy"
"176271",0,0,1,1,"dummy"
"176272",0,0,0,0,"dummy"
"176273",0,1,0,1,"dummy"
"176274",0,29,1,30,"dummy"
"176275",1,13,0,14,"dummy"
"176276",2,2,0,4,"dummy"
"176277",2,6,1,9,"dummy"
"176278",3,15,0,18,"dummy"
"176279",1,4,1,6,"dummy"
"176280",15,2,1,18,"dummy"
"176281",0,0,1,1,"dummy"
"176282",3,11,0,14,"dummy"
"176283",0,1,0,1,"dummy"
"176284",1,0,1,2,"dummy"
"176285",0,1,0,1,"dummy"
"176286",0,6,0,6,"dummy"
"176287",0,0,1,1,"dummy"
"176288",1,3,3,7,"dummy"
"176289",0,0,1,1,"dummy"
"176292",3,2,0,5,"dummy"
"176293",1,2,1,4,"dummy"
"176294",0,2,0,2,"dummy"
"176301",0,0,1,1,"dummy"
"176302",2,2,0,4,"dummy"
"176319",4,10,2,16,"dummy"
"176320",0,1,0,1,"dummy"
"176348",10,9,5,24,"dummy"
"176351",0,0,0,0,"dummy"
"176352",0,0,0,0,"dummy"
"176353",0,0,0,0,"dummy"
"176354",0,0,0,0,"dummy"
"176355",0,0,0,0,"dummy"
"176356",0,0,1,1,"dummy"
"176357",0,0,0,0,"dummy"
"176358",0,0,0,0,"dummy"
"176359",1,2,0,3,"dummy"
"176360",0,0,0,0,"dummy"
"176361",0,0,0,0,"dummy"
"176362",0,0,0,0,"dummy"
"176363",0,0,0,0,"dummy"
"176364",0,0,1,1,"dummy"
"176365",0,0,0,0,"dummy"
"176366",0,0,0,0,"dummy"
"176367",0,0,0,0,"dummy"
"176368",0,0,1,1,"dummy"
"176369",0,0,0,0,"dummy"
"176370",0,0,1,1,"dummy"
"176374",0,1,2,3,"dummy"
"176375",0,7,0,7,"dummy"
"176376",0,2,1,3,"dummy"
"176377",2,1,0,3,"dummy"
"176378",0,1,0,1,"dummy"
"176379",0,0,3,3,"dummy"
"176380",0,1,1,2,"dummy"
"176381",0,0,0,0,"dummy"
"176385",2,0,0,2,"dummy"
"176399",0,0,2,2,"dummy"
"176408",0,1,1,2,"dummy"
"176409",1,0,1,2,"dummy"
"176429",0,1,0,1,"dummy"
"176430",0,1,0,1,"dummy"
"176434",2,2,0,4,"dummy"
"176435",0,6,1,7,"dummy"
"176436",2,5,0,7,"dummy"
"176451",0,0,0,0,"dummy"
"176458",0,4,0,4,"dummy"
"176466",0,0,1,1,"dummy"
"176467",0,1,1,2,"dummy"
"176468",1,13,1,15,"dummy"
"176484",0,3,0,3,"dummy"
"176485",10,8,2,20,"dummy"
"176486",0,0,1,1,"dummy"
"176491",0,0,1,1,"dummy"
"176492",0,0,3,3,"dummy"
"176493",0,0,1,1,"dummy"
"176494",0,0,3,3,"dummy"
"176495",0,3,0,3,"dummy"
"176496",0,0,2,2,"dummy"
"176497",3,0,0,3,"dummy"
"176498",0,3,0,3,"dummy"
"176499",1,0,2,3,"dummy"
"176500",0,0,2,2,"dummy"
"176501",0,0,0,0,"dummy"
"176502",0,1,0,1,"dummy"
"176503",0,0,0,0,"dummy"
"176504",0,0,1,1,"dummy"
"176505",0,0,1,1,"dummy"
"176506",12,0,1,13,"dummy"
"176507",0,0,0,0,"dummy"
"176317",1,0,0,1,"dummy"
"176322",1,0,0,1,"dummy"
"176323",12,0,2,14,"dummy"
"176324",0,1,0,1,"dummy"
"176325",0,2,1,3,"dummy"
"176340",0,1,0,1,"dummy"
"176341",1,0,0,1,"dummy"
"176344",0,2,1,3,"dummy"
"176372",1,0,0,1,"dummy"
"176383",2,2,0,4,"dummy"
"176397",0,1,0,1,"dummy"
"176401",0,1,1,2,"dummy"
"176402",1,1,0,2,"dummy"
"176403",1,1,0,2,"dummy"
"176404",0,1,0,1,"dummy"
"176405",1,1,1,3,"dummy"
"176406",1,1,0,2,"dummy"
"176432",0,0,3,3,"dummy"
"176442",0,1,0,1,"dummy"
"176443",1,1,0,2,"dummy"
"176446",0,8,0,8,"dummy"
"176447",0,0,0,0,"dummy"
"176448",0,0,1,1,"dummy"
"176449",0,0,0,0,"dummy"
"176531",0,3,2,5,"dummy"
"176532",2,4,3,9,"dummy"
"176533",4,4,1,9,"dummy"
"176534",0,1,0,1,"dummy"
"176535",1,9,1,11,"dummy"
"176536",0,0,1,1,"dummy"
"176539",0,1,0,1,"dummy"
"176540",5,12,3,20,"dummy"
"176541",0,1,0,1,"dummy"
"176542",1,1,0,2,"dummy"
"176543",1,1,0,2,"dummy"
"176552",4,2,0,6,"dummy"
"176553",0,1,0,1,"dummy"
"176556",2,1,2,5,"dummy"
"176557",0,1,0,1,"dummy"
"176585",1,1,0,2,"dummy"
"176586",4,8,0,12,"dummy"
"176587",0,1,0,1,"dummy"
"176588",1,0,15,16,"dummy"
"176589",0,1,15,16,"dummy"
"176590",0,0,16,16,"dummy"
"176591",0,2,0,2,"dummy"
"176592",0,2,0,2,"dummy"
"176593",0,2,0,2,"dummy"
"176594",0,1,1,2,"dummy"
"176595",0,0,1,1,"dummy"
"176601",0,1,0,1,"dummy"
"176602",0,3,1,4,"dummy"
"176609",0,10,2,12,"dummy"
"176610",3,7,2,12,"dummy"
"176611",0,1,0,1,"dummy"
"176612",0,1,0,1,"dummy"
"176613",0,0,0,0,"dummy"
"176614",0,0,0,0,"dummy"
"176615",0,0,2,2,"dummy"
"176616",10,1,2,13,"dummy"
"176617",0,1,0,1,"dummy"
"176618",0,0,3,3,"dummy"
"176619",0,0,1,1,"dummy"
"176630",2,2,2,6,"dummy"
"176633",0,1,0,1,"dummy"
"176508",2,0,0,2,"dummy"
"176509",2,0,1,3,"dummy"
"176510",9,17,2,28,"dummy"
"176511",3,0,1,4,"dummy"
"176512",3,0,1,4,"dummy"
"176513",2,0,1,3,"dummy"
"176514",2,0,0,2,"dummy"
"176515",1,1,1,3,"dummy"
"176516",2,0,1,3,"dummy"
"176517",0,0,0,0,"dummy"
"176518",1,1,1,3,"dummy"
"176519",0,1,0,1,"dummy"
"176520",0,0,2,2,"dummy"
"176521",1,0,2,3,"dummy"
"176522",0,0,1,1,"dummy"
"176523",0,1,0,1,"dummy"
"176524",0,0,2,2,"dummy"
"176525",9,20,3,32,"dummy"
"176526",0,0,1,1,"dummy"
"176527",1,1,1,3,"dummy"
"176528",24,1,4,29,"dummy"
"176529",0,0,1,1,"dummy"
"176545",0,1,0,1,"dummy"
"176546",0,2,0,2,"dummy"
"176547",0,2,0,2,"dummy"
"176548",0,4,1,5,"dummy"
"176579",0,1,1,2,"dummy"
"176580",0,1,0,1,"dummy"
"176581",0,0,0,0,"dummy"
"176582",0,0,2,2,"dummy"
"176583",0,1,2,3,"dummy"
"176599",3,4,0,7,"dummy"
"176606",0,1,0,1,"dummy"
"176607",0,0,1,1,"dummy"
"176627",0,2,0,2,"dummy"
"176628",0,2,0,2,"dummy"
"176635",0,0,0,0,"dummy"
"176659",1,22,0,23,"dummy"
"176660",0,1,0,1,"dummy"
"176661",3,35,1,39,"dummy"
"176662",1,1,1,3,"dummy"
"176663",0,3,0,3,"dummy"
"176664",0,0,1,1,"dummy"
"176665",0,1,0,1,"dummy"
"176666",0,0,2,2,"dummy"
"176667",0,4,0,4,"dummy"
"176668",0,5,0,5,"dummy"
"176669",0,0,3,3,"dummy"
"176670",0,4,0,4,"dummy"
"176671",31,1,0,32,"dummy"
"176672",10,13,2,25,"dummy"
"176673",5,1,0,6,"dummy"
"176674",0,1,1,2,"dummy"
"176675",0,1,0,1,"dummy"
"176692",1,12,0,13,"dummy"
"176693",22,4,2,28,"dummy"
"176694",4,24,2,30,"dummy"
"176695",1,3,1,5,"dummy"
"176696",0,1,0,1,"dummy"
"176697",0,1,1,2,"dummy"
"176714",0,1,0,1,"dummy"
"176743",0,0,1,1,"dummy"
"176755",30,9,0,39,"dummy"
"176756",1,29,0,30,"dummy"
"176757",29,0,0,29,"dummy"
"176758",0,1,0,1,"dummy"
"176763",0,1,1,2,"dummy"
"176683",2,6,0,8,"dummy"
"176684",0,0,1,1,"dummy"
"176685",0,0,1,1,"dummy"
"176686",0,0,3,3,"dummy"
"176687",1,7,4,12,"dummy"
"176688",0,0,0,0,"dummy"
"176699",0,0,3,3,"dummy"
"176700",0,0,1,1,"dummy"
"176701",0,1,0,1,"dummy"
"176702",0,7,0,7,"dummy"
"176703",0,0,1,1,"dummy"
"176704",7,0,2,9,"dummy"
"176705",0,0,1,1,"dummy"
"176708",0,0,4,4,"dummy"
"176711",0,1,1,2,"dummy"
"176712",1,3,1,5,"dummy"
"176716",1,1,1,3,"dummy"
"176732",0,4,0,4,"dummy"
"176733",0,0,1,1,"dummy"
"176736",0,3,0,3,"dummy"
"176737",0,2,0,2,"dummy"
"176738",0,1,0,1,"dummy"
"176739",0,0,1,1,"dummy"
"176745",0,8,0,8,"dummy"
"176760",1,0,2,3,"dummy"
"176761",1,4,2,7,"dummy"
"176785",0,0,1,1,"dummy"
"176786",0,1,0,1,"dummy"
"176791",1,1,0,2,"dummy"
"176798",1,0,0,1,"dummy"
"176810",0,0,0,0,"dummy"
"176811",0,0,1,1,"dummy"
"176812",0,0,0,0,"dummy"
"176813",0,1,0,1,"dummy"
"176814",0,0,0,0,"dummy"
"176815",0,0,0,0,"dummy"
"176816",0,0,0,0,"dummy"
"176837",2,3,0,5,"dummy"
"176838",1,0,1,2,"dummy"
"176839",0,1,0,1,"dummy"
"176842",0,0,1,1,"dummy"
"176863",0,0,0,0,"dummy"
"176876",0,0,0,0,"dummy"
"176881",0,1,0,1,"dummy"
"176882",0,1,0,1,"dummy"
"176883",4,3,2,9,"dummy"
"176884",0,0,0,0,"dummy"
"176885",0,1,0,1,"dummy"
"176886",4,0,1,5,"dummy"
"176889",1,0,0,1,"dummy"
"176890",0,0,1,1,"dummy"
"176891",0,1,1,2,"dummy"
"176892",4,4,0,8,"dummy"
"176900",0,1,0,1,"dummy"
"176901",1,0,0,1,"dummy"
"176902",3,3,1,7,"dummy"
"176903",0,0,3,3,"dummy"
"176904",0,0,1,1,"dummy"
"176905",0,0,1,1,"dummy"
"176915",0,0,0,0,"dummy"
"176916",0,0,0,0,"dummy"
"176764",1,0,0,1,"dummy"
"176765",0,0,1,1,"dummy"
"176766",0,0,1,1,"dummy"
"176767",0,0,2,2,"dummy"
"176768",0,1,1,2,"dummy"
"176771",0,0,0,0,"dummy"
"176774",0,1,0,1,"dummy"
"176775",1,3,1,5,"dummy"
"176776",9,7,0,16,"dummy"
"176777",0,0,1,1,"dummy"
"176778",1,1,0,2,"dummy"
"176779",0,1,0,1,"dummy"
"176780",6,7,0,13,"dummy"
"176781",2,0,0,2,"dummy"
"176788",0,0,1,1,"dummy"
"176789",0,0,1,1,"dummy"
"176795",0,0,1,1,"dummy"
"176796",5,2,7,14,"dummy"
"176800",11,58,3,72,"dummy"
"176801",26,13,0,39,"dummy"
"176820",2,2,0,4,"dummy"
"176821",0,1,0,1,"dummy"
"176822",1,0,0,1,"dummy"
"176823",0,1,0,1,"dummy"
"176824",0,2,0,2,"dummy"
"176829",1,1,0,2,"dummy"
"176830",9,4,6,19,"dummy"
"176831",1,3,1,5,"dummy"
"176832",2,2,0,4,"dummy"
"176833",0,0,2,2,"dummy"
"176850",0,1,0,1,"dummy"
"176851",0,1,0,1,"dummy"
"176852",0,2,0,2,"dummy"
"176853",2,2,0,4,"dummy"
"176854",0,3,1,4,"dummy"
"176855",0,6,0,6,"dummy"
"176856",3,3,0,6,"dummy"
"176857",1,1,0,2,"dummy"
"176858",0,3,1,4,"dummy"
"176859",1,1,0,2,"dummy"
"176860",1,1,0,2,"dummy"
"176861",0,1,0,1,"dummy"
"176865",0,5,0,5,"dummy"
"176866",0,4,0,4,"dummy"
"176867",1,1,3,5,"dummy"
"176868",0,0,2,2,"dummy"
"176874",0,0,0,0,"dummy"
"176878",5,8,2,15,"dummy"
"176879",1,1,0,2,"dummy"
"176934",0,3,0,3,"dummy"
"176935",6,4,0,10,"dummy"
"176936",0,0,3,3,"dummy"
"176937",2,2,2,6,"dummy"
"176938",0,5,0,5,"dummy"
"176939",0,2,0,2,"dummy"
"176940",0,3,0,3,"dummy"
"176941",0,0,1,1,"dummy"
"176942",0,0,1,1,"dummy"
"176943",0,2,0,2,"dummy"
"176944",0,2,0,2,"dummy"
"176945",3,5,0,8,"dummy"
"176946",0,2,0,2,"dummy"
"176947",0,2,0,2,"dummy"
"176948",0,2,0,2,"dummy"
"176951",0,1,0,1,"dummy"
"176952",0,0,0,0,"dummy"
"176953",2,1,2,5,"dummy"
"176990",0,1,0,1,"dummy"
"176991",3,2,1,6,"dummy"
"176992",0,6,3,9,"dummy"
"176993",6,0,2,8,"dummy"
"176994",0,1,1,2,"dummy"
"176999",0,0,2,2,"dummy"
"177000",2,2,1,5,"dummy"
"177001",0,8,0,8,"dummy"
"177002",0,2,0,2,"dummy"
"176917",0,0,0,0,"dummy"
"176918",0,0,0,0,"dummy"
"176919",0,0,0,0,"dummy"
"176922",6,3,4,13,"dummy"
"176957",0,0,1,1,"dummy"
"176958",0,0,1,1,"dummy"
"176959",0,0,2,2,"dummy"
"176960",0,0,1,1,"dummy"
"176961",2,0,0,2,"dummy"
"176962",0,0,1,1,"dummy"
"176963",0,2,0,2,"dummy"
"176964",0,0,1,1,"dummy"
"176965",0,2,0,2,"dummy"
"176966",0,1,0,1,"dummy"
"176967",0,0,1,1,"dummy"
"176968",0,1,0,1,"dummy"
"176969",0,1,1,2,"dummy"
"176970",1,2,1,4,"dummy"
"176971",0,1,1,2,"dummy"
"176972",0,2,0,2,"dummy"
"176973",0,0,1,1,"dummy"
"176974",0,1,0,1,"dummy"
"176975",0,6,0,6,"dummy"
"176976",0,0,0,0,"dummy"
"176977",0,0,0,0,"dummy"
"176978",0,0,2,2,"dummy"
"176979",0,1,0,1,"dummy"
"176980",4,1,0,5,"dummy"
"176981",1,0,0,1,"dummy"
"176982",0,0,0,0,"dummy"
"176983",7,0,0,7,"dummy"
"176984",0,0,0,0,"dummy"
"176985",0,0,0,0,"dummy"
"176986",0,0,0,0,"dummy"
"176987",0,0,0,0,"dummy"
"176988",1,0,0,1,"dummy"
"176996",9,3,2,14,"dummy"
"176997",1,0,0,1,"dummy"
"177006",0,0,1,1,"dummy"
"177032",0,0,1,1,"dummy"
"177033",0,0,1,1,"dummy"
"177034",0,0,1,1,"dummy"
"177035",0,0,1,1,"dummy"
"177043",0,3,0,3,"dummy"
"177044",1,2,4,7,"dummy"
"177045",0,0,1,1,"dummy"
"177046",0,0,2,2,"dummy"
"177050",1,9,1,11,"dummy"
"177051",11,4,2,17,"dummy"
"177056",0,2,0,2,"dummy"
"177062",5,20,0,25,"dummy"
"177081",2,1,0,3,"dummy"
"177082",1,2,1,4,"dummy"
"177085",0,0,0,0,"dummy"
"177086",0,1,0,1,"dummy"
"177087",3,4,2,9,"dummy"
"177088",0,0,1,1,"dummy"
"177089",0,0,1,1,"dummy"
"177090",2,2,0,4,"dummy"
"177091",0,0,1,1,"dummy"
"177092",0,0,1,1,"dummy"
"177093",0,0,1,1,"dummy"
"177094",0,1,0,1,"dummy"
"177095",0,1,0,1,"dummy"
"177096",1,9,4,14,"dummy"
"177097",0,2,0,2,"dummy"
"177098",2,0,2,4,"dummy"
"177099",0,0,1,1,"dummy"
"177100",0,0,0,0,"dummy"
"177101",0,0,0,0,"dummy"
"177118",0,0,0,0,"dummy"
"177121",2,15,1,18,"dummy"
"177122",0,0,1,1,"dummy"
"177125",0,0,2,2,"dummy"
"177126",4,3,2,9,"dummy"
"177127",0,0,1,1,"dummy"
"177128",2,2,0,4,"dummy"
"177129",1,1,0,2,"dummy"
"177130",0,0,0,0,"dummy"
"177048",3,0,0,3,"dummy"
"177053",0,1,0,1,"dummy"
"177054",0,1,0,1,"dummy"
"177058",0,3,1,4,"dummy"
"177059",2,11,3,16,"dummy"
"177060",0,2,0,2,"dummy"
"177064",0,0,2,2,"dummy"
"177065",4,3,4,11,"dummy"
"177066",1,0,3,4,"dummy"
"177067",0,15,3,18,"dummy"
"177105",0,0,0,0,"dummy"
"177108",0,0,1,1,"dummy"
"177109",0,0,1,1,"dummy"
"177113",1,3,1,5,"dummy"
"177114",0,1,0,1,"dummy"
"177132",0,0,1,1,"dummy"
"177133",3,6,1,10,"dummy"
"177134",1,1,0,2,"dummy"
"177135",1,2,0,3,"dummy"
"177136",0,1,1,2,"dummy"
"177143",1,2,2,5,"dummy"
"177146",0,0,1,1,"dummy"
"177147",0,0,2,2,"dummy"
"177148",17,24,6,47,"dummy"
"177149",5,5,0,10,"dummy"
"177150",7,4,0,11,"dummy"
"177151",0,1,0,1,"dummy"
"177175",4,0,0,4,"dummy"
"177176",0,1,1,2,"dummy"
"177186",0,2,2,4,"dummy"
"177191",0,1,0,1,"dummy"
"177192",0,6,1,7,"dummy"
"177193",0,0,1,1,"dummy"
"177194",0,4,1,5,"dummy"
"177197",0,1,1,2,"dummy"
"177198",0,1,0,1,"dummy"
"177240",0,0,1,1,"dummy"
"177241",0,1,1,2,"dummy"
"177242",2,1,0,3,"dummy"
"177243",0,0,2,2,"dummy"
"177244",0,0,0,0,"dummy"
"177245",1,2,1,4,"dummy"
"177246",0,0,1,1,"dummy"
"177247",0,0,0,0,"dummy"
"177248",2,1,0,3,"dummy"
"177249",1,2,0,3,"dummy"
"177250",2,1,0,3,"dummy"
"177251",0,0,1,1,"dummy"
"177252",0,0,1,1,"dummy"
"177253",0,0,0,0,"dummy"
"177254",0,0,1,1,"dummy"
"177255",1,0,0,1,"dummy"
"177256",0,0,1,1,"dummy"
"177257",3,6,7,16,"dummy"
"177258",0,0,1,1,"dummy"
"177259",0,0,1,1,"dummy"
"177260",0,0,1,1,"dummy"
"177261",0,0,2,2,"dummy"
"177262",1,5,2,8,"dummy"
"177263",0,0,1,1,"dummy"
"177323",0,2,0,2,"dummy"
"177324",2,0,0,2,"dummy"
"177325",0,2,0,2,"dummy"
"177326",0,1,0,1,"dummy"
"177153",0,0,0,0,"dummy"
"177154",0,0,1,1,"dummy"
"177155",0,1,0,1,"dummy"
"177156",0,1,0,1,"dummy"
"177164",1,3,0,4,"dummy"
"177165",0,1,0,1,"dummy"
"177166",1,0,0,1,"dummy"
"177167",0,1,0,1,"dummy"
"177168",0,0,1,1,"dummy"
"177169",0,4,0,4,"dummy"
"177170",0,1,0,1,"dummy"
"177171",0,2,0,2,"dummy"
"177178",0,0,0,0,"dummy"
"177179",0,0,0,0,"dummy"
"177182",0,0,1,1,"dummy"
"177183",0,1,0,1,"dummy"
"177184",1,0,0,1,"dummy"
"177188",0,0,1,1,"dummy"
"177189",0,1,0,1,"dummy"
"177200",2,3,0,5,"dummy"
"177201",1,3,0,4,"dummy"
"177202",0,1,0,1,"dummy"
"177203",3,1,0,4,"dummy"
"177204",5,1,0,6,"dummy"
"177207",0,0,1,1,"dummy"
"177210",0,0,1,1,"dummy"
"177224",1,2,1,4,"dummy"
"177225",0,0,1,1,"dummy"
"177226",2,2,3,7,"dummy"
"177227",16,12,6,34,"dummy"
"177228",0,1,0,1,"dummy"
"177229",0,1,0,1,"dummy"
"177230",1,0,0,1,"dummy"
"177231",0,0,1,1,"dummy"
"177232",0,0,1,1,"dummy"
"177233",0,0,0,0,"dummy"
"177234",0,0,1,1,"dummy"
"177235",1,0,0,1,"dummy"
"177236",0,0,1,1,"dummy"
"177265",0,0,4,4,"dummy"
"177266",0,0,0,0,"dummy"
"177267",0,0,0,0,"dummy"
"177268",1,13,0,14,"dummy"
"177269",1,4,4,9,"dummy"
"177270",0,4,0,4,"dummy"
"177271",11,6,4,21,"dummy"
"177272",0,0,0,0,"dummy"
"177273",2,3,0,5,"dummy"
"177274",0,0,1,1,"dummy"
"177277",0,3,0,3,"dummy"
"177278",1,0,0,1,"dummy"
"177279",0,1,2,3,"dummy"
"177280",0,2,0,2,"dummy"
"177281",0,2,0,2,"dummy"
"177282",0,5,0,5,"dummy"
"177283",0,3,0,3,"dummy"
"177284",0,1,0,1,"dummy"
"177285",0,2,0,2,"dummy"
"177286",6,3,0,9,"dummy"
"177287",4,8,5,17,"dummy"
"177288",0,1,0,1,"dummy"
"177289",0,1,0,1,"dummy"
"177290",0,0,0,0,"dummy"
"177291",5,2,0,7,"dummy"
"177292",0,4,0,4,"dummy"
"177293",18,1,3,22,"dummy"
"177294",0,0,1,1,"dummy"
"177295",0,0,1,1,"dummy"
"177296",0,0,1,1,"dummy"
"177297",0,2,0,2,"dummy"
"177298",0,0,0,0,"dummy"
"177299",0,2,0,2,"dummy"
"177300",1,1,1,3,"dummy"
"177301",0,0,1,1,"dummy"
"177302",0,2,0,2,"dummy"
"177303",0,3,0,3,"dummy"
"177304",2,1,0,3,"dummy"
"177305",0,0,1,1,"dummy"
"177306",0,4,0,4,"dummy"
"177307",9,0,0,9,"dummy"
"177308",0,4,0,4,"dummy"
"177309",0,2,0,2,"dummy"
"177310",0,0,0,0,"dummy"
"177311",0,0,0,0,"dummy"
"177312",0,1,0,1,"dummy"
"177313",0,0,0,0,"dummy"
"177314",0,1,0,1,"dummy"
"177315",0,1,0,1,"dummy"
"177316",0,4,0,4,"dummy"
"177317",0,0,1,1,"dummy"
"177318",3,0,0,3,"dummy"
"177319",0,1,0,1,"dummy"
"177329",0,1,1,2,"dummy"
"177333",6,0,2,8,"dummy"
"177334",1,0,0,1,"dummy"
"177335",0,6,4,10,"dummy"
"177337",3,0,0,3,"dummy"
"177338",0,8,0,8,"dummy"
"177339",0,1,0,1,"dummy"
"177340",4,6,1,11,"dummy"
"177341",10,0,1,11,"dummy"
"177343",6,7,2,15,"dummy"
"177344",0,1,0,1,"dummy"
"177345",0,0,0,0,"dummy"
"177346",2,3,0,5,"dummy"
"177347",1,0,0,1,"dummy"
"177349",0,0,0,0,"dummy"
"177350",0,0,0,0,"dummy"
"177353",0,2,0,2,"dummy"
"177357",1,0,0,1,"dummy"
"177359",0,2,0,2,"dummy"
"177360",1,0,1,2,"dummy"
"177362",0,0,1,1,"dummy"
"177363",0,1,0,1,"dummy"
"177365",0,1,0,1,"dummy"
"177374",0,0,7,7,"dummy"
"177375",0,0,1,1,"dummy"
"177377",0,1,0,1,"dummy"
"177378",0,1,0,1,"dummy"
"177379",3,1,3,7,"dummy"
"177380",0,0,0,0,"dummy"
"177381",0,1,0,1,"dummy"
"177382",4,0,5,9,"dummy"
"177383",0,0,1,1,"dummy"
"177384",0,1,0,1,"dummy"
"177386",1,0,0,1,"dummy"
"177387",0,6,0,6,"dummy"
"177388",0,1,0,1,"dummy"
"177389",0,0,0,0,"dummy"
"177390",0,0,1,1,"dummy"
"177398",8,9,0,17,"dummy"
"177399",4,1,0,5,"dummy"
"177400",0,0,1,1,"dummy"
"177401",0,0,1,1,"dummy"
"177402",0,0,0,0,"dummy"
"177403",0,0,1,1,"dummy"
"177404",0,0,1,1,"dummy"
"177437",0,0,0,0,"dummy"
"177438",7,6,0,13,"dummy"
"177439",3,1,0,4,"dummy"
"177440",1,0,0,1,"dummy"
"177441",0,0,3,3,"dummy"
"177442",0,0,3,3,"dummy"
"177443",0,0,1,1,"dummy"
"177444",1,1,1,3,"dummy"
"177445",11,16,3,30,"dummy"
"177446",1,0,0,1,"dummy"
"177447",0,0,3,3,"dummy"
"177449",0,4,0,4,"dummy"
"177451",2,0,0,2,"dummy"
"177452",0,2,0,2,"dummy"
"177457",3,3,0,6,"dummy"
"177459",5,4,1,10,"dummy"
"177460",2,2,2,6,"dummy"
"177462",1,6,2,9,"dummy"
"177463",0,3,1,4,"dummy"
"177466",0,1,0,1,"dummy"
"177467",0,6,0,6,"dummy"
"177468",3,0,0,3,"dummy"
"177469",0,2,0,2,"dummy"
"177470",5,5,0,10,"dummy"
"177473",1,0,1,2,"dummy"
"177476",2,0,1,3,"dummy"
"177477",0,1,1,2,"dummy"
"177478",0,0,1,1,"dummy"
"177479",0,0,0,0,"dummy"
"177480",0,0,0,0,"dummy"
"177481",0,0,0,0,"dummy"
"177483",0,4,0,4,"dummy"
"177484",0,4,0,4,"dummy"
"177485",0,1,0,1,"dummy"
"177486",1,0,0,1,"dummy"
"177487",0,1,0,1,"dummy"
"177488",0,1,0,1,"dummy"
"177489",0,0,3,3,"dummy"
"177490",3,7,0,10,"dummy"
"177491",0,1,0,1,"dummy"
"177492",0,1,0,1,"dummy"
"177494",7,2,3,12,"dummy"
"177495",0,2,0,2,"dummy"
"177496",2,4,4,10,"dummy"
"177497",0,1,0,1,"dummy"
"177500",4,4,5,13,"dummy"
"177508",1,4,0,5,"dummy"
"177509",0,0,1,1,"dummy"
"177510",0,0,3,3,"dummy"
"177511",0,1,0,1,"dummy"
"177512",1,6,1,8,"dummy"
"177513",0,0,1,1,"dummy"
"177514",0,0,3,3,"dummy"
"177516",0,0,2,2,"dummy"
"177521",4,1,0,5,"dummy"
"177522",1,0,0,1,"dummy"
"177523",1,0,0,1,"dummy"
"177525",0,2,0,2,"dummy"
"177526",0,9,0,9,"dummy"
"177528",0,0,1,1,"dummy"
"177532",1,36,3,40,"dummy"
"177533",0,2,0,2,"dummy"
"177534",1,5,1,7,"dummy"
"177535",0,8,0,8,"dummy"
"177536",6,0,0,6,"dummy"
"177537",0,1,0,1,"dummy"
"177539",1,0,0,1,"dummy"
"177540",3,0,0,3,"dummy"
"177541",0,2,0,2,"dummy"
"177542",2,0,0,2,"dummy"
"177543",2,12,0,14,"dummy"
"177544",0,1,0,1,"dummy"
"177545",4,2,1,7,"dummy"
"177546",0,3,0,3,"dummy"
"177547",0,1,0,1,"dummy"
"177548",1,0,0,1,"dummy"
"177549",0,0,0,0,"dummy"
"177550",0,1,0,1,"dummy"
"177554",0,0,0,0,"dummy"
"177555",0,1,0,1,"dummy"
"177558",0,0,1,1,"dummy"
"177559",0,2,0,2,"dummy"
"177562",0,0,1,1,"dummy"
"177563",0,0,1,1,"dummy"
"177564",0,0,2,2,"dummy"
"177567",2,4,2,8,"dummy"
"177568",4,2,2,8,"dummy"
"177569",2,9,3,14,"dummy"
"177570",0,1,0,1,"dummy"
"177571",0,1,0,1,"dummy"
"177573",0,0,1,1,"dummy"
"177574",2,0,0,2,"dummy"
"177575",0,0,0,0,"dummy"
"177576",0,1,0,1,"dummy"
"177580",0,0,1,1,"dummy"
"177581",0,0,1,1,"dummy"
"177582",3,3,3,9,"dummy"
"177583",4,8,0,12,"dummy"
"177584",1,1,0,2,"dummy"
"177585",1,0,0,1,"dummy"
"177588",0,2,0,2,"dummy"
"177589",0,0,0,0,"dummy"
"177590",0,0,0,0,"dummy"
"177591",4,1,0,5,"dummy"
"177592",1,0,0,1,"dummy"
"177593",0,0,0,0,"dummy"
"177594",0,0,0,0,"dummy"
"177597",0,0,0,0,"dummy"
"177599",0,0,1,1,"dummy"
"177600",1,0,1,2,"dummy"
"177604",0,2,0,2,"dummy"
"177605",0,0,1,1,"dummy"
"177606",0,0,1,1,"dummy"
"177607",0,2,1,3,"dummy"
"177608",7,2,2,11,"dummy"
"177612",0,1,0,1,"dummy"
"177613",0,0,1,1,"dummy"
"177615",1,0,0,1,"dummy"
"177617",0,3,2,5,"dummy"
"177619",1,0,1,2,"dummy"
"177621",0,0,1,1,"dummy"
"177623",9,2,2,13,"dummy"
"177626",0,0,1,1,"dummy"
"177627",2,0,1,3,"dummy"
"177628",0,2,0,2,"dummy"
"177629",0,2,0,2,"dummy"
"177630",0,0,0,0,"dummy"
"177631",0,1,0,1,"dummy"
"177632",0,0,0,0,"dummy"
"177633",0,0,1,1,"dummy"
"177636",0,1,0,1,"dummy"
"177638",16,28,2,46,"dummy"
"177639",4,4,3,11,"dummy"
"177640",0,1,0,1,"dummy"
"177664",2,12,1,15,"dummy"
"177665",0,0,1,1,"dummy"
"177666",2,4,2,8,"dummy"
"177668",0,0,0,0,"dummy"
"177671",0,1,2,3,"dummy"
"177672",0,0,0,0,"dummy"
"177673",0,1,0,1,"dummy"
"177674",4,0,2,6,"dummy"
"177675",1,0,0,1,"dummy"
"177676",0,0,0,0,"dummy"
"177677",0,0,0,0,"dummy"
"177680",5,4,0,9,"dummy"
"177681",0,1,0,1,"dummy"
"177683",0,0,1,1,"dummy"
"177684",1,0,0,1,"dummy"
"177685",0,2,1,3,"dummy"
"177690",3,15,0,18,"dummy"
"177691",12,7,0,19,"dummy"
"177692",20,14,2,36,"dummy"
"177693",0,1,0,1,"dummy"
"177694",18,8,8,34,"dummy"
"177695",2,2,0,4,"dummy"
"177696",2,2,0,4,"dummy"
"177697",1,0,2,3,"dummy"
"177698",0,0,0,0,"dummy"
"177699",0,1,0,1,"dummy"
"177700",0,0,1,1,"dummy"
"177701",0,3,0,3,"dummy"
"177702",0,21,0,21,"dummy"
"177703",0,0,0,0,"dummy"
"177704",0,0,0,0,"dummy"
"177705",0,0,0,0,"dummy"
"177707",0,1,0,1,"dummy"
"177708",2,2,2,6,"dummy"
"177709",0,1,0,1,"dummy"
"177710",0,1,0,1,"dummy"
"177711",7,10,0,17,"dummy"
"177715",0,0,1,1,"dummy"
"177726",2,2,0,4,"dummy"
"177728",11,3,2,16,"dummy"
"177729",0,0,1,1,"dummy"
"177730",0,0,1,1,"dummy"
"177731",0,0,1,1,"dummy"
"177734",0,0,0,0,"dummy"
"177735",0,0,0,0,"dummy"
"177752",0,1,0,1,"dummy"
"177753",0,0,2,2,"dummy"
"177756",0,1,0,1,"dummy"
"177762",1,0,0,1,"dummy"
"177763",0,0,2,2,"dummy"
"177764",1,8,6,15,"dummy"
"177765",0,2,0,2,"dummy"
"177766",0,1,0,1,"dummy"
"177767",1,1,0,2,"dummy"
"177768",0,1,0,1,"dummy"
"177770",0,1,0,1,"dummy"
"177771",2,1,1,4,"dummy"
"177773",0,1,0,1,"dummy"
"177774",2,0,2,4,"dummy"
"177791",1,0,1,2,"dummy"
"177792",2,2,2,6,"dummy"
"177795",0,0,0,0,"dummy"
"177797",0,0,0,0,"dummy"
"177798",0,0,1,1,"dummy"
"177799",0,0,1,1,"dummy"
"177800",0,3,0,3,"dummy"
"177801",0,0,1,1,"dummy"
"177802",0,0,1,1,"dummy"
"177803",0,0,1,1,"dummy"
"177804",0,0,1,1,"dummy"
"177805",0,11,0,11,"dummy"
"177806",0,0,1,1,"dummy"
"177807",0,0,1,1,"dummy"
"177808",0,0,1,1,"dummy"
"177809",1,0,0,1,"dummy"
"177810",9,1,0,10,"dummy"
"177811",0,0,1,1,"dummy"
"177812",0,0,1,1,"dummy"
"177813",0,0,1,1,"dummy"
"177814",0,0,1,1,"dummy"
"177815",1,0,0,1,"dummy"
"177817",0,1,2,3,"dummy"
"177818",0,0,3,3,"dummy"
"177819",0,0,0,0,"dummy"
"177820",0,0,5,5,"dummy"
"177821",0,0,5,5,"dummy"
"177822",0,0,5,5,"dummy"
"177823",0,0,5,5,"dummy"
"177824",0,0,5,5,"dummy"
"177825",0,0,5,5,"dummy"
"177827",9,7,2,18,"dummy"
"177828",0,0,1,1,"dummy"
"177829",0,0,3,3,"dummy"
"177832",1,0,1,2,"dummy"
"177833",0,1,0,1,"dummy"
"177838",1,14,2,17,"dummy"
"177845",14,19,0,33,"dummy"
"177846",0,0,1,1,"dummy"
"177847",0,0,1,1,"dummy"
"177848",0,0,3,3,"dummy"
"177849",0,0,1,1,"dummy"
"177850",0,0,1,1,"dummy"
"177851",0,0,1,1,"dummy"
"177852",0,0,1,1,"dummy"
"177853",0,0,1,1,"dummy"
"177856",0,1,0,1,"dummy"
"177857",0,0,1,1,"dummy"
"177862",0,0,1,1,"dummy"
"177864",1,2,0,3,"dummy"
"177865",0,2,1,3,"dummy"
"177866",0,1,0,1,"dummy"
"177867",0,2,0,2,"dummy"
"177868",0,0,0,0,"dummy"
"177869",4,4,1,9,"dummy"
"177870",0,0,0,0,"dummy"
"177871",0,0,0,0,"dummy"
"177872",12,2,7,21,"dummy"
"177873",0,3,0,3,"dummy"
"177874",6,2,2,10,"dummy"
"177875",1,7,6,14,"dummy"
"177876",4,2,0,6,"dummy"
"177877",1,0,1,2,"dummy"
"177878",0,1,0,1,"dummy"
"177924",12,6,2,20,"dummy"
"177925",0,0,1,1,"dummy"
"177926",3,4,2,9,"dummy"
"177927",0,0,0,0,"dummy"
"177928",0,0,1,1,"dummy"
"177930",2,4,0,6,"dummy"
"177931",0,2,0,2,"dummy"
"177932",0,2,0,2,"dummy"
"177933",10,2,0,12,"dummy"
"177934",0,2,0,2,"dummy"
"177935",0,0,0,0,"dummy"
"177936",0,0,3,3,"dummy"
"177937",0,5,0,5,"dummy"
"177938",1,0,1,2,"dummy"
"177941",0,0,0,0,"dummy"
"177942",0,0,0,0,"dummy"
"177944",0,5,0,5,"dummy"
"177945",4,5,3,12,"dummy"
"177946",3,0,1,4,"dummy"
"177947",1,0,1,2,"dummy"
"177954",2,1,1,4,"dummy"
"177955",1,5,1,7,"dummy"
"177956",4,9,1,14,"dummy"
"177957",0,1,1,2,"dummy"
"177958",3,6,1,10,"dummy"
"177959",0,1,0,1,"dummy"
"177960",8,1,1,10,"dummy"
"177961",0,1,0,1,"dummy"
"177962",0,1,0,1,"dummy"
"177963",0,0,0,0,"dummy"
"177964",0,0,1,1,"dummy"
"177965",2,0,0,2,"dummy"
"177966",1,7,0,8,"dummy"
"177967",1,0,0,1,"dummy"
"177968",0,0,1,1,"dummy"
"177969",0,0,1,1,"dummy"
"177970",0,0,1,1,"dummy"
"177971",9,7,1,17,"dummy"
"177972",0,0,1,1,"dummy"
"177975",2,4,1,7,"dummy"
"177976",0,0,1,1,"dummy"
"177977",0,1,0,1,"dummy"
"177978",2,4,0,6,"dummy"
"177979",0,0,2,2,"dummy"
"177980",2,3,1,6,"dummy"
"177981",25,36,1,62,"dummy"
"177982",1,3,0,4,"dummy"
"177983",6,39,0,45,"dummy"
"177984",2,18,3,23,"dummy"
"177985",62,5,0,67,"dummy"
"177986",8,1,1,10,"dummy"
"177987",0,0,1,1,"dummy"
"177988",0,2,1,3,"dummy"
"177989",0,0,0,0,"dummy"
"177990",2,2,1,5,"dummy"
"177991",0,1,0,1,"dummy"
"177992",0,0,1,1,"dummy"
"177993",0,0,1,1,"dummy"
"177994",0,0,1,1,"dummy"
"177996",9,5,6,20,"dummy"
"177997",0,1,0,1,"dummy"
"177998",0,1,0,1,"dummy"
"177999",0,1,0,1,"dummy"
"178001",0,0,1,1,"dummy"
"178002",0,0,1,1,"dummy"
"178003",0,1,0,1,"dummy"
"178004",0,4,1,5,"dummy"
"178006",3,1,0,4,"dummy"
"178007",0,1,0,1,"dummy"
"178010",5,1,0,6,"dummy"
"178011",0,0,1,1,"dummy"
"178012",0,0,1,1,"dummy"
"178013",0,0,1,1,"dummy"
"178016",2,2,0,4,"dummy"
"178021",0,0,1,1,"dummy"
"178022",0,0,1,1,"dummy"
"178025",0,1,0,1,"dummy"
"178026",3,7,0,10,"dummy"
"178027",4,9,0,13,"dummy"
"178028",1,0,0,1,"dummy"
"178029",0,0,2,2,"dummy"
"178030",0,1,0,1,"dummy"
"178031",2,10,0,12,"dummy"
"178032",0,5,0,5,"dummy"
"178033",0,2,0,2,"dummy"
"178034",0,6,0,6,"dummy"
"178035",0,2,0,2,"dummy"
"178036",1,0,0,1,"dummy"
"178037",0,3,0,3,"dummy"
"178038",0,1,0,1,"dummy"
"178039",0,1,0,1,"dummy"
"178040",2,1,0,3,"dummy"
"178041",0,0,0,0,"dummy"
"178042",3,0,6,9,"dummy"
"178043",0,3,6,9,"dummy"
"178044",8,0,0,8,"dummy"
"178045",11,23,3,37,"dummy"
"178057",0,1,0,1,"dummy"
"178058",7,5,1,13,"dummy"
"178059",0,5,0,5,"dummy"
"178060",1,2,0,3,"dummy"
"178061",9,0,2,11,"dummy"
"178062",0,1,0,1,"dummy"
"178063",1,4,0,5,"dummy"
"178064",7,17,6,30,"dummy"
"178065",0,0,2,2,"dummy"
"178066",0,0,1,1,"dummy"
"178067",0,0,0,0,"dummy"
"178068",0,1,0,1,"dummy"
"178070",5,0,1,6,"dummy"
"178077",0,1,0,1,"dummy"
"178078",0,0,1,1,"dummy"
"178080",0,0,1,1,"dummy"
"178081",1,0,0,1,"dummy"
"178082",6,0,0,6,"dummy"
"178085",0,0,1,1,"dummy"
"178089",0,0,1,1,"dummy"
"178091",0,5,0,5,"dummy"
"178092",0,1,0,1,"dummy"
"178093",4,7,4,15,"dummy"
"178094",0,0,1,1,"dummy"
"178095",0,1,1,2,"dummy"
"178096",0,0,1,1,"dummy"
"178100",1,0,0,1,"dummy"
"178104",0,0,1,1,"dummy"
"178105",0,1,0,1,"dummy"
"178106",0,2,0,2,"dummy"
"178107",0,0,0,0,"dummy"
"178108",0,0,1,1,"dummy"
"178109",0,0,1,1,"dummy"
"178110",1,0,0,1,"dummy"
"178112",0,0,0,0,"dummy"
"178113",0,2,0,2,"dummy"
"178114",1,0,0,1,"dummy"
"178115",0,0,0,0,"dummy"
"178117",1,1,0,2,"dummy"
"178118",1,0,2,3,"dummy"
"178120",5,11,2,18,"dummy"
"178121",1,0,0,1,"dummy"
"178132",0,1,0,1,"dummy"
"178135",2,22,0,24,"dummy"
"178137",1,1,1,3,"dummy"
"178139",0,0,1,1,"dummy"
"178141",1,0,0,1,"dummy"
"178142",0,2,0,2,"dummy"
"178145",1,9,5,15,"dummy"
"178147",8,9,5,22,"dummy"
"178148",0,1,0,1,"dummy"
"178149",4,1,4,9,"dummy"
"178150",4,2,0,6,"dummy"
"178151",0,0,0,0,"dummy"
"178152",3,10,2,15,"dummy"
"178153",0,0,0,0,"dummy"
"178154",0,2,0,2,"dummy"
"178155",2,6,0,8,"dummy"
"178156",3,0,0,3,"dummy"
"178157",0,1,0,1,"dummy"
"178158",2,3,4,9,"dummy"
"178159",0,1,0,1,"dummy"
"178160",1,15,0,16,"dummy"
"178161",2,2,1,5,"dummy"
"178162",0,3,3,6,"dummy"
"178163",0,1,0,1,"dummy"
"178164",0,0,0,0,"dummy"
"178165",1,0,0,1,"dummy"
"178166",0,3,0,3,"dummy"
"178167",0,0,4,4,"dummy"
"178186",2,0,3,5,"dummy"
"178187",1,0,0,1,"dummy"
"178188",0,1,0,1,"dummy"
"178189",0,1,1,2,"dummy"
"178192",0,3,1,4,"dummy"
"178193",1,0,0,1,"dummy"
"178195",0,0,2,2,"dummy"
"178197",1,1,0,2,"dummy"
"178200",0,0,3,3,"dummy"
"178202",0,2,0,2,"dummy"
"178203",0,0,3,3,"dummy"
"178204",1,3,0,4,"dummy"
"178205",5,1,0,6,"dummy"
"178206",4,0,0,4,"dummy"
"178207",7,3,4,14,"dummy"
"178210",0,1,0,1,"dummy"
"178211",0,2,0,2,"dummy"
"178212",2,25,0,27,"dummy"
"178213",0,2,0,2,"dummy"
"178215",0,0,1,1,"dummy"
"178224",2,2,0,4,"dummy"
"178225",0,0,1,1,"dummy"
"178226",0,4,0,4,"dummy"
"178228",0,1,0,1,"dummy"
"178232",0,0,1,1,"dummy"
"178233",0,1,1,2,"dummy"
"178234",1,1,0,2,"dummy"
"178235",3,10,2,15,"dummy"
"178236",4,12,1,17,"dummy"
"178241",0,1,0,1,"dummy"
"178242",0,1,0,1,"dummy"
"178243",0,0,1,1,"dummy"
"178251",1,9,1,11,"dummy"
"178254",0,3,0,3,"dummy"
"178255",0,1,0,1,"dummy"
"178256",0,1,0,1,"dummy"
"178257",4,18,1,23,"dummy"
"178258",0,1,0,1,"dummy"
"178259",0,1,0,1,"dummy"
"178260",0,1,0,1,"dummy"
"178267",0,2,0,2,"dummy"
"178286",0,14,0,14,"dummy"
"178287",1,3,0,4,"dummy"
"178288",8,1,1,10,"dummy"
"178311",0,6,0,6,"dummy"
"178317",0,0,1,1,"dummy"
"178370",0,1,2,3,"dummy"
"178371",0,0,0,0,"dummy"
"178388",0,0,0,0,"dummy"
"178389",0,1,0,1,"dummy"
"178390",1,0,1,2,"dummy"
"178391",0,1,0,1,"dummy"
"178392",0,1,0,1,"dummy"
"178406",0,2,0,2,"dummy"
"178407",2,5,2,9,"dummy"
"178440",4,2,3,9,"dummy"
"178441",1,0,0,1,"dummy"
"178442",0,1,0,1,"dummy"
"178443",0,0,1,1,"dummy"
"178457",0,1,0,1,"dummy"
"178460",0,2,0,2,"dummy"
"178461",0,9,1,10,"dummy"
"178462",0,5,0,5,"dummy"
"178468",1,9,1,11,"dummy"
"178469",0,0,1,1,"dummy"
"178470",0,1,0,1,"dummy"
"178471",2,1,0,3,"dummy"
"178472",1,2,0,3,"dummy"
"178494",0,0,1,1,"dummy"
"178495",0,0,1,1,"dummy"
"178498",0,3,0,3,"dummy"
"178499",7,1,0,8,"dummy"
"178500",0,11,3,14,"dummy"
"178501",8,0,1,9,"dummy"
"178502",3,0,3,6,"dummy"
"178503",0,6,0,6,"dummy"
"178504",0,7,0,7,"dummy"
"178505",0,2,0,2,"dummy"
"178506",0,5,0,5,"dummy"
"178507",1,0,1,2,"dummy"
"178508",0,2,1,3,"dummy"
"178511",1,13,5,19,"dummy"
"178512",8,2,3,13,"dummy"
"178513",1,0,2,3,"dummy"
"178514",0,1,0,1,"dummy"
"178515",1,1,0,2,"dummy"
"178516",0,0,0,0,"dummy"
"178517",8,2,5,15,"dummy"
"178518",0,0,1,1,"dummy"
"178519",2,5,1,8,"dummy"
"178520",0,0,1,1,"dummy"
"178521",0,0,1,1,"dummy"
"178522",0,1,0,1,"dummy"
"178523",0,0,1,1,"dummy"
"178269",0,2,0,2,"dummy"
"178270",0,0,0,0,"dummy"
"178271",0,0,0,0,"dummy"
"178272",0,0,1,1,"dummy"
"178273",0,0,3,3,"dummy"
"178274",0,0,0,0,"dummy"
"178275",0,1,0,1,"dummy"
"178276",0,0,1,1,"dummy"
"178277",0,0,0,0,"dummy"
"178278",0,0,0,0,"dummy"
"178279",0,3,0,3,"dummy"
"178280",5,0,0,5,"dummy"
"178281",0,12,0,12,"dummy"
"178282",0,0,1,1,"dummy"
"178283",0,0,1,1,"dummy"
"178284",13,0,0,13,"dummy"
"178290",1,7,2,10,"dummy"
"178291",4,24,2,30,"dummy"
"178292",2,3,0,5,"dummy"
"178293",13,3,6,22,"dummy"
"178307",7,18,3,28,"dummy"
"178308",0,2,1,3,"dummy"
"178309",0,0,1,1,"dummy"
"178315",5,1,1,7,"dummy"
"178373",1,2,0,3,"dummy"
"178378",1,1,0,2,"dummy"
"178379",2,33,1,36,"dummy"
"178380",0,0,0,0,"dummy"
"178381",0,0,1,1,"dummy"
"178382",0,0,0,0,"dummy"
"178385",0,1,0,1,"dummy"
"178386",0,0,1,1,"dummy"
"178409",5,7,3,15,"dummy"
"178410",3,4,4,11,"dummy"
"178411",24,1,0,25,"dummy"
"178412",0,8,0,8,"dummy"
"178413",0,11,0,11,"dummy"
"178414",5,10,0,15,"dummy"
"178415",6,0,0,6,"dummy"
"178416",3,5,2,10,"dummy"
"178417",0,1,2,3,"dummy"
"178418",1,1,0,2,"dummy"
"178419",1,1,0,2,"dummy"
"178420",1,0,0,1,"dummy"
"178421",1,0,0,1,"dummy"
"178422",0,1,0,1,"dummy"
"178425",1,0,1,2,"dummy"
"178426",9,25,2,36,"dummy"
"178427",24,10,2,36,"dummy"
"178428",0,2,0,2,"dummy"
"178429",0,0,0,0,"dummy"
"178430",0,0,0,0,"dummy"
"178431",5,4,0,9,"dummy"
"178432",1,0,0,1,"dummy"
"178433",0,0,1,1,"dummy"
"178434",0,3,0,3,"dummy"
"178435",0,0,0,0,"dummy"
"178436",0,1,0,1,"dummy"
"178447",0,0,0,0,"dummy"
"178454",0,0,0,0,"dummy"
"178455",0,0,0,0,"dummy"
"178478",0,0,1,1,"dummy"
"178479",1,0,0,1,"dummy"
"178482",0,0,1,1,"dummy"
"178542",0,0,1,1,"dummy"
"178543",3,2,0,5,"dummy"
"178524",0,0,1,1,"dummy"
"178525",5,0,1,6,"dummy"
"178526",0,4,0,4,"dummy"
"178527",0,1,0,1,"dummy"
"178528",0,4,0,4,"dummy"
"178529",1,12,5,18,"dummy"
"178530",0,2,0,2,"dummy"
"178531",2,5,0,7,"dummy"
"178532",2,2,0,4,"dummy"
"178533",1,2,0,3,"dummy"
"178534",0,0,4,4,"dummy"
"178535",1,0,0,1,"dummy"
"178536",2,1,2,5,"dummy"
"178537",1,2,1,4,"dummy"
"178538",0,0,1,1,"dummy"
"178539",0,2,0,2,"dummy"
"178540",0,1,0,1,"dummy"
"178546",0,4,0,4,"dummy"
"178547",2,0,2,4,"dummy"
"178548",1,0,2,3,"dummy"
"178549",0,8,4,12,"dummy"
"178551",0,1,0,1,"dummy"
"178552",0,1,0,1,"dummy"
"178558",0,0,1,1,"dummy"
"178559",0,0,1,1,"dummy"
"178561",0,1,0,1,"dummy"
"178562",3,3,4,10,"dummy"
"178565",0,9,0,9,"dummy"
"178566",1,2,0,3,"dummy"
"178567",1,0,0,1,"dummy"
"178570",0,1,1,2,"dummy"
"178571",0,2,2,4,"dummy"
"178572",2,0,3,5,"dummy"
"178576",3,0,0,3,"dummy"
"178578",1,0,0,1,"dummy"
"178579",0,0,1,1,"dummy"
"178581",15,5,3,23,"dummy"
"178582",0,1,0,1,"dummy"
"178583",5,1,1,7,"dummy"
"178584",0,2,0,2,"dummy"
"178585",1,1,2,4,"dummy"
"178586",0,3,0,3,"dummy"
"178587",0,0,1,1,"dummy"
"178588",0,1,0,1,"dummy"
"178589",0,0,1,1,"dummy"
"178590",0,0,3,3,"dummy"
"178591",0,0,3,3,"dummy"
"178593",0,0,0,0,"dummy"
"178595",0,2,5,7,"dummy"
"178596",0,1,1,2,"dummy"
"178597",0,0,2,2,"dummy"
"178599",0,1,2,3,"dummy"
"178600",0,0,0,0,"dummy"
"178601",0,1,0,1,"dummy"
"178602",4,0,2,6,"dummy"
"178603",1,0,0,1,"dummy"
"178604",0,0,0,0,"dummy"
"178605",0,0,0,0,"dummy"
"178607",0,3,1,4,"dummy"
"178608",2,0,0,2,"dummy"
"178609",0,15,0,15,"dummy"
"178615",0,0,3,3,"dummy"
"178619",0,22,0,22,"dummy"
"178620",1,1,2,4,"dummy"
"178621",0,0,1,1,"dummy"
"178622",1,1,1,3,"dummy"
"178624",0,6,0,6,"dummy"
"178625",0,0,0,0,"dummy"
"178628",0,0,1,1,"dummy"
"178644",0,14,0,14,"dummy"
"178645",0,2,0,2,"dummy"
"178647",0,0,0,0,"dummy"
"178649",5,11,2,18,"dummy"
"178651",0,0,2,2,"dummy"
"178652",1,6,0,7,"dummy"
"178653",0,0,0,0,"dummy"
"178654",0,0,1,1,"dummy"
"178655",0,0,1,1,"dummy"
"178656",0,3,2,5,"dummy"
"178659",0,0,1,1,"dummy"
"178660",0,0,0,0,"dummy"
"178661",0,2,2,4,"dummy"
"178662",0,1,0,1,"dummy"
"178663",0,0,1,1,"dummy"
"178664",0,0,0,0,"dummy"
"178665",0,0,1,1,"dummy"
"178667",4,3,1,8,"dummy"
"178668",5,2,0,7,"dummy"
"178672",0,0,4,4,"dummy"
"178673",0,0,2,2,"dummy"
"178675",0,3,0,3,"dummy"
"178676",0,0,0,0,"dummy"
"178677",0,0,0,0,"dummy"
"178678",1,1,0,2,"dummy"
"178679",0,0,0,0,"dummy"
"178682",0,1,0,1,"dummy"
"178683",16,1,2,19,"dummy"
"178684",0,0,2,2,"dummy"
"178685",0,0,1,1,"dummy"
"178686",0,7,0,7,"dummy"
"178687",2,8,1,11,"dummy"
"178708",0,1,1,2,"dummy"
"178710",1,2,0,3,"dummy"
"178712",4,5,0,9,"dummy"
"178713",1,6,1,8,"dummy"
"178714",0,0,3,3,"dummy"
"178715",0,0,3,3,"dummy"
"178716",1,0,1,2,"dummy"
"178717",0,0,3,3,"dummy"
"178718",9,0,0,9,"dummy"
"178719",5,6,0,11,"dummy"
"178720",0,0,2,2,"dummy"
"178721",0,0,1,1,"dummy"
"178722",1,1,0,2,"dummy"
"178723",0,0,2,2,"dummy"
"178724",8,2,1,11,"dummy"
"178725",7,0,0,7,"dummy"
"178726",0,0,1,1,"dummy"
"178727",0,1,0,1,"dummy"
"178729",0,2,0,2,"dummy"
"178731",0,6,1,7,"dummy"
"178732",0,2,1,3,"dummy"
"178733",0,1,1,2,"dummy"
"178734",0,1,0,1,"dummy"
"178735",0,0,1,1,"dummy"
"178738",0,5,0,5,"dummy"
"178740",0,0,1,1,"dummy"
"178741",0,0,1,1,"dummy"
"178742",0,0,1,1,"dummy"
"178743",0,0,1,1,"dummy"
"178749",0,1,0,1,"dummy"
"178752",0,2,0,2,"dummy"
"178756",1,9,3,13,"dummy"
"178757",3,1,1,5,"dummy"
"178758",0,2,2,4,"dummy"
"178762",0,2,0,2,"dummy"
"178763",1,1,0,2,"dummy"
"178764",0,6,1,7,"dummy"
"178765",0,2,0,2,"dummy"
"178766",0,3,0,3,"dummy"
"178768",2,4,0,6,"dummy"
"178769",0,2,0,2,"dummy"
"178770",0,2,0,2,"dummy"
"178771",10,2,0,12,"dummy"
"178772",0,2,0,2,"dummy"
"178773",0,0,0,0,"dummy"
"178774",0,0,3,3,"dummy"
"178775",0,5,0,5,"dummy"
"178777",0,0,3,3,"dummy"
"178779",1,0,0,1,"dummy"
"178781",0,0,2,2,"dummy"
"178784",0,1,0,1,"dummy"
"178788",0,0,3,3,"dummy"
"178789",3,2,0,5,"dummy"
"178790",2,0,0,2,"dummy"
"178792",0,8,0,8,"dummy"
"178796",16,4,0,20,"dummy"
"178797",0,0,2,2,"dummy"
"178804",2,0,0,2,"dummy"
"178806",0,0,0,0,"dummy"
"178808",0,1,0,1,"dummy"
"178809",0,0,1,1,"dummy"
"178810",0,0,1,1,"dummy"
"178818",3,5,3,11,"dummy"
"178821",0,2,0,2,"dummy"
"178822",1,1,0,2,"dummy"
"178823",1,1,0,2,"dummy"
"178827",0,0,6,6,"dummy"
"178828",1,0,1,2,"dummy"
"178829",0,2,0,2,"dummy"
"178830",1,8,1,10,"dummy"
"178833",0,0,1,1,"dummy"
"178837",1,10,0,11,"dummy"
"178840",0,0,0,0,"dummy"
"178841",0,8,0,8,"dummy"
"178842",0,0,1,1,"dummy"
"178843",2,1,0,3,"dummy"
"178844",0,0,0,0,"dummy"
"178845",1,0,0,1,"dummy"
"178846",0,0,0,0,"dummy"
"178847",0,0,0,0,"dummy"
"178848",0,2,0,2,"dummy"
"178855",0,0,0,0,"dummy"
"178857",0,2,0,2,"dummy"
"178858",0,0,1,1,"dummy"
"178859",0,0,1,1,"dummy"
"178860",0,0,1,1,"dummy"
"178861",0,3,2,5,"dummy"
"178862",2,18,0,20,"dummy"
"178863",0,0,1,1,"dummy"
"178864",0,0,3,3,"dummy"
"178865",0,0,1,1,"dummy"
"178868",0,22,0,22,"dummy"
"178875",0,3,1,4,"dummy"
"178877",0,1,0,1,"dummy"
"178878",0,1,1,2,"dummy"
"178879",1,0,1,2,"dummy"
"178882",0,1,0,1,"dummy"
"178883",0,0,1,1,"dummy"
"178884",0,1,1,2,"dummy"
"178885",0,0,1,1,"dummy"
"178886",0,0,3,3,"dummy"
"178887",0,0,1,1,"dummy"
"178888",0,0,1,1,"dummy"
"178890",2,0,2,4,"dummy"
"178891",0,0,2,2,"dummy"
"178893",0,0,2,2,"dummy"
"178894",3,0,1,4,"dummy"
"178895",1,1,0,2,"dummy"
"178898",0,14,0,14,"dummy"
"178932",0,7,0,7,"dummy"
"178933",0,1,1,2,"dummy"
"178934",0,2,0,2,"dummy"
"178935",0,4,0,4,"dummy"
"178936",4,0,0,4,"dummy"
"178937",0,4,0,4,"dummy"
"178938",5,16,1,22,"dummy"
"178948",0,3,0,3,"dummy"
"178951",0,1,0,1,"dummy"
"178952",0,0,1,1,"dummy"
"178953",13,16,4,33,"dummy"
"178954",1,0,0,1,"dummy"
"178955",2,7,0,9,"dummy"
"178956",0,1,0,1,"dummy"
"178957",1,0,0,1,"dummy"
"178958",0,2,0,2,"dummy"
"178959",0,1,0,1,"dummy"
"178960",0,1,0,1,"dummy"
"178961",1,1,1,3,"dummy"
"178962",2,3,1,6,"dummy"
"178963",0,1,0,1,"dummy"
"179009",1,17,1,19,"dummy"
"179025",7,1,0,8,"dummy"
"179026",0,0,1,1,"dummy"
"179027",3,0,0,3,"dummy"
"179037",0,0,2,2,"dummy"
"179042",0,1,0,1,"dummy"
"179045",0,2,0,2,"dummy"
"179046",0,36,0,36,"dummy"
"179047",14,0,0,14,"dummy"
"179048",4,2,0,6,"dummy"
"179049",0,0,1,1,"dummy"
"179054",0,6,3,9,"dummy"
"179055",0,1,0,1,"dummy"
"179056",2,0,0,2,"dummy"
"179057",0,2,0,2,"dummy"
"179058",0,2,0,2,"dummy"
"179063",0,1,0,1,"dummy"
"179064",0,2,0,2,"dummy"
"179065",0,0,0,0,"dummy"
"179066",0,1,0,1,"dummy"
"179067",0,1,0,1,"dummy"
"179068",0,0,0,0,"dummy"
"179069",2,0,6,8,"dummy"
"179079",6,5,1,12,"dummy"
"179080",0,0,1,1,"dummy"
"179081",1,0,1,2,"dummy"
"179082",0,4,1,5,"dummy"
"179083",0,0,1,1,"dummy"
"179084",3,0,2,5,"dummy"
"179085",0,3,1,4,"dummy"
"179132",0,1,0,1,"dummy"
"179153",2,4,0,6,"dummy"
"179154",0,2,0,2,"dummy"
"179155",0,2,0,2,"dummy"
"179156",10,2,0,12,"dummy"
"179157",0,2,0,2,"dummy"
"179158",0,0,0,0,"dummy"
"179159",0,0,3,3,"dummy"
"179173",1,1,0,2,"dummy"
"178900",0,2,0,2,"dummy"
"178901",0,1,0,1,"dummy"
"178902",0,2,0,2,"dummy"
"178903",3,2,1,6,"dummy"
"178904",0,0,2,2,"dummy"
"178905",0,1,0,1,"dummy"
"178906",0,0,2,2,"dummy"
"178909",1,0,1,2,"dummy"
"178920",0,2,0,2,"dummy"
"178921",0,1,0,1,"dummy"
"178922",0,2,0,2,"dummy"
"178923",2,0,3,5,"dummy"
"178924",1,1,6,8,"dummy"
"178925",0,0,2,2,"dummy"
"178926",3,3,2,8,"dummy"
"178927",0,7,0,7,"dummy"
"178928",0,2,0,2,"dummy"
"178929",5,7,0,12,"dummy"
"178930",1,0,0,1,"dummy"
"178943",1,4,0,5,"dummy"
"178944",0,1,0,1,"dummy"
"178945",3,11,3,17,"dummy"
"178946",0,0,2,2,"dummy"
"178973",1,3,0,4,"dummy"
"178974",3,8,6,17,"dummy"
"178975",15,0,3,18,"dummy"
"178976",0,0,0,0,"dummy"
"178977",0,2,0,2,"dummy"
"178978",0,1,0,1,"dummy"
"178979",0,1,0,1,"dummy"
"178980",3,1,0,4,"dummy"
"178981",0,0,1,1,"dummy"
"178982",0,1,0,1,"dummy"
"178983",20,25,3,48,"dummy"
"178984",9,6,2,17,"dummy"
"178985",12,5,0,17,"dummy"
"178986",2,0,1,3,"dummy"
"178987",5,0,0,5,"dummy"
"178988",0,0,5,5,"dummy"
"178989",0,0,1,1,"dummy"
"178990",0,0,1,1,"dummy"
"178993",0,0,0,0,"dummy"
"178994",2,1,1,4,"dummy"
"178995",0,0,1,1,"dummy"
"178996",0,0,0,0,"dummy"
"179003",0,3,0,3,"dummy"
"179004",1,3,1,5,"dummy"
"179007",2,0,1,3,"dummy"
"179013",1,1,1,3,"dummy"
"179014",0,3,0,3,"dummy"
"179015",0,0,1,1,"dummy"
"179016",1,2,4,7,"dummy"
"179023",0,0,2,2,"dummy"
"179035",0,0,1,1,"dummy"
"179039",1,0,0,1,"dummy"
"179040",4,0,0,4,"dummy"
"179060",0,0,0,0,"dummy"
"179061",0,0,0,0,"dummy"
"179117",0,0,0,0,"dummy"
"179118",0,0,1,1,"dummy"
"179119",3,0,0,3,"dummy"
"179120",0,0,1,1,"dummy"
"179121",0,1,0,1,"dummy"
"179122",0,2,0,2,"dummy"
"179123",0,0,0,0,"dummy"
"179124",0,0,0,0,"dummy"
"179125",4,1,0,5,"dummy"
"179126",1,0,0,1,"dummy"
"179127",0,0,0,0,"dummy"
"179128",0,0,0,0,"dummy"
"179134",14,18,0,32,"dummy"
"179135",13,10,3,26,"dummy"
"179136",0,0,1,1,"dummy"
"179137",0,0,1,1,"dummy"
"179138",2,0,0,2,"dummy"
"179139",1,1,0,2,"dummy"
"179140",3,0,0,3,"dummy"
"179141",0,2,1,3,"dummy"
"179144",0,0,1,1,"dummy"
"179145",1,1,2,4,"dummy"
"179161",7,11,4,22,"dummy"
"179162",0,0,1,1,"dummy"
"179163",0,0,1,1,"dummy"
"179164",0,0,1,1,"dummy"
"179165",0,11,3,14,"dummy"
"179175",0,1,0,1,"dummy"
"179182",0,2,0,2,"dummy"
"179183",0,1,0,1,"dummy"
"179264",3,4,12,19,"dummy"
"179265",0,1,0,1,"dummy"
"179266",0,1,0,1,"dummy"
"179284",2,7,4,13,"dummy"
"179285",0,0,1,1,"dummy"
"179286",0,0,1,1,"dummy"
"179294",2,0,3,5,"dummy"
"179299",1,0,0,1,"dummy"
"179300",0,0,0,0,"dummy"
"179301",0,0,0,0,"dummy"
"179302",0,0,0,0,"dummy"
"179393",0,0,0,0,"dummy"
"179394",0,0,0,0,"dummy"
"179395",0,0,4,4,"dummy"
"179396",0,0,0,0,"dummy"
"179397",0,0,0,0,"dummy"
"179398",6,3,0,9,"dummy"
"179399",0,57,0,57,"dummy"
"179400",1,1,0,2,"dummy"
"179401",2,4,1,7,"dummy"
"179402",0,0,1,1,"dummy"
"179403",0,0,1,1,"dummy"
"179404",0,0,1,1,"dummy"
"179405",0,2,0,2,"dummy"
"179412",4,4,0,8,"dummy"
"179413",4,4,1,9,"dummy"
"179414",4,4,0,8,"dummy"
"179415",0,0,1,1,"dummy"
"179416",0,1,0,1,"dummy"
"179417",0,0,1,1,"dummy"
"179418",0,0,2,2,"dummy"
"179419",4,4,0,8,"dummy"
"179420",4,4,0,8,"dummy"
"179421",4,4,0,8,"dummy"
"179422",0,1,0,1,"dummy"
"179423",4,0,0,4,"dummy"
"179424",0,1,0,1,"dummy"
"179425",1,0,0,1,"dummy"
"179426",0,6,0,6,"dummy"
"179439",0,0,1,1,"dummy"
"179440",0,0,1,1,"dummy"
"179441",0,1,0,1,"dummy"
"179442",1,0,0,1,"dummy"
"179446",0,0,2,2,"dummy"
"179451",1,0,0,1,"dummy"
"179460",1,5,2,8,"dummy"
"179461",0,2,0,2,"dummy"
"179462",1,0,0,1,"dummy"
"179469",0,0,2,2,"dummy"
"179470",0,0,2,2,"dummy"
"179177",1,3,0,4,"dummy"
"179178",1,15,0,16,"dummy"
"179179",11,1,0,12,"dummy"
"179180",0,0,1,1,"dummy"
"179187",0,1,0,1,"dummy"
"179198",0,0,0,0,"dummy"
"179199",0,0,0,0,"dummy"
"179200",0,0,0,0,"dummy"
"179201",0,0,0,0,"dummy"
"179202",0,0,0,0,"dummy"
"179203",0,0,0,0,"dummy"
"179204",0,0,0,0,"dummy"
"179205",0,0,0,0,"dummy"
"179206",0,0,0,0,"dummy"
"179207",0,0,0,0,"dummy"
"179208",0,0,0,0,"dummy"
"179209",0,0,0,0,"dummy"
"179210",0,0,0,0,"dummy"
"179211",0,0,0,0,"dummy"
"179212",0,0,0,0,"dummy"
"179213",0,1,0,1,"dummy"
"179214",0,0,0,0,"dummy"
"179215",0,0,0,0,"dummy"
"179216",0,0,0,0,"dummy"
"179217",0,0,0,0,"dummy"
"179218",0,6,0,6,"dummy"
"179219",0,0,0,0,"dummy"
"179220",0,0,0,0,"dummy"
"179221",0,0,1,1,"dummy"
"179222",0,0,0,0,"dummy"
"179223",0,0,1,1,"dummy"
"179224",0,0,1,1,"dummy"
"179225",0,2,0,2,"dummy"
"179226",0,0,0,0,"dummy"
"179227",0,2,0,2,"dummy"
"179228",2,0,0,2,"dummy"
"179229",0,2,0,2,"dummy"
"179230",2,0,0,2,"dummy"
"179231",0,2,0,2,"dummy"
"179232",3,0,0,3,"dummy"
"179233",0,2,0,2,"dummy"
"179234",0,0,0,0,"dummy"
"179235",0,0,0,0,"dummy"
"179236",0,38,2,40,"dummy"
"179237",0,2,0,2,"dummy"
"179238",1,0,0,1,"dummy"
"179239",0,4,0,4,"dummy"
"179240",2,4,0,6,"dummy"
"179241",0,3,0,3,"dummy"
"179242",16,4,9,29,"dummy"
"179243",0,2,0,2,"dummy"
"179244",0,0,1,1,"dummy"
"179245",3,14,2,19,"dummy"
"179246",0,2,0,2,"dummy"
"179247",1,1,1,3,"dummy"
"179248",0,2,0,2,"dummy"
"179249",0,0,1,1,"dummy"
"179250",0,0,2,2,"dummy"
"179251",0,0,2,2,"dummy"
"179254",1,1,0,2,"dummy"
"179255",0,19,0,19,"dummy"
"179256",2,0,1,3,"dummy"
"179257",2,2,0,4,"dummy"
"179258",0,1,0,1,"dummy"
"179268",0,2,0,2,"dummy"
"179273",3,0,0,3,"dummy"
"179274",1,0,0,1,"dummy"
"179279",0,0,3,3,"dummy"
"179282",0,3,1,4,"dummy"
"179292",7,1,0,8,"dummy"
"179296",0,0,1,1,"dummy"
"179297",0,0,0,0,"dummy"
"179306",0,4,2,6,"dummy"
"179307",4,0,2,6,"dummy"
"179368",0,0,1,1,"dummy"
"179371",12,8,4,24,"dummy"
"179374",1,6,4,11,"dummy"
"179375",2,5,0,7,"dummy"
"179376",3,11,0,14,"dummy"
"179377",0,10,0,10,"dummy"
"179378",6,0,0,6,"dummy"
"179379",0,1,0,1,"dummy"
"179380",1,1,0,2,"dummy"
"179381",0,3,0,3,"dummy"
"179382",0,0,3,3,"dummy"
"179385",5,2,0,7,"dummy"
"179386",1,0,0,1,"dummy"
"179387",0,3,0,3,"dummy"
"179388",3,4,0,7,"dummy"
"179389",4,1,0,5,"dummy"
"179390",0,0,1,1,"dummy"
"179391",1,0,0,1,"dummy"
"179428",0,0,0,0,"dummy"
"179429",0,2,0,2,"dummy"
"179430",0,0,3,3,"dummy"
"179431",0,0,1,1,"dummy"
"179432",0,0,4,4,"dummy"
"179435",2,3,4,9,"dummy"
"179436",3,1,0,4,"dummy"
"179437",0,0,2,2,"dummy"
"179444",0,0,0,0,"dummy"
"179453",0,23,0,23,"dummy"
"179454",1,1,0,2,"dummy"
"179455",0,0,1,1,"dummy"
"179456",1,0,0,1,"dummy"
"179457",0,2,0,2,"dummy"
"179458",2,0,0,2,"dummy"
"179479",0,2,0,2,"dummy"
"179480",0,0,1,1,"dummy"
"179481",0,0,1,1,"dummy"
"179482",0,0,1,1,"dummy"
"179483",1,0,0,1,"dummy"
"179486",2,1,0,3,"dummy"
"179487",5,13,1,19,"dummy"
"179498",0,5,0,5,"dummy"
"179499",0,0,0,0,"dummy"
"179500",0,1,2,3,"dummy"
"179501",17,4,0,21,"dummy"
"179502",0,0,2,2,"dummy"
"179503",0,0,1,1,"dummy"
"179506",0,0,1,1,"dummy"
"179507",0,0,1,1,"dummy"
"179526",0,0,2,2,"dummy"
"179527",0,1,0,1,"dummy"
"179552",0,0,2,2,"dummy"
"179553",0,0,2,2,"dummy"
"179554",0,0,0,0,"dummy"
"179555",0,0,2,2,"dummy"
"179556",0,0,0,0,"dummy"
"179557",0,0,0,0,"dummy"
"179560",0,0,1,1,"dummy"
"179616",1,2,0,3,"dummy"
"179617",3,9,0,12,"dummy"
"179618",17,1,0,18,"dummy"
"179619",1,18,0,19,"dummy"
"179620",0,1,1,2,"dummy"
"179621",0,0,0,0,"dummy"
"179622",17,1,0,18,"dummy"
"179623",1,0,0,1,"dummy"
"179624",0,0,0,0,"dummy"
"179625",0,1,1,2,"dummy"
"179626",2,2,0,4,"dummy"
"179627",2,3,0,5,"dummy"
"179628",0,0,1,1,"dummy"
"179629",2,2,0,4,"dummy"
"179630",0,1,0,1,"dummy"
"179631",0,3,1,4,"dummy"
"179632",3,5,2,10,"dummy"
"179475",0,2,3,5,"dummy"
"179493",0,0,1,1,"dummy"
"179494",0,4,1,5,"dummy"
"179495",0,0,1,1,"dummy"
"179496",0,0,1,1,"dummy"
"179509",2,12,3,17,"dummy"
"179515",0,7,0,7,"dummy"
"179516",4,1,0,5,"dummy"
"179517",1,1,0,2,"dummy"
"179518",5,0,0,5,"dummy"
"179519",2,7,1,10,"dummy"
"179520",0,1,0,1,"dummy"
"179529",0,1,1,2,"dummy"
"179530",2,0,1,3,"dummy"
"179531",3,6,2,11,"dummy"
"179539",0,0,0,0,"dummy"
"179540",0,0,0,0,"dummy"
"179541",0,0,0,0,"dummy"
"179542",0,0,0,0,"dummy"
"179545",0,0,0,0,"dummy"
"179546",0,0,2,2,"dummy"
"179547",0,2,0,2,"dummy"
"179550",0,1,0,1,"dummy"
"179564",0,0,2,2,"dummy"
"179565",0,0,2,2,"dummy"
"179566",0,0,1,1,"dummy"
"179567",0,0,2,2,"dummy"
"179568",0,0,1,1,"dummy"
"179569",0,0,1,1,"dummy"
"179570",0,0,1,1,"dummy"
"179575",0,2,0,2,"dummy"
"179576",2,0,0,2,"dummy"
"179577",0,2,0,2,"dummy"
"179578",1,2,0,3,"dummy"
"179584",3,2,0,5,"dummy"
"179585",2,8,5,15,"dummy"
"179611",0,3,0,3,"dummy"
"179612",0,2,0,2,"dummy"
"179613",4,6,0,10,"dummy"
"179614",0,0,0,0,"dummy"
"179634",0,1,0,1,"dummy"
"179635",0,0,2,2,"dummy"
"179636",0,0,1,1,"dummy"
"179655",0,0,1,1,"dummy"
"179656",2,0,2,4,"dummy"
"179680",1,3,1,5,"dummy"
"179681",1,0,0,1,"dummy"
"179682",2,0,0,2,"dummy"
"179691",0,1,2,3,"dummy"
"179692",0,0,0,0,"dummy"
"179693",0,1,0,1,"dummy"
"179694",4,0,2,6,"dummy"
"179695",1,0,0,1,"dummy"
"179696",0,0,0,0,"dummy"
"179729",2,2,0,4,"dummy"
"179730",0,2,0,2,"dummy"
"179731",0,0,1,1,"dummy"
"179732",0,0,1,1,"dummy"
"179733",0,1,0,1,"dummy"
"179734",0,0,1,1,"dummy"
"179735",0,0,1,1,"dummy"
"179652",1,5,0,6,"dummy"
"179658",0,0,0,0,"dummy"
"179659",0,0,0,0,"dummy"
"179662",1,1,0,2,"dummy"
"179663",1,0,0,1,"dummy"
"179684",0,0,1,1,"dummy"
"179687",0,0,0,0,"dummy"
"179688",0,0,0,0,"dummy"
"179689",3,2,1,6,"dummy"
"179702",0,0,1,1,"dummy"
"179703",0,0,1,1,"dummy"
"179704",0,0,1,1,"dummy"
"179705",0,0,1,1,"dummy"
"179706",0,0,1,1,"dummy"
"179707",0,0,1,1,"dummy"
"179708",0,0,1,1,"dummy"
"179709",0,0,1,1,"dummy"
"179710",10,9,0,19,"dummy"
"179713",1,0,3,4,"dummy"
"179714",0,0,2,2,"dummy"
"179715",2,7,3,12,"dummy"
"179716",0,6,0,6,"dummy"
"179717",0,3,1,4,"dummy"
"179718",0,0,0,0,"dummy"
"179719",0,1,0,1,"dummy"
"179720",0,0,0,0,"dummy"
"179721",36,4,0,40,"dummy"
"179722",0,0,1,1,"dummy"
"179723",0,2,0,2,"dummy"
"179726",0,0,1,1,"dummy"
"179727",0,0,0,0,"dummy"
"179739",0,1,0,1,"dummy"
"179740",0,0,2,2,"dummy"
"179741",0,0,1,1,"dummy"
"179742",0,0,2,2,"dummy"
"179743",0,0,0,0,"dummy"
"179744",0,0,1,1,"dummy"
"179745",0,0,0,0,"dummy"
"179746",3,0,0,3,"dummy"
"179760",1,0,3,4,"dummy"
"179764",0,41,0,41,"dummy"
"179765",0,0,1,1,"dummy"
"179766",0,0,1,1,"dummy"
"179767",0,0,1,1,"dummy"
"179768",0,0,1,1,"dummy"
"179769",0,5,1,6,"dummy"
"179770",0,1,0,1,"dummy"
"179771",0,0,1,1,"dummy"
"179777",1,5,0,6,"dummy"
"179778",0,3,3,6,"dummy"
"179779",0,0,1,1,"dummy"
"179780",1,1,2,4,"dummy"
"179781",2,0,0,2,"dummy"
"179782",0,1,0,1,"dummy"
"179783",0,3,0,3,"dummy"
"179784",0,0,0,0,"dummy"
"179785",0,0,1,1,"dummy"
"179786",3,0,0,3,"dummy"
"179787",0,0,1,1,"dummy"
"179788",0,0,1,1,"dummy"
"179789",0,1,0,1,"dummy"
"179790",0,1,0,1,"dummy"
"179791",8,5,0,13,"dummy"
"179793",0,0,1,1,"dummy"
"179794",0,0,1,1,"dummy"
"179795",0,0,0,0,"dummy"
"179796",3,9,1,13,"dummy"
"179797",0,0,0,0,"dummy"
"179808",0,1,0,1,"dummy"
"179810",0,1,0,1,"dummy"
"179811",1,6,2,9,"dummy"
"179812",0,1,0,1,"dummy"
"179813",0,1,0,1,"dummy"
"179814",9,0,2,11,"dummy"
"179815",0,0,1,1,"dummy"
"179816",0,0,1,1,"dummy"
"179818",0,1,0,1,"dummy"
"179819",0,3,0,3,"dummy"
"179848",0,0,1,1,"dummy"
"179849",1,1,1,3,"dummy"
"179851",0,0,1,1,"dummy"
"179852",0,0,1,1,"dummy"
"179853",1,0,1,2,"dummy"
"179854",0,1,0,1,"dummy"
"179855",0,1,0,1,"dummy"
"179857",2,2,5,9,"dummy"
"179858",2,4,7,13,"dummy"
"179859",2,2,4,8,"dummy"
"179860",2,0,3,5,"dummy"
"179861",0,0,1,1,"dummy"
"179862",0,2,1,3,"dummy"
"179864",1,0,0,1,"dummy"
"179866",0,3,3,6,"dummy"
"179867",1,9,4,14,"dummy"
"179870",0,3,0,3,"dummy"
"179872",0,1,0,1,"dummy"
"179873",8,1,0,9,"dummy"
"179874",0,0,0,0,"dummy"
"179875",0,0,0,0,"dummy"
"179876",1,10,0,11,"dummy"
"179877",7,1,0,8,"dummy"
"179878",2,0,3,5,"dummy"
"179880",0,9,0,9,"dummy"
"179881",31,8,1,40,"dummy"
"179882",2,6,2,10,"dummy"
"179883",0,1,0,1,"dummy"
"179884",8,1,5,14,"dummy"
"179885",0,1,0,1,"dummy"
"179886",1,0,1,2,"dummy"
"179887",1,1,0,2,"dummy"
"179888",0,1,0,1,"dummy"
"179889",0,1,0,1,"dummy"
"179890",1,0,0,1,"dummy"
"179896",1,5,0,6,"dummy"
"179897",0,2,0,2,"dummy"
"179898",0,0,0,0,"dummy"
"179899",0,1,0,1,"dummy"
"179904",0,0,1,1,"dummy"
"179905",0,0,1,1,"dummy"
"179906",0,3,0,3,"dummy"
"179907",0,0,1,1,"dummy"
"179912",2,0,0,2,"dummy"
"179913",0,0,2,2,"dummy"
"179918",0,1,0,1,"dummy"
"179919",0,1,0,1,"dummy"
"179920",0,0,2,2,"dummy"
"179923",0,2,1,3,"dummy"
"179924",1,1,0,2,"dummy"
"179925",0,1,0,1,"dummy"
"179936",0,0,1,1,"dummy"
"179937",0,0,1,1,"dummy"
"179938",0,1,0,1,"dummy"
"179939",2,2,0,4,"dummy"
"179940",0,0,1,1,"dummy"
"179941",2,2,0,4,"dummy"
"179942",0,1,0,1,"dummy"
"179943",0,1,0,1,"dummy"
"179944",0,0,1,1,"dummy"
"179945",1,0,0,1,"dummy"
"179946",1,1,2,4,"dummy"
"179947",0,0,1,1,"dummy"
"179948",2,0,0,2,"dummy"
"179949",0,0,1,1,"dummy"
"179950",0,0,1,1,"dummy"
"179951",0,0,1,1,"dummy"
"179952",0,0,1,1,"dummy"
"179953",0,0,1,1,"dummy"
"179954",0,0,1,1,"dummy"
"179955",0,0,1,1,"dummy"
"179956",0,1,1,2,"dummy"
"179957",0,0,1,1,"dummy"
"179958",0,2,1,3,"dummy"
"179959",1,2,0,3,"dummy"
"179960",4,1,0,5,"dummy"
"179961",0,1,0,1,"dummy"
"179962",1,2,0,3,"dummy"
"179963",0,0,1,1,"dummy"
"179964",0,1,1,2,"dummy"
"179965",0,0,1,1,"dummy"
"179966",0,0,2,2,"dummy"
"179967",0,0,1,1,"dummy"
"179968",3,1,1,5,"dummy"
"179969",0,0,1,1,"dummy"
"179970",0,0,1,1,"dummy"
"179971",0,0,1,1,"dummy"
"179972",3,2,2,7,"dummy"
"179973",0,0,1,1,"dummy"
"179974",0,0,2,2,"dummy"
"179975",0,0,1,1,"dummy"
"179976",1,0,0,1,"dummy"
"179977",1,1,0,2,"dummy"
"179978",0,0,1,1,"dummy"
"179979",0,0,1,1,"dummy"
"179980",0,0,1,1,"dummy"
"179981",0,0,1,1,"dummy"
"179982",0,0,1,1,"dummy"
"179983",0,0,1,1,"dummy"
"179984",0,0,1,1,"dummy"
"179985",0,0,1,1,"dummy"
"179986",1,2,0,3,"dummy"
"179987",0,0,1,1,"dummy"
"179988",0,0,1,1,"dummy"
"179989",0,1,1,2,"dummy"
"179990",0,0,1,1,"dummy"
"180013",0,0,0,0,"dummy"
"180017",0,0,1,1,"dummy"
"180020",5,10,0,15,"dummy"
"180024",0,0,1,1,"dummy"
"180066",0,0,1,1,"dummy"
"180067",0,0,2,2,"dummy"
"180068",0,0,2,2,"dummy"
"180070",0,2,1,3,"dummy"
"180071",0,0,0,0,"dummy"
"180072",0,2,0,2,"dummy"
"180073",0,1,0,1,"dummy"
"180074",0,1,0,1,"dummy"
"180075",0,1,0,1,"dummy"
"180076",11,0,0,11,"dummy"
"180077",0,2,1,3,"dummy"
"180080",0,2,0,2,"dummy"
"180081",1,0,0,1,"dummy"
"180082",0,1,0,1,"dummy"
"180084",0,0,2,2,"dummy"
"180085",0,0,1,1,"dummy"
"180086",3,0,1,4,"dummy"
"180089",0,0,0,0,"dummy"
"180090",0,0,1,1,"dummy"
"180091",3,0,0,3,"dummy"
"180092",0,0,1,1,"dummy"
"180093",0,1,0,1,"dummy"
"180094",0,0,0,0,"dummy"
"180095",0,0,1,1,"dummy"
"180096",0,2,0,2,"dummy"
"180098",0,1,0,1,"dummy"
"180104",8,1,0,9,"dummy"
"180106",1,0,0,1,"dummy"
"180107",0,2,0,2,"dummy"
"180108",1,1,1,3,"dummy"
"180109",0,3,2,5,"dummy"
"180110",4,10,2,16,"dummy"
"180111",1,0,0,1,"dummy"
"180112",3,0,0,3,"dummy"
"180113",1,0,2,3,"dummy"
"180114",1,0,0,1,"dummy"
"180115",3,0,0,3,"dummy"
"180116",0,0,1,1,"dummy"
"180117",0,4,0,4,"dummy"
"180118",8,2,2,12,"dummy"
"180119",0,0,1,1,"dummy"
"180121",10,0,2,12,"dummy"
"180122",0,3,0,3,"dummy"
"180123",0,0,1,1,"dummy"
"180124",0,0,1,1,"dummy"
"180126",1,1,0,2,"dummy"
"180128",2,17,1,20,"dummy"
"180131",0,1,0,1,"dummy"
"180133",5,2,0,7,"dummy"
"180134",26,11,7,44,"dummy"
"180213",0,1,0,1,"dummy"
"180217",0,2,3,5,"dummy"
"180218",0,2,0,2,"dummy"
"180220",0,0,1,1,"dummy"
"180221",1,0,0,1,"dummy"
"180224",0,1,2,3,"dummy"
"180225",2,2,4,8,"dummy"
"180229",1,0,2,3,"dummy"
"180230",2,9,0,11,"dummy"
"180231",8,7,1,16,"dummy"
"180232",0,1,1,2,"dummy"
"180233",0,0,1,1,"dummy"
"180234",1,4,0,5,"dummy"
"180235",0,2,0,2,"dummy"
"180236",4,5,0,9,"dummy"
"180237",5,4,0,9,"dummy"
"180238",4,16,2,22,"dummy"
"180239",0,0,3,3,"dummy"
"180240",0,2,2,4,"dummy"
"180241",0,0,0,0,"dummy"
"180242",2,2,0,4,"dummy"
"180243",8,5,1,14,"dummy"
"180246",0,0,3,3,"dummy"
"180250",0,4,0,4,"dummy"
"180251",7,20,0,27,"dummy"
"180252",0,0,1,1,"dummy"
"180253",1,0,0,1,"dummy"
"180254",1,0,0,1,"dummy"
"180256",0,0,1,1,"dummy"
"180257",2,0,0,2,"dummy"
"180258",2,0,0,2,"dummy"
"180259",0,0,3,3,"dummy"
"180261",0,0,1,1,"dummy"
"180262",0,0,4,4,"dummy"
"180263",0,0,0,0,"dummy"
"180264",1,1,0,2,"dummy"
"180265",0,0,2,2,"dummy"
"180269",0,1,0,1,"dummy"
"180270",5,15,2,22,"dummy"
"180271",0,2,0,2,"dummy"
"180272",1,0,0,1,"dummy"
"180273",1,0,0,1,"dummy"
"180275",0,1,0,1,"dummy"
"180276",0,5,0,5,"dummy"
"180277",4,3,1,8,"dummy"
"180278",0,1,0,1,"dummy"
"180279",2,2,0,4,"dummy"
"180280",2,2,1,5,"dummy"
"180281",0,1,0,1,"dummy"
"180282",0,2,0,2,"dummy"
"180283",0,1,0,1,"dummy"
"180286",0,0,0,0,"dummy"
"180287",0,2,0,2,"dummy"
"180288",0,0,1,1,"dummy"
"180289",3,3,0,6,"dummy"
"180290",0,7,0,7,"dummy"
"180291",2,0,0,2,"dummy"
"180297",0,1,0,1,"dummy"
"180299",3,3,0,6,"dummy"
"180302",0,0,0,0,"dummy"
"180303",0,0,0,0,"dummy"
"180304",0,0,0,0,"dummy"
"180305",0,0,0,0,"dummy"
"180306",0,0,0,0,"dummy"
"180307",0,0,0,0,"dummy"
"180308",0,0,0,0,"dummy"
"180309",0,0,0,0,"dummy"
"180310",0,0,0,0,"dummy"
"180311",0,0,0,0,"dummy"
"180312",0,0,0,0,"dummy"
"180313",0,0,0,0,"dummy"
"180314",0,0,0,0,"dummy"
"180315",0,0,0,0,"dummy"
"180317",1,2,1,4,"dummy"
"180318",0,0,1,1,"dummy"
"180320",0,0,0,0,"dummy"
"180324",0,1,0,1,"dummy"
"180325",1,0,1,2,"dummy"
"180328",6,7,2,15,"dummy"
"180329",0,1,0,1,"dummy"
"180330",0,1,0,1,"dummy"
"180331",0,0,0,0,"dummy"
"180332",2,3,0,5,"dummy"
"180333",1,0,0,1,"dummy"
"180337",0,1,0,1,"dummy"
"180338",0,5,0,5,"dummy"
"180339",0,3,1,4,"dummy"
"180340",4,3,1,8,"dummy"
"180341",1,3,2,6,"dummy"
"180342",1,3,1,5,"dummy"
"180344",0,4,0,4,"dummy"
"180347",3,1,0,4,"dummy"
"180348",0,4,1,5,"dummy"
"180349",1,1,1,3,"dummy"
"180350",3,0,0,3,"dummy"
"180351",6,1,4,11,"dummy"
"180353",12,1,3,16,"dummy"
"180354",0,0,0,0,"dummy"
"180359",2,2,0,4,"dummy"
"180360",2,10,0,12,"dummy"
"180361",0,0,1,1,"dummy"
"180362",0,0,1,1,"dummy"
"180363",6,14,0,20,"dummy"
"180364",11,6,2,19,"dummy"
"180365",0,2,0,2,"dummy"
"180368",0,6,0,6,"dummy"
"180369",4,1,1,6,"dummy"
"180370",1,3,0,4,"dummy"
"180371",0,2,0,2,"dummy"
"180372",0,0,0,0,"dummy"
"180373",0,0,0,0,"dummy"
"180374",3,7,1,11,"dummy"
"180375",4,23,1,28,"dummy"
"180376",28,0,0,28,"dummy"
"180377",0,2,0,2,"dummy"
"180378",0,2,0,2,"dummy"
"180379",0,0,1,1,"dummy"
"180380",2,5,0,7,"dummy"
"180381",10,0,4,14,"dummy"
"180383",3,1,0,4,"dummy"
"180385",1,0,1,2,"dummy"
"180386",2,0,0,2,"dummy"
"180387",0,0,1,1,"dummy"
"180388",0,0,1,1,"dummy"
"180389",0,1,0,1,"dummy"
"180399",0,2,0,2,"dummy"
"180400",0,0,1,1,"dummy"
"180401",3,1,0,4,"dummy"
"180402",0,1,0,1,"dummy"
"180403",13,8,4,25,"dummy"
"180404",2,2,0,4,"dummy"
"180405",1,1,0,2,"dummy"
"180406",0,1,0,1,"dummy"
"180407",2,6,0,8,"dummy"
"180408",1,0,0,1,"dummy"
"180409",3,7,0,10,"dummy"
"180410",0,1,0,1,"dummy"
"180411",0,1,0,1,"dummy"
"180412",0,3,0,3,"dummy"
"180413",0,1,0,1,"dummy"
"180414",0,3,0,3,"dummy"
"180417",0,1,0,1,"dummy"
"180418",0,3,0,3,"dummy"
"180419",9,9,0,18,"dummy"
"180420",2,2,0,4,"dummy"
"180421",9,9,0,18,"dummy"
"180422",0,5,0,5,"dummy"
"180423",0,0,1,1,"dummy"
"180424",4,1,5,10,"dummy"
"180425",0,2,1,3,"dummy"
"180426",0,0,1,1,"dummy"
"180427",0,4,0,4,"dummy"
"180428",1,0,1,2,"dummy"
"180429",0,1,0,1,"dummy"
"180430",7,7,0,14,"dummy"
"180431",2,0,0,2,"dummy"
"180432",0,3,0,3,"dummy"
"180433",8,2,0,10,"dummy"
"180434",0,1,0,1,"dummy"
"180435",2,3,0,5,"dummy"
"180436",4,6,1,11,"dummy"
"180437",0,9,0,9,"dummy"
"180440",0,2,0,2,"dummy"
"180441",0,3,0,3,"dummy"
"180442",1,4,1,6,"dummy"
"180443",0,1,0,1,"dummy"
"180444",0,1,0,1,"dummy"
"180445",1,0,0,1,"dummy"
"180446",5,1,1,7,"dummy"
"180447",0,0,1,1,"dummy"
"180463",0,2,0,2,"dummy"
"180465",1,2,0,3,"dummy"
"180467",0,1,1,2,"dummy"
"180468",0,0,1,1,"dummy"
"180469",0,0,1,1,"dummy"
"180471",3,0,1,4,"dummy"
"180475",3,1,1,5,"dummy"
"180476",0,1,0,1,"dummy"
"180480",3,5,2,10,"dummy"
"180481",0,0,2,2,"dummy"
"180482",0,3,0,3,"dummy"
"180483",0,0,1,1,"dummy"
"180484",4,4,0,8,"dummy"
"180485",0,0,1,1,"dummy"
"180486",0,0,1,1,"dummy"
"180487",1,0,0,1,"dummy"
"180489",0,10,0,10,"dummy"
"180490",11,1,0,12,"dummy"
"180491",0,2,0,2,"dummy"
"180495",0,1,0,1,"dummy"
"180496",0,0,1,1,"dummy"
"180498",0,2,0,2,"dummy"
"180502",0,1,0,1,"dummy"
"180504",0,5,0,5,"dummy"
"180505",0,1,0,1,"dummy"
"180506",1,2,0,3,"dummy"
"180509",0,1,0,1,"dummy"
"180510",4,4,0,8,"dummy"
"180512",0,0,1,1,"dummy"
"180513",0,0,1,1,"dummy"
"180514",0,2,0,2,"dummy"
"180518",0,0,0,0,"dummy"
"180519",0,2,0,2,"dummy"
"180520",2,9,1,12,"dummy"
"180521",0,3,1,4,"dummy"
"180522",1,5,0,6,"dummy"
"180523",0,2,1,3,"dummy"
"180524",0,0,1,1,"dummy"
"180525",0,1,0,1,"dummy"
"180526",0,0,1,1,"dummy"
"180527",0,0,1,1,"dummy"
"180528",3,0,2,5,"dummy"
"180537",0,4,0,4,"dummy"
"180538",0,1,0,1,"dummy"
"180539",0,2,0,2,"dummy"
"180540",3,0,0,3,"dummy"
"180541",0,1,0,1,"dummy"
"180542",0,2,0,2,"dummy"
"180543",1,0,1,2,"dummy"
"180545",0,0,0,0,"dummy"
"180549",0,1,0,1,"dummy"
"180550",0,0,1,1,"dummy"
"180553",0,8,1,9,"dummy"
"180559",0,1,0,1,"dummy"
"180562",0,0,1,1,"dummy"
"180563",0,1,0,1,"dummy"
"180566",0,0,1,1,"dummy"
"180567",0,1,0,1,"dummy"
"180568",2,0,0,2,"dummy"
"180569",0,1,0,1,"dummy"
"180572",1,3,0,4,"dummy"
"180573",0,2,0,2,"dummy"
"180574",0,3,0,3,"dummy"
"180575",0,0,1,1,"dummy"
"180576",0,1,0,1,"dummy"
"180577",0,1,1,2,"dummy"
"180578",9,30,0,39,"dummy"
"180579",3,0,0,3,"dummy"
"180580",0,1,0,1,"dummy"
"180581",3,0,0,3,"dummy"
"180582",0,0,0,0,"dummy"
"180583",1,0,0,1,"dummy"
"180585",1,1,2,4,"dummy"
"180586",0,2,0,2,"dummy"
"180587",0,6,1,7,"dummy"
"180591",0,0,0,0,"dummy"
"180592",2,1,1,4,"dummy"
"180593",0,0,1,1,"dummy"
"180594",0,0,0,0,"dummy"
"180598",2,2,0,4,"dummy"
"180599",2,0,3,5,"dummy"
"180601",11,5,4,20,"dummy"
"180602",0,0,1,1,"dummy"
"180603",0,1,0,1,"dummy"
"180604",0,3,0,3,"dummy"
"180607",15,1,0,16,"dummy"
"180608",0,3,1,4,"dummy"
"180615",1,2,1,4,"dummy"
"180616",5,6,0,11,"dummy"
"180617",0,1,0,1,"dummy"
"180618",0,2,0,2,"dummy"
"180619",4,0,0,4,"dummy"
"180620",0,0,0,0,"dummy"
"180621",0,4,0,4,"dummy"
"180622",0,0,0,0,"dummy"
"180623",3,6,0,9,"dummy"
"180624",0,0,0,0,"dummy"
"180625",5,5,0,10,"dummy"
"180626",0,5,0,5,"dummy"
"180627",0,1,0,1,"dummy"
"180628",0,0,1,1,"dummy"
"180629",4,4,0,8,"dummy"
"180630",17,17,3,37,"dummy"
"180631",4,4,0,8,"dummy"
"180632",0,0,0,0,"dummy"
"180633",7,7,0,14,"dummy"
"180634",0,0,0,0,"dummy"
"180635",1,0,0,1,"dummy"
"180636",0,0,1,1,"dummy"
"180637",3,0,0,3,"dummy"
"180642",0,2,0,2,"dummy"
"180643",2,7,0,9,"dummy"
"180644",0,0,1,1,"dummy"
"180646",0,2,0,2,"dummy"
"180650",0,1,0,1,"dummy"
"180651",0,0,1,1,"dummy"
"180652",3,32,3,38,"dummy"
"180653",0,11,0,11,"dummy"
"180654",13,15,1,29,"dummy"
"180655",1,3,0,4,"dummy"
"180656",8,0,0,8,"dummy"
"180657",0,3,1,4,"dummy"
"180658",0,7,0,7,"dummy"
"180661",0,12,1,13,"dummy"
"180667",0,1,0,1,"dummy"
"180668",2,5,4,11,"dummy"
"180669",0,0,0,0,"dummy"
"180670",1,0,1,2,"dummy"
"180671",3,0,0,3,"dummy"
"180673",0,2,0,2,"dummy"
"180675",0,0,0,0,"dummy"
"180676",0,0,0,0,"dummy"
"180679",0,0,0,0,"dummy"
"180680",0,0,1,1,"dummy"
"180682",1,2,0,3,"dummy"
"180683",2,10,1,13,"dummy"
"180684",1,2,0,3,"dummy"
"180685",2,1,0,3,"dummy"
"180686",1,2,0,3,"dummy"
"180691",9,21,2,32,"dummy"
"180692",21,9,2,32,"dummy"
"180693",9,21,2,32,"dummy"
"180694",21,9,2,32,"dummy"
"180695",9,21,2,32,"dummy"
"180696",21,9,2,32,"dummy"
"180697",0,0,0,0,"dummy"
"180698",9,21,2,32,"dummy"
"180699",21,9,2,32,"dummy"
"180700",0,2,0,2,"dummy"
"180701",10,20,2,32,"dummy"
"180702",13,9,3,25,"dummy"
"180703",3,1,0,4,"dummy"
"180704",1,0,1,2,"dummy"
"180705",2,0,0,2,"dummy"
"180706",2,2,0,4,"dummy"
"180707",0,0,0,0,"dummy"
"180708",0,1,0,1,"dummy"
"180709",0,1,0,1,"dummy"
"180710",1,0,0,1,"dummy"
"180711",0,1,0,1,"dummy"
"180712",1,0,0,1,"dummy"
"180713",7,13,3,23,"dummy"
"180714",2,0,2,4,"dummy"
"180715",0,3,2,5,"dummy"
"180716",6,8,2,16,"dummy"
"180718",1,1,0,2,"dummy"
"180719",0,1,1,2,"dummy"
"180720",0,3,0,3,"dummy"
"180721",0,3,0,3,"dummy"
"180722",3,1,0,4,"dummy"
"180723",0,0,2,2,"dummy"
"180724",1,3,1,5,"dummy"
"180725",3,1,1,5,"dummy"
"180726",2,1,0,3,"dummy"
"180727",0,0,1,1,"dummy"
"180728",0,4,0,4,"dummy"
"180729",1,1,1,3,"dummy"
"180730",1,1,1,3,"dummy"
"180731",2,0,0,2,"dummy"
"180732",0,2,0,2,"dummy"
"180733",0,3,0,3,"dummy"
"180734",0,1,0,1,"dummy"
"180735",17,1,2,20,"dummy"
"180737",0,1,0,1,"dummy"
"180742",1,0,0,1,"dummy"
"180743",0,0,1,1,"dummy"
"180744",0,4,0,4,"dummy"
"180745",4,0,0,4,"dummy"
"180748",1,1,0,2,"dummy"
"180749",3,8,1,12,"dummy"
"180750",0,1,0,1,"dummy"
"180751",21,20,2,43,"dummy"
"180752",0,3,1,4,"dummy"
"180753",0,0,1,1,"dummy"
"180760",0,3,0,3,"dummy"
"180762",2,2,3,7,"dummy"
"180766",0,2,0,2,"dummy"
"180767",0,1,0,1,"dummy"
"180768",1,0,0,1,"dummy"
"180772",0,1,0,1,"dummy"
"180774",2,2,5,9,"dummy"
"180775",1,6,0,7,"dummy"
"180776",1,4,1,6,"dummy"
"180777",0,0,1,1,"dummy"
"180778",0,0,1,1,"dummy"
"180786",0,0,1,1,"dummy"
"180787",0,0,1,1,"dummy"
"180788",0,0,2,2,"dummy"
"180789",26,3,7,36,"dummy"
"180791",0,2,0,2,"dummy"
"180792",1,7,3,11,"dummy"
"180793",0,2,0,2,"dummy"
"180794",0,1,0,1,"dummy"
"180795",0,0,2,2,"dummy"
"180799",0,0,0,0,"dummy"
"180803",0,0,1,1,"dummy"
"180804",2,2,0,4,"dummy"
"180806",11,4,4,19,"dummy"
"180807",0,0,1,1,"dummy"
"180808",0,0,1,1,"dummy"
"180809",0,0,1,1,"dummy"
"180810",0,0,1,1,"dummy"
"180811",3,0,0,3,"dummy"
"180815",0,1,1,2,"dummy"
"180816",0,1,0,1,"dummy"
"180817",0,0,1,1,"dummy"
"180818",8,11,2,21,"dummy"
"180819",0,0,1,1,"dummy"
"180823",0,1,0,1,"dummy"
"180825",0,0,1,1,"dummy"
"180826",0,0,1,1,"dummy"
"180827",0,0,1,1,"dummy"
"180828",0,0,1,1,"dummy"
"180830",3,4,0,7,"dummy"
"180831",0,0,1,1,"dummy"
"180832",0,0,1,1,"dummy"
"180833",0,0,1,1,"dummy"
"180839",0,0,1,1,"dummy"
"180840",0,0,1,1,"dummy"
"180841",0,4,1,5,"dummy"
"180842",0,0,1,1,"dummy"
"180843",0,0,1,1,"dummy"
"180844",0,0,1,1,"dummy"
"180846",0,1,0,1,"dummy"
"180847",2,0,2,4,"dummy"
"180849",0,0,1,1,"dummy"
"180850",0,0,1,1,"dummy"
"180852",0,0,0,0,"dummy"
"180853",1,0,0,1,"dummy"
"180854",0,0,1,1,"dummy"
"180856",11,6,0,17,"dummy"
"180857",0,2,1,3,"dummy"
"180859",7,4,1,12,"dummy"
"180860",0,1,0,1,"dummy"
"180871",2,0,0,2,"dummy"
"180872",0,0,0,0,"dummy"
"180875",0,1,0,1,"dummy"
"180878",0,1,0,1,"dummy"
"180879",4,12,3,19,"dummy"
"180880",0,5,0,5,"dummy"
"180935",0,4,1,5,"dummy"
"180936",1,0,1,2,"dummy"
"180940",0,0,1,1,"dummy"
"180945",5,1,0,6,"dummy"
"180946",0,1,0,1,"dummy"
"180947",8,1,3,12,"dummy"
"180948",0,0,0,0,"dummy"
"180956",1,0,2,3,"dummy"
"180960",0,1,0,1,"dummy"
"180961",0,4,0,4,"dummy"
"180962",0,1,0,1,"dummy"
"180966",8,9,2,19,"dummy"
"180967",1,7,0,8,"dummy"
"180968",0,2,0,2,"dummy"
"180969",2,3,0,5,"dummy"
"180970",4,4,0,8,"dummy"
"180973",0,0,2,2,"dummy"
"180974",0,1,1,2,"dummy"
"180975",0,0,1,1,"dummy"
"180976",2,1,1,4,"dummy"
"180978",4,1,0,5,"dummy"
"180979",1,4,0,5,"dummy"
"180980",4,1,0,5,"dummy"
"180981",0,3,0,3,"dummy"
"180982",2,2,1,5,"dummy"
"180983",0,0,0,0,"dummy"
"180984",0,2,0,2,"dummy"
"180986",0,0,3,3,"dummy"
"180987",4,9,4,17,"dummy"
"180988",0,0,3,3,"dummy"
"180989",0,0,2,2,"dummy"
"180992",0,1,1,2,"dummy"
"180993",0,0,1,1,"dummy"
"180994",0,1,2,3,"dummy"
"180996",0,0,1,1,"dummy"
"180997",0,0,4,4,"dummy"
"180998",10,3,0,13,"dummy"
"181000",1,2,1,4,"dummy"
"181003",1,0,0,1,"dummy"
"181024",0,2,0,2,"dummy"
"181025",1,0,0,1,"dummy"
"181026",1,0,1,2,"dummy"
"181027",0,0,0,0,"dummy"
"181032",4,5,1,10,"dummy"
"181049",1,1,0,2,"dummy"
"181053",2,1,3,6,"dummy"
"181126",0,0,1,1,"dummy"
"181127",0,0,1,1,"dummy"
"181128",0,1,1,2,"dummy"
"181129",0,0,1,1,"dummy"
"181130",0,1,0,1,"dummy"
"181131",0,0,1,1,"dummy"
"181132",0,0,1,1,"dummy"
"181133",0,0,1,1,"dummy"
"181134",0,0,1,1,"dummy"
"181135",0,0,1,1,"dummy"
"181136",0,0,1,1,"dummy"
"181137",0,0,1,1,"dummy"
"181138",0,0,1,1,"dummy"
"181139",0,0,1,1,"dummy"
"181140",0,0,1,1,"dummy"
"181141",0,0,1,1,"dummy"
"181142",0,0,1,1,"dummy"
"181143",0,0,1,1,"dummy"
"181144",0,0,1,1,"dummy"
"181145",0,0,1,1,"dummy"
"181146",0,0,1,1,"dummy"
"181147",0,0,1,1,"dummy"
"181148",0,0,1,1,"dummy"
"181149",0,0,1,1,"dummy"
"181150",0,0,1,1,"dummy"
"181151",0,0,1,1,"dummy"
"181152",0,0,1,1,"dummy"
"181153",0,0,1,1,"dummy"
"181154",0,0,1,1,"dummy"
"181155",0,0,1,1,"dummy"
"181156",0,0,1,1,"dummy"
"181157",0,0,1,1,"dummy"
"181161",0,0,2,2,"dummy"
"181162",0,5,0,5,"dummy"
"181163",0,2,0,2,"dummy"
"181164",3,5,0,8,"dummy"
"181169",3,6,0,9,"dummy"
"181176",0,0,1,1,"dummy"
"181178",2,0,0,2,"dummy"
"181198",0,0,0,0,"dummy"
"181201",13,0,2,15,"dummy"
"181203",0,0,1,1,"dummy"
"181204",0,0,1,1,"dummy"
"181205",2,3,0,5,"dummy"
"181208",0,0,0,0,"dummy"
"181210",1,1,0,2,"dummy"
"181211",0,6,1,7,"dummy"
"181212",7,1,1,9,"dummy"
"181213",0,6,1,7,"dummy"
"181214",9,7,0,16,"dummy"
"181215",5,1,2,8,"dummy"
"181216",0,1,0,1,"dummy"
"181217",1,0,2,3,"dummy"
"181218",0,1,0,1,"dummy"
"181219",5,5,1,11,"dummy"
"181220",8,9,1,18,"dummy"
"181221",0,0,0,0,"dummy"
"181222",0,0,1,1,"dummy"
"181223",0,1,0,1,"dummy"
"181224",0,0,1,1,"dummy"
"181225",8,8,0,16,"dummy"
"181227",1,2,2,5,"dummy"
"181228",0,0,1,1,"dummy"
"181229",0,1,1,2,"dummy"
"181230",0,1,0,1,"dummy"
"181231",0,8,0,8,"dummy"
"181233",0,0,1,1,"dummy"
"181234",0,2,0,2,"dummy"
"181235",0,0,1,1,"dummy"
"181236",0,1,0,1,"dummy"
"181237",0,0,1,1,"dummy"
"181240",0,8,0,8,"dummy"
"181246",0,0,1,1,"dummy"
"181249",3,0,0,3,"dummy"
"181254",0,0,0,0,"dummy"
"181255",0,0,0,0,"dummy"
"181256",0,0,0,0,"dummy"
"181259",0,0,1,1,"dummy"
"181260",0,0,1,1,"dummy"
"181264",0,0,1,1,"dummy"
"181265",0,1,1,2,"dummy"
"181266",0,0,1,1,"dummy"
"181268",3,3,0,6,"dummy"
"181269",0,0,1,1,"dummy"
"181270",0,0,0,0,"dummy"
"181273",0,0,1,1,"dummy"
"181274",0,3,0,3,"dummy"
"181275",0,0,1,1,"dummy"
"181276",0,0,0,0,"dummy"
"181277",0,2,0,2,"dummy"
"181278",2,0,0,2,"dummy"
"181281",0,3,2,5,"dummy"
"181282",0,0,2,2,"dummy"
"181284",0,0,2,2,"dummy"
"181286",0,0,1,1,"dummy"
"181287",1,12,0,13,"dummy"
"181288",1,0,0,1,"dummy"
"181289",0,3,0,3,"dummy"
"181290",0,1,0,1,"dummy"
"181291",1,0,0,1,"dummy"
"181293",0,2,0,2,"dummy"
"181294",0,0,0,0,"dummy"
"181295",0,1,0,1,"dummy"
"181310",0,1,0,1,"dummy"
"181311",0,5,0,5,"dummy"
"181314",1,5,0,6,"dummy"
"181315",1,2,0,3,"dummy"
"181316",0,0,0,0,"dummy"
"181325",0,0,0,0,"dummy"
"181326",7,5,0,12,"dummy"
"181329",0,0,0,0,"dummy"
"181330",0,1,0,1,"dummy"
"181332",0,7,1,8,"dummy"
"181333",0,3,0,3,"dummy"
"181336",0,3,1,4,"dummy"
"181337",2,8,2,12,"dummy"
"181338",1,1,0,2,"dummy"
"181351",0,2,1,3,"dummy"
"181353",2,1,1,4,"dummy"
"181354",0,1,0,1,"dummy"
"181355",3,0,0,3,"dummy"
"181356",0,1,0,1,"dummy"
"181358",2,1,0,3,"dummy"
"181359",0,2,0,2,"dummy"
"181362",0,0,1,1,"dummy"
"181364",2,1,2,5,"dummy"
"181366",1,1,0,2,"dummy"
"181368",0,1,0,1,"dummy"
"181369",0,1,0,1,"dummy"
"181370",0,5,0,5,"dummy"
"181371",0,4,0,4,"dummy"
"181372",0,2,0,2,"dummy"
"181373",1,5,0,6,"dummy"
"181374",0,1,0,1,"dummy"
"181375",0,4,0,4,"dummy"
"181376",0,4,1,5,"dummy"
"181377",0,1,0,1,"dummy"
"181378",0,3,0,3,"dummy"
"181379",0,3,0,3,"dummy"
"181380",0,4,0,4,"dummy"
"181381",12,10,3,25,"dummy"
"181382",0,0,2,2,"dummy"
"181383",0,2,0,2,"dummy"
"181385",0,0,0,0,"dummy"
"181387",0,0,1,1,"dummy"
"181389",0,2,0,2,"dummy"
"181390",0,1,0,1,"dummy"
"181391",0,0,0,0,"dummy"
"181392",0,1,0,1,"dummy"
"181393",0,6,1,7,"dummy"
"181394",1,0,0,1,"dummy"
"181396",0,2,0,2,"dummy"
"181398",0,4,0,4,"dummy"
"181399",0,0,0,0,"dummy"
"181400",0,1,0,1,"dummy"
"181402",1,0,0,1,"dummy"
"181403",3,15,2,20,"dummy"
"181404",4,3,5,12,"dummy"
"181405",1,2,0,3,"dummy"
"181406",1,1,0,2,"dummy"
"181407",2,2,0,4,"dummy"
"181408",0,0,1,1,"dummy"
"181409",0,3,0,3,"dummy"
"181410",1,2,1,4,"dummy"
"181411",2,1,1,4,"dummy"
"181412",0,0,0,0,"dummy"
"181413",1,0,2,3,"dummy"
"181414",0,2,0,2,"dummy"
"181415",0,0,1,1,"dummy"
"181416",1,1,0,2,"dummy"
"181417",1,0,2,3,"dummy"
"181418",0,1,0,1,"dummy"
"181420",0,0,1,1,"dummy"
"181422",0,0,1,1,"dummy"
"181423",10,8,1,19,"dummy"
"181425",0,2,0,2,"dummy"
"181426",2,0,0,2,"dummy"
"181427",0,0,2,2,"dummy"
"181432",2,0,0,2,"dummy"
"181433",1,2,0,3,"dummy"
"181434",2,0,1,3,"dummy"
"181435",0,2,0,2,"dummy"
"181437",0,1,0,1,"dummy"
"181441",0,1,0,1,"dummy"
"181443",3,24,1,28,"dummy"
"181444",0,1,2,3,"dummy"
"181445",0,0,1,1,"dummy"
"181446",0,0,0,0,"dummy"
"181447",0,3,0,3,"dummy"
"181448",0,0,0,0,"dummy"
"181449",1,1,1,3,"dummy"
"181450",0,0,1,1,"dummy"
"181451",0,1,0,1,"dummy"
"181454",0,1,0,1,"dummy"
"181455",1,1,0,2,"dummy"
"181456",3,8,0,11,"dummy"
"181457",0,0,1,1,"dummy"
"181458",1,0,0,1,"dummy"
"181459",1,0,0,1,"dummy"
"181460",0,0,1,1,"dummy"
"181461",0,0,0,0,"dummy"
"181462",0,1,0,1,"dummy"
"181463",0,0,1,1,"dummy"
"181464",0,0,1,1,"dummy"
"181468",2,0,2,4,"dummy"
"181472",6,6,1,13,"dummy"
"181473",0,0,0,0,"dummy"
"181474",1,0,0,1,"dummy"
"181477",0,3,0,3,"dummy"
"181478",0,1,0,1,"dummy"
"181479",0,6,0,6,"dummy"
"181480",0,0,1,1,"dummy"
"181481",1,0,2,3,"dummy"
"181482",2,3,0,5,"dummy"
"181483",1,2,0,3,"dummy"
"181484",2,1,0,3,"dummy"
"181485",1,0,1,2,"dummy"
"181486",0,2,0,2,"dummy"
"181488",3,6,2,11,"dummy"
"181490",0,0,0,0,"dummy"
"181491",0,1,0,1,"dummy"
"181492",0,2,0,2,"dummy"
"181493",2,0,0,2,"dummy"
"181494",0,1,0,1,"dummy"
"181495",15,2,1,18,"dummy"
"181496",1,4,0,5,"dummy"
"181497",3,0,0,3,"dummy"
"181498",0,1,0,1,"dummy"
"181509",0,1,0,1,"dummy"
"181510",0,0,0,0,"dummy"
"181511",1,2,0,3,"dummy"
"181512",2,2,0,4,"dummy"
"181513",2,8,0,10,"dummy"
"181514",1,2,0,3,"dummy"
"181515",0,1,3,4,"dummy"
"181516",1,1,0,2,"dummy"
"181517",1,0,3,4,"dummy"
"181518",0,1,3,4,"dummy"
"181519",0,1,0,1,"dummy"
"181520",10,6,2,18,"dummy"
"181521",2,0,0,2,"dummy"
"181522",0,0,1,1,"dummy"
"181523",2,2,0,4,"dummy"
"181524",1,4,0,5,"dummy"
"181525",11,3,0,14,"dummy"
"181526",1,1,0,2,"dummy"
"181527",0,1,0,1,"dummy"
"181528",5,2,1,8,"dummy"
"181529",2,0,0,2,"dummy"
"181530",1,2,0,3,"dummy"
"181531",2,0,1,3,"dummy"
"181532",2,1,0,3,"dummy"
"181533",1,2,0,3,"dummy"
"181534",2,1,0,3,"dummy"
"181535",2,0,0,2,"dummy"
"181536",0,2,0,2,"dummy"
"181537",0,0,1,1,"dummy"
"181538",7,1,0,8,"dummy"
"181539",2,0,0,2,"dummy"
"181540",1,0,1,2,"dummy"
"181541",1,3,3,7,"dummy"
"181542",0,0,3,3,"dummy"
"181543",0,0,1,1,"dummy"
"181544",0,12,0,12,"dummy"
"181545",0,0,0,0,"dummy"
"181546",0,1,0,1,"dummy"
"181547",5,1,0,6,"dummy"
"181550",0,1,0,1,"dummy"
"181551",1,1,0,2,"dummy"
"181552",0,1,0,1,"dummy"
"181553",0,0,1,1,"dummy"
"181574",0,1,0,1,"dummy"
"181575",0,0,1,1,"dummy"
"181579",3,2,1,6,"dummy"
"181580",0,1,0,1,"dummy"
"181588",2,7,1,10,"dummy"
"181589",0,0,2,2,"dummy"
"181590",0,0,1,1,"dummy"
"181591",0,0,1,1,"dummy"
"181592",0,0,2,2,"dummy"
"181600",0,0,0,0,"dummy"
"181601",0,0,1,1,"dummy"
"181602",3,0,0,3,"dummy"
"181603",0,0,1,1,"dummy"
"181604",0,1,0,1,"dummy"
"181605",0,0,0,0,"dummy"
"181606",0,0,1,1,"dummy"
"181607",0,2,0,2,"dummy"
"181608",0,0,0,0,"dummy"
"181609",0,0,0,0,"dummy"
"181610",0,2,0,2,"dummy"
"181611",4,1,0,5,"dummy"
"181612",1,0,0,1,"dummy"
"181613",0,0,0,0,"dummy"
"181614",0,0,0,0,"dummy"
"181615",0,0,2,2,"dummy"
"181616",0,0,0,0,"dummy"
"181617",0,0,0,0,"dummy"
"181627",2,18,2,22,"dummy"
"181628",0,0,1,1,"dummy"
"181629",0,1,0,1,"dummy"
"181652",0,1,2,3,"dummy"
"181653",1,0,0,1,"dummy"
"181654",1,0,0,1,"dummy"
"181655",1,3,0,4,"dummy"
"181656",0,1,0,1,"dummy"
"181657",0,1,0,1,"dummy"
"181658",0,0,1,1,"dummy"
"181659",4,5,0,9,"dummy"
"181660",0,0,1,1,"dummy"
"181663",3,2,1,6,"dummy"
"181683",3,0,0,3,"dummy"
"181503",0,0,1,1,"dummy"
"181504",0,0,0,0,"dummy"
"181577",1,1,0,2,"dummy"
"181596",1,5,0,6,"dummy"
"181597",0,2,0,2,"dummy"
"181598",0,0,1,1,"dummy"
"181625",0,1,0,1,"dummy"
"181631",2,1,1,4,"dummy"
"181632",0,0,0,0,"dummy"
"181633",0,2,1,3,"dummy"
"181634",1,0,0,1,"dummy"
"181635",2,3,1,6,"dummy"
"181636",1,0,0,1,"dummy"
"181637",0,1,0,1,"dummy"
"181638",1,0,0,1,"dummy"
"181639",0,1,0,1,"dummy"
"181640",1,0,0,1,"dummy"
"181645",0,0,1,1,"dummy"
"181649",0,3,1,4,"dummy"
"181650",3,0,2,5,"dummy"
"181665",0,2,0,2,"dummy"
"181668",0,1,0,1,"dummy"
"181669",0,0,1,1,"dummy"
"181670",0,0,0,0,"dummy"
"181671",0,0,1,1,"dummy"
"181672",0,0,1,1,"dummy"
"181673",0,0,1,1,"dummy"
"181674",2,0,0,2,"dummy"
"181675",0,2,0,2,"dummy"
"181676",0,0,0,0,"dummy"
"181677",1,3,0,4,"dummy"
"181678",0,2,0,2,"dummy"
"181679",0,2,0,2,"dummy"
"181680",2,0,0,2,"dummy"
"181681",1,4,1,6,"dummy"
"181685",0,0,0,0,"dummy"
"181686",0,0,0,0,"dummy"
"181696",0,2,0,2,"dummy"
"181697",3,11,2,16,"dummy"
"181698",1,0,1,2,"dummy"
"181699",10,3,1,14,"dummy"
"181700",0,0,0,0,"dummy"
"181701",0,0,0,0,"dummy"
"181702",0,3,0,3,"dummy"
"181703",0,1,0,1,"dummy"
"181704",1,0,0,1,"dummy"
"181712",0,1,0,1,"dummy"
"181717",0,4,0,4,"dummy"
"181718",1,3,0,4,"dummy"
"181719",0,5,0,5,"dummy"
"181720",1,0,0,1,"dummy"
"181737",0,0,1,1,"dummy"
"181738",0,0,1,1,"dummy"
"181739",0,0,1,1,"dummy"
"181740",0,0,1,1,"dummy"
"181741",0,0,1,1,"dummy"
"181742",0,0,1,1,"dummy"
"181743",0,0,1,1,"dummy"
"181744",0,0,1,1,"dummy"
"181745",0,0,1,1,"dummy"
"181746",0,0,1,1,"dummy"
"181747",1,0,1,2,"dummy"
"181748",0,1,0,1,"dummy"
"181749",0,0,1,1,"dummy"
"181706",0,0,0,0,"dummy"
"181709",4,2,0,6,"dummy"
"181710",1,3,1,5,"dummy"
"181724",10,2,5,17,"dummy"
"181788",0,0,1,1,"dummy"
"181789",0,1,2,3,"dummy"
"181790",1,2,1,4,"dummy"
"181791",0,0,1,1,"dummy"
"181792",1,0,0,1,"dummy"
"181793",0,0,1,1,"dummy"
"181794",0,0,1,1,"dummy"
"181795",1,0,2,3,"dummy"
"181800",2,4,0,6,"dummy"
"181801",0,2,0,2,"dummy"
"181802",0,2,0,2,"dummy"
"181803",10,2,0,12,"dummy"
"181804",0,2,0,2,"dummy"
"181805",0,0,0,0,"dummy"
"181806",0,0,3,3,"dummy"
"181807",0,5,0,5,"dummy"
"181833",0,6,0,6,"dummy"
"181834",3,3,0,6,"dummy"
"181835",3,4,0,7,"dummy"
"181842",0,1,0,1,"dummy"
"181843",1,1,1,3,"dummy"
"181848",0,0,1,1,"dummy"
"181849",7,22,5,34,"dummy"
"181850",21,7,5,33,"dummy"
"181865",0,2,0,2,"dummy"
"181866",0,4,0,4,"dummy"
"181877",5,6,5,16,"dummy"
"181878",0,1,0,1,"dummy"
"181879",1,2,0,3,"dummy"
"181880",1,1,0,2,"dummy"
"181889",3,3,3,9,"dummy"
"181907",1,0,2,3,"dummy"
"181908",0,3,0,3,"dummy"
"181926",0,0,1,1,"dummy"
"181927",0,0,1,1,"dummy"
"181928",0,8,0,8,"dummy"
"181929",0,0,1,1,"dummy"
"181930",0,0,0,0,"dummy"
"181931",0,2,1,3,"dummy"
"181932",0,9,1,10,"dummy"
"181933",2,2,4,8,"dummy"
"181934",1,0,2,3,"dummy"
"181935",0,0,1,1,"dummy"
"181936",0,1,1,2,"dummy"
"181937",0,0,1,1,"dummy"
"181938",0,0,1,1,"dummy"
"181939",0,0,1,1,"dummy"
"181940",0,2,2,4,"dummy"
"181941",1,0,1,2,"dummy"
"181942",0,0,1,1,"dummy"
"181949",0,8,1,9,"dummy"
"181954",6,0,0,6,"dummy"
"181955",2,5,2,9,"dummy"
"181958",0,0,1,1,"dummy"
"181959",0,0,1,1,"dummy"
"182048",3,7,1,11,"dummy"
"182049",0,0,0,0,"dummy"
"182050",0,4,0,4,"dummy"
"182051",0,3,2,5,"dummy"
"182052",0,1,0,1,"dummy"
"182053",0,0,1,1,"dummy"
"181750",0,0,1,1,"dummy"
"181751",0,0,1,1,"dummy"
"181752",0,1,0,1,"dummy"
"181753",1,0,1,2,"dummy"
"181754",0,0,1,1,"dummy"
"181755",0,0,1,1,"dummy"
"181756",0,0,1,1,"dummy"
"181757",0,0,1,1,"dummy"
"181775",1,0,0,1,"dummy"
"181784",0,0,1,1,"dummy"
"181785",0,0,1,1,"dummy"
"181786",0,0,1,1,"dummy"
"181797",2,0,1,3,"dummy"
"181798",0,5,0,5,"dummy"
"181822",9,0,3,12,"dummy"
"181823",0,0,0,0,"dummy"
"181824",0,0,0,0,"dummy"
"181825",0,1,1,2,"dummy"
"181826",0,4,1,5,"dummy"
"181827",0,1,1,2,"dummy"
"181828",4,2,1,7,"dummy"
"181845",0,0,1,1,"dummy"
"181846",0,0,1,1,"dummy"
"181852",0,1,0,1,"dummy"
"181855",1,0,0,1,"dummy"
"181856",0,0,0,0,"dummy"
"181857",0,0,0,0,"dummy"
"181858",1,0,1,2,"dummy"
"181859",1,0,1,2,"dummy"
"181860",0,0,1,1,"dummy"
"181870",0,2,0,2,"dummy"
"181873",1,0,0,1,"dummy"
"181884",6,2,1,9,"dummy"
"181885",0,10,0,10,"dummy"
"181886",8,0,0,8,"dummy"
"181887",1,2,0,3,"dummy"
"181912",7,1,2,10,"dummy"
"181913",0,0,1,1,"dummy"
"181914",1,0,1,2,"dummy"
"181915",2,2,1,5,"dummy"
"181916",1,7,1,9,"dummy"
"181917",6,1,0,7,"dummy"
"181918",0,1,0,1,"dummy"
"181919",0,0,0,0,"dummy"
"181920",0,0,0,0,"dummy"
"181921",1,0,0,1,"dummy"
"181922",0,0,1,1,"dummy"
"181923",0,0,0,0,"dummy"
"181924",0,0,0,0,"dummy"
"182055",0,7,0,7,"dummy"
"182056",0,2,0,2,"dummy"
"182060",0,0,0,0,"dummy"
"182061",0,0,0,0,"dummy"
"182065",0,0,0,0,"dummy"
"182066",0,0,0,0,"dummy"
"182067",0,0,0,0,"dummy"
"182068",0,0,0,0,"dummy"
"182073",0,0,1,1,"dummy"
"182074",0,1,5,6,"dummy"
"182075",0,1,0,1,"dummy"
"182076",8,9,2,19,"dummy"
"182077",2,4,1,7,"dummy"
"182078",13,9,0,22,"dummy"
"182085",0,4,0,4,"dummy"
"182086",0,17,2,19,"dummy"
"182087",0,3,1,4,"dummy"
"182088",4,7,0,11,"dummy"
"182089",0,2,0,2,"dummy"
"182090",1,0,0,1,"dummy"
"182091",2,1,1,4,"dummy"
"182092",12,2,2,16,"dummy"
"182093",8,6,1,15,"dummy"
"182094",0,3,1,4,"dummy"
"182095",0,0,1,1,"dummy"
"182096",2,0,0,2,"dummy"
"182097",0,1,1,2,"dummy"
"182098",10,0,1,11,"dummy"
"182099",0,4,0,4,"dummy"
"182100",2,3,0,5,"dummy"
"182101",0,1,0,1,"dummy"
"182102",0,2,0,2,"dummy"
"182103",2,2,0,4,"dummy"
"182104",3,2,2,7,"dummy"
"182105",6,1,0,7,"dummy"
"182106",3,1,0,4,"dummy"
"182107",0,1,0,1,"dummy"
"182108",0,2,0,2,"dummy"
"182109",7,8,1,16,"dummy"
"182110",2,3,1,6,"dummy"
"182111",0,0,2,2,"dummy"
"182112",2,1,0,3,"dummy"
"182121",0,0,1,1,"dummy"
"182132",0,0,3,3,"dummy"
"182139",0,2,0,2,"dummy"
"182140",0,0,1,1,"dummy"
"182141",0,3,0,3,"dummy"
"182142",0,1,0,1,"dummy"
"182146",0,5,1,6,"dummy"
"182147",0,3,0,3,"dummy"
"182148",0,0,2,2,"dummy"
"182149",2,2,3,7,"dummy"
"182150",0,2,0,2,"dummy"
"182151",0,2,0,2,"dummy"
"182152",0,0,1,1,"dummy"
"182153",0,16,0,16,"dummy"
"182154",0,0,0,0,"dummy"
"182155",10,6,3,19,"dummy"
"182161",0,3,3,6,"dummy"
"182162",3,0,3,6,"dummy"
"182163",0,3,0,3,"dummy"
"182164",2,0,1,3,"dummy"
"182165",0,3,0,3,"dummy"
"182166",0,0,1,1,"dummy"
"182167",0,1,0,1,"dummy"
"182168",0,0,1,1,"dummy"
"182195",0,0,1,1,"dummy"
"182196",2,2,0,4,"dummy"
"182197",4,2,2,8,"dummy"
"182198",0,0,1,1,"dummy"
"182213",1,1,0,2,"dummy"
"182221",1,1,0,2,"dummy"
"182222",1,2,0,3,"dummy"
"182223",0,0,1,1,"dummy"
"182224",0,0,1,1,"dummy"
"182234",0,0,0,0,"dummy"
"182235",0,0,0,0,"dummy"
"182236",0,3,0,3,"dummy"
"182237",2,6,0,8,"dummy"
"182238",0,1,0,1,"dummy"
"182239",1,1,1,3,"dummy"
"182240",0,2,0,2,"dummy"
"182241",3,0,0,3,"dummy"
"182244",0,0,1,1,"dummy"
"182058",0,2,0,2,"dummy"
"182063",0,1,2,3,"dummy"
"182114",0,1,2,3,"dummy"
"182115",0,0,0,0,"dummy"
"182116",0,1,0,1,"dummy"
"182117",4,0,2,6,"dummy"
"182118",1,0,0,1,"dummy"
"182119",0,0,0,0,"dummy"
"182123",0,0,3,3,"dummy"
"182124",12,34,3,49,"dummy"
"182125",0,6,2,8,"dummy"
"182126",3,1,5,9,"dummy"
"182127",0,0,1,1,"dummy"
"182128",0,1,3,4,"dummy"
"182129",0,3,0,3,"dummy"
"182130",0,0,1,1,"dummy"
"182134",0,1,0,1,"dummy"
"182135",0,1,0,1,"dummy"
"182136",0,1,0,1,"dummy"
"182137",1,1,0,2,"dummy"
"182144",0,5,0,5,"dummy"
"182157",1,0,1,2,"dummy"
"182158",0,1,0,1,"dummy"
"182170",0,2,0,2,"dummy"
"182171",0,2,0,2,"dummy"
"182172",0,1,0,1,"dummy"
"182173",3,3,1,7,"dummy"
"182174",1,0,0,1,"dummy"
"182175",0,2,0,2,"dummy"
"182176",0,0,1,1,"dummy"
"182177",0,3,0,3,"dummy"
"182178",0,1,0,1,"dummy"
"182187",1,0,0,1,"dummy"
"182188",0,0,1,1,"dummy"
"182189",0,1,0,1,"dummy"
"182190",0,0,2,2,"dummy"
"182200",6,2,2,10,"dummy"
"182201",0,1,0,1,"dummy"
"182202",0,3,0,3,"dummy"
"182203",0,1,0,1,"dummy"
"182204",0,1,0,1,"dummy"
"182207",0,0,0,0,"dummy"
"182208",0,1,4,5,"dummy"
"182209",0,10,1,11,"dummy"
"182215",0,0,1,1,"dummy"
"182216",0,0,1,1,"dummy"
"182217",0,2,0,2,"dummy"
"182226",0,1,0,1,"dummy"
"182227",0,1,1,2,"dummy"
"182228",0,0,2,2,"dummy"
"182229",0,0,2,2,"dummy"
"182230",0,0,2,2,"dummy"
"182231",4,2,0,6,"dummy"
"182232",0,0,2,2,"dummy"
"182249",0,0,1,1,"dummy"
"182275",2,2,1,5,"dummy"
"182276",0,2,0,2,"dummy"
"182284",8,10,2,20,"dummy"
"182285",3,5,0,8,"dummy"
"182286",1,2,0,3,"dummy"
"182287",0,1,1,2,"dummy"
"182290",0,0,0,0,"dummy"
"182291",0,0,0,0,"dummy"
"182292",0,0,1,1,"dummy"
"182299",7,1,0,8,"dummy"
"182300",0,0,0,0,"dummy"
"182301",0,0,0,0,"dummy"
"182310",0,0,2,2,"dummy"
"182245",0,14,1,15,"dummy"
"182246",11,6,0,17,"dummy"
"182247",2,1,5,8,"dummy"
"182251",0,0,0,0,"dummy"
"182252",0,0,1,1,"dummy"
"182257",0,0,2,2,"dummy"
"182258",0,0,1,1,"dummy"
"182263",1,0,1,2,"dummy"
"182278",0,2,0,2,"dummy"
"182281",0,3,0,3,"dummy"
"182282",3,0,0,3,"dummy"
"182312",0,0,0,0,"dummy"
"182313",2,0,0,2,"dummy"
"182344",9,38,3,50,"dummy"
"182345",8,15,12,35,"dummy"
"182346",5,4,1,10,"dummy"
"182347",1,4,0,5,"dummy"
"182348",2,3,0,5,"dummy"
"182353",0,6,0,6,"dummy"
"182354",5,7,0,12,"dummy"
"182355",0,6,0,6,"dummy"
"182356",8,0,0,8,"dummy"
"182357",2,5,1,8,"dummy"
"182358",8,3,1,12,"dummy"
"182359",0,0,1,1,"dummy"
"182360",0,1,0,1,"dummy"
"182361",3,5,0,8,"dummy"
"182362",1,1,0,2,"dummy"
"182363",0,1,0,1,"dummy"
"182364",6,5,0,11,"dummy"
"182365",1,4,0,5,"dummy"
"182366",0,0,1,1,"dummy"
"182367",0,3,0,3,"dummy"
"182368",0,3,0,3,"dummy"
"182369",0,0,1,1,"dummy"
"182380",0,0,1,1,"dummy"
"182400",0,2,0,2,"dummy"
"182401",0,0,1,1,"dummy"
"182402",0,0,1,1,"dummy"
"182403",0,0,1,1,"dummy"
"182404",4,0,0,4,"dummy"
"182405",4,3,0,7,"dummy"
"182406",0,2,0,2,"dummy"
"182407",1,1,0,2,"dummy"
"182408",0,0,0,0,"dummy"
"182409",0,0,1,1,"dummy"
"182410",0,0,0,0,"dummy"
"182411",0,0,1,1,"dummy"
"182412",0,0,0,0,"dummy"
"182413",0,0,1,1,"dummy"
"182414",0,0,0,0,"dummy"
"182415",1,2,0,3,"dummy"
"182416",0,0,1,1,"dummy"
"182417",0,0,1,1,"dummy"
"182418",0,0,1,1,"dummy"
"182419",0,0,0,0,"dummy"
"182420",0,0,1,1,"dummy"
"182421",0,0,1,1,"dummy"
"182422",0,0,1,1,"dummy"
"182423",0,0,1,1,"dummy"
"182424",0,0,0,0,"dummy"
"182425",0,0,0,0,"dummy"
"182432",21,98,2,121,"dummy"
"182433",0,2,0,2,"dummy"
"182434",2,4,0,6,"dummy"
"182435",2,3,0,5,"dummy"
"182436",1,1,0,2,"dummy"
"182437",59,5,0,64,"dummy"
"182447",1,0,0,1,"dummy"
"182455",0,2,0,2,"dummy"
"182456",0,1,0,1,"dummy"
"182464",6,0,0,6,"dummy"
"182465",0,3,0,3,"dummy"
"182466",0,1,0,1,"dummy"
"182467",0,0,1,1,"dummy"
"182468",0,14,0,14,"dummy"
"182469",0,0,1,1,"dummy"
"182339",0,0,0,0,"dummy"
"182340",0,4,0,4,"dummy"
"182341",0,2,0,2,"dummy"
"182342",1,0,1,2,"dummy"
"182427",2,0,4,6,"dummy"
"182428",0,1,2,3,"dummy"
"182429",0,2,1,3,"dummy"
"182430",2,4,1,7,"dummy"
"182439",0,0,1,1,"dummy"
"182442",0,0,1,1,"dummy"
"182443",0,0,1,1,"dummy"
"182444",0,0,1,1,"dummy"
"182445",0,0,0,0,"dummy"
"182451",14,2,2,18,"dummy"
"182458",0,1,0,1,"dummy"
"182461",0,0,3,3,"dummy"
"182462",2,0,1,3,"dummy"
"182473",0,17,0,17,"dummy"
"182474",0,2,0,2,"dummy"
"182477",1,6,4,11,"dummy"
"182478",0,2,1,3,"dummy"
"182481",0,3,0,3,"dummy"
"182482",5,4,0,9,"dummy"
"182483",1,2,1,4,"dummy"
"182484",1,1,0,2,"dummy"
"182485",3,0,0,3,"dummy"
"182486",1,0,0,1,"dummy"
"182491",0,0,1,1,"dummy"
"182492",11,7,2,20,"dummy"
"182497",0,3,0,3,"dummy"
"182498",0,0,1,1,"dummy"
"182502",0,0,0,0,"dummy"
"182523",2,3,0,5,"dummy"
"182524",0,0,2,2,"dummy"
"182525",0,0,2,2,"dummy"
"182526",0,1,0,1,"dummy"
"182527",0,0,2,2,"dummy"
"182528",1,0,0,1,"dummy"
"182534",0,0,0,0,"dummy"
"182494",0,1,0,1,"dummy"
"182495",1,2,0,3,"dummy"
"182500",14,16,2,32,"dummy"
"182519",0,0,3,3,"dummy"
"182520",0,1,0,1,"dummy"
"182521",0,1,0,1,"dummy"
"182530",0,3,0,3,"dummy"
"182531",5,2,0,7,"dummy"
"182532",0,1,1,2,"dummy"
"182536",0,0,1,1,"dummy"
"182537",0,0,1,1,"dummy"
"182538",0,0,1,1,"dummy"
"182539",0,0,1,1,"dummy"
"182542",1,1,0,2,"dummy"
"182565",2,12,4,18,"dummy"
"182566",12,1,4,17,"dummy"
"182567",0,3,0,3,"dummy"
"182569",1,0,0,1,"dummy"
"182570",1,0,3,4,"dummy"
"182571",0,1,1,2,"dummy"
"182572",12,9,2,23,"dummy"
"182573",0,0,3,3,"dummy"
"182574",0,0,3,3,"dummy"
"182577",0,1,0,1,"dummy"
"182579",14,16,2,32,"dummy"
"182581",0,1,0,1,"dummy"
"182583",2,2,1,5,"dummy"
"182584",1,5,0,6,"dummy"
"182586",0,0,2,2,"dummy"
"182591",3,1,0,4,"dummy"
"182593",2,0,1,3,"dummy"
"182594",0,0,0,0,"dummy"
"182598",0,0,0,0,"dummy"
"182600",0,3,0,3,"dummy"
"182601",0,0,1,1,"dummy"
"182602",0,0,1,1,"dummy"
"182603",0,0,1,1,"dummy"
"182604",0,0,1,1,"dummy"
"182605",3,2,1,6,"dummy"
"182606",0,1,0,1,"dummy"
"182607",5,4,0,9,"dummy"
"182611",2,2,3,7,"dummy"
"182612",0,3,0,3,"dummy"
"182613",3,0,0,3,"dummy"
"182614",2,0,0,2,"dummy"
"182615",0,0,1,1,"dummy"
"182616",0,1,0,1,"dummy"
"182617",0,1,0,1,"dummy"
"182642",0,3,2,5,"dummy"
"182650",0,1,0,1,"dummy"
"182652",0,2,0,2,"dummy"
"182653",4,4,0,8,"dummy"
"182654",1,0,1,2,"dummy"
"182655",0,1,0,1,"dummy"
"182656",1,0,0,1,"dummy"
"182658",0,0,2,2,"dummy"
"182659",0,0,0,0,"dummy"
"182660",0,0,0,0,"dummy"
"182661",0,0,2,2,"dummy"
"182662",4,1,0,5,"dummy"
"182663",1,0,0,1,"dummy"
"182664",0,0,1,1,"dummy"
"182665",0,0,0,0,"dummy"
"182666",0,0,1,1,"dummy"
"182667",0,0,0,0,"dummy"
"182668",2,0,0,2,"dummy"
"182670",0,0,1,1,"dummy"
"182671",2,1,1,4,"dummy"
"182673",0,1,0,1,"dummy"
"182674",0,1,2,3,"dummy"
"182677",0,1,0,1,"dummy"
"182678",8,5,0,13,"dummy"
"182679",0,0,1,1,"dummy"
"182681",0,2,0,2,"dummy"
"182682",2,1,0,3,"dummy"
"182683",0,3,1,4,"dummy"
"182684",1,1,2,4,"dummy"
"182685",0,1,1,2,"dummy"
"182686",0,3,1,4,"dummy"
"182687",2,0,0,2,"dummy"
"182688",0,1,0,1,"dummy"
"182689",1,0,0,1,"dummy"
"182690",1,1,1,3,"dummy"
"182691",0,1,0,1,"dummy"
"182692",0,1,0,1,"dummy"
"182693",0,1,0,1,"dummy"
"182694",2,15,0,17,"dummy"
"182695",2,1,0,3,"dummy"
"182696",1,3,0,4,"dummy"
"182703",0,0,1,1,"dummy"
"182706",0,0,1,1,"dummy"
"182707",0,1,0,1,"dummy"
"182708",7,2,0,9,"dummy"
"182709",0,4,0,4,"dummy"
"182710",0,1,0,1,"dummy"
"182711",1,0,4,5,"dummy"
"182712",0,0,1,1,"dummy"
"182713",1,1,1,3,"dummy"
"182714",0,3,0,3,"dummy"
"182715",0,1,0,1,"dummy"
"182716",0,0,1,1,"dummy"
"182723",0,0,0,0,"dummy"
"182727",5,6,6,17,"dummy"
"182772",2,7,1,10,"dummy"
"182773",1,3,0,4,"dummy"
"182774",5,3,0,8,"dummy"
"182777",0,2,1,3,"dummy"
"182778",5,5,1,11,"dummy"
"182781",2,0,0,2,"dummy"
"182782",0,0,0,0,"dummy"
"182783",0,0,0,0,"dummy"
"182785",0,1,0,1,"dummy"
"182786",0,1,2,3,"dummy"
"182787",0,5,0,5,"dummy"
"182788",0,3,0,3,"dummy"
"182790",0,0,0,0,"dummy"
"182791",0,0,0,0,"dummy"
"182792",0,0,0,0,"dummy"
"182793",0,0,0,0,"dummy"
"182794",1,0,0,1,"dummy"
"182795",0,0,0,0,"dummy"
"182796",1,0,0,1,"dummy"
"182797",0,0,0,0,"dummy"
"182798",0,0,0,0,"dummy"
"182802",0,0,1,1,"dummy"
"182803",0,1,0,1,"dummy"
"182808",0,4,0,4,"dummy"
"182809",0,4,0,4,"dummy"
"182810",0,0,1,1,"dummy"
"182811",0,1,0,1,"dummy"
"182812",1,0,0,1,"dummy"
"182813",0,1,0,1,"dummy"
"182816",0,0,0,0,"dummy"
"182817",0,0,1,1,"dummy"
"182818",8,6,0,14,"dummy"
"182819",12,12,0,24,"dummy"
"182820",0,0,0,0,"dummy"
"182821",0,1,0,1,"dummy"
"182822",17,17,0,34,"dummy"
"182823",0,0,0,0,"dummy"
"182824",0,0,0,0,"dummy"
"182825",0,0,0,0,"dummy"
"182826",0,3,1,4,"dummy"
"182829",0,0,1,1,"dummy"
"182830",0,1,1,2,"dummy"
"182832",0,0,0,0,"dummy"
"182833",0,7,2,9,"dummy"
"182834",1,0,0,1,"dummy"
"182836",0,0,1,1,"dummy"
"182837",0,0,3,3,"dummy"
"182838",1,4,0,5,"dummy"
"182841",4,1,0,5,"dummy"
"182842",0,9,2,11,"dummy"
"182843",0,1,0,1,"dummy"
"182844",0,0,1,1,"dummy"
"182845",0,2,0,2,"dummy"
"182846",0,4,0,4,"dummy"
"182847",0,9,2,11,"dummy"
"182848",0,1,0,1,"dummy"
"182850",0,1,0,1,"dummy"
"182851",0,3,0,3,"dummy"
"182852",9,9,0,18,"dummy"
"182853",2,2,0,4,"dummy"
"182854",9,9,0,18,"dummy"
"182855",0,5,0,5,"dummy"
"182856",0,0,1,1,"dummy"
"182857",4,1,5,10,"dummy"
"182858",0,2,1,3,"dummy"
"182859",0,0,1,1,"dummy"
"182860",0,4,0,4,"dummy"
"182861",1,0,1,2,"dummy"
"182862",0,1,0,1,"dummy"
"182863",7,7,0,14,"dummy"
"182864",2,0,0,2,"dummy"
"182865",0,3,0,3,"dummy"
"182866",8,2,0,10,"dummy"
"182867",0,1,0,1,"dummy"
"182868",2,3,0,5,"dummy"
"182870",1,0,0,1,"dummy"
"182871",4,7,2,13,"dummy"
"182872",0,2,0,2,"dummy"
"182876",1,0,0,1,"dummy"
"182877",2,2,0,4,"dummy"
"182878",3,4,5,12,"dummy"
"182880",4,3,0,7,"dummy"
"182881",0,0,0,0,"dummy"
"182882",0,0,1,1,"dummy"
"182883",0,0,1,1,"dummy"
"182884",0,1,0,1,"dummy"
"182886",0,0,1,1,"dummy"
"182887",0,2,0,2,"dummy"
"182888",0,1,0,1,"dummy"
"182889",0,0,1,1,"dummy"
"182891",0,0,0,0,"dummy"
"182892",3,2,5,10,"dummy"
"182893",0,0,1,1,"dummy"
"182894",0,0,1,1,"dummy"
"182897",1,2,0,3,"dummy"
"182898",0,0,0,0,"dummy"
"182900",12,25,1,38,"dummy"
"182902",3,1,0,4,"dummy"
"182903",0,1,1,2,"dummy"
"182910",11,1,0,12,"dummy"
"182911",0,2,0,2,"dummy"
"182924",0,0,0,0,"dummy"
"182925",0,0,0,0,"dummy"
"182928",0,1,0,1,"dummy"
"182929",0,3,0,3,"dummy"
"182930",1,0,0,1,"dummy"
"182931",0,1,0,1,"dummy"
"182939",0,0,0,0,"dummy"
"182940",0,0,0,0,"dummy"
"182976",0,1,0,1,"dummy"
"182977",0,0,0,0,"dummy"
"183003",1,1,0,2,"dummy"
"183012",0,0,0,0,"dummy"
"183015",0,1,0,1,"dummy"
"183016",1,3,1,5,"dummy"
"183019",1,1,0,2,"dummy"
"183020",0,0,1,1,"dummy"
"183021",0,2,0,2,"dummy"
"183024",1,4,0,5,"dummy"
"183025",1,4,1,6,"dummy"
"183026",5,5,0,10,"dummy"
"183027",0,0,0,0,"dummy"
"183039",0,0,2,2,"dummy"
"183040",0,0,2,2,"dummy"
"183041",0,0,2,2,"dummy"
"183042",0,0,2,2,"dummy"
"183043",0,0,2,2,"dummy"
"183044",20,2,3,25,"dummy"
"183045",0,0,1,1,"dummy"
"183046",0,0,1,1,"dummy"
"183047",0,0,1,1,"dummy"
"183069",0,0,0,0,"dummy"
"183084",1,4,0,5,"dummy"
"183085",0,0,1,1,"dummy"
"183086",1,2,0,3,"dummy"
"183096",0,0,0,0,"dummy"
"183099",5,14,0,19,"dummy"
"183110",2,2,0,4,"dummy"
"183111",1,0,0,1,"dummy"
"183112",0,1,0,1,"dummy"
"183113",1,1,1,3,"dummy"
"183114",1,0,0,1,"dummy"
"183115",5,7,3,15,"dummy"
"183116",2,2,2,6,"dummy"
"183117",2,3,2,7,"dummy"
"183118",1,0,0,1,"dummy"
"183119",0,0,0,0,"dummy"
"183125",0,0,2,2,"dummy"
"183126",0,0,2,2,"dummy"
"183127",0,0,1,1,"dummy"
"183156",0,0,2,2,"dummy"
"183157",0,0,1,1,"dummy"
"183190",0,0,1,1,"dummy"
"183191",1,1,0,2,"dummy"
"183192",9,0,2,11,"dummy"
"183193",0,0,0,0,"dummy"
"183194",0,9,2,11,"dummy"
"183240",0,3,0,3,"dummy"
"182933",0,0,12,12,"dummy"
"182934",0,1,0,1,"dummy"
"182942",1,0,0,1,"dummy"
"182949",0,5,2,7,"dummy"
"182952",38,13,3,54,"dummy"
"182953",0,1,0,1,"dummy"
"182954",0,2,0,2,"dummy"
"182955",0,1,0,1,"dummy"
"182956",1,1,0,2,"dummy"
"182957",0,1,0,1,"dummy"
"182958",1,0,1,2,"dummy"
"182959",5,0,0,5,"dummy"
"182962",0,1,0,1,"dummy"
"182963",0,1,0,1,"dummy"
"182964",14,4,4,22,"dummy"
"182965",1,1,1,3,"dummy"
"182966",1,0,0,1,"dummy"
"182967",0,0,1,1,"dummy"
"182968",0,0,1,1,"dummy"
"182969",0,1,0,1,"dummy"
"182972",0,2,0,2,"dummy"
"182973",0,0,1,1,"dummy"
"182974",1,0,0,1,"dummy"
"182979",0,4,0,4,"dummy"
"182980",16,1,2,19,"dummy"
"183005",0,0,1,1,"dummy"
"183029",1,1,0,2,"dummy"
"183030",7,13,2,22,"dummy"
"183031",9,17,1,27,"dummy"
"183032",15,10,0,25,"dummy"
"183033",8,10,2,20,"dummy"
"183034",0,2,0,2,"dummy"
"183035",11,6,0,17,"dummy"
"183036",3,1,0,4,"dummy"
"183037",0,0,1,1,"dummy"
"183049",3,2,2,7,"dummy"
"183050",6,2,0,8,"dummy"
"183051",0,1,1,2,"dummy"
"183052",9,12,2,23,"dummy"
"183053",1,1,0,2,"dummy"
"183054",1,2,0,3,"dummy"
"183055",0,0,0,0,"dummy"
"183058",0,4,0,4,"dummy"
"183059",14,3,3,20,"dummy"
"183062",0,1,0,1,"dummy"
"183065",0,0,1,1,"dummy"
"183066",1,0,0,1,"dummy"
"183067",0,0,1,1,"dummy"
"183090",0,0,3,3,"dummy"
"183091",0,1,0,1,"dummy"
"183092",6,4,0,10,"dummy"
"183140",0,0,0,0,"dummy"
"183143",0,4,0,4,"dummy"
"183144",0,2,0,2,"dummy"
"183145",0,2,0,2,"dummy"
"183146",0,0,1,1,"dummy"
"183147",2,0,0,2,"dummy"
"183148",0,1,0,1,"dummy"
"183151",2,3,1,6,"dummy"
"183152",1,0,0,1,"dummy"
"183163",7,12,7,26,"dummy"
"183173",8,10,5,23,"dummy"
"183174",0,9,0,9,"dummy"
"183175",5,8,1,14,"dummy"
"183176",0,1,2,3,"dummy"
"183177",0,1,0,1,"dummy"
"183178",7,3,1,11,"dummy"
"183179",1,3,5,9,"dummy"
"183180",0,7,0,7,"dummy"
"183181",0,1,1,2,"dummy"
"183182",2,0,0,2,"dummy"
"183187",0,0,0,0,"dummy"
"183188",0,0,0,0,"dummy"
"183234",0,2,0,2,"dummy"
"183237",0,0,1,1,"dummy"
"183238",0,0,1,1,"dummy"
"183308",0,1,0,1,"dummy"
"183320",0,3,0,3,"dummy"
"183321",0,0,1,1,"dummy"
"183322",0,3,0,3,"dummy"
"183323",0,1,0,1,"dummy"
"183324",0,1,0,1,"dummy"
"183325",0,1,0,1,"dummy"
"183326",0,2,0,2,"dummy"
"183380",0,0,1,1,"dummy"
"183381",0,0,1,1,"dummy"
"183423",0,4,0,4,"dummy"
"183430",1,0,1,2,"dummy"
"183431",0,0,1,1,"dummy"
"183435",0,10,4,14,"dummy"
"183476",0,1,0,1,"dummy"
"183477",2,15,1,18,"dummy"
"183478",1,0,0,1,"dummy"
"183479",2,2,0,4,"dummy"
"183480",5,5,1,11,"dummy"
"183481",1,1,0,2,"dummy"
"183482",0,0,2,2,"dummy"
"183483",0,2,0,2,"dummy"
"183484",0,1,0,1,"dummy"
"183485",0,0,2,2,"dummy"
"183486",0,1,0,1,"dummy"
"183487",1,0,0,1,"dummy"
"183488",3,0,0,3,"dummy"
"183497",0,1,0,1,"dummy"
"183498",0,0,1,1,"dummy"
"183310",0,0,0,0,"dummy"
"183311",0,0,0,0,"dummy"
"183328",0,1,0,1,"dummy"
"183329",0,1,0,1,"dummy"
"183330",1,3,0,4,"dummy"
"183331",1,4,0,5,"dummy"
"183332",0,5,0,5,"dummy"
"183333",3,11,1,15,"dummy"
"183334",0,0,1,1,"dummy"
"183335",0,0,1,1,"dummy"
"183338",0,2,1,3,"dummy"
"183339",0,0,1,1,"dummy"
"183340",1,2,1,4,"dummy"
"183369",0,1,0,1,"dummy"
"183376",4,5,2,11,"dummy"
"183377",0,0,1,1,"dummy"
"183378",0,4,0,4,"dummy"
"183383",0,1,0,1,"dummy"
"183384",1,1,0,2,"dummy"
"183385",0,1,0,1,"dummy"
"183390",0,2,0,2,"dummy"
"183391",0,0,1,1,"dummy"
"183392",0,0,1,1,"dummy"
"183398",4,0,0,4,"dummy"
"183399",0,0,2,2,"dummy"
"183400",0,0,2,2,"dummy"
"183418",0,2,0,2,"dummy"
"183419",3,6,0,9,"dummy"
"183420",0,1,0,1,"dummy"
"183421",0,4,1,5,"dummy"
"183425",1,0,1,2,"dummy"
"183426",10,3,1,14,"dummy"
"183427",0,0,0,0,"dummy"
"183428",1,1,1,3,"dummy"
"183433",0,1,0,1,"dummy"
"183462",5,6,2,13,"dummy"
"183463",0,3,0,3,"dummy"
"183464",1,1,0,2,"dummy"
"183465",0,6,0,6,"dummy"
"183466",4,2,0,6,"dummy"
"183467",0,3,0,3,"dummy"
"183468",0,1,0,1,"dummy"
"183469",0,1,0,1,"dummy"
"183470",0,1,0,1,"dummy"
"183471",0,2,0,2,"dummy"
"183472",0,1,0,1,"dummy"
"183473",0,0,0,0,"dummy"
"183474",1,1,0,2,"dummy"
"183508",1,0,0,1,"dummy"
"183509",0,0,1,1,"dummy"
"183510",1,2,0,3,"dummy"
"183511",8,12,3,23,"dummy"
"183512",12,9,3,24,"dummy"
"183513",8,12,3,23,"dummy"
"183514",0,1,0,1,"dummy"
"183515",0,1,1,2,"dummy"
"183516",0,1,0,1,"dummy"
"183517",3,0,1,4,"dummy"
"183518",0,2,1,3,"dummy"
"183519",0,0,1,1,"dummy"
"183520",0,0,0,0,"dummy"
"183521",0,0,2,2,"dummy"
"183522",0,1,0,1,"dummy"
"183523",0,0,0,0,"dummy"
"183524",5,8,0,13,"dummy"
"183525",0,0,0,0,"dummy"
"183526",13,5,0,18,"dummy"
"183527",5,13,0,18,"dummy"
"183528",13,5,0,18,"dummy"
"183529",0,2,1,3,"dummy"
"183530",2,9,0,11,"dummy"
"183531",7,8,0,15,"dummy"
"183532",0,1,0,1,"dummy"
"183533",0,0,2,2,"dummy"
"183534",5,5,1,11,"dummy"
"183535",3,3,0,6,"dummy"
"183536",0,0,0,0,"dummy"
"183537",0,0,0,0,"dummy"
"183538",2,5,1,8,"dummy"
"183539",0,0,1,1,"dummy"
"183567",1,1,0,2,"dummy"
"183568",14,9,3,26,"dummy"
"183573",1,1,0,2,"dummy"
"183760",0,1,0,1,"dummy"
"183761",0,0,1,1,"dummy"
"183762",2,0,1,3,"dummy"
"183763",0,2,0,2,"dummy"
"183764",0,0,1,1,"dummy"
"183765",2,5,1,8,"dummy"
"183766",2,4,0,6,"dummy"
"183767",0,1,0,1,"dummy"
"183768",0,0,0,0,"dummy"
"183769",1,5,0,6,"dummy"
"183770",0,2,0,2,"dummy"
"183771",0,2,0,2,"dummy"
"183772",1,3,0,4,"dummy"
"183773",0,3,0,3,"dummy"
"183774",3,10,1,14,"dummy"
"183775",0,3,0,3,"dummy"
"183776",0,0,1,1,"dummy"
"183777",0,1,1,2,"dummy"
"183778",0,1,1,2,"dummy"
"183779",0,1,1,2,"dummy"
"183780",1,3,0,4,"dummy"
"183781",0,0,1,1,"dummy"
"183782",0,1,0,1,"dummy"
"183783",0,12,0,12,"dummy"
"183784",1,1,1,3,"dummy"
"183785",0,0,2,2,"dummy"
"183786",0,2,0,2,"dummy"
"183795",0,1,0,1,"dummy"
"183812",0,2,0,2,"dummy"
"183832",0,4,0,4,"dummy"
"183833",0,1,0,1,"dummy"
"183839",0,1,0,1,"dummy"
"183843",3,1,1,5,"dummy"
"183844",0,1,0,1,"dummy"
"183845",8,0,2,10,"dummy"
"183856",0,1,0,1,"dummy"
"183880",0,3,0,3,"dummy"
"183884",0,0,1,1,"dummy"
"183885",0,0,1,1,"dummy"
"183886",0,0,0,0,"dummy"
"183887",0,0,1,1,"dummy"
"183888",0,0,1,1,"dummy"
"183894",0,0,1,1,"dummy"
"183895",0,2,0,2,"dummy"
"183896",0,0,1,1,"dummy"
"183897",0,1,0,1,"dummy"
"183898",0,1,0,1,"dummy"
"183899",3,4,0,7,"dummy"
"183900",1,0,0,1,"dummy"
"183901",0,2,0,2,"dummy"
"183902",2,1,0,3,"dummy"
"183903",7,6,3,16,"dummy"
"183904",0,3,1,4,"dummy"
"183905",2,1,0,3,"dummy"
"183906",2,1,0,3,"dummy"
"183907",3,3,1,7,"dummy"
"183908",0,3,0,3,"dummy"
"183909",1,0,2,3,"dummy"
"183910",3,0,3,6,"dummy"
"183911",1,0,0,1,"dummy"
"183912",0,1,0,1,"dummy"
"183913",0,1,0,1,"dummy"
"183914",0,1,0,1,"dummy"
"183915",0,1,0,1,"dummy"
"183916",5,1,2,8,"dummy"
"183917",0,0,1,1,"dummy"
"183918",0,0,1,1,"dummy"
"183919",0,0,1,1,"dummy"
"183920",0,0,1,1,"dummy"
"183926",1,2,0,3,"dummy"
"183929",1,0,0,1,"dummy"
"183930",0,1,0,1,"dummy"
"183931",0,1,0,1,"dummy"
"183936",0,0,1,1,"dummy"
"183540",0,0,1,1,"dummy"
"183541",2,8,0,10,"dummy"
"183542",2,1,0,3,"dummy"
"183543",0,0,0,0,"dummy"
"183544",1,0,0,1,"dummy"
"183545",0,0,2,2,"dummy"
"183546",0,0,0,0,"dummy"
"183547",0,1,1,2,"dummy"
"183548",1,0,0,1,"dummy"
"183549",0,1,0,1,"dummy"
"183550",0,0,1,1,"dummy"
"183551",0,0,0,0,"dummy"
"183552",0,0,0,0,"dummy"
"183553",0,0,1,1,"dummy"
"183554",1,0,0,1,"dummy"
"183555",2,2,0,4,"dummy"
"183556",3,0,0,3,"dummy"
"183557",0,0,0,0,"dummy"
"183558",1,0,0,1,"dummy"
"183559",1,0,0,1,"dummy"
"183560",0,0,0,0,"dummy"
"183561",0,0,0,0,"dummy"
"183562",0,0,0,0,"dummy"
"183563",2,1,0,3,"dummy"
"183608",0,0,1,1,"dummy"
"183609",0,0,1,1,"dummy"
"183610",13,17,0,30,"dummy"
"183611",0,0,1,1,"dummy"
"183612",0,0,1,1,"dummy"
"183613",0,0,1,1,"dummy"
"183614",0,0,1,1,"dummy"
"183615",0,0,1,1,"dummy"
"183616",0,0,1,1,"dummy"
"183617",0,0,1,1,"dummy"
"183618",0,0,1,1,"dummy"
"183619",0,0,1,1,"dummy"
"183620",0,0,1,1,"dummy"
"183621",0,0,1,1,"dummy"
"183622",0,0,1,1,"dummy"
"183623",0,0,1,1,"dummy"
"183624",0,0,1,1,"dummy"
"183625",0,0,1,1,"dummy"
"183626",0,0,1,1,"dummy"
"183627",0,0,1,1,"dummy"
"183628",0,0,1,1,"dummy"
"183629",0,0,1,1,"dummy"
"183630",0,0,1,1,"dummy"
"183631",0,0,1,1,"dummy"
"183632",0,0,1,1,"dummy"
"183633",0,0,1,1,"dummy"
"183634",0,0,1,1,"dummy"
"183635",0,0,1,1,"dummy"
"183636",0,0,1,1,"dummy"
"183637",0,0,1,1,"dummy"
"183638",0,0,1,1,"dummy"
"183639",0,0,1,1,"dummy"
"183640",0,0,1,1,"dummy"
"183641",0,0,1,1,"dummy"
"183642",0,0,1,1,"dummy"
"183643",0,0,1,1,"dummy"
"183644",0,0,1,1,"dummy"
"183645",0,0,1,1,"dummy"
"183646",0,0,1,1,"dummy"
"183647",0,0,1,1,"dummy"
"183648",0,0,1,1,"dummy"
"183649",0,0,1,1,"dummy"
"183650",0,0,1,1,"dummy"
"183651",0,0,1,1,"dummy"
"183652",0,0,1,1,"dummy"
"183653",0,0,1,1,"dummy"
"183654",0,0,1,1,"dummy"
"183655",0,0,1,1,"dummy"
"183656",0,0,1,1,"dummy"
"183657",0,0,1,1,"dummy"
"183658",0,0,1,1,"dummy"
"183659",0,0,1,1,"dummy"
"183660",0,0,1,1,"dummy"
"183661",0,0,1,1,"dummy"
"183662",0,0,1,1,"dummy"
"183663",0,0,1,1,"dummy"
"183664",0,0,1,1,"dummy"
"183665",0,0,1,1,"dummy"
"183666",0,0,1,1,"dummy"
"183667",0,0,1,1,"dummy"
"183668",0,0,1,1,"dummy"
"183669",0,0,1,1,"dummy"
"183670",0,0,1,1,"dummy"
"183671",0,0,1,1,"dummy"
"183672",0,0,1,1,"dummy"
"183673",0,0,1,1,"dummy"
"183674",0,0,1,1,"dummy"
"183675",0,0,1,1,"dummy"
"183676",0,0,1,1,"dummy"
"183677",0,0,1,1,"dummy"
"183678",0,0,1,1,"dummy"
"183679",0,0,1,1,"dummy"
"183680",0,0,1,1,"dummy"
"183681",0,0,1,1,"dummy"
"183682",0,0,1,1,"dummy"
"183683",0,0,1,1,"dummy"
"183684",0,0,1,1,"dummy"
"183685",0,0,1,1,"dummy"
"183686",0,0,1,1,"dummy"
"183687",0,0,1,1,"dummy"
"183688",0,0,1,1,"dummy"
"183689",0,0,1,1,"dummy"
"183690",0,0,1,1,"dummy"
"183691",0,0,1,1,"dummy"
"183692",0,0,1,1,"dummy"
"183693",0,0,1,1,"dummy"
"183694",0,0,1,1,"dummy"
"183695",0,0,1,1,"dummy"
"183696",0,0,1,1,"dummy"
"183697",0,0,1,1,"dummy"
"183698",0,0,1,1,"dummy"
"183699",0,0,1,1,"dummy"
"183700",0,0,1,1,"dummy"
"183701",0,0,1,1,"dummy"
"183702",0,0,1,1,"dummy"
"183703",0,0,1,1,"dummy"
"183704",0,0,1,1,"dummy"
"183705",0,0,1,1,"dummy"
"183706",0,0,1,1,"dummy"
"183707",0,0,1,1,"dummy"
"183708",0,0,1,1,"dummy"
"183709",0,0,1,1,"dummy"
"183710",0,0,1,1,"dummy"
"183711",0,0,1,1,"dummy"
"183712",0,0,0,0,"dummy"
"183713",0,0,1,1,"dummy"
"183714",0,0,1,1,"dummy"
"183715",0,0,1,1,"dummy"
"183716",0,0,1,1,"dummy"
"183717",0,0,1,1,"dummy"
"183718",0,0,1,1,"dummy"
"183719",0,0,1,1,"dummy"
"183720",0,0,1,1,"dummy"
"183721",0,0,1,1,"dummy"
"183722",0,0,1,1,"dummy"
"183723",0,0,1,1,"dummy"
"183724",0,0,1,1,"dummy"
"183725",0,0,1,1,"dummy"
"183726",0,0,1,1,"dummy"
"183727",0,0,1,1,"dummy"
"183728",0,0,1,1,"dummy"
"183729",0,0,1,1,"dummy"
"183730",0,0,1,1,"dummy"
"183731",0,0,1,1,"dummy"
"183732",0,0,1,1,"dummy"
"183733",0,0,1,1,"dummy"
"183734",0,0,0,0,"dummy"
"183735",0,0,1,1,"dummy"
"183736",0,0,1,1,"dummy"
"183737",0,0,1,1,"dummy"
"183738",16,3,0,19,"dummy"
"183739",0,0,0,0,"dummy"
"183740",0,0,1,1,"dummy"
"183741",0,0,1,1,"dummy"
"183742",0,0,1,1,"dummy"
"183743",0,0,1,1,"dummy"
"183744",0,0,1,1,"dummy"
"183745",0,0,1,1,"dummy"
"183746",0,0,1,1,"dummy"
"183747",0,0,1,1,"dummy"
"183748",0,0,1,1,"dummy"
"183749",0,0,1,1,"dummy"
"183750",0,0,1,1,"dummy"
"183751",0,0,1,1,"dummy"
"183752",0,0,1,1,"dummy"
"183753",0,0,1,1,"dummy"
"183754",0,0,1,1,"dummy"
"183755",0,0,1,1,"dummy"
"183756",0,0,1,1,"dummy"
"183757",0,0,1,1,"dummy"
"183758",0,0,1,1,"dummy"
"183788",0,0,0,0,"dummy"
"183789",1,4,0,5,"dummy"
"183790",4,3,0,7,"dummy"
"183791",1,3,0,4,"dummy"
"183792",0,0,0,0,"dummy"
"183793",0,0,0,0,"dummy"
"183797",0,0,1,1,"dummy"
"183798",0,5,0,5,"dummy"
"183799",0,0,1,1,"dummy"
"183804",0,0,1,1,"dummy"
"183810",0,0,2,2,"dummy"
"183835",2,0,3,5,"dummy"
"183841",0,0,1,1,"dummy"
"183851",1,3,1,5,"dummy"
"183852",0,0,0,0,"dummy"
"183858",0,0,1,1,"dummy"
"183861",7,3,2,12,"dummy"
"183862",2,1,2,5,"dummy"
"183863",0,1,0,1,"dummy"
"183864",2,4,3,9,"dummy"
"183865",2,0,1,3,"dummy"
"183866",1,1,0,2,"dummy"
"183867",1,4,2,7,"dummy"
"183870",0,3,0,3,"dummy"
"183871",1,2,1,4,"dummy"
"183872",1,0,2,3,"dummy"
"183873",5,1,1,7,"dummy"
"183874",5,12,3,20,"dummy"
"183882",0,0,2,2,"dummy"
"183892",0,0,1,1,"dummy"
"183922",0,1,1,2,"dummy"
"183933",0,3,2,5,"dummy"
"183934",5,5,0,10,"dummy"
"183939",0,4,0,4,"dummy"
"183940",0,17,0,17,"dummy"
"183941",1,0,0,1,"dummy"
"183942",0,0,0,0,"dummy"
"183943",1,0,0,1,"dummy"
"183944",6,41,2,49,"dummy"
"183945",1,11,0,12,"dummy"
"183946",1,2,1,4,"dummy"
"184051",0,9,0,9,"dummy"
"183937",10,12,6,28,"dummy"
"184058",0,1,0,1,"dummy"
"184062",2,0,1,3,"dummy"
"184066",0,1,1,2,"dummy"
"184067",0,1,0,1,"dummy"
"184068",2,0,3,5,"dummy"
"184072",5,2,2,9,"dummy"
"184073",0,2,0,2,"dummy"
"184074",1,0,0,1,"dummy"
"184077",0,1,1,2,"dummy"
"184079",2,2,3,7,"dummy"
"184080",2,2,3,7,"dummy"
"184081",15,10,3,28,"dummy"
"184082",10,15,3,28,"dummy"
"184083",2,2,3,7,"dummy"
"184084",2,0,0,2,"dummy"
"184089",0,0,1,1,"dummy"
"184090",17,1,0,18,"dummy"
"184091",0,1,0,1,"dummy"
"184092",0,1,0,1,"dummy"
"184093",0,0,1,1,"dummy"
"184094",1,0,0,1,"dummy"
"184097",1,3,2,6,"dummy"
"184098",3,6,2,11,"dummy"
"184101",0,0,0,0,"dummy"
"184102",2,0,0,2,"dummy"
"184106",0,0,1,1,"dummy"
"184128",1,0,0,1,"dummy"
"184129",1,1,0,2,"dummy"
"184131",0,10,0,10,"dummy"
"184132",2,4,17,23,"dummy"
"184133",3,1,15,19,"dummy"
"184134",0,0,2,2,"dummy"
"184135",2,5,17,24,"dummy"
"184136",4,2,17,23,"dummy"
"184137",0,0,2,2,"dummy"
"184138",0,0,1,1,"dummy"
"184139",0,10,0,10,"dummy"
"184140",1,2,12,15,"dummy"
"184142",7,12,0,19,"dummy"
"184143",2,0,0,2,"dummy"
"184145",6,7,3,16,"dummy"
"184146",1,0,0,1,"dummy"
"184147",0,1,0,1,"dummy"
"184148",0,0,1,1,"dummy"
"184149",0,1,0,1,"dummy"
"184150",0,2,0,2,"dummy"
"184151",2,0,0,2,"dummy"
"184153",0,0,1,1,"dummy"
"184154",3,4,4,11,"dummy"
"184155",2,2,2,6,"dummy"
"184156",0,2,2,4,"dummy"
"184157",0,4,1,5,"dummy"
"184158",0,2,1,3,"dummy"
"184159",9,3,0,12,"dummy"
"184160",0,2,0,2,"dummy"
"184162",0,0,2,2,"dummy"
"184163",0,1,0,1,"dummy"
"184164",1,2,1,4,"dummy"
"184165",2,2,1,5,"dummy"
"184166",0,0,1,1,"dummy"
"184169",0,0,1,1,"dummy"
"184170",0,0,1,1,"dummy"
"184171",0,0,2,2,"dummy"
"184172",0,0,1,1,"dummy"
"184173",0,0,1,1,"dummy"
"184174",4,5,2,11,"dummy"
"184175",0,1,0,1,"dummy"
"184176",0,0,1,1,"dummy"
"184177",0,0,1,1,"dummy"
"184178",0,0,1,1,"dummy"
"184179",0,0,1,1,"dummy"
"184180",0,0,1,1,"dummy"
"184181",0,0,1,1,"dummy"
"184182",0,0,1,1,"dummy"
"184183",0,0,1,1,"dummy"
"184184",0,0,1,1,"dummy"
"184185",0,0,1,1,"dummy"
"184186",0,0,1,1,"dummy"
"184187",0,0,1,1,"dummy"
"184188",0,0,1,1,"dummy"
"184192",0,0,1,1,"dummy"
"184193",3,1,1,5,"dummy"
"184194",0,0,1,1,"dummy"
"184195",0,2,0,2,"dummy"
"184199",1,4,2,7,"dummy"
"184236",7,8,1,16,"dummy"
"184237",0,3,0,3,"dummy"
"184238",0,1,3,4,"dummy"
"184239",2,8,11,21,"dummy"
"184240",13,4,0,17,"dummy"
"184241",10,14,2,26,"dummy"
"184250",0,2,0,2,"dummy"
"184251",0,2,0,2,"dummy"
"184252",0,1,1,2,"dummy"
"184253",1,0,1,2,"dummy"
"184254",0,1,0,1,"dummy"
"184255",0,0,1,1,"dummy"
"184256",2,1,4,7,"dummy"
"184257",0,1,0,1,"dummy"
"184259",11,1,0,12,"dummy"
"184260",1,3,1,5,"dummy"
"184261",3,1,1,5,"dummy"
"184276",0,3,0,3,"dummy"
"184277",0,1,0,1,"dummy"
"184280",0,1,0,1,"dummy"
"184281",0,0,1,1,"dummy"
"184283",0,3,0,3,"dummy"
"184285",2,1,0,3,"dummy"
"184293",4,1,2,7,"dummy"
"184294",0,1,0,1,"dummy"
"184295",1,2,0,3,"dummy"
"184302",0,0,1,1,"dummy"
"184303",6,4,1,11,"dummy"
"184304",0,0,1,1,"dummy"
"184305",1,0,0,1,"dummy"
"184307",0,0,3,3,"dummy"
"184310",0,0,0,0,"dummy"
"184312",0,9,1,10,"dummy"
"184314",1,0,0,1,"dummy"
"184315",0,0,1,1,"dummy"
"184317",1,3,1,5,"dummy"
"184319",23,35,1,59,"dummy"
"184320",0,5,0,5,"dummy"
"184321",3,3,0,6,"dummy"
"184322",4,0,0,4,"dummy"
"184323",0,4,0,4,"dummy"
"184326",0,1,0,1,"dummy"
"184327",0,0,1,1,"dummy"
"184328",0,0,0,0,"dummy"
"184331",1,0,0,1,"dummy"
"184332",0,0,0,0,"dummy"
"184334",0,1,0,1,"dummy"
"184335",0,0,1,1,"dummy"
"184336",5,0,1,6,"dummy"
"184337",5,2,1,8,"dummy"
"184338",0,1,0,1,"dummy"
"184339",0,3,0,3,"dummy"
"184346",0,2,0,2,"dummy"
"184347",0,0,0,0,"dummy"
"184348",0,0,3,3,"dummy"
"184356",2,2,4,8,"dummy"
"184361",0,0,0,0,"dummy"
"184362",2,1,2,5,"dummy"
"184363",0,0,0,0,"dummy"
"184371",0,1,0,1,"dummy"
"184374",0,1,0,1,"dummy"
"184379",0,2,1,3,"dummy"
"184381",18,1,1,20,"dummy"
"184383",0,0,0,0,"dummy"
"184384",0,0,1,1,"dummy"
"184385",0,0,0,0,"dummy"
"184387",0,3,0,3,"dummy"
"184388",1,2,0,3,"dummy"
"184389",0,1,0,1,"dummy"
"184390",0,0,1,1,"dummy"
"184391",0,0,1,1,"dummy"
"184392",0,1,0,1,"dummy"
"184417",0,2,0,2,"dummy"
"184420",8,14,4,26,"dummy"
"184421",0,0,2,2,"dummy"
"184422",0,1,2,3,"dummy"
"184423",1,12,0,13,"dummy"
"184424",0,0,1,1,"dummy"
"184425",0,1,0,1,"dummy"
"184426",0,1,0,1,"dummy"
"184427",1,1,0,2,"dummy"
"184428",0,2,0,2,"dummy"
"184429",3,0,0,3,"dummy"
"184456",4,5,4,13,"dummy"
"184457",0,2,0,2,"dummy"
"184458",0,0,0,0,"dummy"
"184459",1,1,0,2,"dummy"
"184461",0,4,0,4,"dummy"
"184462",2,1,0,3,"dummy"
"184465",0,0,0,0,"dummy"
"184466",0,0,1,1,"dummy"
"184467",0,0,0,0,"dummy"
"184468",0,0,1,1,"dummy"
"184469",0,0,3,3,"dummy"
"184470",0,1,0,1,"dummy"
"184471",0,1,0,1,"dummy"
"184474",1,1,1,3,"dummy"
"184475",0,0,0,0,"dummy"
"184482",0,1,0,1,"dummy"
"184483",1,7,0,8,"dummy"
"184484",2,1,0,3,"dummy"
"184485",0,0,1,1,"dummy"
"184486",7,3,0,10,"dummy"
"184487",0,0,1,1,"dummy"
"184488",0,0,1,1,"dummy"
"184489",4,4,0,8,"dummy"
"184491",2,5,2,9,"dummy"
"184494",0,1,0,1,"dummy"
"184495",0,1,0,1,"dummy"
"184496",0,3,0,3,"dummy"
"184497",0,9,0,9,"dummy"
"184498",0,10,0,10,"dummy"
"184499",21,5,1,27,"dummy"
"184500",4,0,0,4,"dummy"
"184501",0,2,0,2,"dummy"
"184502",0,2,0,2,"dummy"
"184503",0,1,0,1,"dummy"
"184504",0,1,0,1,"dummy"
"184505",0,2,0,2,"dummy"
"184506",1,6,0,7,"dummy"
"184507",0,1,0,1,"dummy"
"184508",0,1,0,1,"dummy"
"184510",0,3,1,4,"dummy"
"184511",0,0,1,1,"dummy"
"184513",0,0,1,1,"dummy"
"184514",0,0,1,1,"dummy"
"184515",0,0,1,1,"dummy"
"184516",0,0,1,1,"dummy"
"184517",0,0,1,1,"dummy"
"184518",0,0,1,1,"dummy"
"184519",0,0,1,1,"dummy"
"184520",0,0,1,1,"dummy"
"184521",0,0,1,1,"dummy"
"184522",0,0,1,1,"dummy"
"184523",0,0,1,1,"dummy"
"184525",0,1,2,3,"dummy"
"184526",3,6,1,10,"dummy"
"184535",0,0,0,0,"dummy"
"184536",0,0,5,5,"dummy"
"184540",2,2,0,4,"dummy"
"184541",2,1,0,3,"dummy"
"184542",2,3,2,7,"dummy"
"184543",0,0,0,0,"dummy"
"184545",0,0,2,2,"dummy"
"184549",0,1,0,1,"dummy"
"184550",0,12,0,12,"dummy"
"184551",1,2,0,3,"dummy"
"184552",0,0,0,0,"dummy"
"184553",0,1,0,1,"dummy"
"184554",1,0,0,1,"dummy"
"184555",0,0,1,1,"dummy"
"184556",0,0,1,1,"dummy"
"184557",0,0,1,1,"dummy"
"184558",0,2,0,2,"dummy"
"184559",0,2,0,2,"dummy"
"184560",0,0,1,1,"dummy"
"184561",0,0,2,2,"dummy"
"184562",0,0,1,1,"dummy"
"184563",0,0,1,1,"dummy"
"184564",14,0,0,14,"dummy"
"184565",2,0,0,2,"dummy"
"184566",0,2,0,2,"dummy"
"184567",0,0,2,2,"dummy"
"184568",0,1,0,1,"dummy"
"184569",1,0,0,1,"dummy"
"184570",0,0,1,1,"dummy"
"184571",0,1,2,3,"dummy"
"184574",0,0,0,0,"dummy"
"184575",1,4,1,6,"dummy"
"184576",8,5,3,16,"dummy"
"184577",2,5,2,9,"dummy"
"184578",0,1,0,1,"dummy"
"184579",3,9,0,12,"dummy"
"184580",1,0,0,1,"dummy"
"184614",2,0,3,5,"dummy"
"184615",5,6,4,15,"dummy"
"184631",1,6,1,8,"dummy"
"184632",0,1,0,1,"dummy"
"184633",4,2,0,6,"dummy"
"184636",0,0,1,1,"dummy"
"184641",1,1,0,2,"dummy"
"184654",0,12,0,12,"dummy"
"184655",0,7,0,7,"dummy"
"184656",4,6,5,15,"dummy"
"184657",2,11,0,13,"dummy"
"184658",0,0,0,0,"dummy"
"184659",0,0,1,1,"dummy"
"184660",0,1,1,2,"dummy"
"184661",0,2,0,2,"dummy"
"184662",0,0,0,0,"dummy"
"184663",1,2,1,4,"dummy"
"184664",4,11,8,23,"dummy"
"184665",2,4,0,6,"dummy"
"184666",5,4,0,9,"dummy"
"184667",0,2,0,2,"dummy"
"184668",0,0,1,1,"dummy"
"184669",5,22,1,28,"dummy"
"184670",0,1,0,1,"dummy"
"184671",0,3,0,3,"dummy"
"184672",4,1,1,6,"dummy"
"184673",0,4,0,4,"dummy"
"184674",0,0,1,1,"dummy"
"184675",0,2,0,2,"dummy"
"184676",0,1,0,1,"dummy"
"184677",0,1,0,1,"dummy"
"184678",0,0,0,0,"dummy"
"184691",24,3,0,27,"dummy"
"184692",0,0,0,0,"dummy"
"184693",29,20,4,53,"dummy"
"184694",0,1,0,1,"dummy"
"184695",0,4,0,4,"dummy"
"184696",6,6,0,12,"dummy"
"184697",0,4,0,4,"dummy"
"184698",0,1,0,1,"dummy"
"184699",0,0,1,1,"dummy"
"184700",4,0,1,5,"dummy"
"184701",0,1,0,1,"dummy"
"184702",0,4,0,4,"dummy"
"184703",0,2,0,2,"dummy"
"184704",5,0,0,5,"dummy"
"184705",0,1,0,1,"dummy"
"184706",1,0,0,1,"dummy"
"184707",1,0,0,1,"dummy"
"184711",2,2,0,4,"dummy"
"184712",0,1,0,1,"dummy"
"184713",1,0,0,1,"dummy"
"184714",0,1,0,1,"dummy"
"184715",0,0,1,1,"dummy"
"184716",0,2,0,2,"dummy"
"184717",0,0,1,1,"dummy"
"184718",0,1,0,1,"dummy"
"184719",0,0,1,1,"dummy"
"184798",1,1,0,2,"dummy"
"184799",1,1,0,2,"dummy"
"184800",0,1,0,1,"dummy"
"184801",0,1,1,2,"dummy"
"184802",1,0,2,3,"dummy"
"184806",0,1,0,1,"dummy"
"184823",0,2,0,2,"dummy"
"184824",0,0,1,1,"dummy"
"184825",0,0,1,1,"dummy"
"184826",3,2,2,7,"dummy"
"184827",0,0,2,2,"dummy"
"184828",1,0,0,1,"dummy"
"184833",2,5,2,9,"dummy"
"184834",1,0,0,1,"dummy"
"184586",0,1,1,2,"dummy"
"184587",0,1,0,1,"dummy"
"184590",0,0,2,2,"dummy"
"184591",0,0,1,1,"dummy"
"184592",0,0,1,1,"dummy"
"184593",0,0,1,1,"dummy"
"184594",0,4,1,5,"dummy"
"184595",0,1,0,1,"dummy"
"184596",0,2,0,2,"dummy"
"184609",0,1,0,1,"dummy"
"184610",0,0,1,1,"dummy"
"184611",1,4,1,6,"dummy"
"184612",0,0,1,1,"dummy"
"184617",0,0,1,1,"dummy"
"184618",0,1,1,2,"dummy"
"184619",0,0,2,2,"dummy"
"184620",1,1,1,3,"dummy"
"184621",3,1,0,4,"dummy"
"184622",6,0,4,10,"dummy"
"184623",1,3,2,6,"dummy"
"184624",3,0,1,4,"dummy"
"184625",0,3,1,4,"dummy"
"184626",0,1,0,1,"dummy"
"184627",0,0,1,1,"dummy"
"184628",0,0,1,1,"dummy"
"184629",0,0,1,1,"dummy"
"184684",0,0,0,0,"dummy"
"184687",5,4,1,10,"dummy"
"184688",3,5,1,9,"dummy"
"184689",5,3,1,9,"dummy"
"184709",8,8,0,16,"dummy"
"184795",1,0,0,1,"dummy"
"184796",0,0,1,1,"dummy"
"184804",10,0,1,11,"dummy"
"184810",1,26,1,28,"dummy"
"184811",0,1,0,1,"dummy"
"184812",0,0,1,1,"dummy"
"184813",0,10,1,11,"dummy"
"184814",11,11,0,22,"dummy"
"184815",3,6,0,9,"dummy"
"184816",6,4,0,10,"dummy"
"184817",6,5,0,11,"dummy"
"184818",0,1,0,1,"dummy"
"184819",3,7,1,11,"dummy"
"184830",0,16,0,16,"dummy"
"184831",2,1,0,3,"dummy"
"184838",0,4,0,4,"dummy"
"184839",0,2,0,2,"dummy"
"184840",0,6,1,7,"dummy"
"184841",0,4,0,4,"dummy"
"184842",10,1,1,12,"dummy"
"184843",3,0,2,5,"dummy"
"184844",0,9,1,10,"dummy"
"184845",4,0,0,4,"dummy"
"184846",5,2,1,8,"dummy"
"184859",5,21,3,29,"dummy"
"184860",0,7,2,9,"dummy"
"184861",0,2,0,2,"dummy"
"184862",0,1,0,1,"dummy"
"184863",1,3,0,4,"dummy"
"184864",7,13,0,20,"dummy"
"184865",0,0,1,1,"dummy"
"184866",10,13,1,24,"dummy"
"184881",0,1,0,1,"dummy"
"184882",0,1,0,1,"dummy"
"184911",0,0,1,1,"dummy"
"184915",0,1,0,1,"dummy"
"184916",0,0,1,1,"dummy"
"184917",0,0,1,1,"dummy"
"184918",0,2,0,2,"dummy"
"184919",0,1,0,1,"dummy"
"184920",0,2,1,3,"dummy"
"184921",0,1,0,1,"dummy"
"184922",0,2,1,3,"dummy"
"184923",6,4,5,15,"dummy"
"184924",0,2,3,5,"dummy"
"184925",0,1,0,1,"dummy"
"184835",5,4,0,9,"dummy"
"184836",0,2,0,2,"dummy"
"184848",3,5,1,9,"dummy"
"184849",0,0,1,1,"dummy"
"184850",0,0,1,1,"dummy"
"184851",1,1,1,3,"dummy"
"184852",0,1,2,3,"dummy"
"184853",1,0,2,3,"dummy"
"184854",0,0,1,1,"dummy"
"184855",0,1,4,5,"dummy"
"184870",1,1,0,2,"dummy"
"184871",1,1,0,2,"dummy"
"184872",14,11,3,28,"dummy"
"184873",0,0,1,1,"dummy"
"184874",0,0,1,1,"dummy"
"184875",1,0,1,2,"dummy"
"184876",2,2,3,7,"dummy"
"184877",0,2,4,6,"dummy"
"184878",9,0,1,10,"dummy"
"184879",0,0,1,1,"dummy"
"184888",0,3,0,3,"dummy"
"184889",1,1,0,2,"dummy"
"184890",0,3,0,3,"dummy"
"184891",1,0,0,1,"dummy"
"184892",1,1,1,3,"dummy"
"184893",0,0,1,1,"dummy"
"184896",2,12,1,15,"dummy"
"184897",2,2,0,4,"dummy"
"184898",3,6,1,10,"dummy"
"184899",1,3,1,5,"dummy"
"184900",0,1,0,1,"dummy"
"184901",0,1,0,1,"dummy"
"184902",0,1,1,2,"dummy"
"184903",2,0,3,5,"dummy"
"184904",0,0,1,1,"dummy"
"184905",0,0,1,1,"dummy"
"184906",0,0,1,1,"dummy"
"184907",0,0,1,1,"dummy"
"184908",0,0,1,1,"dummy"
"184909",0,2,0,2,"dummy"
"184913",2,4,1,7,"dummy"
"184932",3,5,1,9,"dummy"
"184933",0,1,0,1,"dummy"
"184934",0,0,1,1,"dummy"
"184935",0,1,0,1,"dummy"
"184936",0,1,0,1,"dummy"
"184937",0,1,0,1,"dummy"
"184938",0,1,0,1,"dummy"
"184939",0,0,1,1,"dummy"
"184940",0,1,0,1,"dummy"
"184941",2,0,0,2,"dummy"
"184942",1,0,0,1,"dummy"
"184943",0,3,0,3,"dummy"
"184964",0,5,0,5,"dummy"
"184965",5,0,0,5,"dummy"
"184979",1,2,0,3,"dummy"
"184982",5,2,0,7,"dummy"
"184983",0,1,1,2,"dummy"
"184984",3,40,0,43,"dummy"
"184985",0,1,0,1,"dummy"
"184986",0,2,0,2,"dummy"
"184987",2,2,0,4,"dummy"
"184988",34,10,1,45,"dummy"
"184989",10,4,2,16,"dummy"
"184990",0,6,0,6,"dummy"
"184991",0,2,1,3,"dummy"
"184992",4,2,2,8,"dummy"
"184993",0,1,1,2,"dummy"
"184999",4,8,1,13,"dummy"
"185000",3,0,0,3,"dummy"
"185006",0,1,0,1,"dummy"
"185007",0,1,0,1,"dummy"
"185014",0,1,0,1,"dummy"
"185015",5,6,1,12,"dummy"
"185016",2,1,0,3,"dummy"
"185017",0,0,0,0,"dummy"
"185035",0,0,0,0,"dummy"
"185038",1,0,0,1,"dummy"
"185054",1,3,0,4,"dummy"
"185055",0,0,0,0,"dummy"
"184926",1,1,1,3,"dummy"
"184927",1,0,0,1,"dummy"
"184928",0,2,0,2,"dummy"
"184929",0,1,1,2,"dummy"
"184930",0,0,2,2,"dummy"
"184945",0,5,0,5,"dummy"
"184946",0,1,0,1,"dummy"
"184947",2,2,0,4,"dummy"
"184950",0,0,3,3,"dummy"
"184951",0,0,2,2,"dummy"
"184952",0,0,2,2,"dummy"
"184953",0,0,2,2,"dummy"
"184956",0,4,0,4,"dummy"
"184957",5,8,1,14,"dummy"
"184958",2,3,0,5,"dummy"
"184959",6,5,0,11,"dummy"
"184960",0,0,0,0,"dummy"
"184997",1,2,1,4,"dummy"
"185004",0,0,1,1,"dummy"
"185009",8,3,2,13,"dummy"
"185012",4,5,0,9,"dummy"
"185019",0,1,0,1,"dummy"
"185020",0,0,1,1,"dummy"
"185021",0,1,0,1,"dummy"
"185022",0,0,1,1,"dummy"
"185023",0,0,1,1,"dummy"
"185024",0,2,0,2,"dummy"
"185025",0,0,1,1,"dummy"
"185026",0,1,0,1,"dummy"
"185027",0,0,1,1,"dummy"
"185028",0,0,1,1,"dummy"
"185029",0,1,0,1,"dummy"
"185030",1,0,1,2,"dummy"
"185033",0,3,0,3,"dummy"
"185040",0,1,0,1,"dummy"
"185041",5,42,2,49,"dummy"
"185042",1,0,0,1,"dummy"
"185043",0,0,3,3,"dummy"
"185044",2,2,0,4,"dummy"
"185045",4,0,0,4,"dummy"
"185046",0,5,0,5,"dummy"
"185047",0,0,1,1,"dummy"
"185048",3,6,2,11,"dummy"
"185049",0,0,1,1,"dummy"
"185050",3,0,0,3,"dummy"
"185061",0,1,0,1,"dummy"
"185062",1,1,0,2,"dummy"
"185063",0,1,0,1,"dummy"
"185064",0,0,4,4,"dummy"
"185065",0,1,0,1,"dummy"
"185066",0,1,0,1,"dummy"
"185067",0,2,0,2,"dummy"
"185068",0,7,0,7,"dummy"
"185069",0,1,0,1,"dummy"
"185070",0,6,0,6,"dummy"
"185071",0,1,0,1,"dummy"
"185079",0,3,0,3,"dummy"
"185080",3,7,0,10,"dummy"
"185081",16,0,0,16,"dummy"
"185082",5,5,0,10,"dummy"
"185083",3,0,0,3,"dummy"
"185084",0,0,0,0,"dummy"
"185085",0,2,0,2,"dummy"
"185086",0,0,1,1,"dummy"
"185087",0,3,0,3,"dummy"
"185088",0,4,0,4,"dummy"
"185089",1,0,0,1,"dummy"
"185090",0,1,0,1,"dummy"
"185091",4,0,0,4,"dummy"
"185092",0,2,0,2,"dummy"
"185095",2,2,0,4,"dummy"
"185100",0,0,1,1,"dummy"
"185101",1,2,0,3,"dummy"
"185102",2,1,0,3,"dummy"
"185103",1,2,0,3,"dummy"
"185107",0,6,0,6,"dummy"
"185108",0,28,0,28,"dummy"
"185109",0,0,1,1,"dummy"
"185116",0,0,1,1,"dummy"
"185117",0,0,1,1,"dummy"
"185118",0,1,0,1,"dummy"
"185056",0,0,1,1,"dummy"
"185057",0,2,1,3,"dummy"
"185075",0,0,1,1,"dummy"
"185097",0,3,7,10,"dummy"
"185098",1,5,1,7,"dummy"
"185111",0,0,1,1,"dummy"
"185112",0,2,1,3,"dummy"
"185113",0,0,1,1,"dummy"
"185114",0,2,1,3,"dummy"
"185128",0,1,0,1,"dummy"
"185129",0,0,1,1,"dummy"
"185130",1,0,0,1,"dummy"
"185131",0,4,0,4,"dummy"
"185132",0,1,0,1,"dummy"
"185133",0,2,0,2,"dummy"
"185134",0,0,0,0,"dummy"
"185135",0,1,0,1,"dummy"
"185138",0,3,0,3,"dummy"
"185139",0,1,0,1,"dummy"
"185157",2,0,1,3,"dummy"
"185191",0,5,2,7,"dummy"
"185198",0,0,1,1,"dummy"
"185199",0,1,1,2,"dummy"
"185200",0,0,1,1,"dummy"
"185201",0,0,1,1,"dummy"
"185202",0,0,1,1,"dummy"
"185206",0,0,3,3,"dummy"
"185207",0,0,1,1,"dummy"
"185208",0,0,0,0,"dummy"
"185209",0,11,0,11,"dummy"
"185210",12,14,0,26,"dummy"
"185211",0,0,0,0,"dummy"
"185212",0,0,1,1,"dummy"
"185213",13,1,0,14,"dummy"
"185214",0,0,1,1,"dummy"
"185215",0,0,1,1,"dummy"
"185216",0,0,1,1,"dummy"
"185217",0,0,0,0,"dummy"
"185218",0,0,0,0,"dummy"
"185219",0,0,0,0,"dummy"
"185220",0,0,1,1,"dummy"
"185221",0,0,1,1,"dummy"
"185222",0,0,0,0,"dummy"
"185223",0,0,0,0,"dummy"
"185224",0,0,0,0,"dummy"
"185225",0,0,0,0,"dummy"
"185226",0,0,0,0,"dummy"
"185227",0,0,0,0,"dummy"
"185228",2,0,0,2,"dummy"
"185229",0,2,0,2,"dummy"
"185230",0,0,0,0,"dummy"
"185231",8,8,1,17,"dummy"
"185232",0,0,1,1,"dummy"
"185233",0,1,0,1,"dummy"
"185234",0,1,0,1,"dummy"
"185235",0,0,1,1,"dummy"
"185236",0,0,1,1,"dummy"
"185242",0,1,0,1,"dummy"
"185297",3,1,0,4,"dummy"
"185298",2,3,0,5,"dummy"
"185299",0,0,2,2,"dummy"
"185119",0,0,0,0,"dummy"
"185120",0,0,1,1,"dummy"
"185121",0,4,0,4,"dummy"
"185122",0,1,0,1,"dummy"
"185123",0,3,1,4,"dummy"
"185124",0,0,0,0,"dummy"
"185143",0,0,0,0,"dummy"
"185144",2,0,0,2,"dummy"
"185145",0,0,0,0,"dummy"
"185146",0,0,0,0,"dummy"
"185147",0,0,0,0,"dummy"
"185148",0,0,0,0,"dummy"
"185149",0,0,0,0,"dummy"
"185153",0,1,0,1,"dummy"
"185163",6,4,3,13,"dummy"
"185166",1,1,0,2,"dummy"
"185185",1,0,3,4,"dummy"
"185188",2,1,0,3,"dummy"
"185189",0,1,1,2,"dummy"
"185193",0,0,2,2,"dummy"
"185194",0,0,3,3,"dummy"
"185195",0,2,2,4,"dummy"
"185196",0,0,2,2,"dummy"
"185204",0,3,0,3,"dummy"
"185303",0,4,0,4,"dummy"
"185306",0,0,1,1,"dummy"
"185307",2,6,2,10,"dummy"
"185308",0,0,1,1,"dummy"
"185376",0,2,0,2,"dummy"
"185377",0,1,0,1,"dummy"
"185378",0,1,0,1,"dummy"
"185379",4,5,0,9,"dummy"
"185382",0,0,0,0,"dummy"
"185383",0,0,0,0,"dummy"
"185387",0,2,0,2,"dummy"
"185401",0,0,2,2,"dummy"
"185402",1,2,0,3,"dummy"
"185403",2,4,0,6,"dummy"
"185417",0,1,1,2,"dummy"
"185418",0,0,0,0,"dummy"
"185419",0,0,0,0,"dummy"
"185420",0,2,0,2,"dummy"
"185421",1,0,3,4,"dummy"
"185432",0,1,0,1,"dummy"
"185433",0,0,2,2,"dummy"
"185442",0,0,1,1,"dummy"
"185457",20,2,2,24,"dummy"
"185458",0,1,0,1,"dummy"
"185459",0,4,0,4,"dummy"
"185460",0,4,0,4,"dummy"
"185300",0,2,3,5,"dummy"
"185301",0,2,0,2,"dummy"
"185359",0,1,0,1,"dummy"
"185364",3,1,2,6,"dummy"
"185365",3,7,0,10,"dummy"
"185366",6,6,0,12,"dummy"
"185371",2,2,1,5,"dummy"
"185372",1,2,1,4,"dummy"
"185391",0,1,1,2,"dummy"
"185392",0,2,0,2,"dummy"
"185407",2,1,4,7,"dummy"
"185408",0,1,0,1,"dummy"
"185411",0,0,0,0,"dummy"
"185412",0,4,0,4,"dummy"
"185413",0,4,0,4,"dummy"
"185414",4,4,0,8,"dummy"
"185415",3,17,1,21,"dummy"
"185423",0,0,1,1,"dummy"
"185424",3,2,0,5,"dummy"
"185425",0,0,1,1,"dummy"
"185426",0,0,1,1,"dummy"
"185427",0,0,1,1,"dummy"
"185428",0,0,1,1,"dummy"
"185429",0,0,0,0,"dummy"
"185430",0,0,0,0,"dummy"
"185437",0,0,1,1,"dummy"
"185438",0,1,0,1,"dummy"
"185439",0,0,1,1,"dummy"
"185440",0,2,0,2,"dummy"
"185444",0,1,0,1,"dummy"
"185445",0,0,0,0,"dummy"
"185446",9,0,0,9,"dummy"
"185447",3,2,0,5,"dummy"
"185448",1,2,0,3,"dummy"
"185449",4,4,1,9,"dummy"
"185450",1,9,0,10,"dummy"
"185451",0,2,0,2,"dummy"
"185452",0,0,1,1,"dummy"
"185453",1,1,0,2,"dummy"
"185454",0,4,0,4,"dummy"
"185455",0,1,0,1,"dummy"
"185488",0,0,0,0,"dummy"
"185489",0,4,0,4,"dummy"
"185473",1,0,0,1,"dummy"
"185475",0,0,1,1,"dummy"
"185477",0,7,1,8,"dummy"
"185481",1,0,0,1,"dummy"
"185483",0,0,3,3,"dummy"
"185484",0,0,1,1,"dummy"
"185490",0,4,0,4,"dummy"
"185491",4,4,0,8,"dummy"
"185492",3,17,1,21,"dummy"
"185503",0,1,0,1,"dummy"
"185513",0,1,0,1,"dummy"
"185514",2,0,2,4,"dummy"
"185515",0,2,0,2,"dummy"
"185516",0,3,0,3,"dummy"
"185517",1,1,0,2,"dummy"
"185518",0,0,0,0,"dummy"
"185519",0,0,2,2,"dummy"
"185521",0,0,0,0,"dummy"
"185522",5,0,2,7,"dummy"
"185523",0,0,0,0,"dummy"
"185527",0,4,0,4,"dummy"
"185529",0,4,0,4,"dummy"
"185530",13,5,0,18,"dummy"
"185531",4,0,2,6,"dummy"
"185533",0,0,1,1,"dummy"
"185535",4,23,6,33,"dummy"
"185537",0,1,0,1,"dummy"
"185538",0,0,1,1,"dummy"
"185539",0,0,1,1,"dummy"
"185540",0,0,1,1,"dummy"
"185541",0,0,1,1,"dummy"
"185542",0,0,1,1,"dummy"
"185543",0,0,1,1,"dummy"
"185544",0,0,1,1,"dummy"
"185545",0,0,1,1,"dummy"
"185546",0,0,1,1,"dummy"
"185549",2,4,0,6,"dummy"
"185550",0,2,0,2,"dummy"
"185551",0,2,0,2,"dummy"
"185552",10,2,0,12,"dummy"
"185553",0,2,0,2,"dummy"
"185563",3,4,0,7,"dummy"
"185564",0,2,0,2,"dummy"
"185570",0,1,0,1,"dummy"
"185573",1,9,1,11,"dummy"
"185574",0,3,0,3,"dummy"
"185586",0,0,2,2,"dummy"
"185587",0,0,1,1,"dummy"
"185588",2,2,2,6,"dummy"
"185589",0,0,0,0,"dummy"
"185590",2,0,0,2,"dummy"
"185593",6,0,0,6,"dummy"
"185594",2,5,2,9,"dummy"
"185598",1,4,0,5,"dummy"
"185599",0,0,0,0,"dummy"
"185600",0,0,0,0,"dummy"
"185601",0,0,0,0,"dummy"
"185602",1,0,0,1,"dummy"
"185603",0,0,1,1,"dummy"
"185604",4,1,0,5,"dummy"
"185605",2,2,0,4,"dummy"
"185606",7,16,3,26,"dummy"
"185607",16,9,3,28,"dummy"
"185608",4,0,0,4,"dummy"
"185609",0,0,2,2,"dummy"
"185610",0,3,0,3,"dummy"
"185611",0,2,0,2,"dummy"
"185612",3,2,0,5,"dummy"
"185613",2,2,0,4,"dummy"
"185614",1,4,0,5,"dummy"
"185621",1,27,1,29,"dummy"
"185622",0,2,0,2,"dummy"
"185623",0,5,0,5,"dummy"
"185625",4,4,2,10,"dummy"
"185626",0,0,1,1,"dummy"
"185628",0,5,0,5,"dummy"
"185629",0,2,0,2,"dummy"
"185630",0,1,1,2,"dummy"
"185631",0,1,0,1,"dummy"
"185632",0,5,0,5,"dummy"
"185633",0,4,1,5,"dummy"
"185634",0,6,1,7,"dummy"
"185635",0,2,0,2,"dummy"
"185636",0,0,1,1,"dummy"
"185637",11,2,0,13,"dummy"
"185638",2,2,0,4,"dummy"
"185639",3,2,0,5,"dummy"
"185640",2,2,0,4,"dummy"
"185641",0,0,0,0,"dummy"
"185642",15,0,2,17,"dummy"
"185643",2,2,0,4,"dummy"
"185644",0,1,0,1,"dummy"
"185646",2,3,0,5,"dummy"
"185648",0,3,0,3,"dummy"
"185649",1,0,1,2,"dummy"
"185652",2,1,1,4,"dummy"
"185653",0,2,0,2,"dummy"
"185659",0,0,0,0,"dummy"
"185662",3,3,1,7,"dummy"
"185664",0,0,1,1,"dummy"
"185665",0,1,0,1,"dummy"
"185666",1,0,0,1,"dummy"
"185667",0,1,0,1,"dummy"
"185672",0,0,2,2,"dummy"
"185680",0,5,0,5,"dummy"
"185681",20,7,5,32,"dummy"
"185682",13,8,3,24,"dummy"
"185684",1,0,0,1,"dummy"
"185686",0,6,0,6,"dummy"
"185687",5,2,4,11,"dummy"
"185688",0,0,0,0,"dummy"
"185689",0,1,0,1,"dummy"
"185690",4,0,3,7,"dummy"
"185691",2,0,0,2,"dummy"
"185692",0,0,1,1,"dummy"
"185693",2,3,1,6,"dummy"
"185697",0,1,0,1,"dummy"
"185698",5,1,0,6,"dummy"
"185699",2,4,4,10,"dummy"
"185700",3,4,5,12,"dummy"
"185701",2,0,3,5,"dummy"
"185702",0,0,2,2,"dummy"
"185703",0,2,0,2,"dummy"
"185704",0,0,1,1,"dummy"
"185706",0,2,0,2,"dummy"
"185707",0,1,0,1,"dummy"
"185710",6,0,0,6,"dummy"
"185711",2,5,2,9,"dummy"
"185713",0,0,1,1,"dummy"
"185715",2,0,3,5,"dummy"
"185716",1,0,0,1,"dummy"
"185717",0,1,0,1,"dummy"
"185718",0,1,1,2,"dummy"
"185738",0,0,0,0,"dummy"
"185739",0,0,0,0,"dummy"
"185740",0,0,2,2,"dummy"
"185744",0,3,0,3,"dummy"
"185745",2,2,0,4,"dummy"
"185746",0,1,0,1,"dummy"
"185748",1,0,0,1,"dummy"
"185749",0,1,0,1,"dummy"
"185750",1,0,1,2,"dummy"
"185751",0,0,1,1,"dummy"
"185752",0,1,0,1,"dummy"
"185753",0,2,1,3,"dummy"
"185754",2,2,1,5,"dummy"
"185755",2,2,0,4,"dummy"
"185756",1,0,1,2,"dummy"
"185757",0,1,0,1,"dummy"
"185758",1,0,0,1,"dummy"
"185759",0,2,1,3,"dummy"
"185760",2,0,1,3,"dummy"
"185763",1,2,0,3,"dummy"
"185764",0,1,0,1,"dummy"
"185765",4,0,2,6,"dummy"
"185766",0,3,1,4,"dummy"
"185768",6,7,2,15,"dummy"
"185769",15,0,0,15,"dummy"
"185770",0,3,1,4,"dummy"
"185771",1,7,1,9,"dummy"
"185772",2,3,0,5,"dummy"
"185773",3,3,0,6,"dummy"
"185774",8,0,0,8,"dummy"
"185775",0,0,1,1,"dummy"
"185778",0,2,0,2,"dummy"
"185781",2,0,0,2,"dummy"
"185782",1,0,0,1,"dummy"
"185783",0,4,0,4,"dummy"
"185822",0,5,0,5,"dummy"
"185823",0,0,1,1,"dummy"
"185842",3,0,3,6,"dummy"
"185843",0,0,5,5,"dummy"
"185844",0,1,0,1,"dummy"
"185845",4,4,0,8,"dummy"
"185846",0,1,0,1,"dummy"
"185847",0,1,0,1,"dummy"
"185848",0,1,0,1,"dummy"
"185849",3,0,0,3,"dummy"
"185857",0,2,0,2,"dummy"
"185858",5,5,0,10,"dummy"
"185875",0,0,1,1,"dummy"
"185881",0,1,0,1,"dummy"
"185882",4,5,0,9,"dummy"
"185887",0,1,0,1,"dummy"
"185888",0,0,1,1,"dummy"
"185889",1,4,2,7,"dummy"
"185890",0,0,1,1,"dummy"
"185891",3,9,0,12,"dummy"
"185892",0,0,2,2,"dummy"
"185893",0,0,1,1,"dummy"
"185894",2,10,3,15,"dummy"
"185924",0,0,1,1,"dummy"
"185927",0,1,0,1,"dummy"
"185930",3,0,2,5,"dummy"
"185931",1,0,0,1,"dummy"
"185932",0,2,0,2,"dummy"
"185942",0,3,1,4,"dummy"
"185943",3,0,1,4,"dummy"
"185944",0,3,1,4,"dummy"
"185945",1,3,0,4,"dummy"
"185955",0,0,1,1,"dummy"
"185956",0,0,1,1,"dummy"
"185968",0,1,0,1,"dummy"
"185992",0,2,1,3,"dummy"
"185996",1,1,1,3,"dummy"
"185997",0,3,1,4,"dummy"
"185998",0,3,0,3,"dummy"
"185999",0,0,1,1,"dummy"
"186000",0,0,0,0,"dummy"
"186001",0,10,0,10,"dummy"
"186036",9,7,0,16,"dummy"
"186037",1,4,2,7,"dummy"
"186048",0,1,0,1,"dummy"
"186052",0,0,2,2,"dummy"
"186072",1,0,0,1,"dummy"
"186073",1,0,0,1,"dummy"
"186074",0,1,0,1,"dummy"
"186075",1,2,5,8,"dummy"
"186081",0,0,1,1,"dummy"
"186087",2,4,0,6,"dummy"
"186088",0,2,0,2,"dummy"
"186089",0,2,0,2,"dummy"
"186090",10,2,0,12,"dummy"
"186091",0,2,0,2,"dummy"
"186092",0,0,0,0,"dummy"
"186093",0,0,3,3,"dummy"
"186094",0,5,0,5,"dummy"
"185785",0,4,0,4,"dummy"
"185786",0,0,1,1,"dummy"
"185787",0,4,0,4,"dummy"
"185788",2,5,1,8,"dummy"
"185789",1,0,0,1,"dummy"
"185790",0,0,3,3,"dummy"
"185791",0,1,0,1,"dummy"
"185792",0,0,3,3,"dummy"
"185793",0,0,2,2,"dummy"
"185794",0,0,4,4,"dummy"
"185795",1,1,4,6,"dummy"
"185796",1,0,3,4,"dummy"
"185797",0,0,2,2,"dummy"
"185798",0,1,0,1,"dummy"
"185801",1,1,0,2,"dummy"
"185802",0,0,1,1,"dummy"
"185803",8,10,3,21,"dummy"
"185804",4,6,0,10,"dummy"
"185805",1,1,2,4,"dummy"
"185806",0,1,0,1,"dummy"
"185807",0,1,0,1,"dummy"
"185808",7,4,2,13,"dummy"
"185811",2,3,0,5,"dummy"
"185812",0,1,0,1,"dummy"
"185813",2,1,1,4,"dummy"
"185814",0,3,1,4,"dummy"
"185815",3,0,2,5,"dummy"
"185820",0,0,1,1,"dummy"
"185832",0,2,0,2,"dummy"
"185835",0,0,1,1,"dummy"
"185836",0,2,0,2,"dummy"
"185837",0,1,0,1,"dummy"
"185838",4,5,1,10,"dummy"
"185839",0,2,0,2,"dummy"
"185840",2,19,2,23,"dummy"
"185851",0,0,0,0,"dummy"
"185854",0,0,1,1,"dummy"
"185855",0,1,0,1,"dummy"
"185862",0,3,0,3,"dummy"
"185863",0,7,2,9,"dummy"
"185864",0,1,2,3,"dummy"
"185865",0,0,3,3,"dummy"
"185866",0,0,1,1,"dummy"
"185867",9,0,0,9,"dummy"
"185868",0,7,1,8,"dummy"
"185869",6,5,1,12,"dummy"
"185870",0,1,0,1,"dummy"
"185871",1,2,0,3,"dummy"
"185872",0,1,0,1,"dummy"
"185873",3,2,1,6,"dummy"
"185877",0,0,6,6,"dummy"
"185878",0,0,1,1,"dummy"
"185879",0,1,0,1,"dummy"
"185884",0,3,0,3,"dummy"
"185885",1,2,1,4,"dummy"
"185896",3,8,1,12,"dummy"
"185936",1,5,0,6,"dummy"
"185937",1,1,2,4,"dummy"
"185938",0,0,1,1,"dummy"
"185939",1,0,0,1,"dummy"
"185940",0,0,1,1,"dummy"
"185947",0,3,0,3,"dummy"
"185948",7,1,0,8,"dummy"
"185949",0,11,3,14,"dummy"
"185950",8,0,1,9,"dummy"
"185951",3,0,3,6,"dummy"
"185952",0,6,0,6,"dummy"
"185953",0,7,0,7,"dummy"
"185958",0,0,0,0,"dummy"
"185959",0,1,0,1,"dummy"
"185960",0,0,2,2,"dummy"
"185961",1,7,0,8,"dummy"
"185962",5,1,1,7,"dummy"
"185963",0,0,0,0,"dummy"
"185966",3,0,0,3,"dummy"
"185970",0,1,0,1,"dummy"
"185971",0,1,0,1,"dummy"
"185972",6,18,0,24,"dummy"
"185973",0,1,0,1,"dummy"
"185974",0,1,0,1,"dummy"
"185975",2,2,0,4,"dummy"
"185976",2,7,0,9,"dummy"
"185977",0,0,1,1,"dummy"
"185978",0,4,0,4,"dummy"
"185979",3,2,1,6,"dummy"
"185980",3,2,0,5,"dummy"
"185981",0,5,0,5,"dummy"
"185982",1,2,1,4,"dummy"
"185983",2,0,1,3,"dummy"
"185984",1,0,0,1,"dummy"
"185985",0,0,0,0,"dummy"
"185990",6,0,0,6,"dummy"
"185994",0,1,0,1,"dummy"
"186010",0,2,0,2,"dummy"
"186011",2,0,0,2,"dummy"
"186014",0,0,0,0,"dummy"
"186015",0,0,0,0,"dummy"
"186016",1,0,0,1,"dummy"
"186017",0,0,0,0,"dummy"
"186018",0,0,0,0,"dummy"
"186019",0,13,0,13,"dummy"
"186020",4,4,0,8,"dummy"
"186021",0,0,4,4,"dummy"
"186022",0,1,4,5,"dummy"
"186023",0,0,1,1,"dummy"
"186024",0,0,0,0,"dummy"
"186025",4,4,1,9,"dummy"
"186026",8,9,3,20,"dummy"
"186027",0,0,2,2,"dummy"
"186028",0,2,0,2,"dummy"
"186029",1,3,0,4,"dummy"
"186030",8,2,0,10,"dummy"
"186039",0,2,0,2,"dummy"
"186040",0,1,0,1,"dummy"
"186041",0,1,0,1,"dummy"
"186046",0,0,3,3,"dummy"
"186056",0,1,0,1,"dummy"
"186057",0,0,2,2,"dummy"
"186058",0,1,0,1,"dummy"
"186059",0,1,1,2,"dummy"
"186064",0,0,1,1,"dummy"
"186065",0,2,0,2,"dummy"
"186066",0,3,0,3,"dummy"
"186077",4,3,0,7,"dummy"
"186085",0,1,0,1,"dummy"
"186097",0,2,0,2,"dummy"
"186098",0,0,1,1,"dummy"
"186099",0,0,1,1,"dummy"
"186100",0,0,1,1,"dummy"
"186101",0,0,1,1,"dummy"
"186102",0,0,1,1,"dummy"
"186103",0,0,1,1,"dummy"
"186104",0,0,1,1,"dummy"
"186105",0,0,1,1,"dummy"
"186106",0,0,1,1,"dummy"
"186107",0,0,1,1,"dummy"
"186108",0,0,1,1,"dummy"
"186109",0,0,1,1,"dummy"
"186110",0,0,1,1,"dummy"
"186111",0,0,1,1,"dummy"
"186112",0,0,1,1,"dummy"
"186113",0,0,1,1,"dummy"
"186114",0,0,1,1,"dummy"
"186115",0,0,1,1,"dummy"
"186116",0,0,1,1,"dummy"
"186117",0,0,1,1,"dummy"
"186118",0,0,1,1,"dummy"
"186119",0,0,1,1,"dummy"
"186120",0,0,1,1,"dummy"
"186121",0,0,1,1,"dummy"
"186122",0,0,1,1,"dummy"
"186123",0,0,1,1,"dummy"
"186124",0,0,1,1,"dummy"
"186125",0,0,1,1,"dummy"
"186147",0,0,0,0,"dummy"
"186150",0,0,1,1,"dummy"
"186151",3,0,0,3,"dummy"
"186152",0,0,1,1,"dummy"
"186153",0,0,1,1,"dummy"
"186154",0,1,0,1,"dummy"
"186155",0,1,0,1,"dummy"
"186156",0,0,0,0,"dummy"
"186157",0,0,0,0,"dummy"
"186162",7,3,3,13,"dummy"
"186167",0,0,1,1,"dummy"
"186168",3,0,1,4,"dummy"
"186169",0,0,1,1,"dummy"
"186095",1,0,1,2,"dummy"
"186159",1,0,0,1,"dummy"
"186160",0,0,0,0,"dummy"
"186188",0,0,1,1,"dummy"
"186189",5,0,0,5,"dummy"
"186190",1,0,0,1,"dummy"
"186198",2,2,0,4,"dummy"
"186199",2,1,0,3,"dummy"
"186200",0,0,1,1,"dummy"
"186209",0,0,1,1,"dummy"
"186249",0,0,1,1,"dummy"
"186250",0,1,0,1,"dummy"
"186263",0,1,0,1,"dummy"
"186276",4,8,0,12,"dummy"
"186277",0,1,1,2,"dummy"
"186278",0,0,1,1,"dummy"
"186279",0,3,1,4,"dummy"
"186280",7,12,1,20,"dummy"
"186281",0,2,1,3,"dummy"
"186282",0,0,2,2,"dummy"
"186283",0,0,1,1,"dummy"
"186284",11,12,3,26,"dummy"
"186285",2,1,0,3,"dummy"
"186286",0,1,1,2,"dummy"
"186287",12,16,5,33,"dummy"
"186290",0,1,0,1,"dummy"
"186291",0,0,1,1,"dummy"
"186292",1,0,0,1,"dummy"
"186343",0,0,4,4,"dummy"
"186353",0,0,0,0,"dummy"
"186354",3,1,1,5,"dummy"
"186360",0,2,0,2,"dummy"
"186361",0,0,1,1,"dummy"
"186362",0,1,0,1,"dummy"
"186363",0,1,0,1,"dummy"
"186370",11,0,1,12,"dummy"
"186376",0,0,0,0,"dummy"
"186377",0,0,1,1,"dummy"
"186378",0,1,0,1,"dummy"
"186379",0,1,0,1,"dummy"
"186407",0,0,0,0,"dummy"
"186408",0,0,0,0,"dummy"
"186413",9,18,4,31,"dummy"
"186414",4,2,1,7,"dummy"
"186418",1,5,0,6,"dummy"
"186419",0,7,2,9,"dummy"
"186170",0,0,1,1,"dummy"
"186171",0,0,1,1,"dummy"
"186172",0,0,1,1,"dummy"
"186173",0,0,3,3,"dummy"
"186174",0,0,1,1,"dummy"
"186175",0,0,1,1,"dummy"
"186176",1,1,1,3,"dummy"
"186177",0,0,1,1,"dummy"
"186180",2,2,1,5,"dummy"
"186181",0,0,2,2,"dummy"
"186182",0,0,1,1,"dummy"
"186183",0,0,0,0,"dummy"
"186184",0,0,0,0,"dummy"
"186185",2,3,2,7,"dummy"
"186186",4,0,0,4,"dummy"
"186196",8,5,0,13,"dummy"
"186202",0,0,1,1,"dummy"
"186203",2,7,0,9,"dummy"
"186204",1,1,0,2,"dummy"
"186205",7,3,0,10,"dummy"
"186206",0,0,1,1,"dummy"
"186207",4,4,0,8,"dummy"
"186211",0,1,1,2,"dummy"
"186212",2,4,0,6,"dummy"
"186213",7,12,0,19,"dummy"
"186214",21,12,1,34,"dummy"
"186215",1,2,1,4,"dummy"
"186216",0,2,0,2,"dummy"
"186217",3,6,0,9,"dummy"
"186218",0,1,0,1,"dummy"
"186219",0,2,0,2,"dummy"
"186220",4,4,0,8,"dummy"
"186221",0,1,0,1,"dummy"
"186222",0,1,0,1,"dummy"
"186242",1,3,0,4,"dummy"
"186243",2,0,0,2,"dummy"
"186244",0,1,0,1,"dummy"
"186245",3,3,0,6,"dummy"
"186246",1,4,1,6,"dummy"
"186247",1,0,0,1,"dummy"
"186265",0,1,0,1,"dummy"
"186266",0,0,4,4,"dummy"
"186269",0,2,0,2,"dummy"
"186270",0,7,0,7,"dummy"
"186271",0,1,0,1,"dummy"
"186272",1,10,2,13,"dummy"
"186294",0,1,0,1,"dummy"
"186295",0,2,0,2,"dummy"
"186296",0,0,3,3,"dummy"
"186297",2,1,4,7,"dummy"
"186298",1,56,4,61,"dummy"
"186299",8,0,2,10,"dummy"
"186300",31,12,5,48,"dummy"
"186301",15,3,11,29,"dummy"
"186302",21,17,2,40,"dummy"
"186303",0,1,0,1,"dummy"
"186318",0,0,1,1,"dummy"
"186319",0,0,0,0,"dummy"
"186320",0,0,2,2,"dummy"
"186321",0,0,0,0,"dummy"
"186322",0,1,0,1,"dummy"
"186323",0,2,0,2,"dummy"
"186324",0,1,0,1,"dummy"
"186325",0,2,0,2,"dummy"
"186326",2,2,0,4,"dummy"
"186327",0,0,0,0,"dummy"
"186328",0,0,0,0,"dummy"
"186329",2,2,1,5,"dummy"
"186330",10,17,2,29,"dummy"
"186331",11,2,0,13,"dummy"
"186332",0,0,1,1,"dummy"
"186333",0,1,0,1,"dummy"
"186334",1,0,0,1,"dummy"
"186335",0,0,1,1,"dummy"
"186336",0,1,0,1,"dummy"
"186337",0,0,1,1,"dummy"
"186338",0,4,0,4,"dummy"
"186339",0,0,0,0,"dummy"
"186340",0,0,0,0,"dummy"
"186341",0,4,0,4,"dummy"
"186345",1,2,0,3,"dummy"
"186346",0,1,0,1,"dummy"
"186347",0,0,2,2,"dummy"
"186348",0,0,2,2,"dummy"
"186351",0,1,0,1,"dummy"
"186356",1,3,0,4,"dummy"
"186365",1,3,0,4,"dummy"
"186366",1,1,4,6,"dummy"
"186367",0,2,1,3,"dummy"
"186368",0,2,0,2,"dummy"
"186374",0,0,1,1,"dummy"
"186405",1,0,1,2,"dummy"
"186416",0,1,0,1,"dummy"
"186447",0,0,3,3,"dummy"
"186457",0,1,4,5,"dummy"
"186460",5,2,7,14,"dummy"
"186483",1,11,3,15,"dummy"
"186484",3,1,2,6,"dummy"
"186499",5,39,12,56,"dummy"
"186500",15,53,8,76,"dummy"
"186518",0,1,0,1,"dummy"
"186519",2,2,0,4,"dummy"
"186520",1,1,1,3,"dummy"
"186521",1,2,1,4,"dummy"
"186522",0,0,5,5,"dummy"
"186523",15,30,4,49,"dummy"
"186524",7,15,0,22,"dummy"
"186525",4,8,0,12,"dummy"
"186526",0,2,0,2,"dummy"
"186527",0,0,1,1,"dummy"
"186528",2,3,1,6,"dummy"
"186529",0,1,0,1,"dummy"
"186530",0,2,0,2,"dummy"
"186531",0,0,1,1,"dummy"
"186532",0,0,1,1,"dummy"
"186535",9,11,1,21,"dummy"
"186536",7,4,0,11,"dummy"
"186556",0,0,4,4,"dummy"
"186557",0,0,1,1,"dummy"
"186567",0,0,2,2,"dummy"
"186568",0,0,1,1,"dummy"
"186580",0,1,0,1,"dummy"
"186606",0,0,1,1,"dummy"
"186607",0,0,3,3,"dummy"
"186608",0,0,0,0,"dummy"
"186609",0,0,3,3,"dummy"
"186610",1,2,0,3,"dummy"
"186615",4,21,2,27,"dummy"
"186622",0,0,0,0,"dummy"
"186630",0,2,0,2,"dummy"
"186631",2,7,0,9,"dummy"
"186422",12,8,1,21,"dummy"
"186449",0,1,2,3,"dummy"
"186450",0,0,0,0,"dummy"
"186451",0,1,0,1,"dummy"
"186452",4,0,2,6,"dummy"
"186453",1,0,0,1,"dummy"
"186454",0,0,0,0,"dummy"
"186455",0,0,0,0,"dummy"
"186462",0,1,0,1,"dummy"
"186463",0,4,1,5,"dummy"
"186464",0,2,0,2,"dummy"
"186472",0,2,1,3,"dummy"
"186473",3,1,2,6,"dummy"
"186474",0,0,3,3,"dummy"
"186475",0,0,3,3,"dummy"
"186476",0,3,0,3,"dummy"
"186477",0,0,0,0,"dummy"
"186478",1,1,1,3,"dummy"
"186479",0,0,1,1,"dummy"
"186480",1,1,0,2,"dummy"
"186481",1,1,0,2,"dummy"
"186488",0,0,0,0,"dummy"
"186491",1,4,1,6,"dummy"
"186494",0,0,1,1,"dummy"
"186495",0,1,0,1,"dummy"
"186496",0,0,0,0,"dummy"
"186497",0,0,0,0,"dummy"
"186502",0,0,2,2,"dummy"
"186505",0,0,3,3,"dummy"
"186506",2,4,2,8,"dummy"
"186507",0,3,0,3,"dummy"
"186512",5,4,1,10,"dummy"
"186513",0,0,1,1,"dummy"
"186514",1,1,3,5,"dummy"
"186515",0,0,1,1,"dummy"
"186516",0,0,0,0,"dummy"
"186540",0,0,1,1,"dummy"
"186541",0,6,0,6,"dummy"
"186542",1,0,0,1,"dummy"
"186543",0,1,0,1,"dummy"
"186544",0,0,0,0,"dummy"
"186545",1,1,0,2,"dummy"
"186546",1,1,0,2,"dummy"
"186553",1,0,0,1,"dummy"
"186554",0,1,0,1,"dummy"
"186559",0,0,0,0,"dummy"
"186560",0,3,0,3,"dummy"
"186561",0,0,0,0,"dummy"
"186562",0,0,2,2,"dummy"
"186563",0,0,0,0,"dummy"
"186576",3,2,1,6,"dummy"
"186594",0,1,0,1,"dummy"
"186595",0,0,1,1,"dummy"
"186596",0,0,1,1,"dummy"
"186599",0,2,0,2,"dummy"
"186600",3,2,0,5,"dummy"
"186601",0,0,1,1,"dummy"
"186604",1,1,0,2,"dummy"
"186624",2,0,0,2,"dummy"
"186625",0,1,0,1,"dummy"
"186626",0,2,0,2,"dummy"
"186627",0,1,1,2,"dummy"
"186628",4,0,0,4,"dummy"
"186633",0,2,0,2,"dummy"
"186634",0,0,1,1,"dummy"
"186635",0,0,1,1,"dummy"
"186636",1,0,2,3,"dummy"
"186637",0,0,1,1,"dummy"
"186638",0,0,1,1,"dummy"
"186639",0,0,1,1,"dummy"
"186640",0,0,1,1,"dummy"
"186641",0,5,0,5,"dummy"
"186642",0,3,0,3,"dummy"
"186643",0,0,2,2,"dummy"
"186644",0,0,1,1,"dummy"
"186645",3,2,1,6,"dummy"
"186646",0,1,0,1,"dummy"
"186647",0,0,1,1,"dummy"
"186648",0,0,2,2,"dummy"
"186649",3,0,2,5,"dummy"
"186650",6,7,1,14,"dummy"
"186651",1,0,0,1,"dummy"
"186652",1,2,1,4,"dummy"
"186653",0,0,1,1,"dummy"
"186654",0,0,1,1,"dummy"
"186694",0,1,0,1,"dummy"
"186695",0,4,1,5,"dummy"
"186696",1,1,1,3,"dummy"
"186701",9,5,1,15,"dummy"
"186702",0,1,0,1,"dummy"
"186703",0,0,1,1,"dummy"
"186706",0,1,0,1,"dummy"
"186709",0,1,0,1,"dummy"
"186711",5,4,0,9,"dummy"
"186712",0,1,0,1,"dummy"
"186713",0,1,0,1,"dummy"
"186714",1,1,0,2,"dummy"
"186719",0,0,2,2,"dummy"
"186720",0,0,1,1,"dummy"
"186721",0,0,1,1,"dummy"
"186722",0,0,2,2,"dummy"
"186727",4,1,0,5,"dummy"
"186729",0,1,0,1,"dummy"
"186730",0,1,0,1,"dummy"
"186731",0,6,0,6,"dummy"
"186732",1,0,0,1,"dummy"
"186733",0,1,0,1,"dummy"
"186734",0,2,0,2,"dummy"
"186736",5,9,0,14,"dummy"
"186737",0,2,0,2,"dummy"
"186738",0,0,1,1,"dummy"
"186739",8,9,3,20,"dummy"
"186740",1,3,0,4,"dummy"
"186741",0,0,1,1,"dummy"
"186742",0,0,1,1,"dummy"
"186743",0,0,1,1,"dummy"
"186744",2,3,1,6,"dummy"
"186745",2,2,1,5,"dummy"
"186746",0,0,1,1,"dummy"
"186748",0,0,1,1,"dummy"
"186752",0,3,0,3,"dummy"
"186755",0,1,1,2,"dummy"
"186757",1,1,0,2,"dummy"
"186773",0,0,2,2,"dummy"
"186774",2,2,0,4,"dummy"
"186775",2,2,1,5,"dummy"
"186776",2,2,1,5,"dummy"
"186778",3,0,1,4,"dummy"
"186779",0,0,0,0,"dummy"
"186780",3,0,2,5,"dummy"
"186781",5,5,1,11,"dummy"
"186782",0,1,0,1,"dummy"
"186783",2,2,0,4,"dummy"
"186785",5,8,0,13,"dummy"
"186786",3,2,0,5,"dummy"
"186787",0,0,1,1,"dummy"
"186788",0,1,0,1,"dummy"
"186789",1,0,0,1,"dummy"
"186797",0,2,0,2,"dummy"
"186798",1,2,0,3,"dummy"
"186799",2,1,0,3,"dummy"
"186800",0,1,0,1,"dummy"
"186801",0,0,1,1,"dummy"
"186802",1,5,0,6,"dummy"
"186803",2,0,0,2,"dummy"
"186804",1,0,0,1,"dummy"
"186808",0,0,1,1,"dummy"
"186809",0,3,0,3,"dummy"
"186810",2,0,2,4,"dummy"
"186811",3,1,2,6,"dummy"
"186812",2,0,3,5,"dummy"
"186814",0,0,0,0,"dummy"
"186815",1,0,0,1,"dummy"
"186816",0,0,1,1,"dummy"
"186817",2,0,0,2,"dummy"
"186818",0,0,1,1,"dummy"
"186819",0,1,0,1,"dummy"
"186820",0,2,0,2,"dummy"
"186821",0,0,0,0,"dummy"
"186822",0,0,0,0,"dummy"
"186823",4,0,0,4,"dummy"
"186824",0,0,0,0,"dummy"
"186825",0,0,0,0,"dummy"
"186827",0,2,0,2,"dummy"
"186828",0,0,0,0,"dummy"
"186829",0,1,0,1,"dummy"
"186830",1,1,0,2,"dummy"
"186831",0,0,0,0,"dummy"
"186832",1,4,0,5,"dummy"
"186833",1,1,1,3,"dummy"
"186838",6,8,4,18,"dummy"
"186840",0,0,0,0,"dummy"
"186841",0,1,0,1,"dummy"
"186844",0,0,1,1,"dummy"
"186845",0,0,2,2,"dummy"
"186846",1,2,0,3,"dummy"
"186847",0,1,0,1,"dummy"
"186848",1,1,0,2,"dummy"
"186849",0,0,1,1,"dummy"
"186850",2,3,0,5,"dummy"
"186851",0,0,2,2,"dummy"
"186852",0,2,0,2,"dummy"
"186853",0,1,2,3,"dummy"
"186854",0,0,1,1,"dummy"
"186885",0,1,0,1,"dummy"
"186892",3,1,1,5,"dummy"
"186893",17,30,2,49,"dummy"
"186894",0,3,1,4,"dummy"
"186895",3,3,0,6,"dummy"
"186896",1,3,1,5,"dummy"
"186897",0,1,0,1,"dummy"
"186898",4,8,2,14,"dummy"
"186899",2,5,0,7,"dummy"
"186900",5,1,0,6,"dummy"
"186901",0,3,1,4,"dummy"
"186902",30,19,2,51,"dummy"
"186903",1,5,0,6,"dummy"
"186904",0,1,0,1,"dummy"
"186905",13,1,0,14,"dummy"
"186906",4,0,0,4,"dummy"
"186907",0,1,1,2,"dummy"
"186908",1,0,1,2,"dummy"
"186909",0,1,1,2,"dummy"
"186910",0,1,0,1,"dummy"
"186911",1,0,2,3,"dummy"
"186912",2,3,1,6,"dummy"
"186915",15,2,3,20,"dummy"
"186931",0,0,0,0,"dummy"
"186932",0,0,0,0,"dummy"
"186933",0,0,0,0,"dummy"
"186934",0,0,0,0,"dummy"
"186936",0,0,0,0,"dummy"
"186937",0,0,1,1,"dummy"
"186938",2,4,2,8,"dummy"
"186941",0,0,1,1,"dummy"
"186942",0,0,1,1,"dummy"
"186943",8,19,3,30,"dummy"
"186944",0,0,1,1,"dummy"
"186945",0,0,1,1,"dummy"
"186947",0,19,0,19,"dummy"
"186952",0,0,0,0,"dummy"
"186953",0,0,0,0,"dummy"
"186955",0,0,1,1,"dummy"
"186957",0,2,0,2,"dummy"
"186960",0,0,1,1,"dummy"
"186961",4,9,4,17,"dummy"
"186986",6,17,3,26,"dummy"
"186988",1,6,0,7,"dummy"
"186990",0,14,0,14,"dummy"
"186991",3,1,2,6,"dummy"
"186992",0,0,1,1,"dummy"
"186993",0,2,3,5,"dummy"
"186994",0,0,2,2,"dummy"
"186995",9,2,3,14,"dummy"
"186996",0,0,3,3,"dummy"
"187001",1,3,0,4,"dummy"
"187002",0,0,1,1,"dummy"
"187003",2,3,1,6,"dummy"
"187004",0,0,1,1,"dummy"
"187017",15,1,2,18,"dummy"
"187018",1,0,1,2,"dummy"
"187019",0,0,1,1,"dummy"
"187020",2,2,3,7,"dummy"
"187021",0,0,1,1,"dummy"
"187022",3,0,0,3,"dummy"
"187026",8,2,0,10,"dummy"
"187028",0,1,0,1,"dummy"
"187029",0,0,1,1,"dummy"
"187030",7,12,6,25,"dummy"
"187031",11,0,0,11,"dummy"
"187032",0,1,1,2,"dummy"
"187033",0,2,0,2,"dummy"
"187034",4,6,2,12,"dummy"
"187035",0,3,0,3,"dummy"
"187036",0,0,1,1,"dummy"
"187037",0,0,1,1,"dummy"
"187039",5,3,3,11,"dummy"
"187040",8,5,7,20,"dummy"
"187042",3,4,2,9,"dummy"
"187043",1,6,2,9,"dummy"
"187044",0,0,1,1,"dummy"
"187046",0,0,1,1,"dummy"
"187051",0,0,1,1,"dummy"
"187054",4,2,0,6,"dummy"
"187055",0,1,0,1,"dummy"
"187056",0,0,0,0,"dummy"
"187057",0,0,0,0,"dummy"
"187058",0,1,0,1,"dummy"
"187059",0,0,1,1,"dummy"
"187060",0,2,0,2,"dummy"
"187061",0,0,0,0,"dummy"
"187063",2,0,0,2,"dummy"
"187078",0,0,0,0,"dummy"
"187079",0,4,0,4,"dummy"
"187082",9,14,0,23,"dummy"
"187083",1,2,0,3,"dummy"
"187084",0,0,3,3,"dummy"
"187085",0,1,0,1,"dummy"
"187086",5,14,0,19,"dummy"
"187087",0,0,1,1,"dummy"
"187088",2,0,0,2,"dummy"
"187089",0,20,0,20,"dummy"
"187090",12,0,0,12,"dummy"
"187091",0,5,1,6,"dummy"
"187092",1,8,1,10,"dummy"
"187093",0,0,1,1,"dummy"
"187094",0,1,0,1,"dummy"
"187095",3,0,0,3,"dummy"
"187096",0,0,6,6,"dummy"
"187097",0,1,0,1,"dummy"
"187098",0,1,0,1,"dummy"
"187099",8,0,1,9,"dummy"
"187100",10,0,0,10,"dummy"
"187101",0,0,3,3,"dummy"
"187102",0,0,0,0,"dummy"
"187117",0,0,2,2,"dummy"
"187118",2,2,0,4,"dummy"
"187121",1,12,0,13,"dummy"
"187122",1,6,0,7,"dummy"
"187123",0,1,0,1,"dummy"
"187124",0,1,0,1,"dummy"
"187125",0,1,0,1,"dummy"
"187129",1,1,0,2,"dummy"
"187130",2,2,4,8,"dummy"
"187141",1,1,0,2,"dummy"
"187144",0,0,1,1,"dummy"
"187145",1,2,1,4,"dummy"
"187157",0,0,0,0,"dummy"
"187160",0,3,1,4,"dummy"
"187161",0,1,0,1,"dummy"
"187162",19,0,2,21,"dummy"
"187163",0,0,0,0,"dummy"
"187164",0,1,0,1,"dummy"
"187168",1,0,0,1,"dummy"
"187169",0,0,0,0,"dummy"
"187180",1,1,0,2,"dummy"
"187181",0,0,0,0,"dummy"
"187186",1,0,0,1,"dummy"
"187187",0,1,0,1,"dummy"
"187188",2,0,0,2,"dummy"
"187189",1,0,0,1,"dummy"
"187190",0,0,0,0,"dummy"
"187191",0,0,0,0,"dummy"
"187194",2,0,0,2,"dummy"
"187215",0,0,0,0,"dummy"
"187216",0,1,0,1,"dummy"
"187217",0,1,0,1,"dummy"
"187218",0,1,0,1,"dummy"
"187225",0,1,0,1,"dummy"
"187240",29,11,3,43,"dummy"
"187241",12,8,4,24,"dummy"
"187244",3,1,0,4,"dummy"
"187245",7,10,1,18,"dummy"
"187246",3,0,0,3,"dummy"
"187249",0,0,1,1,"dummy"
"187254",7,7,0,14,"dummy"
"187312",0,0,2,2,"dummy"
"187315",1,0,2,3,"dummy"
"187316",0,1,2,3,"dummy"
"187317",0,1,0,1,"dummy"
"187318",0,0,0,0,"dummy"
"187319",0,0,1,1,"dummy"
"187320",0,0,3,3,"dummy"
"187321",0,0,3,3,"dummy"
"187322",0,0,4,4,"dummy"
"187323",2,3,1,6,"dummy"
"187328",2,1,0,3,"dummy"
"187329",0,5,0,5,"dummy"
"187330",0,0,1,1,"dummy"
"187341",2,2,0,4,"dummy"
"187127",1,17,1,19,"dummy"
"187132",9,0,0,9,"dummy"
"187139",1,4,1,6,"dummy"
"187155",0,0,0,0,"dummy"
"187166",5,2,0,7,"dummy"
"187171",0,3,0,3,"dummy"
"187172",0,0,1,1,"dummy"
"187173",0,1,0,1,"dummy"
"187174",0,3,0,3,"dummy"
"187175",0,1,0,1,"dummy"
"187176",0,1,0,1,"dummy"
"187177",0,1,0,1,"dummy"
"187178",0,1,3,4,"dummy"
"187183",1,0,0,1,"dummy"
"187184",0,0,1,1,"dummy"
"187196",4,14,2,20,"dummy"
"187197",2,1,0,3,"dummy"
"187198",1,2,0,3,"dummy"
"187199",1,0,1,2,"dummy"
"187200",0,31,1,32,"dummy"
"187201",0,4,0,4,"dummy"
"187202",0,2,0,2,"dummy"
"187203",1,3,0,4,"dummy"
"187204",1,0,0,1,"dummy"
"187205",3,6,0,9,"dummy"
"187206",6,4,0,10,"dummy"
"187207",1,2,0,3,"dummy"
"187208",0,0,0,0,"dummy"
"187209",7,0,0,7,"dummy"
"187210",0,1,1,2,"dummy"
"187211",0,1,1,2,"dummy"
"187212",0,2,0,2,"dummy"
"187213",0,3,0,3,"dummy"
"187227",0,2,0,2,"dummy"
"187230",0,0,1,1,"dummy"
"187231",0,2,2,4,"dummy"
"187232",0,0,2,2,"dummy"
"187233",0,0,1,1,"dummy"
"187238",0,6,0,6,"dummy"
"187251",2,3,0,5,"dummy"
"187252",1,4,0,5,"dummy"
"187256",0,1,1,2,"dummy"
"187257",0,1,0,1,"dummy"
"187310",4,0,1,5,"dummy"
"187325",0,2,3,5,"dummy"
"187326",0,0,1,1,"dummy"
"187332",0,5,0,5,"dummy"
"187333",0,4,0,4,"dummy"
"187334",0,1,0,1,"dummy"
"187335",0,3,0,3,"dummy"
"187336",0,1,0,1,"dummy"
"187337",0,0,0,0,"dummy"
"187343",11,10,4,25,"dummy"
"187351",1,2,0,3,"dummy"
"187352",0,0,2,2,"dummy"
"187353",2,4,0,6,"dummy"
"187354",3,2,0,5,"dummy"
"187355",0,1,1,2,"dummy"
"187356",1,0,0,1,"dummy"
"187357",0,1,0,1,"dummy"
"187368",0,2,0,2,"dummy"
"187369",0,3,0,3,"dummy"
"187370",1,1,0,2,"dummy"
"187345",5,7,1,13,"dummy"
"187346",0,3,0,3,"dummy"
"187347",2,2,0,4,"dummy"
"187359",0,1,0,1,"dummy"
"187360",0,1,0,1,"dummy"
"187361",0,1,0,1,"dummy"
"187362",0,1,0,1,"dummy"
"187372",0,0,0,0,"dummy"
"187373",0,0,1,1,"dummy"
"187374",0,0,0,0,"dummy"
"187375",24,12,3,39,"dummy"
"187376",0,0,0,0,"dummy"
"187377",10,22,2,34,"dummy"
"187378",0,0,0,0,"dummy"
"187379",0,0,1,1,"dummy"
"187380",0,0,1,1,"dummy"
"187381",0,0,1,1,"dummy"
"187382",2,8,4,14,"dummy"
"187383",0,0,1,1,"dummy"
"187384",0,0,1,1,"dummy"
"187385",0,0,1,1,"dummy"
"187386",0,0,1,1,"dummy"
"187387",0,0,1,1,"dummy"
"187388",0,0,1,1,"dummy"
"187389",0,0,1,1,"dummy"
"187390",0,0,1,1,"dummy"
"187391",0,0,2,2,"dummy"
"187392",0,0,2,2,"dummy"
"187393",0,1,0,1,"dummy"
"187394",0,0,0,0,"dummy"
"187395",0,0,1,1,"dummy"
"187396",0,0,0,0,"dummy"
"187397",0,0,1,1,"dummy"
"187398",0,2,1,3,"dummy"
"187399",0,0,1,1,"dummy"
"187400",0,0,1,1,"dummy"
"187401",0,0,1,1,"dummy"
"187402",0,0,1,1,"dummy"
"187405",1,1,0,2,"dummy"
"187406",1,3,0,4,"dummy"
"187407",0,1,3,4,"dummy"
"187410",6,1,1,8,"dummy"
"187411",3,0,0,3,"dummy"
"187414",0,0,0,0,"dummy"
"187417",0,1,0,1,"dummy"
"187418",0,1,3,4,"dummy"
"187424",1,0,0,1,"dummy"
"187429",0,1,1,2,"dummy"
"187430",3,1,1,5,"dummy"
"187431",2,2,2,6,"dummy"
"187432",1,1,2,4,"dummy"
"187433",2,1,1,4,"dummy"
"187435",1,1,0,2,"dummy"
"187436",10,0,0,10,"dummy"
"187437",0,1,0,1,"dummy"
"187438",0,1,0,1,"dummy"
"187439",0,1,0,1,"dummy"
"187440",0,1,0,1,"dummy"
"187441",0,0,1,1,"dummy"
"187442",0,3,0,3,"dummy"
"187443",0,2,0,2,"dummy"
"187445",2,2,0,4,"dummy"
"187447",0,0,1,1,"dummy"
"187448",0,2,2,4,"dummy"
"187449",0,0,1,1,"dummy"
"187450",0,0,1,1,"dummy"
"187456",0,1,0,1,"dummy"
"187457",2,1,0,3,"dummy"
"187458",0,0,1,1,"dummy"
"187459",0,2,0,2,"dummy"
"187460",0,1,0,1,"dummy"
"187461",3,3,1,7,"dummy"
"187462",2,0,0,2,"dummy"
"187463",1,4,1,6,"dummy"
"187464",1,4,0,5,"dummy"
"187465",0,1,0,1,"dummy"
"187466",1,0,0,1,"dummy"
"187467",0,1,0,1,"dummy"
"187470",0,2,0,2,"dummy"
"187471",2,0,0,2,"dummy"
"187474",9,4,1,14,"dummy"
"187475",0,1,0,1,"dummy"
"187476",0,0,0,0,"dummy"
"187477",2,0,0,2,"dummy"
"187496",0,0,1,1,"dummy"
"187497",0,1,0,1,"dummy"
"187498",0,1,0,1,"dummy"
"187499",0,0,1,1,"dummy"
"187518",1,2,0,3,"dummy"
"187519",3,7,0,10,"dummy"
"187520",7,19,3,29,"dummy"
"187521",1,1,0,2,"dummy"
"187522",0,1,0,1,"dummy"
"187523",0,2,1,3,"dummy"
"187524",0,1,0,1,"dummy"
"187525",0,1,0,1,"dummy"
"187526",1,0,0,1,"dummy"
"187536",0,1,4,5,"dummy"
"187537",0,0,1,1,"dummy"
"187538",0,0,1,1,"dummy"
"187539",2,1,0,3,"dummy"
"187540",0,0,1,1,"dummy"
"187544",0,1,0,1,"dummy"
"187572",0,0,1,1,"dummy"
"187573",0,3,2,5,"dummy"
"187578",0,0,0,0,"dummy"
"187579",0,0,1,1,"dummy"
"187602",1,0,1,2,"dummy"
"187610",0,0,1,1,"dummy"
"187611",0,0,0,0,"dummy"
"187630",0,4,2,6,"dummy"
"187633",0,1,1,2,"dummy"
"187634",0,0,1,1,"dummy"
"187648",0,1,1,2,"dummy"
"187653",2,4,0,6,"dummy"
"187654",0,2,0,2,"dummy"
"187655",0,2,0,2,"dummy"
"187656",10,2,0,12,"dummy"
"187657",0,2,0,2,"dummy"
"187674",2,0,0,2,"dummy"
"187723",0,3,0,3,"dummy"
"187724",0,0,1,1,"dummy"
"187725",3,1,1,5,"dummy"
"187726",0,3,1,4,"dummy"
"187727",6,3,0,9,"dummy"
"187728",0,0,1,1,"dummy"
"187729",3,11,1,15,"dummy"
"187730",0,0,1,1,"dummy"
"187731",0,0,1,1,"dummy"
"187737",2,7,4,13,"dummy"
"187738",4,4,0,8,"dummy"
"187741",0,0,3,3,"dummy"
"187742",5,0,0,5,"dummy"
"187743",3,3,2,8,"dummy"
"187744",10,4,0,14,"dummy"
"187745",1,0,0,1,"dummy"
"187762",2,4,0,6,"dummy"
"187763",0,2,0,2,"dummy"
"187764",0,2,0,2,"dummy"
"187765",10,2,0,12,"dummy"
"187766",0,2,0,2,"dummy"
"187494",0,1,0,1,"dummy"
"187503",0,9,0,9,"dummy"
"187504",0,1,0,1,"dummy"
"187505",1,4,0,5,"dummy"
"187506",0,4,0,4,"dummy"
"187507",3,4,0,7,"dummy"
"187508",0,3,0,3,"dummy"
"187509",0,13,0,13,"dummy"
"187510",0,1,0,1,"dummy"
"187511",0,0,0,0,"dummy"
"187514",0,4,0,4,"dummy"
"187515",1,0,0,1,"dummy"
"187516",0,2,0,2,"dummy"
"187528",0,5,2,7,"dummy"
"187529",1,2,0,3,"dummy"
"187530",0,0,1,1,"dummy"
"187531",0,1,0,1,"dummy"
"187532",2,1,0,3,"dummy"
"187533",0,1,0,1,"dummy"
"187534",0,1,0,1,"dummy"
"187542",1,2,1,4,"dummy"
"187546",0,2,0,2,"dummy"
"187547",0,1,0,1,"dummy"
"187548",1,2,0,3,"dummy"
"187549",0,1,0,1,"dummy"
"187550",3,4,0,7,"dummy"
"187551",2,2,0,4,"dummy"
"187552",0,0,1,1,"dummy"
"187553",0,1,2,3,"dummy"
"187554",5,7,0,12,"dummy"
"187555",1,0,0,1,"dummy"
"187556",1,0,0,1,"dummy"
"187557",0,0,1,1,"dummy"
"187558",0,0,1,1,"dummy"
"187559",0,0,1,1,"dummy"
"187560",0,3,0,3,"dummy"
"187561",0,5,1,6,"dummy"
"187562",0,2,0,2,"dummy"
"187563",4,2,2,8,"dummy"
"187564",2,2,0,4,"dummy"
"187565",0,1,0,1,"dummy"
"187575",6,0,0,6,"dummy"
"187576",2,5,2,9,"dummy"
"187583",2,2,0,4,"dummy"
"187584",2,6,2,10,"dummy"
"187585",0,0,1,1,"dummy"
"187586",0,0,2,2,"dummy"
"187587",0,1,0,1,"dummy"
"187588",1,2,0,3,"dummy"
"187594",0,2,0,2,"dummy"
"187595",0,1,0,1,"dummy"
"187596",0,0,1,1,"dummy"
"187597",0,0,1,1,"dummy"
"187598",0,1,0,1,"dummy"
"187599",0,1,0,1,"dummy"
"187600",0,0,1,1,"dummy"
"187604",0,1,0,1,"dummy"
"187605",0,0,0,0,"dummy"
"187606",0,0,0,0,"dummy"
"187607",0,0,0,0,"dummy"
"187608",0,0,0,0,"dummy"
"187613",0,1,0,1,"dummy"
"187614",0,0,6,6,"dummy"
"187615",0,6,1,7,"dummy"
"187616",7,18,0,25,"dummy"
"187617",4,0,0,4,"dummy"
"187620",0,0,1,1,"dummy"
"187621",0,1,0,1,"dummy"
"187622",0,0,1,1,"dummy"
"187623",6,1,2,9,"dummy"
"187624",2,1,1,4,"dummy"
"187625",0,1,0,1,"dummy"
"187626",1,0,0,1,"dummy"
"187661",0,0,1,1,"dummy"
"187662",0,0,1,1,"dummy"
"187663",1,0,0,1,"dummy"
"187664",0,1,1,2,"dummy"
"187671",0,0,1,1,"dummy"
"187672",0,2,0,2,"dummy"
"187676",4,2,0,6,"dummy"
"187677",0,1,0,1,"dummy"
"187699",2,6,0,8,"dummy"
"187700",0,0,1,1,"dummy"
"187705",2,4,1,7,"dummy"
"187706",1,0,0,1,"dummy"
"187707",0,0,1,1,"dummy"
"187708",11,11,2,24,"dummy"
"187709",3,1,0,4,"dummy"
"187710",0,2,1,3,"dummy"
"187711",0,0,1,1,"dummy"
"187712",2,2,4,8,"dummy"
"187713",0,0,1,1,"dummy"
"187714",0,2,1,3,"dummy"
"187715",1,2,1,4,"dummy"
"187716",0,3,0,3,"dummy"
"187717",0,2,0,2,"dummy"
"187718",1,3,0,4,"dummy"
"187719",2,2,0,4,"dummy"
"187720",0,1,0,1,"dummy"
"187721",1,0,0,1,"dummy"
"187735",0,1,0,1,"dummy"
"187749",0,1,0,1,"dummy"
"187750",0,0,1,1,"dummy"
"187751",0,1,0,1,"dummy"
"187752",1,8,1,10,"dummy"
"187753",0,0,1,1,"dummy"
"187754",11,8,0,19,"dummy"
"187755",0,0,0,0,"dummy"
"187758",0,0,1,1,"dummy"
"187768",0,2,0,2,"dummy"
"187769",0,3,0,3,"dummy"
"187770",0,2,0,2,"dummy"
"187771",0,2,0,2,"dummy"
"187772",0,0,1,1,"dummy"
"187782",0,0,1,1,"dummy"
"187783",3,4,0,7,"dummy"
"187784",0,1,0,1,"dummy"
"187785",1,0,1,2,"dummy"
"187786",1,0,0,1,"dummy"
"187787",0,1,0,1,"dummy"
"187788",0,3,1,4,"dummy"
"187829",0,1,0,1,"dummy"
"187830",0,0,0,0,"dummy"
"187831",1,7,0,8,"dummy"
"187832",0,1,0,1,"dummy"
"187833",0,1,0,1,"dummy"
"187847",3,6,3,12,"dummy"
"187912",0,10,0,10,"dummy"
"187920",0,2,0,2,"dummy"
"187921",0,0,1,1,"dummy"
"187774",0,0,2,2,"dummy"
"187775",0,0,1,1,"dummy"
"187776",0,0,1,1,"dummy"
"187790",0,0,0,0,"dummy"
"187795",3,0,0,3,"dummy"
"187796",5,12,0,17,"dummy"
"187797",1,0,1,2,"dummy"
"187798",0,0,1,1,"dummy"
"187799",1,2,0,3,"dummy"
"187800",0,1,1,2,"dummy"
"187801",1,0,0,1,"dummy"
"187802",0,0,1,1,"dummy"
"187803",1,3,7,11,"dummy"
"187804",1,1,0,2,"dummy"
"187837",0,0,1,1,"dummy"
"187844",4,2,0,6,"dummy"
"187845",2,1,0,3,"dummy"
"187868",1,0,1,2,"dummy"
"187869",0,0,1,1,"dummy"
"187872",0,1,0,1,"dummy"
"187875",0,1,1,2,"dummy"
"187904",2,1,2,5,"dummy"
"187905",1,5,0,6,"dummy"
"187906",0,0,2,2,"dummy"
"187907",1,2,0,3,"dummy"
"187908",0,6,1,7,"dummy"
"187914",0,0,1,1,"dummy"
"187915",0,0,2,2,"dummy"
"187916",0,0,1,1,"dummy"
"187926",1,3,0,4,"dummy"
"187933",0,0,1,1,"dummy"
"187934",0,0,1,1,"dummy"
"187935",0,0,2,2,"dummy"
"187936",26,3,7,36,"dummy"
"187938",2,3,0,5,"dummy"
"187939",0,1,0,1,"dummy"
"187940",1,1,0,2,"dummy"
"187943",0,1,0,1,"dummy"
"187944",0,1,0,1,"dummy"
"187945",0,6,0,6,"dummy"
"187946",0,1,0,1,"dummy"
"187947",2,0,0,2,"dummy"
"187950",0,0,0,0,"dummy"
"187952",0,0,1,1,"dummy"
"187954",1,0,4,5,"dummy"
"187955",0,2,1,3,"dummy"
"187958",0,0,0,0,"dummy"
"187959",0,1,0,1,"dummy"
"187960",0,0,0,0,"dummy"
"187961",0,0,0,0,"dummy"
"187962",0,1,0,1,"dummy"
"187963",0,0,3,3,"dummy"
"187966",5,5,2,12,"dummy"
"187967",0,1,0,1,"dummy"
"187968",0,1,0,1,"dummy"
"187983",1,1,0,2,"dummy"
"187985",0,0,1,1,"dummy"
"187986",0,0,1,1,"dummy"
"187987",0,1,1,2,"dummy"
"187988",0,0,1,1,"dummy"
"187989",0,0,0,0,"dummy"
"187990",1,1,0,2,"dummy"
"187991",0,0,1,1,"dummy"
"187992",0,0,1,1,"dummy"
"187994",0,0,1,1,"dummy"
"187995",0,2,0,2,"dummy"
"188022",3,0,1,4,"dummy"
"188039",1,7,1,9,"dummy"
"188040",5,14,0,19,"dummy"
"188041",0,7,0,7,"dummy"
"188042",1,15,1,17,"dummy"
"188043",0,0,2,2,"dummy"
"188054",0,0,0,0,"dummy"
"188055",2,0,1,3,"dummy"
"188056",0,1,1,2,"dummy"
"188057",0,0,1,1,"dummy"
"188058",0,0,0,0,"dummy"
"188059",0,0,2,2,"dummy"
"188060",0,0,1,1,"dummy"
"188061",0,0,0,0,"dummy"
"188063",1,7,0,8,"dummy"
"188064",0,1,1,2,"dummy"
"188065",2,2,2,6,"dummy"
"188066",2,1,1,4,"dummy"
"188067",0,0,1,1,"dummy"
"188068",0,0,1,1,"dummy"
"188069",0,2,2,4,"dummy"
"188071",0,0,0,0,"dummy"
"188099",0,11,0,11,"dummy"
"188100",0,17,5,22,"dummy"
"188101",17,0,5,22,"dummy"
"188105",0,0,1,1,"dummy"
"188107",2,3,0,5,"dummy"
"188108",3,3,0,6,"dummy"
"188109",4,6,1,11,"dummy"
"188110",0,5,0,5,"dummy"
"188112",0,0,1,1,"dummy"
"188113",2,2,0,4,"dummy"
"188115",6,5,1,12,"dummy"
"188116",6,4,2,12,"dummy"
"188120",0,0,0,0,"dummy"
"188121",0,0,0,0,"dummy"
"188124",0,1,0,1,"dummy"
"188125",0,0,1,1,"dummy"
"188126",0,1,0,1,"dummy"
"188127",0,0,1,1,"dummy"
"188128",0,1,0,1,"dummy"
"188129",0,1,0,1,"dummy"
"188130",1,1,0,2,"dummy"
"188131",0,0,1,1,"dummy"
"188132",2,7,0,9,"dummy"
"188134",0,2,0,2,"dummy"
"188135",0,1,0,1,"dummy"
"188136",0,1,0,1,"dummy"
"188137",0,4,0,4,"dummy"
"188138",5,5,2,12,"dummy"
"188139",0,2,0,2,"dummy"
"188140",2,0,0,2,"dummy"
"188141",0,1,0,1,"dummy"
"188142",0,2,0,2,"dummy"
"188143",2,0,0,2,"dummy"
"188144",0,2,1,3,"dummy"
"188145",0,7,0,7,"dummy"
"188146",0,1,0,1,"dummy"
"188147",1,2,0,3,"dummy"
"188148",1,0,0,1,"dummy"
"188149",1,1,0,2,"dummy"
"188155",1,1,0,2,"dummy"
"188156",0,0,0,0,"dummy"
"188157",0,1,0,1,"dummy"
"188160",1,4,0,5,"dummy"
"188161",0,1,1,2,"dummy"
"188162",1,3,1,5,"dummy"
"188164",0,0,0,0,"dummy"
"188168",0,3,0,3,"dummy"
"188169",1,0,0,1,"dummy"
"188170",7,2,0,9,"dummy"
"188171",2,1,3,6,"dummy"
"188172",1,2,3,6,"dummy"
"188173",3,17,0,20,"dummy"
"188174",0,4,1,5,"dummy"
"188175",0,3,11,14,"dummy"
"188183",0,0,1,1,"dummy"
"188184",0,0,1,1,"dummy"
"188185",0,5,0,5,"dummy"
"188186",0,1,0,1,"dummy"
"188187",0,0,1,1,"dummy"
"188188",1,1,0,2,"dummy"
"188199",1,0,0,1,"dummy"
"188202",0,0,1,1,"dummy"
"188203",0,1,1,2,"dummy"
"188204",0,1,0,1,"dummy"
"188205",1,0,0,1,"dummy"
"188206",0,0,0,0,"dummy"
"188214",1,1,0,2,"dummy"
"188218",0,0,1,1,"dummy"
"188220",0,2,0,2,"dummy"
"188221",4,3,0,7,"dummy"
"188222",2,2,0,4,"dummy"
"188223",9,15,1,25,"dummy"
"188224",0,1,0,1,"dummy"
"188225",0,12,1,13,"dummy"
"188226",18,27,4,49,"dummy"
"188227",11,3,0,14,"dummy"
"188228",0,0,1,1,"dummy"
"188229",10,0,2,12,"dummy"
"188230",1,1,1,3,"dummy"
"188231",1,2,0,3,"dummy"
"188232",1,3,0,4,"dummy"
"188233",0,0,0,0,"dummy"
"188234",6,0,0,6,"dummy"
"188235",0,1,0,1,"dummy"
"188236",0,0,0,0,"dummy"
"188238",0,0,2,2,"dummy"
"188278",0,1,0,1,"dummy"
"188279",1,3,1,5,"dummy"
"188280",0,1,0,1,"dummy"
"188282",0,0,1,1,"dummy"
"188283",0,0,1,1,"dummy"
"188284",0,1,0,1,"dummy"
"188288",0,0,1,1,"dummy"
"188290",0,1,1,2,"dummy"
"188298",0,1,4,5,"dummy"
"188299",0,0,1,1,"dummy"
"188300",0,0,1,1,"dummy"
"188301",2,1,0,3,"dummy"
"188302",0,0,1,1,"dummy"
"188304",0,0,1,1,"dummy"
"188305",0,0,1,1,"dummy"
"188306",1,5,0,6,"dummy"
"188307",0,4,3,7,"dummy"
"188308",0,1,0,1,"dummy"
"188309",0,1,0,1,"dummy"
"188310",16,4,2,22,"dummy"
"188311",12,0,2,14,"dummy"
"188319",0,0,1,1,"dummy"
"188320",0,0,0,0,"dummy"
"188321",0,0,0,0,"dummy"
"188322",0,0,0,0,"dummy"
"188325",1,3,0,4,"dummy"
"188326",0,1,0,1,"dummy"
"188327",3,15,2,20,"dummy"
"188329",0,0,0,0,"dummy"
"188330",0,0,0,0,"dummy"
"188333",2,7,4,13,"dummy"
"188334",0,0,1,1,"dummy"
"188345",0,0,1,1,"dummy"
"188346",2,1,0,3,"dummy"
"188347",0,1,0,1,"dummy"
"188348",2,3,1,6,"dummy"
"188349",3,4,1,8,"dummy"
"188350",0,0,1,1,"dummy"
"188353",1,0,0,1,"dummy"
"188354",0,1,0,1,"dummy"
"188355",0,1,0,1,"dummy"
"188356",1,0,0,1,"dummy"
"188357",0,1,0,1,"dummy"
"188358",0,0,1,1,"dummy"
"188359",0,0,1,1,"dummy"
"188360",0,1,0,1,"dummy"
"188361",2,0,0,2,"dummy"
"188362",1,0,0,1,"dummy"
"188363",0,1,0,1,"dummy"
"188364",1,0,0,1,"dummy"
"188369",0,1,0,1,"dummy"
"188371",0,1,0,1,"dummy"
"188372",1,0,0,1,"dummy"
"188375",0,2,0,2,"dummy"
"188376",0,0,2,2,"dummy"
"188378",0,0,0,0,"dummy"
"188381",0,0,0,0,"dummy"
"188382",0,0,0,0,"dummy"
"188383",0,0,0,0,"dummy"
"188387",0,0,0,0,"dummy"
"188388",0,0,0,0,"dummy"
"188389",0,0,0,0,"dummy"
"188391",0,0,1,1,"dummy"
"188392",0,0,1,1,"dummy"
"188393",0,1,0,1,"dummy"
"188395",1,0,0,1,"dummy"
"188397",0,1,0,1,"dummy"
"188399",1,4,0,5,"dummy"
"188400",0,1,0,1,"dummy"
"188401",1,0,0,1,"dummy"
"188402",0,2,0,2,"dummy"
"188403",0,4,0,4,"dummy"
"188404",0,5,0,5,"dummy"
"188405",2,2,0,4,"dummy"
"188406",0,0,1,1,"dummy"
"188410",0,1,0,1,"dummy"
"188412",5,4,1,10,"dummy"
"188413",0,0,1,1,"dummy"
"188414",0,1,2,3,"dummy"
"188415",2,1,0,3,"dummy"
"188416",0,5,0,5,"dummy"
"188420",1,0,0,1,"dummy"
"188421",5,1,0,6,"dummy"
"188422",0,4,1,5,"dummy"
"188426",0,5,0,5,"dummy"
"188427",0,9,0,9,"dummy"
"188428",0,9,0,9,"dummy"
"188429",0,2,0,2,"dummy"
"188430",0,1,0,1,"dummy"
"188431",6,10,0,16,"dummy"
"188433",11,0,1,12,"dummy"
"188435",0,0,0,0,"dummy"
"188436",0,0,0,0,"dummy"
"188437",0,0,1,1,"dummy"
"188438",0,0,0,0,"dummy"
"188439",0,0,0,0,"dummy"
"188440",0,0,1,1,"dummy"
"188441",0,0,0,0,"dummy"
"188442",0,0,0,0,"dummy"
"188443",0,0,1,1,"dummy"
"188446",5,0,0,5,"dummy"
"188447",0,0,0,0,"dummy"
"188448",0,0,1,1,"dummy"
"188450",0,0,0,0,"dummy"
"188452",1,1,0,2,"dummy"
"188453",0,1,0,1,"dummy"
"188454",0,1,0,1,"dummy"
"188455",0,0,0,0,"dummy"
"188456",5,14,1,20,"dummy"
"188457",9,11,0,20,"dummy"
"188458",5,1,0,6,"dummy"
"188459",10,12,1,23,"dummy"
"188460",6,2,0,8,"dummy"
"188461",4,0,0,4,"dummy"
"188462",0,0,1,1,"dummy"
"188463",0,0,0,0,"dummy"
"188465",0,0,1,1,"dummy"
"188466",0,0,0,0,"dummy"
"188467",12,4,1,17,"dummy"
"188468",0,5,0,5,"dummy"
"188469",0,0,2,2,"dummy"
"188470",2,3,0,5,"dummy"
"188471",0,1,1,2,"dummy"
"188472",0,2,0,2,"dummy"
"188473",0,0,1,1,"dummy"
"188474",2,2,0,4,"dummy"
"188475",0,0,1,1,"dummy"
"188476",0,0,2,2,"dummy"
"188479",0,2,0,2,"dummy"
"188496",0,0,0,0,"dummy"
"188497",0,1,0,1,"dummy"
"188500",0,3,0,3,"dummy"
"188501",0,2,0,2,"dummy"
"188502",0,0,1,1,"dummy"
"188503",0,0,2,2,"dummy"
"188504",0,0,3,3,"dummy"
"188514",0,1,0,1,"dummy"
"188515",0,0,2,2,"dummy"
"188516",0,0,0,0,"dummy"
"188518",0,0,3,3,"dummy"
"188520",0,1,1,2,"dummy"
"188523",1,2,1,4,"dummy"
"188524",0,0,1,1,"dummy"
"188525",0,0,1,1,"dummy"
"188526",1,4,0,5,"dummy"
"188527",0,0,1,1,"dummy"
"188529",0,1,0,1,"dummy"
"188531",0,0,3,3,"dummy"
"188532",0,0,1,1,"dummy"
"188535",5,0,1,6,"dummy"
"188540",0,2,0,2,"dummy"
"188541",2,0,0,2,"dummy"
"188542",0,0,2,2,"dummy"
"188544",0,1,1,2,"dummy"
"188545",0,1,1,2,"dummy"
"188546",0,0,1,1,"dummy"
"188547",0,0,1,1,"dummy"
"188549",0,1,0,1,"dummy"
"188552",18,7,3,28,"dummy"
"188553",7,18,3,28,"dummy"
"188586",0,0,1,1,"dummy"
"188587",0,0,0,0,"dummy"
"188588",0,1,0,1,"dummy"
"188590",2,22,1,25,"dummy"
"188591",8,4,0,12,"dummy"
"188592",0,1,1,2,"dummy"
"188593",0,2,0,2,"dummy"
"188594",0,0,2,2,"dummy"
"188599",5,1,4,10,"dummy"
"188600",1,6,2,9,"dummy"
"188601",0,0,0,0,"dummy"
"188602",5,0,2,7,"dummy"
"188603",0,0,0,0,"dummy"
"188619",0,0,1,1,"dummy"
"188620",0,9,0,9,"dummy"
"188621",1,1,0,2,"dummy"
"188622",0,0,1,1,"dummy"
"188625",0,4,0,4,"dummy"
"188626",4,9,0,13,"dummy"
"188627",10,0,1,11,"dummy"
"188628",0,0,0,0,"dummy"
"188629",0,0,2,2,"dummy"
"188630",1,0,2,3,"dummy"
"188631",0,0,1,1,"dummy"
"188636",8,6,0,14,"dummy"
"188637",1,0,0,1,"dummy"
"188638",1,2,1,4,"dummy"
"188639",2,2,1,5,"dummy"
"188642",0,2,1,3,"dummy"
"188643",0,1,0,1,"dummy"
"188644",0,0,0,0,"dummy"
"188645",1,1,0,2,"dummy"
"188648",0,1,0,1,"dummy"
"188651",26,12,1,39,"dummy"
"188652",0,5,0,5,"dummy"
"188654",4,2,4,10,"dummy"
"188655",2,12,4,18,"dummy"
"188656",5,6,1,12,"dummy"
"188657",3,0,0,3,"dummy"
"188659",0,1,0,1,"dummy"
"188660",2,1,0,3,"dummy"
"188661",2,5,0,7,"dummy"
"188662",13,1,6,20,"dummy"
"188668",0,4,0,4,"dummy"
"188670",0,0,1,1,"dummy"
"188671",0,0,1,1,"dummy"
"188672",0,0,1,1,"dummy"
"188673",0,0,1,1,"dummy"
"188674",0,1,0,1,"dummy"
"188675",0,3,1,4,"dummy"
"188676",3,2,1,6,"dummy"
"188677",0,1,1,2,"dummy"
"188687",0,0,2,2,"dummy"
"188689",0,16,0,16,"dummy"
"188690",2,1,0,3,"dummy"
"188691",1,16,0,17,"dummy"
"188692",0,1,0,1,"dummy"
"188693",0,3,0,3,"dummy"
"188696",0,2,0,2,"dummy"
"188697",0,7,0,7,"dummy"
"188698",0,5,0,5,"dummy"
"188699",0,6,0,6,"dummy"
"188700",0,2,0,2,"dummy"
"188701",0,8,0,8,"dummy"
"188702",1,2,1,4,"dummy"
"188703",0,1,0,1,"dummy"
"188704",1,3,0,4,"dummy"
"188705",1,1,0,2,"dummy"
"188706",0,1,0,1,"dummy"
"188707",7,1,1,9,"dummy"
"188708",0,5,0,5,"dummy"
"188709",6,9,0,15,"dummy"
"188710",0,1,0,1,"dummy"
"188711",1,0,0,1,"dummy"
"188712",0,1,0,1,"dummy"
"188713",0,0,1,1,"dummy"
"188714",0,2,1,3,"dummy"
"188715",3,4,0,7,"dummy"
"188845",4,4,0,8,"dummy"
"188846",4,4,0,8,"dummy"
"188847",4,4,0,8,"dummy"
"188848",4,4,0,8,"dummy"
"188849",0,4,0,4,"dummy"
"188856",0,2,1,3,"dummy"
"188857",0,0,1,1,"dummy"
"188858",0,1,0,1,"dummy"
"188861",0,0,0,0,"dummy"
"188862",4,27,1,32,"dummy"
"188863",0,1,0,1,"dummy"
"188868",0,0,1,1,"dummy"
"188873",2,3,0,5,"dummy"
"188874",0,0,0,0,"dummy"
"188875",0,1,0,1,"dummy"
"188902",0,0,0,0,"dummy"
"188907",2,0,3,5,"dummy"
"188949",0,0,1,1,"dummy"
"188950",0,1,0,1,"dummy"
"188951",0,1,0,1,"dummy"
"188952",2,3,3,8,"dummy"
"188953",4,2,1,7,"dummy"
"188959",0,3,2,5,"dummy"
"188966",1,2,0,3,"dummy"
"188967",8,4,0,12,"dummy"
"188968",3,6,0,9,"dummy"
"188969",1,3,0,4,"dummy"
"188970",9,3,0,12,"dummy"
"188971",0,0,1,1,"dummy"
"188972",0,1,0,1,"dummy"
"188973",0,0,1,1,"dummy"
"188974",0,1,0,1,"dummy"
"188975",1,13,1,15,"dummy"
"188976",0,1,0,1,"dummy"
"188982",0,3,0,3,"dummy"
"188994",1,0,4,5,"dummy"
"188999",0,1,0,1,"dummy"
"189000",0,2,1,3,"dummy"
"189001",0,1,0,1,"dummy"
"189009",2,2,0,4,"dummy"
"189010",0,1,0,1,"dummy"
"189011",0,2,0,2,"dummy"
"189012",0,0,1,1,"dummy"
"189013",0,0,1,1,"dummy"
"189014",0,1,0,1,"dummy"
"189015",0,0,1,1,"dummy"
"189016",0,0,1,1,"dummy"
"189019",2,19,1,22,"dummy"
"189020",3,4,5,12,"dummy"
"189021",2,5,7,14,"dummy"
"189022",0,0,1,1,"dummy"
"189023",0,0,1,1,"dummy"
"189024",5,0,0,5,"dummy"
"188719",0,0,1,1,"dummy"
"188720",0,0,1,1,"dummy"
"188721",0,0,3,3,"dummy"
"188851",0,0,3,3,"dummy"
"188865",0,1,0,1,"dummy"
"188866",0,3,0,3,"dummy"
"188895",0,0,1,1,"dummy"
"188898",1,0,0,1,"dummy"
"188904",0,1,0,1,"dummy"
"188905",0,0,0,0,"dummy"
"188909",1,1,0,2,"dummy"
"188910",0,1,0,1,"dummy"
"188911",0,0,1,1,"dummy"
"188912",0,0,1,1,"dummy"
"188913",1,2,0,3,"dummy"
"188914",0,0,1,1,"dummy"
"188915",0,0,1,1,"dummy"
"188916",1,1,1,3,"dummy"
"188917",0,0,1,1,"dummy"
"188918",1,1,0,2,"dummy"
"188919",0,0,1,1,"dummy"
"188920",0,0,1,1,"dummy"
"188921",2,1,0,3,"dummy"
"188922",2,0,0,2,"dummy"
"188923",4,3,3,10,"dummy"
"188924",0,1,0,1,"dummy"
"188925",1,1,0,2,"dummy"
"188926",0,0,1,1,"dummy"
"188932",1,2,0,3,"dummy"
"188933",0,0,0,0,"dummy"
"188934",0,0,1,1,"dummy"
"188935",0,0,1,1,"dummy"
"188936",0,0,1,1,"dummy"
"188937",1,1,1,3,"dummy"
"188938",0,1,1,2,"dummy"
"188939",2,1,0,3,"dummy"
"188940",0,0,1,1,"dummy"
"188943",36,0,0,36,"dummy"
"188944",0,0,0,0,"dummy"
"188945",0,0,3,3,"dummy"
"188946",0,0,1,1,"dummy"
"188947",71,17,9,97,"dummy"
"188955",0,1,0,1,"dummy"
"188956",4,0,2,6,"dummy"
"188957",0,0,2,2,"dummy"
"188978",0,4,0,4,"dummy"
"188979",1,6,0,7,"dummy"
"188980",0,1,0,1,"dummy"
"188984",0,0,0,0,"dummy"
"188985",1,4,0,5,"dummy"
"188988",2,4,0,6,"dummy"
"188989",0,2,0,2,"dummy"
"188990",0,2,0,2,"dummy"
"188991",10,2,0,12,"dummy"
"188992",0,2,0,2,"dummy"
"189003",5,0,0,5,"dummy"
"189026",0,0,0,0,"dummy"
"189027",0,0,0,0,"dummy"
"189030",0,0,1,1,"dummy"
"189031",0,2,0,2,"dummy"
"189042",0,0,2,2,"dummy"
"189043",0,8,0,8,"dummy"
"189044",0,2,0,2,"dummy"
"189045",6,11,0,17,"dummy"
"189049",0,1,0,1,"dummy"
"189050",30,15,2,47,"dummy"
"189051",1,11,0,12,"dummy"
"189061",0,1,1,2,"dummy"
"189062",1,0,1,2,"dummy"
"189063",0,0,1,1,"dummy"
"189071",0,0,0,0,"dummy"
"189037",0,1,0,1,"dummy"
"189040",1,1,1,3,"dummy"
"189055",1,3,1,5,"dummy"
"189056",0,1,0,1,"dummy"
"189057",0,11,2,13,"dummy"
"189090",0,0,1,1,"dummy"
"189098",1,2,0,3,"dummy"
"189099",0,0,1,1,"dummy"
"189100",2,0,0,2,"dummy"
"189101",1,2,0,3,"dummy"
"189107",0,0,0,0,"dummy"
"189108",0,1,0,1,"dummy"
"189109",0,0,1,1,"dummy"
"189137",0,1,0,1,"dummy"
"189138",1,3,0,4,"dummy"
"189139",0,1,0,1,"dummy"
"189140",1,2,1,4,"dummy"
"189141",2,0,1,3,"dummy"
"189142",0,0,0,0,"dummy"
"189143",0,0,0,0,"dummy"
"189144",0,1,0,1,"dummy"
"189145",0,0,0,0,"dummy"
"189146",0,1,0,1,"dummy"
"189147",0,5,0,5,"dummy"
"189148",0,1,0,1,"dummy"
"189149",0,1,0,1,"dummy"
"189150",1,0,0,1,"dummy"
"189072",1,0,0,1,"dummy"
"189073",0,0,1,1,"dummy"
"189074",2,0,0,2,"dummy"
"189075",0,3,0,3,"dummy"
"189076",0,0,1,1,"dummy"
"189096",7,9,0,16,"dummy"
"189111",3,1,3,7,"dummy"
"189112",0,1,0,1,"dummy"
"189113",0,1,1,2,"dummy"
"189114",0,1,1,2,"dummy"
"189123",0,0,1,1,"dummy"
"189124",1,18,0,19,"dummy"
"189125",0,0,0,0,"dummy"
"189126",0,0,1,1,"dummy"
"189127",1,0,0,1,"dummy"
"189128",0,1,0,1,"dummy"
"189129",19,2,0,21,"dummy"
"189130",1,19,0,20,"dummy"
"189131",0,2,0,2,"dummy"
"189132",0,0,0,0,"dummy"
"189133",15,21,8,44,"dummy"
"189134",0,0,0,0,"dummy"
"189135",1,0,0,1,"dummy"
"189152",0,0,2,2,"dummy"
"189155",0,1,1,2,"dummy"
"189156",0,0,1,1,"dummy"
"189158",1,0,0,1,"dummy"
"189159",0,0,1,1,"dummy"
"189161",0,2,0,2,"dummy"
"189162",3,1,0,4,"dummy"
"189163",1,0,0,1,"dummy"
"189164",1,4,0,5,"dummy"
"189171",0,0,1,1,"dummy"
"189173",1,1,1,3,"dummy"
"189174",0,0,2,2,"dummy"
"189178",0,1,0,1,"dummy"
"189179",0,1,0,1,"dummy"
"189180",0,4,0,4,"dummy"
"189181",0,2,0,2,"dummy"
"189182",5,5,0,10,"dummy"
"189186",0,1,0,1,"dummy"
"189188",0,0,0,0,"dummy"
"189189",0,0,0,0,"dummy"
"189190",0,0,0,0,"dummy"
"189191",0,0,0,0,"dummy"
"189192",0,0,0,0,"dummy"
"189193",0,0,0,0,"dummy"
"189195",1,0,0,1,"dummy"
"189196",0,1,0,1,"dummy"
"189204",0,1,0,1,"dummy"
"189205",0,0,1,1,"dummy"
"189206",0,0,1,1,"dummy"
"189207",0,2,0,2,"dummy"
"189208",2,0,0,2,"dummy"
"189209",0,2,0,2,"dummy"
"189210",0,1,0,1,"dummy"
"189211",0,1,0,1,"dummy"
"189212",0,1,0,1,"dummy"
"189213",0,0,1,1,"dummy"
"189214",0,1,0,1,"dummy"
"189217",0,0,0,0,"dummy"
"189222",0,0,1,1,"dummy"
"189223",0,0,0,0,"dummy"
"189224",0,0,1,1,"dummy"
"189225",1,2,0,3,"dummy"
"189226",0,0,1,1,"dummy"
"189227",0,0,1,1,"dummy"
"189228",2,1,0,3,"dummy"
"189229",0,0,1,1,"dummy"
"189230",1,0,1,2,"dummy"
"189231",0,0,1,1,"dummy"
"189232",0,1,1,2,"dummy"
"189233",1,1,1,3,"dummy"
"189234",0,1,0,1,"dummy"
"189236",0,2,1,3,"dummy"
"189239",0,0,1,1,"dummy"
"189240",0,0,1,1,"dummy"
"189242",0,0,1,1,"dummy"
"189243",0,3,1,4,"dummy"
"189244",0,1,0,1,"dummy"
"189245",1,1,0,2,"dummy"
"189246",4,1,0,5,"dummy"
"189247",0,2,0,2,"dummy"
"189248",0,0,1,1,"dummy"
"189249",0,1,1,2,"dummy"
"189250",0,0,1,1,"dummy"
"189251",3,2,1,6,"dummy"
"189252",0,0,1,1,"dummy"
"189253",0,4,2,6,"dummy"
"189254",0,0,1,1,"dummy"
"189255",0,1,1,2,"dummy"
"189256",0,0,1,1,"dummy"
"189257",0,0,2,2,"dummy"
"189258",0,0,1,1,"dummy"
"189259",2,1,1,4,"dummy"
"189260",0,0,1,1,"dummy"
"189261",0,0,1,1,"dummy"
"189262",0,0,1,1,"dummy"
"189263",0,0,2,2,"dummy"
"189264",0,0,1,1,"dummy"
"189265",7,2,2,11,"dummy"
"189266",0,0,1,1,"dummy"
"189267",2,1,0,3,"dummy"
"189268",0,0,1,1,"dummy"
"189269",0,0,1,1,"dummy"
"189270",0,0,1,1,"dummy"
"189271",0,0,1,1,"dummy"
"189272",0,0,1,1,"dummy"
"189273",0,1,1,2,"dummy"
"189274",0,0,1,1,"dummy"
"189278",6,1,1,8,"dummy"
"189280",0,0,0,0,"dummy"
"189281",0,0,0,0,"dummy"
"189282",0,0,0,0,"dummy"
"189283",0,0,0,0,"dummy"
"189284",0,0,0,0,"dummy"
"189285",0,0,1,1,"dummy"
"189288",0,2,0,2,"dummy"
"189289",0,1,0,1,"dummy"
"189291",0,4,0,4,"dummy"
"189292",0,25,0,25,"dummy"
"189293",0,1,0,1,"dummy"
"189294",0,4,0,4,"dummy"
"189295",0,2,0,2,"dummy"
"189296",1,0,1,2,"dummy"
"189302",1,2,1,4,"dummy"
"189303",0,3,0,3,"dummy"
"189304",0,1,0,1,"dummy"
"189305",1,3,0,4,"dummy"
"189306",0,0,1,1,"dummy"
"189307",0,0,1,1,"dummy"
"189308",3,4,0,7,"dummy"
"189309",0,0,1,1,"dummy"
"189311",0,2,0,2,"dummy"
"189312",0,2,0,2,"dummy"
"189313",0,4,0,4,"dummy"
"189314",0,4,0,4,"dummy"
"189315",0,0,1,1,"dummy"
"189316",0,1,0,1,"dummy"
"189317",0,0,1,1,"dummy"
"189331",0,0,0,0,"dummy"
"189332",0,0,1,1,"dummy"
"189333",3,2,0,5,"dummy"
"189334",0,0,1,1,"dummy"
"189335",3,10,0,13,"dummy"
"189336",0,0,2,2,"dummy"
"189338",6,0,0,6,"dummy"
"189339",2,5,2,9,"dummy"
"189343",0,13,0,13,"dummy"
"189344",0,1,0,1,"dummy"
"189348",1,0,0,1,"dummy"
"189364",2,0,0,2,"dummy"
"189366",2,1,0,3,"dummy"
"189367",1,0,7,8,"dummy"
"189368",1,0,2,3,"dummy"
"189369",0,0,2,2,"dummy"
"189370",1,1,1,3,"dummy"
"189371",0,1,0,1,"dummy"
"189372",0,1,0,1,"dummy"
"189374",0,2,0,2,"dummy"
"189375",0,1,0,1,"dummy"
"189378",0,1,0,1,"dummy"
"189383",0,7,0,7,"dummy"
"189385",7,1,1,9,"dummy"
"189386",0,6,0,6,"dummy"
"189387",0,0,1,1,"dummy"
"189388",0,3,0,3,"dummy"
"189389",1,3,0,4,"dummy"
"189390",3,3,0,6,"dummy"
"189391",0,2,5,7,"dummy"
"189392",3,2,5,10,"dummy"
"189393",0,0,1,1,"dummy"
"189394",1,4,1,6,"dummy"
"189407",0,0,1,1,"dummy"
"189409",1,14,0,15,"dummy"
"189410",0,2,0,2,"dummy"
"189413",9,12,2,23,"dummy"
"189414",0,1,0,1,"dummy"
"189417",0,0,1,1,"dummy"
"189418",0,0,1,1,"dummy"
"189419",0,0,1,1,"dummy"
"189420",0,0,0,0,"dummy"
"189421",0,0,1,1,"dummy"
"189423",2,1,2,5,"dummy"
"189427",0,0,0,0,"dummy"
"189429",0,1,0,1,"dummy"
"189430",0,0,2,2,"dummy"
"189434",1,0,0,1,"dummy"
"189435",0,2,0,2,"dummy"
"189437",0,9,1,10,"dummy"
"189438",1,0,6,7,"dummy"
"189439",0,0,2,2,"dummy"
"189440",0,0,2,2,"dummy"
"189441",0,0,2,2,"dummy"
"189442",9,1,0,10,"dummy"
"189443",3,0,2,5,"dummy"
"189444",0,0,0,0,"dummy"
"189445",0,0,1,1,"dummy"
"189447",1,1,0,2,"dummy"
"189448",0,1,0,1,"dummy"
"189449",0,1,0,1,"dummy"
"189453",1,2,0,3,"dummy"
"189454",2,0,0,2,"dummy"
"189455",0,0,1,1,"dummy"
"189456",0,0,0,0,"dummy"
"189457",0,0,0,0,"dummy"
"189458",9,8,2,19,"dummy"
"189459",2,0,0,2,"dummy"
"189460",0,0,0,0,"dummy"
"189461",0,13,0,13,"dummy"
"189463",1,0,0,1,"dummy"
"189464",0,1,0,1,"dummy"
"189465",6,7,2,15,"dummy"
"189466",0,0,1,1,"dummy"
"189467",0,2,1,3,"dummy"
"189468",0,2,0,2,"dummy"
"189469",0,0,1,1,"dummy"
"189471",0,0,1,1,"dummy"
"189472",0,0,1,1,"dummy"
"189473",0,0,1,1,"dummy"
"189474",0,0,1,1,"dummy"
"189475",0,0,1,1,"dummy"
"189476",0,0,1,1,"dummy"
"189477",0,0,1,1,"dummy"
"189478",0,0,1,1,"dummy"
"189479",0,0,1,1,"dummy"
"189480",0,0,1,1,"dummy"
"189481",0,0,1,1,"dummy"
"189482",0,0,1,1,"dummy"
"189483",0,0,1,1,"dummy"
"189484",0,0,1,1,"dummy"
"189485",0,0,1,1,"dummy"
"189486",0,0,1,1,"dummy"
"189487",0,0,1,1,"dummy"
"189488",0,0,1,1,"dummy"
"189489",0,0,1,1,"dummy"
"189504",0,1,0,1,"dummy"
"189522",1,3,1,5,"dummy"
"189523",1,3,0,4,"dummy"
"189524",2,7,0,9,"dummy"
"189525",7,3,2,12,"dummy"
"189528",0,2,0,2,"dummy"
"189530",0,1,0,1,"dummy"
"189532",0,1,0,1,"dummy"
"189533",0,3,0,3,"dummy"
"189534",0,0,1,1,"dummy"
"189536",0,1,0,1,"dummy"
"189537",0,0,1,1,"dummy"
"189539",0,2,0,2,"dummy"
"189540",0,0,1,1,"dummy"
"189541",18,8,1,27,"dummy"
"189542",0,5,0,5,"dummy"
"189543",4,4,1,9,"dummy"
"189544",0,2,0,2,"dummy"
"189545",6,0,1,7,"dummy"
"189557",0,1,1,2,"dummy"
"189559",5,0,0,5,"dummy"
"189560",0,0,2,2,"dummy"
"189561",2,1,0,3,"dummy"
"189562",0,0,1,1,"dummy"
"189563",6,2,0,8,"dummy"
"189564",0,3,0,3,"dummy"
"189565",0,4,0,4,"dummy"
"189568",0,3,0,3,"dummy"
"189579",0,1,0,1,"dummy"
"189582",0,1,2,3,"dummy"
"189583",0,0,1,1,"dummy"
"189584",0,0,1,1,"dummy"
"189586",1,0,0,1,"dummy"
"189587",1,0,3,4,"dummy"
"189588",0,2,1,3,"dummy"
"189590",0,1,0,1,"dummy"
"189592",0,0,1,1,"dummy"
"189593",0,0,1,1,"dummy"
"189594",0,0,1,1,"dummy"
"189595",0,0,1,1,"dummy"
"189596",0,0,1,1,"dummy"
"189597",0,0,1,1,"dummy"
"189598",0,0,1,1,"dummy"
"189599",0,0,1,1,"dummy"
"189600",0,0,1,1,"dummy"
"189601",0,1,0,1,"dummy"
"189602",0,0,1,1,"dummy"
"189603",0,0,1,1,"dummy"
"189604",0,0,1,1,"dummy"
"189605",0,0,1,1,"dummy"
"189606",0,0,1,1,"dummy"
"189607",0,0,1,1,"dummy"
"189608",0,0,1,1,"dummy"
"189609",0,0,1,1,"dummy"
"189610",3,8,1,12,"dummy"
"189611",0,0,1,1,"dummy"
"189612",1,0,0,1,"dummy"
"189615",0,1,0,1,"dummy"
"189616",1,0,1,2,"dummy"
"189651",0,0,0,0,"dummy"
"189652",0,0,0,0,"dummy"
"189655",1,3,1,5,"dummy"
"189656",1,6,0,7,"dummy"
"189657",1,0,1,2,"dummy"
"189658",2,7,1,10,"dummy"
"189659",2,3,2,7,"dummy"
"189660",0,3,1,4,"dummy"
"189663",0,0,1,1,"dummy"
"189664",0,0,0,0,"dummy"
"189665",0,0,0,0,"dummy"
"189666",0,0,0,0,"dummy"
"189667",0,0,0,0,"dummy"
"189668",0,0,1,1,"dummy"
"189669",0,0,1,1,"dummy"
"189670",0,0,1,1,"dummy"
"189680",0,0,0,0,"dummy"
"189681",0,0,1,1,"dummy"
"189692",0,0,0,0,"dummy"
"189693",0,1,2,3,"dummy"
"189704",0,0,1,1,"dummy"
"189705",0,0,1,1,"dummy"
"189707",4,0,0,4,"dummy"
"189708",0,1,1,2,"dummy"
"189709",1,3,2,6,"dummy"
"189710",0,1,1,2,"dummy"
"189711",3,1,1,5,"dummy"
"189712",3,6,1,10,"dummy"
"189713",1,0,0,1,"dummy"
"189714",1,0,0,1,"dummy"
"189715",2,3,0,5,"dummy"
"189716",2,4,0,6,"dummy"
"189717",0,0,1,1,"dummy"
"189718",0,1,0,1,"dummy"
"189719",0,5,0,5,"dummy"
"189720",0,0,0,0,"dummy"
"189721",0,0,0,0,"dummy"
"189729",0,0,0,0,"dummy"
"189730",0,0,0,0,"dummy"
"189732",0,0,1,1,"dummy"
"189733",0,0,1,1,"dummy"
"189734",0,0,1,1,"dummy"
"189752",1,4,3,8,"dummy"
"189755",0,0,0,0,"dummy"
"189756",0,0,1,1,"dummy"
"189757",1,1,1,3,"dummy"
"189758",0,1,0,1,"dummy"
"189759",0,0,1,1,"dummy"
"189760",0,0,1,1,"dummy"
"189761",0,0,1,1,"dummy"
"189762",1,1,1,3,"dummy"
"189763",0,1,0,1,"dummy"
"189764",0,0,0,0,"dummy"
"189765",0,1,0,1,"dummy"
"189766",0,1,0,1,"dummy"
"189767",6,1,3,10,"dummy"
"189768",0,3,0,3,"dummy"
"189769",0,0,0,0,"dummy"
"189770",0,0,1,1,"dummy"
"189771",4,0,1,5,"dummy"
"189772",0,0,1,1,"dummy"
"189773",0,1,1,2,"dummy"
"189774",0,1,0,1,"dummy"
"189775",0,3,0,3,"dummy"
"189776",0,0,1,1,"dummy"
"189777",1,1,0,2,"dummy"
"189778",5,14,0,19,"dummy"
"189779",8,4,0,12,"dummy"
"189780",0,0,0,0,"dummy"
"189781",2,0,2,4,"dummy"
"189782",0,1,0,1,"dummy"
"189783",0,1,0,1,"dummy"
"189784",0,3,2,5,"dummy"
"189785",0,2,1,3,"dummy"
"189786",9,0,2,11,"dummy"
"189787",0,9,2,11,"dummy"
"189788",0,1,0,1,"dummy"
"189789",7,0,1,8,"dummy"
"189790",0,1,1,2,"dummy"
"189791",0,6,0,6,"dummy"
"189794",0,1,2,3,"dummy"
"189795",0,0,0,0,"dummy"
"189796",0,1,0,1,"dummy"
"189797",4,0,2,6,"dummy"
"189798",1,0,0,1,"dummy"
"189799",0,0,0,0,"dummy"
"189800",0,0,0,0,"dummy"
"189804",0,1,0,1,"dummy"
"189805",4,4,1,9,"dummy"
"189806",1,3,0,4,"dummy"
"189807",5,0,0,5,"dummy"
"189808",0,1,0,1,"dummy"
"189809",0,2,0,2,"dummy"
"189810",1,1,0,2,"dummy"
"189811",0,0,1,1,"dummy"
"189812",1,1,1,3,"dummy"
"189813",8,5,1,14,"dummy"
"189814",0,3,0,3,"dummy"
"189815",0,2,0,2,"dummy"
"189820",0,0,2,2,"dummy"
"189824",0,2,0,2,"dummy"
"189825",3,0,1,4,"dummy"
"189849",0,3,0,3,"dummy"
"189850",0,0,4,4,"dummy"
"189851",7,6,0,13,"dummy"
"189852",3,9,1,13,"dummy"
"189853",0,2,0,2,"dummy"
"189854",2,0,0,2,"dummy"
"189855",0,2,0,2,"dummy"
"189856",0,4,0,4,"dummy"
"189857",0,1,1,2,"dummy"
"189858",0,0,0,0,"dummy"
"189863",2,2,0,4,"dummy"
"189864",22,7,2,31,"dummy"
"189865",0,4,0,4,"dummy"
"189866",8,14,0,22,"dummy"
"189867",2,2,0,4,"dummy"
"189868",7,1,2,10,"dummy"
"189869",5,1,0,6,"dummy"
"189870",1,0,0,1,"dummy"
"189871",0,0,1,1,"dummy"
"189872",0,0,0,0,"dummy"
"189873",0,0,0,0,"dummy"
"189874",0,0,0,0,"dummy"
"189875",0,0,0,0,"dummy"
"189876",0,0,0,0,"dummy"
"189877",2,5,0,7,"dummy"
"189878",0,0,0,0,"dummy"
"189879",4,14,0,18,"dummy"
"189880",14,4,0,18,"dummy"
"189881",0,0,0,0,"dummy"
"189882",1,0,0,1,"dummy"
"189883",0,2,0,2,"dummy"
"189884",0,0,0,0,"dummy"
"189885",0,0,0,0,"dummy"
"189886",0,1,0,1,"dummy"
"189887",0,0,0,0,"dummy"
"189888",0,0,0,0,"dummy"
"189889",0,0,0,0,"dummy"
"189890",1,3,0,4,"dummy"
"189891",1,0,0,1,"dummy"
"189892",0,0,0,0,"dummy"
"189893",1,0,0,1,"dummy"
"189894",1,0,1,2,"dummy"
"189895",0,0,0,0,"dummy"
"189896",0,0,0,0,"dummy"
"189898",0,3,1,4,"dummy"
"189904",0,1,0,1,"dummy"
"189905",2,11,0,13,"dummy"
"189906",8,4,0,12,"dummy"
"189907",0,2,0,2,"dummy"
"189909",0,0,2,2,"dummy"
"189910",2,6,2,10,"dummy"
"189911",0,1,0,1,"dummy"
"189912",0,0,4,4,"dummy"
"189914",0,0,1,1,"dummy"
"189915",0,1,0,1,"dummy"
"189916",0,1,0,1,"dummy"
"189917",0,1,1,2,"dummy"
"189918",1,0,1,2,"dummy"
"189919",0,1,2,3,"dummy"
"189920",0,0,1,1,"dummy"
"189922",1,1,2,4,"dummy"
"189923",3,6,0,9,"dummy"
"189925",0,2,0,2,"dummy"
"189926",0,0,3,3,"dummy"
"189927",0,3,1,4,"dummy"
"189928",5,1,0,6,"dummy"
"189929",5,0,0,5,"dummy"
"189930",7,2,4,13,"dummy"
"189934",0,8,1,9,"dummy"
"189935",0,5,1,6,"dummy"
"189936",3,3,1,7,"dummy"
"189937",0,4,0,4,"dummy"
"189938",0,1,0,1,"dummy"
"189939",0,0,1,1,"dummy"
"189940",11,5,1,17,"dummy"
"189941",1,3,0,4,"dummy"
"189942",0,1,0,1,"dummy"
"189943",0,1,1,2,"dummy"
"189944",0,6,0,6,"dummy"
"189945",0,0,0,0,"dummy"
"189946",0,1,0,1,"dummy"
"189947",1,6,0,7,"dummy"
"189948",5,3,1,9,"dummy"
"189949",1,0,0,1,"dummy"
"189950",4,6,1,11,"dummy"
"189951",0,0,0,0,"dummy"
"189952",2,3,0,5,"dummy"
"189953",0,0,0,0,"dummy"
"189954",0,0,0,0,"dummy"
"189956",3,2,0,5,"dummy"
"189958",3,0,0,3,"dummy"
"189960",0,0,1,1,"dummy"
"189962",0,0,1,1,"dummy"
"189965",1,1,1,3,"dummy"
"189967",0,0,1,1,"dummy"
"189971",0,2,1,3,"dummy"
"189972",0,1,1,2,"dummy"
"189973",0,0,1,1,"dummy"
"189974",0,0,2,2,"dummy"
"189975",0,0,1,1,"dummy"
"189976",0,2,0,2,"dummy"
"189977",0,0,2,2,"dummy"
"189978",5,8,3,16,"dummy"
"189979",11,20,11,42,"dummy"
"189981",0,0,1,1,"dummy"
"189982",0,0,1,1,"dummy"
"189983",0,0,1,1,"dummy"
"189985",0,1,0,1,"dummy"
"189989",0,1,0,1,"dummy"
"189990",4,1,0,5,"dummy"
"189991",16,6,3,25,"dummy"
"189992",15,0,0,15,"dummy"
"189994",0,4,0,4,"dummy"
"189995",4,13,1,18,"dummy"
"189996",5,6,0,11,"dummy"
"189997",0,1,5,6,"dummy"
"189998",2,0,0,2,"dummy"
"189999",0,0,0,0,"dummy"
"190007",1,0,0,1,"dummy"
"190009",9,2,0,11,"dummy"
"190010",0,1,0,1,"dummy"
"190014",0,0,0,0,"dummy"
"190016",0,0,1,1,"dummy"
"190017",0,0,4,4,"dummy"
"190018",0,0,3,3,"dummy"
"190022",1,4,0,5,"dummy"
"190023",5,6,1,12,"dummy"
"190033",0,1,0,1,"dummy"
"190035",1,1,0,2,"dummy"
"190037",9,0,1,10,"dummy"
"190038",2,0,0,2,"dummy"
"190042",6,0,0,6,"dummy"
"190043",2,5,2,9,"dummy"
"190045",0,0,1,1,"dummy"
"190046",0,0,0,0,"dummy"
"190047",0,0,0,0,"dummy"
"190053",0,1,0,1,"dummy"
"190054",0,5,0,5,"dummy"
"190055",8,12,0,20,"dummy"
"190057",3,1,3,7,"dummy"
"190060",1,1,0,2,"dummy"
"190061",0,3,0,3,"dummy"
"190063",2,1,0,3,"dummy"
"190066",0,1,0,1,"dummy"
"190068",0,0,1,1,"dummy"
"190069",1,7,0,8,"dummy"
"190070",0,0,0,0,"dummy"
"190071",0,7,5,12,"dummy"
"190073",0,0,1,1,"dummy"
"190074",0,0,1,1,"dummy"
"190075",0,0,2,2,"dummy"
"190076",26,3,7,36,"dummy"
"190078",7,4,1,12,"dummy"
"190080",1,6,2,9,"dummy"
"190084",2,4,0,6,"dummy"
"190085",0,2,0,2,"dummy"
"190086",0,2,0,2,"dummy"
"190087",10,2,0,12,"dummy"
"190088",0,2,0,2,"dummy"
"190089",0,0,0,0,"dummy"
"190100",0,1,0,1,"dummy"
"190101",1,2,0,3,"dummy"
"190102",5,6,1,12,"dummy"
"190103",2,1,4,7,"dummy"
"190104",0,1,0,1,"dummy"
"190105",0,0,2,2,"dummy"
"190106",0,0,2,2,"dummy"
"190107",0,1,2,3,"dummy"
"190108",0,0,1,1,"dummy"
"190109",1,0,0,1,"dummy"
"190110",0,0,1,1,"dummy"
"190111",0,0,0,0,"dummy"
"190115",0,2,1,3,"dummy"
"190117",0,8,0,8,"dummy"
"190118",0,7,0,7,"dummy"
"190119",0,17,0,17,"dummy"
"190120",4,3,0,7,"dummy"
"190121",0,7,2,9,"dummy"
"190122",0,6,1,7,"dummy"
"190123",0,0,0,0,"dummy"
"190133",0,3,0,3,"dummy"
"190135",0,1,0,1,"dummy"
"190137",0,0,0,0,"dummy"
"190138",1,0,1,2,"dummy"
"190144",0,1,0,1,"dummy"
"190148",0,1,0,1,"dummy"
"190154",5,3,3,11,"dummy"
"190157",0,0,1,1,"dummy"
"190158",0,3,0,3,"dummy"
"190159",0,0,0,0,"dummy"
"190160",0,1,0,1,"dummy"
"190161",5,6,0,11,"dummy"
"190162",0,1,0,1,"dummy"
"190163",2,5,1,8,"dummy"
"190164",3,3,0,6,"dummy"
"190165",6,1,0,7,"dummy"
"190166",1,1,1,3,"dummy"
"190167",5,8,0,13,"dummy"
"190168",1,2,0,3,"dummy"
"190169",4,1,0,5,"dummy"
"190170",1,1,1,3,"dummy"
"190171",0,3,0,3,"dummy"
"190172",3,3,0,6,"dummy"
"190173",0,0,1,1,"dummy"
"190174",0,0,1,1,"dummy"
"190176",2,2,1,5,"dummy"
"190177",0,3,3,6,"dummy"
"190181",0,0,4,4,"dummy"
"190182",0,0,0,0,"dummy"
"190183",0,0,1,1,"dummy"
"190184",0,0,1,1,"dummy"
"190190",0,1,0,1,"dummy"
"190191",0,9,0,9,"dummy"
"190192",8,2,2,12,"dummy"
"190193",0,1,0,1,"dummy"
"190194",0,1,0,1,"dummy"
"190195",0,2,0,2,"dummy"
"190200",0,0,1,1,"dummy"
"190204",0,2,0,2,"dummy"
"190208",0,0,1,1,"dummy"
"190210",2,1,0,3,"dummy"
"190211",15,2,1,18,"dummy"
"190212",2,1,0,3,"dummy"
"190213",0,0,1,1,"dummy"
"190214",0,0,3,3,"dummy"
"190215",0,0,1,1,"dummy"
"190216",1,0,0,1,"dummy"
"190217",0,0,1,1,"dummy"
"190218",0,0,3,3,"dummy"
"190219",5,5,0,10,"dummy"
"190220",6,3,0,9,"dummy"
"190221",0,1,0,1,"dummy"
"190222",0,0,1,1,"dummy"
"190223",0,1,1,2,"dummy"
"190224",5,5,0,10,"dummy"
"190250",2,0,0,2,"dummy"
"190251",0,0,0,0,"dummy"
"190258",0,0,1,1,"dummy"
"190266",11,18,4,33,"dummy"
"190267",3,0,0,3,"dummy"
"190268",3,1,3,7,"dummy"
"190269",0,0,2,2,"dummy"
"190270",0,0,0,0,"dummy"
"190271",2,50,1,53,"dummy"
"190272",18,14,13,45,"dummy"
"190273",14,6,1,21,"dummy"
"190274",0,1,0,1,"dummy"
"190275",0,0,0,0,"dummy"
"190276",0,0,0,0,"dummy"
"190277",10,6,2,18,"dummy"
"190302",0,2,0,2,"dummy"
"190303",0,0,1,1,"dummy"
"190304",0,0,1,1,"dummy"
"190305",0,0,1,1,"dummy"
"190306",10,2,0,12,"dummy"
"190307",2,10,0,12,"dummy"
"190308",0,1,1,2,"dummy"
"190309",0,1,0,1,"dummy"
"190320",0,0,0,0,"dummy"
"190332",0,1,0,1,"dummy"
"190333",0,1,0,1,"dummy"
"190334",0,0,1,1,"dummy"
"190339",0,2,0,2,"dummy"
"190352",0,7,1,8,"dummy"
"190356",1,0,0,1,"dummy"
"190365",0,1,0,1,"dummy"
"190368",0,2,0,2,"dummy"
"190371",0,0,1,1,"dummy"
"190372",0,0,1,1,"dummy"
"190373",0,0,2,2,"dummy"
"190374",26,3,7,36,"dummy"
"190387",0,2,0,2,"dummy"
"190388",0,4,0,4,"dummy"
"190393",0,1,0,1,"dummy"
"190394",0,1,0,1,"dummy"
"190395",6,6,2,14,"dummy"
"190396",0,1,0,1,"dummy"
"190399",0,0,3,3,"dummy"
"190400",3,18,0,21,"dummy"
"190401",1,1,2,4,"dummy"
"190402",2,0,0,2,"dummy"
"190403",0,6,0,6,"dummy"
"190404",0,2,0,2,"dummy"
"190405",1,0,1,2,"dummy"
"190413",0,0,4,4,"dummy"
"190414",1,0,1,2,"dummy"
"190415",47,0,4,51,"dummy"
"190416",0,0,2,2,"dummy"
"190421",0,0,0,0,"dummy"
"190441",0,0,0,0,"dummy"
"190442",0,0,0,0,"dummy"
"190443",0,0,0,0,"dummy"
"190444",0,0,0,0,"dummy"
"190228",0,0,4,4,"dummy"
"190229",0,0,0,0,"dummy"
"190230",0,0,0,0,"dummy"
"190233",0,0,5,5,"dummy"
"190234",0,0,1,1,"dummy"
"190235",0,0,1,1,"dummy"
"190236",2,6,1,9,"dummy"
"190237",0,0,1,1,"dummy"
"190240",6,0,0,6,"dummy"
"190241",2,5,2,9,"dummy"
"190246",0,0,0,0,"dummy"
"190247",0,0,1,1,"dummy"
"190248",0,0,0,0,"dummy"
"190260",0,0,1,1,"dummy"
"190261",0,0,1,1,"dummy"
"190264",0,1,0,1,"dummy"
"190279",11,0,3,14,"dummy"
"190280",0,1,0,1,"dummy"
"190281",0,1,0,1,"dummy"
"190284",0,2,2,4,"dummy"
"190285",0,9,5,14,"dummy"
"190292",0,1,2,3,"dummy"
"190293",2,0,0,2,"dummy"
"190294",1,1,0,2,"dummy"
"190295",2,0,0,2,"dummy"
"190296",0,0,0,0,"dummy"
"190297",0,0,0,0,"dummy"
"190298",0,1,0,1,"dummy"
"190299",0,0,0,0,"dummy"
"190300",0,2,0,2,"dummy"
"190311",2,3,0,5,"dummy"
"190312",0,3,0,3,"dummy"
"190313",1,7,0,8,"dummy"
"190314",3,0,0,3,"dummy"
"190315",0,1,0,1,"dummy"
"190316",18,18,1,37,"dummy"
"190317",0,2,0,2,"dummy"
"190318",0,8,0,8,"dummy"
"190324",0,1,2,3,"dummy"
"190325",0,0,2,2,"dummy"
"190326",0,0,1,1,"dummy"
"190329",0,5,0,5,"dummy"
"190330",0,0,0,0,"dummy"
"190336",35,16,5,56,"dummy"
"190337",0,4,0,4,"dummy"
"190341",6,0,4,10,"dummy"
"190342",0,2,0,2,"dummy"
"190343",0,0,3,3,"dummy"
"190344",0,0,2,2,"dummy"
"190354",0,0,0,0,"dummy"
"190358",6,2,2,10,"dummy"
"190359",2,0,1,3,"dummy"
"190360",0,1,0,1,"dummy"
"190361",0,1,0,1,"dummy"
"190362",1,0,0,1,"dummy"
"190363",0,0,1,1,"dummy"
"190376",0,0,1,1,"dummy"
"190377",3,4,0,7,"dummy"
"190378",0,0,1,1,"dummy"
"190379",0,0,1,1,"dummy"
"190380",0,0,1,1,"dummy"
"190381",0,1,0,1,"dummy"
"190382",0,0,1,1,"dummy"
"190383",0,0,1,1,"dummy"
"190409",0,1,0,1,"dummy"
"190418",0,0,0,0,"dummy"
"190419",0,0,0,0,"dummy"
"190423",0,0,2,2,"dummy"
"190424",0,0,1,1,"dummy"
"190425",0,0,1,1,"dummy"
"190426",0,1,0,1,"dummy"
"190427",0,0,1,1,"dummy"
"190428",0,0,0,0,"dummy"
"190429",0,0,1,1,"dummy"
"190430",0,0,0,0,"dummy"
"190431",0,0,1,1,"dummy"
"190434",10,0,3,13,"dummy"
"190435",3,0,0,3,"dummy"
"190436",0,1,0,1,"dummy"
"190437",0,1,0,1,"dummy"
"190438",0,1,0,1,"dummy"
"190439",2,4,0,6,"dummy"
"190446",13,7,3,23,"dummy"
"190447",0,0,4,4,"dummy"
"190448",0,0,1,1,"dummy"
"190449",0,0,2,2,"dummy"
"190450",2,7,3,12,"dummy"
"190451",0,0,1,1,"dummy"
"190452",1,1,0,2,"dummy"
"190453",1,1,0,2,"dummy"
"190454",0,2,0,2,"dummy"
"190455",0,0,1,1,"dummy"
"190456",0,0,1,1,"dummy"
"190457",1,0,1,2,"dummy"
"190458",0,0,1,1,"dummy"
"190463",0,0,1,1,"dummy"
"190467",0,1,0,1,"dummy"
"190471",0,0,2,2,"dummy"
"190472",0,0,1,1,"dummy"
"190476",0,5,1,6,"dummy"
"190477",0,1,0,1,"dummy"
"190478",0,1,1,2,"dummy"
"190479",2,0,0,2,"dummy"
"190481",3,0,0,3,"dummy"
"190482",0,1,0,1,"dummy"
"190483",0,3,0,3,"dummy"
"190484",0,1,0,1,"dummy"
"190487",0,1,0,1,"dummy"
"190489",0,0,3,3,"dummy"
"190490",1,0,0,1,"dummy"
"190491",1,1,3,5,"dummy"
"190495",0,1,0,1,"dummy"
"190496",1,3,0,4,"dummy"
"190499",0,3,0,3,"dummy"
"190500",0,0,2,2,"dummy"
"190501",0,0,2,2,"dummy"
"190503",2,4,0,6,"dummy"
"190504",0,2,0,2,"dummy"
"190505",0,2,0,2,"dummy"
"190506",10,2,0,12,"dummy"
"190507",0,2,0,2,"dummy"
"190510",0,0,1,1,"dummy"
"190514",0,0,1,1,"dummy"
"190515",0,0,1,1,"dummy"
"190516",0,2,0,2,"dummy"
"190517",0,1,0,1,"dummy"
"190523",4,0,1,5,"dummy"
"190524",2,0,0,2,"dummy"
"190525",2,0,1,3,"dummy"
"190526",1,8,0,9,"dummy"
"190527",0,1,0,1,"dummy"
"190528",0,0,1,1,"dummy"
"190529",0,1,0,1,"dummy"
"190530",1,0,0,1,"dummy"
"190531",9,7,0,16,"dummy"
"190532",7,4,0,11,"dummy"
"190533",0,1,0,1,"dummy"
"190545",0,1,0,1,"dummy"
"190546",2,1,1,4,"dummy"
"190548",1,4,0,5,"dummy"
"190549",48,36,2,86,"dummy"
"190550",0,6,1,7,"dummy"
"190551",1,0,0,1,"dummy"
"190561",0,3,0,3,"dummy"
"190566",0,0,1,1,"dummy"
"190567",0,0,1,1,"dummy"
"190568",0,0,1,1,"dummy"
"190569",0,0,0,0,"dummy"
"190570",0,0,1,1,"dummy"
"190571",0,0,1,1,"dummy"
"190588",5,2,0,7,"dummy"
"190589",0,1,0,1,"dummy"
"190590",0,2,0,2,"dummy"
"190591",0,1,0,1,"dummy"
"190592",1,0,0,1,"dummy"
"190593",0,0,2,2,"dummy"
"190610",0,0,1,1,"dummy"
"190613",1,0,0,1,"dummy"
"190616",0,0,0,0,"dummy"
"190618",0,0,1,1,"dummy"
"190621",2,2,1,5,"dummy"
"190622",8,8,1,17,"dummy"
"190623",0,0,2,2,"dummy"
"190624",1,6,2,9,"dummy"
"190626",2,3,2,7,"dummy"
"190634",0,8,1,9,"dummy"
"190635",0,3,3,6,"dummy"
"190636",2,12,3,17,"dummy"
"190638",0,0,1,1,"dummy"
"190639",1,2,2,5,"dummy"
"190640",0,0,1,1,"dummy"
"190641",0,3,0,3,"dummy"
"190642",0,0,0,0,"dummy"
"190643",1,1,0,2,"dummy"
"190644",1,1,1,3,"dummy"
"190645",0,0,2,2,"dummy"
"190646",0,0,1,1,"dummy"
"190650",0,1,0,1,"dummy"
"190652",2,0,0,2,"dummy"
"190653",4,1,0,5,"dummy"
"190662",3,0,5,8,"dummy"
"190664",0,1,0,1,"dummy"
"190671",0,0,1,1,"dummy"
"190672",8,4,6,18,"dummy"
"190673",0,0,1,1,"dummy"
"190674",5,0,0,5,"dummy"
"190675",0,0,1,1,"dummy"
"190677",1,0,0,1,"dummy"
"190685",2,0,1,3,"dummy"
"190686",0,1,1,2,"dummy"
"190687",0,0,1,1,"dummy"
"190688",0,0,0,0,"dummy"
"190689",0,0,0,0,"dummy"
"190690",0,0,0,0,"dummy"
"190692",5,21,0,26,"dummy"
"190693",0,4,0,4,"dummy"
"190694",19,1,0,20,"dummy"
"190698",5,4,0,9,"dummy"
"190699",0,0,0,0,"dummy"
"190700",0,0,2,2,"dummy"
"190701",4,4,0,8,"dummy"
"190702",0,0,1,1,"dummy"
"190703",0,0,1,1,"dummy"
"190704",1,1,2,4,"dummy"
"190705",0,0,1,1,"dummy"
"190707",0,2,0,2,"dummy"
"190708",5,5,1,11,"dummy"
"190709",0,0,2,2,"dummy"
"190710",0,0,1,1,"dummy"
"190712",1,1,0,2,"dummy"
"190713",1,6,1,8,"dummy"
"190726",8,8,3,19,"dummy"
"190728",10,0,3,13,"dummy"
"190729",5,1,0,6,"dummy"
"190731",0,0,0,0,"dummy"
"190733",2,0,0,2,"dummy"
"190734",0,0,1,1,"dummy"
"190735",1,11,2,14,"dummy"
"190736",2,0,2,4,"dummy"
"190737",0,2,1,3,"dummy"
"190738",0,0,1,1,"dummy"
"190739",0,0,2,2,"dummy"
"190740",0,3,0,3,"dummy"
"190741",0,0,2,2,"dummy"
"190742",0,0,3,3,"dummy"
"190749",1,10,0,11,"dummy"
"190752",2,1,1,4,"dummy"
"190753",0,0,1,1,"dummy"
"190757",0,4,0,4,"dummy"
"190758",0,0,1,1,"dummy"
"190759",0,2,0,2,"dummy"
"190760",0,0,1,1,"dummy"
"190761",1,2,1,4,"dummy"
"190762",0,2,0,2,"dummy"
"190763",0,1,0,1,"dummy"
"190764",3,0,2,5,"dummy"
"190765",0,0,1,1,"dummy"
"190771",0,3,0,3,"dummy"
"190774",0,0,2,2,"dummy"
"190775",0,0,1,1,"dummy"
"190776",0,0,1,1,"dummy"
"190777",0,0,1,1,"dummy"
"190778",0,0,1,1,"dummy"
"190779",0,0,1,1,"dummy"
"190780",4,6,0,10,"dummy"
"190781",0,1,0,1,"dummy"
"190782",0,0,2,2,"dummy"
"190783",0,0,1,1,"dummy"
"190784",0,0,2,2,"dummy"
"190785",0,0,1,1,"dummy"
"190786",0,0,4,4,"dummy"
"190787",0,0,1,1,"dummy"
"190790",0,4,0,4,"dummy"
"190791",0,1,0,1,"dummy"
"190792",0,1,0,1,"dummy"
"190793",0,1,0,1,"dummy"
"190796",6,0,2,8,"dummy"
"190797",0,1,0,1,"dummy"
"190800",0,0,1,1,"dummy"
"190802",2,4,0,6,"dummy"
"190803",0,2,0,2,"dummy"
"190804",0,2,0,2,"dummy"
"190805",10,2,0,12,"dummy"
"190806",0,2,0,2,"dummy"
"190810",0,1,0,1,"dummy"
"190811",0,9,0,9,"dummy"
"190816",0,0,1,1,"dummy"
"190837",0,0,1,1,"dummy"
"190839",6,0,0,6,"dummy"
"190840",2,5,2,9,"dummy"
"190846",9,0,3,12,"dummy"
"190847",1,0,0,1,"dummy"
"190849",0,0,1,1,"dummy"
"190850",0,1,0,1,"dummy"
"190851",0,0,1,1,"dummy"
"190852",0,0,1,1,"dummy"
"190853",0,0,1,1,"dummy"
"190854",0,0,1,1,"dummy"
"190855",2,0,1,3,"dummy"
"190856",0,0,1,1,"dummy"
"190857",0,0,1,1,"dummy"
"190858",0,0,1,1,"dummy"
"190859",0,0,1,1,"dummy"
"190862",0,0,0,0,"dummy"
"190863",0,0,1,1,"dummy"
"190864",0,0,1,1,"dummy"
"190865",0,0,1,1,"dummy"
"190866",0,0,1,1,"dummy"
"190867",0,0,1,1,"dummy"
"190868",0,0,1,1,"dummy"
"190869",0,0,1,1,"dummy"
"190870",0,0,1,1,"dummy"
"190871",0,0,1,1,"dummy"
"190872",0,0,1,1,"dummy"
"190873",0,0,1,1,"dummy"
"190874",0,0,1,1,"dummy"
"190875",4,9,0,13,"dummy"
"190876",0,0,1,1,"dummy"
"190877",4,6,0,10,"dummy"
"190878",0,0,1,1,"dummy"
"190880",0,1,0,1,"dummy"
"190881",0,2,0,2,"dummy"
"190882",0,0,1,1,"dummy"
"190883",0,0,1,1,"dummy"
"190885",2,2,1,5,"dummy"
"190886",0,0,1,1,"dummy"
"190887",0,1,0,1,"dummy"
"190889",0,0,1,1,"dummy"
"190890",0,0,1,1,"dummy"
"190893",4,3,4,11,"dummy"
"190894",0,0,1,1,"dummy"
"190897",0,0,2,2,"dummy"
"190898",0,0,0,0,"dummy"
"190899",0,2,0,2,"dummy"
"190900",0,1,0,1,"dummy"
"190905",0,4,0,4,"dummy"
"190907",0,6,2,8,"dummy"
"190908",2,3,0,5,"dummy"
"190909",1,4,1,6,"dummy"
"190910",0,0,2,2,"dummy"
"190911",2,3,3,8,"dummy"
"190912",0,1,0,1,"dummy"
"190914",0,1,0,1,"dummy"
"190917",0,1,2,3,"dummy"
"190918",13,13,5,31,"dummy"
"190919",4,2,0,6,"dummy"
"190920",7,1,1,9,"dummy"
"190922",5,9,1,15,"dummy"
"190925",4,9,4,17,"dummy"
"190927",1,2,0,3,"dummy"
"190928",4,6,0,10,"dummy"
"190929",0,3,0,3,"dummy"
"190931",0,0,0,0,"dummy"
"190933",0,0,1,1,"dummy"
"190934",0,0,1,1,"dummy"
"190935",0,0,1,1,"dummy"
"190936",0,0,1,1,"dummy"
"190937",0,0,1,1,"dummy"
"190939",0,0,1,1,"dummy"
"190941",0,0,0,0,"dummy"
"190942",1,0,0,1,"dummy"
"190943",0,0,1,1,"dummy"
"190944",2,0,0,2,"dummy"
"190945",0,3,0,3,"dummy"
"190946",0,0,1,1,"dummy"
"190947",0,0,0,0,"dummy"
"190948",0,0,0,0,"dummy"
"190949",6,2,0,8,"dummy"
"190950",2,0,0,2,"dummy"
"190951",0,0,0,0,"dummy"
"190952",0,0,0,0,"dummy"
"190953",0,0,1,1,"dummy"
"190956",2,1,0,3,"dummy"
"190957",3,1,1,5,"dummy"
"190958",0,1,0,1,"dummy"
"190964",2,2,0,4,"dummy"
"190966",1,0,0,1,"dummy"
"190967",1,0,1,2,"dummy"
"190968",0,0,1,1,"dummy"
"190969",0,0,1,1,"dummy"
"190970",0,0,1,1,"dummy"
"190971",0,0,1,1,"dummy"
"190972",0,0,1,1,"dummy"
"190973",0,0,1,1,"dummy"
"190974",0,0,1,1,"dummy"
"190975",0,0,1,1,"dummy"
"190976",0,0,1,1,"dummy"
"190977",0,0,1,1,"dummy"
"190978",0,0,1,1,"dummy"
"190979",0,0,1,1,"dummy"
"190980",0,0,1,1,"dummy"
"190981",0,0,1,1,"dummy"
"190982",0,0,1,1,"dummy"
"190983",0,0,1,1,"dummy"
"190984",0,0,1,1,"dummy"
"190985",0,0,1,1,"dummy"
"190986",0,0,1,1,"dummy"
"190987",0,0,1,1,"dummy"
"190988",0,0,1,1,"dummy"
"190989",0,0,1,1,"dummy"
"190990",0,0,1,1,"dummy"
"190991",0,0,1,1,"dummy"
"190992",0,0,1,1,"dummy"
"190993",0,0,1,1,"dummy"
"190994",0,0,0,0,"dummy"
"190995",0,1,1,2,"dummy"
"190997",4,7,1,12,"dummy"
"191000",1,0,2,3,"dummy"
"191001",0,3,2,5,"dummy"
"191002",0,1,0,1,"dummy"
"191004",0,1,1,2,"dummy"
"191005",0,7,0,7,"dummy"
"191006",0,0,0,0,"dummy"
"191007",0,0,0,0,"dummy"
"191008",0,1,0,1,"dummy"
"191009",0,0,0,0,"dummy"
"191016",0,0,1,1,"dummy"
"191017",4,5,2,11,"dummy"
"191018",0,0,3,3,"dummy"
"191019",2,0,0,2,"dummy"
"191020",3,0,1,4,"dummy"
"191022",0,4,0,4,"dummy"
"191023",2,1,1,4,"dummy"
"191024",0,0,0,0,"dummy"
"191025",0,0,2,2,"dummy"
"191026",0,2,0,2,"dummy"
"191028",0,0,1,1,"dummy"
"191030",0,9,0,9,"dummy"
"191033",0,0,1,1,"dummy"
"191056",0,10,0,10,"dummy"
"191057",0,0,5,5,"dummy"
"191058",0,0,0,0,"dummy"
"191065",1,1,0,2,"dummy"
"191066",0,1,0,1,"dummy"
"191067",3,3,2,8,"dummy"
"191068",0,1,0,1,"dummy"
"191071",2,3,1,6,"dummy"
"191072",0,0,3,3,"dummy"
"191073",0,1,1,2,"dummy"
"191074",2,2,0,4,"dummy"
"191075",0,0,1,1,"dummy"
"191077",3,7,0,10,"dummy"
"191078",0,1,0,1,"dummy"
"191085",6,0,0,6,"dummy"
"191086",2,5,2,9,"dummy"
"191107",0,9,3,12,"dummy"
"191112",0,0,1,1,"dummy"
"191121",0,0,0,0,"dummy"
"191122",0,0,0,0,"dummy"
"191123",0,3,0,3,"dummy"
"191124",0,0,0,0,"dummy"
"191128",0,0,1,1,"dummy"
"191168",0,13,0,13,"dummy"
"191169",0,1,0,1,"dummy"
"191186",0,0,2,2,"dummy"
"191194",0,0,1,1,"dummy"
"191195",12,13,6,31,"dummy"
"191198",0,0,1,1,"dummy"
"191199",1,5,0,6,"dummy"
"191200",7,18,5,30,"dummy"
"191208",1,0,0,1,"dummy"
"191215",1,7,1,9,"dummy"
"191216",0,0,1,1,"dummy"
"191217",2,2,2,6,"dummy"
"191218",0,1,2,3,"dummy"
"191219",2,2,1,5,"dummy"
"191220",0,2,0,2,"dummy"
"191221",0,0,1,1,"dummy"
"191278",2,6,1,9,"dummy"
"191279",2,5,3,10,"dummy"
"191280",0,0,0,0,"dummy"
"191281",0,0,2,2,"dummy"
"191282",0,0,1,1,"dummy"
"191283",0,0,1,1,"dummy"
"191284",0,0,1,1,"dummy"
"191285",0,0,1,1,"dummy"
"191286",0,0,1,1,"dummy"
"191287",0,0,0,0,"dummy"
"191288",0,0,1,1,"dummy"
"191289",2,0,0,2,"dummy"
"191290",0,0,1,1,"dummy"
"191291",3,0,2,5,"dummy"
"191292",0,10,0,10,"dummy"
"191293",0,1,0,1,"dummy"
"191301",0,1,0,1,"dummy"
"191302",0,0,1,1,"dummy"
"191303",0,0,1,1,"dummy"
"191304",0,0,2,2,"dummy"
"191305",0,0,2,2,"dummy"
"191306",0,0,2,2,"dummy"
"191307",0,0,1,1,"dummy"
"191308",0,0,1,1,"dummy"
"191309",0,0,2,2,"dummy"
"191310",0,0,2,2,"dummy"
"191311",0,0,1,1,"dummy"
"191312",0,0,1,1,"dummy"
"191317",0,2,0,2,"dummy"
"191318",0,0,0,0,"dummy"
"191328",0,2,0,2,"dummy"
"191331",0,0,1,1,"dummy"
"191332",0,0,1,1,"dummy"
"191080",3,5,1,9,"dummy"
"191081",0,0,4,4,"dummy"
"191088",0,2,0,2,"dummy"
"191089",22,0,2,24,"dummy"
"191090",1,0,0,1,"dummy"
"191091",0,4,0,4,"dummy"
"191130",2,12,0,14,"dummy"
"191166",3,3,0,6,"dummy"
"191173",0,2,0,2,"dummy"
"191174",0,5,6,11,"dummy"
"191175",0,0,4,4,"dummy"
"191182",0,3,0,3,"dummy"
"191183",0,0,1,1,"dummy"
"191184",6,6,0,12,"dummy"
"191188",0,3,1,4,"dummy"
"191189",3,1,1,5,"dummy"
"191190",1,1,0,2,"dummy"
"191202",0,2,0,2,"dummy"
"191203",0,1,0,1,"dummy"
"191204",1,6,2,9,"dummy"
"191205",2,2,0,4,"dummy"
"191206",0,0,0,0,"dummy"
"191210",0,3,0,3,"dummy"
"191211",0,18,0,18,"dummy"
"191212",14,27,3,44,"dummy"
"191213",2,7,0,9,"dummy"
"191223",3,1,0,4,"dummy"
"191236",0,2,0,2,"dummy"
"191237",0,1,2,3,"dummy"
"191238",0,8,1,9,"dummy"
"191239",0,2,0,2,"dummy"
"191240",2,0,0,2,"dummy"
"191241",0,2,0,2,"dummy"
"191242",0,2,0,2,"dummy"
"191243",0,1,0,1,"dummy"
"191244",1,0,0,1,"dummy"
"191245",12,4,1,17,"dummy"
"191246",0,0,4,4,"dummy"
"191247",2,8,2,12,"dummy"
"191248",1,0,0,1,"dummy"
"191249",0,0,0,0,"dummy"
"191250",1,1,0,2,"dummy"
"191251",1,0,0,1,"dummy"
"191252",0,0,4,4,"dummy"
"191253",0,0,4,4,"dummy"
"191254",0,0,4,4,"dummy"
"191255",0,0,4,4,"dummy"
"191256",0,2,0,2,"dummy"
"191257",0,0,4,4,"dummy"
"191258",0,0,1,1,"dummy"
"191259",0,1,5,6,"dummy"
"191260",0,0,1,1,"dummy"
"191261",0,0,1,1,"dummy"
"191262",0,0,2,2,"dummy"
"191263",0,0,1,1,"dummy"
"191264",0,0,2,2,"dummy"
"191265",0,0,1,1,"dummy"
"191266",0,0,1,1,"dummy"
"191267",0,0,1,1,"dummy"
"191270",0,0,0,0,"dummy"
"191273",0,1,0,1,"dummy"
"191274",0,8,0,8,"dummy"
"191275",0,2,0,2,"dummy"
"191276",0,2,0,2,"dummy"
"191295",0,0,0,0,"dummy"
"191296",0,1,0,1,"dummy"
"191297",0,0,0,0,"dummy"
"191298",0,0,1,1,"dummy"
"191299",0,0,2,2,"dummy"
"191314",1,17,0,18,"dummy"
"191315",0,7,0,7,"dummy"
"191322",1,1,0,2,"dummy"
"191323",5,5,1,11,"dummy"
"191324",0,1,0,1,"dummy"
"191337",0,5,0,5,"dummy"
"191338",0,3,0,3,"dummy"
"191339",0,1,0,1,"dummy"
"191340",1,1,0,2,"dummy"
"191341",2,0,0,2,"dummy"
"191350",4,5,1,10,"dummy"
"191351",0,0,0,0,"dummy"
"191357",0,2,0,2,"dummy"
"191358",1,0,0,1,"dummy"
"191367",0,1,0,1,"dummy"
"191374",3,5,2,10,"dummy"
"191375",13,5,3,21,"dummy"
"191379",2,2,0,4,"dummy"
"191386",1,0,0,1,"dummy"
"191387",0,1,0,1,"dummy"
"191388",0,0,1,1,"dummy"
"191389",1,1,0,2,"dummy"
"191397",1,2,0,3,"dummy"
"191406",1,0,0,1,"dummy"
"191407",0,2,0,2,"dummy"
"191416",0,0,0,0,"dummy"
"191417",0,0,1,1,"dummy"
"191418",0,0,0,0,"dummy"
"191440",0,2,1,3,"dummy"
"191449",4,4,2,10,"dummy"
"191450",0,0,1,1,"dummy"
"191451",0,0,1,1,"dummy"
"191452",2,0,0,2,"dummy"
"191453",4,9,0,13,"dummy"
"191454",2,1,0,3,"dummy"
"191455",2,0,0,2,"dummy"
"191471",2,0,0,2,"dummy"
"191472",0,1,0,1,"dummy"
"191473",2,0,1,3,"dummy"
"191474",0,1,0,1,"dummy"
"191475",0,0,1,1,"dummy"
"191476",0,2,0,2,"dummy"
"191477",0,1,0,1,"dummy"
"191478",0,8,0,8,"dummy"
"191481",6,6,1,13,"dummy"
"191484",0,1,0,1,"dummy"
"191501",0,1,0,1,"dummy"
"191502",6,11,3,20,"dummy"
"191503",6,2,2,10,"dummy"
"191504",1,1,0,2,"dummy"
"191507",2,4,0,6,"dummy"
"191508",0,2,0,2,"dummy"
"191509",0,2,0,2,"dummy"
"191510",10,2,0,12,"dummy"
"191511",0,2,0,2,"dummy"
"191560",1,1,0,2,"dummy"
"191561",0,0,3,3,"dummy"
"191562",0,1,0,1,"dummy"
"191563",2,9,0,11,"dummy"
"191564",1,5,1,7,"dummy"
"191568",1,0,0,1,"dummy"
"191569",0,0,1,1,"dummy"
"191335",0,0,2,2,"dummy"
"191353",0,0,3,3,"dummy"
"191354",0,2,0,2,"dummy"
"191355",0,1,0,1,"dummy"
"191365",5,0,0,5,"dummy"
"191371",0,1,0,1,"dummy"
"191372",0,3,0,3,"dummy"
"191377",0,0,1,1,"dummy"
"191381",0,0,3,3,"dummy"
"191384",0,4,0,4,"dummy"
"191391",0,2,1,3,"dummy"
"191392",0,3,2,5,"dummy"
"191393",0,0,2,2,"dummy"
"191394",0,0,2,2,"dummy"
"191395",0,0,2,2,"dummy"
"191409",11,3,0,14,"dummy"
"191410",2,1,0,3,"dummy"
"191411",0,0,0,0,"dummy"
"191412",0,0,0,0,"dummy"
"191413",0,0,1,1,"dummy"
"191414",0,0,0,0,"dummy"
"191442",0,1,0,1,"dummy"
"191443",0,2,0,2,"dummy"
"191446",2,2,0,4,"dummy"
"191447",1,0,0,1,"dummy"
"191459",0,0,1,1,"dummy"
"191460",0,0,1,1,"dummy"
"191461",0,1,2,3,"dummy"
"191462",0,0,0,0,"dummy"
"191463",0,1,0,1,"dummy"
"191464",1,0,0,1,"dummy"
"191465",1,0,2,3,"dummy"
"191466",0,0,1,1,"dummy"
"191467",0,0,1,1,"dummy"
"191468",0,3,0,3,"dummy"
"191469",0,1,0,1,"dummy"
"191486",0,0,5,5,"dummy"
"191487",0,4,0,4,"dummy"
"191490",1,0,0,1,"dummy"
"191493",0,0,0,0,"dummy"
"191498",0,0,1,1,"dummy"
"191499",0,0,1,1,"dummy"
"191513",2,4,0,6,"dummy"
"191514",0,2,0,2,"dummy"
"191515",0,2,0,2,"dummy"
"191516",10,2,0,12,"dummy"
"191517",0,2,0,2,"dummy"
"191518",0,0,0,0,"dummy"
"191521",0,0,2,2,"dummy"
"191522",0,0,1,1,"dummy"
"191523",1,27,2,30,"dummy"
"191524",6,11,0,17,"dummy"
"191525",0,1,0,1,"dummy"
"191526",0,3,0,3,"dummy"
"191527",7,25,0,32,"dummy"
"191528",3,6,0,9,"dummy"
"191529",28,5,1,34,"dummy"
"191530",1,1,0,2,"dummy"
"191531",0,1,0,1,"dummy"
"191532",0,0,1,1,"dummy"
"191533",1,1,0,2,"dummy"
"191534",0,0,0,0,"dummy"
"191549",0,0,2,2,"dummy"
"191550",0,0,1,1,"dummy"
"191551",0,0,1,1,"dummy"
"191552",0,0,1,1,"dummy"
"191555",0,0,0,0,"dummy"
"191556",0,0,0,0,"dummy"
"191557",0,0,1,1,"dummy"
"191558",5,5,0,10,"dummy"
"191570",0,0,1,1,"dummy"
"191571",1,6,2,9,"dummy"
"191572",1,0,0,1,"dummy"
"191573",0,0,1,1,"dummy"
"191574",1,2,1,4,"dummy"
"191577",0,9,0,9,"dummy"
"191585",1,3,2,6,"dummy"
"191586",0,0,1,1,"dummy"
"191587",0,2,1,3,"dummy"
"191588",0,2,1,3,"dummy"
"191589",0,2,1,3,"dummy"
"191599",0,0,1,1,"dummy"
"191613",0,7,4,11,"dummy"
"191614",0,2,0,2,"dummy"
"191615",9,1,4,14,"dummy"
"191616",2,9,4,15,"dummy"
"191617",3,4,0,7,"dummy"
"191618",0,1,0,1,"dummy"
"191619",0,1,0,1,"dummy"
"191620",0,0,0,0,"dummy"
"191621",0,1,0,1,"dummy"
"191622",1,0,0,1,"dummy"
"191623",0,1,0,1,"dummy"
"191624",0,1,0,1,"dummy"
"191625",0,0,1,1,"dummy"
"191626",0,0,2,2,"dummy"
"191627",0,1,2,3,"dummy"
"191628",1,0,3,4,"dummy"
"191629",1,4,3,8,"dummy"
"191630",0,2,0,2,"dummy"
"191631",1,0,0,1,"dummy"
"191632",0,1,0,1,"dummy"
"191633",1,2,0,3,"dummy"
"191634",0,0,1,1,"dummy"
"191635",3,1,0,4,"dummy"
"191676",0,0,1,1,"dummy"
"191677",0,1,0,1,"dummy"
"191581",3,2,0,5,"dummy"
"191582",0,3,2,5,"dummy"
"191583",0,0,0,0,"dummy"
"191591",0,0,1,1,"dummy"
"191596",0,1,0,1,"dummy"
"191597",0,0,0,0,"dummy"
"191601",0,0,1,1,"dummy"
"191604",0,6,1,7,"dummy"
"191605",0,1,0,1,"dummy"
"191606",0,0,0,0,"dummy"
"191607",0,0,1,1,"dummy"
"191608",0,0,0,0,"dummy"
"191609",0,5,6,11,"dummy"
"191610",0,0,1,1,"dummy"
"191611",0,0,0,0,"dummy"
"191686",1,1,0,2,"dummy"
"191689",0,2,0,2,"dummy"
"191691",1,1,0,2,"dummy"
"191692",0,3,1,4,"dummy"
"191694",0,0,1,1,"dummy"
"191695",0,2,0,2,"dummy"
"191703",1,4,0,5,"dummy"
"191704",4,1,0,5,"dummy"
"191705",1,4,0,5,"dummy"
"191707",8,1,0,9,"dummy"
"191708",0,4,0,4,"dummy"
"191709",0,0,1,1,"dummy"
"191710",1,2,0,3,"dummy"
"191711",0,5,0,5,"dummy"
"191712",0,1,0,1,"dummy"
"191717",0,2,0,2,"dummy"
"191720",0,0,1,1,"dummy"
"191726",26,1,0,27,"dummy"
"191727",0,0,1,1,"dummy"
"191728",0,0,0,0,"dummy"
"191729",0,0,2,2,"dummy"
"191731",0,1,0,1,"dummy"
"191732",2,5,1,8,"dummy"
"191733",6,3,0,9,"dummy"
"191734",0,0,1,1,"dummy"
"191735",0,1,0,1,"dummy"
"191736",0,1,0,1,"dummy"
"191737",0,0,0,0,"dummy"
"191743",0,0,1,1,"dummy"
"191744",0,3,0,3,"dummy"
"191745",0,1,0,1,"dummy"
"191746",1,2,0,3,"dummy"
"191747",0,0,2,2,"dummy"
"191750",6,0,0,6,"dummy"
"191751",0,3,0,3,"dummy"
"191754",0,7,5,12,"dummy"
"191755",0,5,0,5,"dummy"
"191756",0,21,0,21,"dummy"
"191759",1,2,0,3,"dummy"
"191760",0,1,0,1,"dummy"
"191761",0,3,1,4,"dummy"
"191764",0,0,0,0,"dummy"
"191765",0,0,0,0,"dummy"
"191767",0,1,0,1,"dummy"
"191771",0,5,0,5,"dummy"
"191781",5,7,2,14,"dummy"
"191782",8,3,1,12,"dummy"
"191783",0,2,0,2,"dummy"
"191784",0,0,1,1,"dummy"
"191785",0,1,0,1,"dummy"
"191786",0,8,0,8,"dummy"
"191787",0,0,1,1,"dummy"
"191788",0,1,0,1,"dummy"
"191789",0,1,0,1,"dummy"
"191790",0,0,1,1,"dummy"
"191791",13,3,0,16,"dummy"
"191792",0,1,0,1,"dummy"
"191793",1,4,0,5,"dummy"
"191827",0,0,1,1,"dummy"
"191828",0,0,1,1,"dummy"
"191829",0,0,1,1,"dummy"
"191832",0,0,1,1,"dummy"
"191833",0,2,0,2,"dummy"
"191835",0,1,2,3,"dummy"
"191837",0,5,1,6,"dummy"
"191838",0,0,1,1,"dummy"
"191840",0,0,1,1,"dummy"
"191841",0,0,1,1,"dummy"
"191863",0,0,0,0,"dummy"
"191864",0,0,0,0,"dummy"
"191925",3,0,0,3,"dummy"
"191926",4,0,0,4,"dummy"
"191927",1,5,1,7,"dummy"
"191929",0,0,3,3,"dummy"
"191930",1,5,0,6,"dummy"
"191932",3,2,0,5,"dummy"
"191933",0,15,0,15,"dummy"
"191934",1,0,0,1,"dummy"
"191935",5,2,0,7,"dummy"
"191936",0,0,0,0,"dummy"
"191937",3,3,0,6,"dummy"
"191938",0,1,0,1,"dummy"
"191939",0,1,0,1,"dummy"
"191940",0,0,1,1,"dummy"
"191941",4,1,0,5,"dummy"
"191942",0,0,1,1,"dummy"
"191943",1,4,0,5,"dummy"
"191944",0,0,2,2,"dummy"
"191945",2,2,1,5,"dummy"
"191946",1,3,1,5,"dummy"
"191947",0,0,2,2,"dummy"
"191948",0,3,4,7,"dummy"
"191949",4,2,0,6,"dummy"
"191950",8,2,0,10,"dummy"
"191951",0,0,1,1,"dummy"
"191952",7,0,0,7,"dummy"
"191953",0,0,0,0,"dummy"
"191954",1,0,0,1,"dummy"
"191955",0,7,0,7,"dummy"
"191956",0,2,0,2,"dummy"
"191957",0,13,0,13,"dummy"
"191958",0,0,1,1,"dummy"
"191959",0,1,0,1,"dummy"
"191960",0,3,0,3,"dummy"
"191961",0,2,0,2,"dummy"
"191962",0,1,0,1,"dummy"
"191963",0,0,0,0,"dummy"
"191964",0,0,0,0,"dummy"
"191965",0,3,0,3,"dummy"
"191966",0,1,0,1,"dummy"
"191967",14,0,0,14,"dummy"
"191968",2,1,0,3,"dummy"
"191969",0,1,0,1,"dummy"
"191970",0,1,0,1,"dummy"
"191971",1,0,0,1,"dummy"
"191972",0,1,0,1,"dummy"
"191973",1,0,0,1,"dummy"
"191974",2,0,0,2,"dummy"
"191978",0,1,0,1,"dummy"
"191979",0,1,0,1,"dummy"
"191980",0,1,0,1,"dummy"
"191981",0,3,0,3,"dummy"
"191982",0,1,0,1,"dummy"
"191983",0,2,0,2,"dummy"
"191984",2,4,0,6,"dummy"
"191985",2,3,1,6,"dummy"
"191986",0,1,0,1,"dummy"
"191988",1,0,1,2,"dummy"
"191989",0,2,0,2,"dummy"
"191990",0,1,0,1,"dummy"
"191991",0,1,0,1,"dummy"
"191992",0,1,0,1,"dummy"
"191993",0,0,0,0,"dummy"
"191995",8,51,3,62,"dummy"
"191996",1,6,1,8,"dummy"
"191997",0,0,1,1,"dummy"
"191998",2,2,0,4,"dummy"
"191999",2,2,0,4,"dummy"
"192000",0,1,0,1,"dummy"
"192001",9,12,4,25,"dummy"
"192002",0,13,0,13,"dummy"
"192003",9,7,5,21,"dummy"
"192004",0,0,1,1,"dummy"
"192009",0,5,0,5,"dummy"
"192014",0,2,0,2,"dummy"
"192015",0,0,0,0,"dummy"
"192016",0,1,0,1,"dummy"
"192017",0,2,0,2,"dummy"
"192018",0,4,0,4,"dummy"
"192019",0,0,1,1,"dummy"
"192020",0,0,1,1,"dummy"
"192021",0,2,0,2,"dummy"
"192022",0,0,1,1,"dummy"
"192030",1,0,0,1,"dummy"
"192031",0,1,0,1,"dummy"
"192032",1,10,0,11,"dummy"
"192033",0,1,0,1,"dummy"
"192034",0,0,0,0,"dummy"
"192035",0,1,0,1,"dummy"
"192036",0,0,0,0,"dummy"
"192037",0,0,0,0,"dummy"
"192038",0,0,1,1,"dummy"
"192039",0,0,1,1,"dummy"
"192040",0,0,3,3,"dummy"
"192041",0,1,0,1,"dummy"
"192042",15,4,1,20,"dummy"
"192043",0,1,0,1,"dummy"
"192044",0,1,0,1,"dummy"
"192045",0,3,0,3,"dummy"
"192046",11,2,0,13,"dummy"
"192047",0,0,0,0,"dummy"
"192048",0,0,1,1,"dummy"
"192051",0,0,2,2,"dummy"
"192052",0,4,3,7,"dummy"
"192053",0,0,3,3,"dummy"
"192054",0,1,3,4,"dummy"
"192055",0,2,0,2,"dummy"
"192056",0,3,0,3,"dummy"
"192058",0,0,1,1,"dummy"
"192059",2,1,0,3,"dummy"
"192062",0,0,0,0,"dummy"
"192063",0,3,1,4,"dummy"
"192064",1,2,0,3,"dummy"
"192065",0,0,0,0,"dummy"
"192066",0,0,0,0,"dummy"
"192067",0,0,0,0,"dummy"
"192068",0,0,0,0,"dummy"
"192069",0,2,0,2,"dummy"
"192070",0,0,0,0,"dummy"
"192071",6,2,0,8,"dummy"
"192072",0,4,0,4,"dummy"
"192073",0,0,0,0,"dummy"
"192074",1,1,0,2,"dummy"
"192075",0,0,0,0,"dummy"
"192076",0,1,0,1,"dummy"
"192077",0,0,0,0,"dummy"
"192078",0,0,0,0,"dummy"
"192079",4,0,1,5,"dummy"
"192080",0,1,0,1,"dummy"
"192081",0,0,1,1,"dummy"
"192082",0,1,1,2,"dummy"
"192083",0,0,0,0,"dummy"
"192084",0,0,0,0,"dummy"
"192085",0,1,0,1,"dummy"
"192086",0,10,0,10,"dummy"
"192087",0,0,1,1,"dummy"
"192088",0,1,1,2,"dummy"
"192089",1,0,2,3,"dummy"
"192090",0,1,0,1,"dummy"
"192091",1,0,0,1,"dummy"
"192092",0,1,0,1,"dummy"
"192093",1,0,0,1,"dummy"
"192094",13,1,2,16,"dummy"
"192095",1,13,2,16,"dummy"
"192096",12,1,2,15,"dummy"
"192097",0,0,0,0,"dummy"
"192098",0,5,1,6,"dummy"
"192099",3,10,2,15,"dummy"
"192100",5,1,2,8,"dummy"
"192101",1,4,1,6,"dummy"
"192102",0,1,0,1,"dummy"
"192104",0,11,2,13,"dummy"
"192105",0,0,1,1,"dummy"
"192106",0,4,1,5,"dummy"
"192107",0,0,0,0,"dummy"
"192108",4,1,0,5,"dummy"
"192109",1,4,0,5,"dummy"
"192110",0,2,1,3,"dummy"
"192111",2,8,0,10,"dummy"
"192112",0,1,0,1,"dummy"
"192113",0,2,1,3,"dummy"
"192114",1,0,2,3,"dummy"
"192115",0,0,0,0,"dummy"
"192116",0,0,2,2,"dummy"
"192118",1,3,0,4,"dummy"
"192119",4,0,0,4,"dummy"
"192129",0,0,1,1,"dummy"
"192130",0,0,1,1,"dummy"
"192132",2,2,1,5,"dummy"
"192134",0,0,3,3,"dummy"
"192144",2,4,0,6,"dummy"
"192148",5,0,0,5,"dummy"
"192149",1,0,0,1,"dummy"
"192150",0,0,1,1,"dummy"
"192151",2,4,0,6,"dummy"
"192152",0,4,0,4,"dummy"
"192160",0,0,1,1,"dummy"
"192176",0,3,0,3,"dummy"
"192178",8,35,4,47,"dummy"
"192179",4,6,0,10,"dummy"
"192180",0,0,1,1,"dummy"
"192183",3,13,3,19,"dummy"
"192185",0,0,2,2,"dummy"
"192187",0,5,1,6,"dummy"
"192188",3,5,2,10,"dummy"
"192192",0,0,0,0,"dummy"
"192193",1,6,1,8,"dummy"
"192194",3,13,0,16,"dummy"
"192204",2,20,4,26,"dummy"
"192205",0,1,0,1,"dummy"
"192206",0,1,0,1,"dummy"
"192207",0,1,1,2,"dummy"
"192208",23,0,0,23,"dummy"
"192209",0,1,0,1,"dummy"
"192210",0,30,0,30,"dummy"
"192214",0,0,0,0,"dummy"
"192215",0,2,0,2,"dummy"
"192220",2,0,0,2,"dummy"
"192221",0,2,0,2,"dummy"
"192222",0,1,0,1,"dummy"
"192223",0,2,0,2,"dummy"
"192224",2,1,0,3,"dummy"
"192225",1,3,0,4,"dummy"
"192226",1,1,0,2,"dummy"
"192228",0,0,0,0,"dummy"
"192230",3,2,0,5,"dummy"
"192234",0,1,0,1,"dummy"
"192235",0,2,0,2,"dummy"
"192236",2,1,1,4,"dummy"
"192237",0,1,0,1,"dummy"
"192238",1,0,0,1,"dummy"
"192239",2,1,0,3,"dummy"
"192240",0,1,0,1,"dummy"
"192241",12,12,3,27,"dummy"
"192242",0,0,1,1,"dummy"
"192243",2,0,0,2,"dummy"
"192244",0,1,0,1,"dummy"
"192245",0,1,0,1,"dummy"
"192246",0,0,1,1,"dummy"
"192247",0,1,0,1,"dummy"
"192248",1,0,0,1,"dummy"
"192249",0,1,0,1,"dummy"
"192250",1,4,0,5,"dummy"
"192251",0,2,0,2,"dummy"
"192252",2,1,0,3,"dummy"
"192253",2,2,0,4,"dummy"
"192254",0,0,1,1,"dummy"
"192255",4,1,0,5,"dummy"
"192256",0,1,0,1,"dummy"
"192257",2,4,1,7,"dummy"
"192258",0,1,0,1,"dummy"
"192259",0,1,0,1,"dummy"
"192260",1,0,0,1,"dummy"
"192261",0,0,1,1,"dummy"
"192262",0,0,1,1,"dummy"
"192263",1,0,0,1,"dummy"
"192264",0,1,0,1,"dummy"
"192265",0,1,0,1,"dummy"
"192266",0,2,0,2,"dummy"
"192267",2,2,0,4,"dummy"
"192268",0,0,0,0,"dummy"
"192269",0,1,0,1,"dummy"
"192270",0,1,0,1,"dummy"
"192271",2,2,0,4,"dummy"
"192272",0,1,0,1,"dummy"
"192273",0,4,0,4,"dummy"
"192275",3,3,4,10,"dummy"
"192276",9,1,5,15,"dummy"
"192277",0,2,2,4,"dummy"
"192279",0,1,0,1,"dummy"
"192281",0,0,1,1,"dummy"
"192285",9,6,5,20,"dummy"
"192286",1,0,0,1,"dummy"
"192287",0,0,1,1,"dummy"
"192288",0,1,0,1,"dummy"
"192291",15,1,2,18,"dummy"
"192292",0,0,0,0,"dummy"
"192293",0,0,1,1,"dummy"
"192295",0,1,0,1,"dummy"
"192296",0,0,1,1,"dummy"
"192297",0,1,0,1,"dummy"
"192298",0,3,0,3,"dummy"
"192299",3,0,0,3,"dummy"
"192300",0,1,0,1,"dummy"
"192301",0,1,0,1,"dummy"
"192302",7,0,0,7,"dummy"
"192303",0,0,1,1,"dummy"
"192304",0,0,1,1,"dummy"
"192305",0,0,1,1,"dummy"
"192306",0,0,1,1,"dummy"
"192307",11,1,1,13,"dummy"
"192308",0,0,1,1,"dummy"
"192309",0,0,1,1,"dummy"
"192310",0,0,1,1,"dummy"
"192311",0,0,1,1,"dummy"
"192312",1,2,1,4,"dummy"
"192313",0,0,1,1,"dummy"
"192314",0,1,0,1,"dummy"
"192315",0,0,1,1,"dummy"
"192316",0,0,1,1,"dummy"
"192317",0,0,1,1,"dummy"
"192318",0,0,1,1,"dummy"
"192319",0,2,0,2,"dummy"
"192320",0,0,1,1,"dummy"
"192321",0,0,1,1,"dummy"
"192322",0,0,1,1,"dummy"
"192323",0,0,1,1,"dummy"
"192324",0,0,1,1,"dummy"
"192325",0,0,1,1,"dummy"
"192326",0,0,1,1,"dummy"
"192327",0,0,1,1,"dummy"
"192328",1,0,1,2,"dummy"
"192329",0,0,1,1,"dummy"
"192330",0,0,1,1,"dummy"
"192331",0,0,1,1,"dummy"
"192332",0,0,1,1,"dummy"
"192333",0,0,1,1,"dummy"
"192334",0,0,1,1,"dummy"
"192335",0,0,1,1,"dummy"
"192336",0,0,1,1,"dummy"
"192337",0,0,1,1,"dummy"
"192338",0,0,1,1,"dummy"
"192339",0,0,1,1,"dummy"
"192340",0,0,0,0,"dummy"
"192341",0,0,1,1,"dummy"
"192342",0,0,1,1,"dummy"
"192343",3,0,0,3,"dummy"
"192344",0,0,1,1,"dummy"
"192345",0,1,0,1,"dummy"
"192346",0,1,0,1,"dummy"
"192347",0,0,1,1,"dummy"
"192348",0,0,1,1,"dummy"
"192349",0,0,1,1,"dummy"
"192350",0,0,1,1,"dummy"
"192351",0,0,1,1,"dummy"
"192352",0,0,1,1,"dummy"
"192353",0,0,1,1,"dummy"
"192354",0,0,1,1,"dummy"
"192355",0,0,1,1,"dummy"
"192356",0,0,1,1,"dummy"
"192357",0,0,1,1,"dummy"
"192358",0,0,1,1,"dummy"
"192359",0,0,1,1,"dummy"
"192360",0,0,1,1,"dummy"
"192361",0,0,1,1,"dummy"
"192362",0,0,1,1,"dummy"
"192363",0,0,1,1,"dummy"
"192364",0,1,0,1,"dummy"
"192365",0,0,1,1,"dummy"
"192366",0,0,1,1,"dummy"
"192367",0,0,1,1,"dummy"
"192368",0,0,1,1,"dummy"
"192369",0,0,1,1,"dummy"
"192370",0,0,1,1,"dummy"
"192371",0,0,1,1,"dummy"
"192372",0,0,1,1,"dummy"
"192373",0,0,1,1,"dummy"
"192374",0,0,1,1,"dummy"
"192375",0,0,1,1,"dummy"
"192376",0,1,0,1,"dummy"
"192377",0,0,1,1,"dummy"
"192378",0,0,1,1,"dummy"
"192379",0,0,1,1,"dummy"
"192380",0,0,1,1,"dummy"
"192381",0,0,1,1,"dummy"
"192382",0,2,2,4,"dummy"
"192383",0,0,1,1,"dummy"
"192384",1,0,1,2,"dummy"
"192385",0,0,1,1,"dummy"
"192386",0,0,1,1,"dummy"
"192387",0,0,1,1,"dummy"
"192388",0,0,1,1,"dummy"
"192389",0,0,1,1,"dummy"
"192390",0,0,1,1,"dummy"
"192391",0,0,1,1,"dummy"
"192392",0,0,1,1,"dummy"
"192393",0,0,1,1,"dummy"
"192394",0,0,1,1,"dummy"
"192395",0,0,1,1,"dummy"
"192396",0,0,1,1,"dummy"
"192397",0,0,1,1,"dummy"
"192398",0,0,1,1,"dummy"
"192399",0,0,1,1,"dummy"
"192400",0,0,1,1,"dummy"
"192401",0,0,1,1,"dummy"
"192402",0,0,1,1,"dummy"
"192403",0,0,1,1,"dummy"
"192404",0,0,1,1,"dummy"
"192405",0,0,1,1,"dummy"
"192406",0,0,1,1,"dummy"
"192407",0,0,1,1,"dummy"
"192408",0,0,1,1,"dummy"
"192409",0,0,1,1,"dummy"
"192410",0,0,1,1,"dummy"
"192411",0,0,1,1,"dummy"
"192412",0,0,1,1,"dummy"
"192413",0,0,1,1,"dummy"
"192414",0,0,1,1,"dummy"
"192415",0,0,1,1,"dummy"
"192416",0,0,1,1,"dummy"
"192417",0,0,1,1,"dummy"
"192418",0,0,1,1,"dummy"
"192419",0,0,1,1,"dummy"
"192420",2,4,4,10,"dummy"
"192421",0,0,1,1,"dummy"
"192422",2,0,1,3,"dummy"
"192423",0,1,0,1,"dummy"
"192425",0,10,0,10,"dummy"
"192426",1,1,0,2,"dummy"
"192427",13,0,1,14,"dummy"
"192428",2,11,1,14,"dummy"
"192429",10,2,1,13,"dummy"
"192430",3,0,0,3,"dummy"
"192431",2,0,0,2,"dummy"
"192432",0,0,1,1,"dummy"
"192433",0,1,1,2,"dummy"
"192434",1,0,0,1,"dummy"
"192435",0,0,0,0,"dummy"
"192436",0,13,0,13,"dummy"
"192437",0,0,0,0,"dummy"
"192438",0,3,0,3,"dummy"
"192439",0,1,0,1,"dummy"
"192440",0,1,0,1,"dummy"
"192441",2,0,0,2,"dummy"
"192442",0,3,0,3,"dummy"
"192443",0,1,1,2,"dummy"
"192444",0,0,1,1,"dummy"
"192446",45,12,2,59,"dummy"
"192447",0,2,0,2,"dummy"
"192448",0,1,0,1,"dummy"
"192449",0,1,1,2,"dummy"
"192450",3,6,0,9,"dummy"
"192451",3,0,0,3,"dummy"
"192452",0,1,0,1,"dummy"
"192453",4,0,0,4,"dummy"
"192454",0,0,1,1,"dummy"
"192455",0,0,0,0,"dummy"
"192456",0,0,1,1,"dummy"
"192457",0,1,0,1,"dummy"
"192458",0,6,1,7,"dummy"
"192459",0,0,1,1,"dummy"
"192460",1,8,0,9,"dummy"
"192461",0,0,0,0,"dummy"
"192462",0,0,0,0,"dummy"
"192463",0,0,0,0,"dummy"
"192464",0,0,1,1,"dummy"
"192477",0,0,1,1,"dummy"
"192478",0,3,0,3,"dummy"
"192479",0,1,0,1,"dummy"
"192482",1,2,0,3,"dummy"
"192483",0,0,1,1,"dummy"
"192485",9,0,4,13,"dummy"
"192486",0,9,0,9,"dummy"
"192487",0,0,1,1,"dummy"
"192491",0,1,0,1,"dummy"
"192512",0,2,1,3,"dummy"
"192513",0,1,1,2,"dummy"
"192514",0,2,0,2,"dummy"
"192515",2,2,2,6,"dummy"
"192516",0,6,0,6,"dummy"
"192517",3,6,2,11,"dummy"
"192518",1,0,1,2,"dummy"
"192519",3,0,1,4,"dummy"
"192520",0,2,0,2,"dummy"
"192521",0,2,0,2,"dummy"
"192522",0,1,0,1,"dummy"
"192523",0,2,0,2,"dummy"
"192525",3,1,2,6,"dummy"
"192526",0,2,0,2,"dummy"
"192527",2,0,0,2,"dummy"
"192530",0,0,0,0,"dummy"
"192531",0,0,1,1,"dummy"
"192533",0,2,0,2,"dummy"
"192534",1,3,0,4,"dummy"
"192535",0,1,0,1,"dummy"
"192536",1,0,0,1,"dummy"
"192537",0,1,0,1,"dummy"
"192538",0,1,0,1,"dummy"
"192539",1,0,0,1,"dummy"
"192543",0,0,0,0,"dummy"
"192544",1,5,0,6,"dummy"
"192545",1,0,0,1,"dummy"
"192552",0,3,1,4,"dummy"
"192555",0,1,0,1,"dummy"
"192557",6,6,1,13,"dummy"
"192574",0,1,0,1,"dummy"
"192577",0,3,0,3,"dummy"
"192578",0,1,0,1,"dummy"
"192579",6,12,0,18,"dummy"
"192580",0,0,1,1,"dummy"
"192581",9,15,2,26,"dummy"
"192582",0,7,5,12,"dummy"
"192583",9,8,0,17,"dummy"
"192585",3,5,1,9,"dummy"
"192586",2,0,0,2,"dummy"
"192587",0,3,1,4,"dummy"
"192588",0,1,0,1,"dummy"
"192591",0,4,0,4,"dummy"
"192592",1,0,0,1,"dummy"
"192616",0,1,0,1,"dummy"
"192617",1,3,0,4,"dummy"
"192618",1,5,0,6,"dummy"
"192619",3,7,0,10,"dummy"
"192621",0,0,4,4,"dummy"
"192624",7,2,4,13,"dummy"
"192638",0,4,3,7,"dummy"
"192642",0,1,0,1,"dummy"
"192643",0,0,1,1,"dummy"
"192644",4,1,0,5,"dummy"
"192645",0,0,5,5,"dummy"
"192646",1,2,0,3,"dummy"
"192647",0,0,1,1,"dummy"
"192649",0,0,4,4,"dummy"
"192651",0,0,1,1,"dummy"
"192652",0,0,1,1,"dummy"
"192655",2,12,3,17,"dummy"
"192660",1,0,0,1,"dummy"
"192664",1,2,0,3,"dummy"
"192665",0,0,1,1,"dummy"
"192666",0,1,0,1,"dummy"
"192667",0,0,1,1,"dummy"
"192668",0,0,0,0,"dummy"
"192669",0,0,1,1,"dummy"
"192670",0,0,1,1,"dummy"
"192671",0,0,1,1,"dummy"
"192672",0,0,1,1,"dummy"
"192674",7,3,1,11,"dummy"
"192675",0,2,0,2,"dummy"
"192677",0,1,0,1,"dummy"
"192678",3,5,4,12,"dummy"
"192680",0,3,0,3,"dummy"
"192684",0,0,1,1,"dummy"
"192686",2,1,0,3,"dummy"
"192687",2,1,0,3,"dummy"
"192688",1,0,0,1,"dummy"
"192689",0,0,1,1,"dummy"
"192690",1,0,0,1,"dummy"
"192691",0,0,1,1,"dummy"
"192694",1,0,2,3,"dummy"
"192695",14,8,4,26,"dummy"
"192696",0,0,0,0,"dummy"
"192705",0,0,1,1,"dummy"
"192711",3,4,0,7,"dummy"
"192712",4,1,0,5,"dummy"
"192713",0,0,0,0,"dummy"
"192714",0,0,0,0,"dummy"
"192717",2,0,0,2,"dummy"
"192718",0,0,0,0,"dummy"
"192721",0,3,1,4,"dummy"
"192723",0,0,0,0,"dummy"
"192725",2,1,0,3,"dummy"
"192727",0,1,1,2,"dummy"
"192728",1,0,1,2,"dummy"
"192732",14,10,3,27,"dummy"
"192733",3,1,1,5,"dummy"
"192734",1,4,0,5,"dummy"
"192735",0,11,0,11,"dummy"
"192736",0,2,0,2,"dummy"
"192737",1,4,0,5,"dummy"
"192739",0,0,1,1,"dummy"
"192740",0,0,1,1,"dummy"
"192741",0,2,0,2,"dummy"
"192742",0,1,0,1,"dummy"
"192743",2,0,0,2,"dummy"
"192744",0,2,0,2,"dummy"
"192745",1,1,0,2,"dummy"
"192746",1,1,1,3,"dummy"
"192747",1,2,0,3,"dummy"
"192748",1,1,1,3,"dummy"
"192749",0,0,1,1,"dummy"
"192750",1,1,0,2,"dummy"
"192751",1,1,1,3,"dummy"
"192752",1,5,1,7,"dummy"
"192753",3,0,1,4,"dummy"
"192754",0,1,0,1,"dummy"
"192755",0,1,0,1,"dummy"
"192756",1,1,0,2,"dummy"
"192757",2,0,2,4,"dummy"
"192758",5,0,1,6,"dummy"
"192798",0,0,1,1,"dummy"
"192799",0,0,1,1,"dummy"
"192800",0,0,1,1,"dummy"
"192801",1,1,1,3,"dummy"
"192802",0,0,1,1,"dummy"
"192803",0,0,1,1,"dummy"
"192804",2,2,0,4,"dummy"
"192805",3,3,1,7,"dummy"
"192811",0,0,1,1,"dummy"
"192812",0,0,1,1,"dummy"
"192813",0,0,2,2,"dummy"
"192814",0,0,1,1,"dummy"
"192815",0,0,1,1,"dummy"
"192816",0,0,1,1,"dummy"
"192842",0,0,1,1,"dummy"
"192843",0,2,2,4,"dummy"
"192851",0,0,1,1,"dummy"
"192852",0,1,0,1,"dummy"
"192857",0,1,2,3,"dummy"
"192858",0,2,0,2,"dummy"
"192859",0,0,1,1,"dummy"
"192860",1,0,1,2,"dummy"
"192861",0,0,1,1,"dummy"
"192862",0,0,1,1,"dummy"
"192863",2,2,1,5,"dummy"
"192864",0,0,1,1,"dummy"
"192865",0,1,0,1,"dummy"
"192868",1,0,0,1,"dummy"
"192869",0,1,0,1,"dummy"
"192870",0,0,1,1,"dummy"
"192873",0,0,1,1,"dummy"
"192885",0,0,1,1,"dummy"
"192886",0,1,0,1,"dummy"
"192887",0,5,0,5,"dummy"
"192888",0,0,2,2,"dummy"
"192889",0,1,1,2,"dummy"
"192890",0,2,1,3,"dummy"
"192891",0,1,2,3,"dummy"
"192892",1,1,1,3,"dummy"
"192893",2,3,1,6,"dummy"
"192894",0,0,2,2,"dummy"
"192911",1,1,0,2,"dummy"
"192912",0,5,0,5,"dummy"
"192913",0,5,1,6,"dummy"
"192914",0,1,0,1,"dummy"
"192925",0,0,1,1,"dummy"
"192926",2,0,0,2,"dummy"
"192927",0,0,1,1,"dummy"
"192928",0,0,0,0,"dummy"
"192929",0,1,2,3,"dummy"
"192930",1,0,0,1,"dummy"
"192931",0,0,1,1,"dummy"
"192932",2,0,0,2,"dummy"
"192933",0,0,1,1,"dummy"
"192934",0,1,0,1,"dummy"
"192935",0,2,0,2,"dummy"
"192936",0,0,0,0,"dummy"
"192937",0,1,0,1,"dummy"
"192938",4,0,0,4,"dummy"
"192939",0,0,0,0,"dummy"
"192940",0,0,0,0,"dummy"
"192941",4,0,0,4,"dummy"
"192944",0,1,0,1,"dummy"
"192945",0,0,1,1,"dummy"
"192960",3,2,0,5,"dummy"
"192961",0,2,0,2,"dummy"
"192967",0,3,0,3,"dummy"
"192968",1,6,2,9,"dummy"
"192978",0,1,0,1,"dummy"
"192979",0,0,0,0,"dummy"
"192990",0,0,0,0,"dummy"
"192991",0,0,1,1,"dummy"
"192992",0,1,0,1,"dummy"
"192807",0,1,1,2,"dummy"
"192808",0,1,0,1,"dummy"
"192809",3,0,2,5,"dummy"
"192818",0,0,1,1,"dummy"
"192819",0,7,0,7,"dummy"
"192820",0,1,0,1,"dummy"
"192821",1,1,0,2,"dummy"
"192822",3,13,1,17,"dummy"
"192823",0,0,4,4,"dummy"
"192824",3,10,3,16,"dummy"
"192827",0,0,0,0,"dummy"
"192832",0,0,1,1,"dummy"
"192833",0,0,1,1,"dummy"
"192834",0,0,2,2,"dummy"
"192835",26,3,7,36,"dummy"
"192838",0,0,0,0,"dummy"
"192845",0,12,0,12,"dummy"
"192846",0,2,0,2,"dummy"
"192847",2,0,0,2,"dummy"
"192854",0,0,0,0,"dummy"
"192855",0,0,0,0,"dummy"
"192899",1,5,0,6,"dummy"
"192900",1,2,0,3,"dummy"
"192901",0,0,3,3,"dummy"
"192902",1,2,0,3,"dummy"
"192903",0,1,0,1,"dummy"
"192904",0,1,0,1,"dummy"
"192905",0,2,0,2,"dummy"
"192906",0,1,0,1,"dummy"
"192909",0,2,0,2,"dummy"
"192916",0,1,0,1,"dummy"
"192917",2,24,2,28,"dummy"
"192918",0,2,0,2,"dummy"
"192919",3,6,0,9,"dummy"
"192920",1,1,0,2,"dummy"
"192921",0,1,0,1,"dummy"
"192947",0,1,0,1,"dummy"
"192948",0,0,1,1,"dummy"
"192949",0,0,0,0,"dummy"
"192952",0,0,0,0,"dummy"
"192953",0,0,0,0,"dummy"
"192954",0,0,0,0,"dummy"
"192955",0,0,0,0,"dummy"
"192956",0,0,0,0,"dummy"
"192957",0,0,0,0,"dummy"
"192958",0,0,0,0,"dummy"
"192965",0,2,0,2,"dummy"
"192972",0,1,0,1,"dummy"
"192973",0,2,1,3,"dummy"
"192974",0,1,0,1,"dummy"
"192981",0,15,1,16,"dummy"
"192982",1,3,0,4,"dummy"
"192983",9,31,0,40,"dummy"
"192984",0,2,0,2,"dummy"
"192985",0,3,0,3,"dummy"
"192986",2,4,0,6,"dummy"
"192998",1,3,1,5,"dummy"
"192999",0,1,0,1,"dummy"
"193000",0,2,0,2,"dummy"
"193001",0,1,0,1,"dummy"
"193002",3,6,0,9,"dummy"
"193003",4,8,4,16,"dummy"
"193004",0,0,3,3,"dummy"
"193005",0,0,1,1,"dummy"
"193006",0,0,0,0,"dummy"
"193039",0,1,1,2,"dummy"
"193040",0,0,1,1,"dummy"
"193071",0,2,2,4,"dummy"
"193099",0,28,0,28,"dummy"
"192993",0,0,0,0,"dummy"
"192994",13,1,2,16,"dummy"
"193010",5,0,0,5,"dummy"
"193011",0,1,0,1,"dummy"
"193012",0,2,1,3,"dummy"
"193013",0,1,0,1,"dummy"
"193014",3,5,12,20,"dummy"
"193015",0,2,0,2,"dummy"
"193016",0,2,0,2,"dummy"
"193017",2,0,1,3,"dummy"
"193018",1,7,1,9,"dummy"
"193019",1,0,0,1,"dummy"
"193020",3,1,1,5,"dummy"
"193021",4,0,0,4,"dummy"
"193022",1,0,1,2,"dummy"
"193023",1,4,0,5,"dummy"
"193024",0,3,1,4,"dummy"
"193025",0,0,1,1,"dummy"
"193026",0,4,0,4,"dummy"
"193027",2,3,2,7,"dummy"
"193028",6,12,0,18,"dummy"
"193029",0,2,0,2,"dummy"
"193030",0,0,0,0,"dummy"
"193031",0,3,0,3,"dummy"
"193032",15,7,6,28,"dummy"
"193033",0,1,0,1,"dummy"
"193034",0,2,0,2,"dummy"
"193035",0,0,1,1,"dummy"
"193036",1,0,0,1,"dummy"
"193037",1,6,3,10,"dummy"
"193042",0,0,0,0,"dummy"
"193043",0,2,0,2,"dummy"
"193044",5,6,2,13,"dummy"
"193045",0,7,0,7,"dummy"
"193046",1,0,0,1,"dummy"
"193047",0,0,0,0,"dummy"
"193048",0,0,0,0,"dummy"
"193049",3,3,0,6,"dummy"
"193050",3,0,0,3,"dummy"
"193051",0,1,0,1,"dummy"
"193052",1,0,0,1,"dummy"
"193053",2,2,1,5,"dummy"
"193054",0,0,0,0,"dummy"
"193055",0,0,0,0,"dummy"
"193056",0,0,0,0,"dummy"
"193057",0,0,0,0,"dummy"
"193058",1,0,0,1,"dummy"
"193059",0,0,0,0,"dummy"
"193060",1,0,0,1,"dummy"
"193063",0,2,0,2,"dummy"
"193064",0,0,1,1,"dummy"
"193065",1,2,0,3,"dummy"
"193066",1,1,0,2,"dummy"
"193067",1,3,1,5,"dummy"
"193068",3,1,0,4,"dummy"
"193069",0,2,0,2,"dummy"
"193073",0,0,1,1,"dummy"
"193074",0,0,1,1,"dummy"
"193075",0,0,0,0,"dummy"
"193093",0,4,0,4,"dummy"
"193094",2,11,0,13,"dummy"
"193095",0,1,0,1,"dummy"
"193096",2,6,1,9,"dummy"
"193097",0,0,0,0,"dummy"
"193106",0,0,1,1,"dummy"
"193107",0,0,1,1,"dummy"
"193108",1,2,1,4,"dummy"
"193109",6,4,1,11,"dummy"
"193110",0,2,1,3,"dummy"
"193111",0,1,1,2,"dummy"
"193112",0,0,2,2,"dummy"
"193113",1,5,2,8,"dummy"
"193114",26,7,2,35,"dummy"
"193118",0,0,0,0,"dummy"
"193124",0,0,3,3,"dummy"
"193125",0,0,3,3,"dummy"
"193126",0,1,0,1,"dummy"
"193127",0,0,1,1,"dummy"
"193128",0,0,1,1,"dummy"
"193129",0,0,1,1,"dummy"
"193130",0,0,1,1,"dummy"
"193133",4,6,2,12,"dummy"
"193134",0,0,1,1,"dummy"
"193135",0,1,1,2,"dummy"
"193136",0,0,1,1,"dummy"
"193137",4,0,3,7,"dummy"
"193144",0,1,0,1,"dummy"
"193150",2,1,0,3,"dummy"
"193100",0,1,0,1,"dummy"
"193101",2,12,1,15,"dummy"
"193102",11,7,1,19,"dummy"
"193103",5,2,0,7,"dummy"
"193104",5,7,4,16,"dummy"
"193116",2,4,1,7,"dummy"
"193120",1,0,0,1,"dummy"
"193139",2,0,2,4,"dummy"
"193140",1,3,0,4,"dummy"
"193141",3,1,0,4,"dummy"
"193142",2,1,4,7,"dummy"
"193148",0,0,1,1,"dummy"
"193212",5,10,0,15,"dummy"
"193213",0,6,0,6,"dummy"
"193214",0,0,0,0,"dummy"
"193215",0,1,0,1,"dummy"
"193218",0,0,1,1,"dummy"
"193223",0,10,0,10,"dummy"
"193224",1,1,0,2,"dummy"
"193226",0,0,0,0,"dummy"
"193228",1,2,3,6,"dummy"
"193230",0,0,1,1,"dummy"
"193249",1,1,0,2,"dummy"
"193250",0,0,0,0,"dummy"
"193252",0,0,1,1,"dummy"
"193253",0,0,1,1,"dummy"
"193254",1,0,0,1,"dummy"
"193256",6,9,0,15,"dummy"
"193258",0,1,0,1,"dummy"
"193259",0,2,0,2,"dummy"
"193261",0,1,2,3,"dummy"
"193262",1,2,2,5,"dummy"
"193264",0,0,2,2,"dummy"
"193267",0,0,2,2,"dummy"
"193268",0,0,1,1,"dummy"
"193269",0,1,0,1,"dummy"
"193272",1,5,0,6,"dummy"
"193273",0,0,1,1,"dummy"
"193274",0,1,3,4,"dummy"
"193280",1,1,0,2,"dummy"
"193281",0,1,0,1,"dummy"
"193282",0,0,1,1,"dummy"
"193283",0,0,1,1,"dummy"
"193288",0,1,0,1,"dummy"
"193291",0,0,0,0,"dummy"
"193306",12,0,0,12,"dummy"
"193309",0,0,1,1,"dummy"
"193310",0,0,1,1,"dummy"
"193311",0,0,1,1,"dummy"
"193313",0,2,0,2,"dummy"
"193314",0,5,0,5,"dummy"
"193315",2,2,0,4,"dummy"
"193317",0,1,2,3,"dummy"
"193318",4,4,1,9,"dummy"
"193319",1,2,3,6,"dummy"
"193327",0,0,1,1,"dummy"
"193328",1,0,0,1,"dummy"
"193329",0,6,2,8,"dummy"
"193331",22,23,0,45,"dummy"
"193332",1,2,0,3,"dummy"
"193333",6,8,0,14,"dummy"
"193334",2,0,0,2,"dummy"
"193337",0,0,1,1,"dummy"
"193339",0,6,0,6,"dummy"
"193341",0,3,0,3,"dummy"
"193342",0,0,1,1,"dummy"
"193343",0,12,0,12,"dummy"
"193345",0,2,1,3,"dummy"
"193347",0,1,0,1,"dummy"
"193352",0,1,1,2,"dummy"
"193357",0,0,1,1,"dummy"
"193360",0,0,0,0,"dummy"
"193363",0,2,0,2,"dummy"
"193364",1,0,1,2,"dummy"
"193365",0,0,0,0,"dummy"
"193366",0,0,3,3,"dummy"
"193367",0,0,1,1,"dummy"
"193372",1,0,0,1,"dummy"
"193375",0,5,0,5,"dummy"
"193376",0,0,1,1,"dummy"
"193377",1,0,1,2,"dummy"
"193378",2,2,1,5,"dummy"
"193379",1,7,1,9,"dummy"
"193380",6,1,0,7,"dummy"
"193381",0,1,0,1,"dummy"
"193382",0,0,0,0,"dummy"
"193383",0,0,0,0,"dummy"
"193384",0,0,1,1,"dummy"
"193385",0,0,0,0,"dummy"
"193386",0,0,0,0,"dummy"
"193388",1,0,0,1,"dummy"
"193389",0,2,0,2,"dummy"
"193390",0,3,0,3,"dummy"
"193391",1,0,0,1,"dummy"
"193392",2,1,0,3,"dummy"
"193400",0,1,0,1,"dummy"
"193407",0,0,2,2,"dummy"
"193408",1,0,1,2,"dummy"
"193409",0,0,1,1,"dummy"
"193410",2,12,1,15,"dummy"
"193411",1,2,0,3,"dummy"
"193414",0,0,1,1,"dummy"
"193415",0,0,1,1,"dummy"
"193416",0,1,0,1,"dummy"
"193418",0,0,1,1,"dummy"
"193419",8,0,3,11,"dummy"
"193421",0,0,4,4,"dummy"
"193422",0,1,0,1,"dummy"
"193423",0,0,1,1,"dummy"
"193424",0,0,2,2,"dummy"
"193425",0,0,1,1,"dummy"
"193426",0,0,1,1,"dummy"
"193427",0,0,1,1,"dummy"
"193428",0,0,1,1,"dummy"
"193429",0,2,0,2,"dummy"
"193430",3,2,0,5,"dummy"
"193431",0,3,0,3,"dummy"
"193432",0,0,1,1,"dummy"
"193447",3,2,1,6,"dummy"
"193448",0,1,0,1,"dummy"
"193449",3,2,1,6,"dummy"
"193450",1,2,1,4,"dummy"
"193451",0,0,1,1,"dummy"
"193452",5,20,2,27,"dummy"
"193461",0,0,0,0,"dummy"
"193460",1,0,0,1,"dummy"
"193459",11,6,1,18,"dummy"
"193458",0,0,1,1,"dummy"
"193463",2,4,0,6,"dummy"
"193464",0,0,1,1,"dummy"
"193465",0,6,0,6,"dummy"
"193477",4,2,0,6,"dummy"
"193478",0,1,0,1,"dummy"
"193479",0,0,0,0,"dummy"
"193480",0,0,0,0,"dummy"
"193490",2,0,0,2,"dummy"
"193491",0,0,0,0,"dummy"
"193494",2,2,5,9,"dummy"
"193495",0,0,3,3,"dummy"
"193499",1,4,0,5,"dummy"
"193502",0,2,0,2,"dummy"
"193503",0,0,3,3,"dummy"
"193509",0,3,0,3,"dummy"
"193539",4,3,0,7,"dummy"
"193540",0,0,1,1,"dummy"
"193548",1,1,0,2,"dummy"
"193549",0,3,0,3,"dummy"
"193550",7,2,3,12,"dummy"
"193551",2,6,2,10,"dummy"
"193552",2,0,0,2,"dummy"
"193570",0,0,1,1,"dummy"
"193571",0,0,1,1,"dummy"
"193574",12,0,0,12,"dummy"
"193575",2,0,0,2,"dummy"
"193576",0,4,3,7,"dummy"
"193577",0,3,2,5,"dummy"
"193578",0,1,0,1,"dummy"
"193579",7,0,4,11,"dummy"
"193580",0,20,1,21,"dummy"
"193581",0,2,0,2,"dummy"
"193582",4,9,1,14,"dummy"
"193583",0,2,0,2,"dummy"
"193584",0,0,0,0,"dummy"
"193585",0,2,0,2,"dummy"
"193586",2,0,0,2,"dummy"
"193587",0,0,1,1,"dummy"
"193588",0,4,1,5,"dummy"
"193589",3,1,0,4,"dummy"
"193590",18,4,3,25,"dummy"
"193591",3,0,1,4,"dummy"
"193592",0,1,0,1,"dummy"
"193593",2,2,1,5,"dummy"
"193594",7,6,0,13,"dummy"
"193595",0,1,0,1,"dummy"
"193596",0,0,0,0,"dummy"
"193597",1,7,0,8,"dummy"
"193600",1,1,0,2,"dummy"
"193623",0,1,0,1,"dummy"
"193624",0,1,1,2,"dummy"
"193627",0,0,0,0,"dummy"
"193634",0,0,0,0,"dummy"
"193635",3,12,0,15,"dummy"
"193636",1,1,0,2,"dummy"
"193637",1,1,0,2,"dummy"
"193664",2,1,0,3,"dummy"
"193665",0,1,0,1,"dummy"
"193666",0,1,0,1,"dummy"
"193667",0,1,0,1,"dummy"
"193668",1,0,0,1,"dummy"
"193669",0,5,0,5,"dummy"
"193670",0,1,0,1,"dummy"
"193700",0,0,1,1,"dummy"
"193701",0,1,0,1,"dummy"
"193702",2,0,1,3,"dummy"
"193703",0,2,2,4,"dummy"
"193712",0,0,1,1,"dummy"
"193715",0,12,0,12,"dummy"
"193716",7,5,0,12,"dummy"
"193717",7,32,1,40,"dummy"
"193718",9,14,0,23,"dummy"
"193719",17,4,0,21,"dummy"
"193720",0,1,0,1,"dummy"
"193454",0,1,0,1,"dummy"
"193469",3,2,0,5,"dummy"
"193482",0,0,1,1,"dummy"
"193485",1,0,0,1,"dummy"
"193486",0,0,0,0,"dummy"
"193505",0,5,2,7,"dummy"
"193506",0,6,2,8,"dummy"
"193507",0,1,0,1,"dummy"
"193511",6,0,6,12,"dummy"
"193512",0,3,0,3,"dummy"
"193513",1,0,0,1,"dummy"
"193514",0,1,1,2,"dummy"
"193515",1,0,0,1,"dummy"
"193516",0,6,0,6,"dummy"
"193517",13,0,0,13,"dummy"
"193518",0,1,0,1,"dummy"
"193519",0,4,0,4,"dummy"
"193520",12,0,0,12,"dummy"
"193521",0,1,2,3,"dummy"
"193522",1,1,0,2,"dummy"
"193523",0,0,1,1,"dummy"
"193524",0,0,1,1,"dummy"
"193525",0,0,0,0,"dummy"
"193526",0,1,1,2,"dummy"
"193527",0,0,0,0,"dummy"
"193528",0,0,0,0,"dummy"
"193529",0,1,0,1,"dummy"
"193530",0,0,0,0,"dummy"
"193531",0,1,0,1,"dummy"
"193532",0,0,0,0,"dummy"
"193533",0,0,0,0,"dummy"
"193534",0,1,0,1,"dummy"
"193535",0,0,1,1,"dummy"
"193536",0,0,0,0,"dummy"
"193537",1,1,0,2,"dummy"
"193542",24,10,2,36,"dummy"
"193543",0,0,0,0,"dummy"
"193544",0,0,1,1,"dummy"
"193558",0,0,0,0,"dummy"
"193559",0,2,0,2,"dummy"
"193560",0,0,3,3,"dummy"
"193561",1,0,2,3,"dummy"
"193562",0,3,0,3,"dummy"
"193563",2,1,1,4,"dummy"
"193564",2,0,0,2,"dummy"
"193565",3,0,1,4,"dummy"
"193614",0,0,1,1,"dummy"
"193615",0,0,1,1,"dummy"
"193618",2,9,0,11,"dummy"
"193619",1,0,0,1,"dummy"
"193620",0,0,1,1,"dummy"
"193621",2,3,0,5,"dummy"
"193705",0,0,1,1,"dummy"
"193706",1,0,1,2,"dummy"
"193734",5,2,3,10,"dummy"
"193735",0,1,0,1,"dummy"
"193721",0,1,1,2,"dummy"
"193722",0,1,0,1,"dummy"
"193723",1,1,0,2,"dummy"
"193726",0,2,0,2,"dummy"
"193727",0,0,0,0,"dummy"
"193728",10,10,4,24,"dummy"
"193729",0,1,0,1,"dummy"
"193737",0,0,1,1,"dummy"
"193740",10,14,2,26,"dummy"
"193741",0,1,3,4,"dummy"
"193742",0,1,0,1,"dummy"
"193743",0,1,0,1,"dummy"
"193744",3,7,1,11,"dummy"
"193745",0,1,0,1,"dummy"
"193752",1,0,0,1,"dummy"
"193753",1,3,1,5,"dummy"
"193754",1,2,1,4,"dummy"
"193794",1,0,1,2,"dummy"
"193795",0,0,1,1,"dummy"
"193796",1,2,0,3,"dummy"
"193806",6,0,0,6,"dummy"
"193807",2,5,2,9,"dummy"
"193816",0,6,3,9,"dummy"
"193817",9,5,0,14,"dummy"
"193820",0,0,0,0,"dummy"
"193821",0,2,0,2,"dummy"
"193849",0,0,7,7,"dummy"
"193856",0,0,2,2,"dummy"
"193857",0,1,0,1,"dummy"
"193873",0,1,0,1,"dummy"
"193887",0,1,0,1,"dummy"
"193909",0,8,1,9,"dummy"
"193926",0,1,0,1,"dummy"
"193955",0,0,1,1,"dummy"
"193958",0,1,0,1,"dummy"
"193959",0,2,0,2,"dummy"
"193960",0,0,0,0,"dummy"
"193961",0,1,0,1,"dummy"
"193962",0,0,1,1,"dummy"
"193967",0,0,0,0,"dummy"
"193971",0,0,0,0,"dummy"
"193972",0,0,0,0,"dummy"
"193973",0,3,0,3,"dummy"
"193974",0,0,0,0,"dummy"
"193975",0,0,0,0,"dummy"
"193979",0,2,0,2,"dummy"
"193980",2,7,0,9,"dummy"
"193985",0,3,0,3,"dummy"
"193986",0,0,1,1,"dummy"
"193987",21,6,5,32,"dummy"
"193988",0,5,1,6,"dummy"
"194008",0,0,0,0,"dummy"
"194047",0,0,4,4,"dummy"
"194048",0,3,0,3,"dummy"
"194049",0,2,0,2,"dummy"
"193792",0,2,0,2,"dummy"
"193798",0,6,0,6,"dummy"
"193801",0,0,1,1,"dummy"
"193802",0,0,0,0,"dummy"
"193809",0,1,0,1,"dummy"
"193814",0,4,0,4,"dummy"
"193825",0,5,0,5,"dummy"
"193826",3,0,0,3,"dummy"
"193827",0,0,3,3,"dummy"
"193828",29,47,15,91,"dummy"
"193829",0,0,3,3,"dummy"
"193833",0,0,1,1,"dummy"
"193834",3,6,4,13,"dummy"
"193835",0,0,2,2,"dummy"
"193838",0,0,1,1,"dummy"
"193839",0,0,1,1,"dummy"
"193842",0,1,0,1,"dummy"
"193843",0,0,1,1,"dummy"
"193844",0,0,1,1,"dummy"
"193845",0,0,1,1,"dummy"
"193851",0,2,0,2,"dummy"
"193861",1,0,0,1,"dummy"
"193862",0,2,0,2,"dummy"
"193865",0,0,1,1,"dummy"
"193866",0,0,1,1,"dummy"
"193867",0,0,1,1,"dummy"
"193868",0,0,1,1,"dummy"
"193869",0,0,1,1,"dummy"
"193875",1,0,1,2,"dummy"
"193889",1,0,0,1,"dummy"
"193890",1,3,1,5,"dummy"
"193891",0,0,0,0,"dummy"
"193892",0,0,0,0,"dummy"
"193893",0,0,1,1,"dummy"
"193894",0,2,0,2,"dummy"
"193895",2,0,0,2,"dummy"
"193896",0,0,1,1,"dummy"
"193897",0,0,1,1,"dummy"
"193898",0,0,1,1,"dummy"
"193901",0,0,1,1,"dummy"
"193902",0,0,1,1,"dummy"
"193907",2,5,2,9,"dummy"
"193913",0,5,0,5,"dummy"
"193916",14,12,3,29,"dummy"
"193917",4,11,0,15,"dummy"
"193918",0,0,1,1,"dummy"
"193919",0,17,0,17,"dummy"
"193920",1,0,0,1,"dummy"
"193921",0,1,0,1,"dummy"
"193922",3,2,0,5,"dummy"
"193923",0,1,0,1,"dummy"
"193924",0,1,0,1,"dummy"
"193928",0,0,0,0,"dummy"
"193929",2,7,2,11,"dummy"
"193930",0,5,6,11,"dummy"
"193931",5,9,0,14,"dummy"
"193932",0,0,1,1,"dummy"
"193933",0,1,0,1,"dummy"
"193934",0,1,1,2,"dummy"
"193935",3,4,1,8,"dummy"
"193936",0,2,0,2,"dummy"
"193937",0,6,0,6,"dummy"
"193938",25,7,3,35,"dummy"
"193939",2,2,0,4,"dummy"
"193940",1,3,0,4,"dummy"
"193941",0,2,0,2,"dummy"
"193942",1,0,0,1,"dummy"
"193943",0,0,1,1,"dummy"
"193944",3,0,0,3,"dummy"
"193945",0,4,0,4,"dummy"
"193946",0,2,0,2,"dummy"
"193947",0,2,0,2,"dummy"
"193948",0,1,1,2,"dummy"
"193951",0,0,1,1,"dummy"
"193952",11,3,3,17,"dummy"
"193953",0,2,0,2,"dummy"
"193977",0,0,1,1,"dummy"
"193982",2,0,0,2,"dummy"
"193983",0,0,0,0,"dummy"
"193990",0,11,1,12,"dummy"
"193991",0,1,0,1,"dummy"
"193992",0,1,0,1,"dummy"
"193993",2,1,0,3,"dummy"
"193994",17,1,0,18,"dummy"
"193995",0,1,0,1,"dummy"
"193996",1,2,0,3,"dummy"
"193997",0,1,0,1,"dummy"
"193998",0,11,0,11,"dummy"
"193999",0,2,0,2,"dummy"
"194000",5,8,0,13,"dummy"
"194001",1,0,0,1,"dummy"
"194002",19,4,0,23,"dummy"
"194003",10,9,3,22,"dummy"
"194004",0,0,1,1,"dummy"
"194005",0,10,0,10,"dummy"
"194006",0,0,3,3,"dummy"
"194014",0,0,0,0,"dummy"
"194015",0,0,0,0,"dummy"
"194016",0,0,0,0,"dummy"
"194017",0,0,0,0,"dummy"
"194018",0,0,0,0,"dummy"
"194019",3,17,1,21,"dummy"
"194020",0,0,1,1,"dummy"
"194021",0,4,3,7,"dummy"
"194022",0,1,0,1,"dummy"
"194023",2,4,1,7,"dummy"
"194024",0,2,0,2,"dummy"
"194025",0,1,0,1,"dummy"
"194026",1,0,0,1,"dummy"
"194027",16,5,6,27,"dummy"
"194028",0,0,3,3,"dummy"
"194029",0,0,0,0,"dummy"
"194030",0,0,3,3,"dummy"
"194031",12,30,4,46,"dummy"
"194032",21,25,4,50,"dummy"
"194033",1,2,3,6,"dummy"
"194034",0,0,1,1,"dummy"
"194035",0,0,1,1,"dummy"
"194036",20,2,2,24,"dummy"
"194037",0,1,2,3,"dummy"
"194038",0,0,1,1,"dummy"
"194039",0,0,1,1,"dummy"
"194040",0,0,1,1,"dummy"
"194041",0,0,1,1,"dummy"
"194051",0,2,0,2,"dummy"
"194052",0,0,2,2,"dummy"
"194053",0,1,0,1,"dummy"
"194056",0,0,1,1,"dummy"
"194057",0,2,0,2,"dummy"
"194058",2,0,0,2,"dummy"
"194059",1,4,0,5,"dummy"
"194060",0,1,1,2,"dummy"
"194061",4,0,0,4,"dummy"
"194062",13,6,3,22,"dummy"
"194063",0,0,1,1,"dummy"
"194064",3,6,0,9,"dummy"
"194075",0,0,1,1,"dummy"
"194078",0,2,1,3,"dummy"
"194079",0,0,1,1,"dummy"
"194080",0,1,1,2,"dummy"
"194103",0,1,0,1,"dummy"
"194104",0,1,0,1,"dummy"
"194105",0,1,0,1,"dummy"
"194108",0,0,1,1,"dummy"
"194070",9,0,0,9,"dummy"
"194071",0,4,0,4,"dummy"
"194082",1,4,0,5,"dummy"
"194083",6,8,1,15,"dummy"
"194084",2,0,0,2,"dummy"
"194085",0,1,0,1,"dummy"
"194086",11,1,1,13,"dummy"
"194087",0,0,1,1,"dummy"
"194088",0,0,1,1,"dummy"
"194089",2,8,1,11,"dummy"
"194090",0,0,2,2,"dummy"
"194091",0,4,0,4,"dummy"
"194092",0,0,1,1,"dummy"
"194093",0,0,2,2,"dummy"
"194094",0,1,1,2,"dummy"
"194095",0,0,1,1,"dummy"
"194096",1,1,1,3,"dummy"
"194097",0,0,1,1,"dummy"
"194098",0,0,1,1,"dummy"
"194099",1,0,1,2,"dummy"
"194100",0,0,1,1,"dummy"
"194101",6,0,1,7,"dummy"
"194110",0,0,1,1,"dummy"
"194111",0,0,1,1,"dummy"
"194112",0,2,0,2,"dummy"
"194113",0,0,1,1,"dummy"
"194114",4,2,0,6,"dummy"
"194115",0,0,1,1,"dummy"
"194116",0,0,1,1,"dummy"
"194141",1,3,0,4,"dummy"
"194144",0,0,2,2,"dummy"
"194145",0,0,2,2,"dummy"
"194150",0,0,2,2,"dummy"
"194183",14,4,3,21,"dummy"
"194184",0,0,1,1,"dummy"
"194188",1,34,0,35,"dummy"
"194194",1,3,0,4,"dummy"
"194195",3,27,1,31,"dummy"
"194196",10,12,2,24,"dummy"
"194209",0,0,1,1,"dummy"
"194210",0,0,1,1,"dummy"
"194211",1,0,1,2,"dummy"
"194212",0,0,2,2,"dummy"
"194213",0,0,1,1,"dummy"
"194214",0,0,0,0,"dummy"
"194215",0,1,1,2,"dummy"
"194216",0,0,1,1,"dummy"
"194217",3,3,2,8,"dummy"
"194218",0,0,1,1,"dummy"
"194219",0,0,1,1,"dummy"
"194220",0,0,1,1,"dummy"
"194221",0,0,1,1,"dummy"
"194222",0,0,1,1,"dummy"
"194223",0,0,0,0,"dummy"
"194224",1,0,0,1,"dummy"
"194225",0,1,0,1,"dummy"
"194226",0,0,1,1,"dummy"
"194227",0,12,0,12,"dummy"
"194237",0,4,0,4,"dummy"
"194238",7,22,2,31,"dummy"
"194239",3,7,0,10,"dummy"
"194240",2,19,0,21,"dummy"
"194244",0,3,1,4,"dummy"
"194251",5,2,0,7,"dummy"
"194252",2,4,0,6,"dummy"
"194257",0,0,1,1,"dummy"
"194264",2,7,3,12,"dummy"
"194265",0,5,0,5,"dummy"
"194274",0,0,0,0,"dummy"
"194275",0,1,0,1,"dummy"
"194276",2,15,0,17,"dummy"
"194277",3,2,0,5,"dummy"
"194278",0,1,0,1,"dummy"
"194279",8,4,0,12,"dummy"
"194280",0,0,1,1,"dummy"
"194281",26,3,1,30,"dummy"
"194282",4,4,0,8,"dummy"
"194294",2,2,1,5,"dummy"
"194295",0,1,0,1,"dummy"
"194181",0,0,1,1,"dummy"
"194186",0,1,0,1,"dummy"
"194190",0,0,1,1,"dummy"
"194206",0,7,2,9,"dummy"
"194207",0,0,1,1,"dummy"
"194229",0,2,0,2,"dummy"
"194230",0,1,0,1,"dummy"
"194231",0,2,0,2,"dummy"
"194232",0,3,0,3,"dummy"
"194235",0,0,0,0,"dummy"
"194242",0,0,1,1,"dummy"
"194254",3,1,0,4,"dummy"
"194255",10,2,1,13,"dummy"
"194259",0,1,1,2,"dummy"
"194260",1,0,0,1,"dummy"
"194261",1,3,1,5,"dummy"
"194262",0,1,0,1,"dummy"
"194271",0,0,1,1,"dummy"
"194272",1,3,1,5,"dummy"
"194284",7,2,4,13,"dummy"
"194286",0,0,1,1,"dummy"
"194287",0,0,1,1,"dummy"
"194288",1,0,0,1,"dummy"
"194289",0,0,1,1,"dummy"
"194290",2,0,0,2,"dummy"
"194291",1,0,0,1,"dummy"
"194292",2,0,0,2,"dummy"
"194298",0,0,1,1,"dummy"
"194299",0,0,1,1,"dummy"
"194300",0,0,1,1,"dummy"
"194301",1,0,0,1,"dummy"
"194302",0,1,0,1,"dummy"
"194305",8,2,0,10,"dummy"
"194306",0,0,0,0,"dummy"
"194307",4,0,1,5,"dummy"
"194308",0,1,1,2,"dummy"
"194309",0,3,1,4,"dummy"
"194310",0,0,0,0,"dummy"
"194311",4,13,0,17,"dummy"
"194325",0,1,1,2,"dummy"
"194326",0,3,2,5,"dummy"
"194329",2,2,0,4,"dummy"
"194330",2,2,0,4,"dummy"
"194331",0,1,0,1,"dummy"
"194332",1,1,0,2,"dummy"
"194333",0,0,0,0,"dummy"
"194334",0,1,2,3,"dummy"
"194335",0,0,0,0,"dummy"
"194336",0,0,3,3,"dummy"
"194337",0,0,3,3,"dummy"
"194338",0,0,0,0,"dummy"
"194339",0,1,0,1,"dummy"
"194340",0,0,0,0,"dummy"
"194341",1,0,0,1,"dummy"
"194342",0,1,0,1,"dummy"
"194343",0,1,0,1,"dummy"
"194344",0,2,0,2,"dummy"
"194345",0,0,2,2,"dummy"
"194353",0,0,1,1,"dummy"
"194354",0,2,0,2,"dummy"
"194355",1,1,5,7,"dummy"
"194356",1,0,5,6,"dummy"
"194361",6,0,1,7,"dummy"
"194373",0,2,1,3,"dummy"
"194374",0,1,0,1,"dummy"
"194375",4,5,1,10,"dummy"
"194378",1,1,2,4,"dummy"
"194379",0,1,0,1,"dummy"
"194380",1,0,0,1,"dummy"
"194381",0,3,0,3,"dummy"
"194415",0,2,0,2,"dummy"
"194296",0,2,0,2,"dummy"
"194317",0,2,0,2,"dummy"
"194318",0,7,1,8,"dummy"
"194319",1,0,0,1,"dummy"
"194320",0,0,1,1,"dummy"
"194321",0,0,1,1,"dummy"
"194322",0,1,0,1,"dummy"
"194323",1,0,0,1,"dummy"
"194347",0,4,1,5,"dummy"
"194363",0,0,1,1,"dummy"
"194364",0,0,1,1,"dummy"
"194365",0,0,2,2,"dummy"
"194366",26,3,7,36,"dummy"
"194369",1,10,2,13,"dummy"
"194370",2,0,0,2,"dummy"
"194371",0,8,0,8,"dummy"
"194405",1,7,1,9,"dummy"
"194406",2,3,0,5,"dummy"
"194417",0,0,0,0,"dummy"
"194418",0,0,2,2,"dummy"
"194419",0,0,0,0,"dummy"
"194420",0,0,1,1,"dummy"
"194423",0,13,2,15,"dummy"
"194424",0,1,1,2,"dummy"
"194425",0,1,1,2,"dummy"
"194429",0,1,0,1,"dummy"
"194430",0,4,0,4,"dummy"
"194431",4,0,0,4,"dummy"
"194432",0,4,0,4,"dummy"
"194435",1,0,0,1,"dummy"
"194448",0,2,0,2,"dummy"
"194450",6,0,0,6,"dummy"
"194451",2,5,2,9,"dummy"
"194454",4,9,4,17,"dummy"
"194455",0,1,0,1,"dummy"
"194456",1,0,3,4,"dummy"
"194458",3,3,1,7,"dummy"
"194460",0,0,1,1,"dummy"
"194461",1,3,0,4,"dummy"
"194462",3,1,0,4,"dummy"
"194467",2,0,1,3,"dummy"
"194468",0,0,1,1,"dummy"
"194471",0,0,2,2,"dummy"
"194472",0,0,2,2,"dummy"
"194473",0,1,1,2,"dummy"
"194474",0,0,1,1,"dummy"
"194475",1,2,3,6,"dummy"
"194476",9,9,2,20,"dummy"
"194485",0,0,2,2,"dummy"
"194488",0,0,1,1,"dummy"
"194489",0,0,1,1,"dummy"
"194490",0,0,1,1,"dummy"
"194491",1,0,1,2,"dummy"
"194494",0,1,0,1,"dummy"
"194495",0,0,0,0,"dummy"
"194499",0,0,1,1,"dummy"
"194501",0,1,4,5,"dummy"
"194502",0,0,1,1,"dummy"
"194503",0,0,1,1,"dummy"
"194504",2,1,0,3,"dummy"
"194505",0,0,1,1,"dummy"
"194517",1,0,0,1,"dummy"
"194520",6,1,1,8,"dummy"
"194521",0,0,0,0,"dummy"
"194523",3,4,0,7,"dummy"
"194531",0,1,0,1,"dummy"
"194532",0,0,1,1,"dummy"
"194533",10,43,4,57,"dummy"
"194539",0,3,0,3,"dummy"
"194543",8,1,3,12,"dummy"
"194544",0,0,0,0,"dummy"
"194545",0,0,1,1,"dummy"
"194546",0,0,0,0,"dummy"
"194549",0,3,0,3,"dummy"
"194550",0,1,0,1,"dummy"
"194551",0,1,0,1,"dummy"
"194552",2,1,0,3,"dummy"
"194553",0,5,0,5,"dummy"
"194554",0,1,0,1,"dummy"
"194555",0,0,1,1,"dummy"
"194556",0,0,5,5,"dummy"
"194557",0,0,1,1,"dummy"
"194563",0,0,1,1,"dummy"
"194565",6,2,1,9,"dummy"
"194566",0,1,0,1,"dummy"
"194567",0,1,0,1,"dummy"
"194568",0,0,1,1,"dummy"
"194570",4,2,1,7,"dummy"
"194571",0,0,1,1,"dummy"
"194572",0,1,0,1,"dummy"
"194574",0,0,0,0,"dummy"
"194575",0,1,0,1,"dummy"
"194576",3,3,1,7,"dummy"
"194582",0,1,0,1,"dummy"
"194583",1,2,2,5,"dummy"
"194584",3,0,0,3,"dummy"
"194585",10,1,0,11,"dummy"
"194586",0,0,1,1,"dummy"
"194587",0,0,1,1,"dummy"
"194588",0,0,1,1,"dummy"
"194589",0,0,1,1,"dummy"
"194590",0,0,1,1,"dummy"
"194591",0,0,1,1,"dummy"
"194592",0,0,1,1,"dummy"
"194593",0,2,0,2,"dummy"
"194594",0,0,1,1,"dummy"
"194595",0,0,1,1,"dummy"
"194596",0,0,1,1,"dummy"
"194597",0,0,1,1,"dummy"
"194598",0,0,1,1,"dummy"
"194599",0,0,1,1,"dummy"
"194600",0,0,1,1,"dummy"
"194601",0,0,1,1,"dummy"
"194602",1,0,0,1,"dummy"
"194603",0,0,2,2,"dummy"
"194604",0,0,1,1,"dummy"
"194605",1,0,0,1,"dummy"
"194606",0,0,1,1,"dummy"
"194607",0,0,1,1,"dummy"
"194616",0,0,1,1,"dummy"
"194618",0,0,2,2,"dummy"
"194621",2,10,1,13,"dummy"
"194622",2,4,0,6,"dummy"
"194624",1,0,1,2,"dummy"
"194625",0,0,1,1,"dummy"
"194626",4,2,0,6,"dummy"
"194627",0,1,1,2,"dummy"
"194628",1,0,0,1,"dummy"
"194631",1,2,0,3,"dummy"
"194632",3,9,0,12,"dummy"
"194633",17,1,0,18,"dummy"
"194634",1,18,0,19,"dummy"
"194635",0,1,1,2,"dummy"
"194636",0,0,0,0,"dummy"
"194637",17,1,0,18,"dummy"
"194638",1,0,0,1,"dummy"
"194639",0,0,0,0,"dummy"
"194640",0,1,1,2,"dummy"
"194641",2,2,0,4,"dummy"
"194642",2,3,0,5,"dummy"
"194643",0,0,1,1,"dummy"
"194644",2,2,0,4,"dummy"
"194645",0,1,0,1,"dummy"
"194646",0,3,1,4,"dummy"
"194647",3,5,2,10,"dummy"
"194648",2,2,1,5,"dummy"
"194649",0,1,0,1,"dummy"
"194650",0,1,0,1,"dummy"
"194651",4,1,0,5,"dummy"
"194652",1,1,1,3,"dummy"
"194653",2,5,2,9,"dummy"
"194654",0,0,1,1,"dummy"
"194655",5,2,1,8,"dummy"
"194656",5,2,1,8,"dummy"
"194657",12,6,0,18,"dummy"
"194658",0,0,0,0,"dummy"
"194659",0,0,0,0,"dummy"
"194660",0,0,0,0,"dummy"
"194661",0,11,0,11,"dummy"
"194662",0,1,0,1,"dummy"
"194663",3,6,0,9,"dummy"
"194664",0,1,0,1,"dummy"
"194665",0,2,0,2,"dummy"
"194666",0,0,1,1,"dummy"
"194667",0,1,0,1,"dummy"
"194668",0,1,0,1,"dummy"
"194669",11,0,0,11,"dummy"
"194670",1,2,1,4,"dummy"
"194671",0,0,1,1,"dummy"
"194678",0,7,0,7,"dummy"
"194681",0,0,1,1,"dummy"
"194684",0,0,0,0,"dummy"
"194686",0,4,0,4,"dummy"
"194687",0,1,1,2,"dummy"
"194688",0,1,0,1,"dummy"
"194689",0,0,1,1,"dummy"
"194690",2,1,4,7,"dummy"
"194693",0,18,0,18,"dummy"
"194694",0,1,0,1,"dummy"
"194698",0,3,0,3,"dummy"
"194699",0,0,1,1,"dummy"
"194700",5,0,2,7,"dummy"
"194717",0,0,4,4,"dummy"
"194721",5,4,2,11,"dummy"
"194722",4,1,0,5,"dummy"
"194742",9,2,0,11,"dummy"
"194746",0,0,1,1,"dummy"
"194747",0,0,1,1,"dummy"
"194748",1,1,0,2,"dummy"
"194749",1,1,0,2,"dummy"
"194750",0,0,1,1,"dummy"
"194752",4,1,0,5,"dummy"
"194753",0,0,0,0,"dummy"
"194754",0,0,0,0,"dummy"
"194755",0,0,1,1,"dummy"
"194756",0,0,0,0,"dummy"
"194757",0,0,0,0,"dummy"
"194758",0,0,0,0,"dummy"
"194759",0,0,1,1,"dummy"
"194760",0,0,0,0,"dummy"
"194765",0,0,1,1,"dummy"
"194766",0,0,1,1,"dummy"
"194767",0,0,1,1,"dummy"
"194768",0,0,1,1,"dummy"
"194769",0,0,1,1,"dummy"
"194770",0,0,1,1,"dummy"
"194771",0,0,1,1,"dummy"
"194772",3,10,1,14,"dummy"
"194773",0,0,1,1,"dummy"
"194774",0,0,1,1,"dummy"
"194775",0,0,1,1,"dummy"
"194776",0,0,1,1,"dummy"
"194777",0,0,1,1,"dummy"
"194778",0,0,1,1,"dummy"
"194779",0,0,1,1,"dummy"
"194780",0,0,1,1,"dummy"
"194781",0,0,1,1,"dummy"
"194782",0,0,1,1,"dummy"
"194783",0,0,1,1,"dummy"
"194784",0,0,1,1,"dummy"
"194785",0,0,1,1,"dummy"
"194786",0,0,1,1,"dummy"
"194787",0,0,1,1,"dummy"
"194788",0,0,1,1,"dummy"
"194789",0,0,1,1,"dummy"
"194790",0,0,1,1,"dummy"
"194791",0,0,1,1,"dummy"
"194792",0,0,1,1,"dummy"
"194793",0,0,1,1,"dummy"
"194794",0,0,1,1,"dummy"
"194795",0,0,1,1,"dummy"
"194799",0,7,0,7,"dummy"
"194800",0,2,0,2,"dummy"
"194801",0,1,0,1,"dummy"
"194802",0,1,2,3,"dummy"
"194805",0,1,0,1,"dummy"
"194806",0,1,0,1,"dummy"
"194807",0,0,2,2,"dummy"
"194809",0,3,0,3,"dummy"
"194810",1,0,0,1,"dummy"
"194811",0,3,0,3,"dummy"
"194812",0,2,0,2,"dummy"
"194813",0,1,0,1,"dummy"
"194814",0,2,0,2,"dummy"
"194815",0,1,0,1,"dummy"
"194816",0,2,0,2,"dummy"
"194817",5,2,2,9,"dummy"
"194818",0,5,0,5,"dummy"
"194819",7,8,2,17,"dummy"
"194820",0,0,0,0,"dummy"
"194821",0,0,0,0,"dummy"
"194822",1,14,1,16,"dummy"
"194823",0,4,0,4,"dummy"
"194824",0,1,0,1,"dummy"
"194825",0,0,2,2,"dummy"
"194826",10,11,2,23,"dummy"
"194838",0,0,1,1,"dummy"
"194839",0,1,0,1,"dummy"
"194840",0,0,8,8,"dummy"
"194892",4,11,0,15,"dummy"
"194893",0,1,0,1,"dummy"
"194894",4,21,0,25,"dummy"
"194895",0,2,0,2,"dummy"
"194898",0,0,1,1,"dummy"
"194899",0,0,1,1,"dummy"
"194900",0,0,1,1,"dummy"
"194901",0,1,0,1,"dummy"
"194902",0,0,1,1,"dummy"
"194903",0,0,1,1,"dummy"
"194904",0,0,1,1,"dummy"
"194905",0,0,1,1,"dummy"
"194906",0,0,1,1,"dummy"
"194907",2,2,0,4,"dummy"
"194908",0,0,1,1,"dummy"
"194909",0,0,1,1,"dummy"
"194910",0,0,1,1,"dummy"
"194911",0,0,1,1,"dummy"
"194912",0,0,1,1,"dummy"
"194913",0,0,1,1,"dummy"
"194914",0,0,1,1,"dummy"
"194915",0,0,1,1,"dummy"
"194916",0,0,1,1,"dummy"
"194917",0,0,1,1,"dummy"
"194918",0,0,1,1,"dummy"
"194919",0,0,1,1,"dummy"
"194920",0,0,1,1,"dummy"
"194921",0,0,1,1,"dummy"
"194922",0,0,1,1,"dummy"
"194923",0,0,1,1,"dummy"
"194924",0,0,1,1,"dummy"
"194925",0,0,1,1,"dummy"
"194926",0,0,1,1,"dummy"
"194927",0,0,1,1,"dummy"
"194928",0,0,1,1,"dummy"
"194929",0,0,1,1,"dummy"
"194930",0,0,1,1,"dummy"
"194931",0,0,1,1,"dummy"
"194932",0,0,1,1,"dummy"
"194933",0,0,1,1,"dummy"
"194934",0,0,1,1,"dummy"
"194935",0,0,1,1,"dummy"
"194936",0,0,1,1,"dummy"
"194937",0,0,1,1,"dummy"
"194938",0,0,1,1,"dummy"
"194939",0,0,1,1,"dummy"
"194940",0,0,1,1,"dummy"
"194941",0,0,1,1,"dummy"
"194942",0,0,1,1,"dummy"
"194943",0,0,1,1,"dummy"
"194944",0,0,1,1,"dummy"
"194945",0,0,1,1,"dummy"
"194946",0,0,1,1,"dummy"
"194947",0,0,1,1,"dummy"
"194948",0,0,1,1,"dummy"
"194949",0,0,1,1,"dummy"
"194950",0,0,1,1,"dummy"
"194954",0,0,1,1,"dummy"
"194955",2,0,1,3,"dummy"
"194961",0,0,1,1,"dummy"
"194964",0,0,1,1,"dummy"
"194965",0,0,0,0,"dummy"
"195008",11,5,2,18,"dummy"
"195009",0,0,1,1,"dummy"
"195010",0,0,1,1,"dummy"
"195011",0,0,1,1,"dummy"
"195012",0,0,1,1,"dummy"
"195013",0,0,1,1,"dummy"
"195014",0,2,0,2,"dummy"
"195015",0,0,1,1,"dummy"
"195052",11,20,6,37,"dummy"
"195053",0,1,0,1,"dummy"
"195054",1,2,2,5,"dummy"
"195055",0,1,1,2,"dummy"
"194886",0,0,2,2,"dummy"
"194952",3,0,0,3,"dummy"
"194957",1,10,3,14,"dummy"
"194958",2,17,5,24,"dummy"
"194959",0,2,0,2,"dummy"
"194967",7,4,0,11,"dummy"
"194968",7,6,3,16,"dummy"
"194969",0,0,1,1,"dummy"
"194970",0,1,0,1,"dummy"
"194971",0,1,1,2,"dummy"
"194972",2,4,0,6,"dummy"
"195002",0,2,1,3,"dummy"
"195005",1,14,1,16,"dummy"
"195006",1,0,0,1,"dummy"
"195017",2,0,0,2,"dummy"
"195018",0,1,0,1,"dummy"
"195062",0,0,1,1,"dummy"
"195063",0,0,3,3,"dummy"
"195064",0,1,0,1,"dummy"
"195065",1,0,0,1,"dummy"
"195066",2,4,0,6,"dummy"
"195067",1,0,0,1,"dummy"
"195089",0,1,0,1,"dummy"
"195100",2,2,0,4,"dummy"
"195101",0,1,0,1,"dummy"
"195102",1,0,0,1,"dummy"
"195105",1,0,2,3,"dummy"
"195106",0,0,1,1,"dummy"
"195112",3,2,0,5,"dummy"
"195113",0,3,1,4,"dummy"
"195114",0,0,1,1,"dummy"
"195115",2,0,0,2,"dummy"
"195116",4,4,0,8,"dummy"
"195120",0,0,1,1,"dummy"
"195124",5,0,1,6,"dummy"
"195125",0,5,1,6,"dummy"
"195126",5,0,1,6,"dummy"
"195127",0,0,0,0,"dummy"
"195131",0,0,1,1,"dummy"
"195132",0,0,1,1,"dummy"
"195133",0,0,1,1,"dummy"
"195134",0,0,1,1,"dummy"
"195135",0,0,1,1,"dummy"
"195136",0,0,1,1,"dummy"
"195137",0,0,1,1,"dummy"
"195162",2,0,0,2,"dummy"
"195165",0,16,0,16,"dummy"
"195166",2,1,0,3,"dummy"
"195196",2,2,0,4,"dummy"
"195197",0,2,0,2,"dummy"
"195198",0,0,1,1,"dummy"
"195199",0,0,1,1,"dummy"
"195200",0,1,0,1,"dummy"
"195201",0,0,1,1,"dummy"
"195202",0,0,0,0,"dummy"
"195203",0,3,1,4,"dummy"
"195204",3,0,2,5,"dummy"
"195205",0,3,1,4,"dummy"
"195211",2,0,0,2,"dummy"
"195216",0,0,1,1,"dummy"
"195217",2,5,0,7,"dummy"
"195218",0,2,0,2,"dummy"
"195219",7,13,2,22,"dummy"
"195220",2,1,0,3,"dummy"
"195221",0,0,2,2,"dummy"
"195222",10,11,1,22,"dummy"
"195223",0,0,1,1,"dummy"
"195224",16,0,1,17,"dummy"
"195056",2,3,0,5,"dummy"
"195059",7,16,2,25,"dummy"
"195060",0,0,1,1,"dummy"
"195077",0,1,0,1,"dummy"
"195078",0,0,1,1,"dummy"
"195079",0,0,1,1,"dummy"
"195080",0,1,0,1,"dummy"
"195083",0,0,0,0,"dummy"
"195084",0,0,0,0,"dummy"
"195087",0,0,0,0,"dummy"
"195108",0,0,1,1,"dummy"
"195109",4,7,0,11,"dummy"
"195110",0,1,0,1,"dummy"
"195118",0,2,0,2,"dummy"
"195122",0,0,1,1,"dummy"
"195129",0,0,1,1,"dummy"
"195142",11,6,0,17,"dummy"
"195143",0,0,1,1,"dummy"
"195144",3,2,0,5,"dummy"
"195145",2,0,0,2,"dummy"
"195146",0,4,0,4,"dummy"
"195147",0,1,0,1,"dummy"
"195170",1,0,1,2,"dummy"
"195207",3,9,1,13,"dummy"
"195208",0,2,0,2,"dummy"
"195209",0,2,0,2,"dummy"
"195227",1,0,0,1,"dummy"
"195228",0,2,0,2,"dummy"
"195238",0,1,0,1,"dummy"
"195239",0,1,0,1,"dummy"
"195240",1,0,0,1,"dummy"
"195241",5,5,0,10,"dummy"
"195242",0,0,1,1,"dummy"
"195243",0,0,2,2,"dummy"
"195244",0,3,1,4,"dummy"
"195245",5,51,2,58,"dummy"
"195246",45,2,0,47,"dummy"
"195247",2,4,2,8,"dummy"
"195259",0,2,0,2,"dummy"
"195260",1,0,1,2,"dummy"
"195265",1,0,2,3,"dummy"
"195266",0,0,1,1,"dummy"
"195271",0,0,3,3,"dummy"
"195272",0,2,0,2,"dummy"
"195273",0,4,1,5,"dummy"
"195274",0,4,0,4,"dummy"
"195283",2,4,0,6,"dummy"
"195284",0,2,0,2,"dummy"
"195285",0,2,0,2,"dummy"
"195286",10,2,0,12,"dummy"
"195287",0,2,0,2,"dummy"
"195293",0,1,0,1,"dummy"
"195225",0,0,1,1,"dummy"
"195230",1,1,0,2,"dummy"
"195231",0,0,0,0,"dummy"
"195232",0,1,0,1,"dummy"
"195233",0,1,1,2,"dummy"
"195234",2,2,4,8,"dummy"
"195235",3,3,0,6,"dummy"
"195236",0,0,1,1,"dummy"
"195256",2,0,0,2,"dummy"
"195257",0,0,0,0,"dummy"
"195268",2,2,2,6,"dummy"
"195269",0,0,2,2,"dummy"
"195276",6,16,3,25,"dummy"
"195277",0,1,3,4,"dummy"
"195280",1,7,0,8,"dummy"
"195281",2,1,0,3,"dummy"
"195289",2,7,4,13,"dummy"
"195290",0,0,1,1,"dummy"
"195291",0,0,1,1,"dummy"
"195314",0,2,0,2,"dummy"
"195315",0,3,1,4,"dummy"
"195316",3,1,0,4,"dummy"
"195324",0,1,0,1,"dummy"
"195325",0,4,0,4,"dummy"
"195326",1,0,0,1,"dummy"
"195327",1,4,1,6,"dummy"
"195328",0,0,1,1,"dummy"
"195329",8,4,2,14,"dummy"
"195330",0,0,1,1,"dummy"
"195331",5,7,2,14,"dummy"
"195332",0,1,0,1,"dummy"
"195333",2,2,1,5,"dummy"
"195334",7,6,2,15,"dummy"
"195335",0,3,0,3,"dummy"
"195336",19,1,1,21,"dummy"
"195337",0,0,0,0,"dummy"
"195338",0,1,0,1,"dummy"
"195339",0,0,0,0,"dummy"
"195340",0,0,1,1,"dummy"
"195344",2,11,0,13,"dummy"
"195345",0,7,0,7,"dummy"
"195355",9,3,5,17,"dummy"
"195358",0,0,0,0,"dummy"
"195359",0,1,0,1,"dummy"
"195360",0,0,0,0,"dummy"
"195361",1,0,1,2,"dummy"
"195362",0,1,1,2,"dummy"
"195363",0,1,0,1,"dummy"
"195364",2,1,0,3,"dummy"
"195365",0,2,0,2,"dummy"
"195369",0,9,0,9,"dummy"
"195370",4,3,0,7,"dummy"
"195371",1,0,1,2,"dummy"
"195374",2,12,1,15,"dummy"
"195389",0,0,2,2,"dummy"
"195390",1,0,0,1,"dummy"
"195396",0,1,0,1,"dummy"
"195431",1,0,0,1,"dummy"
"195437",0,0,2,2,"dummy"
"195438",2,1,0,3,"dummy"
"195439",1,1,0,2,"dummy"
"195440",0,1,0,1,"dummy"
"195441",0,3,0,3,"dummy"
"195442",1,0,0,1,"dummy"
"195443",1,3,0,4,"dummy"
"195448",1,3,3,7,"dummy"
"195449",0,1,0,1,"dummy"
"195450",0,1,0,1,"dummy"
"195451",0,0,1,1,"dummy"
"195454",2,0,0,2,"dummy"
"195462",0,0,1,1,"dummy"
"195463",0,1,0,1,"dummy"
"195342",0,11,0,11,"dummy"
"195347",0,1,0,1,"dummy"
"195350",0,0,2,2,"dummy"
"195351",0,0,2,2,"dummy"
"195367",0,0,2,2,"dummy"
"195378",0,0,0,0,"dummy"
"195381",0,1,0,1,"dummy"
"195382",0,1,0,1,"dummy"
"195383",0,1,0,1,"dummy"
"195384",2,6,0,8,"dummy"
"195385",1,1,0,2,"dummy"
"195386",3,3,2,8,"dummy"
"195387",8,1,3,12,"dummy"
"195392",4,4,0,8,"dummy"
"195393",6,2,1,9,"dummy"
"195394",0,3,0,3,"dummy"
"195398",0,0,1,1,"dummy"
"195399",0,0,1,1,"dummy"
"195400",0,0,2,2,"dummy"
"195401",1,0,1,2,"dummy"
"195402",0,0,1,1,"dummy"
"195403",0,0,1,1,"dummy"
"195404",0,0,1,1,"dummy"
"195405",0,0,1,1,"dummy"
"195406",0,0,1,1,"dummy"
"195407",0,0,1,1,"dummy"
"195408",0,0,1,1,"dummy"
"195409",0,0,1,1,"dummy"
"195410",1,0,1,2,"dummy"
"195411",0,1,2,3,"dummy"
"195412",0,0,1,1,"dummy"
"195413",1,0,2,3,"dummy"
"195414",0,0,1,1,"dummy"
"195415",0,4,1,5,"dummy"
"195416",3,3,0,6,"dummy"
"195417",1,1,0,2,"dummy"
"195418",0,0,1,1,"dummy"
"195419",5,1,0,6,"dummy"
"195420",0,2,1,3,"dummy"
"195421",1,0,2,3,"dummy"
"195422",0,1,2,3,"dummy"
"195423",2,4,2,8,"dummy"
"195424",0,2,0,2,"dummy"
"195425",1,6,1,8,"dummy"
"195426",1,0,0,1,"dummy"
"195427",0,0,1,1,"dummy"
"195433",0,1,0,1,"dummy"
"195456",0,0,1,1,"dummy"
"195457",4,11,0,15,"dummy"
"195458",1,1,0,2,"dummy"
"195504",4,3,2,9,"dummy"
"195505",0,1,0,1,"dummy"
"195511",0,3,3,6,"dummy"
"195514",3,2,0,5,"dummy"
"195519",1,0,0,1,"dummy"
"195524",0,0,1,1,"dummy"
"195525",0,0,0,0,"dummy"
"195526",1,0,0,1,"dummy"
"195527",0,3,0,3,"dummy"
"195528",0,0,1,1,"dummy"
"195529",1,1,0,2,"dummy"
"195530",0,1,0,1,"dummy"
"195531",0,1,0,1,"dummy"
"195532",0,0,1,1,"dummy"
"195533",0,1,0,1,"dummy"
"195534",1,0,0,1,"dummy"
"195535",0,1,0,1,"dummy"
"195536",0,1,0,1,"dummy"
"195537",0,0,2,2,"dummy"
"195538",0,0,2,2,"dummy"
"195539",0,1,1,2,"dummy"
"195540",1,2,1,4,"dummy"
"195541",1,0,0,1,"dummy"
"195548",0,2,0,2,"dummy"
"195464",1,0,2,3,"dummy"
"195465",0,1,1,2,"dummy"
"195521",0,4,0,4,"dummy"
"195522",0,0,1,1,"dummy"
"195543",0,1,0,1,"dummy"
"195544",0,0,1,1,"dummy"
"195545",0,1,0,1,"dummy"
"195546",0,0,1,1,"dummy"
"195550",5,0,0,5,"dummy"
"195551",1,0,2,3,"dummy"
"195552",1,3,4,8,"dummy"
"195557",0,0,1,1,"dummy"
"195562",0,0,1,1,"dummy"
"195563",0,0,1,1,"dummy"
"195564",0,0,1,1,"dummy"
"195565",0,0,1,1,"dummy"
"195566",0,0,1,1,"dummy"
"195570",0,1,2,3,"dummy"
"195571",0,2,0,2,"dummy"
"195572",0,0,1,1,"dummy"
"195576",6,3,3,12,"dummy"
"195587",0,2,0,2,"dummy"
"195623",6,1,4,11,"dummy"
"195624",3,4,4,11,"dummy"
"195625",4,4,1,9,"dummy"
"195626",4,3,4,11,"dummy"
"195627",0,0,0,0,"dummy"
"195634",0,0,1,1,"dummy"
"195635",0,0,0,0,"dummy"
"195645",0,1,0,1,"dummy"
"195646",0,1,0,1,"dummy"
"195647",1,2,1,4,"dummy"
"195687",0,0,0,0,"dummy"
"195692",0,1,2,3,"dummy"
"195693",0,0,1,1,"dummy"
"195694",16,21,1,38,"dummy"
"195695",0,0,0,0,"dummy"
"195703",7,0,1,8,"dummy"
"195706",1,1,0,2,"dummy"
"195709",0,0,0,0,"dummy"
"195710",0,0,0,0,"dummy"
"195711",0,0,0,0,"dummy"
"195712",0,0,0,0,"dummy"
"195713",0,0,0,0,"dummy"
"195716",0,0,0,0,"dummy"
"195568",1,0,0,1,"dummy"
"195574",0,0,1,1,"dummy"
"195578",0,1,0,1,"dummy"
"195579",0,0,3,3,"dummy"
"195582",1,0,0,1,"dummy"
"195583",2,2,2,6,"dummy"
"195589",0,0,1,1,"dummy"
"195592",0,0,0,0,"dummy"
"195593",0,1,0,1,"dummy"
"195594",1,0,0,1,"dummy"
"195595",1,0,0,1,"dummy"
"195596",0,0,0,0,"dummy"
"195597",0,1,1,2,"dummy"
"195598",1,0,1,2,"dummy"
"195599",0,1,1,2,"dummy"
"195600",0,0,0,0,"dummy"
"195601",0,2,1,3,"dummy"
"195602",0,0,1,1,"dummy"
"195603",2,5,1,8,"dummy"
"195604",1,4,0,5,"dummy"
"195605",0,4,0,4,"dummy"
"195606",0,1,1,2,"dummy"
"195607",8,0,0,8,"dummy"
"195608",3,0,0,3,"dummy"
"195609",0,0,0,0,"dummy"
"195610",0,7,0,7,"dummy"
"195611",1,0,0,1,"dummy"
"195612",0,2,0,2,"dummy"
"195613",1,1,0,2,"dummy"
"195614",0,0,1,1,"dummy"
"195615",3,0,0,3,"dummy"
"195616",2,0,0,2,"dummy"
"195617",0,2,0,2,"dummy"
"195618",0,2,0,2,"dummy"
"195621",1,0,1,2,"dummy"
"195631",3,1,0,4,"dummy"
"195632",0,0,3,3,"dummy"
"195649",0,1,0,1,"dummy"
"195650",1,16,0,17,"dummy"
"195651",0,4,0,4,"dummy"
"195652",0,1,1,2,"dummy"
"195653",3,3,5,11,"dummy"
"195654",0,2,0,2,"dummy"
"195689",3,3,0,6,"dummy"
"195690",0,2,0,2,"dummy"
"195697",0,0,1,1,"dummy"
"195700",0,0,0,0,"dummy"
"195701",0,2,0,2,"dummy"
"195718",0,0,0,0,"dummy"
"195719",0,0,1,1,"dummy"
"195724",0,4,0,4,"dummy"
"195752",2,7,1,10,"dummy"
"195726",0,1,0,1,"dummy"
"195727",0,1,0,1,"dummy"
"195728",3,2,0,5,"dummy"
"195729",0,1,1,2,"dummy"
"195730",0,3,0,3,"dummy"
"195731",2,6,1,9,"dummy"
"195732",1,3,0,4,"dummy"
"195733",0,0,1,1,"dummy"
"195734",1,2,0,3,"dummy"
"195735",0,0,1,1,"dummy"
"195736",0,2,1,3,"dummy"
"195737",0,0,2,2,"dummy"
"195738",0,1,0,1,"dummy"
"195739",0,2,0,2,"dummy"
"195740",2,3,0,5,"dummy"
"195741",1,0,0,1,"dummy"
"195742",0,0,5,5,"dummy"
"195743",0,1,0,1,"dummy"
"195744",2,0,0,2,"dummy"
"195745",1,1,0,2,"dummy"
"195746",0,0,0,0,"dummy"
"195747",2,2,0,4,"dummy"
"195748",0,0,0,0,"dummy"
"195749",0,0,2,2,"dummy"
"195750",0,2,0,2,"dummy"
"195754",0,2,2,4,"dummy"
"195755",6,5,1,12,"dummy"
"195756",0,1,2,3,"dummy"
"195757",1,4,1,6,"dummy"
"195758",0,2,0,2,"dummy"
"195759",16,0,3,19,"dummy"
"195760",4,3,0,7,"dummy"
"195761",0,2,3,5,"dummy"
"195762",4,0,0,4,"dummy"
"195763",0,6,0,6,"dummy"
"195764",0,0,1,1,"dummy"
"195765",0,0,1,1,"dummy"
"195766",0,1,0,1,"dummy"
"195767",0,0,1,1,"dummy"
"195768",0,0,0,0,"dummy"
"195769",0,2,0,2,"dummy"
"195770",0,3,0,3,"dummy"
"195771",3,0,0,3,"dummy"
"195772",0,3,0,3,"dummy"
"195773",0,0,1,1,"dummy"
"195777",0,1,0,1,"dummy"
"195778",0,0,0,0,"dummy"
"195781",0,2,0,2,"dummy"
"195782",1,0,0,1,"dummy"
"195783",1,4,0,5,"dummy"
"195784",1,0,0,1,"dummy"
"195787",1,0,1,2,"dummy"
"195790",0,4,0,4,"dummy"
"195793",0,0,2,2,"dummy"
"195794",1,0,0,1,"dummy"
"195796",0,0,0,0,"dummy"
"195798",2,1,0,3,"dummy"
"195799",1,0,0,1,"dummy"
"195800",0,1,0,1,"dummy"
"195805",0,0,1,1,"dummy"
"195806",0,3,1,4,"dummy"
"195807",2,2,1,5,"dummy"
"195808",0,2,0,2,"dummy"
"195809",2,0,0,2,"dummy"
"195817",0,0,2,2,"dummy"
"195821",0,0,2,2,"dummy"
"195822",0,0,1,1,"dummy"
"195823",0,0,1,1,"dummy"
"195824",1,0,0,1,"dummy"
"195826",1,0,0,1,"dummy"
"195828",0,1,1,2,"dummy"
"195829",0,1,0,1,"dummy"
"195830",0,0,1,1,"dummy"
"195831",0,2,0,2,"dummy"
"195832",0,0,1,1,"dummy"
"195833",0,0,0,0,"dummy"
"195834",0,1,0,1,"dummy"
"195835",3,2,0,5,"dummy"
"195836",0,0,1,1,"dummy"
"195837",0,0,1,1,"dummy"
"195838",4,4,0,8,"dummy"
"195839",9,5,1,15,"dummy"
"195840",5,0,1,6,"dummy"
"195842",0,1,1,2,"dummy"
"195843",1,0,0,1,"dummy"
"195844",2,1,1,4,"dummy"
"195845",0,5,0,5,"dummy"
"195846",2,2,1,5,"dummy"
"195847",2,3,1,6,"dummy"
"195848",4,2,1,7,"dummy"
"195849",0,1,1,2,"dummy"
"195850",1,0,1,2,"dummy"
"195851",0,1,1,2,"dummy"
"195857",0,0,0,0,"dummy"
"195858",0,0,0,0,"dummy"
"195860",0,0,2,2,"dummy"
"195861",0,0,1,1,"dummy"
"195863",0,1,0,1,"dummy"
"195865",0,7,0,7,"dummy"
"195866",7,9,0,16,"dummy"
"195867",13,0,1,14,"dummy"
"195868",1,0,0,1,"dummy"
"195869",1,0,0,1,"dummy"
"195870",5,1,4,10,"dummy"
"195871",0,0,1,1,"dummy"
"195872",0,0,2,2,"dummy"
"195873",3,0,0,3,"dummy"
"195874",2,2,1,5,"dummy"
"195875",1,1,0,2,"dummy"
"195876",0,0,1,1,"dummy"
"195877",0,0,1,1,"dummy"
"195878",0,0,1,1,"dummy"
"195880",1,3,1,5,"dummy"
"195896",0,2,0,2,"dummy"
"195897",0,0,1,1,"dummy"
"195899",0,0,0,0,"dummy"
"195900",0,0,0,0,"dummy"
"195902",0,0,1,1,"dummy"
"195903",0,4,0,4,"dummy"
"195904",0,1,1,2,"dummy"
"195910",1,0,0,1,"dummy"
"195911",1,0,0,1,"dummy"
"195912",2,1,0,3,"dummy"
"195913",7,8,0,15,"dummy"
"195914",0,2,0,2,"dummy"
"195915",0,2,0,2,"dummy"
"195917",2,5,0,7,"dummy"
"195918",1,1,0,2,"dummy"
"195919",1,1,0,2,"dummy"
"195920",0,0,1,1,"dummy"
"195921",0,1,0,1,"dummy"
"195922",0,2,0,2,"dummy"
"195924",0,1,0,1,"dummy"
"195925",1,0,0,1,"dummy"
"195927",0,1,0,1,"dummy"
"195929",1,3,0,4,"dummy"
"195930",0,0,1,1,"dummy"
"195933",3,4,0,7,"dummy"
"195934",4,3,0,7,"dummy"
"195935",2,2,0,4,"dummy"
"195936",6,6,2,14,"dummy"
"195939",0,0,1,1,"dummy"
"195940",0,0,0,0,"dummy"
"195942",1,6,1,8,"dummy"
"195943",1,6,0,7,"dummy"
"195944",0,0,1,1,"dummy"
"195945",10,10,1,21,"dummy"
"195946",5,11,4,20,"dummy"
"195947",18,2,2,22,"dummy"
"195948",0,2,0,2,"dummy"
"195949",1,9,0,10,"dummy"
"195950",16,4,0,20,"dummy"
"195952",0,1,0,1,"dummy"
"195953",2,4,1,7,"dummy"
"195954",0,1,1,2,"dummy"
"195955",0,0,1,1,"dummy"
"195959",0,1,0,1,"dummy"
"195962",0,0,1,1,"dummy"
"195963",1,0,0,1,"dummy"
"195964",0,0,1,1,"dummy"
"195965",0,0,1,1,"dummy"
"195967",0,0,0,0,"dummy"
"195968",0,0,0,0,"dummy"
"195970",0,1,0,1,"dummy"
"195971",4,9,0,13,"dummy"
"195973",1,0,0,1,"dummy"
"195974",2,0,1,3,"dummy"
"195975",0,0,0,0,"dummy"
"195976",0,1,0,1,"dummy"
"195977",8,1,0,9,"dummy"
"195978",0,0,0,0,"dummy"
"195979",0,0,0,0,"dummy"
"195980",1,10,0,11,"dummy"
"195981",7,1,0,8,"dummy"
"195982",2,0,3,5,"dummy"
"195984",0,0,0,0,"dummy"
"195985",0,0,0,0,"dummy"
"195986",0,1,2,3,"dummy"
"195987",1,1,1,3,"dummy"
"195988",0,0,0,0,"dummy"
"195990",0,1,0,1,"dummy"
"195994",10,32,0,42,"dummy"
"195995",0,2,0,2,"dummy"
"195996",0,1,0,1,"dummy"
"195997",1,0,1,2,"dummy"
"195998",0,1,0,1,"dummy"
"195999",2,7,0,9,"dummy"
"196000",0,1,0,1,"dummy"
"196001",0,0,1,1,"dummy"
"196002",0,0,0,0,"dummy"
"196003",1,4,0,5,"dummy"
"196004",0,2,0,2,"dummy"
"196005",3,7,0,10,"dummy"
"196006",14,5,0,19,"dummy"
"196007",10,12,0,22,"dummy"
"196008",0,2,0,2,"dummy"
"196009",1,1,0,2,"dummy"
"196010",5,1,1,7,"dummy"
"196011",0,3,0,3,"dummy"
"196012",0,1,0,1,"dummy"
"196014",2,4,1,7,"dummy"
"196015",0,3,0,3,"dummy"
"196016",0,1,0,1,"dummy"
"196017",0,2,1,3,"dummy"
"196018",0,3,0,3,"dummy"
"196019",0,2,0,2,"dummy"
"196020",12,2,3,17,"dummy"
"196021",0,0,1,1,"dummy"
"196022",0,2,0,2,"dummy"
"196023",0,0,2,2,"dummy"
"196024",0,0,1,1,"dummy"
"196025",0,2,0,2,"dummy"
"196026",0,0,1,1,"dummy"
"196027",0,2,0,2,"dummy"
"196028",0,2,0,2,"dummy"
"196029",1,2,1,4,"dummy"
"196030",0,0,3,3,"dummy"
"196031",0,0,0,0,"dummy"
"196033",1,7,1,9,"dummy"
"196034",3,10,2,15,"dummy"
"196035",1,0,0,1,"dummy"
"196036",0,1,0,1,"dummy"
"196037",0,2,0,2,"dummy"
"196038",0,0,1,1,"dummy"
"196039",0,1,0,1,"dummy"
"196040",0,0,1,1,"dummy"
"196041",0,0,1,1,"dummy"
"196042",0,0,0,0,"dummy"
"196058",0,0,1,1,"dummy"
"196063",0,11,0,11,"dummy"
"196064",3,6,0,9,"dummy"
"196065",2,1,0,3,"dummy"
"196067",0,2,0,2,"dummy"
"196068",0,2,0,2,"dummy"
"196069",2,4,0,6,"dummy"
"196070",0,6,1,7,"dummy"
"196071",5,1,1,7,"dummy"
"196072",14,2,0,16,"dummy"
"196073",1,0,0,1,"dummy"
"196081",1,0,1,2,"dummy"
"196083",0,0,0,0,"dummy"
"196084",0,0,0,0,"dummy"
"196087",0,0,2,2,"dummy"
"196088",0,0,2,2,"dummy"
"196089",0,0,2,2,"dummy"
"196090",0,1,0,1,"dummy"
"196091",0,0,3,3,"dummy"
"196092",0,0,3,3,"dummy"
"196093",0,0,2,2,"dummy"
"196094",0,1,3,4,"dummy"
"196095",1,0,0,1,"dummy"
"196096",0,1,0,1,"dummy"
"196098",1,2,0,3,"dummy"
"196099",1,1,0,2,"dummy"
"196101",0,3,0,3,"dummy"
"196102",0,0,0,0,"dummy"
"196104",1,0,0,1,"dummy"
"196105",0,3,1,4,"dummy"
"196106",0,0,0,0,"dummy"
"196107",0,2,0,2,"dummy"
"196108",0,10,0,10,"dummy"
"196109",0,2,0,2,"dummy"
"196110",0,1,1,2,"dummy"
"196111",0,0,1,1,"dummy"
"196113",0,22,0,22,"dummy"
"196131",0,7,1,8,"dummy"
"196132",9,0,0,9,"dummy"
"196133",0,1,0,1,"dummy"
"196134",0,11,0,11,"dummy"
"196157",0,1,0,1,"dummy"
"196158",1,0,0,1,"dummy"
"196164",0,2,0,2,"dummy"
"196165",0,1,0,1,"dummy"
"196166",0,1,0,1,"dummy"
"196182",0,0,0,0,"dummy"
"196183",0,0,0,0,"dummy"
"196185",2,1,0,3,"dummy"
"196187",0,2,0,2,"dummy"
"196188",0,0,0,0,"dummy"
"196191",4,6,1,11,"dummy"
"196192",5,0,2,7,"dummy"
"196193",0,0,1,1,"dummy"
"196194",0,0,1,1,"dummy"
"196195",0,0,1,1,"dummy"
"196196",0,0,1,1,"dummy"
"196197",1,3,2,6,"dummy"
"196198",1,0,0,1,"dummy"
"196199",0,4,0,4,"dummy"
"196200",1,0,1,2,"dummy"
"196205",9,11,0,20,"dummy"
"196206",2,1,0,3,"dummy"
"196209",1,0,0,1,"dummy"
"196213",1,0,0,1,"dummy"
"196214",0,0,0,0,"dummy"
"196215",0,0,1,1,"dummy"
"196216",1,1,0,2,"dummy"
"196217",0,1,0,1,"dummy"
"196218",1,1,0,2,"dummy"
"196221",2,0,3,5,"dummy"
"196241",1,2,0,3,"dummy"
"196244",2,4,0,6,"dummy"
"196245",0,2,0,2,"dummy"
"196246",0,2,0,2,"dummy"
"196247",10,2,0,12,"dummy"
"196248",0,2,0,2,"dummy"
"196249",0,0,0,0,"dummy"
"196251",0,0,0,0,"dummy"
"196252",0,0,0,0,"dummy"
"196254",46,10,4,60,"dummy"
"196255",5,5,0,10,"dummy"
"196256",10,11,1,22,"dummy"
"196257",14,22,3,39,"dummy"
"196258",0,1,0,1,"dummy"
"196259",11,5,2,18,"dummy"
"196260",24,9,4,37,"dummy"
"196261",0,2,1,3,"dummy"
"196262",1,9,0,10,"dummy"
"196263",0,2,1,3,"dummy"
"196264",1,11,1,13,"dummy"
"196265",25,18,0,43,"dummy"
"196267",0,19,2,21,"dummy"
"196268",16,1,0,17,"dummy"
"196269",0,0,0,0,"dummy"
"196270",0,0,0,0,"dummy"
"196272",10,0,0,10,"dummy"
"196273",0,1,0,1,"dummy"
"196274",0,0,3,3,"dummy"
"196275",1,0,0,1,"dummy"
"196277",0,4,0,4,"dummy"
"196278",17,5,2,24,"dummy"
"196282",0,4,2,6,"dummy"
"196283",0,8,1,9,"dummy"
"196284",0,0,1,1,"dummy"
"196285",0,2,1,3,"dummy"
"196286",1,3,2,6,"dummy"
"196287",0,3,2,5,"dummy"
"196288",0,0,1,1,"dummy"
"196290",0,0,1,1,"dummy"
"196292",0,0,1,1,"dummy"
"196293",0,0,1,1,"dummy"
"196295",0,0,1,1,"dummy"
"196296",0,5,1,6,"dummy"
"196297",0,0,0,0,"dummy"
"196302",4,3,0,7,"dummy"
"196303",0,1,0,1,"dummy"
"196304",1,0,0,1,"dummy"
"196305",0,1,0,1,"dummy"
"196306",0,1,0,1,"dummy"
"196307",0,1,0,1,"dummy"
"196308",0,1,0,1,"dummy"
"196317",2,0,0,2,"dummy"
"196318",0,3,0,3,"dummy"
"196319",4,0,0,4,"dummy"
"196321",0,0,1,1,"dummy"
"196322",2,2,0,4,"dummy"
"196323",0,0,1,1,"dummy"
"196324",2,2,0,4,"dummy"
"196325",2,2,0,4,"dummy"
"196326",2,2,0,4,"dummy"
"196327",0,0,1,1,"dummy"
"196328",0,0,1,1,"dummy"
"196329",2,2,1,5,"dummy"
"196330",0,0,1,1,"dummy"
"196331",0,0,1,1,"dummy"
"196332",0,0,1,1,"dummy"
"196333",2,2,0,4,"dummy"
"196334",0,0,1,1,"dummy"
"196335",0,0,1,1,"dummy"
"196336",0,0,1,1,"dummy"
"196337",3,3,0,6,"dummy"
"196338",0,1,0,1,"dummy"
"196339",4,2,0,6,"dummy"
"196340",0,1,0,1,"dummy"
"196341",0,0,1,1,"dummy"
"196342",4,2,0,6,"dummy"
"196343",0,0,2,2,"dummy"
"196344",0,0,1,1,"dummy"
"196345",0,0,2,2,"dummy"
"196346",0,0,2,2,"dummy"
"196347",0,0,1,1,"dummy"
"196350",0,3,0,3,"dummy"
"196351",3,0,0,3,"dummy"
"196353",5,5,0,10,"dummy"
"196354",0,3,0,3,"dummy"
"196355",0,1,0,1,"dummy"
"196356",0,1,0,1,"dummy"
"196357",2,3,0,5,"dummy"
"196358",0,0,0,0,"dummy"
"196359",0,2,0,2,"dummy"
"196360",0,2,0,2,"dummy"
"196361",2,1,1,4,"dummy"
"196365",1,11,2,14,"dummy"
"196367",3,5,0,8,"dummy"
"196368",5,2,1,8,"dummy"
"196369",0,2,2,4,"dummy"
"196370",7,8,4,19,"dummy"
"196371",0,3,0,3,"dummy"
"196372",0,0,1,1,"dummy"
"196373",0,0,1,1,"dummy"
"196382",0,0,1,1,"dummy"
"196383",0,0,1,1,"dummy"
"196384",0,1,0,1,"dummy"
"196386",0,0,0,0,"dummy"
"196387",0,0,0,0,"dummy"
"196388",0,1,0,1,"dummy"
"196390",1,0,0,1,"dummy"
"196391",0,0,2,2,"dummy"
"196392",4,5,0,9,"dummy"
"196393",2,3,2,7,"dummy"
"196394",1,2,0,3,"dummy"
"196395",0,0,0,0,"dummy"
"196396",0,0,0,0,"dummy"
"196397",0,0,0,0,"dummy"
"196398",0,0,2,2,"dummy"
"196399",0,0,1,1,"dummy"
"196400",3,0,0,3,"dummy"
"196401",0,0,2,2,"dummy"
"196402",5,5,0,10,"dummy"
"196404",0,0,0,0,"dummy"
"196405",0,0,0,0,"dummy"
"196407",6,6,0,12,"dummy"
"196410",0,3,0,3,"dummy"
"196411",5,0,0,5,"dummy"
"196416",0,3,0,3,"dummy"
"196417",1,1,0,2,"dummy"
"196419",3,0,0,3,"dummy"
"196423",0,1,0,1,"dummy"
"196424",1,0,0,1,"dummy"
"196425",1,1,1,3,"dummy"
"196427",1,0,0,1,"dummy"
"196431",0,1,0,1,"dummy"
"196432",1,2,1,4,"dummy"
"196433",0,0,1,1,"dummy"
"196436",0,0,1,1,"dummy"
"196438",13,40,2,55,"dummy"
"196439",51,7,3,61,"dummy"
"196440",4,7,0,11,"dummy"
"196441",7,7,0,14,"dummy"
"196442",5,1,0,6,"dummy"
"196443",0,1,0,1,"dummy"
"196444",4,50,3,57,"dummy"
"196445",36,3,1,40,"dummy"
"196446",0,8,1,9,"dummy"
"196447",0,1,0,1,"dummy"
"196448",1,0,0,1,"dummy"
"196449",0,0,0,0,"dummy"
"196450",0,3,0,3,"dummy"
"196451",0,0,0,0,"dummy"
"196452",0,1,0,1,"dummy"
"196453",0,2,0,2,"dummy"
"196454",2,3,1,6,"dummy"
"196455",3,3,0,6,"dummy"
"196456",1,0,0,1,"dummy"
"196457",19,1,0,20,"dummy"
"196458",1,24,0,25,"dummy"
"196459",1,0,0,1,"dummy"
"196460",0,3,0,3,"dummy"
"196461",2,0,0,2,"dummy"
"196462",7,15,1,23,"dummy"
"196463",0,0,1,1,"dummy"
"196464",0,6,2,8,"dummy"
"196465",0,2,0,2,"dummy"
"196466",0,1,0,1,"dummy"
"196467",1,2,1,4,"dummy"
"196468",0,0,0,0,"dummy"
"196469",2,1,1,4,"dummy"
"196470",0,3,0,3,"dummy"
"196471",0,0,0,0,"dummy"
"196472",3,2,0,5,"dummy"
"196474",0,3,0,3,"dummy"
"196475",0,0,1,1,"dummy"
"196476",0,0,1,1,"dummy"
"196479",0,3,0,3,"dummy"
"196482",0,1,0,1,"dummy"
"196484",0,0,1,1,"dummy"
"196486",0,0,0,0,"dummy"
"196488",1,0,0,1,"dummy"
"196490",0,0,0,0,"dummy"
"196492",0,2,1,3,"dummy"
"196494",0,0,2,2,"dummy"
"196496",3,3,1,7,"dummy"
"196498",8,0,4,12,"dummy"
"196499",2,3,2,7,"dummy"
"196500",2,2,2,6,"dummy"
"196504",0,15,0,15,"dummy"
"196505",6,0,0,6,"dummy"
"196507",2,2,0,4,"dummy"
"196508",0,0,1,1,"dummy"
"196533",0,0,0,0,"dummy"
"196535",0,3,0,3,"dummy"
"196536",1,0,0,1,"dummy"
"196538",0,0,4,4,"dummy"
"196539",0,1,0,1,"dummy"
"196541",5,7,3,15,"dummy"
"196545",3,3,0,6,"dummy"
"196546",3,0,0,3,"dummy"
"196551",5,4,0,9,"dummy"
"196552",0,0,2,2,"dummy"
"196553",5,1,3,9,"dummy"
"196554",0,0,2,2,"dummy"
"196555",0,0,2,2,"dummy"
"196556",0,0,3,3,"dummy"
"196602",0,0,1,1,"dummy"
"196603",0,0,1,1,"dummy"
"196604",0,0,1,1,"dummy"
"196605",0,0,1,1,"dummy"
"196606",0,0,1,1,"dummy"
"196607",0,0,1,1,"dummy"
"196608",0,0,1,1,"dummy"
"196609",0,0,1,1,"dummy"
"196610",0,0,1,1,"dummy"
"196611",0,0,1,1,"dummy"
"196612",0,0,1,1,"dummy"
"196613",0,0,1,1,"dummy"
"196614",0,0,1,1,"dummy"
"196615",0,0,1,1,"dummy"
"196616",0,0,1,1,"dummy"
"196619",2,11,0,13,"dummy"
"196621",1,0,0,1,"dummy"
"196622",0,0,0,0,"dummy"
"196623",7,0,0,7,"dummy"
"196625",0,0,1,1,"dummy"
"196626",0,0,4,4,"dummy"
"196630",0,0,3,3,"dummy"
"196632",0,0,6,6,"dummy"
"196635",0,0,8,8,"dummy"
"196636",1,2,0,3,"dummy"
"196637",1,2,0,3,"dummy"
"196638",0,0,4,4,"dummy"
"196640",1,4,0,5,"dummy"
"196641",4,1,0,5,"dummy"
"196642",1,4,1,6,"dummy"
"196643",4,1,1,6,"dummy"
"196646",1,0,1,2,"dummy"
"196647",0,1,0,1,"dummy"
"196651",0,1,0,1,"dummy"
"196654",1,1,0,2,"dummy"
"196656",0,0,0,0,"dummy"
"196658",0,0,0,0,"dummy"
"196659",6,3,0,9,"dummy"
"196660",0,1,0,1,"dummy"
"196661",0,2,0,2,"dummy"
"196663",0,0,1,1,"dummy"
"196668",0,1,1,2,"dummy"
"196670",3,1,0,4,"dummy"
"196671",0,1,0,1,"dummy"
"196673",2,3,0,5,"dummy"
"196674",3,3,0,6,"dummy"
"196675",8,0,0,8,"dummy"
"196676",0,0,1,1,"dummy"
"196684",2,0,3,5,"dummy"
"196694",0,1,0,1,"dummy"
"196695",1,4,0,5,"dummy"
"196696",1,0,0,1,"dummy"
"196697",0,1,0,1,"dummy"
"196698",0,0,1,1,"dummy"
"196699",2,1,0,3,"dummy"
"196700",0,0,1,1,"dummy"
"196701",1,0,0,1,"dummy"
"196702",0,0,1,1,"dummy"
"196703",0,2,4,6,"dummy"
"196707",2,4,0,6,"dummy"
"196708",0,2,0,2,"dummy"
"196709",0,2,0,2,"dummy"
"196710",10,2,0,12,"dummy"
"196711",0,2,0,2,"dummy"
"196712",0,0,0,0,"dummy"
"196713",0,0,3,3,"dummy"
"196714",0,5,0,5,"dummy"
"196716",1,3,2,6,"dummy"
"196717",0,1,0,1,"dummy"
"196720",0,0,1,1,"dummy"
"196721",1,0,0,1,"dummy"
"196722",0,2,1,3,"dummy"
"196723",0,1,0,1,"dummy"
"196724",0,1,0,1,"dummy"
"196725",2,0,0,2,"dummy"
"196726",0,0,1,1,"dummy"
"196727",1,0,0,1,"dummy"
"196728",8,4,0,12,"dummy"
"196729",0,1,0,1,"dummy"
"196730",7,24,0,31,"dummy"
"196731",0,1,0,1,"dummy"
"196735",8,1,2,11,"dummy"
"196736",0,1,2,3,"dummy"
"196737",0,1,0,1,"dummy"
"196738",1,0,0,1,"dummy"
"196739",2,0,1,3,"dummy"
"196748",2,4,0,6,"dummy"
"196749",0,2,0,2,"dummy"
"196750",0,2,0,2,"dummy"
"196751",10,2,0,12,"dummy"
"196752",0,2,0,2,"dummy"
"196753",0,0,0,0,"dummy"
"196754",0,0,3,3,"dummy"
"196755",0,5,0,5,"dummy"
"196756",1,0,1,2,"dummy"
"196759",4,0,0,4,"dummy"
"196760",0,0,1,1,"dummy"
"196761",0,0,0,0,"dummy"
"196762",0,1,0,1,"dummy"
"196763",0,0,2,2,"dummy"
"196764",0,0,1,1,"dummy"
"196767",0,0,3,3,"dummy"
"196768",0,1,0,1,"dummy"
"196769",0,1,0,1,"dummy"
"196770",0,1,0,1,"dummy"
"196772",0,0,1,1,"dummy"
"196774",0,0,0,0,"dummy"
"196782",0,14,0,14,"dummy"
"196783",1,6,1,8,"dummy"
"196784",3,3,0,6,"dummy"
"196785",2,4,1,7,"dummy"
"196786",8,9,1,18,"dummy"
"196787",1,2,0,3,"dummy"
"196788",6,14,0,20,"dummy"
"196789",4,3,1,8,"dummy"
"196790",0,0,1,1,"dummy"
"196794",3,30,0,33,"dummy"
"196795",0,0,1,1,"dummy"
"196796",5,4,1,10,"dummy"
"196797",5,11,4,20,"dummy"
"196798",3,1,3,7,"dummy"
"196803",0,2,1,3,"dummy"
"196804",5,0,1,6,"dummy"
"196805",0,0,1,1,"dummy"
"196806",0,0,1,1,"dummy"
"196807",0,0,1,1,"dummy"
"196808",0,0,1,1,"dummy"
"196809",0,1,0,1,"dummy"
"196810",0,0,1,1,"dummy"
"196811",0,2,0,2,"dummy"
"196812",0,2,0,2,"dummy"
"196813",0,0,1,1,"dummy"
"196814",0,0,1,1,"dummy"
"196815",0,1,0,1,"dummy"
"196816",1,0,0,1,"dummy"
"196817",0,1,0,1,"dummy"
"196818",0,0,1,1,"dummy"
"196819",0,0,1,1,"dummy"
"196820",0,1,0,1,"dummy"
"196821",0,1,0,1,"dummy"
"196822",0,0,1,1,"dummy"
"196823",0,1,0,1,"dummy"
"196824",0,0,1,1,"dummy"
"196825",1,0,0,1,"dummy"
"196826",0,1,0,1,"dummy"
"196827",0,1,0,1,"dummy"
"196828",0,1,0,1,"dummy"
"196829",0,2,0,2,"dummy"
"196843",0,0,0,0,"dummy"
"196946",0,0,0,0,"dummy"
"196947",1,1,0,2,"dummy"
"196948",1,1,0,2,"dummy"
"196949",3,2,2,7,"dummy"
"196951",0,0,1,1,"dummy"
"196954",1,0,2,3,"dummy"
"196955",0,0,1,1,"dummy"
"196956",0,0,1,1,"dummy"
"196957",0,1,2,3,"dummy"
"196978",0,5,0,5,"dummy"
"196979",0,3,0,3,"dummy"
"196980",0,0,1,1,"dummy"
"196981",0,5,1,6,"dummy"
"196982",8,9,3,20,"dummy"
"196983",4,8,3,15,"dummy"
"196984",0,1,0,1,"dummy"
"196985",6,9,4,19,"dummy"
"196986",8,12,3,23,"dummy"
"196989",4,1,0,5,"dummy"
"196990",1,0,0,1,"dummy"
"196994",0,0,1,1,"dummy"
"196995",0,1,1,2,"dummy"
"196996",1,0,1,2,"dummy"
"197002",1,2,0,3,"dummy"
"197005",0,1,2,3,"dummy"
"197006",0,0,0,0,"dummy"
"197007",0,1,0,1,"dummy"
"197008",4,0,2,6,"dummy"
"197009",1,0,0,1,"dummy"
"197010",0,0,0,0,"dummy"
"197012",0,3,1,4,"dummy"
"197013",0,3,0,3,"dummy"
"197014",3,2,0,5,"dummy"
"197015",2,2,0,4,"dummy"
"197016",0,1,0,1,"dummy"
"197017",2,1,3,6,"dummy"
"197018",3,1,1,5,"dummy"
"197019",0,0,0,0,"dummy"
"197020",3,1,4,8,"dummy"
"197021",2,3,0,5,"dummy"
"197024",6,7,10,23,"dummy"
"197025",22,30,0,52,"dummy"
"197026",0,10,0,10,"dummy"
"197027",0,1,1,2,"dummy"
"197028",0,0,1,1,"dummy"
"197029",0,0,1,1,"dummy"
"197030",0,0,0,0,"dummy"
"197031",1,3,0,4,"dummy"
"197033",0,0,1,1,"dummy"
"197034",0,0,1,1,"dummy"
"197035",0,0,1,1,"dummy"
"197042",0,0,1,1,"dummy"
"197045",0,0,1,1,"dummy"
"197046",2,0,0,2,"dummy"
"197047",2,0,0,2,"dummy"
"197048",0,0,3,3,"dummy"
"197054",0,8,0,8,"dummy"
"197055",0,0,4,4,"dummy"
"197057",0,1,0,1,"dummy"
"197074",0,1,0,1,"dummy"
"197075",2,2,0,4,"dummy"
"197076",1,1,1,3,"dummy"
"197077",1,2,1,4,"dummy"
"197078",0,0,5,5,"dummy"
"197079",15,30,4,49,"dummy"
"197080",7,15,0,22,"dummy"
"197081",4,8,0,12,"dummy"
"197082",0,2,0,2,"dummy"
"197083",0,0,1,1,"dummy"
"197084",0,2,0,2,"dummy"
"197085",0,2,0,2,"dummy"
"197086",0,0,1,1,"dummy"
"197088",0,0,3,3,"dummy"
"197089",4,4,3,11,"dummy"
"197090",0,3,0,3,"dummy"
"197091",0,1,0,1,"dummy"
"197096",0,0,1,1,"dummy"
"197097",0,0,0,0,"dummy"
"197100",0,1,0,1,"dummy"
"197101",5,3,2,10,"dummy"
"197106",0,3,2,5,"dummy"
"197108",4,4,0,8,"dummy"
"197109",1,1,0,2,"dummy"
"197115",0,2,0,2,"dummy"
"197116",2,4,1,7,"dummy"
"197117",0,0,1,1,"dummy"
"197118",0,0,1,1,"dummy"
"197124",2,2,0,4,"dummy"
"197127",0,1,0,1,"dummy"
"197128",0,2,0,2,"dummy"
"197129",0,0,1,1,"dummy"
"197130",0,1,0,1,"dummy"
"197131",0,0,1,1,"dummy"
"197135",0,0,0,0,"dummy"
"197139",0,0,1,1,"dummy"
"197140",0,0,1,1,"dummy"
"197143",1,1,0,2,"dummy"
"197145",0,6,0,6,"dummy"
"197146",0,0,1,1,"dummy"
"197147",0,0,2,2,"dummy"
"197148",0,0,1,1,"dummy"
"197172",0,0,1,1,"dummy"
"197173",0,1,0,1,"dummy"
"197174",0,1,0,1,"dummy"
"197177",12,9,1,22,"dummy"
"197178",3,4,0,7,"dummy"
"197179",0,1,0,1,"dummy"
"197180",4,4,0,8,"dummy"
"197181",2,0,0,2,"dummy"
"197182",0,0,1,1,"dummy"
"197184",0,0,2,2,"dummy"
"197187",0,1,0,1,"dummy"
"197188",0,0,3,3,"dummy"
"197189",0,1,0,1,"dummy"
"197190",1,2,0,3,"dummy"
"197194",0,2,1,3,"dummy"
"197196",0,0,1,1,"dummy"
"197208",0,0,1,1,"dummy"
"197210",3,6,2,11,"dummy"
"197211",5,6,1,12,"dummy"
"197212",0,0,0,0,"dummy"
"197215",0,2,0,2,"dummy"
"197216",2,0,1,3,"dummy"
"197218",1,3,1,5,"dummy"
"197220",0,0,1,1,"dummy"
"197223",5,6,0,11,"dummy"
"197224",6,5,0,11,"dummy"
"197225",1,0,0,1,"dummy"
"197226",0,2,0,2,"dummy"
"197228",0,0,0,0,"dummy"
"197229",0,0,1,1,"dummy"
"197231",0,1,1,2,"dummy"
"197232",0,0,2,2,"dummy"
"197235",0,0,2,2,"dummy"
"197240",0,1,0,1,"dummy"
"197241",0,0,4,4,"dummy"
"197242",0,2,1,3,"dummy"
"197243",0,0,1,1,"dummy"
"197244",2,4,3,9,"dummy"
"197245",0,0,0,0,"dummy"
"197246",2,0,0,2,"dummy"
"197247",2,0,0,2,"dummy"
"197248",0,1,0,1,"dummy"
"197250",0,0,1,1,"dummy"
"197251",7,3,0,10,"dummy"
"197253",0,0,0,0,"dummy"
"197254",0,0,0,0,"dummy"
"197258",1,0,0,1,"dummy"
"197267",0,3,0,3,"dummy"
"197269",0,0,0,0,"dummy"
"197272",2,5,2,9,"dummy"
"197274",0,0,4,4,"dummy"
"197275",0,5,0,5,"dummy"
"197276",6,8,1,15,"dummy"
"197277",0,0,1,1,"dummy"
"197278",0,1,0,1,"dummy"
"197279",0,0,0,0,"dummy"
"197280",8,3,1,12,"dummy"
"197281",0,0,0,0,"dummy"
"197282",0,1,0,1,"dummy"
"197283",0,2,0,2,"dummy"
"197284",0,0,0,0,"dummy"
"197285",0,0,1,1,"dummy"
"197286",0,0,0,0,"dummy"
"197291",0,2,0,2,"dummy"
"197292",1,0,0,1,"dummy"
"197293",0,1,0,1,"dummy"
"197294",0,3,0,3,"dummy"
"197295",3,6,1,10,"dummy"
"197296",0,7,1,8,"dummy"
"197297",0,1,0,1,"dummy"
"197298",0,1,0,1,"dummy"
"197301",2,0,0,2,"dummy"
"197302",0,2,0,2,"dummy"
"197304",1,1,5,7,"dummy"
"197305",0,0,1,1,"dummy"
"197309",0,4,1,5,"dummy"
"197310",0,5,0,5,"dummy"
"197311",0,1,0,1,"dummy"
"197312",0,2,0,2,"dummy"
"197313",0,6,5,11,"dummy"
"197314",2,4,0,6,"dummy"
"197315",4,16,7,27,"dummy"
"197348",0,4,0,4,"dummy"
"197349",4,1,1,6,"dummy"
"197350",0,1,0,1,"dummy"
"197351",0,0,2,2,"dummy"
"197352",0,1,0,1,"dummy"
"197353",0,0,1,1,"dummy"
"197354",1,0,0,1,"dummy"
"197355",2,0,0,2,"dummy"
"197358",1,0,0,1,"dummy"
"197359",0,3,0,3,"dummy"
"197360",0,1,0,1,"dummy"
"197361",0,0,1,1,"dummy"
"197362",0,0,1,1,"dummy"
"197363",1,0,1,2,"dummy"
"197367",0,0,0,0,"dummy"
"197368",0,0,0,0,"dummy"
"197370",4,7,1,12,"dummy"
"197371",0,2,0,2,"dummy"
"197373",0,0,0,0,"dummy"
"197374",1,0,0,1,"dummy"
"197376",0,0,0,0,"dummy"
"197377",13,29,2,44,"dummy"
"197378",0,7,0,7,"dummy"
"197379",0,2,0,2,"dummy"
"197380",15,0,0,15,"dummy"
"197381",0,4,0,4,"dummy"
"197382",2,1,0,3,"dummy"
"197386",0,1,0,1,"dummy"
"197387",0,0,4,4,"dummy"
"197388",1,1,4,6,"dummy"
"197390",0,0,1,1,"dummy"
"197391",0,1,0,1,"dummy"
"197392",1,1,1,3,"dummy"
"197393",1,0,0,1,"dummy"
"197394",0,1,0,1,"dummy"
"197395",2,1,0,3,"dummy"
"197396",0,1,0,1,"dummy"
"197397",0,0,1,1,"dummy"
"197398",1,3,1,5,"dummy"
"197401",0,0,0,0,"dummy"
"197402",1,2,1,4,"dummy"
"197411",4,3,0,7,"dummy"
"197412",0,1,0,1,"dummy"
"197413",0,3,0,3,"dummy"
"197414",0,1,0,1,"dummy"
"197415",0,2,0,2,"dummy"
"197416",2,13,0,15,"dummy"
"197417",2,11,0,13,"dummy"
"197418",0,9,0,9,"dummy"
"197419",8,13,4,25,"dummy"
"197420",0,5,1,6,"dummy"
"197421",0,1,0,1,"dummy"
"197422",3,0,0,3,"dummy"
"197423",12,16,5,33,"dummy"
"197424",4,1,1,6,"dummy"
"197425",2,9,1,12,"dummy"
"197426",0,1,0,1,"dummy"
"197427",0,0,1,1,"dummy"
"197428",4,6,0,10,"dummy"
"197429",1,0,1,2,"dummy"
"197430",0,0,1,1,"dummy"
"197431",0,0,1,1,"dummy"
"197440",2,0,3,5,"dummy"
"197441",1,0,0,1,"dummy"
"197442",0,1,0,1,"dummy"
"197443",0,1,1,2,"dummy"
"197445",0,2,0,2,"dummy"
"197452",0,0,1,1,"dummy"
"197453",0,0,1,1,"dummy"
"197454",0,0,2,2,"dummy"
"197455",26,3,7,36,"dummy"
"197463",0,10,0,10,"dummy"
"197464",0,1,0,1,"dummy"
"197508",1,0,0,1,"dummy"
"197511",0,0,1,1,"dummy"
"197512",5,1,1,7,"dummy"
"197513",0,1,0,1,"dummy"
"197514",0,0,2,2,"dummy"
"197544",0,0,1,1,"dummy"
"197545",0,0,1,1,"dummy"
"197549",4,5,1,10,"dummy"
"197550",0,0,5,5,"dummy"
"197551",0,1,3,4,"dummy"
"197552",6,3,2,11,"dummy"
"197556",0,0,1,1,"dummy"
"197571",0,0,1,1,"dummy"
"197572",0,0,1,1,"dummy"
"197573",1,1,1,3,"dummy"
"197574",0,1,0,1,"dummy"
"197575",0,1,0,1,"dummy"
"197576",0,0,1,1,"dummy"
"197577",12,0,0,12,"dummy"
"197578",0,1,0,1,"dummy"
"197579",0,1,0,1,"dummy"
"197580",3,3,1,7,"dummy"
"197581",0,0,2,2,"dummy"
"197582",0,1,0,1,"dummy"
"197583",0,1,0,1,"dummy"
"197584",0,4,0,4,"dummy"
"197585",5,7,0,12,"dummy"
"197586",1,2,0,3,"dummy"
"197587",3,3,3,9,"dummy"
"197588",6,5,1,12,"dummy"
"197589",0,2,0,2,"dummy"
"197590",0,2,0,2,"dummy"
"197593",4,3,1,8,"dummy"
"197612",0,2,0,2,"dummy"
"197613",2,5,0,7,"dummy"
"197614",4,19,1,24,"dummy"
"197615",2,0,0,2,"dummy"
"197616",3,9,1,13,"dummy"
"197617",18,2,1,21,"dummy"
"197618",0,0,7,7,"dummy"
"197619",0,1,0,1,"dummy"
"197620",0,0,0,0,"dummy"
"197621",2,0,1,3,"dummy"
"197622",0,7,0,7,"dummy"
"197623",0,1,0,1,"dummy"
"197624",0,0,2,2,"dummy"
"197672",1,3,2,6,"dummy"
"197673",0,0,1,1,"dummy"
"197674",0,0,1,1,"dummy"
"197675",0,0,1,1,"dummy"
"197678",0,2,1,3,"dummy"
"197679",1,2,0,3,"dummy"
"197461",0,2,0,2,"dummy"
"197474",21,30,0,51,"dummy"
"197475",0,2,0,2,"dummy"
"197476",31,1,0,32,"dummy"
"197477",0,0,0,0,"dummy"
"197478",0,0,0,0,"dummy"
"197479",0,0,0,0,"dummy"
"197480",0,0,0,0,"dummy"
"197481",2,0,0,2,"dummy"
"197484",0,0,0,0,"dummy"
"197485",0,1,0,1,"dummy"
"197486",0,4,1,5,"dummy"
"197487",10,6,2,18,"dummy"
"197488",0,1,1,2,"dummy"
"197560",0,0,1,1,"dummy"
"197565",0,1,0,1,"dummy"
"197566",0,1,0,1,"dummy"
"197567",0,0,1,1,"dummy"
"197595",0,1,0,1,"dummy"
"197596",1,5,0,6,"dummy"
"197597",1,0,0,1,"dummy"
"197598",0,0,1,1,"dummy"
"197599",0,1,0,1,"dummy"
"197600",0,1,0,1,"dummy"
"197601",6,4,0,10,"dummy"
"197602",0,1,0,1,"dummy"
"197603",0,1,0,1,"dummy"
"197604",0,2,1,3,"dummy"
"197607",0,1,0,1,"dummy"
"197608",2,2,0,4,"dummy"
"197609",0,0,0,0,"dummy"
"197610",0,3,2,5,"dummy"
"197670",0,0,1,1,"dummy"
"197685",0,1,0,1,"dummy"
"197724",0,1,0,1,"dummy"
"197725",1,2,0,3,"dummy"
"197726",0,1,0,1,"dummy"
"197727",3,0,1,4,"dummy"
"197728",0,1,0,1,"dummy"
"197733",0,0,6,6,"dummy"
"197738",1,0,0,1,"dummy"
"197739",3,17,2,22,"dummy"
"197740",0,1,0,1,"dummy"
"197741",0,1,0,1,"dummy"
"197742",0,2,0,2,"dummy"
"197743",2,4,2,8,"dummy"
"197744",0,1,0,1,"dummy"
"197745",0,1,0,1,"dummy"
"197746",29,12,4,45,"dummy"
"197749",3,2,0,5,"dummy"
"197765",0,19,0,19,"dummy"
"197771",1,1,0,2,"dummy"
"197772",1,1,0,2,"dummy"
"197773",0,1,0,1,"dummy"
"197776",1,2,0,3,"dummy"
"197782",0,0,1,1,"dummy"
"197783",0,0,0,0,"dummy"
"197718",1,0,1,2,"dummy"
"197719",0,0,1,1,"dummy"
"197722",0,0,1,1,"dummy"
"197735",0,0,0,0,"dummy"
"197736",0,0,0,0,"dummy"
"197751",0,0,0,0,"dummy"
"197752",0,0,1,1,"dummy"
"197760",0,1,0,1,"dummy"
"197763",0,2,0,2,"dummy"
"197767",0,6,0,6,"dummy"
"197780",0,0,1,1,"dummy"
"197799",0,0,0,0,"dummy"
"197800",0,0,0,0,"dummy"
"197812",0,0,3,3,"dummy"
"197813",0,0,1,1,"dummy"
"197828",0,0,0,0,"dummy"
"197846",2,2,1,5,"dummy"
"197903",4,2,1,7,"dummy"
"197904",5,2,0,7,"dummy"
"197905",1,2,0,3,"dummy"
"197906",2,1,0,3,"dummy"
"197909",0,0,1,1,"dummy"
"197910",0,0,1,1,"dummy"
"197918",1,4,2,7,"dummy"
"197919",18,7,0,25,"dummy"
"197920",0,1,0,1,"dummy"
"197921",0,1,0,1,"dummy"
"197922",0,1,0,1,"dummy"
"197923",0,0,2,2,"dummy"
"197928",1,0,1,2,"dummy"
"197929",3,0,1,4,"dummy"
"197930",0,0,1,1,"dummy"
"197931",0,1,0,1,"dummy"
"197932",2,8,2,12,"dummy"
"197933",3,1,0,4,"dummy"
"197934",0,3,1,4,"dummy"
"197935",2,0,1,3,"dummy"
"197953",0,4,1,5,"dummy"
"197954",16,12,3,31,"dummy"
"197960",0,0,1,1,"dummy"
"197961",1,0,0,1,"dummy"
"197962",1,1,0,2,"dummy"
"197963",6,3,2,11,"dummy"
"197964",0,2,0,2,"dummy"
"197973",0,1,0,1,"dummy"
"197974",0,0,2,2,"dummy"
"197997",0,1,0,1,"dummy"
"197998",0,0,1,1,"dummy"
"197999",4,1,0,5,"dummy"
"198000",1,1,0,2,"dummy"
"198005",0,0,1,1,"dummy"
"197784",0,0,0,0,"dummy"
"197785",2,0,0,2,"dummy"
"197786",0,1,0,1,"dummy"
"197787",0,0,0,0,"dummy"
"197788",3,0,0,3,"dummy"
"197789",0,0,0,0,"dummy"
"197790",0,0,1,1,"dummy"
"197791",0,0,1,1,"dummy"
"197792",0,0,0,0,"dummy"
"197793",1,0,0,1,"dummy"
"197815",2,0,1,3,"dummy"
"197816",0,2,0,2,"dummy"
"197817",0,2,0,2,"dummy"
"197834",1,0,0,1,"dummy"
"197835",0,1,0,1,"dummy"
"197836",0,0,1,1,"dummy"
"197837",0,2,1,3,"dummy"
"197838",2,0,0,2,"dummy"
"197841",10,0,0,10,"dummy"
"197842",0,1,0,1,"dummy"
"197843",0,2,0,2,"dummy"
"197844",0,1,0,1,"dummy"
"197848",0,0,1,1,"dummy"
"197851",0,1,0,1,"dummy"
"197852",0,6,0,6,"dummy"
"197861",3,1,3,7,"dummy"
"197862",0,5,0,5,"dummy"
"197863",2,7,1,10,"dummy"
"197883",0,1,0,1,"dummy"
"197884",0,0,0,0,"dummy"
"197885",0,0,0,0,"dummy"
"197886",0,0,0,0,"dummy"
"197887",0,3,0,3,"dummy"
"197888",0,2,0,2,"dummy"
"197889",0,1,0,1,"dummy"
"197890",0,2,0,2,"dummy"
"197891",0,1,0,1,"dummy"
"197892",0,0,0,0,"dummy"
"197893",1,1,0,2,"dummy"
"197894",2,0,0,2,"dummy"
"197895",2,3,2,7,"dummy"
"197896",2,2,0,4,"dummy"
"197897",2,3,0,5,"dummy"
"197898",1,0,0,1,"dummy"
"197899",0,0,1,1,"dummy"
"197900",0,1,1,2,"dummy"
"197901",13,2,2,17,"dummy"
"197912",0,0,1,1,"dummy"
"197913",0,1,0,1,"dummy"
"197914",1,0,1,2,"dummy"
"197915",6,0,4,10,"dummy"
"197916",0,2,1,3,"dummy"
"197941",0,2,0,2,"dummy"
"197942",0,0,1,1,"dummy"
"197943",0,12,1,13,"dummy"
"197944",8,2,1,11,"dummy"
"197945",0,0,1,1,"dummy"
"197946",2,2,2,6,"dummy"
"197951",4,18,5,27,"dummy"
"197956",1,0,2,3,"dummy"
"197968",0,1,0,1,"dummy"
"197978",0,0,0,0,"dummy"
"197979",0,0,0,0,"dummy"
"198038",1,0,2,3,"dummy"
"198006",0,0,1,1,"dummy"
"198007",0,0,2,2,"dummy"
"198012",3,0,0,3,"dummy"
"198013",0,1,0,1,"dummy"
"198014",2,65,1,68,"dummy"
"198015",25,10,0,35,"dummy"
"198016",0,23,1,24,"dummy"
"198019",0,1,0,1,"dummy"
"198020",1,1,1,3,"dummy"
"198035",0,0,1,1,"dummy"
"198036",0,0,1,1,"dummy"
"198052",8,0,1,9,"dummy"
"198053",1,2,0,3,"dummy"
"198058",2,5,2,9,"dummy"
"198061",10,26,6,42,"dummy"
"198062",0,0,2,2,"dummy"
"198063",0,0,1,1,"dummy"
"198064",0,0,1,1,"dummy"
"198069",3,2,3,8,"dummy"
"198077",2,0,0,2,"dummy"
"198078",1,0,2,3,"dummy"
"198082",1,0,0,1,"dummy"
"198085",0,0,0,0,"dummy"
"198086",1,0,0,1,"dummy"
"198087",0,0,1,1,"dummy"
"198088",1,1,0,2,"dummy"
"198089",6,0,0,6,"dummy"
"198090",2,0,0,2,"dummy"
"198091",0,0,1,1,"dummy"
"198092",0,0,1,1,"dummy"
"198093",2,2,1,5,"dummy"
"198094",0,0,0,0,"dummy"
"198095",0,0,0,0,"dummy"
"198096",0,1,0,1,"dummy"
"198097",0,0,1,1,"dummy"
"198098",0,4,0,4,"dummy"
"198099",4,0,0,4,"dummy"
"198100",0,0,0,0,"dummy"
"198101",0,0,0,0,"dummy"
"198102",0,0,0,0,"dummy"
"198117",0,2,0,2,"dummy"
"198134",0,1,0,1,"dummy"
"198142",2,3,4,9,"dummy"
"198143",3,1,0,4,"dummy"
"198177",1,2,1,4,"dummy"
"198178",0,0,1,1,"dummy"
"198179",3,1,0,4,"dummy"
"198203",0,0,1,1,"dummy"
"198215",0,0,0,0,"dummy"
"198216",0,0,0,0,"dummy"
"198219",2,1,2,5,"dummy"
"198220",0,0,0,0,"dummy"
"198223",0,1,0,1,"dummy"
"198234",1,0,0,1,"dummy"
"198235",2,3,0,5,"dummy"
"198236",1,0,0,1,"dummy"
"198237",1,2,0,3,"dummy"
"198241",0,1,2,3,"dummy"
"198242",0,0,0,0,"dummy"
"198243",0,1,0,1,"dummy"
"198244",4,0,2,6,"dummy"
"198245",1,0,0,1,"dummy"
"198246",0,0,0,0,"dummy"
"198247",0,0,0,0,"dummy"
"198055",0,4,0,4,"dummy"
"198056",2,0,0,2,"dummy"
"198066",0,0,2,2,"dummy"
"198067",0,1,0,1,"dummy"
"198071",0,0,1,1,"dummy"
"198072",5,19,2,26,"dummy"
"198073",2,4,5,11,"dummy"
"198080",0,0,1,1,"dummy"
"198104",0,1,0,1,"dummy"
"198105",0,3,0,3,"dummy"
"198106",0,0,2,2,"dummy"
"198107",0,0,1,1,"dummy"
"198108",1,5,1,7,"dummy"
"198109",0,6,2,8,"dummy"
"198110",15,5,5,25,"dummy"
"198111",4,0,0,4,"dummy"
"198112",0,1,3,4,"dummy"
"198113",0,2,0,2,"dummy"
"198114",5,3,2,10,"dummy"
"198115",0,1,3,4,"dummy"
"198138",1,2,1,4,"dummy"
"198145",2,0,2,4,"dummy"
"198167",0,0,0,0,"dummy"
"198181",0,0,1,1,"dummy"
"198182",0,0,1,1,"dummy"
"198183",0,0,1,1,"dummy"
"198184",0,0,1,1,"dummy"
"198187",0,0,2,2,"dummy"
"198188",0,0,2,2,"dummy"
"198189",0,0,1,1,"dummy"
"198190",2,8,0,10,"dummy"
"198191",1,0,0,1,"dummy"
"198194",1,5,0,6,"dummy"
"198195",1,1,0,2,"dummy"
"198196",2,3,0,5,"dummy"
"198197",0,0,0,0,"dummy"
"198198",1,1,0,2,"dummy"
"198201",0,0,1,1,"dummy"
"198205",1,0,0,1,"dummy"
"198206",0,1,0,1,"dummy"
"198207",0,3,0,3,"dummy"
"198212",0,0,0,0,"dummy"
"198213",2,0,2,4,"dummy"
"198228",2,3,1,6,"dummy"
"198229",0,1,2,3,"dummy"
"198230",1,0,3,4,"dummy"
"198231",0,1,0,1,"dummy"
"198232",0,1,2,3,"dummy"
"198239",0,4,2,6,"dummy"
"198249",1,0,0,1,"dummy"
"198250",2,0,1,3,"dummy"
"198251",0,0,0,0,"dummy"
"198252",0,1,0,1,"dummy"
"198253",8,1,0,9,"dummy"
"198254",0,0,0,0,"dummy"
"198255",0,0,0,0,"dummy"
"198256",1,10,0,11,"dummy"
"198257",7,1,0,8,"dummy"
"198258",0,0,1,1,"dummy"
"198259",2,0,3,5,"dummy"
"198262",0,4,2,6,"dummy"
"198264",0,2,0,2,"dummy"
"198265",0,1,0,1,"dummy"
"198275",3,2,9,14,"dummy"
"198276",0,3,0,3,"dummy"
"198278",3,0,0,3,"dummy"
"198282",0,1,0,1,"dummy"
"198284",0,2,0,2,"dummy"
"198288",2,1,0,3,"dummy"
"198290",2,0,0,2,"dummy"
"198292",0,1,0,1,"dummy"
"198294",10,7,0,17,"dummy"
"198295",10,3,3,16,"dummy"
"198296",0,0,0,0,"dummy"
"198297",0,1,0,1,"dummy"
"198298",0,1,2,3,"dummy"
"198299",2,0,2,4,"dummy"
"198301",0,0,4,4,"dummy"
"198302",1,0,2,3,"dummy"
"198303",0,0,0,0,"dummy"
"198304",0,1,2,3,"dummy"
"198306",0,2,0,2,"dummy"
"198307",0,0,1,1,"dummy"
"198308",0,1,0,1,"dummy"
"198309",0,1,0,1,"dummy"
"198311",0,10,0,10,"dummy"
"198312",3,2,0,5,"dummy"
"198313",0,1,0,1,"dummy"
"198315",0,1,0,1,"dummy"
"198316",0,0,3,3,"dummy"
"198317",1,2,0,3,"dummy"
"198320",1,1,0,2,"dummy"
"198321",3,0,2,5,"dummy"
"198324",0,0,1,1,"dummy"
"198326",2,4,0,6,"dummy"
"198327",0,2,0,2,"dummy"
"198328",0,2,0,2,"dummy"
"198329",10,2,0,12,"dummy"
"198330",0,2,0,2,"dummy"
"198331",0,0,0,0,"dummy"
"198332",0,0,3,3,"dummy"
"198333",0,5,0,5,"dummy"
"198335",0,1,0,1,"dummy"
"198338",0,3,0,3,"dummy"
"198339",0,0,1,1,"dummy"
"198340",0,0,0,0,"dummy"
"198343",2,0,0,2,"dummy"
"198344",1,2,0,3,"dummy"
"198345",1,0,0,1,"dummy"
"198347",0,0,0,0,"dummy"
"198348",5,0,2,7,"dummy"
"198349",0,0,0,0,"dummy"
"198371",0,0,3,3,"dummy"
"198372",0,0,3,3,"dummy"
"198373",0,0,1,1,"dummy"
"198376",0,1,0,1,"dummy"
"198377",0,3,0,3,"dummy"
"198378",0,0,0,0,"dummy"
"198380",1,1,1,3,"dummy"
"198382",0,4,0,4,"dummy"
"198383",0,1,0,1,"dummy"
"198384",1,4,0,5,"dummy"
"198385",2,2,0,4,"dummy"
"198386",1,2,1,4,"dummy"
"198387",2,1,0,3,"dummy"
"198388",0,2,0,2,"dummy"
"198391",0,1,0,1,"dummy"
"198392",0,1,0,1,"dummy"
"198398",2,4,0,6,"dummy"
"198401",0,10,4,14,"dummy"
"198402",0,0,1,1,"dummy"
"198403",3,2,0,5,"dummy"
"198404",0,1,0,1,"dummy"
"198405",2,2,0,4,"dummy"
"198406",3,0,0,3,"dummy"
"198409",2,9,4,15,"dummy"
"198410",0,1,0,1,"dummy"
"198411",20,32,2,54,"dummy"
"198412",1,2,1,4,"dummy"
"198413",0,2,0,2,"dummy"
"198414",2,0,0,2,"dummy"
"198418",0,7,0,7,"dummy"
"198434",2,0,2,4,"dummy"
"198438",0,6,0,6,"dummy"
"198441",4,1,0,5,"dummy"
"198442",1,0,0,1,"dummy"
"198443",0,1,2,3,"dummy"
"198444",1,0,0,1,"dummy"
"198445",0,0,0,0,"dummy"
"198446",0,0,0,0,"dummy"
"198449",1,3,3,7,"dummy"
"198450",0,1,0,1,"dummy"
"198451",5,2,0,7,"dummy"
"198452",0,0,3,3,"dummy"
"198456",0,2,0,2,"dummy"
"198457",2,2,5,9,"dummy"
"198460",0,1,0,1,"dummy"
"198462",0,5,2,7,"dummy"
"198463",0,1,0,1,"dummy"
"198464",0,1,0,1,"dummy"
"198467",0,0,0,0,"dummy"
"198468",3,0,0,3,"dummy"
"198469",0,0,1,1,"dummy"
"198470",0,0,1,1,"dummy"
"198472",0,1,0,1,"dummy"
"198474",0,0,3,3,"dummy"
"198475",0,1,0,1,"dummy"
"198476",1,6,1,8,"dummy"
"198479",0,0,1,1,"dummy"
"198481",0,0,0,0,"dummy"
"198482",0,0,0,0,"dummy"
"198489",1,3,4,8,"dummy"
"198493",1,0,0,1,"dummy"
"198494",0,1,0,1,"dummy"
"198495",9,0,2,11,"dummy"
"198496",0,0,2,2,"dummy"
"198497",0,0,1,1,"dummy"
"198505",0,2,1,3,"dummy"
"198506",0,0,1,1,"dummy"
"198507",0,10,1,11,"dummy"
"198508",10,0,1,11,"dummy"
"198509",0,1,1,2,"dummy"
"198510",1,2,1,4,"dummy"
"198511",1,5,0,6,"dummy"
"198512",1,0,0,1,"dummy"
"198513",0,0,0,0,"dummy"
"198516",2,0,0,2,"dummy"
"198519",0,0,4,4,"dummy"
"198520",0,1,0,1,"dummy"
"198521",8,4,0,12,"dummy"
"198544",0,2,2,4,"dummy"
"198551",0,0,1,1,"dummy"
"198553",2,0,1,3,"dummy"
"198554",0,2,0,2,"dummy"
"198558",0,1,0,1,"dummy"
"198559",0,1,0,1,"dummy"
"198560",0,1,0,1,"dummy"
"198561",0,1,0,1,"dummy"
"198562",0,0,1,1,"dummy"
"198563",0,0,1,1,"dummy"
"198564",0,13,1,14,"dummy"
"198565",0,0,1,1,"dummy"
"198566",0,0,1,1,"dummy"
"198567",0,0,1,1,"dummy"
"198568",0,1,0,1,"dummy"
"198579",14,0,2,16,"dummy"
"198581",0,1,0,1,"dummy"
"198582",0,0,2,2,"dummy"
"198585",0,0,2,2,"dummy"
"198587",0,1,0,1,"dummy"
"198588",1,0,1,2,"dummy"
"198589",0,1,0,1,"dummy"
"198591",4,2,10,16,"dummy"
"198594",2,4,0,6,"dummy"
"198595",0,2,0,2,"dummy"
"198596",0,2,0,2,"dummy"
"198597",10,2,0,12,"dummy"
"198598",0,2,0,2,"dummy"
"198599",0,0,0,0,"dummy"
"198600",0,0,3,3,"dummy"
"198601",0,5,0,5,"dummy"
"198602",1,0,1,2,"dummy"
"198605",0,0,1,1,"dummy"
"198609",5,24,3,32,"dummy"
"198611",0,0,0,0,"dummy"
"198612",0,2,0,2,"dummy"
"198615",4,8,0,12,"dummy"
"198616",0,0,1,1,"dummy"
"198617",0,4,1,5,"dummy"
"198632",0,6,0,6,"dummy"
"198641",0,0,1,1,"dummy"
"198646",3,1,0,4,"dummy"
"198647",0,2,0,2,"dummy"
"198651",6,0,0,6,"dummy"
"198652",2,5,2,9,"dummy"
"198654",0,2,0,2,"dummy"
"198658",0,3,0,3,"dummy"
"198659",4,17,1,22,"dummy"
"198662",0,0,1,1,"dummy"
"198666",1,5,0,6,"dummy"
"198667",0,1,0,1,"dummy"
"198669",2,0,1,3,"dummy"
"198670",0,0,2,2,"dummy"
"198676",0,7,2,9,"dummy"
"198677",0,0,1,1,"dummy"
"198678",6,1,0,7,"dummy"
"198692",0,0,7,7,"dummy"
"198693",0,0,0,0,"dummy"
"198694",0,1,0,1,"dummy"
"198696",0,3,0,3,"dummy"
"198697",20,0,3,23,"dummy"
"198705",3,19,4,26,"dummy"
"198706",0,4,0,4,"dummy"
"198707",0,1,1,2,"dummy"
"198708",1,0,1,2,"dummy"
"198709",13,1,0,14,"dummy"
"198710",0,1,0,1,"dummy"
"198711",0,1,2,3,"dummy"
"198712",0,1,0,1,"dummy"
"198713",0,1,0,1,"dummy"
"198729",0,2,0,2,"dummy"
"198730",0,0,0,0,"dummy"
"198731",1,1,1,3,"dummy"
"198737",0,0,1,1,"dummy"
"198738",0,0,1,1,"dummy"
"198739",0,0,1,1,"dummy"
"198740",0,0,1,1,"dummy"
"198741",0,0,1,1,"dummy"
"198742",1,2,1,4,"dummy"
"198743",0,0,1,1,"dummy"
"198744",0,0,1,1,"dummy"
"198745",0,0,1,1,"dummy"
"198746",0,0,1,1,"dummy"
"198747",0,0,0,0,"dummy"
"198748",0,0,1,1,"dummy"
"198750",0,1,1,2,"dummy"
"198753",0,1,0,1,"dummy"
"198754",0,0,1,1,"dummy"
"198755",0,0,1,1,"dummy"
"198756",0,0,1,1,"dummy"
"198757",0,0,1,1,"dummy"
"198758",0,0,1,1,"dummy"
"198760",0,1,2,3,"dummy"
"198762",4,3,1,8,"dummy"
"198764",5,2,2,9,"dummy"
"198765",0,0,1,1,"dummy"
"198767",22,1,2,25,"dummy"
"198768",4,1,1,6,"dummy"
"198769",0,0,1,1,"dummy"
"198770",0,0,1,1,"dummy"
"198771",0,0,1,1,"dummy"
"198772",0,1,0,1,"dummy"
"198783",0,1,0,1,"dummy"
"198785",7,33,2,42,"dummy"
"198789",0,12,0,12,"dummy"
"198790",0,2,1,3,"dummy"
"198791",0,1,1,2,"dummy"
"198792",1,2,0,3,"dummy"
"198793",2,1,1,4,"dummy"
"198797",0,0,0,0,"dummy"
"198800",0,1,0,1,"dummy"
"198801",2,1,1,4,"dummy"
"198802",0,5,1,6,"dummy"
"198803",3,3,3,9,"dummy"
"198805",2,0,0,2,"dummy"
"198807",3,8,1,12,"dummy"
"198809",3,3,0,6,"dummy"
"198811",26,2,2,30,"dummy"
"198812",0,0,1,1,"dummy"
"198813",0,0,1,1,"dummy"
"198814",0,1,0,1,"dummy"
"198818",0,5,1,6,"dummy"
"198819",1,3,2,6,"dummy"
"198820",2,0,0,2,"dummy"
"198821",0,1,1,2,"dummy"
"198822",2,1,0,3,"dummy"
"198823",0,0,0,0,"dummy"
"198824",0,0,0,0,"dummy"
"198825",0,0,2,2,"dummy"
"198828",0,1,0,1,"dummy"
"198829",0,3,0,3,"dummy"
"198830",0,2,0,2,"dummy"
"198831",0,1,0,1,"dummy"
"198832",7,0,0,7,"dummy"
"198840",2,2,0,4,"dummy"
"198848",0,0,1,1,"dummy"
"198849",0,0,0,0,"dummy"
"198850",0,0,1,1,"dummy"
"198851",0,0,1,1,"dummy"
"198852",0,0,1,1,"dummy"
"198854",2,2,0,4,"dummy"
"198858",2,0,3,5,"dummy"
"198859",1,0,0,1,"dummy"
"198860",0,1,0,1,"dummy"
"198861",0,1,1,2,"dummy"
"198863",0,5,1,6,"dummy"
"198864",0,0,1,1,"dummy"
"198865",0,0,2,2,"dummy"
"198867",0,0,2,2,"dummy"
"198869",0,2,3,5,"dummy"
"198871",0,2,0,2,"dummy"
"198872",0,4,0,4,"dummy"
"198873",0,1,0,1,"dummy"
"198874",6,1,1,8,"dummy"
"198875",2,0,0,2,"dummy"
"198876",0,3,0,3,"dummy"
"198877",0,1,0,1,"dummy"
"198878",1,6,1,8,"dummy"
"198879",0,1,0,1,"dummy"
"198880",0,1,0,1,"dummy"
"198881",3,9,3,15,"dummy"
"198882",0,0,0,0,"dummy"
"198883",0,0,1,1,"dummy"
"198884",0,1,0,1,"dummy"
"198885",3,4,6,13,"dummy"
"198886",0,0,1,1,"dummy"
"198887",0,1,0,1,"dummy"
"198888",0,3,0,3,"dummy"
"198889",0,0,0,0,"dummy"
"198891",0,0,1,1,"dummy"
"198892",0,0,1,1,"dummy"
"198893",0,0,1,1,"dummy"
"198896",2,0,0,2,"dummy"
"198898",3,0,2,5,"dummy"
"198899",0,1,0,1,"dummy"
"198901",1,0,0,1,"dummy"
"198903",1,3,0,4,"dummy"
"198904",2,10,0,12,"dummy"
"198905",1,6,0,7,"dummy"
"198906",0,3,1,4,"dummy"
"198907",0,3,1,4,"dummy"
"198908",22,1,0,23,"dummy"
"198909",0,3,0,3,"dummy"
"198910",0,0,0,0,"dummy"
"198911",0,0,1,1,"dummy"
"198912",0,0,1,1,"dummy"
"198913",0,1,1,2,"dummy"
"198914",0,2,0,2,"dummy"
"198920",0,0,1,1,"dummy"
"198921",0,0,1,1,"dummy"
"198922",0,0,1,1,"dummy"
"198923",0,0,1,1,"dummy"
"198926",1,15,0,16,"dummy"
"198927",8,10,0,18,"dummy"
"198928",1,0,0,1,"dummy"
"198929",0,1,0,1,"dummy"
"198935",0,0,0,0,"dummy"
"198947",0,0,0,0,"dummy"
"198948",0,0,0,0,"dummy"
"198949",0,0,0,0,"dummy"
"198950",0,0,0,0,"dummy"
"198951",0,0,1,1,"dummy"
"198952",0,0,1,1,"dummy"
"198953",0,0,1,1,"dummy"
"198955",0,0,1,1,"dummy"
"198956",2,2,0,4,"dummy"
"198959",0,0,1,1,"dummy"
"198960",0,0,1,1,"dummy"
"198968",7,9,5,21,"dummy"
"198969",8,0,1,9,"dummy"
"198970",0,3,0,3,"dummy"
"198971",0,6,1,7,"dummy"
"198972",2,0,0,2,"dummy"
"198973",0,1,0,1,"dummy"
"198975",0,0,0,0,"dummy"
"198976",0,0,0,0,"dummy"
"198991",0,0,0,0,"dummy"
"198992",0,0,0,0,"dummy"
"198994",48,23,9,80,"dummy"
"198998",0,0,1,1,"dummy"
"198999",0,0,3,3,"dummy"
"199000",0,2,0,2,"dummy"
"199002",0,0,1,1,"dummy"
"199003",2,0,0,2,"dummy"
"199013",0,2,0,2,"dummy"
"199014",0,0,0,0,"dummy"
"199015",0,0,0,0,"dummy"
"199016",0,0,0,0,"dummy"
"199017",0,0,0,0,"dummy"
"199018",0,0,0,0,"dummy"
"199019",0,0,0,0,"dummy"
"199020",0,0,0,0,"dummy"
"199021",0,0,1,1,"dummy"
"199022",0,0,0,0,"dummy"
"199023",0,0,0,0,"dummy"
"199024",0,0,0,0,"dummy"
"199025",0,0,0,0,"dummy"
"199026",0,0,1,1,"dummy"
"199027",0,0,1,1,"dummy"
"199029",2,2,2,6,"dummy"
"199030",4,1,1,6,"dummy"
"199031",0,0,1,1,"dummy"
"199032",4,1,0,5,"dummy"
"199033",0,1,0,1,"dummy"
"199034",0,3,0,3,"dummy"
"199035",2,1,0,3,"dummy"
"199036",0,0,0,0,"dummy"
"199037",0,1,0,1,"dummy"
"199039",0,20,3,23,"dummy"
"199040",0,2,0,2,"dummy"
"199041",0,1,0,1,"dummy"
"199042",0,0,1,1,"dummy"
"199043",0,0,1,1,"dummy"
"199044",0,0,1,1,"dummy"
"199045",0,0,1,1,"dummy"
"199046",0,1,2,3,"dummy"
"199047",2,12,0,14,"dummy"
"199050",0,0,1,1,"dummy"
"199051",0,0,1,1,"dummy"
"199052",1,3,1,5,"dummy"
"199054",13,2,1,16,"dummy"
"199057",0,2,0,2,"dummy"
"199059",0,0,1,1,"dummy"
"199060",0,0,1,1,"dummy"
"199068",0,11,0,11,"dummy"
"199069",0,1,0,1,"dummy"
"199070",1,1,0,2,"dummy"
"199071",0,4,0,4,"dummy"
"199072",0,1,0,1,"dummy"
"199073",0,1,0,1,"dummy"
"199074",0,1,0,1,"dummy"
"199075",0,0,1,1,"dummy"
"199076",0,1,0,1,"dummy"
"199077",0,1,0,1,"dummy"
"199078",0,0,0,0,"dummy"
"199079",16,2,0,18,"dummy"
"199080",1,5,0,6,"dummy"
"199081",0,25,0,25,"dummy"
"199082",0,1,0,1,"dummy"
"199083",6,6,0,12,"dummy"
"199084",4,3,0,7,"dummy"
"199085",0,1,0,1,"dummy"
"199086",0,0,1,1,"dummy"
"199087",0,1,0,1,"dummy"
"199088",1,0,0,1,"dummy"
"199089",0,1,0,1,"dummy"
"199090",0,2,1,3,"dummy"
"199091",0,1,0,1,"dummy"
"199092",2,0,0,2,"dummy"
"199093",0,1,0,1,"dummy"
"199094",0,9,0,9,"dummy"
"199095",6,1,0,7,"dummy"
"199096",4,0,0,4,"dummy"
"199097",1,1,0,2,"dummy"
"199098",0,1,0,1,"dummy"
"199099",1,0,0,1,"dummy"
"199100",0,1,0,1,"dummy"
"199117",0,0,2,2,"dummy"
"199118",0,4,2,6,"dummy"
"199119",0,0,1,1,"dummy"
"199122",0,0,1,1,"dummy"
"199123",1,1,0,2,"dummy"
"199124",4,0,0,4,"dummy"
"199125",0,0,0,0,"dummy"
"199126",0,0,0,0,"dummy"
"199152",2,0,3,5,"dummy"
"199153",1,0,0,1,"dummy"
"199154",0,1,0,1,"dummy"
"199155",0,1,1,2,"dummy"
"199162",0,0,0,0,"dummy"
"199163",0,0,1,1,"dummy"
"199164",0,0,1,1,"dummy"
"199172",0,0,1,1,"dummy"
"199173",0,2,1,3,"dummy"
"199186",4,5,5,14,"dummy"
"199187",0,1,0,1,"dummy"
"199188",1,1,0,2,"dummy"
"199189",0,0,1,1,"dummy"
"199190",0,1,0,1,"dummy"
"199191",8,1,0,9,"dummy"
"199194",0,0,0,0,"dummy"
"199206",2,0,0,2,"dummy"
"199207",0,0,0,0,"dummy"
"199211",3,3,0,6,"dummy"
"199212",19,9,3,31,"dummy"
"199213",0,0,1,1,"dummy"
"199216",0,0,1,1,"dummy"
"199219",10,3,4,17,"dummy"
"199220",3,2,1,6,"dummy"
"199221",0,0,1,1,"dummy"
"199222",0,0,1,1,"dummy"
"199223",3,2,0,5,"dummy"
"199224",0,1,0,1,"dummy"
"199225",0,2,0,2,"dummy"
"199228",0,0,0,0,"dummy"
"199242",0,0,0,0,"dummy"
"199262",3,0,1,4,"dummy"
"199263",2,0,0,2,"dummy"
"199278",0,1,0,1,"dummy"
"199279",0,8,0,8,"dummy"
"199280",1,0,2,3,"dummy"
"199066",1,0,0,1,"dummy"
"199149",1,0,0,1,"dummy"
"199150",0,0,0,0,"dummy"
"199159",1,0,4,5,"dummy"
"199160",6,0,0,6,"dummy"
"199166",11,10,0,21,"dummy"
"199167",1,1,0,2,"dummy"
"199168",5,5,0,10,"dummy"
"199169",12,0,1,13,"dummy"
"199170",0,1,0,1,"dummy"
"199180",0,0,1,1,"dummy"
"199181",2,2,2,6,"dummy"
"199209",0,0,0,0,"dummy"
"199230",0,2,1,3,"dummy"
"199231",0,0,1,1,"dummy"
"199232",0,0,1,1,"dummy"
"199233",0,2,0,2,"dummy"
"199234",0,1,0,1,"dummy"
"199239",2,1,1,4,"dummy"
"199240",0,1,0,1,"dummy"
"199244",0,0,0,0,"dummy"
"199245",0,0,1,1,"dummy"
"199246",3,2,0,5,"dummy"
"199247",0,0,1,1,"dummy"
"199248",0,1,0,1,"dummy"
"199249",0,2,0,2,"dummy"
"199250",0,0,0,0,"dummy"
"199251",0,0,2,2,"dummy"
"199252",0,0,0,0,"dummy"
"199253",4,1,0,5,"dummy"
"199254",1,0,0,1,"dummy"
"199255",0,0,0,0,"dummy"
"199256",1,4,0,5,"dummy"
"199257",0,0,0,0,"dummy"
"199265",0,0,0,0,"dummy"
"199268",0,2,0,2,"dummy"
"199269",1,0,0,1,"dummy"
"199270",0,1,0,1,"dummy"
"199271",0,3,0,3,"dummy"
"199272",2,4,0,6,"dummy"
"199273",1,0,0,1,"dummy"
"199274",2,0,0,2,"dummy"
"199275",0,1,0,1,"dummy"
"199276",1,0,0,1,"dummy"
"199283",4,0,4,8,"dummy"
"199284",1,0,0,1,"dummy"
"199285",0,1,1,2,"dummy"
"199286",0,0,0,0,"dummy"
"199293",0,1,0,1,"dummy"
"199294",0,0,1,1,"dummy"
"199295",0,0,1,1,"dummy"
"199296",1,0,0,1,"dummy"
"199297",0,0,1,1,"dummy"
"199298",0,0,1,1,"dummy"
"199299",0,0,1,1,"dummy"
"199281",0,1,0,1,"dummy"
"199290",0,0,1,1,"dummy"
"199291",0,0,1,1,"dummy"
"199301",0,0,1,1,"dummy"
"199306",0,0,2,2,"dummy"
"199307",0,0,2,2,"dummy"
"199308",0,0,1,1,"dummy"
"199319",0,0,1,1,"dummy"
"199321",0,1,1,2,"dummy"
"199323",0,0,1,1,"dummy"
"199324",4,10,1,15,"dummy"
"199338",0,0,0,0,"dummy"
"199341",3,5,3,11,"dummy"
"199343",0,1,0,1,"dummy"
"199344",0,1,0,1,"dummy"
"199345",2,0,0,2,"dummy"
"199347",2,1,1,4,"dummy"
"199349",11,5,0,16,"dummy"
"199350",0,0,1,1,"dummy"
"199351",0,0,1,1,"dummy"
"199354",0,0,1,1,"dummy"
"199355",0,0,3,3,"dummy"
"199356",0,0,1,1,"dummy"
"199359",0,0,1,1,"dummy"
"199360",0,0,0,0,"dummy"
"199363",7,6,2,15,"dummy"
"199364",0,0,3,3,"dummy"
"199365",6,7,2,15,"dummy"
"199366",2,0,0,2,"dummy"
"199372",0,1,0,1,"dummy"
"199373",1,3,0,4,"dummy"
"199374",1,0,0,1,"dummy"
"199375",0,1,0,1,"dummy"
"199376",1,0,0,1,"dummy"
"199378",0,0,1,1,"dummy"
"199379",4,0,2,6,"dummy"
"199390",1,1,1,3,"dummy"
"199394",3,3,8,14,"dummy"
"199396",0,1,0,1,"dummy"
"199399",0,6,0,6,"dummy"
"199401",0,0,1,1,"dummy"
"199402",2,0,1,3,"dummy"
"199403",0,1,0,1,"dummy"
"199404",0,1,0,1,"dummy"
"199408",1,1,2,4,"dummy"
"199409",1,0,0,1,"dummy"
"199412",0,1,0,1,"dummy"
"199413",0,0,0,0,"dummy"
"199414",0,2,0,2,"dummy"
"199418",0,6,0,6,"dummy"
"199419",2,2,0,4,"dummy"
"199420",0,1,1,2,"dummy"
"199421",0,1,0,1,"dummy"
"199422",0,0,1,1,"dummy"
"199423",0,1,3,4,"dummy"
"199424",0,1,2,3,"dummy"
"199425",1,3,1,5,"dummy"
"199426",3,0,0,3,"dummy"
"199427",0,0,0,0,"dummy"
"199428",0,0,1,1,"dummy"
"199431",0,1,0,1,"dummy"
"199432",1,2,0,3,"dummy"
"199435",0,1,2,3,"dummy"
"199436",0,2,0,2,"dummy"
"199437",0,1,0,1,"dummy"
"199438",0,1,0,1,"dummy"
"199445",0,2,0,2,"dummy"
"199447",5,9,5,19,"dummy"
"199448",14,3,2,19,"dummy"
"199449",0,0,1,1,"dummy"
"199450",3,13,2,18,"dummy"
"199458",0,2,3,5,"dummy"
"199472",0,1,1,2,"dummy"
"199474",0,1,0,1,"dummy"
"199475",2,2,3,7,"dummy"
"199476",2,4,0,6,"dummy"
"199477",4,0,2,6,"dummy"
"199478",4,3,0,7,"dummy"
"199479",0,1,0,1,"dummy"
"199480",3,0,0,3,"dummy"
"199481",0,4,0,4,"dummy"
"199482",4,0,0,4,"dummy"
"199483",4,4,0,8,"dummy"
"199484",0,6,4,10,"dummy"
"199485",0,1,1,2,"dummy"
"199486",0,15,0,15,"dummy"
"199489",3,3,4,10,"dummy"
"199490",0,0,2,2,"dummy"
"199491",2,2,1,5,"dummy"
"199492",1,2,0,3,"dummy"
"199494",0,0,2,2,"dummy"
"199497",0,1,1,2,"dummy"
"199499",1,8,1,10,"dummy"
"199501",2,0,0,2,"dummy"
"199502",0,0,0,0,"dummy"
"199503",4,0,1,5,"dummy"
"199553",0,0,1,1,"dummy"
"199554",0,0,0,0,"dummy"
"199557",2,12,1,15,"dummy"
"199558",2,2,0,4,"dummy"
"199559",3,6,1,10,"dummy"
"199560",1,3,1,5,"dummy"
"199561",0,1,0,1,"dummy"
"199562",0,1,0,1,"dummy"
"199563",0,1,1,2,"dummy"
"199564",2,0,3,5,"dummy"
"199565",0,0,1,1,"dummy"
"199566",0,0,1,1,"dummy"
"199567",0,0,1,1,"dummy"
"199568",0,0,1,1,"dummy"
"199569",0,6,5,11,"dummy"
"199579",1,1,0,2,"dummy"
"199581",2,6,1,9,"dummy"
"199582",0,1,4,5,"dummy"
"199583",1,16,0,17,"dummy"
"199584",0,0,3,3,"dummy"
"199585",0,7,0,7,"dummy"
"199586",0,2,0,2,"dummy"
"199587",1,7,0,8,"dummy"
"199588",2,2,2,6,"dummy"
"199589",3,0,0,3,"dummy"
"199590",40,28,12,80,"dummy"
"199591",0,1,0,1,"dummy"
"199592",0,3,0,3,"dummy"
"199593",1,3,2,6,"dummy"
"199594",4,1,2,7,"dummy"
"199595",2,1,2,5,"dummy"
"199596",5,0,0,5,"dummy"
"199597",6,5,4,15,"dummy"
"199600",0,0,0,0,"dummy"
"199601",0,2,0,2,"dummy"
"199605",1,0,0,1,"dummy"
"199606",0,0,1,1,"dummy"
"199610",0,0,2,2,"dummy"
"199611",0,0,1,1,"dummy"
"199612",0,0,1,1,"dummy"
"199613",2,1,0,3,"dummy"
"199614",0,3,1,4,"dummy"
"199616",31,3,2,36,"dummy"
"199618",0,0,1,1,"dummy"
"199620",0,0,3,3,"dummy"
"199624",3,12,3,18,"dummy"
"199632",0,0,2,2,"dummy"
"199633",0,0,2,2,"dummy"
"199634",10,0,2,12,"dummy"
"199639",0,10,0,10,"dummy"
"199640",11,1,0,12,"dummy"
"199641",0,2,0,2,"dummy"
"199645",0,2,0,2,"dummy"
"199646",0,1,0,1,"dummy"
"199647",0,1,0,1,"dummy"
"199659",0,0,4,4,"dummy"
"199660",3,0,0,3,"dummy"
"199661",0,5,0,5,"dummy"
"199662",4,1,0,5,"dummy"
"199663",6,3,1,10,"dummy"
"199664",0,1,1,2,"dummy"
"199665",0,3,1,4,"dummy"
"199666",0,0,2,2,"dummy"
"199667",0,1,6,7,"dummy"
"199668",0,0,1,1,"dummy"
"199669",0,0,1,1,"dummy"
"199670",0,4,6,10,"dummy"
"199671",2,4,0,6,"dummy"
"199672",0,1,2,3,"dummy"
"199673",0,1,0,1,"dummy"
"199677",0,5,0,5,"dummy"
"199678",0,2,2,4,"dummy"
"199684",0,2,0,2,"dummy"
"199689",4,0,1,5,"dummy"
"199694",1,0,0,1,"dummy"
"199695",0,0,0,0,"dummy"
"199698",0,0,1,1,"dummy"
"199705",1,4,1,6,"dummy"
"199706",2,2,1,5,"dummy"
"199707",0,4,0,4,"dummy"
"199708",1,2,0,3,"dummy"
"199709",0,0,1,1,"dummy"
"199710",1,0,1,2,"dummy"
"199711",0,1,0,1,"dummy"
"199712",1,0,0,1,"dummy"
"199713",0,2,0,2,"dummy"
"199714",0,1,0,1,"dummy"
"199715",1,0,0,1,"dummy"
"199716",2,3,0,5,"dummy"
"199717",3,2,0,5,"dummy"
"199718",2,3,1,6,"dummy"
"199719",0,1,0,1,"dummy"
"199720",0,3,0,3,"dummy"
"199721",7,25,1,33,"dummy"
"199722",0,0,1,1,"dummy"
"199723",9,4,0,13,"dummy"
"199724",0,0,1,1,"dummy"
"199725",0,0,1,1,"dummy"
"199726",6,28,4,38,"dummy"
"199727",1,0,0,1,"dummy"
"199728",0,4,4,8,"dummy"
"199729",0,2,0,2,"dummy"
"199736",0,0,1,1,"dummy"
"199737",0,0,1,1,"dummy"
"199738",0,0,1,1,"dummy"
"199739",0,0,1,1,"dummy"
"199740",0,0,1,1,"dummy"
"199741",0,0,1,1,"dummy"
"199742",0,0,1,1,"dummy"
"199743",2,6,1,9,"dummy"
"199744",0,0,1,1,"dummy"
"199745",1,0,4,5,"dummy"
"199746",0,0,0,0,"dummy"
"199750",0,0,0,0,"dummy"
"199751",1,0,0,1,"dummy"
"199753",0,0,1,1,"dummy"
"199754",2,0,0,2,"dummy"
"199760",0,1,0,1,"dummy"
"199761",0,0,1,1,"dummy"
"199762",0,0,1,1,"dummy"
"199774",0,0,1,1,"dummy"
"199775",1,0,0,1,"dummy"
"199776",0,0,1,1,"dummy"
"199777",0,2,0,2,"dummy"
"199779",0,5,0,5,"dummy"
"199780",9,0,1,10,"dummy"
"199784",0,0,0,0,"dummy"
"199786",2,2,0,4,"dummy"
"199787",0,1,0,1,"dummy"
"199788",1,1,0,2,"dummy"
"199789",2,3,1,6,"dummy"
"199790",0,0,2,2,"dummy"
"199791",0,0,1,1,"dummy"
"199792",1,2,0,3,"dummy"
"199793",2,1,0,3,"dummy"
"199794",1,1,0,2,"dummy"
"199795",1,1,3,5,"dummy"
"199796",0,0,1,1,"dummy"
"199797",0,0,1,1,"dummy"
"199798",0,0,1,1,"dummy"
"199799",3,1,0,4,"dummy"
"199800",0,0,1,1,"dummy"
"199801",0,0,1,1,"dummy"
"199802",1,1,0,2,"dummy"
"199803",0,1,0,1,"dummy"
"199804",2,2,0,4,"dummy"
"199805",0,1,0,1,"dummy"
"199806",0,1,0,1,"dummy"
"199807",1,0,1,2,"dummy"
"199808",0,1,0,1,"dummy"
"199809",1,0,0,1,"dummy"
"199810",0,0,0,0,"dummy"
"199811",1,1,2,4,"dummy"
"199812",2,0,0,2,"dummy"
"199813",0,0,1,1,"dummy"
"199814",0,0,1,1,"dummy"
"199815",0,0,1,1,"dummy"
"199816",0,0,1,1,"dummy"
"199817",0,0,1,1,"dummy"
"199818",0,0,2,2,"dummy"
"199819",0,0,1,1,"dummy"
"199820",0,0,1,1,"dummy"
"199821",0,0,1,1,"dummy"
"199822",0,0,1,1,"dummy"
"199823",0,2,1,3,"dummy"
"199824",0,1,0,1,"dummy"
"199825",1,1,0,2,"dummy"
"199826",4,1,0,5,"dummy"
"199827",0,0,1,1,"dummy"
"199828",0,1,1,2,"dummy"
"199829",0,0,1,1,"dummy"
"199830",0,0,2,2,"dummy"
"199831",0,0,1,1,"dummy"
"199832",0,0,2,2,"dummy"
"199833",0,0,1,1,"dummy"
"199834",0,0,1,1,"dummy"
"199835",0,0,1,1,"dummy"
"199836",3,2,2,7,"dummy"
"199837",0,0,1,1,"dummy"
"199838",0,0,2,2,"dummy"
"199839",0,0,1,1,"dummy"
"199840",1,0,0,1,"dummy"
"199841",1,1,0,2,"dummy"
"199842",0,0,1,1,"dummy"
"199843",0,0,1,1,"dummy"
"199844",0,0,1,1,"dummy"
"199845",0,0,1,1,"dummy"
"199846",0,0,1,1,"dummy"
"199847",0,0,1,1,"dummy"
"199848",0,0,1,1,"dummy"
"199849",0,1,1,2,"dummy"
"199850",0,0,1,1,"dummy"
"199851",0,0,1,1,"dummy"
"199853",0,1,0,1,"dummy"
"199854",1,0,0,1,"dummy"
"199878",0,2,0,2,"dummy"
"199879",0,6,1,7,"dummy"
"199882",1,1,0,2,"dummy"
"199883",2,4,0,6,"dummy"
"199885",0,1,0,1,"dummy"
"199886",0,2,0,2,"dummy"
"199887",0,0,0,0,"dummy"
"199888",0,0,0,0,"dummy"
"199889",0,0,2,2,"dummy"
"199890",1,0,1,2,"dummy"
"199891",0,0,1,1,"dummy"
"199892",9,22,6,37,"dummy"
"199893",2,2,2,6,"dummy"
"199894",2,7,1,10,"dummy"
"199895",1,2,4,7,"dummy"
"199896",0,0,1,1,"dummy"
"199897",0,0,1,1,"dummy"
"199898",0,2,2,4,"dummy"
"199899",1,3,0,4,"dummy"
"199900",2,0,0,2,"dummy"
"199901",4,0,1,5,"dummy"
"199902",3,1,1,5,"dummy"
"199903",0,0,1,1,"dummy"
"199905",5,2,0,7,"dummy"
"199906",0,1,0,1,"dummy"
"199907",1,7,0,8,"dummy"
"199908",5,0,0,5,"dummy"
"199909",0,4,0,4,"dummy"
"199910",0,1,0,1,"dummy"
"199911",0,2,0,2,"dummy"
"199912",0,0,0,0,"dummy"
"199913",0,0,0,0,"dummy"
"199914",0,1,0,1,"dummy"
"199964",0,0,1,1,"dummy"
"199965",0,9,1,10,"dummy"
"199973",1,1,0,2,"dummy"
"199976",0,1,1,2,"dummy"
"199977",2,1,0,3,"dummy"
"199980",2,0,0,2,"dummy"
"199982",0,0,1,1,"dummy"
"199986",0,1,0,1,"dummy"
"199987",0,0,2,2,"dummy"
"199988",0,0,1,1,"dummy"
"199990",0,3,1,4,"dummy"
"200015",0,0,1,1,"dummy"
"200016",6,5,1,12,"dummy"
"200019",0,0,0,0,"dummy"
"200021",0,0,0,0,"dummy"
"200024",0,0,0,0,"dummy"
"200025",3,1,1,5,"dummy"
"200026",11,9,2,22,"dummy"
"200028",2,0,0,2,"dummy"
"200029",0,7,0,7,"dummy"
"200030",0,1,0,1,"dummy"
"200031",0,3,0,3,"dummy"
"200034",0,1,0,1,"dummy"
"200035",1,1,0,2,"dummy"
"200036",1,1,0,2,"dummy"
"200038",4,0,0,4,"dummy"
"200040",0,1,2,3,"dummy"
"200042",0,5,2,7,"dummy"
"200043",0,0,0,0,"dummy"
"200044",9,5,2,16,"dummy"
"200045",2,9,1,12,"dummy"
"200046",3,6,1,10,"dummy"
"200047",4,1,2,7,"dummy"
"200048",4,0,0,4,"dummy"
"200049",3,5,2,10,"dummy"
"200050",0,0,1,1,"dummy"
"200051",0,3,0,3,"dummy"
"200053",0,0,0,0,"dummy"
"200054",0,0,0,0,"dummy"
"200058",0,3,3,6,"dummy"
"200059",0,2,3,5,"dummy"
"200062",10,0,2,12,"dummy"
"200063",0,1,1,2,"dummy"
"200064",2,5,2,9,"dummy"
"200065",0,1,0,1,"dummy"
"200073",18,2,4,24,"dummy"
"200075",2,0,0,2,"dummy"
"200078",9,6,1,16,"dummy"
"200079",0,0,1,1,"dummy"
"200080",0,0,0,0,"dummy"
"200081",0,0,0,0,"dummy"
"200083",0,1,0,1,"dummy"
"200084",0,2,0,2,"dummy"
"200085",1,0,0,1,"dummy"
"200086",0,0,0,0,"dummy"
"200087",6,0,0,6,"dummy"
"200088",5,1,0,6,"dummy"
"200089",0,1,0,1,"dummy"
"200090",1,0,0,1,"dummy"
"200092",2,1,3,6,"dummy"
"200094",0,15,1,16,"dummy"
"200096",0,1,0,1,"dummy"
"200097",2,0,2,4,"dummy"
"200099",0,0,1,1,"dummy"
"200100",0,0,1,1,"dummy"
"200101",0,0,1,1,"dummy"
"200102",0,0,1,1,"dummy"
"200103",0,0,1,1,"dummy"
"200104",0,0,1,1,"dummy"
"200105",0,0,1,1,"dummy"
"200106",0,0,1,1,"dummy"
"200121",4,9,4,17,"dummy"
"200122",0,0,3,3,"dummy"
"200123",0,0,2,2,"dummy"
"200125",0,3,1,4,"dummy"
"200126",0,0,1,1,"dummy"
"200127",0,1,0,1,"dummy"
"200129",0,16,0,16,"dummy"
"200130",5,13,3,21,"dummy"
"200131",3,1,1,5,"dummy"
"200132",0,0,0,0,"dummy"
"200133",0,1,1,2,"dummy"
"200135",0,1,0,1,"dummy"
"200136",0,1,2,3,"dummy"
"200137",2,4,1,7,"dummy"
"200138",11,0,7,18,"dummy"
"200142",0,0,1,1,"dummy"
"200144",0,0,1,1,"dummy"
"200145",0,3,0,3,"dummy"
"200147",0,2,1,3,"dummy"
"200149",0,1,1,2,"dummy"
"200150",4,0,1,5,"dummy"
"200151",0,1,1,2,"dummy"
"200152",0,1,1,2,"dummy"
"200153",1,1,0,2,"dummy"
"200155",5,4,4,13,"dummy"
"200156",0,0,1,1,"dummy"
"200157",0,0,1,1,"dummy"
"200158",2,0,0,2,"dummy"
"200159",0,0,1,1,"dummy"
"200160",0,0,1,1,"dummy"
"200161",0,0,1,1,"dummy"
"200162",0,0,1,1,"dummy"
"200163",0,0,1,1,"dummy"
"200164",0,0,1,1,"dummy"
"200166",3,2,1,6,"dummy"
"200167",1,1,0,2,"dummy"
"200169",1,3,0,4,"dummy"
"200170",1,0,0,1,"dummy"
"200171",1,1,0,2,"dummy"
"200175",0,0,1,1,"dummy"
"200184",0,1,0,1,"dummy"
"200185",0,0,1,1,"dummy"
"200186",1,11,0,12,"dummy"
"200187",0,8,0,8,"dummy"
"200188",0,3,0,3,"dummy"
"200189",0,2,0,2,"dummy"
"200190",0,1,6,7,"dummy"
"200191",0,1,1,2,"dummy"
"200192",19,7,10,36,"dummy"
"200193",13,4,0,17,"dummy"
"200194",10,15,1,26,"dummy"
"200198",0,2,0,2,"dummy"
"200203",0,0,1,1,"dummy"
"200204",4,0,0,4,"dummy"
"200205",2,2,2,6,"dummy"
"200206",2,1,1,4,"dummy"
"200207",0,4,0,4,"dummy"
"200208",0,4,0,4,"dummy"
"200209",1,2,0,3,"dummy"
"200210",3,3,0,6,"dummy"
"200211",2,0,0,2,"dummy"
"200212",0,1,0,1,"dummy"
"200213",0,0,1,1,"dummy"
"200214",8,0,0,8,"dummy"
"200215",0,8,0,8,"dummy"
"200216",1,0,1,2,"dummy"
"200217",0,7,0,7,"dummy"
"200219",0,0,0,0,"dummy"
"200220",16,2,0,18,"dummy"
"200222",18,2,1,21,"dummy"
"200223",0,1,0,1,"dummy"
"200224",0,0,1,1,"dummy"
"200226",0,1,0,1,"dummy"
"200227",0,0,1,1,"dummy"
"200228",0,1,0,1,"dummy"
"200249",1,9,0,10,"dummy"
"200250",0,1,0,1,"dummy"
"200251",0,0,0,0,"dummy"
"200252",0,4,1,5,"dummy"
"200253",0,1,1,2,"dummy"
"200254",0,1,0,1,"dummy"
"200255",1,0,0,1,"dummy"
"200256",0,1,0,1,"dummy"
"200257",0,4,0,4,"dummy"
"200258",0,0,1,1,"dummy"
"200259",26,5,8,39,"dummy"
"200260",0,1,0,1,"dummy"
"200261",0,4,0,4,"dummy"
"200262",0,0,2,2,"dummy"
"200263",22,26,5,53,"dummy"
"200264",0,1,1,2,"dummy"
"200266",1,0,6,7,"dummy"
"200267",1,1,0,2,"dummy"
"200269",4,1,2,7,"dummy"
"200271",0,1,0,1,"dummy"
"200272",0,1,0,1,"dummy"
"200273",0,6,0,6,"dummy"
"200274",0,1,0,1,"dummy"
"200275",2,0,0,2,"dummy"
"200281",2,2,3,7,"dummy"
"200282",0,2,10,12,"dummy"
"200283",0,1,0,1,"dummy"
"200284",7,18,0,25,"dummy"
"200285",4,0,0,4,"dummy"
"200287",0,14,0,14,"dummy"
"200288",0,2,0,2,"dummy"
"200289",0,0,1,1,"dummy"
"200290",0,1,0,1,"dummy"
"200291",0,0,1,1,"dummy"
"200292",0,2,0,2,"dummy"
"200293",0,2,0,2,"dummy"
"200294",1,6,0,7,"dummy"
"200295",0,1,2,3,"dummy"
"200296",1,3,1,5,"dummy"
"200297",0,0,1,1,"dummy"
"200300",0,0,0,0,"dummy"
"200303",8,8,0,16,"dummy"
"200304",0,1,0,1,"dummy"
"200308",0,0,1,1,"dummy"
"200309",0,0,1,1,"dummy"
"200310",0,1,0,1,"dummy"
"200312",1,1,2,4,"dummy"
"200313",1,0,0,1,"dummy"
"200314",0,0,0,0,"dummy"
"200330",1,1,2,4,"dummy"
"200332",0,0,1,1,"dummy"
"200334",0,1,3,4,"dummy"
"200335",0,0,1,1,"dummy"
"200336",0,0,1,1,"dummy"
"200338",0,1,0,1,"dummy"
"200339",0,0,1,1,"dummy"
"200346",2,0,3,5,"dummy"
"200356",22,1,1,24,"dummy"
"200357",0,12,0,12,"dummy"
"200360",1,3,4,8,"dummy"
"200361",1,1,5,7,"dummy"
"200362",0,1,0,1,"dummy"
"200363",1,2,0,3,"dummy"
"200364",0,4,0,4,"dummy"
"200365",1,2,0,3,"dummy"
"200367",0,3,0,3,"dummy"
"200370",0,0,1,1,"dummy"
"200374",1,0,0,1,"dummy"
"200375",0,0,0,0,"dummy"
"200380",23,5,1,29,"dummy"
"200381",5,16,0,21,"dummy"
"200382",1,2,3,6,"dummy"
"200385",1,0,0,1,"dummy"
"200389",0,3,0,3,"dummy"
"200390",0,0,1,1,"dummy"
"200391",5,4,0,9,"dummy"
"200392",0,1,0,1,"dummy"
"200393",0,0,2,2,"dummy"
"200414",0,3,0,3,"dummy"
"200417",0,0,5,5,"dummy"
"200421",0,9,0,9,"dummy"
"200422",3,0,0,3,"dummy"
"200423",1,0,0,1,"dummy"
"200424",0,0,0,0,"dummy"
"200425",9,1,0,10,"dummy"
"200427",0,2,0,2,"dummy"
"200429",0,1,0,1,"dummy"
"200431",1,2,0,3,"dummy"
"200432",0,3,0,3,"dummy"
"200433",2,0,0,2,"dummy"
"200434",3,0,0,3,"dummy"
"200435",0,1,1,2,"dummy"
"200436",0,3,0,3,"dummy"
"200437",0,4,0,4,"dummy"
"200438",0,1,0,1,"dummy"
"200439",2,0,0,2,"dummy"
"200440",0,5,0,5,"dummy"
"200441",0,2,0,2,"dummy"
"200442",2,3,2,7,"dummy"
"200449",1,12,0,13,"dummy"
"200479",0,0,1,1,"dummy"
"200480",0,0,1,1,"dummy"
"200481",0,0,1,1,"dummy"
"200482",0,0,1,1,"dummy"
"200483",0,0,1,1,"dummy"
"200484",0,0,1,1,"dummy"
"200485",0,0,1,1,"dummy"
"200486",0,2,0,2,"dummy"
"200487",2,0,0,2,"dummy"
"200489",0,2,0,2,"dummy"
"200490",0,4,0,4,"dummy"
"200491",0,1,0,1,"dummy"
"200492",0,1,1,2,"dummy"
"200493",0,1,0,1,"dummy"
"200494",1,3,0,4,"dummy"
"200495",3,1,0,4,"dummy"
"200496",0,0,0,0,"dummy"
"200497",0,2,0,2,"dummy"
"200498",0,0,1,1,"dummy"
"200500",0,0,0,0,"dummy"
"200501",1,2,2,5,"dummy"
"200502",0,1,0,1,"dummy"
"200503",1,0,4,5,"dummy"
"200504",0,1,2,3,"dummy"
"200505",0,1,0,1,"dummy"
"200509",1,1,1,3,"dummy"
"200516",0,0,1,1,"dummy"
"200517",3,3,0,6,"dummy"
"200518",0,1,0,1,"dummy"
"200519",0,0,1,1,"dummy"
"200526",0,1,0,1,"dummy"
"200527",1,0,0,1,"dummy"
"200528",0,0,1,1,"dummy"
"200529",0,1,0,1,"dummy"
"200530",0,1,0,1,"dummy"
"200540",0,2,0,2,"dummy"
"200541",0,1,0,1,"dummy"
"200542",0,1,1,2,"dummy"
"200543",0,1,0,1,"dummy"
"200544",0,0,0,0,"dummy"
"200545",7,3,0,10,"dummy"
"200546",0,2,0,2,"dummy"
"200549",1,0,1,2,"dummy"
"200550",0,1,0,1,"dummy"
"200551",0,1,0,1,"dummy"
"200552",0,1,0,1,"dummy"
"200553",0,0,0,0,"dummy"
"200554",0,1,0,1,"dummy"
"200555",0,2,0,2,"dummy"
"200563",0,0,1,1,"dummy"
"200564",0,2,0,2,"dummy"
"200565",2,6,0,8,"dummy"
"200566",6,3,0,9,"dummy"
"200567",0,2,2,4,"dummy"
"200570",0,14,0,14,"dummy"
"200571",0,7,0,7,"dummy"
"200578",0,5,0,5,"dummy"
"200579",0,0,5,5,"dummy"
"200580",0,2,0,2,"dummy"
"200581",15,2,3,20,"dummy"
"200582",0,0,2,2,"dummy"
"200583",0,0,0,0,"dummy"
"200589",1,2,0,3,"dummy"
"200592",1,1,3,5,"dummy"
"200593",2,5,0,7,"dummy"
"200594",0,0,1,1,"dummy"
"200598",4,8,3,15,"dummy"
"200599",0,2,0,2,"dummy"
"200600",0,1,0,1,"dummy"
"200601",0,0,1,1,"dummy"
"200602",0,2,0,2,"dummy"
"200603",2,0,0,2,"dummy"
"200618",1,0,2,3,"dummy"
"200634",0,0,1,1,"dummy"
"200635",0,0,1,1,"dummy"
"200636",0,0,2,2,"dummy"
"200637",0,0,1,1,"dummy"
"200638",0,0,1,1,"dummy"
"200639",0,2,0,2,"dummy"
"200640",0,1,0,1,"dummy"
"200641",1,0,1,2,"dummy"
"200642",0,1,0,1,"dummy"
"200643",0,0,1,1,"dummy"
"200644",0,1,0,1,"dummy"
"200645",0,1,0,1,"dummy"
"200646",2,2,0,4,"dummy"
"200649",0,2,0,2,"dummy"
"200652",2,0,3,5,"dummy"
"200664",0,0,0,0,"dummy"
"200665",0,1,0,1,"dummy"
"200532",0,1,0,1,"dummy"
"200573",0,0,0,0,"dummy"
"200574",0,0,1,1,"dummy"
"200575",0,0,0,0,"dummy"
"200576",1,0,0,1,"dummy"
"200596",0,2,0,2,"dummy"
"200605",5,7,0,12,"dummy"
"200608",0,1,0,1,"dummy"
"200609",0,0,1,1,"dummy"
"200667",2,0,0,2,"dummy"
"200668",1,1,0,2,"dummy"
"200669",0,0,0,0,"dummy"
"200670",0,0,3,3,"dummy"
"200671",0,1,1,2,"dummy"
"200672",3,0,0,3,"dummy"
"200673",0,0,0,0,"dummy"
"200674",0,0,3,3,"dummy"
"200675",0,0,2,2,"dummy"
"200676",0,0,1,1,"dummy"
"200677",1,0,0,1,"dummy"
"200678",1,0,0,1,"dummy"
"200686",1,1,0,2,"dummy"
"200687",0,0,2,2,"dummy"
"200688",1,0,0,1,"dummy"
"200695",0,0,1,1,"dummy"
"200709",1,0,7,8,"dummy"
"200711",1,0,0,1,"dummy"
"200714",0,1,0,1,"dummy"
"200721",0,2,0,2,"dummy"
"200722",0,0,1,1,"dummy"
"200724",0,1,0,1,"dummy"
"200727",0,1,2,3,"dummy"
"200729",0,1,0,1,"dummy"
"200730",0,0,1,1,"dummy"
"200731",0,2,0,2,"dummy"
"200732",1,0,5,6,"dummy"
"200733",0,1,0,1,"dummy"
"200735",1,2,0,3,"dummy"
"200742",0,3,0,3,"dummy"
"200743",0,0,2,2,"dummy"
"200744",0,0,0,0,"dummy"
"200748",0,4,2,6,"dummy"
"200749",0,1,0,1,"dummy"
"200750",0,0,0,0,"dummy"
"200773",0,2,0,2,"dummy"
"200776",3,3,6,12,"dummy"
"200777",1,0,0,1,"dummy"
"200780",0,0,1,1,"dummy"
"200781",4,4,2,10,"dummy"
"200782",0,0,2,2,"dummy"
"200783",0,4,0,4,"dummy"
"200785",0,0,1,1,"dummy"
"200786",0,0,1,1,"dummy"
"200787",0,0,1,1,"dummy"
"200788",0,0,1,1,"dummy"
"200789",0,0,1,1,"dummy"
"200796",0,2,0,2,"dummy"
"200797",1,0,0,1,"dummy"
"200798",0,2,0,2,"dummy"
"200804",0,1,1,2,"dummy"
"200805",0,1,0,1,"dummy"
"200808",0,1,2,3,"dummy"
"200809",0,0,0,0,"dummy"
"200810",0,1,0,1,"dummy"
"200811",4,0,2,6,"dummy"
"200812",1,0,0,1,"dummy"
"200813",0,0,0,0,"dummy"
"200819",1,2,1,4,"dummy"
"200823",0,0,2,2,"dummy"
"200824",0,0,3,3,"dummy"
"200825",0,0,2,2,"dummy"
"200826",2,13,0,15,"dummy"
"200827",0,1,0,1,"dummy"
"200828",14,3,1,18,"dummy"
"200829",2,14,0,16,"dummy"
"200830",0,1,0,1,"dummy"
"200831",19,15,2,36,"dummy"
"200832",0,0,1,1,"dummy"
"200833",0,0,1,1,"dummy"
"200835",2,0,3,5,"dummy"
"200841",0,0,2,2,"dummy"
"200848",0,0,1,1,"dummy"
"200849",0,0,0,0,"dummy"
"200853",2,6,1,9,"dummy"
"200854",0,1,1,2,"dummy"
"200855",1,0,0,1,"dummy"
"200856",1,0,0,1,"dummy"
"200858",3,3,2,8,"dummy"
"200859",3,1,0,4,"dummy"
"200860",0,0,2,2,"dummy"
"200862",0,0,4,4,"dummy"
"200866",0,1,0,1,"dummy"
"200867",9,13,0,22,"dummy"
"200868",0,1,1,2,"dummy"
"200871",0,0,0,0,"dummy"
"200872",3,1,0,4,"dummy"
"200874",1,4,0,5,"dummy"
"200877",0,0,0,0,"dummy"
"200879",11,2,1,14,"dummy"
"200881",0,1,1,2,"dummy"
"200882",0,0,0,0,"dummy"
"200883",0,0,0,0,"dummy"
"200884",0,0,0,0,"dummy"
"200885",0,0,1,1,"dummy"
"200887",0,0,2,2,"dummy"
"200888",0,0,1,1,"dummy"
"200889",0,0,1,1,"dummy"
"200890",0,0,1,1,"dummy"
"200896",0,0,1,1,"dummy"
"200897",0,0,2,2,"dummy"
"200898",0,0,0,0,"dummy"
"200899",0,0,2,2,"dummy"
"200900",0,0,2,2,"dummy"
"200902",0,0,2,2,"dummy"
"200903",0,1,3,4,"dummy"
"200904",0,0,1,1,"dummy"
"200906",2,1,0,3,"dummy"
"200908",1,2,1,4,"dummy"
"200909",2,0,0,2,"dummy"
"200910",2,7,1,10,"dummy"
"200911",8,8,0,16,"dummy"
"200912",0,5,0,5,"dummy"
"200913",5,1,0,6,"dummy"
"200919",0,0,1,1,"dummy"
"200921",0,0,1,1,"dummy"
"200922",0,0,1,1,"dummy"
"200954",0,0,1,1,"dummy"
"200955",6,3,0,9,"dummy"
"200956",0,0,1,1,"dummy"
"200957",3,10,1,14,"dummy"
"200958",0,0,1,1,"dummy"
"200959",0,0,1,1,"dummy"
"200960",0,0,1,1,"dummy"
"200972",0,0,1,1,"dummy"
"200973",1,0,0,1,"dummy"
"200974",0,0,1,1,"dummy"
"200975",0,1,0,1,"dummy"
"200976",1,1,0,2,"dummy"
"200978",20,5,4,29,"dummy"
"200979",7,20,2,29,"dummy"
"200981",28,26,4,58,"dummy"
"200982",0,4,0,4,"dummy"
"200983",0,0,1,1,"dummy"
"200984",1,5,0,6,"dummy"
"200985",0,0,3,3,"dummy"
"200986",2,0,0,2,"dummy"
"200988",0,4,0,4,"dummy"
"200989",1,4,0,5,"dummy"
"200990",2,1,1,4,"dummy"
"200991",0,0,2,2,"dummy"
"200992",0,1,0,1,"dummy"
"200996",0,1,0,1,"dummy"
"200997",2,11,0,13,"dummy"
"200998",7,0,0,7,"dummy"
"200999",1,1,0,2,"dummy"
"201009",2,0,2,4,"dummy"
"201010",2,2,0,4,"dummy"
"201011",0,0,1,1,"dummy"
"201014",0,0,1,1,"dummy"
"201015",0,1,1,2,"dummy"
"201016",8,0,3,11,"dummy"
"201020",10,0,0,10,"dummy"
"201022",0,0,1,1,"dummy"
"201023",0,0,1,1,"dummy"
"201024",7,9,1,17,"dummy"
"201025",6,0,0,6,"dummy"
"201026",0,0,1,1,"dummy"
"201027",0,0,2,2,"dummy"
"201028",3,4,0,7,"dummy"
"201074",0,2,0,2,"dummy"
"201075",0,2,0,2,"dummy"
"201076",0,0,3,3,"dummy"
"201078",0,2,0,2,"dummy"
"201079",0,0,0,0,"dummy"
"201080",0,2,0,2,"dummy"
"201081",2,0,0,2,"dummy"
"201083",1,0,0,1,"dummy"
"201085",7,3,0,10,"dummy"
"201086",0,1,0,1,"dummy"
"201104",2,7,2,11,"dummy"
"201105",2,3,1,6,"dummy"
"201106",2,3,0,5,"dummy"
"201118",0,8,0,8,"dummy"
"201119",5,10,1,16,"dummy"
"201120",0,1,1,2,"dummy"
"201121",0,0,2,2,"dummy"
"201122",6,1,2,9,"dummy"
"201123",0,3,0,3,"dummy"
"201124",4,0,2,6,"dummy"
"201125",0,0,2,2,"dummy"
"201126",0,1,0,1,"dummy"
"201127",0,1,1,2,"dummy"
"201128",1,1,0,2,"dummy"
"201129",1,1,1,3,"dummy"
"201130",0,0,1,1,"dummy"
"201131",2,3,0,5,"dummy"
"201132",0,0,1,1,"dummy"
"201133",0,0,1,1,"dummy"
"201137",0,0,1,1,"dummy"
"201139",0,2,0,2,"dummy"
"201140",1,0,0,1,"dummy"
"201141",0,0,1,1,"dummy"
"201142",2,2,0,4,"dummy"
"201143",1,1,0,2,"dummy"
"201144",0,0,2,2,"dummy"
"201146",0,1,0,1,"dummy"
"201149",0,0,1,1,"dummy"
"201150",2,9,0,11,"dummy"
"201151",2,10,2,14,"dummy"
"201152",0,2,0,2,"dummy"
"201153",2,0,0,2,"dummy"
"201154",1,1,0,2,"dummy"
"201155",0,11,0,11,"dummy"
"201156",13,12,0,25,"dummy"
"201157",12,0,0,12,"dummy"
"201158",0,12,0,12,"dummy"
"201159",4,4,1,9,"dummy"
"201160",2,2,0,4,"dummy"
"201161",2,2,0,4,"dummy"
"201162",2,3,0,5,"dummy"
"201163",2,2,0,4,"dummy"
"201164",4,7,1,12,"dummy"
"201165",0,0,2,2,"dummy"
"201166",0,2,0,2,"dummy"
"201167",0,0,1,1,"dummy"
"201168",0,2,0,2,"dummy"
"201169",0,0,1,1,"dummy"
"201170",0,0,1,1,"dummy"
"201171",0,0,1,1,"dummy"
"201172",0,0,1,1,"dummy"
"201173",1,2,2,5,"dummy"
"201174",0,0,1,1,"dummy"
"201175",0,0,1,1,"dummy"
"201176",0,0,1,1,"dummy"
"201178",0,1,0,1,"dummy"
"201179",0,4,0,4,"dummy"
"201180",0,1,0,1,"dummy"
"201181",0,4,1,5,"dummy"
"201182",1,1,0,2,"dummy"
"201183",4,8,1,13,"dummy"
"201189",0,2,0,2,"dummy"
"201193",0,2,0,2,"dummy"
"201195",0,7,0,7,"dummy"
"201196",0,0,2,2,"dummy"
"201197",0,0,1,1,"dummy"
"201198",0,1,0,1,"dummy"
"201199",0,0,2,2,"dummy"
"201200",0,0,1,1,"dummy"
"201201",0,0,1,1,"dummy"
"201202",0,0,1,1,"dummy"
"201203",0,0,1,1,"dummy"
"201204",0,0,1,1,"dummy"
"201205",0,0,1,1,"dummy"
"201206",0,0,1,1,"dummy"
"201207",2,0,0,2,"dummy"
"201209",0,0,1,1,"dummy"
"201210",1,0,0,1,"dummy"
"201211",0,0,1,1,"dummy"
"201212",1,7,2,10,"dummy"
"201213",7,2,2,11,"dummy"
"201214",0,1,0,1,"dummy"
"201215",2,4,0,6,"dummy"
"201216",0,2,0,2,"dummy"
"201217",1,0,0,1,"dummy"
"201218",1,0,1,2,"dummy"
"201219",0,0,0,0,"dummy"
"201224",0,1,0,1,"dummy"
"201228",0,0,1,1,"dummy"
"201229",0,0,1,1,"dummy"
"201230",0,0,1,1,"dummy"
"201231",0,0,1,1,"dummy"
"201232",0,0,1,1,"dummy"
"201233",0,0,2,2,"dummy"
"201235",3,1,0,4,"dummy"
"201242",9,8,2,19,"dummy"
"201243",0,1,0,1,"dummy"
"201244",1,0,0,1,"dummy"
"201245",0,1,0,1,"dummy"
"201246",5,2,4,11,"dummy"
"201247",0,1,0,1,"dummy"
"201248",0,1,1,2,"dummy"
"201251",0,0,0,0,"dummy"
"201252",0,0,0,0,"dummy"
"201256",0,0,0,0,"dummy"
"201258",0,0,0,0,"dummy"
"201260",0,2,0,2,"dummy"
"201263",1,0,0,1,"dummy"
"201270",0,2,0,2,"dummy"
"201275",0,2,0,2,"dummy"
"201288",0,0,1,1,"dummy"
"201289",2,2,0,4,"dummy"
"201291",0,1,1,2,"dummy"
"201292",0,1,0,1,"dummy"
"201293",0,3,0,3,"dummy"
"201294",1,0,0,1,"dummy"
"201295",8,7,0,15,"dummy"
"201299",0,4,1,5,"dummy"
"201300",2,2,0,4,"dummy"
"201301",3,0,0,3,"dummy"
"201302",0,5,0,5,"dummy"
"201303",1,2,0,3,"dummy"
"201304",1,6,2,9,"dummy"
"201305",6,0,0,6,"dummy"
"201306",0,0,2,2,"dummy"
"201307",0,3,0,3,"dummy"
"201308",0,1,0,1,"dummy"
"201309",16,3,2,21,"dummy"
"201310",0,1,0,1,"dummy"
"201311",0,0,3,3,"dummy"
"201313",0,0,1,1,"dummy"
"201316",0,0,0,0,"dummy"
"201317",3,3,0,6,"dummy"
"201318",0,4,0,4,"dummy"
"201319",5,5,4,14,"dummy"
"201327",0,1,0,1,"dummy"
"201342",0,0,1,1,"dummy"
"201345",2,0,2,4,"dummy"
"201346",0,1,0,1,"dummy"
"201347",0,0,0,0,"dummy"
"201348",0,8,1,9,"dummy"
"201349",0,1,0,1,"dummy"
"201350",0,1,0,1,"dummy"
"201353",1,0,0,1,"dummy"
"201354",0,0,1,1,"dummy"
"201355",0,0,0,0,"dummy"
"201356",0,0,1,1,"dummy"
"201357",1,0,1,2,"dummy"
"201367",0,0,1,1,"dummy"
"201496",0,1,0,1,"dummy"
"201499",0,2,0,2,"dummy"
"201509",0,2,0,2,"dummy"
"201521",0,1,0,1,"dummy"
"201522",0,2,0,2,"dummy"
"201559",5,0,2,7,"dummy"
"201560",0,1,0,1,"dummy"
"201561",0,1,0,1,"dummy"
"201562",0,0,0,0,"dummy"
"201563",0,1,0,1,"dummy"
"201564",1,6,3,10,"dummy"
"201567",0,2,0,2,"dummy"
"201568",12,6,4,22,"dummy"
"201575",0,0,1,1,"dummy"
"201579",0,1,0,1,"dummy"
"201580",0,3,1,4,"dummy"
"201581",2,0,0,2,"dummy"
"201595",4,4,5,13,"dummy"
"201596",0,3,1,4,"dummy"
"201597",1,1,0,2,"dummy"
"201602",8,9,2,19,"dummy"
"201603",23,7,3,33,"dummy"
"201325",0,0,1,1,"dummy"
"201335",0,2,0,2,"dummy"
"201361",0,0,1,1,"dummy"
"201362",0,0,4,4,"dummy"
"201365",0,0,1,1,"dummy"
"201380",0,4,0,4,"dummy"
"201437",0,0,0,0,"dummy"
"201438",0,0,0,0,"dummy"
"201439",0,0,0,0,"dummy"
"201440",0,0,0,0,"dummy"
"201441",0,0,0,0,"dummy"
"201442",0,0,0,0,"dummy"
"201443",0,0,0,0,"dummy"
"201444",0,0,1,1,"dummy"
"201445",1,1,0,2,"dummy"
"201446",0,0,0,0,"dummy"
"201447",0,0,0,0,"dummy"
"201448",0,0,1,1,"dummy"
"201449",3,3,0,6,"dummy"
"201450",0,5,0,5,"dummy"
"201451",0,0,1,1,"dummy"
"201452",2,2,0,4,"dummy"
"201453",1,0,0,1,"dummy"
"201454",1,0,0,1,"dummy"
"201455",4,2,4,10,"dummy"
"201456",1,0,0,1,"dummy"
"201457",0,0,0,0,"dummy"
"201458",0,1,0,1,"dummy"
"201459",0,0,1,1,"dummy"
"201460",1,0,1,2,"dummy"
"201461",0,0,1,1,"dummy"
"201462",0,0,1,1,"dummy"
"201463",0,0,1,1,"dummy"
"201464",1,2,0,3,"dummy"
"201465",0,0,1,1,"dummy"
"201466",4,1,0,5,"dummy"
"201467",0,0,1,1,"dummy"
"201468",0,0,1,1,"dummy"
"201469",1,0,0,1,"dummy"
"201470",0,0,1,1,"dummy"
"201471",1,2,0,3,"dummy"
"201472",1,4,1,6,"dummy"
"201473",7,4,1,12,"dummy"
"201474",0,0,2,2,"dummy"
"201475",0,1,0,1,"dummy"
"201476",2,1,2,5,"dummy"
"201477",0,1,0,1,"dummy"
"201478",0,0,1,1,"dummy"
"201479",2,2,0,4,"dummy"
"201480",2,2,1,5,"dummy"
"201481",2,2,1,5,"dummy"
"201482",0,0,0,0,"dummy"
"201483",0,2,0,2,"dummy"
"201484",1,0,0,1,"dummy"
"201487",0,1,0,1,"dummy"
"201488",0,1,0,1,"dummy"
"201489",0,1,0,1,"dummy"
"201490",0,1,0,1,"dummy"
"201491",0,2,2,4,"dummy"
"201492",2,1,2,5,"dummy"
"201493",0,2,2,4,"dummy"
"201494",0,1,0,1,"dummy"
"201501",7,12,1,20,"dummy"
"201502",3,3,1,7,"dummy"
"201513",0,1,0,1,"dummy"
"201514",2,5,0,7,"dummy"
"201515",0,1,0,1,"dummy"
"201516",0,2,0,2,"dummy"
"201517",1,0,0,1,"dummy"
"201524",0,14,0,14,"dummy"
"201525",3,1,2,6,"dummy"
"201526",0,0,1,1,"dummy"
"201527",0,2,3,5,"dummy"
"201545",0,2,0,2,"dummy"
"201548",1,1,6,8,"dummy"
"201549",1,0,6,7,"dummy"
"201552",0,2,2,4,"dummy"
"201553",0,2,0,2,"dummy"
"201554",0,4,0,4,"dummy"
"201555",0,0,0,0,"dummy"
"201556",0,4,0,4,"dummy"
"201557",10,4,9,23,"dummy"
"201572",0,1,1,2,"dummy"
"201573",18,2,4,24,"dummy"
"201577",0,0,1,1,"dummy"
"201583",0,1,0,1,"dummy"
"201591",0,1,0,1,"dummy"
"201616",0,0,1,1,"dummy"
"201617",0,1,0,1,"dummy"
"201632",0,1,0,1,"dummy"
"201633",0,1,0,1,"dummy"
"201634",0,0,2,2,"dummy"
"201637",3,3,0,6,"dummy"
"201638",1,0,0,1,"dummy"
"201639",0,1,0,1,"dummy"
"201640",0,0,1,1,"dummy"
"201641",0,0,1,1,"dummy"
"201642",0,0,1,1,"dummy"
"201652",0,0,0,0,"dummy"
"201653",0,0,0,0,"dummy"
"201654",0,3,0,3,"dummy"
"201667",0,0,1,1,"dummy"
"201668",7,15,1,23,"dummy"
"201671",2,5,0,7,"dummy"
"201672",1,8,2,11,"dummy"
"201673",0,1,0,1,"dummy"
"201674",0,1,0,1,"dummy"
"201675",0,0,1,1,"dummy"
"201676",2,2,0,4,"dummy"
"201677",1,1,0,2,"dummy"
"201678",0,4,0,4,"dummy"
"201679",0,4,0,4,"dummy"
"201682",0,0,0,0,"dummy"
"201694",0,0,1,1,"dummy"
"201747",0,1,0,1,"dummy"
"201748",0,4,0,4,"dummy"
"201749",6,1,1,8,"dummy"
"201767",5,4,1,10,"dummy"
"201768",0,0,1,1,"dummy"
"201775",1,1,0,2,"dummy"
"201784",4,4,0,8,"dummy"
"201785",4,4,0,8,"dummy"
"201786",0,1,0,1,"dummy"
"201787",0,0,0,0,"dummy"
"201788",2,0,3,5,"dummy"
"201789",0,0,0,0,"dummy"
"201794",0,0,2,2,"dummy"
"201902",0,0,0,0,"dummy"
"201624",2,0,0,2,"dummy"
"201625",0,4,2,6,"dummy"
"201626",5,0,0,5,"dummy"
"201627",0,0,5,5,"dummy"
"201628",1,2,3,6,"dummy"
"201644",0,0,1,1,"dummy"
"201645",2,1,0,3,"dummy"
"201646",0,5,0,5,"dummy"
"201647",0,5,0,5,"dummy"
"201648",0,0,0,0,"dummy"
"201649",0,1,0,1,"dummy"
"201650",0,0,0,0,"dummy"
"201656",0,0,0,0,"dummy"
"201657",0,0,2,2,"dummy"
"201658",0,0,2,2,"dummy"
"201659",1,0,0,1,"dummy"
"201660",0,0,2,2,"dummy"
"201665",0,0,0,0,"dummy"
"201684",3,1,0,4,"dummy"
"201685",2,0,0,2,"dummy"
"201686",0,1,0,1,"dummy"
"201689",1,1,0,2,"dummy"
"201690",0,0,1,1,"dummy"
"201691",0,0,1,1,"dummy"
"201692",0,0,1,1,"dummy"
"201700",0,0,1,1,"dummy"
"201737",0,0,1,1,"dummy"
"201738",0,0,1,1,"dummy"
"201739",0,0,3,3,"dummy"
"201740",0,0,1,1,"dummy"
"201741",0,0,2,2,"dummy"
"201742",1,3,1,5,"dummy"
"201743",2,1,0,3,"dummy"
"201753",2,0,0,2,"dummy"
"201756",6,0,0,6,"dummy"
"201757",2,5,2,9,"dummy"
"201760",0,0,0,0,"dummy"
"201761",0,0,0,0,"dummy"
"201762",0,0,0,0,"dummy"
"201763",0,0,0,0,"dummy"
"201772",3,5,2,10,"dummy"
"201773",13,5,3,21,"dummy"
"201779",0,0,3,3,"dummy"
"201780",0,0,1,1,"dummy"
"201781",0,0,1,1,"dummy"
"201782",9,6,3,18,"dummy"
"201791",0,0,1,1,"dummy"
"201792",5,5,4,14,"dummy"
"201798",0,1,1,2,"dummy"
"201799",2,2,1,5,"dummy"
"201802",0,1,0,1,"dummy"
"201803",0,1,0,1,"dummy"
"201804",0,4,0,4,"dummy"
"201805",0,1,0,1,"dummy"
"201806",1,0,0,1,"dummy"
"201807",0,1,0,1,"dummy"
"201812",1,0,0,1,"dummy"
"201813",0,1,0,1,"dummy"
"201814",0,2,2,4,"dummy"
"201815",0,0,1,1,"dummy"
"201820",0,1,0,1,"dummy"
"201821",2,1,0,3,"dummy"
"201822",0,0,1,1,"dummy"
"201834",0,2,0,2,"dummy"
"201835",1,2,1,4,"dummy"
"201842",0,0,3,3,"dummy"
"201899",2,0,4,6,"dummy"
"201900",0,2,0,2,"dummy"
"201904",0,3,0,3,"dummy"
"201905",0,3,0,3,"dummy"
"201906",0,0,1,1,"dummy"
"201907",0,1,0,1,"dummy"
"201908",0,0,0,0,"dummy"
"201909",1,0,0,1,"dummy"
"201910",0,1,0,1,"dummy"
"201911",0,1,0,1,"dummy"
"201912",1,0,1,2,"dummy"
"201913",2,0,1,3,"dummy"
"201914",0,0,1,1,"dummy"
"201921",0,0,0,0,"dummy"
"201952",0,3,1,4,"dummy"
"201953",0,1,0,1,"dummy"
"201960",0,0,1,1,"dummy"
"201963",0,0,1,1,"dummy"
"201964",11,7,2,20,"dummy"
"201971",1,1,1,3,"dummy"
"201945",0,1,1,2,"dummy"
"201946",1,4,1,6,"dummy"
"201947",0,0,1,1,"dummy"
"201948",5,15,1,21,"dummy"
"201949",0,2,0,2,"dummy"
"201950",0,0,1,1,"dummy"
"201955",4,0,0,4,"dummy"
"201958",2,1,0,3,"dummy"
"201966",0,0,1,1,"dummy"
"201967",0,3,0,3,"dummy"
"201968",0,0,1,1,"dummy"
"201969",0,0,2,2,"dummy"
"201977",0,3,0,3,"dummy"
"201978",3,2,1,6,"dummy"
"201979",0,1,0,1,"dummy"
"201980",0,3,0,3,"dummy"
"201981",0,2,1,3,"dummy"
"201984",0,1,1,2,"dummy"
"201986",0,0,2,2,"dummy"
"201987",0,1,0,1,"dummy"
"201988",0,0,2,2,"dummy"
"201989",0,0,2,2,"dummy"
"201991",0,2,0,2,"dummy"
"201992",1,1,1,3,"dummy"
"201994",0,5,0,5,"dummy"
"201995",4,2,4,10,"dummy"
"201997",2,5,2,9,"dummy"
"202000",0,1,2,3,"dummy"
"202001",0,0,0,0,"dummy"
"202002",0,1,0,1,"dummy"
"202003",4,0,2,6,"dummy"
"202004",1,0,0,1,"dummy"
"202005",0,0,0,0,"dummy"
"202007",0,0,0,0,"dummy"
"202008",5,0,2,7,"dummy"
"202009",0,0,0,0,"dummy"
"202012",0,0,2,2,"dummy"
"202017",0,1,0,1,"dummy"
"202018",0,0,0,0,"dummy"
"202022",0,1,0,1,"dummy"
"202023",0,4,0,4,"dummy"
"202024",1,0,0,1,"dummy"
"202025",2,2,1,5,"dummy"
"202026",4,0,0,4,"dummy"
"202027",0,2,0,2,"dummy"
"202028",2,0,0,2,"dummy"
"202029",0,1,0,1,"dummy"
"202047",0,2,0,2,"dummy"
"202049",1,2,2,5,"dummy"
"202050",0,1,0,1,"dummy"
"202054",1,2,0,3,"dummy"
"202055",0,0,0,0,"dummy"
"202056",1,4,3,8,"dummy"
"202057",0,1,0,1,"dummy"
"202060",0,0,1,1,"dummy"
"202061",0,0,1,1,"dummy"
"202062",0,0,2,2,"dummy"
"202063",26,3,7,36,"dummy"
"202071",10,4,1,15,"dummy"
"202072",0,1,3,4,"dummy"
"202073",1,1,0,2,"dummy"
"202074",0,12,0,12,"dummy"
"202075",2,2,2,6,"dummy"
"202076",0,0,2,2,"dummy"
"202078",8,0,1,9,"dummy"
"202079",0,0,1,1,"dummy"
"202081",0,0,1,1,"dummy"
"202103",0,0,0,0,"dummy"
"202107",0,1,0,1,"dummy"
"202108",0,0,1,1,"dummy"
"202142",1,4,0,5,"dummy"
"202143",1,3,1,5,"dummy"
"202144",3,2,1,6,"dummy"
"202145",1,0,0,1,"dummy"
"202146",0,0,0,0,"dummy"
"202152",0,0,1,1,"dummy"
"202153",0,1,1,2,"dummy"
"202154",0,1,0,1,"dummy"
"202155",0,2,1,3,"dummy"
"202156",1,2,0,3,"dummy"
"202157",0,3,1,4,"dummy"
"202158",2,0,0,2,"dummy"
"202159",0,1,1,2,"dummy"
"202160",1,0,0,1,"dummy"
"202161",0,0,1,1,"dummy"
"202162",7,5,1,13,"dummy"
"202163",0,1,0,1,"dummy"
"202164",0,2,0,2,"dummy"
"202165",0,2,1,3,"dummy"
"202166",17,14,3,34,"dummy"
"202167",1,0,0,1,"dummy"
"202169",0,5,0,5,"dummy"
"202170",2,2,0,4,"dummy"
"202171",0,1,0,1,"dummy"
"202172",1,0,0,1,"dummy"
"202173",0,1,1,2,"dummy"
"202174",0,3,0,3,"dummy"
"202175",0,10,0,10,"dummy"
"202176",0,0,1,1,"dummy"
"202177",2,2,3,7,"dummy"
"202178",0,2,0,2,"dummy"
"202179",0,0,0,0,"dummy"
"202180",0,1,0,1,"dummy"
"202181",2,3,1,6,"dummy"
"202182",1,1,0,2,"dummy"
"202183",0,0,1,1,"dummy"
"202184",0,2,0,2,"dummy"
"202185",1,5,0,6,"dummy"
"202186",5,0,0,5,"dummy"
"202187",0,2,0,2,"dummy"
"202188",3,0,0,3,"dummy"
"202189",0,1,0,1,"dummy"
"202190",0,0,2,2,"dummy"
"202191",5,1,0,6,"dummy"
"202192",0,0,2,2,"dummy"
"202193",0,0,1,1,"dummy"
"202194",1,4,0,5,"dummy"
"202195",1,0,0,1,"dummy"
"202196",0,0,0,0,"dummy"
"202197",0,2,0,2,"dummy"
"202198",0,1,0,1,"dummy"
"202199",0,0,2,2,"dummy"
"202201",0,0,6,6,"dummy"
"202205",0,1,1,2,"dummy"
"202206",1,8,2,11,"dummy"
"202207",0,0,0,0,"dummy"
"202209",0,1,0,1,"dummy"
"202211",1,5,1,7,"dummy"
"202213",0,0,1,1,"dummy"
"202216",0,0,1,1,"dummy"
"202217",0,2,0,2,"dummy"
"202218",1,1,5,7,"dummy"
"202219",1,0,5,6,"dummy"
"202221",11,1,1,13,"dummy"
"202223",24,10,2,36,"dummy"
"202224",0,0,0,0,"dummy"
"202225",0,0,1,1,"dummy"
"202226",0,0,1,1,"dummy"
"202228",0,1,1,2,"dummy"
"202243",0,1,1,2,"dummy"
"202244",1,7,0,8,"dummy"
"202247",0,1,0,1,"dummy"
"202248",0,0,1,1,"dummy"
"202249",0,0,1,1,"dummy"
"202250",0,0,1,1,"dummy"
"202251",0,0,0,0,"dummy"
"202252",0,0,1,1,"dummy"
"202255",4,2,3,9,"dummy"
"202259",0,0,1,1,"dummy"
"202272",0,0,1,1,"dummy"
"202275",0,1,0,1,"dummy"
"202278",0,1,0,1,"dummy"
"202280",0,0,1,1,"dummy"
"202281",0,2,0,2,"dummy"
"202284",0,0,0,0,"dummy"
"202287",0,0,2,2,"dummy"
"202288",3,1,2,6,"dummy"
"202289",0,1,1,2,"dummy"
"202290",1,0,0,1,"dummy"
"202291",0,0,1,1,"dummy"
"202292",0,0,2,2,"dummy"
"202294",1,3,1,5,"dummy"
"202295",6,6,2,14,"dummy"
"202296",0,2,0,2,"dummy"
"202297",0,1,0,1,"dummy"
"202298",2,0,0,2,"dummy"
"202299",0,0,1,1,"dummy"
"202300",0,0,1,1,"dummy"
"202303",0,29,0,29,"dummy"
"202304",0,1,0,1,"dummy"
"202305",1,2,0,3,"dummy"
"202306",1,3,2,6,"dummy"
"202307",0,3,0,3,"dummy"
"202308",1,2,0,3,"dummy"
"202309",1,2,0,3,"dummy"
"202310",3,4,2,9,"dummy"
"202311",0,2,0,2,"dummy"
"202312",2,2,0,4,"dummy"
"202313",0,0,2,2,"dummy"
"202316",0,1,0,1,"dummy"
"202317",0,0,0,0,"dummy"
"202319",0,0,0,0,"dummy"
"202320",0,0,0,0,"dummy"
"202324",2,15,1,18,"dummy"
"202325",4,4,1,9,"dummy"
"202326",0,1,0,1,"dummy"
"202327",0,0,2,2,"dummy"
"202328",2,0,2,4,"dummy"
"202329",0,0,1,1,"dummy"
"202330",0,0,1,1,"dummy"
"202331",1,4,0,5,"dummy"
"202333",0,1,0,1,"dummy"
"202334",2,3,5,10,"dummy"
"202335",0,0,1,1,"dummy"
"202338",0,3,0,3,"dummy"
"202339",0,0,2,2,"dummy"
"202341",0,14,0,14,"dummy"
"202343",0,0,0,0,"dummy"
"202344",0,0,2,2,"dummy"
"202345",0,0,0,0,"dummy"
"202346",0,0,1,1,"dummy"
"202347",0,0,0,0,"dummy"
"202348",2,0,1,3,"dummy"
"202349",2,0,0,2,"dummy"
"202358",0,0,2,2,"dummy"
"202359",0,0,1,1,"dummy"
"202362",0,1,0,1,"dummy"
"202363",0,1,0,1,"dummy"
"202364",0,1,0,1,"dummy"
"202365",0,0,0,0,"dummy"
"202366",0,0,0,0,"dummy"
"202367",0,1,0,1,"dummy"
"202368",0,0,0,0,"dummy"
"202369",0,2,4,6,"dummy"
"202370",0,1,0,1,"dummy"
"202371",0,0,2,2,"dummy"
"202373",0,0,1,1,"dummy"
"202385",6,2,1,9,"dummy"
"202387",0,0,0,0,"dummy"
"202391",0,2,0,2,"dummy"
"202392",0,0,1,1,"dummy"
"202394",0,3,3,6,"dummy"
"202395",0,3,2,5,"dummy"
"202396",0,1,0,1,"dummy"
"202397",0,0,1,1,"dummy"
"202398",0,0,1,1,"dummy"
"202399",2,1,1,4,"dummy"
"202401",1,0,0,1,"dummy"
"202402",1,2,0,3,"dummy"
"202403",5,2,2,9,"dummy"
"202404",0,3,0,3,"dummy"
"202405",0,1,0,1,"dummy"
"202406",0,0,1,1,"dummy"
"202407",0,0,1,1,"dummy"
"202408",0,1,0,1,"dummy"
"202409",0,0,1,1,"dummy"
"202410",2,1,1,4,"dummy"
"202411",0,1,0,1,"dummy"
"202412",2,0,0,2,"dummy"
"202414",0,2,0,2,"dummy"
"202417",0,0,1,1,"dummy"
"202418",0,3,1,4,"dummy"
"202427",17,1,0,18,"dummy"
"202428",0,0,2,2,"dummy"
"202429",0,0,1,1,"dummy"
"202432",5,8,6,19,"dummy"
"202462",0,4,2,6,"dummy"
"202465",1,3,0,4,"dummy"
"202471",0,0,1,1,"dummy"
"202472",0,1,0,1,"dummy"
"202473",1,4,0,5,"dummy"
"202474",1,2,0,3,"dummy"
"202476",1,9,2,12,"dummy"
"202477",1,2,0,3,"dummy"
"202478",0,1,0,1,"dummy"
"202479",0,0,1,1,"dummy"
"202480",0,0,1,1,"dummy"
"202483",1,1,0,2,"dummy"
"202484",0,2,0,2,"dummy"
"202486",0,0,1,1,"dummy"
"202487",0,0,1,1,"dummy"
"202488",0,0,1,1,"dummy"
"202490",0,1,2,3,"dummy"
"202494",0,3,0,3,"dummy"
"202495",1,1,0,2,"dummy"
"202499",0,2,0,2,"dummy"
"202500",0,2,0,2,"dummy"
"202501",0,1,0,1,"dummy"
"202502",2,0,0,2,"dummy"
"202503",6,19,5,30,"dummy"
"202504",0,0,4,4,"dummy"
"202505",0,0,4,4,"dummy"
"202506",0,2,0,2,"dummy"
"202507",0,0,4,4,"dummy"
"202508",0,0,4,4,"dummy"
"202509",0,0,4,4,"dummy"
"202510",0,0,4,4,"dummy"
"202511",0,0,1,1,"dummy"
"202512",0,0,4,4,"dummy"
"202513",0,0,4,4,"dummy"
"202514",6,7,0,13,"dummy"
"202515",7,6,0,13,"dummy"
"202516",0,0,4,4,"dummy"
"202517",0,0,4,4,"dummy"
"202518",0,0,4,4,"dummy"
"202519",0,0,1,1,"dummy"
"202520",0,0,4,4,"dummy"
"202521",4,2,0,6,"dummy"
"202522",0,0,2,2,"dummy"
"202523",0,0,1,1,"dummy"
"202526",1,2,0,3,"dummy"
"202528",0,3,0,3,"dummy"
"202530",0,11,0,11,"dummy"
"202577",0,0,0,0,"dummy"
"202591",1,1,0,2,"dummy"
"202592",0,0,1,1,"dummy"
"202593",0,2,0,2,"dummy"
"202598",0,0,3,3,"dummy"
"202599",0,1,0,1,"dummy"
"202604",0,0,1,1,"dummy"
"202605",0,0,1,1,"dummy"
"202606",0,0,1,1,"dummy"
"202608",1,1,0,2,"dummy"
"202612",0,0,1,1,"dummy"
"202613",0,0,2,2,"dummy"
"202614",0,0,1,1,"dummy"
"202626",0,6,0,6,"dummy"
"202627",0,0,1,1,"dummy"
"202637",2,1,0,3,"dummy"
"202638",0,0,1,1,"dummy"
"202639",0,0,1,1,"dummy"
"202640",0,1,0,1,"dummy"
"202641",0,0,1,1,"dummy"
"202642",13,2,0,15,"dummy"
"202643",0,0,0,0,"dummy"
"202644",0,0,0,0,"dummy"
"202645",0,0,0,0,"dummy"
"202646",0,0,0,0,"dummy"
"202647",0,0,0,0,"dummy"
"202648",0,0,0,0,"dummy"
"202649",0,0,0,0,"dummy"
"202659",0,1,2,3,"dummy"
"202660",2,7,0,9,"dummy"
"202661",0,0,1,1,"dummy"
"202662",0,2,0,2,"dummy"
"202663",0,0,0,0,"dummy"
"202737",0,11,0,11,"dummy"
"202738",1,0,0,1,"dummy"
"202779",0,0,1,1,"dummy"
"202801",0,2,1,3,"dummy"
"202802",0,1,0,1,"dummy"
"202803",0,0,1,1,"dummy"
"202804",5,5,0,10,"dummy"
"202805",2,2,0,4,"dummy"
"202810",2,0,2,4,"dummy"
"202828",0,0,1,1,"dummy"
"202829",0,0,2,2,"dummy"
"202846",0,0,1,1,"dummy"
"202847",0,0,0,0,"dummy"
"202851",1,0,2,3,"dummy"
"202856",4,5,1,10,"dummy"
"202861",0,0,1,1,"dummy"
"202864",0,1,0,1,"dummy"
"202865",2,0,0,2,"dummy"
"202866",3,3,0,6,"dummy"
"202867",0,3,1,4,"dummy"
"202868",0,1,0,1,"dummy"
"202869",0,1,0,1,"dummy"
"202870",0,2,0,2,"dummy"
"202871",0,8,2,10,"dummy"
"202872",2,0,0,2,"dummy"
"202873",1,0,0,1,"dummy"
"202911",0,0,1,1,"dummy"
"202928",1,2,0,3,"dummy"
"202929",0,12,0,12,"dummy"
"202932",15,4,2,21,"dummy"
"202933",1,2,0,3,"dummy"
"202938",5,4,0,9,"dummy"
"202939",2,4,1,7,"dummy"
"202940",0,0,1,1,"dummy"
"202941",1,0,0,1,"dummy"
"202942",1,1,1,3,"dummy"
"202943",7,12,2,21,"dummy"
"202944",9,8,1,18,"dummy"
"202945",0,1,1,2,"dummy"
"202946",0,1,0,1,"dummy"
"202610",4,6,2,12,"dummy"
"202618",0,0,1,1,"dummy"
"202621",0,1,0,1,"dummy"
"202622",0,0,6,6,"dummy"
"202629",0,0,1,1,"dummy"
"202630",0,0,1,1,"dummy"
"202631",0,0,1,1,"dummy"
"202632",0,0,1,1,"dummy"
"202633",0,0,1,1,"dummy"
"202634",0,0,1,1,"dummy"
"202635",0,0,1,1,"dummy"
"202653",0,7,0,7,"dummy"
"202654",0,8,0,8,"dummy"
"202655",8,0,2,10,"dummy"
"202656",0,4,0,4,"dummy"
"202657",0,8,0,8,"dummy"
"202721",9,29,2,40,"dummy"
"202722",0,13,0,13,"dummy"
"202723",0,1,7,8,"dummy"
"202726",0,0,0,0,"dummy"
"202727",1,0,0,1,"dummy"
"202728",1,0,0,1,"dummy"
"202729",2,5,1,8,"dummy"
"202730",4,4,1,9,"dummy"
"202731",1,6,1,8,"dummy"
"202732",5,0,1,6,"dummy"
"202746",0,0,0,0,"dummy"
"202754",0,1,0,1,"dummy"
"202755",0,0,1,1,"dummy"
"202756",0,2,0,2,"dummy"
"202757",0,1,0,1,"dummy"
"202760",2,0,3,5,"dummy"
"202763",0,0,1,1,"dummy"
"202764",0,0,1,1,"dummy"
"202765",0,0,1,1,"dummy"
"202774",0,4,0,4,"dummy"
"202775",3,0,0,3,"dummy"
"202776",1,0,0,1,"dummy"
"202777",5,0,0,5,"dummy"
"202781",1,0,1,2,"dummy"
"202782",0,1,0,1,"dummy"
"202783",0,0,2,2,"dummy"
"202786",0,1,0,1,"dummy"
"202787",0,1,0,1,"dummy"
"202788",0,3,1,4,"dummy"
"202789",0,0,0,0,"dummy"
"202790",2,0,0,2,"dummy"
"202791",0,0,0,0,"dummy"
"202792",1,0,2,3,"dummy"
"202793",0,0,1,1,"dummy"
"202794",2,1,0,3,"dummy"
"202795",0,0,0,0,"dummy"
"202796",2,3,1,6,"dummy"
"202799",3,2,0,5,"dummy"
"202835",0,2,2,4,"dummy"
"202840",0,0,1,1,"dummy"
"202841",0,0,1,1,"dummy"
"202842",0,0,2,2,"dummy"
"202843",0,0,2,2,"dummy"
"202844",0,2,2,4,"dummy"
"202849",0,0,1,1,"dummy"
"202877",0,0,0,0,"dummy"
"202878",0,0,0,0,"dummy"
"202879",1,0,0,1,"dummy"
"202880",0,0,0,0,"dummy"
"202881",0,0,0,0,"dummy"
"202882",0,13,0,13,"dummy"
"202883",4,4,0,8,"dummy"
"202884",0,0,4,4,"dummy"
"202885",0,1,4,5,"dummy"
"202886",0,0,1,1,"dummy"
"202887",0,0,0,0,"dummy"
"202888",4,4,1,9,"dummy"
"202889",7,4,0,11,"dummy"
"202890",8,11,0,19,"dummy"
"202891",0,4,1,5,"dummy"
"202892",0,0,0,0,"dummy"
"202893",11,4,1,16,"dummy"
"202894",4,7,1,12,"dummy"
"202895",0,0,2,2,"dummy"
"202896",0,0,1,1,"dummy"
"202897",4,1,0,5,"dummy"
"202898",9,11,5,25,"dummy"
"202899",0,0,1,1,"dummy"
"202900",0,2,0,2,"dummy"
"202901",2,0,0,2,"dummy"
"202902",0,1,1,2,"dummy"
"202903",0,0,1,1,"dummy"
"202904",0,1,3,4,"dummy"
"202905",1,0,2,3,"dummy"
"202906",0,3,0,3,"dummy"
"202907",0,2,0,2,"dummy"
"202908",0,0,1,1,"dummy"
"202909",0,0,0,0,"dummy"
"202913",0,1,0,1,"dummy"
"202914",0,0,1,1,"dummy"
"202915",6,3,1,10,"dummy"
"202916",0,0,1,1,"dummy"
"202917",0,1,0,1,"dummy"
"202918",0,0,0,0,"dummy"
"202919",0,1,0,1,"dummy"
"202922",1,6,0,7,"dummy"
"202923",1,7,0,8,"dummy"
"202924",0,1,0,1,"dummy"
"202925",5,7,0,12,"dummy"
"202926",3,5,0,8,"dummy"
"202950",0,3,1,4,"dummy"
"202951",0,1,0,1,"dummy"
"202952",0,2,0,2,"dummy"
"202953",0,3,0,3,"dummy"
"202954",1,1,0,2,"dummy"
"202955",0,0,1,1,"dummy"
"202956",0,0,1,1,"dummy"
"202961",0,0,1,1,"dummy"
"202962",0,0,1,1,"dummy"
"202963",0,0,1,1,"dummy"
"202964",0,0,1,1,"dummy"
"202976",0,0,2,2,"dummy"
"202986",0,0,1,1,"dummy"
"202995",2,2,0,4,"dummy"
"202996",0,1,0,1,"dummy"
"202997",6,17,3,26,"dummy"
"202998",0,1,1,2,"dummy"
"202999",0,0,0,0,"dummy"
"203000",0,0,1,1,"dummy"
"203006",0,0,1,1,"dummy"
"203007",0,0,2,2,"dummy"
"203010",0,0,1,1,"dummy"
"203015",0,0,0,0,"dummy"
"203016",0,1,0,1,"dummy"
"203026",0,5,0,5,"dummy"
"203027",1,1,1,3,"dummy"
"203028",0,4,0,4,"dummy"
"203029",1,0,0,1,"dummy"
"203030",1,2,1,4,"dummy"
"203031",0,0,0,0,"dummy"
"203032",0,1,0,1,"dummy"
"203033",2,1,0,3,"dummy"
"203034",0,1,0,1,"dummy"
"203035",0,1,0,1,"dummy"
"203036",1,0,0,1,"dummy"
"203037",5,5,0,10,"dummy"
"203038",0,1,4,5,"dummy"
"203039",0,1,0,1,"dummy"
"203040",0,1,5,6,"dummy"
"203041",1,0,0,1,"dummy"
"203042",0,1,0,1,"dummy"
"203043",0,1,0,1,"dummy"
"203047",6,1,0,7,"dummy"
"203048",0,0,0,0,"dummy"
"203049",0,0,1,1,"dummy"
"203050",0,3,0,3,"dummy"
"203054",0,3,1,4,"dummy"
"203055",1,1,0,2,"dummy"
"203056",0,1,0,1,"dummy"
"203061",0,0,1,1,"dummy"
"202958",2,0,0,2,"dummy"
"202959",0,0,0,0,"dummy"
"202980",0,0,0,0,"dummy"
"202981",5,5,1,11,"dummy"
"202982",0,0,0,0,"dummy"
"203002",1,1,0,2,"dummy"
"203003",0,1,0,1,"dummy"
"203004",1,0,0,1,"dummy"
"203018",0,1,1,2,"dummy"
"203024",0,0,1,1,"dummy"
"203045",2,0,3,5,"dummy"
"203052",0,7,0,7,"dummy"
"203058",0,0,1,1,"dummy"
"203059",0,1,0,1,"dummy"
"203065",0,5,0,5,"dummy"
"203066",1,0,1,2,"dummy"
"203067",0,1,1,2,"dummy"
"203071",0,0,0,0,"dummy"
"203072",0,1,2,3,"dummy"
"203101",0,2,3,5,"dummy"
"203109",2,14,7,23,"dummy"
"203110",6,0,1,7,"dummy"
"203113",20,2,2,24,"dummy"
"203114",0,1,0,1,"dummy"
"203115",0,4,0,4,"dummy"
"203116",0,4,0,4,"dummy"
"203117",0,1,0,1,"dummy"
"203118",3,1,0,4,"dummy"
"203069",0,0,2,2,"dummy"
"203080",0,0,1,1,"dummy"
"203085",35,3,0,38,"dummy"
"203086",0,31,0,31,"dummy"
"203087",0,1,0,1,"dummy"
"203088",0,0,1,1,"dummy"
"203089",0,0,1,1,"dummy"
"203090",0,1,0,1,"dummy"
"203091",0,0,1,1,"dummy"
"203092",0,1,0,1,"dummy"
"203093",0,0,1,1,"dummy"
"203094",1,0,0,1,"dummy"
"203095",0,0,1,1,"dummy"
"203096",0,1,1,2,"dummy"
"203097",2,2,0,4,"dummy"
"203103",14,18,1,33,"dummy"
"203104",0,0,1,1,"dummy"
"203105",6,0,1,7,"dummy"
"203106",1,1,0,2,"dummy"
"203107",0,4,3,7,"dummy"
"203126",0,5,0,5,"dummy"
"203129",0,1,0,1,"dummy"
"203130",3,0,1,4,"dummy"
"203131",0,0,1,1,"dummy"
"203132",0,1,1,2,"dummy"
"203133",0,1,0,1,"dummy"
"203135",0,0,1,1,"dummy"
"203136",1,0,0,1,"dummy"
"203138",5,0,1,6,"dummy"
"203139",0,2,1,3,"dummy"
"203143",14,18,1,33,"dummy"
"203144",0,0,1,1,"dummy"
"203145",6,0,1,7,"dummy"
"203146",1,1,0,2,"dummy"
"203147",0,4,3,7,"dummy"
"203151",0,7,0,7,"dummy"
"203152",0,5,0,5,"dummy"
"203153",20,3,1,24,"dummy"
"203154",0,0,2,2,"dummy"
"203158",0,28,0,28,"dummy"
"203160",5,5,0,10,"dummy"
"203167",0,2,0,2,"dummy"
"203171",6,0,1,7,"dummy"
"203172",0,1,0,1,"dummy"
"203173",3,9,3,15,"dummy"
"203175",0,0,1,1,"dummy"
"203178",0,2,0,2,"dummy"
"203179",0,0,0,0,"dummy"
"203180",0,1,0,1,"dummy"
"203181",4,4,1,9,"dummy"
"203182",4,5,1,10,"dummy"
"203183",0,0,0,0,"dummy"
"203185",0,6,0,6,"dummy"
"203187",0,0,2,2,"dummy"
"203188",1,1,0,2,"dummy"
"203190",3,3,1,7,"dummy"
"203191",0,3,0,3,"dummy"
"203192",0,1,0,1,"dummy"
"203193",0,1,0,1,"dummy"
"203194",2,0,1,3,"dummy"
"203195",11,18,3,32,"dummy"
"203196",1,6,1,8,"dummy"
"203198",0,0,1,1,"dummy"
"203199",1,0,0,1,"dummy"
"203214",0,0,1,1,"dummy"
"203215",0,0,2,2,"dummy"
"203216",0,0,1,1,"dummy"
"203217",0,0,1,1,"dummy"
"203219",1,0,1,2,"dummy"
"203221",0,2,0,2,"dummy"
"203226",0,0,2,2,"dummy"
"203229",0,0,3,3,"dummy"
"203233",0,1,0,1,"dummy"
"203234",0,0,0,0,"dummy"
"203235",0,0,0,0,"dummy"
"203239",0,1,0,1,"dummy"
"203240",0,2,0,2,"dummy"
"203243",0,3,0,3,"dummy"
"203247",0,1,0,1,"dummy"
"203248",2,2,0,4,"dummy"
"203249",0,0,3,3,"dummy"
"203251",8,5,0,13,"dummy"
"203254",0,1,0,1,"dummy"
"203258",1,0,0,1,"dummy"
"203261",0,0,1,1,"dummy"
"203262",0,0,1,1,"dummy"
"203264",0,7,0,7,"dummy"
"203265",5,0,0,5,"dummy"
"203266",1,13,0,14,"dummy"
"203267",13,5,0,18,"dummy"
"203268",1,13,0,14,"dummy"
"203269",0,0,1,1,"dummy"
"203270",3,1,0,4,"dummy"
"203271",0,0,0,0,"dummy"
"203272",0,0,0,0,"dummy"
"203273",0,0,0,0,"dummy"
"203274",0,0,1,1,"dummy"
"203275",13,15,0,28,"dummy"
"203276",0,0,2,2,"dummy"
"203277",0,0,1,1,"dummy"
"203278",0,0,1,1,"dummy"
"203279",0,0,1,1,"dummy"
"203280",0,0,3,3,"dummy"
"203281",0,0,1,1,"dummy"
"203282",5,3,0,8,"dummy"
"203283",1,3,0,4,"dummy"
"203284",0,1,0,1,"dummy"
"203285",5,1,0,6,"dummy"
"203286",0,0,2,2,"dummy"
"203287",0,0,1,1,"dummy"
"203288",0,0,0,0,"dummy"
"203289",0,0,0,0,"dummy"
"203290",0,0,0,0,"dummy"
"203291",0,0,0,0,"dummy"
"203292",0,0,0,0,"dummy"
"203293",1,5,1,7,"dummy"
"203296",0,0,5,5,"dummy"
"203299",0,8,0,8,"dummy"
"203300",0,5,0,5,"dummy"
"203303",0,5,0,5,"dummy"
"203304",0,0,3,3,"dummy"
"203308",1,2,0,3,"dummy"
"203309",0,0,1,1,"dummy"
"203310",2,0,0,2,"dummy"
"203311",0,0,0,0,"dummy"
"203312",0,2,0,2,"dummy"
"203313",0,1,0,1,"dummy"
"203314",0,1,0,1,"dummy"
"203315",1,1,1,3,"dummy"
"203316",1,1,1,3,"dummy"
"203317",0,1,2,3,"dummy"
"203318",0,0,0,0,"dummy"
"203321",0,1,0,1,"dummy"
"203322",0,0,0,0,"dummy"
"203323",0,0,1,1,"dummy"
"203324",0,2,0,2,"dummy"
"203325",4,2,0,6,"dummy"
"203326",0,2,0,2,"dummy"
"203327",2,2,0,4,"dummy"
"203328",0,0,2,2,"dummy"
"203329",2,0,0,2,"dummy"
"203330",0,2,0,2,"dummy"
"203331",0,11,4,15,"dummy"
"203332",9,0,0,9,"dummy"
"203333",0,4,0,4,"dummy"
"203334",0,0,1,1,"dummy"
"203335",0,0,2,2,"dummy"
"203336",2,0,0,2,"dummy"
"203337",0,1,0,1,"dummy"
"203338",0,4,0,4,"dummy"
"203339",0,2,0,2,"dummy"
"203341",0,0,1,1,"dummy"
"203342",1,2,0,3,"dummy"
"203343",0,3,0,3,"dummy"
"203347",0,2,0,2,"dummy"
"203348",2,2,0,4,"dummy"
"203349",0,1,0,1,"dummy"
"203350",0,1,0,1,"dummy"
"203351",1,1,0,2,"dummy"
"203352",4,13,1,18,"dummy"
"203353",10,24,6,40,"dummy"
"203356",0,1,0,1,"dummy"
"203357",6,15,0,21,"dummy"
"203358",4,2,2,8,"dummy"
"203359",4,1,0,5,"dummy"
"203360",0,0,1,1,"dummy"
"203365",0,7,0,7,"dummy"
"203366",0,0,0,0,"dummy"
"203367",0,0,0,0,"dummy"
"203369",0,1,5,6,"dummy"
"203371",0,1,0,1,"dummy"
"203372",3,0,0,3,"dummy"
"203373",0,2,1,3,"dummy"
"203374",0,0,0,0,"dummy"
"203378",0,3,2,5,"dummy"
"203379",5,1,0,6,"dummy"
"203380",2,2,1,5,"dummy"
"203381",2,0,0,2,"dummy"
"203389",0,1,0,1,"dummy"
"203388",0,1,0,1,"dummy"
"203387",0,0,1,1,"dummy"
"203386",1,0,0,1,"dummy"
"203392",10,4,0,14,"dummy"
"203394",2,1,1,4,"dummy"
"203395",2,3,0,5,"dummy"
"203396",0,0,1,1,"dummy"
"203399",14,14,4,32,"dummy"
"203400",15,15,6,36,"dummy"
"203401",14,14,4,32,"dummy"
"203402",32,4,5,41,"dummy"
"203403",0,0,4,4,"dummy"
"203404",2,37,3,42,"dummy"
"203405",32,4,3,39,"dummy"
"203406",0,0,1,1,"dummy"
"203407",0,2,4,6,"dummy"
"203408",0,0,6,6,"dummy"
"203409",0,0,1,1,"dummy"
"203410",1,3,5,9,"dummy"
"203411",0,0,6,6,"dummy"
"203412",0,0,1,1,"dummy"
"203413",0,0,7,7,"dummy"
"203414",0,0,6,6,"dummy"
"203415",0,0,1,1,"dummy"
"203416",4,6,5,15,"dummy"
"203417",0,0,6,6,"dummy"
"203418",0,0,1,1,"dummy"
"203419",0,0,6,6,"dummy"
"203420",0,0,1,1,"dummy"
"203421",0,0,1,1,"dummy"
"203422",3,3,6,12,"dummy"
"203423",0,0,6,6,"dummy"
"203424",0,0,6,6,"dummy"
"203425",0,0,1,1,"dummy"
"203428",6,0,0,6,"dummy"
"203429",2,5,2,9,"dummy"
"203432",1,3,0,4,"dummy"
"203433",1,0,0,1,"dummy"
"203434",0,0,0,0,"dummy"
"203435",0,0,1,1,"dummy"
"203436",0,2,0,2,"dummy"
"203437",1,3,2,6,"dummy"
"203438",1,5,0,6,"dummy"
"203441",0,0,1,1,"dummy"
"203442",0,1,0,1,"dummy"
"203445",0,0,1,1,"dummy"
"203448",2,1,2,5,"dummy"
"203449",1,2,1,4,"dummy"
"203450",3,0,2,5,"dummy"
"203457",0,2,0,2,"dummy"
"203458",0,10,2,12,"dummy"
"203459",0,1,0,1,"dummy"
"203460",1,13,0,14,"dummy"
"203465",0,0,1,1,"dummy"
"203466",0,0,1,1,"dummy"
"203467",0,0,1,1,"dummy"
"203468",0,0,1,1,"dummy"
"203471",0,1,0,1,"dummy"
"203472",0,0,1,1,"dummy"
"203473",0,1,0,1,"dummy"
"203474",7,0,0,7,"dummy"
"203475",3,3,0,6,"dummy"
"203476",5,8,2,15,"dummy"
"203477",0,1,0,1,"dummy"
"203478",0,0,1,1,"dummy"
"203479",1,2,1,4,"dummy"
"203480",0,0,2,2,"dummy"
"203481",0,1,1,2,"dummy"
"203482",0,2,0,2,"dummy"
"203500",0,0,0,0,"dummy"
"203501",0,1,0,1,"dummy"
"203511",0,0,0,0,"dummy"
"203512",0,0,0,0,"dummy"
"203513",0,0,0,0,"dummy"
"203514",0,0,0,0,"dummy"
"203549",1,1,1,3,"dummy"
"203550",0,0,2,2,"dummy"
"203551",0,0,1,1,"dummy"
"203552",1,0,2,3,"dummy"
"203556",1,0,0,1,"dummy"
"203557",1,1,0,2,"dummy"
"203583",1,2,1,4,"dummy"
"203584",1,3,0,4,"dummy"
"203585",0,0,0,0,"dummy"
"203586",28,9,4,41,"dummy"
"203591",2,1,1,4,"dummy"
"203594",0,0,1,1,"dummy"
"203595",0,0,1,1,"dummy"
"203598",0,0,1,1,"dummy"
"203599",0,0,3,3,"dummy"
"203604",0,0,2,2,"dummy"
"203605",0,0,1,1,"dummy"
"203606",0,0,1,1,"dummy"
"203607",0,0,1,1,"dummy"
"203608",5,1,1,7,"dummy"
"203609",0,0,1,1,"dummy"
"203610",2,8,1,11,"dummy"
"203611",0,0,1,1,"dummy"
"203612",0,0,1,1,"dummy"
"203613",0,0,1,1,"dummy"
"203614",5,3,4,12,"dummy"
"203615",0,5,0,5,"dummy"
"203616",0,0,1,1,"dummy"
"203617",0,0,1,1,"dummy"
"203618",0,0,1,1,"dummy"
"203619",0,1,1,2,"dummy"
"203620",11,4,11,26,"dummy"
"203621",8,16,4,28,"dummy"
"203629",28,22,7,57,"dummy"
"203630",40,53,5,98,"dummy"
"203631",0,9,1,10,"dummy"
"203452",0,11,0,11,"dummy"
"203453",1,1,0,2,"dummy"
"203462",5,28,2,35,"dummy"
"203463",25,1,0,26,"dummy"
"203493",2,3,0,5,"dummy"
"203496",0,3,2,5,"dummy"
"203507",1,3,0,4,"dummy"
"203508",0,0,1,1,"dummy"
"203509",0,1,0,1,"dummy"
"203554",2,3,1,6,"dummy"
"203559",0,1,1,2,"dummy"
"203560",3,1,6,10,"dummy"
"203563",3,10,0,13,"dummy"
"203564",0,2,1,3,"dummy"
"203565",7,3,0,10,"dummy"
"203566",6,4,1,11,"dummy"
"203575",1,2,0,3,"dummy"
"203576",0,0,1,1,"dummy"
"203577",1,2,0,3,"dummy"
"203578",0,2,0,2,"dummy"
"203579",0,0,1,1,"dummy"
"203580",0,1,0,1,"dummy"
"203581",0,1,0,1,"dummy"
"203588",0,2,0,2,"dummy"
"203589",0,2,1,3,"dummy"
"203645",0,0,2,2,"dummy"
"203646",0,2,0,2,"dummy"
"203647",0,1,0,1,"dummy"
"203668",0,2,0,2,"dummy"
"203671",0,9,0,9,"dummy"
"203674",0,0,1,1,"dummy"
"203675",0,0,1,1,"dummy"
"203676",0,0,1,1,"dummy"
"203677",0,0,1,1,"dummy"
"203680",0,0,1,1,"dummy"
"203685",9,12,1,22,"dummy"
"203686",0,0,1,1,"dummy"
"203687",0,0,1,1,"dummy"
"203690",1,0,0,1,"dummy"
"203691",0,0,1,1,"dummy"
"203692",1,4,0,5,"dummy"
"203632",0,1,0,1,"dummy"
"203633",0,3,2,5,"dummy"
"203634",0,0,0,0,"dummy"
"203637",0,0,1,1,"dummy"
"203642",0,0,1,1,"dummy"
"203643",0,0,1,1,"dummy"
"203649",4,5,2,11,"dummy"
"203650",10,1,7,18,"dummy"
"203651",0,1,0,1,"dummy"
"203652",0,1,0,1,"dummy"
"203653",0,1,0,1,"dummy"
"203654",0,0,1,1,"dummy"
"203655",0,1,1,2,"dummy"
"203656",0,0,1,1,"dummy"
"203657",0,0,1,1,"dummy"
"203658",0,0,1,1,"dummy"
"203659",1,2,0,3,"dummy"
"203660",0,2,1,3,"dummy"
"203661",0,0,3,3,"dummy"
"203662",0,0,1,1,"dummy"
"203663",0,0,1,1,"dummy"
"203664",0,0,1,1,"dummy"
"203665",1,4,0,5,"dummy"
"203666",0,2,2,4,"dummy"
"203709",0,1,3,4,"dummy"
"203710",0,1,0,1,"dummy"
"203711",0,1,3,4,"dummy"
"203712",0,0,0,0,"dummy"
"203713",0,1,1,2,"dummy"
"203738",9,7,1,17,"dummy"
"203742",0,2,0,2,"dummy"
"203743",0,0,1,1,"dummy"
"203744",0,1,0,1,"dummy"
"203745",0,7,0,7,"dummy"
"203746",0,0,2,2,"dummy"
"203747",18,0,0,18,"dummy"
"203766",0,0,1,1,"dummy"
"203782",0,3,0,3,"dummy"
"203783",0,7,1,8,"dummy"
"203784",3,2,0,5,"dummy"
"203802",0,0,2,2,"dummy"
"203829",7,8,14,29,"dummy"
"203850",0,1,0,1,"dummy"
"203859",2,0,1,3,"dummy"
"203877",0,6,2,8,"dummy"
"203893",0,0,3,3,"dummy"
"203897",0,0,1,1,"dummy"
"203903",0,0,0,0,"dummy"
"203904",2,2,0,4,"dummy"
"203905",0,0,2,2,"dummy"
"203906",0,1,0,1,"dummy"
"203907",0,2,1,3,"dummy"
"203706",1,1,0,2,"dummy"
"203707",18,0,5,23,"dummy"
"203715",0,1,0,1,"dummy"
"203716",1,2,0,3,"dummy"
"203717",0,0,2,2,"dummy"
"203718",0,0,2,2,"dummy"
"203719",0,0,2,2,"dummy"
"203720",0,0,2,2,"dummy"
"203725",0,0,1,1,"dummy"
"203726",0,1,0,1,"dummy"
"203733",0,0,0,0,"dummy"
"203734",0,0,0,0,"dummy"
"203740",0,1,0,1,"dummy"
"203749",0,0,1,1,"dummy"
"203750",0,1,0,1,"dummy"
"203761",0,0,0,0,"dummy"
"203762",4,0,2,6,"dummy"
"203763",1,8,4,13,"dummy"
"203764",0,0,5,5,"dummy"
"203786",11,4,1,16,"dummy"
"203787",0,0,1,1,"dummy"
"203819",2,3,0,5,"dummy"
"203831",2,0,0,2,"dummy"
"203832",0,0,2,2,"dummy"
"203837",0,0,4,4,"dummy"
"203838",0,0,4,4,"dummy"
"203839",0,0,4,4,"dummy"
"203840",0,0,0,0,"dummy"
"203846",0,0,1,1,"dummy"
"203847",0,0,1,1,"dummy"
"203848",0,0,1,1,"dummy"
"203852",0,0,0,0,"dummy"
"203879",8,4,0,12,"dummy"
"203895",1,0,0,1,"dummy"
"203899",1,0,5,6,"dummy"
"203900",2,5,15,22,"dummy"
"203901",0,0,1,1,"dummy"
"203910",1,9,0,10,"dummy"
"203911",0,1,0,1,"dummy"
"203912",0,1,0,1,"dummy"
"203913",0,1,0,1,"dummy"
"203914",0,1,0,1,"dummy"
"203915",0,2,0,2,"dummy"
"203916",0,1,0,1,"dummy"
"203917",0,1,0,1,"dummy"
"203918",2,4,0,6,"dummy"
"203919",9,15,0,24,"dummy"
"203920",3,1,1,5,"dummy"
"203921",0,2,0,2,"dummy"
"203922",0,2,0,2,"dummy"
"203923",0,6,0,6,"dummy"
"203924",1,0,0,1,"dummy"
"203925",0,1,0,1,"dummy"
"203926",0,5,0,5,"dummy"
"203927",0,1,0,1,"dummy"
"203928",0,1,0,1,"dummy"
"203929",0,0,1,1,"dummy"
"203930",0,1,0,1,"dummy"
"203931",0,1,0,1,"dummy"
"203932",0,0,1,1,"dummy"
"203933",0,4,0,4,"dummy"
"203908",1,1,0,2,"dummy"
"203942",7,7,3,17,"dummy"
"203943",0,0,0,0,"dummy"
"203944",5,3,1,9,"dummy"
"203945",0,0,1,1,"dummy"
"203946",2,1,0,3,"dummy"
"203947",0,0,4,4,"dummy"
"203948",0,0,5,5,"dummy"
"203949",0,0,1,1,"dummy"
"203950",0,0,1,1,"dummy"
"203951",1,0,4,5,"dummy"
"203952",0,0,4,4,"dummy"
"203953",0,5,0,5,"dummy"
"204004",2,0,3,5,"dummy"
"204005",1,0,0,1,"dummy"
"204006",0,1,0,1,"dummy"
"204007",0,1,1,2,"dummy"
"204064",0,0,1,1,"dummy"
"204065",0,0,1,1,"dummy"
"204066",0,0,1,1,"dummy"
"204067",0,1,1,2,"dummy"
"204068",2,2,0,4,"dummy"
"204069",0,0,1,1,"dummy"
"204070",3,0,0,3,"dummy"
"204075",0,1,0,1,"dummy"
"204076",0,1,0,1,"dummy"
"204077",1,1,0,2,"dummy"
"204085",0,1,0,1,"dummy"
"204086",0,0,0,0,"dummy"
"204091",0,0,1,1,"dummy"
"204092",0,1,0,1,"dummy"
"204098",0,0,1,1,"dummy"
"204126",2,5,2,9,"dummy"
"204151",1,9,6,16,"dummy"
"204152",0,0,2,2,"dummy"
"204153",0,0,1,1,"dummy"
"204154",0,0,1,1,"dummy"
"204155",0,1,0,1,"dummy"
"204156",3,3,4,10,"dummy"
"204157",1,0,1,2,"dummy"
"204192",0,0,1,1,"dummy"
"204193",4,4,0,8,"dummy"
"204196",0,0,1,1,"dummy"
"204202",0,1,0,1,"dummy"
"204203",1,0,0,1,"dummy"
"204204",0,1,0,1,"dummy"
"204209",3,0,1,4,"dummy"
"204210",0,0,0,0,"dummy"
"204211",0,3,1,4,"dummy"
"204212",0,0,0,0,"dummy"
"204281",0,2,0,2,"dummy"
"204282",2,0,0,2,"dummy"
"204283",0,2,0,2,"dummy"
"204284",1,2,0,3,"dummy"
"204296",6,0,0,6,"dummy"
"204297",2,5,2,9,"dummy"
"203934",0,0,1,1,"dummy"
"203935",0,0,1,1,"dummy"
"203936",0,1,0,1,"dummy"
"203957",0,11,1,12,"dummy"
"203962",0,1,0,1,"dummy"
"203963",1,2,0,3,"dummy"
"203964",4,7,0,11,"dummy"
"203965",1,1,0,2,"dummy"
"203966",3,3,0,6,"dummy"
"203967",4,7,1,12,"dummy"
"203968",2,1,1,4,"dummy"
"203969",0,1,1,2,"dummy"
"203970",5,1,0,6,"dummy"
"203971",3,15,0,18,"dummy"
"203972",1,0,0,1,"dummy"
"203973",0,0,0,0,"dummy"
"203999",0,15,2,17,"dummy"
"204000",1,1,1,3,"dummy"
"204001",0,0,2,2,"dummy"
"204002",0,1,0,1,"dummy"
"204009",0,0,1,1,"dummy"
"204010",14,13,3,30,"dummy"
"204011",0,0,1,1,"dummy"
"204012",0,0,1,1,"dummy"
"204013",0,0,1,1,"dummy"
"204014",4,4,1,9,"dummy"
"204015",4,14,1,19,"dummy"
"204016",15,13,3,31,"dummy"
"204017",1,0,2,3,"dummy"
"204018",0,0,1,1,"dummy"
"204019",0,0,1,1,"dummy"
"204020",0,0,1,1,"dummy"
"204021",0,0,1,1,"dummy"
"204022",16,4,1,21,"dummy"
"204023",0,1,0,1,"dummy"
"204024",0,0,0,0,"dummy"
"204025",2,2,0,4,"dummy"
"204026",0,0,1,1,"dummy"
"204027",0,0,1,1,"dummy"
"204028",0,0,1,1,"dummy"
"204029",0,0,2,2,"dummy"
"204030",0,0,1,1,"dummy"
"204031",1,0,0,1,"dummy"
"204032",0,0,1,1,"dummy"
"204033",0,0,1,1,"dummy"
"204034",0,0,1,1,"dummy"
"204035",0,0,1,1,"dummy"
"204036",0,0,1,1,"dummy"
"204037",0,0,1,1,"dummy"
"204038",0,0,1,1,"dummy"
"204039",0,0,1,1,"dummy"
"204040",0,0,1,1,"dummy"
"204041",0,0,1,1,"dummy"
"204042",8,8,2,18,"dummy"
"204043",0,0,1,1,"dummy"
"204044",0,0,1,1,"dummy"
"204045",0,0,1,1,"dummy"
"204072",2,0,0,2,"dummy"
"204073",0,2,0,2,"dummy"
"204079",0,1,0,1,"dummy"
"204080",1,1,0,2,"dummy"
"204081",1,3,0,4,"dummy"
"204082",0,0,4,4,"dummy"
"204083",0,2,0,2,"dummy"
"204088",2,4,0,6,"dummy"
"204089",0,1,0,1,"dummy"
"204094",0,0,2,2,"dummy"
"204113",0,1,0,1,"dummy"
"204114",0,3,0,3,"dummy"
"204121",0,1,0,1,"dummy"
"204122",0,1,0,1,"dummy"
"204123",0,0,1,1,"dummy"
"204124",2,2,1,5,"dummy"
"204134",2,0,0,2,"dummy"
"204137",3,5,3,11,"dummy"
"204138",1,2,0,3,"dummy"
"204139",0,0,3,3,"dummy"
"204146",0,0,1,1,"dummy"
"204147",0,0,1,1,"dummy"
"204148",0,0,1,1,"dummy"
"204149",0,0,1,1,"dummy"
"204159",1,0,1,2,"dummy"
"204166",0,1,3,4,"dummy"
"204171",0,1,0,1,"dummy"
"204172",0,0,1,1,"dummy"
"204173",1,0,0,1,"dummy"
"204176",0,1,0,1,"dummy"
"204177",0,1,0,1,"dummy"
"204178",0,0,1,1,"dummy"
"204179",0,0,1,1,"dummy"
"204180",1,0,0,1,"dummy"
"204181",2,0,0,2,"dummy"
"204182",1,2,0,3,"dummy"
"204183",0,1,0,1,"dummy"
"204184",0,1,0,1,"dummy"
"204185",0,0,1,1,"dummy"
"204186",1,0,0,1,"dummy"
"204187",2,0,0,2,"dummy"
"204188",1,2,1,4,"dummy"
"204198",0,1,0,1,"dummy"
"204199",0,0,0,0,"dummy"
"204200",0,1,0,1,"dummy"
"204214",0,0,0,0,"dummy"
"204215",0,0,0,0,"dummy"
"204216",0,0,0,0,"dummy"
"204217",0,0,0,0,"dummy"
"204218",0,0,0,0,"dummy"
"204219",0,0,0,0,"dummy"
"204220",0,0,1,1,"dummy"
"204221",0,0,0,0,"dummy"
"204222",0,0,0,0,"dummy"
"204223",0,0,0,0,"dummy"
"204224",0,0,1,1,"dummy"
"204225",0,0,0,0,"dummy"
"204226",0,0,0,0,"dummy"
"204227",0,0,0,0,"dummy"
"204228",0,0,0,0,"dummy"
"204229",0,0,0,0,"dummy"
"204232",0,0,1,1,"dummy"
"204233",0,0,1,1,"dummy"
"204234",2,3,0,5,"dummy"
"204235",0,0,1,1,"dummy"
"204286",0,0,2,2,"dummy"
"204287",0,4,0,4,"dummy"
"204288",0,3,0,3,"dummy"
"204289",0,2,0,2,"dummy"
"204290",0,0,1,1,"dummy"
"204291",0,1,1,2,"dummy"
"204292",0,2,0,2,"dummy"
"204293",0,2,0,2,"dummy"
"204294",0,1,0,1,"dummy"
"204299",1,2,0,3,"dummy"
"204300",0,0,1,1,"dummy"
"204301",0,0,1,1,"dummy"
"204302",0,0,1,1,"dummy"
"204303",0,0,1,1,"dummy"
"204315",0,2,0,2,"dummy"
"204319",8,1,0,9,"dummy"
"204332",0,2,0,2,"dummy"
"204335",1,3,0,4,"dummy"
"204336",0,1,0,1,"dummy"
"204337",0,2,0,2,"dummy"
"204338",0,2,0,2,"dummy"
"204339",0,2,3,5,"dummy"
"204340",0,3,0,3,"dummy"
"204341",0,7,0,7,"dummy"
"204342",0,0,1,1,"dummy"
"204345",0,0,0,0,"dummy"
"204346",0,0,0,0,"dummy"
"204347",0,0,0,0,"dummy"
"204363",0,0,0,0,"dummy"
"204364",0,1,0,1,"dummy"
"204365",0,0,1,1,"dummy"
"204366",0,0,0,0,"dummy"
"204367",0,0,0,0,"dummy"
"204368",0,0,0,0,"dummy"
"204371",1,0,0,1,"dummy"
"204307",1,0,0,1,"dummy"
"204310",0,1,0,1,"dummy"
"204311",0,5,0,5,"dummy"
"204312",0,2,0,2,"dummy"
"204313",0,0,1,1,"dummy"
"204317",0,3,0,3,"dummy"
"204321",12,1,0,13,"dummy"
"204322",2,0,2,4,"dummy"
"204325",2,5,4,11,"dummy"
"204328",0,0,1,1,"dummy"
"204329",3,2,6,11,"dummy"
"204330",0,0,0,0,"dummy"
"204349",0,12,0,12,"dummy"
"204350",0,1,0,1,"dummy"
"204351",9,4,1,14,"dummy"
"204352",0,1,2,3,"dummy"
"204353",0,1,2,3,"dummy"
"204358",2,0,0,2,"dummy"
"204359",0,3,1,4,"dummy"
"204360",2,0,0,2,"dummy"
"204361",0,0,5,5,"dummy"
"204409",0,3,0,3,"dummy"
"204410",1,0,1,2,"dummy"
"204412",1,0,0,1,"dummy"
"204414",0,4,0,4,"dummy"
"204416",1,2,1,4,"dummy"
"204417",1,0,2,3,"dummy"
"204418",0,0,0,0,"dummy"
"204425",0,0,0,0,"dummy"
"204426",0,0,0,0,"dummy"
"204428",0,1,0,1,"dummy"
"204442",1,0,0,1,"dummy"
"204444",0,0,0,0,"dummy"
"204445",0,0,1,1,"dummy"
"204449",2,1,1,4,"dummy"
"204450",0,5,0,5,"dummy"
"204451",0,2,0,2,"dummy"
"204453",1,2,1,4,"dummy"
"204454",1,12,0,13,"dummy"
"204455",1,1,6,8,"dummy"
"204457",0,2,2,4,"dummy"
"204459",0,0,0,0,"dummy"
"204460",0,0,0,0,"dummy"
"204477",13,2,0,15,"dummy"
"204478",0,1,0,1,"dummy"
"204479",0,0,0,0,"dummy"
"204480",0,0,0,0,"dummy"
"204481",0,0,0,0,"dummy"
"204484",0,0,1,1,"dummy"
"204487",0,0,0,0,"dummy"
"204489",0,1,0,1,"dummy"
"204490",0,4,0,4,"dummy"
"204491",0,0,0,0,"dummy"
"204492",1,9,1,11,"dummy"
"204493",0,1,0,1,"dummy"
"204494",4,0,6,10,"dummy"
"204495",0,1,0,1,"dummy"
"204496",0,1,0,1,"dummy"
"204497",0,1,0,1,"dummy"
"204498",0,0,0,0,"dummy"
"204499",0,0,1,1,"dummy"
"204500",0,0,1,1,"dummy"
"204501",0,1,0,1,"dummy"
"204502",1,0,1,2,"dummy"
"204503",0,0,1,1,"dummy"
"204504",0,0,1,1,"dummy"
"204505",0,0,1,1,"dummy"
"204506",0,0,1,1,"dummy"
"204507",0,0,1,1,"dummy"
"204509",0,7,0,7,"dummy"
"204510",0,1,2,3,"dummy"
"204513",1,0,0,1,"dummy"
"204515",0,1,0,1,"dummy"
"204516",4,6,1,11,"dummy"
"204518",3,1,1,5,"dummy"
"204519",0,0,1,1,"dummy"
"204520",0,0,0,0,"dummy"
"204521",1,6,1,8,"dummy"
"204523",0,1,0,1,"dummy"
"204527",0,0,0,0,"dummy"
"204528",0,0,0,0,"dummy"
"204534",0,0,1,1,"dummy"
"204536",0,1,1,2,"dummy"
"204538",0,1,0,1,"dummy"
"204539",3,6,0,9,"dummy"
"204540",0,3,0,3,"dummy"
"204541",0,1,0,1,"dummy"
"204542",0,0,1,1,"dummy"
"204543",0,0,1,1,"dummy"
"204544",0,0,1,1,"dummy"
"204545",0,0,1,1,"dummy"
"204546",0,0,1,1,"dummy"
"204547",0,0,1,1,"dummy"
"204562",0,0,1,1,"dummy"
"204563",1,3,3,7,"dummy"
"204568",0,1,0,1,"dummy"
"204578",0,0,1,1,"dummy"
"204579",0,0,1,1,"dummy"
"204580",19,16,1,36,"dummy"
"204581",0,1,3,4,"dummy"
"204582",0,0,1,1,"dummy"
"204585",1,11,1,13,"dummy"
"204586",0,12,1,13,"dummy"
"204587",0,1,0,1,"dummy"
"204588",0,1,1,2,"dummy"
"204590",0,5,0,5,"dummy"
"204591",0,3,0,3,"dummy"
"204592",0,2,0,2,"dummy"
"204594",0,0,1,1,"dummy"
"204598",1,1,2,4,"dummy"
"204599",1,0,0,1,"dummy"
"204600",0,1,0,1,"dummy"
"204601",0,0,2,2,"dummy"
"204602",0,1,0,1,"dummy"
"204614",0,4,0,4,"dummy"
"204615",0,2,0,2,"dummy"
"204616",0,12,0,12,"dummy"
"204617",1,0,0,1,"dummy"
"204618",0,3,0,3,"dummy"
"204620",0,2,0,2,"dummy"
"204622",0,1,0,1,"dummy"
"204652",3,7,2,12,"dummy"
"204657",0,0,1,1,"dummy"
"204659",0,0,1,1,"dummy"
"204668",0,0,0,0,"dummy"
"204669",0,0,0,0,"dummy"
"204670",0,0,0,0,"dummy"
"204671",0,0,0,0,"dummy"
"204672",0,1,0,1,"dummy"
"204673",0,0,0,0,"dummy"
"204677",0,3,1,4,"dummy"
"204678",1,4,3,8,"dummy"
"204679",0,0,3,3,"dummy"
"204680",0,0,3,3,"dummy"
"204681",0,1,3,4,"dummy"
"204685",0,0,1,1,"dummy"
"204686",0,0,1,1,"dummy"
"204687",0,0,1,1,"dummy"
"204688",0,0,1,1,"dummy"
"204691",2,3,0,5,"dummy"
"204692",0,0,1,1,"dummy"
"204693",0,1,0,1,"dummy"
"204698",4,4,1,9,"dummy"
"204699",2,3,0,5,"dummy"
"204700",0,0,1,1,"dummy"
"204701",9,3,2,14,"dummy"
"204702",0,0,0,0,"dummy"
"204703",0,0,1,1,"dummy"
"204704",0,0,1,1,"dummy"
"204705",0,0,1,1,"dummy"
"204706",10,4,0,14,"dummy"
"204707",0,1,0,1,"dummy"
"204708",0,0,0,0,"dummy"
"204709",2,2,0,4,"dummy"
"204710",0,0,2,2,"dummy"
"204711",0,0,1,1,"dummy"
"204712",0,0,1,1,"dummy"
"204713",0,0,1,1,"dummy"
"204714",0,0,1,1,"dummy"
"204715",0,0,1,1,"dummy"
"204716",8,8,1,17,"dummy"
"204717",2,2,4,8,"dummy"
"204752",2,0,1,3,"dummy"
"204753",0,0,0,0,"dummy"
"204817",2,0,1,3,"dummy"
"204818",0,15,1,16,"dummy"
"204819",0,0,1,1,"dummy"
"204820",0,1,0,1,"dummy"
"204821",0,1,0,1,"dummy"
"204822",0,1,1,2,"dummy"
"204823",0,1,0,1,"dummy"
"204824",0,2,1,3,"dummy"
"204825",18,3,2,23,"dummy"
"204826",4,17,1,22,"dummy"
"204827",16,4,1,21,"dummy"
"204828",1,5,0,6,"dummy"
"204829",0,0,0,0,"dummy"
"204830",0,0,0,0,"dummy"
"204831",4,0,1,5,"dummy"
"204846",0,1,0,1,"dummy"
"204847",0,3,0,3,"dummy"
"204848",0,0,1,1,"dummy"
"204849",0,0,1,1,"dummy"
"204850",0,2,0,2,"dummy"
"204851",0,0,0,0,"dummy"
"204852",2,0,0,2,"dummy"
"204853",2,0,0,2,"dummy"
"204854",0,2,0,2,"dummy"
"204855",0,1,0,1,"dummy"
"204856",0,1,0,1,"dummy"
"204857",0,1,0,1,"dummy"
"204858",1,0,0,1,"dummy"
"204859",0,2,0,2,"dummy"
"204860",9,3,5,17,"dummy"
"204862",0,0,5,5,"dummy"
"204864",2,1,0,3,"dummy"
"204865",0,0,1,1,"dummy"
"204866",0,0,1,1,"dummy"
"204867",0,0,1,1,"dummy"
"204868",0,1,0,1,"dummy"
"204899",0,1,0,1,"dummy"
"204900",1,0,0,1,"dummy"
"204901",0,0,2,2,"dummy"
"204902",0,0,1,1,"dummy"
"204904",1,2,1,4,"dummy"
"204905",9,0,1,10,"dummy"
"204906",0,3,0,3,"dummy"
"204907",2,0,1,3,"dummy"
"204908",0,1,0,1,"dummy"
"204909",0,0,0,0,"dummy"
"204910",0,8,0,8,"dummy"
"204911",0,1,0,1,"dummy"
"204912",0,6,0,6,"dummy"
"204914",0,1,2,3,"dummy"
"204915",0,0,0,0,"dummy"
"204916",0,1,0,1,"dummy"
"204917",4,0,2,6,"dummy"
"204918",1,0,0,1,"dummy"
"204919",0,0,0,0,"dummy"
"204920",0,0,0,0,"dummy"
"204922",3,3,0,6,"dummy"
"204923",1,0,0,1,"dummy"
"204924",2,1,1,4,"dummy"
"204925",1,24,0,25,"dummy"
"204926",0,0,1,1,"dummy"
"204927",0,0,1,1,"dummy"
"204928",1,0,0,1,"dummy"
"204929",10,0,0,10,"dummy"
"204930",4,0,1,5,"dummy"
"204931",0,0,0,0,"dummy"
"204932",2,4,1,7,"dummy"
"204933",1,4,0,5,"dummy"
"204934",0,1,0,1,"dummy"
"204935",4,2,0,6,"dummy"
"204936",0,1,1,2,"dummy"
"204937",0,0,0,0,"dummy"
"204938",0,2,0,2,"dummy"
"204939",2,1,0,3,"dummy"
"204940",0,2,0,2,"dummy"
"204941",13,3,0,16,"dummy"
"204942",4,13,1,18,"dummy"
"204943",13,3,0,16,"dummy"
"204944",5,13,0,18,"dummy"
"204945",0,0,1,1,"dummy"
"204947",1,1,1,3,"dummy"
"204948",0,1,0,1,"dummy"
"204949",3,7,4,14,"dummy"
"204951",0,1,0,1,"dummy"
"204952",0,0,0,0,"dummy"
"204953",0,0,0,0,"dummy"
"204958",0,0,2,2,"dummy"
"204977",0,2,0,2,"dummy"
"204979",0,1,0,1,"dummy"
"204980",3,6,0,9,"dummy"
"204981",0,0,4,4,"dummy"
"204982",2,2,1,5,"dummy"
"204986",0,2,4,6,"dummy"
"204987",0,0,1,1,"dummy"
"204988",0,0,1,1,"dummy"
"204989",0,0,1,1,"dummy"
"204990",0,0,1,1,"dummy"
"204991",0,1,1,2,"dummy"
"204992",0,0,1,1,"dummy"
"204996",0,0,0,0,"dummy"
"204997",2,0,0,2,"dummy"
"204998",0,2,0,2,"dummy"
"204999",0,0,1,1,"dummy"
"205000",0,0,1,1,"dummy"
"205001",0,0,0,0,"dummy"
"205002",1,1,0,2,"dummy"
"205003",2,0,0,2,"dummy"
"205004",3,2,0,5,"dummy"
"205005",2,1,1,4,"dummy"
"205007",0,4,0,4,"dummy"
"205010",2,0,0,2,"dummy"
"205012",3,6,2,11,"dummy"
"205013",2,8,6,16,"dummy"
"205014",3,0,3,6,"dummy"
"205015",0,1,0,1,"dummy"
"205018",2,2,1,5,"dummy"
"205019",0,2,2,4,"dummy"
"205020",0,0,0,0,"dummy"
"205022",0,0,1,1,"dummy"
"205024",1,1,0,2,"dummy"
"205026",0,1,3,4,"dummy"
"205028",1,1,2,4,"dummy"
"205029",0,1,0,1,"dummy"
"205030",0,3,0,3,"dummy"
"205032",0,1,0,1,"dummy"
"205043",0,2,0,2,"dummy"
"205044",0,0,1,1,"dummy"
"205046",0,3,0,3,"dummy"
"205047",0,0,0,0,"dummy"
"205048",0,0,1,1,"dummy"
"205050",0,0,1,1,"dummy"
"205051",0,1,0,1,"dummy"
"205052",0,0,1,1,"dummy"
"205053",0,6,0,6,"dummy"
"205054",1,2,0,3,"dummy"
"205055",5,6,1,12,"dummy"
"205056",0,1,1,2,"dummy"
"205059",0,0,1,1,"dummy"
"205060",1,0,1,2,"dummy"
"205062",0,1,0,1,"dummy"
"205065",0,0,0,0,"dummy"
"205067",0,0,1,1,"dummy"
"205068",2,0,0,2,"dummy"
"205069",0,0,2,2,"dummy"
"205082",1,0,0,1,"dummy"
"205085",1,1,0,2,"dummy"
"205092",0,0,2,2,"dummy"
"205093",0,1,0,1,"dummy"
"205094",0,1,0,1,"dummy"
"205095",1,0,0,1,"dummy"
"205096",0,0,1,1,"dummy"
"205097",0,0,0,0,"dummy"
"205098",0,1,1,2,"dummy"
"205099",0,0,1,1,"dummy"
"205116",0,0,1,1,"dummy"
"205117",0,0,1,1,"dummy"
"205118",0,0,1,1,"dummy"
"205119",0,0,1,1,"dummy"
"205120",0,0,1,1,"dummy"
"205121",0,0,1,1,"dummy"
"205122",0,0,1,1,"dummy"
"205123",0,0,1,1,"dummy"
"205124",0,0,1,1,"dummy"
"205125",0,0,1,1,"dummy"
"205126",0,0,1,1,"dummy"
"205127",0,0,1,1,"dummy"
"205128",0,0,1,1,"dummy"
"205129",0,0,1,1,"dummy"
"205130",0,0,1,1,"dummy"
"205131",0,0,1,1,"dummy"
"205132",0,0,1,1,"dummy"
"205133",0,0,1,1,"dummy"
"205134",0,0,1,1,"dummy"
"205135",0,0,1,1,"dummy"
"205136",0,0,1,1,"dummy"
"205140",0,0,1,1,"dummy"
"205142",1,2,1,4,"dummy"
"205143",2,3,6,11,"dummy"
"205145",4,0,2,6,"dummy"
"205146",0,0,6,6,"dummy"
"205149",0,0,1,1,"dummy"
"205150",0,0,1,1,"dummy"
"205151",0,0,1,1,"dummy"
"205152",0,0,1,1,"dummy"
"205153",0,0,1,1,"dummy"
"205154",9,3,0,12,"dummy"
"205155",0,0,1,1,"dummy"
"205157",0,0,1,1,"dummy"
"205158",0,0,1,1,"dummy"
"205159",0,0,1,1,"dummy"
"205160",0,0,0,0,"dummy"
"205161",0,0,1,1,"dummy"
"205162",0,0,1,1,"dummy"
"205163",2,3,1,6,"dummy"
"205164",0,0,1,1,"dummy"
"205165",0,0,0,0,"dummy"
"205167",0,1,0,1,"dummy"
"205168",0,0,1,1,"dummy"
"205170",0,10,0,10,"dummy"
"205171",1,2,0,3,"dummy"
"205173",0,3,0,3,"dummy"
"205174",0,0,2,2,"dummy"
"205175",0,0,4,4,"dummy"
"205176",13,0,2,15,"dummy"
"205180",1,0,0,1,"dummy"
"205181",0,1,0,1,"dummy"
"205186",5,5,2,12,"dummy"
"205189",0,2,0,2,"dummy"
"205190",0,0,3,3,"dummy"
"205192",1,0,3,4,"dummy"
"205193",0,1,0,1,"dummy"
"205196",3,5,0,8,"dummy"
"205197",0,1,0,1,"dummy"
"205206",0,3,0,3,"dummy"
"205208",0,0,0,0,"dummy"
"205209",0,1,0,1,"dummy"
"205210",0,2,0,2,"dummy"
"205211",0,0,0,0,"dummy"
"205228",4,15,0,19,"dummy"
"205229",0,1,0,1,"dummy"
"205232",0,0,2,2,"dummy"
"205233",5,0,0,5,"dummy"
"205234",0,0,1,1,"dummy"
"205235",0,0,0,0,"dummy"
"205236",0,0,2,2,"dummy"
"205237",0,0,1,1,"dummy"
"205238",0,0,1,1,"dummy"
"205239",2,10,1,13,"dummy"
"205240",10,2,1,13,"dummy"
"205241",0,6,0,6,"dummy"
"205242",2,5,1,8,"dummy"
"205243",0,0,2,2,"dummy"
"205244",5,1,2,8,"dummy"
"205245",0,0,2,2,"dummy"
"205251",9,12,1,22,"dummy"
"205252",0,4,0,4,"dummy"
"205253",0,3,1,4,"dummy"
"205254",0,2,0,2,"dummy"
"205255",3,4,7,14,"dummy"
"205256",1,1,0,2,"dummy"
"205257",32,0,7,39,"dummy"
"205259",3,3,0,6,"dummy"
"205261",0,1,0,1,"dummy"
"205262",13,24,2,39,"dummy"
"205265",0,1,3,4,"dummy"
"205266",0,2,0,2,"dummy"
"205267",1,0,0,1,"dummy"
"205268",0,11,1,12,"dummy"
"205270",1,1,1,3,"dummy"
"205272",0,1,0,1,"dummy"
"205273",2,1,1,4,"dummy"
"205274",1,2,0,3,"dummy"
"205275",1,0,0,1,"dummy"
"205278",2,0,0,2,"dummy"
"205283",0,0,0,0,"dummy"
"205284",0,0,1,1,"dummy"
"205285",0,1,0,1,"dummy"
"205286",0,0,0,0,"dummy"
"205287",13,1,2,16,"dummy"
"205289",0,2,0,2,"dummy"
"205292",2,3,0,5,"dummy"
"205296",2,0,3,5,"dummy"
"205299",0,0,3,3,"dummy"
"205300",0,0,1,1,"dummy"
"205301",0,0,1,1,"dummy"
"205302",0,0,1,1,"dummy"
"205303",0,0,1,1,"dummy"
"205304",0,0,1,1,"dummy"
"205305",0,0,1,1,"dummy"
"205306",0,0,1,1,"dummy"
"205307",0,0,2,2,"dummy"
"205308",0,0,1,1,"dummy"
"205309",0,0,1,1,"dummy"
"205310",0,0,1,1,"dummy"
"205311",0,0,1,1,"dummy"
"205312",0,0,1,1,"dummy"
"205313",0,0,1,1,"dummy"
"205314",0,0,1,1,"dummy"
"205315",0,0,1,1,"dummy"
"205323",0,1,0,1,"dummy"
"205325",0,0,1,1,"dummy"
"205326",0,0,1,1,"dummy"
"205327",7,13,2,22,"dummy"
"205328",0,0,0,0,"dummy"
"205329",0,0,0,0,"dummy"
"205331",0,7,0,7,"dummy"
"205335",0,0,1,1,"dummy"
"205336",0,0,2,2,"dummy"
"205337",0,0,1,1,"dummy"
"205338",0,0,1,1,"dummy"
"205339",0,0,1,1,"dummy"
"205436",0,0,0,0,"dummy"
"205437",0,5,1,6,"dummy"
"205438",5,0,1,6,"dummy"
"205439",0,4,2,6,"dummy"
"205442",0,3,1,4,"dummy"
"205443",0,0,1,1,"dummy"
"205444",0,1,0,1,"dummy"
"205445",0,1,0,1,"dummy"
"205446",0,0,1,1,"dummy"
"205447",0,2,0,2,"dummy"
"205448",2,0,1,3,"dummy"
"205449",0,1,1,2,"dummy"
"205450",1,2,1,4,"dummy"
"205451",0,4,0,4,"dummy"
"205452",1,1,0,2,"dummy"
"205470",0,1,0,1,"dummy"
"205471",0,0,1,1,"dummy"
"205472",9,42,2,53,"dummy"
"205487",0,1,1,2,"dummy"
"205488",0,0,1,1,"dummy"
"205489",0,2,0,2,"dummy"
"205490",2,31,2,35,"dummy"
"205491",7,7,0,14,"dummy"
"205492",1,1,1,3,"dummy"
"205493",0,0,1,1,"dummy"
"205494",0,0,2,2,"dummy"
"205495",0,0,1,1,"dummy"
"205496",0,0,1,1,"dummy"
"205497",19,2,8,29,"dummy"
"205498",9,2,0,11,"dummy"
"205499",0,0,0,0,"dummy"
"205500",0,0,1,1,"dummy"
"205501",0,0,1,1,"dummy"
"205502",0,0,1,1,"dummy"
"205503",0,0,1,1,"dummy"
"205504",0,0,1,1,"dummy"
"205505",0,0,1,1,"dummy"
"205506",0,0,2,2,"dummy"
"205507",0,1,0,1,"dummy"
"205508",0,0,0,0,"dummy"
"205509",0,0,1,1,"dummy"
"205510",0,2,2,4,"dummy"
"205511",0,0,0,0,"dummy"
"205512",0,0,1,1,"dummy"
"205528",0,0,4,4,"dummy"
"205529",0,0,0,0,"dummy"
"205530",0,0,0,0,"dummy"
"205533",1,0,1,2,"dummy"
"205536",0,1,0,1,"dummy"
"205562",0,1,0,1,"dummy"
"205563",0,1,0,1,"dummy"
"205564",0,0,3,3,"dummy"
"205565",0,0,2,2,"dummy"
"205566",0,0,1,1,"dummy"
"205567",0,0,0,0,"dummy"
"205568",0,0,2,2,"dummy"
"205569",4,9,1,14,"dummy"
"205570",0,1,0,1,"dummy"
"205576",0,2,1,3,"dummy"
"205577",8,18,0,26,"dummy"
"205583",0,0,0,0,"dummy"
"205584",0,0,0,0,"dummy"
"205591",0,1,0,1,"dummy"
"205592",0,0,2,2,"dummy"
"205593",0,0,1,1,"dummy"
"205594",0,0,0,0,"dummy"
"205615",0,0,1,1,"dummy"
"205616",0,2,0,2,"dummy"
"205617",11,1,1,13,"dummy"
"205625",0,8,2,10,"dummy"
"205626",9,8,3,20,"dummy"
"205333",2,0,3,5,"dummy"
"205341",0,0,0,0,"dummy"
"205342",0,0,2,2,"dummy"
"205343",0,0,0,0,"dummy"
"205344",0,0,0,0,"dummy"
"205460",0,0,1,1,"dummy"
"205461",5,3,0,8,"dummy"
"205462",0,1,0,1,"dummy"
"205463",0,0,0,0,"dummy"
"205464",0,0,5,5,"dummy"
"205465",0,0,2,2,"dummy"
"205468",2,0,0,2,"dummy"
"205514",0,2,3,5,"dummy"
"205515",0,0,1,1,"dummy"
"205516",1,0,0,1,"dummy"
"205517",0,0,1,1,"dummy"
"205518",0,0,1,1,"dummy"
"205519",0,1,0,1,"dummy"
"205520",0,0,1,1,"dummy"
"205521",0,0,0,0,"dummy"
"205522",0,0,1,1,"dummy"
"205523",0,0,1,1,"dummy"
"205524",0,4,0,4,"dummy"
"205525",0,1,0,1,"dummy"
"205526",0,1,0,1,"dummy"
"205538",0,0,0,0,"dummy"
"205539",0,0,0,0,"dummy"
"205542",0,0,1,1,"dummy"
"205543",0,0,1,1,"dummy"
"205546",0,1,0,1,"dummy"
"205547",0,0,0,0,"dummy"
"205548",0,1,0,1,"dummy"
"205549",0,1,0,1,"dummy"
"205554",2,0,0,2,"dummy"
"205555",3,4,1,8,"dummy"
"205556",3,3,0,6,"dummy"
"205557",1,7,0,8,"dummy"
"205558",3,3,0,6,"dummy"
"205559",0,1,0,1,"dummy"
"205560",0,0,1,1,"dummy"
"205572",0,0,0,0,"dummy"
"205573",0,11,0,11,"dummy"
"205574",11,0,0,11,"dummy"
"205581",0,0,1,1,"dummy"
"205596",11,13,0,24,"dummy"
"205597",3,2,0,5,"dummy"
"205598",0,0,0,0,"dummy"
"205599",0,0,1,1,"dummy"
"205600",0,6,0,6,"dummy"
"205601",0,1,0,1,"dummy"
"205602",0,1,0,1,"dummy"
"205603",0,0,1,1,"dummy"
"205604",1,0,0,1,"dummy"
"205605",0,0,4,4,"dummy"
"205606",0,0,2,2,"dummy"
"205607",0,0,4,4,"dummy"
"205608",0,1,0,1,"dummy"
"205609",2,1,0,3,"dummy"
"205610",0,1,1,2,"dummy"
"205613",0,0,1,1,"dummy"
"205619",24,22,2,48,"dummy"
"205620",0,3,0,3,"dummy"
"205621",2,7,0,9,"dummy"
"205622",7,7,1,15,"dummy"
"205623",0,3,0,3,"dummy"
"205628",0,2,0,2,"dummy"
"205633",0,0,1,1,"dummy"
"205638",1,12,3,16,"dummy"
"205639",2,6,3,11,"dummy"
"205640",0,4,0,4,"dummy"
"205641",0,1,0,1,"dummy"
"205642",0,1,0,1,"dummy"
"205635",0,6,0,6,"dummy"
"205636",6,6,0,12,"dummy"
"205645",0,2,0,2,"dummy"
"205646",1,4,1,6,"dummy"
"205647",2,7,3,12,"dummy"
"205648",0,1,0,1,"dummy"
"205649",2,5,0,7,"dummy"
"205650",12,0,1,13,"dummy"
"205655",0,1,1,2,"dummy"
"205656",0,0,1,1,"dummy"
"205665",1,17,0,18,"dummy"
"205666",0,8,0,8,"dummy"
"205667",0,1,0,1,"dummy"
"205670",1,10,0,11,"dummy"
"205671",3,2,1,6,"dummy"
"205672",0,2,0,2,"dummy"
"205673",18,17,2,37,"dummy"
"205674",0,2,0,2,"dummy"
"205675",5,7,0,12,"dummy"
"205676",9,5,0,14,"dummy"
"205677",0,1,0,1,"dummy"
"205678",0,1,0,1,"dummy"
"205679",0,1,0,1,"dummy"
"205680",1,4,0,5,"dummy"
"205681",1,1,0,2,"dummy"
"205682",1,2,0,3,"dummy"
"205683",0,0,0,0,"dummy"
"205684",0,0,0,0,"dummy"
"205685",0,0,0,0,"dummy"
"205686",0,0,1,1,"dummy"
"205687",5,0,0,5,"dummy"
"205688",10,7,1,18,"dummy"
"205689",0,4,2,6,"dummy"
"205690",3,0,0,3,"dummy"
"205691",0,0,0,0,"dummy"
"205692",6,0,0,6,"dummy"
"205693",0,6,0,6,"dummy"
"205694",8,4,2,14,"dummy"
"205695",9,7,7,23,"dummy"
"205696",0,0,0,0,"dummy"
"205697",0,0,5,5,"dummy"
"205698",10,10,0,20,"dummy"
"205699",0,3,0,3,"dummy"
"205700",0,1,0,1,"dummy"
"205701",0,1,7,8,"dummy"
"205702",5,5,1,11,"dummy"
"205703",0,0,5,5,"dummy"
"205704",0,0,6,6,"dummy"
"205705",0,0,5,5,"dummy"
"205750",0,4,0,4,"dummy"
"205763",2,7,0,9,"dummy"
"205764",5,1,0,6,"dummy"
"205765",0,1,1,2,"dummy"
"205766",0,0,0,0,"dummy"
"205767",0,1,0,1,"dummy"
"205770",0,1,0,1,"dummy"
"205771",2,0,0,2,"dummy"
"205772",0,7,0,7,"dummy"
"205785",0,4,1,5,"dummy"
"205786",0,0,0,0,"dummy"
"205806",0,0,1,1,"dummy"
"205811",2,0,1,3,"dummy"
"205814",4,9,2,15,"dummy"
"205821",0,0,1,1,"dummy"
"205822",1,1,0,2,"dummy"
"205823",7,0,0,7,"dummy"
"205824",0,3,0,3,"dummy"
"205825",3,0,0,3,"dummy"
"205826",0,3,0,3,"dummy"
"205643",14,1,1,16,"dummy"
"205652",0,0,1,1,"dummy"
"205653",7,5,0,12,"dummy"
"205707",0,1,0,1,"dummy"
"205708",0,1,0,1,"dummy"
"205709",2,12,0,14,"dummy"
"205714",7,5,2,14,"dummy"
"205715",0,0,2,2,"dummy"
"205716",0,0,2,2,"dummy"
"205717",0,0,2,2,"dummy"
"205718",0,4,0,4,"dummy"
"205719",3,0,0,3,"dummy"
"205720",1,4,0,5,"dummy"
"205721",2,1,0,3,"dummy"
"205722",0,1,0,1,"dummy"
"205723",0,3,0,3,"dummy"
"205738",0,2,0,2,"dummy"
"205739",0,0,0,0,"dummy"
"205740",1,1,0,2,"dummy"
"205741",0,1,0,1,"dummy"
"205744",0,6,2,8,"dummy"
"205754",0,0,0,0,"dummy"
"205755",0,0,0,0,"dummy"
"205756",2,0,0,2,"dummy"
"205757",0,0,0,0,"dummy"
"205758",2,0,1,3,"dummy"
"205759",0,2,0,2,"dummy"
"205774",1,5,2,8,"dummy"
"205775",0,0,2,2,"dummy"
"205776",0,8,0,8,"dummy"
"205777",2,7,0,9,"dummy"
"205778",7,2,1,10,"dummy"
"205779",2,7,0,9,"dummy"
"205780",21,8,3,32,"dummy"
"205781",0,2,2,4,"dummy"
"205782",7,1,0,8,"dummy"
"205783",0,0,0,0,"dummy"
"205804",0,3,2,5,"dummy"
"205808",0,1,0,1,"dummy"
"205809",0,1,0,1,"dummy"
"205816",0,1,1,2,"dummy"
"205817",0,0,1,1,"dummy"
"205818",0,2,0,2,"dummy"
"205819",0,9,0,9,"dummy"
"205828",0,0,0,0,"dummy"
"205829",0,0,0,0,"dummy"
"205830",0,0,0,0,"dummy"
"205831",1,0,4,5,"dummy"
"205832",0,1,4,5,"dummy"
"205833",1,0,4,5,"dummy"
"205834",0,0,0,0,"dummy"
"205835",0,0,0,0,"dummy"
"205836",0,0,3,3,"dummy"
"205837",0,0,4,4,"dummy"
"205838",0,0,0,0,"dummy"
"205839",0,0,0,0,"dummy"
"205840",0,0,0,0,"dummy"
"205843",2,2,1,5,"dummy"
"205844",3,8,0,11,"dummy"
"205845",2,4,0,6,"dummy"
"205846",0,2,0,2,"dummy"
"205847",8,3,1,12,"dummy"
"205848",0,2,0,2,"dummy"
"205849",2,3,2,7,"dummy"
"205850",10,14,1,25,"dummy"
"205851",2,2,0,4,"dummy"
"205852",36,13,3,52,"dummy"
"205853",0,2,0,2,"dummy"
"205854",5,11,1,17,"dummy"
"205855",0,2,0,2,"dummy"
"205856",1,3,1,5,"dummy"
"205857",8,3,1,12,"dummy"
"205865",14,4,5,23,"dummy"
"205873",0,0,1,1,"dummy"
"205874",0,0,0,0,"dummy"
"205876",0,2,0,2,"dummy"
"205877",0,1,0,1,"dummy"
"205879",0,0,1,1,"dummy"
"205880",0,0,1,1,"dummy"
"205890",2,2,4,8,"dummy"
"205891",0,0,0,0,"dummy"
"205892",0,0,0,0,"dummy"
"205893",0,0,0,0,"dummy"
"205894",0,0,5,5,"dummy"
"205895",0,0,0,0,"dummy"
"205896",0,0,0,0,"dummy"
"205897",0,0,0,0,"dummy"
"205898",0,5,1,6,"dummy"
"205902",0,4,0,4,"dummy"
"205903",6,0,0,6,"dummy"
"205904",0,0,1,1,"dummy"
"205906",0,0,1,1,"dummy"
"205907",0,0,2,2,"dummy"
"205908",2,0,4,6,"dummy"
"205909",0,0,4,4,"dummy"
"205910",0,0,1,1,"dummy"
"205912",12,12,2,26,"dummy"
"205913",5,1,1,7,"dummy"
"205915",0,1,0,1,"dummy"
"205920",2,2,5,9,"dummy"
"205921",10,4,6,20,"dummy"
"205923",0,1,0,1,"dummy"
"205924",5,1,0,6,"dummy"
"205925",0,4,0,4,"dummy"
"205926",1,1,0,2,"dummy"
"205927",4,8,0,12,"dummy"
"205928",1,8,0,9,"dummy"
"205929",0,0,1,1,"dummy"
"205930",0,0,1,1,"dummy"
"205931",1,5,8,14,"dummy"
"205932",0,1,0,1,"dummy"
"205933",0,0,1,1,"dummy"
"205934",0,1,0,1,"dummy"
"205935",1,2,0,3,"dummy"
"205936",0,2,0,2,"dummy"
"205937",0,2,0,2,"dummy"
"205938",0,3,1,4,"dummy"
"205939",0,0,1,1,"dummy"
"205940",0,0,2,2,"dummy"
"205941",1,4,0,5,"dummy"
"205943",0,0,0,0,"dummy"
"205956",0,0,0,0,"dummy"
"205958",1,15,2,18,"dummy"
"205959",2,2,0,4,"dummy"
"205960",0,1,0,1,"dummy"
"205961",4,21,3,28,"dummy"
"205962",1,0,1,2,"dummy"
"205963",0,6,1,7,"dummy"
"205964",0,1,1,2,"dummy"
"205965",0,0,1,1,"dummy"
"205966",0,0,1,1,"dummy"
"205967",2,0,0,2,"dummy"
"205968",0,3,0,3,"dummy"
"205969",0,0,5,5,"dummy"
"205970",0,0,5,5,"dummy"
"205971",8,0,0,8,"dummy"
"205972",0,3,0,3,"dummy"
"205973",4,4,1,9,"dummy"
"205974",1,0,1,2,"dummy"
"205977",0,1,0,1,"dummy"
"205979",11,5,1,17,"dummy"
"205984",0,1,0,1,"dummy"
"205985",0,0,1,1,"dummy"
"205986",0,0,1,1,"dummy"
"205987",1,1,2,4,"dummy"
"205988",4,0,0,4,"dummy"
"205989",0,0,1,1,"dummy"
"205990",0,0,1,1,"dummy"
"205991",0,2,1,3,"dummy"
"205992",2,0,0,2,"dummy"
"205993",1,4,0,5,"dummy"
"205994",0,1,1,2,"dummy"
"205995",0,0,2,2,"dummy"
"205996",0,0,1,1,"dummy"
"205997",0,1,0,1,"dummy"
"205998",4,3,3,10,"dummy"
"205999",4,2,0,6,"dummy"
"206000",1,2,0,3,"dummy"
"206001",0,4,0,4,"dummy"
"206002",0,1,0,1,"dummy"
"206003",4,0,0,4,"dummy"
"206004",0,1,0,1,"dummy"
"206005",2,0,0,2,"dummy"
"206006",0,0,0,0,"dummy"
"206007",0,2,0,2,"dummy"
"206008",0,4,0,4,"dummy"
"206010",2,2,0,4,"dummy"
"206011",2,0,0,2,"dummy"
"206012",1,1,0,2,"dummy"
"206017",0,1,1,2,"dummy"
"206019",0,0,1,1,"dummy"
"206020",0,0,1,1,"dummy"
"206021",0,0,0,0,"dummy"
"206022",0,0,0,0,"dummy"
"206023",0,0,0,0,"dummy"
"206024",0,0,0,0,"dummy"
"206025",0,0,0,0,"dummy"
"206026",0,0,1,1,"dummy"
"206027",0,0,1,1,"dummy"
"206028",0,0,1,1,"dummy"
"206029",0,0,0,0,"dummy"
"206031",1,1,0,2,"dummy"
"206033",0,3,0,3,"dummy"
"206034",3,1,0,4,"dummy"
"206035",1,3,0,4,"dummy"
"206036",0,1,0,1,"dummy"
"206038",5,3,0,8,"dummy"
"206039",2,0,0,2,"dummy"
"206041",2,0,3,5,"dummy"
"206045",0,0,0,0,"dummy"
"206046",0,0,0,0,"dummy"
"206047",0,2,0,2,"dummy"
"206050",1,1,0,2,"dummy"
"206051",0,3,0,3,"dummy"
"206052",5,2,4,11,"dummy"
"206053",0,0,1,1,"dummy"
"206054",0,0,0,0,"dummy"
"206055",0,2,0,2,"dummy"
"206056",3,0,0,3,"dummy"
"206058",0,0,0,0,"dummy"
"206059",0,1,0,1,"dummy"
"206062",2,0,0,2,"dummy"
"206065",0,2,0,2,"dummy"
"206069",0,0,0,0,"dummy"
"206070",0,0,0,0,"dummy"
"206071",0,0,0,0,"dummy"
"206073",0,25,0,25,"dummy"
"206074",1,1,1,3,"dummy"
"206075",1,0,1,2,"dummy"
"206076",2,2,0,4,"dummy"
"206077",0,7,0,7,"dummy"
"206078",0,0,1,1,"dummy"
"206079",0,0,2,2,"dummy"
"206080",9,3,0,12,"dummy"
"206081",0,1,0,1,"dummy"
"206082",0,2,0,2,"dummy"
"206083",0,10,0,10,"dummy"
"206084",0,0,1,1,"dummy"
"206085",0,0,1,1,"dummy"
"206086",0,0,1,1,"dummy"
"206087",0,0,3,3,"dummy"
"206091",0,2,0,2,"dummy"
"206104",0,0,0,0,"dummy"
"206106",0,1,0,1,"dummy"
"206107",0,0,1,1,"dummy"
"206109",0,0,0,0,"dummy"
"206110",0,0,0,0,"dummy"
"206111",0,0,0,0,"dummy"
"206113",4,11,1,16,"dummy"
"206114",0,6,1,7,"dummy"
"206115",2,0,0,2,"dummy"
"206116",0,0,1,1,"dummy"
"206127",14,3,3,20,"dummy"
"206129",0,0,1,1,"dummy"
"206130",0,0,1,1,"dummy"
"206131",0,4,0,4,"dummy"
"206133",0,1,0,1,"dummy"
"206134",0,0,1,1,"dummy"
"206142",2,2,5,9,"dummy"
"206143",0,2,0,2,"dummy"
"206144",0,1,0,1,"dummy"
"206149",0,4,0,4,"dummy"
"206150",0,1,0,1,"dummy"
"206152",24,1,3,28,"dummy"
"206153",1,0,1,2,"dummy"
"206154",0,0,1,1,"dummy"
"206155",0,1,0,1,"dummy"
"206156",0,0,1,1,"dummy"
"206157",0,0,0,0,"dummy"
"206158",0,0,1,1,"dummy"
"206159",0,0,1,1,"dummy"
"206160",0,0,0,0,"dummy"
"206162",0,2,0,2,"dummy"
"206166",3,0,3,6,"dummy"
"206167",0,1,0,1,"dummy"
"206172",0,0,3,3,"dummy"
"206176",0,0,1,1,"dummy"
"206178",0,0,0,0,"dummy"
"206179",0,0,0,0,"dummy"
"206180",0,0,0,0,"dummy"
"206183",0,3,0,3,"dummy"
"206186",0,1,0,1,"dummy"
"206187",0,0,1,1,"dummy"
"206188",1,2,1,4,"dummy"
"206189",1,1,0,2,"dummy"
"206192",12,0,0,12,"dummy"
"206193",0,1,0,1,"dummy"
"206194",0,1,0,1,"dummy"
"206196",3,1,1,5,"dummy"
"206197",0,1,0,1,"dummy"
"206198",0,0,1,1,"dummy"
"206199",0,13,1,14,"dummy"
"206200",14,2,0,16,"dummy"
"206201",0,0,1,1,"dummy"
"206203",0,0,4,4,"dummy"
"206206",0,0,0,0,"dummy"
"206207",0,1,0,1,"dummy"
"206213",6,2,1,9,"dummy"
"206215",0,0,1,1,"dummy"
"206216",0,1,0,1,"dummy"
"206217",1,0,4,5,"dummy"
"206219",0,0,1,1,"dummy"
"206220",0,5,1,6,"dummy"
"206221",3,3,0,6,"dummy"
"206222",2,2,1,5,"dummy"
"206224",0,0,1,1,"dummy"
"206225",0,1,1,2,"dummy"
"206228",0,0,1,1,"dummy"
"206230",0,1,1,2,"dummy"
"206232",0,0,1,1,"dummy"
"206233",0,0,1,1,"dummy"
"206235",2,7,0,9,"dummy"
"206236",3,1,0,4,"dummy"
"206237",0,3,0,3,"dummy"
"206238",1,0,0,1,"dummy"
"206241",0,2,0,2,"dummy"
"206242",0,2,0,2,"dummy"
"206245",0,0,1,1,"dummy"
"206246",0,0,1,1,"dummy"
"206247",0,1,0,1,"dummy"
"206253",24,7,1,32,"dummy"
"206254",13,1,0,14,"dummy"
"206255",6,15,0,21,"dummy"
"206256",0,9,0,9,"dummy"
"206257",0,2,0,2,"dummy"
"206260",3,7,3,13,"dummy"
"206264",7,5,0,12,"dummy"
"206265",1,0,1,2,"dummy"
"206271",0,6,0,6,"dummy"
"206273",0,1,1,2,"dummy"
"206274",3,0,0,3,"dummy"
"206275",0,0,1,1,"dummy"
"206277",0,0,1,1,"dummy"
"206288",0,0,0,0,"dummy"
"206289",0,5,0,5,"dummy"
"206290",4,4,2,10,"dummy"
"206292",6,3,1,10,"dummy"
"206293",0,4,3,7,"dummy"
"206294",0,0,0,0,"dummy"
"206295",1,5,0,6,"dummy"
"206296",1,1,0,2,"dummy"
"206297",4,4,2,10,"dummy"
"206299",0,9,1,10,"dummy"
"206300",0,0,2,2,"dummy"
"206303",0,1,0,1,"dummy"
"206304",0,0,0,0,"dummy"
"206305",0,0,0,0,"dummy"
"206308",0,1,0,1,"dummy"
"206309",1,0,1,2,"dummy"
"206310",0,2,0,2,"dummy"
"206311",0,3,0,3,"dummy"
"206312",4,2,1,7,"dummy"
"206314",3,5,0,8,"dummy"
"206315",1,4,0,5,"dummy"
"206316",0,0,1,1,"dummy"
"206317",0,3,0,3,"dummy"
"206318",0,0,1,1,"dummy"
"206319",1,3,0,4,"dummy"
"206320",0,0,1,1,"dummy"
"206321",0,0,1,1,"dummy"
"206322",0,0,0,0,"dummy"
"206323",0,4,2,6,"dummy"
"206324",2,2,0,4,"dummy"
"206325",3,5,1,9,"dummy"
"206326",0,2,0,2,"dummy"
"206327",0,2,1,3,"dummy"
"206328",2,2,0,4,"dummy"
"206329",2,1,3,6,"dummy"
"206330",3,0,0,3,"dummy"
"206332",0,1,0,1,"dummy"
"206333",0,1,0,1,"dummy"
"206334",0,3,1,4,"dummy"
"206335",0,0,0,0,"dummy"
"206336",2,0,0,2,"dummy"
"206337",0,0,0,0,"dummy"
"206338",1,0,2,3,"dummy"
"206339",0,0,1,1,"dummy"
"206340",2,1,0,3,"dummy"
"206341",0,0,0,0,"dummy"
"206342",0,0,1,1,"dummy"
"206343",0,0,0,0,"dummy"
"206345",3,6,1,10,"dummy"
"206355",0,1,0,1,"dummy"
"206356",0,3,0,3,"dummy"
"206357",9,9,0,18,"dummy"
"206358",2,2,0,4,"dummy"
"206359",9,9,0,18,"dummy"
"206360",0,5,0,5,"dummy"
"206361",0,0,1,1,"dummy"
"206362",4,1,5,10,"dummy"
"206363",0,2,1,3,"dummy"
"206364",0,0,1,1,"dummy"
"206365",0,4,0,4,"dummy"
"206366",1,0,1,2,"dummy"
"206367",0,1,0,1,"dummy"
"206368",7,7,0,14,"dummy"
"206369",2,0,0,2,"dummy"
"206370",0,3,0,3,"dummy"
"206371",8,2,0,10,"dummy"
"206372",0,1,0,1,"dummy"
"206373",2,3,0,5,"dummy"
"206374",0,0,1,1,"dummy"
"206376",5,1,0,6,"dummy"
"206381",8,1,2,11,"dummy"
"206384",0,0,0,0,"dummy"
"206386",0,1,0,1,"dummy"
"206388",17,2,3,22,"dummy"
"206389",0,6,1,7,"dummy"
"206390",0,1,0,1,"dummy"
"206391",0,0,1,1,"dummy"
"206392",6,2,0,8,"dummy"
"206394",0,1,1,2,"dummy"
"206395",5,6,1,12,"dummy"
"206396",0,1,1,2,"dummy"
"206397",0,0,1,1,"dummy"
"206398",0,1,0,1,"dummy"
"206401",0,2,0,2,"dummy"
"206402",4,5,3,12,"dummy"
"206404",0,1,0,1,"dummy"
"206405",7,1,3,11,"dummy"
"206406",0,1,0,1,"dummy"
"206407",0,0,0,0,"dummy"
"206408",0,1,0,1,"dummy"
"206409",0,3,0,3,"dummy"
"206415",6,2,3,11,"dummy"
"206416",0,1,0,1,"dummy"
"206417",2,2,2,6,"dummy"
"206419",2,2,0,4,"dummy"
"206420",3,3,0,6,"dummy"
"206421",0,3,1,4,"dummy"
"206424",0,0,0,0,"dummy"
"206425",1,0,0,1,"dummy"
"206426",0,0,1,1,"dummy"
"206427",2,0,0,2,"dummy"
"206428",0,0,1,1,"dummy"
"206429",0,1,0,1,"dummy"
"206430",0,2,0,2,"dummy"
"206431",1,7,1,9,"dummy"
"206432",0,0,0,0,"dummy"
"206433",0,0,0,0,"dummy"
"206434",0,2,0,2,"dummy"
"206435",6,3,0,9,"dummy"
"206436",3,0,0,3,"dummy"
"206437",0,0,0,0,"dummy"
"206438",0,0,0,0,"dummy"
"206439",0,0,2,2,"dummy"
"206440",0,0,2,2,"dummy"
"206441",0,0,2,2,"dummy"
"206442",0,0,2,2,"dummy"
"206443",0,0,0,0,"dummy"
"206445",2,16,1,19,"dummy"
"206447",0,1,1,2,"dummy"
"206448",0,0,0,0,"dummy"
"206449",0,2,0,2,"dummy"
"206450",1,6,0,7,"dummy"
"206455",0,14,0,14,"dummy"
"206456",0,3,2,5,"dummy"
"206457",1,7,0,8,"dummy"
"206458",3,0,0,3,"dummy"
"206459",0,1,0,1,"dummy"
"206461",0,0,0,0,"dummy"
"206463",0,5,0,5,"dummy"
"206464",1,1,0,2,"dummy"
"206465",4,1,0,5,"dummy"
"206466",0,1,3,4,"dummy"
"206467",1,0,1,2,"dummy"
"206507",0,0,1,1,"dummy"
"206508",0,0,1,1,"dummy"
"206521",2,3,0,5,"dummy"
"206524",0,0,0,0,"dummy"
"206561",0,1,0,1,"dummy"
"206562",0,1,0,1,"dummy"
"206563",0,1,0,1,"dummy"
"206564",1,2,0,3,"dummy"
"206565",0,2,0,2,"dummy"
"206566",5,6,7,18,"dummy"
"206569",0,19,0,19,"dummy"
"206570",0,9,0,9,"dummy"
"206571",0,0,0,0,"dummy"
"206572",8,0,1,9,"dummy"
"206573",0,0,3,3,"dummy"
"206574",0,2,0,2,"dummy"
"206580",1,1,0,2,"dummy"
"206581",0,5,0,5,"dummy"
"206582",7,3,2,12,"dummy"
"206583",0,0,1,1,"dummy"
"206584",0,0,1,1,"dummy"
"206585",0,0,0,0,"dummy"
"206590",1,9,1,11,"dummy"
"206591",0,2,0,2,"dummy"
"206592",0,6,2,8,"dummy"
"206593",2,6,4,12,"dummy"
"206594",0,4,0,4,"dummy"
"206595",1,35,2,38,"dummy"
"206596",1,1,0,2,"dummy"
"206597",0,0,1,1,"dummy"
"206598",1,0,0,1,"dummy"
"206599",0,0,2,2,"dummy"
"206600",0,0,4,4,"dummy"
"206601",0,1,1,2,"dummy"
"206605",1,8,2,11,"dummy"
"206606",1,0,1,2,"dummy"
"206607",0,0,1,1,"dummy"
"206608",0,1,0,1,"dummy"
"206609",0,0,1,1,"dummy"
"206612",0,0,1,1,"dummy"
"206615",0,1,0,1,"dummy"
"206616",1,2,0,3,"dummy"
"206619",0,3,0,3,"dummy"
"206620",1,0,0,1,"dummy"
"206621",0,4,0,4,"dummy"
"206622",0,1,0,1,"dummy"
"206623",0,3,0,3,"dummy"
"206624",2,2,0,4,"dummy"
"206625",7,10,1,18,"dummy"
"206626",0,1,0,1,"dummy"
"206627",10,2,0,12,"dummy"
"206628",0,3,0,3,"dummy"
"206629",0,1,0,1,"dummy"
"206630",2,1,0,3,"dummy"
"206631",1,0,1,2,"dummy"
"206632",0,0,2,2,"dummy"
"206633",0,1,0,1,"dummy"
"206634",0,0,3,3,"dummy"
"206635",0,1,0,1,"dummy"
"206636",4,8,3,15,"dummy"
"206637",0,1,0,1,"dummy"
"206638",0,1,0,1,"dummy"
"206644",0,0,1,1,"dummy"
"206645",0,1,0,1,"dummy"
"206646",0,0,4,4,"dummy"
"206647",2,2,3,7,"dummy"
"206648",0,0,1,1,"dummy"
"206649",0,2,0,2,"dummy"
"206650",0,1,0,1,"dummy"
"206653",0,1,0,1,"dummy"
"206654",0,3,0,3,"dummy"
"206655",1,0,1,2,"dummy"
"206656",0,2,0,2,"dummy"
"206686",0,0,0,0,"dummy"
"206687",1,0,1,2,"dummy"
"206688",0,0,0,0,"dummy"
"206689",0,0,0,0,"dummy"
"206487",2,3,0,5,"dummy"
"206490",0,0,1,1,"dummy"
"206491",0,1,0,1,"dummy"
"206492",0,0,1,1,"dummy"
"206493",0,0,1,1,"dummy"
"206496",0,0,1,1,"dummy"
"206497",2,1,0,3,"dummy"
"206500",0,0,0,0,"dummy"
"206501",0,0,1,1,"dummy"
"206502",3,2,0,5,"dummy"
"206503",0,1,0,1,"dummy"
"206504",1,0,1,2,"dummy"
"206505",0,1,0,1,"dummy"
"206510",0,1,0,1,"dummy"
"206511",0,1,0,1,"dummy"
"206512",0,59,0,59,"dummy"
"206515",0,2,1,3,"dummy"
"206526",2,6,0,8,"dummy"
"206527",1,1,1,3,"dummy"
"206528",0,0,2,2,"dummy"
"206529",0,0,2,2,"dummy"
"206530",10,12,5,27,"dummy"
"206531",0,3,0,3,"dummy"
"206534",13,14,2,29,"dummy"
"206535",0,0,2,2,"dummy"
"206536",0,10,2,12,"dummy"
"206537",0,0,2,2,"dummy"
"206538",2,4,0,6,"dummy"
"206539",0,1,1,2,"dummy"
"206540",0,3,0,3,"dummy"
"206541",0,0,1,1,"dummy"
"206542",0,0,2,2,"dummy"
"206543",0,0,3,3,"dummy"
"206544",0,0,2,2,"dummy"
"206545",0,0,1,1,"dummy"
"206546",0,0,3,3,"dummy"
"206547",0,2,2,4,"dummy"
"206548",0,1,0,1,"dummy"
"206549",0,0,4,4,"dummy"
"206552",0,0,1,1,"dummy"
"206557",1,2,3,6,"dummy"
"206558",0,1,1,2,"dummy"
"206559",2,2,0,4,"dummy"
"206603",0,1,0,1,"dummy"
"206640",0,7,1,8,"dummy"
"206641",1,5,0,6,"dummy"
"206642",0,13,0,13,"dummy"
"206658",2,0,0,2,"dummy"
"206661",0,2,0,2,"dummy"
"206662",0,0,0,0,"dummy"
"206663",0,0,0,0,"dummy"
"206664",2,0,0,2,"dummy"
"206665",0,0,0,0,"dummy"
"206666",0,0,0,0,"dummy"
"206667",0,0,0,0,"dummy"
"206668",0,4,0,4,"dummy"
"206669",0,1,0,1,"dummy"
"206670",0,2,0,2,"dummy"
"206671",0,1,0,1,"dummy"
"206672",0,0,0,0,"dummy"
"206673",0,2,0,2,"dummy"
"206674",0,0,0,0,"dummy"
"206675",2,0,0,2,"dummy"
"206676",0,0,0,0,"dummy"
"206677",0,1,0,1,"dummy"
"206678",0,0,0,0,"dummy"
"206679",0,1,0,1,"dummy"
"206680",2,0,1,3,"dummy"
"206681",0,1,0,1,"dummy"
"206682",0,0,1,1,"dummy"
"206683",0,1,0,1,"dummy"
"206684",0,2,0,2,"dummy"
"206704",0,2,0,2,"dummy"
"206707",3,4,0,7,"dummy"
"206690",0,0,0,0,"dummy"
"206691",1,2,0,3,"dummy"
"206692",2,1,0,3,"dummy"
"206693",0,0,0,0,"dummy"
"206694",0,0,0,0,"dummy"
"206695",0,0,1,1,"dummy"
"206696",0,0,0,0,"dummy"
"206697",0,0,1,1,"dummy"
"206698",0,0,0,0,"dummy"
"206713",0,3,1,4,"dummy"
"206722",0,2,2,4,"dummy"
"206723",4,0,4,8,"dummy"
"206741",0,3,0,3,"dummy"
"206744",2,4,0,6,"dummy"
"206745",0,2,0,2,"dummy"
"206746",0,2,0,2,"dummy"
"206747",10,2,0,12,"dummy"
"206748",0,2,0,2,"dummy"
"206749",0,0,0,0,"dummy"
"206750",0,0,3,3,"dummy"
"206751",14,0,0,14,"dummy"
"206754",0,1,2,3,"dummy"
"206755",3,0,1,4,"dummy"
"206756",0,0,1,1,"dummy"
"206757",0,1,1,2,"dummy"
"206758",0,0,0,0,"dummy"
"206789",5,27,2,34,"dummy"
"206810",0,23,0,23,"dummy"
"206811",0,1,1,2,"dummy"
"206812",0,1,0,1,"dummy"
"206815",0,0,1,1,"dummy"
"206821",0,4,0,4,"dummy"
"206822",1,0,1,2,"dummy"
"206844",0,1,0,1,"dummy"
"206845",0,1,0,1,"dummy"
"206846",1,0,0,1,"dummy"
"206847",0,1,0,1,"dummy"
"206848",0,1,0,1,"dummy"
"206849",3,0,0,3,"dummy"
"206850",3,12,2,17,"dummy"
"206851",2,0,0,2,"dummy"
"206854",0,0,0,0,"dummy"
"206855",0,0,0,0,"dummy"
"206856",0,0,1,1,"dummy"
"206857",0,0,0,0,"dummy"
"206858",0,0,0,0,"dummy"
"206859",0,0,0,0,"dummy"
"206863",0,1,0,1,"dummy"
"206864",0,2,0,2,"dummy"
"206865",0,1,0,1,"dummy"
"206889",0,0,0,0,"dummy"
"206890",0,0,0,0,"dummy"
"206891",0,0,0,0,"dummy"
"206892",0,1,0,1,"dummy"
"206893",0,0,1,1,"dummy"
"206894",0,0,0,0,"dummy"
"206895",4,2,0,6,"dummy"
"206896",0,0,0,0,"dummy"
"206897",0,0,1,1,"dummy"
"206898",0,0,0,0,"dummy"
"206899",0,0,0,0,"dummy"
"206909",0,1,0,1,"dummy"
"206910",2,1,1,4,"dummy"
"206925",19,13,4,36,"dummy"
"206929",0,1,0,1,"dummy"
"206930",0,1,0,1,"dummy"
"206940",1,0,0,1,"dummy"
"206941",0,0,2,2,"dummy"
"206942",0,1,1,2,"dummy"
"206943",1,1,1,3,"dummy"
"206708",1,3,3,7,"dummy"
"206709",0,1,0,1,"dummy"
"206710",0,0,1,1,"dummy"
"206711",0,0,1,1,"dummy"
"206715",3,5,0,8,"dummy"
"206716",2,7,2,11,"dummy"
"206719",0,0,1,1,"dummy"
"206720",0,0,1,1,"dummy"
"206725",1,0,0,1,"dummy"
"206728",0,0,1,1,"dummy"
"206729",0,0,0,0,"dummy"
"206730",0,0,0,0,"dummy"
"206731",0,0,1,1,"dummy"
"206732",0,0,1,1,"dummy"
"206733",0,0,1,1,"dummy"
"206787",1,15,1,17,"dummy"
"206791",3,6,1,10,"dummy"
"206792",10,5,1,16,"dummy"
"206793",0,1,0,1,"dummy"
"206796",0,1,0,1,"dummy"
"206799",0,0,0,0,"dummy"
"206800",0,0,0,0,"dummy"
"206826",1,2,0,3,"dummy"
"206827",1,0,1,2,"dummy"
"206828",0,0,0,0,"dummy"
"206829",0,0,0,0,"dummy"
"206830",1,0,0,1,"dummy"
"206831",0,0,3,3,"dummy"
"206832",0,0,2,2,"dummy"
"206835",0,3,1,4,"dummy"
"206836",10,2,3,15,"dummy"
"206837",0,0,1,1,"dummy"
"206838",1,4,0,5,"dummy"
"206839",0,0,0,0,"dummy"
"206840",0,0,1,1,"dummy"
"206861",0,0,1,1,"dummy"
"206867",1,3,0,4,"dummy"
"206868",0,0,1,1,"dummy"
"206869",0,0,1,1,"dummy"
"206870",0,0,1,1,"dummy"
"206871",0,0,1,1,"dummy"
"206872",0,0,1,1,"dummy"
"206873",0,0,1,1,"dummy"
"206874",0,0,1,1,"dummy"
"206875",0,0,1,1,"dummy"
"206876",0,0,1,1,"dummy"
"206877",0,0,1,1,"dummy"
"206878",0,0,1,1,"dummy"
"206879",0,0,1,1,"dummy"
"206880",0,0,1,1,"dummy"
"206881",0,0,1,1,"dummy"
"206882",0,0,1,1,"dummy"
"206883",0,0,1,1,"dummy"
"206884",0,0,1,1,"dummy"
"206885",0,0,1,1,"dummy"
"206907",0,6,0,6,"dummy"
"206912",5,1,0,6,"dummy"
"206927",0,1,3,4,"dummy"
"206946",0,1,0,1,"dummy"
"206947",2,2,0,4,"dummy"
"206948",0,2,1,3,"dummy"
"206951",1,9,0,10,"dummy"
"206952",8,1,0,9,"dummy"
"206953",3,0,3,6,"dummy"
"206954",1,0,0,1,"dummy"
"206957",3,7,0,10,"dummy"
"206958",0,1,0,1,"dummy"
"206959",0,0,7,7,"dummy"
"206966",0,1,0,1,"dummy"
"206971",0,1,0,1,"dummy"
"206972",1,0,0,1,"dummy"
"206973",0,0,1,1,"dummy"
"206974",0,0,1,1,"dummy"
"206975",0,0,1,1,"dummy"
"206976",0,0,1,1,"dummy"
"206977",0,0,1,1,"dummy"
"206985",0,5,0,5,"dummy"
"206986",0,0,0,0,"dummy"
"206987",0,4,0,4,"dummy"
"206988",0,1,0,1,"dummy"
"206994",0,0,1,1,"dummy"
"206995",1,0,0,1,"dummy"
"206999",0,0,1,1,"dummy"
"207000",3,9,0,12,"dummy"
"207008",0,0,1,1,"dummy"
"207009",0,0,1,1,"dummy"
"207010",2,2,1,5,"dummy"
"207011",0,0,1,1,"dummy"
"207012",2,2,0,4,"dummy"
"207013",2,2,0,4,"dummy"
"207014",0,0,1,1,"dummy"
"207015",4,4,0,8,"dummy"
"207016",2,2,0,4,"dummy"
"207019",5,3,1,9,"dummy"
"207020",7,5,1,13,"dummy"
"207021",0,0,0,0,"dummy"
"207046",0,1,0,1,"dummy"
"207047",5,4,0,9,"dummy"
"207048",0,8,0,8,"dummy"
"207049",2,6,0,8,"dummy"
"207050",0,1,1,2,"dummy"
"207051",1,0,0,1,"dummy"
"207052",0,1,1,2,"dummy"
"207053",0,1,0,1,"dummy"
"207054",0,0,1,1,"dummy"
"207055",3,2,0,5,"dummy"
"207056",0,1,0,1,"dummy"
"207057",0,0,1,1,"dummy"
"207058",1,6,0,7,"dummy"
"207059",0,0,1,1,"dummy"
"207060",3,3,2,8,"dummy"
"207061",1,1,1,3,"dummy"
"207062",0,1,0,1,"dummy"
"207063",0,1,1,2,"dummy"
"207064",0,1,0,1,"dummy"
"207065",0,1,0,1,"dummy"
"207066",1,0,0,1,"dummy"
"207067",0,1,0,1,"dummy"
"207068",29,1,2,32,"dummy"
"207069",0,0,1,1,"dummy"
"207070",1,0,0,1,"dummy"
"207071",0,0,1,1,"dummy"
"207072",1,0,1,2,"dummy"
"207073",0,0,0,0,"dummy"
"207074",2,0,0,2,"dummy"
"207075",0,0,2,2,"dummy"
"207076",0,0,0,0,"dummy"
"207077",0,0,2,2,"dummy"
"207078",0,0,1,1,"dummy"
"207079",0,0,1,1,"dummy"
"207080",0,1,0,1,"dummy"
"207081",1,0,0,1,"dummy"
"207082",0,3,0,3,"dummy"
"207083",0,0,1,1,"dummy"
"207084",0,1,0,1,"dummy"
"207085",0,0,0,0,"dummy"
"207086",0,0,0,0,"dummy"
"207087",0,0,2,2,"dummy"
"207088",0,0,1,1,"dummy"
"207089",0,0,1,1,"dummy"
"207090",0,0,1,1,"dummy"
"207091",0,0,1,1,"dummy"
"207092",0,0,1,1,"dummy"
"207093",0,0,1,1,"dummy"
"207094",0,0,2,2,"dummy"
"207095",0,0,2,2,"dummy"
"207096",0,0,2,2,"dummy"
"207097",0,0,2,2,"dummy"
"207098",0,0,2,2,"dummy"
"207099",0,0,2,2,"dummy"
"207100",0,0,2,2,"dummy"
"207101",0,0,2,2,"dummy"
"207102",0,0,2,2,"dummy"
"207103",2,0,0,2,"dummy"
"207104",0,0,1,1,"dummy"
"207105",0,0,0,0,"dummy"
"207106",0,0,0,0,"dummy"
"207107",1,1,0,2,"dummy"
"207108",0,1,0,1,"dummy"
"207109",0,0,3,3,"dummy"
"206981",0,0,1,1,"dummy"
"206982",6,3,6,15,"dummy"
"206983",12,11,0,23,"dummy"
"206990",0,3,0,3,"dummy"
"206991",0,4,0,4,"dummy"
"206992",0,1,1,2,"dummy"
"206997",0,2,0,2,"dummy"
"207002",0,0,1,1,"dummy"
"207005",0,1,0,1,"dummy"
"207006",2,1,4,7,"dummy"
"207025",0,0,1,1,"dummy"
"207026",0,0,1,1,"dummy"
"207027",0,0,1,1,"dummy"
"207028",0,0,1,1,"dummy"
"207029",0,0,1,1,"dummy"
"207030",0,5,0,5,"dummy"
"207031",5,0,1,6,"dummy"
"207032",2,7,0,9,"dummy"
"207033",0,0,1,1,"dummy"
"207034",0,1,0,1,"dummy"
"207037",1,0,0,1,"dummy"
"207038",0,0,1,1,"dummy"
"207039",2,0,0,2,"dummy"
"207040",0,1,0,1,"dummy"
"207041",0,0,0,0,"dummy"
"207042",0,0,1,1,"dummy"
"207043",0,0,0,0,"dummy"
"207044",0,0,0,0,"dummy"
"207110",0,0,1,1,"dummy"
"207111",1,0,0,1,"dummy"
"207112",1,1,0,2,"dummy"
"207113",0,0,1,1,"dummy"
"207114",0,0,1,1,"dummy"
"207115",0,1,0,1,"dummy"
"207116",0,1,1,2,"dummy"
"207117",0,0,1,1,"dummy"
"207118",0,0,1,1,"dummy"
"207119",0,0,1,1,"dummy"
"207120",0,0,1,1,"dummy"
"207121",0,0,1,1,"dummy"
"207122",0,0,1,1,"dummy"
"207123",0,0,1,1,"dummy"
"207124",0,0,1,1,"dummy"
"207125",0,0,1,1,"dummy"
"207126",0,0,1,1,"dummy"
"207127",0,0,1,1,"dummy"
"207128",0,0,1,1,"dummy"
"207129",0,0,1,1,"dummy"
"207130",0,0,1,1,"dummy"
"207131",0,0,1,1,"dummy"
"207132",0,0,1,1,"dummy"
"207133",0,0,1,1,"dummy"
"207134",0,0,1,1,"dummy"
"207135",0,0,1,1,"dummy"
"207136",0,0,1,1,"dummy"
"207137",0,0,1,1,"dummy"
"207138",0,0,1,1,"dummy"
"207139",0,0,1,1,"dummy"
"207142",1,0,0,1,"dummy"
"207143",0,1,0,1,"dummy"
"207144",0,0,2,2,"dummy"
"207145",0,2,0,2,"dummy"
"207146",0,1,0,1,"dummy"
"207147",4,0,2,6,"dummy"
"207148",0,4,2,6,"dummy"
"207149",5,4,2,11,"dummy"
"207150",0,0,2,2,"dummy"
"207151",0,1,0,1,"dummy"
"207152",1,1,0,2,"dummy"
"207153",0,2,0,2,"dummy"
"207161",0,1,0,1,"dummy"
"207162",0,0,0,0,"dummy"
"207163",2,1,0,3,"dummy"
"207164",0,4,0,4,"dummy"
"207165",4,0,0,4,"dummy"
"207174",0,0,0,0,"dummy"
"207175",0,0,1,1,"dummy"
"207176",0,0,1,1,"dummy"
"207178",0,4,1,5,"dummy"
"207179",1,2,0,3,"dummy"
"207180",1,0,0,1,"dummy"
"207184",0,0,1,1,"dummy"
"207188",0,1,0,1,"dummy"
"207189",0,1,1,2,"dummy"
"207190",0,1,1,2,"dummy"
"207191",0,0,1,1,"dummy"
"207192",0,0,1,1,"dummy"
"207193",0,1,0,1,"dummy"
"207194",0,4,0,4,"dummy"
"207195",1,0,0,1,"dummy"
"207196",0,1,1,2,"dummy"
"207197",1,0,0,1,"dummy"
"207198",1,0,1,2,"dummy"
"207199",0,0,1,1,"dummy"
"207200",0,0,1,1,"dummy"
"207202",3,0,3,6,"dummy"
"207203",0,0,3,3,"dummy"
"207205",1,1,0,2,"dummy"
"207207",2,9,1,12,"dummy"
"207209",0,0,1,1,"dummy"
"207210",0,1,0,1,"dummy"
"207213",0,0,2,2,"dummy"
"207214",0,1,0,1,"dummy"
"207215",0,0,1,1,"dummy"
"207216",0,2,1,3,"dummy"
"207217",0,0,2,2,"dummy"
"207218",1,0,0,1,"dummy"
"207219",1,1,0,2,"dummy"
"207222",0,5,0,5,"dummy"
"207224",0,0,1,1,"dummy"
"207225",0,0,0,0,"dummy"
"207226",0,0,0,0,"dummy"
"207227",3,1,1,5,"dummy"
"207228",4,1,2,7,"dummy"
"207229",1,0,0,1,"dummy"
"207232",9,0,0,9,"dummy"
"207234",0,1,0,1,"dummy"
"207237",0,1,2,3,"dummy"
"207238",1,0,0,1,"dummy"
"207239",1,8,0,9,"dummy"
"207240",0,6,0,6,"dummy"
"207241",0,1,0,1,"dummy"
"207242",1,1,2,4,"dummy"
"207243",0,2,0,2,"dummy"
"207244",0,5,0,5,"dummy"
"207245",0,2,1,3,"dummy"
"207246",3,0,0,3,"dummy"
"207250",3,21,0,24,"dummy"
"207251",3,2,0,5,"dummy"
"207252",17,4,2,23,"dummy"
"207253",10,21,4,35,"dummy"
"207255",2,4,0,6,"dummy"
"207256",0,1,1,2,"dummy"
"207257",0,6,0,6,"dummy"
"207259",0,0,1,1,"dummy"
"207260",0,2,1,3,"dummy"
"207261",0,0,1,1,"dummy"
"207262",0,0,3,3,"dummy"
"207263",0,3,2,5,"dummy"
"207264",0,1,2,3,"dummy"
"207265",0,0,2,2,"dummy"
"207266",6,5,4,15,"dummy"
"207267",0,5,0,5,"dummy"
"207268",3,9,1,13,"dummy"
"207269",11,0,3,14,"dummy"
"207272",0,1,0,1,"dummy"
"207273",0,3,1,4,"dummy"
"207276",2,0,0,2,"dummy"
"207278",0,0,1,1,"dummy"
"207279",0,0,0,0,"dummy"
"207282",0,2,0,2,"dummy"
"207284",2,0,3,5,"dummy"
"207285",1,0,0,1,"dummy"
"207289",6,3,0,9,"dummy"
"207291",1,4,0,5,"dummy"
"207295",0,0,1,1,"dummy"
"207298",19,6,1,26,"dummy"
"207299",2,0,0,2,"dummy"
"207301",1,1,0,2,"dummy"
"207302",0,0,1,1,"dummy"
"207303",0,1,0,1,"dummy"
"207315",0,0,2,2,"dummy"
"207316",0,0,2,2,"dummy"
"207319",0,0,1,1,"dummy"
"207323",3,0,0,3,"dummy"
"207324",0,0,1,1,"dummy"
"207325",2,0,0,2,"dummy"
"207328",0,7,0,7,"dummy"
"207332",0,1,0,1,"dummy"
"207333",1,1,0,2,"dummy"
"207334",0,0,0,0,"dummy"
"207338",3,5,0,8,"dummy"
"207339",2,3,1,6,"dummy"
"207340",3,3,1,7,"dummy"
"207341",0,5,0,5,"dummy"
"207342",0,6,4,10,"dummy"
"207343",0,3,0,3,"dummy"
"207344",0,2,0,2,"dummy"
"207345",2,16,25,43,"dummy"
"207346",1,1,0,2,"dummy"
"207347",0,2,0,2,"dummy"
"207348",0,24,0,24,"dummy"
"207349",13,0,0,13,"dummy"
"207350",0,1,0,1,"dummy"
"207351",1,8,1,10,"dummy"
"207356",7,0,1,8,"dummy"
"207358",0,1,0,1,"dummy"
"207359",5,0,2,7,"dummy"
"207362",11,0,4,15,"dummy"
"207364",0,2,0,2,"dummy"
"207365",5,5,3,13,"dummy"
"207366",0,1,0,1,"dummy"
"207367",2,0,3,5,"dummy"
"207368",3,0,1,4,"dummy"
"207370",0,1,0,1,"dummy"
"207371",0,0,0,0,"dummy"
"207372",0,0,1,1,"dummy"
"207373",0,0,1,1,"dummy"
"207374",0,0,1,1,"dummy"
"207375",1,0,0,1,"dummy"
"207376",0,0,1,1,"dummy"
"207382",2,0,0,2,"dummy"
"207383",0,1,0,1,"dummy"
"207384",2,5,0,7,"dummy"
"207385",0,4,0,4,"dummy"
"207386",3,2,2,7,"dummy"
"207387",0,1,0,1,"dummy"
"207388",0,2,0,2,"dummy"
"207389",1,2,0,3,"dummy"
"207390",3,0,0,3,"dummy"
"207391",0,0,1,1,"dummy"
"207392",1,0,0,1,"dummy"
"207393",0,1,1,2,"dummy"
"207394",0,0,2,2,"dummy"
"207395",0,0,0,0,"dummy"
"207396",0,0,1,1,"dummy"
"207397",0,0,1,1,"dummy"
"207401",0,1,0,1,"dummy"
"207402",1,0,0,1,"dummy"
"207403",0,1,0,1,"dummy"
"207404",1,0,0,1,"dummy"
"207405",0,1,0,1,"dummy"
"207406",1,0,0,1,"dummy"
"207423",0,1,0,1,"dummy"
"207425",0,0,1,1,"dummy"
"207427",4,6,2,12,"dummy"
"207428",0,4,0,4,"dummy"
"207429",0,4,0,4,"dummy"
"207430",0,0,1,1,"dummy"
"207431",0,0,2,2,"dummy"
"207432",0,2,0,2,"dummy"
"207433",0,0,1,1,"dummy"
"207435",1,1,0,2,"dummy"
"207436",0,0,1,1,"dummy"
"207437",0,0,1,1,"dummy"
"207438",0,0,1,1,"dummy"
"207439",0,0,1,1,"dummy"
"207440",0,2,0,2,"dummy"
"207441",0,1,1,2,"dummy"
"207442",0,0,1,1,"dummy"
"207443",0,0,1,1,"dummy"
"207444",0,0,1,1,"dummy"
"207445",0,0,1,1,"dummy"
"207448",2,5,1,8,"dummy"
"207449",3,2,1,6,"dummy"
"207450",0,0,1,1,"dummy"
"207455",0,0,1,1,"dummy"
"207457",7,10,1,18,"dummy"
"207459",1,9,2,12,"dummy"
"207460",11,1,1,13,"dummy"
"207463",4,10,1,15,"dummy"
"207464",0,2,0,2,"dummy"
"207465",5,1,0,6,"dummy"
"207466",1,9,2,12,"dummy"
"207467",0,6,1,7,"dummy"
"207468",0,3,1,4,"dummy"
"207469",1,1,1,3,"dummy"
"207470",1,0,0,1,"dummy"
"207471",0,0,1,1,"dummy"
"207473",3,2,1,6,"dummy"
"207474",0,2,0,2,"dummy"
"207475",4,13,2,19,"dummy"
"207476",1,1,0,2,"dummy"
"207477",1,0,0,1,"dummy"
"207478",0,0,0,0,"dummy"
"207479",3,3,1,7,"dummy"
"207480",1,3,0,4,"dummy"
"207481",1,2,0,3,"dummy"
"207482",0,0,0,0,"dummy"
"207485",0,0,1,1,"dummy"
"207486",0,0,1,1,"dummy"
"207487",0,0,0,0,"dummy"
"207490",0,0,1,1,"dummy"
"207492",0,0,1,1,"dummy"
"207495",0,0,1,1,"dummy"
"207497",0,0,1,1,"dummy"
"207498",0,0,1,1,"dummy"
"207499",0,0,1,1,"dummy"
"207500",0,0,1,1,"dummy"
"207501",0,0,1,1,"dummy"
"207502",0,0,1,1,"dummy"
"207503",6,6,2,14,"dummy"
"207504",0,0,1,1,"dummy"
"207505",0,0,1,1,"dummy"
"207512",0,1,0,1,"dummy"
"207513",0,0,0,0,"dummy"
"207518",0,0,1,1,"dummy"
"207519",0,0,2,2,"dummy"
"207522",1,1,0,2,"dummy"
"207524",0,0,2,2,"dummy"
"207525",1,6,2,9,"dummy"
"207528",0,15,0,15,"dummy"
"207529",0,2,0,2,"dummy"
"207531",0,0,1,1,"dummy"
"207532",0,0,1,1,"dummy"
"207533",0,0,1,1,"dummy"
"207543",0,5,1,6,"dummy"
"207544",1,0,0,1,"dummy"
"207545",6,8,2,16,"dummy"
"207546",11,9,0,20,"dummy"
"207549",3,2,0,5,"dummy"
"207553",1,6,0,7,"dummy"
"207555",0,1,2,3,"dummy"
"207556",0,0,2,2,"dummy"
"207557",0,0,0,0,"dummy"
"207558",9,3,0,12,"dummy"
"207559",0,1,0,1,"dummy"
"207560",0,2,0,2,"dummy"
"207561",3,2,1,6,"dummy"
"207562",0,0,1,1,"dummy"
"207563",0,3,0,3,"dummy"
"207564",0,3,1,4,"dummy"
"207565",0,0,1,1,"dummy"
"207566",2,0,2,4,"dummy"
"207567",0,1,1,2,"dummy"
"207568",0,0,1,1,"dummy"
"207569",0,0,1,1,"dummy"
"207570",0,0,1,1,"dummy"
"207571",1,0,0,1,"dummy"
"207572",3,5,0,8,"dummy"
"207573",1,0,1,2,"dummy"
"207574",6,1,1,8,"dummy"
"207575",0,5,3,8,"dummy"
"207576",2,0,0,2,"dummy"
"207577",0,0,1,1,"dummy"
"207578",1,0,0,1,"dummy"
"207586",0,0,0,0,"dummy"
"207587",0,1,0,1,"dummy"
"207590",0,2,0,2,"dummy"
"207591",0,0,1,1,"dummy"
"207592",2,2,1,5,"dummy"
"207602",0,0,1,1,"dummy"
"207603",22,1,2,25,"dummy"
"207604",0,0,1,1,"dummy"
"207605",0,0,1,1,"dummy"
"207606",0,0,1,1,"dummy"
"207607",0,0,1,1,"dummy"
"207611",0,1,0,1,"dummy"
"207618",6,0,2,8,"dummy"
"207619",4,9,0,13,"dummy"
"207642",1,1,0,2,"dummy"
"207684",2,1,1,4,"dummy"
"207685",25,43,10,78,"dummy"
"207686",1,1,1,3,"dummy"
"207687",2,5,2,9,"dummy"
"207688",0,1,0,1,"dummy"
"207689",1,0,0,1,"dummy"
"207690",0,0,1,1,"dummy"
"207691",0,3,1,4,"dummy"
"207692",3,3,0,6,"dummy"
"207693",0,0,1,1,"dummy"
"207694",0,0,0,0,"dummy"
"207695",0,0,4,4,"dummy"
"207698",0,0,1,1,"dummy"
"207703",0,0,1,1,"dummy"
"207704",4,13,2,19,"dummy"
"207705",13,4,2,19,"dummy"
"207706",0,0,1,1,"dummy"
"207707",1,0,1,2,"dummy"
"207724",2,2,2,6,"dummy"
"207727",0,1,2,3,"dummy"
"207728",0,0,0,0,"dummy"
"207729",0,2,0,2,"dummy"
"207730",5,0,2,7,"dummy"
"207731",1,0,0,1,"dummy"
"207735",1,17,1,19,"dummy"
"207736",0,1,0,1,"dummy"
"207737",0,1,0,1,"dummy"
"207738",0,0,3,3,"dummy"
"207739",0,0,3,3,"dummy"
"207740",0,0,3,3,"dummy"
"207741",0,0,3,3,"dummy"
"207742",0,0,2,2,"dummy"
"207743",0,0,2,2,"dummy"
"207744",0,0,3,3,"dummy"
"207745",0,0,3,3,"dummy"
"207746",0,0,3,3,"dummy"
"207747",0,0,3,3,"dummy"
"207748",0,0,3,3,"dummy"
"207749",0,1,0,1,"dummy"
"207750",0,1,0,1,"dummy"
"207751",0,0,1,1,"dummy"
"207755",0,1,0,1,"dummy"
"207756",0,4,1,5,"dummy"
"207757",2,0,0,2,"dummy"
"207812",0,1,3,4,"dummy"
"207819",0,0,0,0,"dummy"
"207580",0,4,0,4,"dummy"
"207581",0,1,0,1,"dummy"
"207582",2,4,1,7,"dummy"
"207583",0,0,3,3,"dummy"
"207584",0,2,0,2,"dummy"
"207609",0,0,0,0,"dummy"
"207621",7,27,1,35,"dummy"
"207622",0,7,0,7,"dummy"
"207623",0,1,3,4,"dummy"
"207624",5,5,1,11,"dummy"
"207625",1,0,0,1,"dummy"
"207626",0,1,0,1,"dummy"
"207627",0,0,0,0,"dummy"
"207628",0,0,0,0,"dummy"
"207629",0,0,0,0,"dummy"
"207630",0,0,0,0,"dummy"
"207631",10,10,1,21,"dummy"
"207644",0,2,0,2,"dummy"
"207645",1,0,0,1,"dummy"
"207646",0,2,0,2,"dummy"
"207647",2,1,0,3,"dummy"
"207648",0,1,0,1,"dummy"
"207649",1,6,1,8,"dummy"
"207650",0,2,0,2,"dummy"
"207651",1,2,0,3,"dummy"
"207652",0,5,0,5,"dummy"
"207653",0,0,1,1,"dummy"
"207654",0,2,1,3,"dummy"
"207655",0,3,0,3,"dummy"
"207656",0,0,0,0,"dummy"
"207657",10,5,0,15,"dummy"
"207658",3,2,0,5,"dummy"
"207659",0,2,0,2,"dummy"
"207660",1,1,1,3,"dummy"
"207661",0,3,0,3,"dummy"
"207662",1,0,0,1,"dummy"
"207663",0,1,0,1,"dummy"
"207664",0,8,0,8,"dummy"
"207665",0,2,0,2,"dummy"
"207666",1,5,0,6,"dummy"
"207667",4,2,0,6,"dummy"
"207668",1,0,0,1,"dummy"
"207669",0,4,0,4,"dummy"
"207670",0,0,1,1,"dummy"
"207671",3,0,0,3,"dummy"
"207672",0,2,0,2,"dummy"
"207673",9,0,1,10,"dummy"
"207676",0,2,0,2,"dummy"
"207677",0,1,0,1,"dummy"
"207678",0,4,0,4,"dummy"
"207679",0,0,0,0,"dummy"
"207682",2,6,0,8,"dummy"
"207709",0,0,1,1,"dummy"
"207716",1,4,0,5,"dummy"
"207719",7,1,1,9,"dummy"
"207722",0,0,2,2,"dummy"
"207733",2,0,3,5,"dummy"
"207753",0,0,2,2,"dummy"
"207761",0,0,1,1,"dummy"
"207762",0,1,0,1,"dummy"
"207763",0,3,0,3,"dummy"
"207764",0,0,1,1,"dummy"
"207809",0,2,0,2,"dummy"
"207810",0,0,0,0,"dummy"
"207837",2,3,2,7,"dummy"
"207838",0,9,0,9,"dummy"
"207839",1,3,0,4,"dummy"
"207840",9,1,0,10,"dummy"
"207841",4,3,0,7,"dummy"
"207842",3,5,0,8,"dummy"
"207820",1,0,1,2,"dummy"
"207821",1,0,2,3,"dummy"
"207822",1,1,1,3,"dummy"
"207823",3,5,0,8,"dummy"
"207824",0,1,0,1,"dummy"
"207825",1,2,0,3,"dummy"
"207826",0,1,0,1,"dummy"
"207827",0,2,0,2,"dummy"
"207828",0,0,0,0,"dummy"
"207829",0,0,1,1,"dummy"
"207832",0,1,2,3,"dummy"
"207833",0,1,0,1,"dummy"
"207859",2,10,0,12,"dummy"
"207860",1,2,0,3,"dummy"
"207861",17,11,4,32,"dummy"
"207862",6,0,0,6,"dummy"
"207863",0,3,0,3,"dummy"
"207864",1,4,1,6,"dummy"
"207865",0,1,0,1,"dummy"
"207870",0,1,0,1,"dummy"
"207871",0,1,0,1,"dummy"
"207877",0,1,4,5,"dummy"
"207878",0,0,1,1,"dummy"
"207879",0,0,1,1,"dummy"
"207880",2,1,0,3,"dummy"
"207881",0,0,1,1,"dummy"
"207918",0,0,2,2,"dummy"
"207919",0,1,0,1,"dummy"
"207920",2,2,0,4,"dummy"
"207943",1,1,2,4,"dummy"
"207944",4,2,1,7,"dummy"
"207945",0,0,0,0,"dummy"
"207948",0,1,0,1,"dummy"
"207949",0,0,1,1,"dummy"
"207953",0,10,4,14,"dummy"
"207954",0,3,0,3,"dummy"
"207955",0,2,0,2,"dummy"
"207956",0,1,0,1,"dummy"
"207957",2,2,1,5,"dummy"
"207958",1,0,0,1,"dummy"
"207996",3,6,1,10,"dummy"
"207997",4,0,2,6,"dummy"
"207998",0,6,2,8,"dummy"
"207999",0,0,1,1,"dummy"
"208000",0,1,0,1,"dummy"
"208001",0,2,0,2,"dummy"
"208002",0,1,0,1,"dummy"
"208003",8,6,0,14,"dummy"
"208004",2,2,1,5,"dummy"
"208005",1,2,0,3,"dummy"
"208006",8,6,0,14,"dummy"
"208007",1,0,0,1,"dummy"
"208010",0,0,0,0,"dummy"
"208011",0,2,0,2,"dummy"
"208012",0,0,1,1,"dummy"
"208013",3,0,0,3,"dummy"
"208018",0,0,2,2,"dummy"
"208019",0,1,0,1,"dummy"
"208020",0,0,0,0,"dummy"
"208021",0,4,0,4,"dummy"
"208022",0,1,0,1,"dummy"
"208023",0,0,1,1,"dummy"
"208024",0,1,0,1,"dummy"
"208025",6,0,1,7,"dummy"
"208026",0,1,0,1,"dummy"
"208027",0,0,1,1,"dummy"
"208028",0,0,1,1,"dummy"
"208029",0,0,1,1,"dummy"
"208030",0,1,0,1,"dummy"
"208031",0,0,1,1,"dummy"
"208034",0,0,2,2,"dummy"
"208035",0,0,1,1,"dummy"
"208036",0,0,2,2,"dummy"
"208037",0,0,8,8,"dummy"
"208038",0,0,8,8,"dummy"
"208039",1,2,12,15,"dummy"
"208042",1,0,0,1,"dummy"
"208043",0,1,1,2,"dummy"
"208044",4,5,0,9,"dummy"
"207843",2,11,1,14,"dummy"
"207844",0,1,0,1,"dummy"
"207845",2,5,0,7,"dummy"
"207846",2,2,2,6,"dummy"
"207847",5,7,1,13,"dummy"
"207848",0,0,1,1,"dummy"
"207849",5,6,1,12,"dummy"
"207850",0,0,0,0,"dummy"
"207851",0,0,2,2,"dummy"
"207852",0,1,0,1,"dummy"
"207853",1,5,0,6,"dummy"
"207854",17,1,0,18,"dummy"
"207855",0,17,0,17,"dummy"
"207856",0,1,0,1,"dummy"
"207857",0,0,4,4,"dummy"
"207873",2,0,1,3,"dummy"
"207874",1,0,0,1,"dummy"
"207875",2,2,0,4,"dummy"
"207883",0,0,1,1,"dummy"
"207884",0,0,1,1,"dummy"
"207885",0,0,1,1,"dummy"
"207886",0,0,1,1,"dummy"
"207887",1,1,2,4,"dummy"
"207888",0,0,1,1,"dummy"
"207889",0,0,1,1,"dummy"
"207890",0,2,1,3,"dummy"
"207891",0,1,0,1,"dummy"
"207892",4,1,0,5,"dummy"
"207893",0,0,1,1,"dummy"
"207894",0,1,1,2,"dummy"
"207895",0,0,1,1,"dummy"
"207896",0,0,2,2,"dummy"
"207897",0,0,1,1,"dummy"
"207898",0,0,1,1,"dummy"
"207899",0,0,1,1,"dummy"
"207900",3,2,2,7,"dummy"
"207901",0,0,1,1,"dummy"
"207902",0,0,2,2,"dummy"
"207903",0,0,1,1,"dummy"
"207904",1,0,0,1,"dummy"
"207905",1,1,0,2,"dummy"
"207906",0,0,1,1,"dummy"
"207907",0,0,1,1,"dummy"
"207908",0,0,1,1,"dummy"
"207909",0,0,1,1,"dummy"
"207910",0,0,1,1,"dummy"
"207911",0,0,1,1,"dummy"
"207912",0,1,1,2,"dummy"
"207913",0,0,1,1,"dummy"
"207914",0,0,3,3,"dummy"
"207922",0,0,1,1,"dummy"
"207923",0,0,0,0,"dummy"
"207924",0,0,1,1,"dummy"
"207936",0,1,0,1,"dummy"
"207937",0,1,0,1,"dummy"
"207938",0,1,1,2,"dummy"
"207939",0,1,0,1,"dummy"
"207951",0,0,2,2,"dummy"
"207970",0,1,0,1,"dummy"
"208047",0,2,0,2,"dummy"
"208057",0,0,1,1,"dummy"
"208058",0,0,1,1,"dummy"
"208059",0,0,0,0,"dummy"
"208073",0,1,3,4,"dummy"
"208074",0,1,0,1,"dummy"
"208098",0,1,0,1,"dummy"
"208099",0,0,1,1,"dummy"
"208100",0,2,1,3,"dummy"
"208101",0,0,1,1,"dummy"
"208102",0,0,1,1,"dummy"
"208105",3,4,3,10,"dummy"
"208110",1,10,0,11,"dummy"
"208111",1,0,0,1,"dummy"
"208112",2,0,0,2,"dummy"
"208045",3,6,0,9,"dummy"
"208049",0,0,5,5,"dummy"
"208050",0,2,0,2,"dummy"
"208051",4,3,3,10,"dummy"
"208052",1,0,1,2,"dummy"
"208053",0,0,1,1,"dummy"
"208054",0,1,0,1,"dummy"
"208055",0,1,0,1,"dummy"
"208061",3,0,2,5,"dummy"
"208068",1,1,2,4,"dummy"
"208069",0,1,0,1,"dummy"
"208070",8,8,0,16,"dummy"
"208071",8,8,0,16,"dummy"
"208076",1,1,0,2,"dummy"
"208077",0,0,1,1,"dummy"
"208078",0,1,0,1,"dummy"
"208079",0,0,1,1,"dummy"
"208080",1,1,1,3,"dummy"
"208081",0,2,0,2,"dummy"
"208082",1,2,0,3,"dummy"
"208083",0,0,1,1,"dummy"
"208092",0,0,0,0,"dummy"
"208093",0,1,0,1,"dummy"
"208096",0,1,0,1,"dummy"
"208107",0,1,0,1,"dummy"
"208108",5,6,2,13,"dummy"
"208115",0,0,1,1,"dummy"
"208118",8,12,0,20,"dummy"
"208119",5,3,1,9,"dummy"
"208120",0,1,0,1,"dummy"
"208121",2,11,0,13,"dummy"
"208122",0,0,0,0,"dummy"
"208133",0,0,1,1,"dummy"
"208136",0,2,0,2,"dummy"
"208140",1,3,1,5,"dummy"
"208141",0,1,0,1,"dummy"
"208171",4,4,1,9,"dummy"
"208172",0,0,2,2,"dummy"
"208173",0,0,0,0,"dummy"
"208174",0,0,1,1,"dummy"
"208175",0,0,1,1,"dummy"
"208176",6,2,2,10,"dummy"
"208177",0,1,0,1,"dummy"
"208178",2,2,0,4,"dummy"
"208179",0,0,1,1,"dummy"
"208180",0,0,2,2,"dummy"
"208181",0,0,1,1,"dummy"
"208182",0,0,1,1,"dummy"
"208183",0,0,1,1,"dummy"
"208184",0,0,1,1,"dummy"
"208185",6,6,2,14,"dummy"
"208186",0,0,1,1,"dummy"
"208189",2,11,0,13,"dummy"
"208190",0,1,1,2,"dummy"
"208191",0,2,0,2,"dummy"
"208192",0,5,1,6,"dummy"
"208193",2,4,1,7,"dummy"
"208194",0,1,0,1,"dummy"
"208198",0,1,2,3,"dummy"
"208201",0,0,0,0,"dummy"
"208202",0,0,1,1,"dummy"
"208203",0,1,0,1,"dummy"
"208204",2,2,5,9,"dummy"
"208217",2,4,0,6,"dummy"
"208218",1,1,0,2,"dummy"
"208219",0,0,0,0,"dummy"
"208226",1,0,0,1,"dummy"
"208227",8,3,6,17,"dummy"
"208228",1,4,0,5,"dummy"
"208229",1,1,2,4,"dummy"
"208230",9,14,7,30,"dummy"
"208231",7,4,3,14,"dummy"
"208237",0,0,1,1,"dummy"
"208246",0,0,2,2,"dummy"
"208247",0,11,0,11,"dummy"
"208248",0,2,0,2,"dummy"
"208249",0,1,0,1,"dummy"
"208250",0,1,0,1,"dummy"
"208251",0,0,1,1,"dummy"
"208252",0,0,1,1,"dummy"
"208113",0,2,0,2,"dummy"
"208124",5,4,0,9,"dummy"
"208125",0,0,0,0,"dummy"
"208126",0,0,2,2,"dummy"
"208127",4,4,0,8,"dummy"
"208128",0,0,1,1,"dummy"
"208129",0,0,1,1,"dummy"
"208130",1,1,2,4,"dummy"
"208131",0,0,1,1,"dummy"
"208138",1,0,1,2,"dummy"
"208147",1,4,2,7,"dummy"
"208148",0,1,0,1,"dummy"
"208149",1,0,1,2,"dummy"
"208150",0,1,0,1,"dummy"
"208151",0,0,1,1,"dummy"
"208196",2,1,2,5,"dummy"
"208233",0,1,0,1,"dummy"
"208234",0,4,0,4,"dummy"
"208235",0,1,0,1,"dummy"
"208239",0,0,1,1,"dummy"
"208242",0,4,0,4,"dummy"
"208243",2,2,0,4,"dummy"
"208244",0,1,0,1,"dummy"
"208262",0,1,1,2,"dummy"
"208263",0,0,1,1,"dummy"
"208264",0,0,3,3,"dummy"
"208265",0,0,1,1,"dummy"
"208269",1,7,1,9,"dummy"
"208270",0,3,0,3,"dummy"
"208271",3,1,1,5,"dummy"
"208272",1,2,1,4,"dummy"
"208273",4,0,1,5,"dummy"
"208274",3,1,0,4,"dummy"
"208275",0,1,2,3,"dummy"
"208280",0,0,0,0,"dummy"
"208281",0,0,0,0,"dummy"
"208282",0,0,0,0,"dummy"
"208283",0,1,0,1,"dummy"
"208284",0,0,0,0,"dummy"
"208253",0,0,0,0,"dummy"
"208256",1,0,1,2,"dummy"
"208267",1,4,0,5,"dummy"
"208277",2,0,2,4,"dummy"
"208278",2,1,0,3,"dummy"
"208298",0,0,1,1,"dummy"
"208299",0,0,1,1,"dummy"
"208300",0,0,1,1,"dummy"
"208361",1,4,1,6,"dummy"
"208362",3,2,0,5,"dummy"
"208456",0,0,1,1,"dummy"
"208457",0,0,1,1,"dummy"
"208458",0,0,1,1,"dummy"
"208479",2,4,0,6,"dummy"
"208480",0,0,0,0,"dummy"
"208483",0,0,1,1,"dummy"
"208484",0,0,1,1,"dummy"
"208485",0,0,1,1,"dummy"
"208486",0,0,1,1,"dummy"
"208487",0,0,1,1,"dummy"
"208488",0,0,1,1,"dummy"
"208489",7,2,1,10,"dummy"
"208490",8,3,1,12,"dummy"
"208491",0,0,0,0,"dummy"
"208492",2,2,1,5,"dummy"
"208493",0,0,1,1,"dummy"
"208494",0,0,1,1,"dummy"
"208495",0,0,1,1,"dummy"
"208496",0,0,1,1,"dummy"
"208497",2,4,1,7,"dummy"
"208498",0,0,1,1,"dummy"
"208499",0,0,1,1,"dummy"
"208500",4,2,1,7,"dummy"
"208501",2,0,0,2,"dummy"
"208502",0,0,1,1,"dummy"
"208503",0,0,1,1,"dummy"
"208504",0,0,1,1,"dummy"
"208505",0,0,2,2,"dummy"
"208506",0,0,1,1,"dummy"
"208507",0,0,1,1,"dummy"
"208508",0,3,1,4,"dummy"
"208509",0,0,1,1,"dummy"
"208510",0,0,1,1,"dummy"
"208511",0,0,1,1,"dummy"
"208512",0,0,1,1,"dummy"
"208513",0,0,1,1,"dummy"
"208514",0,0,1,1,"dummy"
"208515",0,0,1,1,"dummy"
"208516",0,0,1,1,"dummy"
"208517",0,0,1,1,"dummy"
"208518",0,0,1,1,"dummy"
"208519",1,0,0,1,"dummy"
"208520",0,0,1,1,"dummy"
"208521",0,0,1,1,"dummy"
"208522",0,0,1,1,"dummy"
"208523",0,0,1,1,"dummy"
"208524",0,0,1,1,"dummy"
"208525",0,0,1,1,"dummy"
"208526",0,0,1,1,"dummy"
"208527",0,0,1,1,"dummy"
"208528",0,0,1,1,"dummy"
"208529",0,0,1,1,"dummy"
"208354",0,0,1,1,"dummy"
"208355",0,2,0,2,"dummy"
"208356",0,1,0,1,"dummy"
"208359",0,0,2,2,"dummy"
"208364",0,2,2,4,"dummy"
"208365",0,1,0,1,"dummy"
"208366",0,1,0,1,"dummy"
"208371",0,0,1,1,"dummy"
"208397",4,2,0,6,"dummy"
"208398",0,1,0,1,"dummy"
"208399",0,4,0,4,"dummy"
"208400",0,1,1,2,"dummy"
"208401",0,1,2,3,"dummy"
"208402",0,1,0,1,"dummy"
"208403",0,1,0,1,"dummy"
"208404",0,2,0,2,"dummy"
"208405",0,1,0,1,"dummy"
"208406",1,0,0,1,"dummy"
"208409",0,3,0,3,"dummy"
"208410",0,0,1,1,"dummy"
"208411",5,1,0,6,"dummy"
"208460",0,0,0,0,"dummy"
"208461",0,18,0,18,"dummy"
"208462",18,0,0,18,"dummy"
"208466",0,1,0,1,"dummy"
"208467",1,3,3,7,"dummy"
"208477",0,0,1,1,"dummy"
"208570",14,3,2,19,"dummy"
"208571",0,0,1,1,"dummy"
"208530",0,0,1,1,"dummy"
"208531",0,0,1,1,"dummy"
"208532",0,0,1,1,"dummy"
"208533",0,0,1,1,"dummy"
"208534",0,0,1,1,"dummy"
"208535",6,6,2,14,"dummy"
"208536",0,0,1,1,"dummy"
"208537",0,0,1,1,"dummy"
"208538",0,0,1,1,"dummy"
"208539",0,0,1,1,"dummy"
"208553",1,2,0,3,"dummy"
"208554",2,1,0,3,"dummy"
"208555",2,4,0,6,"dummy"
"208556",2,2,0,4,"dummy"
"208557",1,3,0,4,"dummy"
"208558",2,2,0,4,"dummy"
"208559",4,4,0,8,"dummy"
"208560",1,0,0,1,"dummy"
"208561",3,2,1,6,"dummy"
"208562",0,0,0,0,"dummy"
"208563",0,0,0,0,"dummy"
"208564",0,0,0,0,"dummy"
"208565",0,0,0,0,"dummy"
"208566",4,4,0,8,"dummy"
"208567",0,1,0,1,"dummy"
"208568",2,0,1,3,"dummy"
"208574",10,5,0,15,"dummy"
"208575",1,0,0,1,"dummy"
"208580",0,2,1,3,"dummy"
"208582",2,3,1,6,"dummy"
"208583",0,0,1,1,"dummy"
"208586",0,2,0,2,"dummy"
"208592",0,1,0,1,"dummy"
"208593",0,0,1,1,"dummy"
"208595",1,2,1,4,"dummy"
"208596",7,1,1,9,"dummy"
"208597",1,3,0,4,"dummy"
"208598",0,0,3,3,"dummy"
"208601",0,0,1,1,"dummy"
"208603",0,0,1,1,"dummy"
"208629",0,1,0,1,"dummy"
"208630",0,0,4,4,"dummy"
"208632",2,4,1,7,"dummy"
"208634",1,1,1,3,"dummy"
"208635",1,1,0,2,"dummy"
"208636",0,0,1,1,"dummy"
"208637",0,0,0,0,"dummy"
"208638",0,1,0,1,"dummy"
"208650",0,0,1,1,"dummy"
"208651",0,0,0,0,"dummy"
"208655",0,4,0,4,"dummy"
"208656",0,2,0,2,"dummy"
"208657",0,1,1,2,"dummy"
"208658",1,3,1,5,"dummy"
"208659",0,1,1,2,"dummy"
"208660",0,2,0,2,"dummy"
"208661",0,1,0,1,"dummy"
"208662",1,4,2,7,"dummy"
"208663",0,1,0,1,"dummy"
"208664",0,3,0,3,"dummy"
"208665",3,3,1,7,"dummy"
"208666",3,3,0,6,"dummy"
"208667",3,11,1,15,"dummy"
"208668",0,1,0,1,"dummy"
"208669",6,3,1,10,"dummy"
"208670",0,1,0,1,"dummy"
"208671",0,2,0,2,"dummy"
"208672",2,2,0,4,"dummy"
"208673",0,0,1,1,"dummy"
"208674",0,0,2,2,"dummy"
"208675",0,0,1,1,"dummy"
"208676",11,5,0,16,"dummy"
"208677",0,0,3,3,"dummy"
"208681",0,3,0,3,"dummy"
"208682",1,2,1,4,"dummy"
"208683",0,2,0,2,"dummy"
"208685",1,2,0,3,"dummy"
"208687",0,4,1,5,"dummy"
"208688",2,2,0,4,"dummy"
"208689",0,1,0,1,"dummy"
"208690",0,5,0,5,"dummy"
"208691",0,0,1,1,"dummy"
"208692",4,7,0,11,"dummy"
"208693",4,8,0,12,"dummy"
"208694",0,1,0,1,"dummy"
"208695",5,21,3,29,"dummy"
"208696",0,1,0,1,"dummy"
"208697",1,2,0,3,"dummy"
"208698",9,36,9,54,"dummy"
"208705",0,5,0,5,"dummy"
"208706",0,0,1,1,"dummy"
"208707",1,0,0,1,"dummy"
"208708",0,2,0,2,"dummy"
"208709",0,1,0,1,"dummy"
"208710",0,2,0,2,"dummy"
"208711",21,0,0,21,"dummy"
"208712",0,0,0,0,"dummy"
"208713",4,4,0,8,"dummy"
"208721",1,4,2,7,"dummy"
"208734",0,3,1,4,"dummy"
"208735",10,11,0,21,"dummy"
"208736",0,0,1,1,"dummy"
"208737",2,2,0,4,"dummy"
"208738",1,2,0,3,"dummy"
"208740",0,0,3,3,"dummy"
"208754",7,7,3,17,"dummy"
"208755",0,0,0,0,"dummy"
"208758",1,5,0,6,"dummy"
"208759",0,2,0,2,"dummy"
"208760",0,1,0,1,"dummy"
"208761",0,2,0,2,"dummy"
"208762",0,0,1,1,"dummy"
"208763",16,7,3,26,"dummy"
"208764",0,0,1,1,"dummy"
"208765",12,13,0,25,"dummy"
"208766",0,0,0,0,"dummy"
"208767",0,3,0,3,"dummy"
"208768",0,8,0,8,"dummy"
"208770",12,0,0,12,"dummy"
"208771",1,0,0,1,"dummy"
"208772",0,0,1,1,"dummy"
"208773",0,1,1,2,"dummy"
"208774",0,0,1,1,"dummy"
"208775",0,0,1,1,"dummy"
"208776",1,0,0,1,"dummy"
"208777",0,0,3,3,"dummy"
"208778",5,5,0,10,"dummy"
"208779",17,25,0,42,"dummy"
"208780",6,3,0,9,"dummy"
"208781",5,7,0,12,"dummy"
"208782",0,1,0,1,"dummy"
"208783",0,2,1,3,"dummy"
"208784",5,5,0,10,"dummy"
"208786",2,5,2,9,"dummy"
"208789",3,3,0,6,"dummy"
"208808",0,1,1,2,"dummy"
"208812",4,2,1,7,"dummy"
"208814",0,1,0,1,"dummy"
"208815",1,0,0,1,"dummy"
"208816",0,1,0,1,"dummy"
"208818",1,2,0,3,"dummy"
"208820",5,0,0,5,"dummy"
"208825",0,11,4,15,"dummy"
"208826",4,8,2,14,"dummy"
"208827",5,15,2,22,"dummy"
"208828",0,11,0,11,"dummy"
"208829",1,3,0,4,"dummy"
"208830",5,5,0,10,"dummy"
"208831",3,0,0,3,"dummy"
"208832",4,1,0,5,"dummy"
"208833",0,0,0,0,"dummy"
"208834",2,5,0,7,"dummy"
"208837",0,2,1,3,"dummy"
"208838",0,0,0,0,"dummy"
"208851",0,0,1,1,"dummy"
"208854",3,0,0,3,"dummy"
"208855",0,2,0,2,"dummy"
"208856",0,0,0,0,"dummy"
"208857",0,1,0,1,"dummy"
"208858",0,2,0,2,"dummy"
"208859",0,2,0,2,"dummy"
"208860",6,1,0,7,"dummy"
"208861",0,1,0,1,"dummy"
"208863",0,0,1,1,"dummy"
"208864",1,5,0,6,"dummy"
"208866",0,1,0,1,"dummy"
"208867",0,1,3,4,"dummy"
"208868",0,0,1,1,"dummy"
"208870",4,12,2,18,"dummy"
"208871",2,1,0,3,"dummy"
"208875",0,0,0,0,"dummy"
"208876",0,0,0,0,"dummy"
"208877",0,1,0,1,"dummy"
"208879",0,3,0,3,"dummy"
"208881",0,7,0,7,"dummy"
"208882",0,0,0,0,"dummy"
"208883",1,3,0,4,"dummy"
"208884",0,1,0,1,"dummy"
"208885",0,1,0,1,"dummy"
"208886",3,31,1,35,"dummy"
"208887",0,2,0,2,"dummy"
"208888",0,2,0,2,"dummy"
"208892",0,1,0,1,"dummy"
"208895",0,0,0,0,"dummy"
"208899",0,1,0,1,"dummy"
"208902",0,1,0,1,"dummy"
"208904",0,0,3,3,"dummy"
"208905",0,10,5,15,"dummy"
"208906",0,2,0,2,"dummy"
"208914",0,2,0,2,"dummy"
"208915",0,1,0,1,"dummy"
"208916",0,0,1,1,"dummy"
"208918",0,1,2,3,"dummy"
"208920",0,0,1,1,"dummy"
"208928",2,0,0,2,"dummy"
"208929",1,0,0,1,"dummy"
"208930",0,0,0,0,"dummy"
"208931",0,2,0,2,"dummy"
"208932",0,0,0,0,"dummy"
"208933",0,0,0,0,"dummy"
"208936",0,2,0,2,"dummy"
"208937",0,7,1,8,"dummy"
"208939",0,1,1,2,"dummy"
"208949",0,0,0,0,"dummy"
"208964",0,30,0,30,"dummy"
"208965",0,0,1,1,"dummy"
"208966",0,0,2,2,"dummy"
"208967",0,0,2,2,"dummy"
"208968",13,1,1,15,"dummy"
"208969",23,0,1,24,"dummy"
"208970",2,1,0,3,"dummy"
"208971",0,0,1,1,"dummy"
"208972",1,5,0,6,"dummy"
"208973",0,0,1,1,"dummy"
"208974",2,0,1,3,"dummy"
"208975",0,1,1,2,"dummy"
"208980",0,1,0,1,"dummy"
"208981",0,1,4,5,"dummy"
"208982",0,0,1,1,"dummy"
"208994",0,1,0,1,"dummy"
"208995",0,0,1,1,"dummy"
"208996",1,4,2,7,"dummy"
"209000",17,39,1,57,"dummy"
"209001",0,0,1,1,"dummy"
"209006",3,1,1,5,"dummy"
"209007",0,0,2,2,"dummy"
"209008",0,2,0,2,"dummy"
"209035",0,1,1,2,"dummy"
"209036",11,12,4,27,"dummy"
"209037",0,1,2,3,"dummy"
"209038",0,10,1,11,"dummy"
"209083",0,1,0,1,"dummy"
"209084",0,1,0,1,"dummy"
"209091",0,2,0,2,"dummy"
"209092",0,2,0,2,"dummy"
"209093",4,2,0,6,"dummy"
"209094",2,3,1,6,"dummy"
"209095",0,1,0,1,"dummy"
"209096",0,1,0,1,"dummy"
"209097",2,1,0,3,"dummy"
"209098",1,2,1,4,"dummy"
"209099",0,0,1,1,"dummy"
"209100",2,1,0,3,"dummy"
"209101",0,1,1,2,"dummy"
"209102",0,0,1,1,"dummy"
"209109",0,0,1,1,"dummy"
"209112",2,4,1,7,"dummy"
"209113",2,1,2,5,"dummy"
"209114",0,0,2,2,"dummy"
"209158",0,0,1,1,"dummy"
"209159",4,5,5,14,"dummy"
"209168",0,0,1,1,"dummy"
"209169",0,4,0,4,"dummy"
"209170",0,1,0,1,"dummy"
"209171",0,0,1,1,"dummy"
"209177",0,1,2,3,"dummy"
"209178",1,11,0,12,"dummy"
"209179",0,0,0,0,"dummy"
"209180",40,4,3,47,"dummy"
"209181",9,3,0,12,"dummy"
"209182",1,7,0,8,"dummy"
"209183",0,2,0,2,"dummy"
"209191",0,2,1,3,"dummy"
"209192",3,29,3,35,"dummy"
"209193",11,4,2,17,"dummy"
"209194",0,1,0,1,"dummy"
"209195",0,6,0,6,"dummy"
"209196",0,1,0,1,"dummy"
"209197",0,0,1,1,"dummy"
"209198",2,2,2,6,"dummy"
"209199",0,0,4,4,"dummy"
"209200",1,0,0,1,"dummy"
"209201",1,1,1,3,"dummy"
"209215",2,2,4,8,"dummy"
"209216",0,1,3,4,"dummy"
"209217",1,0,2,3,"dummy"
"208942",0,0,2,2,"dummy"
"208943",0,1,3,4,"dummy"
"208944",0,0,1,1,"dummy"
"208945",0,0,1,1,"dummy"
"208951",0,0,1,1,"dummy"
"208952",0,1,0,1,"dummy"
"208953",0,0,1,1,"dummy"
"208960",2,2,1,5,"dummy"
"208977",1,5,0,6,"dummy"
"208978",0,0,0,0,"dummy"
"208988",6,7,2,15,"dummy"
"208989",0,1,0,1,"dummy"
"208990",0,1,0,1,"dummy"
"208991",0,0,0,0,"dummy"
"208992",1,0,0,1,"dummy"
"208998",6,1,1,8,"dummy"
"209010",0,6,0,6,"dummy"
"209011",5,19,0,24,"dummy"
"209012",2,1,0,3,"dummy"
"209013",2,1,0,3,"dummy"
"209014",0,0,1,1,"dummy"
"209015",3,26,0,29,"dummy"
"209016",3,6,0,9,"dummy"
"209017",0,3,0,3,"dummy"
"209018",2,3,0,5,"dummy"
"209019",7,15,0,22,"dummy"
"209020",0,1,0,1,"dummy"
"209021",0,0,1,1,"dummy"
"209022",2,7,0,9,"dummy"
"209023",16,4,1,21,"dummy"
"209024",19,3,1,23,"dummy"
"209031",1,0,0,1,"dummy"
"209032",2,2,3,7,"dummy"
"209033",2,2,3,7,"dummy"
"209086",0,14,0,14,"dummy"
"209087",1,0,0,1,"dummy"
"209088",8,1,0,9,"dummy"
"209089",0,0,1,1,"dummy"
"209106",0,1,0,1,"dummy"
"209107",0,0,3,3,"dummy"
"209152",0,0,0,0,"dummy"
"209155",3,6,1,10,"dummy"
"209156",0,1,1,2,"dummy"
"209163",0,1,1,2,"dummy"
"209164",4,2,1,7,"dummy"
"209165",1,0,0,1,"dummy"
"209166",0,0,0,0,"dummy"
"209173",0,0,2,2,"dummy"
"209185",0,0,0,0,"dummy"
"209186",0,1,0,1,"dummy"
"209187",0,0,1,1,"dummy"
"209188",0,0,0,0,"dummy"
"209189",0,1,0,1,"dummy"
"209221",2,0,0,2,"dummy"
"209222",0,1,0,1,"dummy"
"209223",0,0,0,0,"dummy"
"209224",3,0,0,3,"dummy"
"209225",0,0,0,0,"dummy"
"209226",0,0,1,1,"dummy"
"209227",0,0,1,1,"dummy"
"209228",0,0,0,0,"dummy"
"209229",1,0,0,1,"dummy"
"209232",0,2,0,2,"dummy"
"209233",2,0,0,2,"dummy"
"209234",0,4,0,4,"dummy"
"209235",0,0,0,0,"dummy"
"209236",0,0,1,1,"dummy"
"209237",0,0,1,1,"dummy"
"209238",0,4,1,5,"dummy"
"209239",0,1,0,1,"dummy"
"209240",0,6,0,6,"dummy"
"209241",0,2,0,2,"dummy"
"209242",0,0,1,1,"dummy"
"209243",3,1,3,7,"dummy"
"209244",0,0,3,3,"dummy"
"209245",2,13,1,16,"dummy"
"209246",1,3,0,4,"dummy"
"209251",0,0,1,1,"dummy"
"209252",0,0,1,1,"dummy"
"209253",0,2,0,2,"dummy"
"209267",0,0,3,3,"dummy"
"209286",0,0,3,3,"dummy"
"209287",0,0,3,3,"dummy"
"209288",0,7,3,10,"dummy"
"209289",0,1,4,5,"dummy"
"209290",0,0,1,1,"dummy"
"209291",0,0,3,3,"dummy"
"209292",0,0,1,1,"dummy"
"209293",1,3,1,5,"dummy"
"209294",0,2,2,4,"dummy"
"209298",0,0,2,2,"dummy"
"209299",9,1,2,12,"dummy"
"209300",1,8,2,11,"dummy"
"209301",2,3,0,5,"dummy"
"209310",3,0,1,4,"dummy"
"209314",0,1,0,1,"dummy"
"209315",0,1,0,1,"dummy"
"209327",0,4,0,4,"dummy"
"209328",0,3,0,3,"dummy"
"209329",0,4,0,4,"dummy"
"209330",7,4,7,18,"dummy"
"209331",0,0,3,3,"dummy"
"209332",13,0,2,15,"dummy"
"209333",1,1,1,3,"dummy"
"209334",0,0,1,1,"dummy"
"209352",1,0,2,3,"dummy"
"209353",0,3,0,3,"dummy"
"209354",0,2,0,2,"dummy"
"209355",0,0,1,1,"dummy"
"209356",0,3,1,4,"dummy"
"209357",0,0,1,1,"dummy"
"209371",0,2,3,5,"dummy"
"209372",0,3,3,6,"dummy"
"209427",2,3,0,5,"dummy"
"209428",2,4,1,7,"dummy"
"209434",0,1,0,1,"dummy"
"209437",6,0,0,6,"dummy"
"209438",2,5,2,9,"dummy"
"209445",0,0,1,1,"dummy"
"209462",0,2,0,2,"dummy"
"209467",0,4,0,4,"dummy"
"209468",0,1,0,1,"dummy"
"209469",1,8,0,9,"dummy"
"209472",0,1,0,1,"dummy"
"209473",0,0,1,1,"dummy"
"209483",5,5,2,12,"dummy"
"209484",1,0,0,1,"dummy"
"209485",0,2,0,2,"dummy"
"209486",1,3,1,5,"dummy"
"209487",0,0,1,1,"dummy"
"209488",0,1,1,2,"dummy"
"209489",2,0,1,3,"dummy"
"209490",2,5,1,8,"dummy"
"209491",2,0,1,3,"dummy"
"209492",0,1,1,2,"dummy"
"209493",0,2,0,2,"dummy"
"209494",0,1,0,1,"dummy"
"209495",1,0,0,1,"dummy"
"209496",0,11,0,11,"dummy"
"209497",0,0,0,0,"dummy"
"209498",0,5,3,8,"dummy"
"209499",1,1,1,3,"dummy"
"209500",1,1,1,3,"dummy"
"209501",0,1,0,1,"dummy"
"209502",0,0,1,1,"dummy"
"209503",0,0,1,1,"dummy"
"209255",0,0,2,2,"dummy"
"209256",0,0,3,3,"dummy"
"209257",4,6,0,10,"dummy"
"209258",0,2,1,3,"dummy"
"209259",0,0,3,3,"dummy"
"209260",1,0,0,1,"dummy"
"209261",1,0,1,2,"dummy"
"209269",0,0,1,1,"dummy"
"209275",34,3,2,39,"dummy"
"209296",0,0,1,1,"dummy"
"209303",1,0,1,2,"dummy"
"209304",0,0,2,2,"dummy"
"209308",0,1,1,2,"dummy"
"209312",0,0,0,0,"dummy"
"209319",0,1,0,1,"dummy"
"209320",0,0,1,1,"dummy"
"209321",0,0,1,1,"dummy"
"209322",0,0,1,1,"dummy"
"209323",0,0,1,1,"dummy"
"209324",0,0,1,1,"dummy"
"209325",1,1,0,2,"dummy"
"209336",3,0,0,3,"dummy"
"209337",2,5,1,8,"dummy"
"209338",0,0,0,0,"dummy"
"209341",4,0,1,5,"dummy"
"209342",0,1,0,1,"dummy"
"209343",5,7,0,12,"dummy"
"209359",0,1,0,1,"dummy"
"209360",0,0,1,1,"dummy"
"209361",1,0,0,1,"dummy"
"209362",0,1,0,1,"dummy"
"209363",0,2,0,2,"dummy"
"209364",0,0,1,1,"dummy"
"209365",1,2,0,3,"dummy"
"209366",0,0,1,1,"dummy"
"209367",0,1,0,1,"dummy"
"209374",0,0,0,0,"dummy"
"209375",0,0,0,0,"dummy"
"209376",0,0,0,0,"dummy"
"209377",0,0,0,0,"dummy"
"209378",0,1,1,2,"dummy"
"209379",3,0,1,4,"dummy"
"209380",0,0,1,1,"dummy"
"209381",0,0,1,1,"dummy"
"209402",0,1,0,1,"dummy"
"209405",3,2,1,6,"dummy"
"209408",7,11,1,19,"dummy"
"209409",1,7,0,8,"dummy"
"209410",0,0,1,1,"dummy"
"209411",4,0,0,4,"dummy"
"209412",0,4,0,4,"dummy"
"209430",1,3,0,4,"dummy"
"209431",0,1,0,1,"dummy"
"209432",0,1,0,1,"dummy"
"209440",1,0,0,1,"dummy"
"209441",0,0,1,1,"dummy"
"209442",0,1,0,1,"dummy"
"209443",0,1,0,1,"dummy"
"209447",0,0,2,2,"dummy"
"209448",14,20,4,38,"dummy"
"209449",0,0,1,1,"dummy"
"209450",8,17,3,28,"dummy"
"209451",0,1,0,1,"dummy"
"209454",0,2,1,3,"dummy"
"209459",0,1,0,1,"dummy"
"209460",1,0,2,3,"dummy"
"209464",0,0,4,4,"dummy"
"209465",0,1,0,1,"dummy"
"209504",0,0,1,1,"dummy"
"209512",0,1,0,1,"dummy"
"209516",0,0,0,0,"dummy"
"209517",0,0,1,1,"dummy"
"209518",0,0,0,0,"dummy"
"209523",0,7,0,7,"dummy"
"209524",0,6,3,9,"dummy"
"209525",0,2,0,2,"dummy"
"209526",0,2,0,2,"dummy"
"209527",7,0,1,8,"dummy"
"209528",0,0,0,0,"dummy"
"209529",0,1,0,1,"dummy"
"209530",0,0,0,0,"dummy"
"209531",0,3,0,3,"dummy"
"209532",0,2,0,2,"dummy"
"209533",0,0,1,1,"dummy"
"209534",0,0,0,0,"dummy"
"209535",3,0,0,3,"dummy"
"209536",0,0,1,1,"dummy"
"209537",1,1,1,3,"dummy"
"209538",2,1,2,5,"dummy"
"209539",0,0,1,1,"dummy"
"209544",0,0,1,1,"dummy"
"209545",0,0,1,1,"dummy"
"209546",0,0,0,0,"dummy"
"209547",0,0,0,0,"dummy"
"209548",1,1,2,4,"dummy"
"209586",0,1,0,1,"dummy"
"209587",0,3,0,3,"dummy"
"209588",9,9,0,18,"dummy"
"209589",2,2,0,4,"dummy"
"209590",9,9,0,18,"dummy"
"209591",0,5,0,5,"dummy"
"209592",0,0,1,1,"dummy"
"209593",4,1,5,10,"dummy"
"209594",0,2,1,3,"dummy"
"209595",0,0,1,1,"dummy"
"209596",0,4,0,4,"dummy"
"209597",1,0,1,2,"dummy"
"209598",0,1,0,1,"dummy"
"209599",7,7,0,14,"dummy"
"209600",2,0,0,2,"dummy"
"209601",0,3,0,3,"dummy"
"209602",8,2,0,10,"dummy"
"209603",0,1,0,1,"dummy"
"209604",2,3,0,5,"dummy"
"209632",0,0,1,1,"dummy"
"209659",0,0,1,1,"dummy"
"209660",7,0,0,7,"dummy"
"209661",0,0,1,1,"dummy"
"209662",0,0,1,1,"dummy"
"209663",8,0,1,9,"dummy"
"209664",1,0,0,1,"dummy"
"209665",0,1,1,2,"dummy"
"209674",0,0,1,1,"dummy"
"209677",2,2,0,4,"dummy"
"209678",0,1,1,2,"dummy"
"209679",0,1,1,2,"dummy"
"209680",0,1,0,1,"dummy"
"209681",0,4,1,5,"dummy"
"209682",0,0,1,1,"dummy"
"209683",1,0,0,1,"dummy"
"209684",0,1,0,1,"dummy"
"209690",0,9,0,9,"dummy"
"209691",1,1,0,2,"dummy"
"209692",4,14,0,18,"dummy"
"209693",4,10,0,14,"dummy"
"209694",0,3,0,3,"dummy"
"209695",24,30,1,55,"dummy"
"209696",2,5,1,8,"dummy"
"209697",0,4,0,4,"dummy"
"209698",0,1,0,1,"dummy"
"209699",0,0,3,3,"dummy"
"209711",0,2,0,2,"dummy"
"209715",0,5,0,5,"dummy"
"209730",2,5,2,9,"dummy"
"209731",3,2,1,6,"dummy"
"209506",0,1,3,4,"dummy"
"209507",1,1,0,2,"dummy"
"209510",1,2,0,3,"dummy"
"209514",0,4,0,4,"dummy"
"209520",34,1,3,38,"dummy"
"209521",1,3,0,4,"dummy"
"209550",0,2,1,3,"dummy"
"209553",0,0,1,1,"dummy"
"209554",0,0,2,2,"dummy"
"209555",0,1,0,1,"dummy"
"209556",0,0,2,2,"dummy"
"209557",0,1,0,1,"dummy"
"209558",0,1,0,1,"dummy"
"209559",0,0,2,2,"dummy"
"209560",0,0,2,2,"dummy"
"209561",0,0,3,3,"dummy"
"209562",11,0,0,11,"dummy"
"209565",3,4,1,8,"dummy"
"209566",3,2,1,6,"dummy"
"209567",0,1,0,1,"dummy"
"209606",0,1,0,1,"dummy"
"209607",0,1,1,2,"dummy"
"209608",0,4,0,4,"dummy"
"209609",2,2,0,4,"dummy"
"209610",1,1,3,5,"dummy"
"209611",0,1,0,1,"dummy"
"209612",0,0,1,1,"dummy"
"209613",0,0,1,1,"dummy"
"209614",0,0,0,0,"dummy"
"209615",0,0,1,1,"dummy"
"209618",0,0,0,0,"dummy"
"209621",1,0,0,1,"dummy"
"209622",2,0,1,3,"dummy"
"209623",0,0,0,0,"dummy"
"209624",0,1,0,1,"dummy"
"209625",8,1,0,9,"dummy"
"209626",0,0,0,0,"dummy"
"209627",0,0,0,0,"dummy"
"209628",1,10,0,11,"dummy"
"209629",7,1,0,8,"dummy"
"209630",2,0,3,5,"dummy"
"209636",0,1,0,1,"dummy"
"209637",0,0,1,1,"dummy"
"209638",0,0,2,2,"dummy"
"209639",0,1,0,1,"dummy"
"209640",2,0,0,2,"dummy"
"209643",3,1,0,4,"dummy"
"209648",0,5,0,5,"dummy"
"209649",0,2,0,2,"dummy"
"209654",1,3,1,5,"dummy"
"209655",0,2,0,2,"dummy"
"209669",0,1,0,1,"dummy"
"209670",0,1,0,1,"dummy"
"209671",1,4,0,5,"dummy"
"209672",0,1,0,1,"dummy"
"209686",1,2,0,3,"dummy"
"209687",1,2,3,6,"dummy"
"209688",1,4,0,5,"dummy"
"209705",0,2,3,5,"dummy"
"209713",0,0,1,1,"dummy"
"209741",0,0,0,0,"dummy"
"209742",5,0,2,7,"dummy"
"209743",0,0,0,0,"dummy"
"209746",0,0,1,1,"dummy"
"209747",0,0,1,1,"dummy"
"209748",0,0,1,1,"dummy"
"209749",1,0,0,1,"dummy"
"209750",2,4,1,7,"dummy"
"209751",1,4,1,6,"dummy"
"209732",1,25,0,26,"dummy"
"209733",0,4,0,4,"dummy"
"209755",0,0,1,1,"dummy"
"209756",2,0,0,2,"dummy"
"209757",0,0,1,1,"dummy"
"209758",3,2,2,7,"dummy"
"209759",3,6,1,10,"dummy"
"209760",0,1,2,3,"dummy"
"209761",2,0,0,2,"dummy"
"209762",0,0,1,1,"dummy"
"209775",0,0,1,1,"dummy"
"209776",0,0,1,1,"dummy"
"209777",0,0,2,2,"dummy"
"209778",26,3,7,36,"dummy"
"209781",2,7,0,9,"dummy"
"209782",0,1,0,1,"dummy"
"209783",0,0,1,1,"dummy"
"209786",0,2,0,2,"dummy"
"209787",0,2,0,2,"dummy"
"209788",7,0,0,7,"dummy"
"209824",11,1,1,13,"dummy"
"209825",1,0,0,1,"dummy"
"209829",3,1,0,4,"dummy"
"209752",7,0,4,11,"dummy"
"209753",0,1,1,2,"dummy"
"209766",0,1,0,1,"dummy"
"209767",3,4,0,7,"dummy"
"209768",0,1,0,1,"dummy"
"209769",0,1,0,1,"dummy"
"209770",0,1,0,1,"dummy"
"209771",2,3,0,5,"dummy"
"209772",0,0,1,1,"dummy"
"209773",4,4,0,8,"dummy"
"209792",0,1,1,2,"dummy"
"209793",1,2,1,4,"dummy"
"209794",6,0,1,7,"dummy"
"209795",0,2,1,3,"dummy"
"209796",4,3,1,8,"dummy"
"209797",0,0,1,1,"dummy"
"209800",4,0,0,4,"dummy"
"209801",0,2,1,3,"dummy"
"209802",2,4,3,9,"dummy"
"209803",0,0,0,0,"dummy"
"209804",0,0,0,0,"dummy"
"209805",1,1,0,2,"dummy"
"209806",2,0,0,2,"dummy"
"209807",2,7,6,15,"dummy"
"209808",4,0,5,9,"dummy"
"209809",0,1,2,3,"dummy"
"209810",0,3,3,6,"dummy"
"209827",0,0,0,0,"dummy"
"209837",1,6,2,9,"dummy"
"209839",19,12,4,35,"dummy"
"209841",0,3,3,6,"dummy"
"209849",0,0,0,0,"dummy"
"209851",0,0,1,1,"dummy"
"209852",0,0,1,1,"dummy"
"209853",0,0,1,1,"dummy"
"209854",2,1,1,4,"dummy"
"209856",2,0,0,2,"dummy"
"209859",0,0,1,1,"dummy"
"209860",0,0,0,0,"dummy"
"209887",0,1,0,1,"dummy"
"209888",1,2,0,3,"dummy"
"209889",0,1,0,1,"dummy"
"209890",1,0,0,1,"dummy"
"209891",1,0,0,1,"dummy"
"209892",1,0,0,1,"dummy"
"209897",6,7,3,16,"dummy"
"209898",0,1,0,1,"dummy"
"209899",2,2,3,7,"dummy"
"209900",0,1,0,1,"dummy"
"209901",0,1,0,1,"dummy"
"209902",0,1,0,1,"dummy"
"209903",0,1,0,1,"dummy"
"209904",0,0,1,1,"dummy"
"209905",0,1,0,1,"dummy"
"209906",0,1,1,2,"dummy"
"209907",0,0,2,2,"dummy"
"209908",0,1,0,1,"dummy"
"209909",0,4,0,4,"dummy"
"209912",0,0,0,0,"dummy"
"209913",4,3,3,10,"dummy"
"209914",0,1,0,1,"dummy"
"209915",1,0,2,3,"dummy"
"209921",0,1,0,1,"dummy"
"209922",1,1,0,2,"dummy"
"209924",0,0,1,1,"dummy"
"209925",0,2,1,3,"dummy"
"209926",0,0,1,1,"dummy"
"209927",0,0,2,2,"dummy"
"209928",0,2,0,2,"dummy"
"209930",0,0,0,0,"dummy"
"209931",0,2,0,2,"dummy"
"209932",0,1,0,1,"dummy"
"209933",0,0,0,0,"dummy"
"209934",26,33,4,63,"dummy"
"209935",1,2,0,3,"dummy"
"209938",0,0,1,1,"dummy"
"209939",0,0,1,1,"dummy"
"209943",0,0,1,1,"dummy"
"209944",0,1,1,2,"dummy"
"209945",1,2,0,3,"dummy"
"209946",3,0,2,5,"dummy"
"209947",0,0,0,0,"dummy"
"209948",0,0,1,1,"dummy"
"209950",0,1,0,1,"dummy"
"209951",0,2,0,2,"dummy"
"209952",2,0,0,2,"dummy"
"209953",0,2,0,2,"dummy"
"209954",0,0,0,0,"dummy"
"209955",0,0,0,0,"dummy"
"209956",0,0,1,1,"dummy"
"209957",3,12,0,15,"dummy"
"209958",0,0,3,3,"dummy"
"209959",0,0,1,1,"dummy"
"209971",1,0,0,1,"dummy"
"209983",0,0,1,1,"dummy"
"209984",0,0,1,1,"dummy"
"209989",0,2,0,2,"dummy"
"209990",5,2,1,8,"dummy"
"209991",2,2,0,4,"dummy"
"209992",0,2,0,2,"dummy"
"209993",0,6,0,6,"dummy"
"209994",0,2,0,2,"dummy"
"209995",0,2,0,2,"dummy"
"209996",0,2,0,2,"dummy"
"209997",4,7,0,11,"dummy"
"209998",0,4,0,4,"dummy"
"209999",0,2,0,2,"dummy"
"210000",6,0,0,6,"dummy"
"210001",0,3,0,3,"dummy"
"210002",0,0,2,2,"dummy"
"210003",1,3,0,4,"dummy"
"210004",0,0,1,1,"dummy"
"210005",0,0,1,1,"dummy"
"210006",7,0,3,10,"dummy"
"210007",0,0,1,1,"dummy"
"210008",0,0,1,1,"dummy"
"210009",0,0,1,1,"dummy"
"210010",0,0,1,1,"dummy"
"210011",0,0,1,1,"dummy"
"210012",10,17,0,27,"dummy"
"210014",3,4,0,7,"dummy"
"210015",1,0,1,2,"dummy"
"210016",4,0,4,8,"dummy"
"210017",0,0,0,0,"dummy"
"210018",0,0,1,1,"dummy"
"210019",0,3,2,5,"dummy"
"210020",2,0,1,3,"dummy"
"210021",2,3,4,9,"dummy"
"210022",4,0,1,5,"dummy"
"210023",0,0,1,1,"dummy"
"210024",0,0,1,1,"dummy"
"210025",0,0,1,1,"dummy"
"210026",0,0,1,1,"dummy"
"210027",0,0,1,1,"dummy"
"210029",0,0,1,1,"dummy"
"210030",1,0,0,1,"dummy"
"210032",0,4,0,4,"dummy"
"210033",0,5,0,5,"dummy"
"210035",1,0,2,3,"dummy"
"210037",0,1,0,1,"dummy"
"210038",0,0,1,1,"dummy"
"210039",0,0,2,2,"dummy"
"210041",0,3,0,3,"dummy"
"210042",0,0,1,1,"dummy"
"210043",1,2,0,3,"dummy"
"210044",4,1,1,6,"dummy"
"210045",0,4,0,4,"dummy"
"210046",0,1,0,1,"dummy"
"210047",0,0,0,0,"dummy"
"210049",0,1,1,2,"dummy"
"210050",3,0,0,3,"dummy"
"210051",0,0,2,2,"dummy"
"210052",0,0,1,1,"dummy"
"210053",0,0,2,2,"dummy"
"210054",0,1,0,1,"dummy"
"210064",13,1,2,16,"dummy"
"210066",0,6,0,6,"dummy"
"210067",0,3,1,4,"dummy"
"210068",11,3,0,14,"dummy"
"210071",1,7,0,8,"dummy"
"210073",0,1,2,3,"dummy"
"210074",0,0,0,0,"dummy"
"210075",0,1,0,1,"dummy"
"210076",4,0,2,6,"dummy"
"210077",1,0,0,1,"dummy"
"210078",0,0,0,0,"dummy"
"210079",0,0,0,0,"dummy"
"210081",0,9,0,9,"dummy"
"210082",0,0,0,0,"dummy"
"210083",0,1,0,1,"dummy"
"210085",0,0,1,1,"dummy"
"210086",1,1,2,4,"dummy"
"210091",11,13,0,24,"dummy"
"210092",0,3,0,3,"dummy"
"210093",0,0,1,1,"dummy"
"210105",0,7,0,7,"dummy"
"210107",5,1,2,8,"dummy"
"210110",0,4,0,4,"dummy"
"210111",0,0,1,1,"dummy"
"210117",14,7,2,23,"dummy"
"210118",3,8,0,11,"dummy"
"210120",0,0,1,1,"dummy"
"210127",0,3,0,3,"dummy"
"210133",15,17,2,34,"dummy"
"210134",0,1,0,1,"dummy"
"210136",3,2,0,5,"dummy"
"210141",1,0,0,1,"dummy"
"210145",1,2,4,7,"dummy"
"210147",0,3,1,4,"dummy"
"210148",0,0,2,2,"dummy"
"210149",0,0,2,2,"dummy"
"210152",2,0,0,2,"dummy"
"210153",3,0,0,3,"dummy"
"210154",0,0,0,0,"dummy"
"210155",0,0,1,1,"dummy"
"210156",0,0,1,1,"dummy"
"210157",1,0,0,1,"dummy"
"210163",0,0,1,1,"dummy"
"210164",7,11,1,19,"dummy"
"210165",0,0,0,0,"dummy"
"210167",0,0,1,1,"dummy"
"210168",0,0,1,1,"dummy"
"210170",0,2,0,2,"dummy"
"210171",5,0,0,5,"dummy"
"210172",3,1,0,4,"dummy"
"210173",0,2,0,2,"dummy"
"210175",0,1,0,1,"dummy"
"210177",0,14,0,14,"dummy"
"210178",0,1,0,1,"dummy"
"210182",0,0,2,2,"dummy"
"210183",0,11,0,11,"dummy"
"210185",4,4,4,12,"dummy"
"210192",0,0,1,1,"dummy"
"210197",0,0,0,0,"dummy"
"210198",7,21,2,30,"dummy"
"210201",2,2,2,6,"dummy"
"210202",2,2,1,5,"dummy"
"210203",1,9,1,11,"dummy"
"210204",0,0,1,1,"dummy"
"210205",2,2,2,6,"dummy"
"210206",0,1,2,3,"dummy"
"210207",2,2,1,5,"dummy"
"210208",0,2,0,2,"dummy"
"210209",0,0,1,1,"dummy"
"210211",0,3,0,3,"dummy"
"210215",0,0,0,0,"dummy"
"210218",1,0,1,2,"dummy"
"210219",0,0,0,0,"dummy"
"210220",0,2,0,2,"dummy"
"210221",4,20,1,25,"dummy"
"210222",0,0,1,1,"dummy"
"210223",4,1,0,5,"dummy"
"210224",18,2,4,24,"dummy"
"210225",0,1,0,1,"dummy"
"210226",0,0,1,1,"dummy"
"210227",2,3,0,5,"dummy"
"210235",0,0,1,1,"dummy"
"210238",1,0,1,2,"dummy"
"210249",5,1,3,9,"dummy"
"210250",0,0,1,1,"dummy"
"210252",0,1,1,2,"dummy"
"210256",0,1,0,1,"dummy"
"210263",0,0,0,0,"dummy"
"210264",3,13,0,16,"dummy"
"210265",0,9,1,10,"dummy"
"210266",0,3,0,3,"dummy"
"210267",5,6,4,15,"dummy"
"210268",0,2,0,2,"dummy"
"210269",4,3,5,12,"dummy"
"210270",4,0,0,4,"dummy"
"210272",0,2,1,3,"dummy"
"210273",0,0,1,1,"dummy"
"210274",0,3,0,3,"dummy"
"210275",0,5,0,5,"dummy"
"210276",3,2,1,6,"dummy"
"210281",1,0,0,1,"dummy"
"210285",0,0,1,1,"dummy"
"210287",2,0,1,3,"dummy"
"210288",0,0,2,2,"dummy"
"210291",0,0,1,1,"dummy"
"210304",0,0,0,0,"dummy"
"210307",0,3,0,3,"dummy"
"210308",0,0,1,1,"dummy"
"210309",0,1,0,1,"dummy"
"210310",0,3,0,3,"dummy"
"210311",0,1,0,1,"dummy"
"210312",0,1,0,1,"dummy"
"210313",0,1,0,1,"dummy"
"210314",0,1,3,4,"dummy"
"210319",6,1,0,7,"dummy"
"210320",2,2,0,4,"dummy"
"210327",2,2,0,4,"dummy"
"210329",0,0,0,0,"dummy"
"210330",5,0,2,7,"dummy"
"210331",0,0,0,0,"dummy"
"210333",7,9,0,16,"dummy"
"210334",6,3,0,9,"dummy"
"210335",1,2,0,3,"dummy"
"210336",10,4,1,15,"dummy"
"210337",1,0,1,2,"dummy"
"210338",0,0,0,0,"dummy"
"210341",3,1,1,5,"dummy"
"210342",17,30,2,49,"dummy"
"210343",0,3,1,4,"dummy"
"210344",3,3,0,6,"dummy"
"210345",1,3,1,5,"dummy"
"210346",0,1,0,1,"dummy"
"210347",4,8,2,14,"dummy"
"210348",2,5,0,7,"dummy"
"210349",5,1,0,6,"dummy"
"210350",0,3,1,4,"dummy"
"210351",30,19,2,51,"dummy"
"210352",1,5,0,6,"dummy"
"210353",0,1,0,1,"dummy"
"210354",13,1,0,14,"dummy"
"210355",4,0,0,4,"dummy"
"210356",0,1,1,2,"dummy"
"210357",1,0,1,2,"dummy"
"210358",0,1,1,2,"dummy"
"210359",0,1,0,1,"dummy"
"210360",1,0,2,3,"dummy"
"210361",2,3,1,6,"dummy"
"210363",0,2,0,2,"dummy"
"210367",0,0,0,0,"dummy"
"210368",0,0,0,0,"dummy"
"210370",0,0,1,1,"dummy"
"210371",0,0,0,0,"dummy"
"210372",0,1,0,1,"dummy"
"210373",0,1,0,1,"dummy"
"210377",0,1,0,1,"dummy"
"210379",0,13,0,13,"dummy"
"210392",0,0,0,0,"dummy"
"210393",0,0,0,0,"dummy"
"210397",0,0,0,0,"dummy"
"210398",0,0,2,2,"dummy"
"210399",0,0,2,2,"dummy"
"210400",0,1,0,1,"dummy"
"210401",0,1,4,5,"dummy"
"210402",0,1,0,1,"dummy"
"210403",1,1,0,2,"dummy"
"210404",3,0,3,6,"dummy"
"210405",0,0,0,0,"dummy"
"210406",0,1,0,1,"dummy"
"210407",0,1,0,1,"dummy"
"210408",0,0,0,0,"dummy"
"210409",3,0,0,3,"dummy"
"210410",0,1,0,1,"dummy"
"210411",0,0,1,1,"dummy"
"210412",0,1,0,1,"dummy"
"210413",1,1,0,2,"dummy"
"210414",1,0,0,1,"dummy"
"210415",1,0,0,1,"dummy"
"210416",0,0,0,0,"dummy"
"210417",0,0,0,0,"dummy"
"210422",0,0,0,0,"dummy"
"210423",1,0,0,1,"dummy"
"210424",2,4,0,6,"dummy"
"210425",0,1,0,1,"dummy"
"210426",0,1,0,1,"dummy"
"210427",4,0,0,4,"dummy"
"210428",0,0,2,2,"dummy"
"210429",0,2,1,3,"dummy"
"210430",0,4,0,4,"dummy"
"210431",3,1,0,4,"dummy"
"210432",0,1,0,1,"dummy"
"210433",5,1,3,9,"dummy"
"210434",0,5,3,8,"dummy"
"210435",0,3,0,3,"dummy"
"210436",4,6,1,11,"dummy"
"210437",0,3,0,3,"dummy"
"210438",0,2,0,2,"dummy"
"210439",6,4,0,10,"dummy"
"210441",0,5,1,6,"dummy"
"210443",1,1,1,3,"dummy"
"210444",0,0,1,1,"dummy"
"210445",1,0,0,1,"dummy"
"210449",1,0,0,1,"dummy"
"210451",0,3,0,3,"dummy"
"210452",0,1,0,1,"dummy"
"210453",0,1,0,1,"dummy"
"210455",0,12,3,15,"dummy"
"210456",3,0,0,3,"dummy"
"210457",0,1,0,1,"dummy"
"210458",1,0,0,1,"dummy"
"210459",0,0,1,1,"dummy"
"210461",0,0,0,0,"dummy"
"210465",0,4,0,4,"dummy"
"210466",0,0,0,0,"dummy"
"210468",0,1,0,1,"dummy"
"210470",0,0,1,1,"dummy"
"210471",1,0,0,1,"dummy"
"210472",0,0,0,0,"dummy"
"210473",0,1,1,2,"dummy"
"210499",0,0,1,1,"dummy"
"210500",0,1,0,1,"dummy"
"210501",4,2,1,7,"dummy"
"210502",1,1,0,2,"dummy"
"210505",2,0,0,2,"dummy"
"210507",1,2,0,3,"dummy"
"210509",0,0,1,1,"dummy"
"210510",29,4,1,34,"dummy"
"210511",1,0,0,1,"dummy"
"210513",0,1,0,1,"dummy"
"210514",0,0,0,0,"dummy"
"210515",0,0,1,1,"dummy"
"210516",0,0,1,1,"dummy"
"210517",1,0,0,1,"dummy"
"210518",0,0,1,1,"dummy"
"210521",0,0,1,1,"dummy"
"210522",0,2,0,2,"dummy"
"210523",2,1,2,5,"dummy"
"210524",0,1,1,2,"dummy"
"210525",0,2,0,2,"dummy"
"210526",4,2,1,7,"dummy"
"210527",2,2,0,4,"dummy"
"210528",1,16,4,21,"dummy"
"210529",4,3,0,7,"dummy"
"210530",9,1,1,11,"dummy"
"210531",1,7,1,9,"dummy"
"210532",0,11,2,13,"dummy"
"210533",0,1,1,2,"dummy"
"210534",8,1,4,13,"dummy"
"210535",0,8,0,8,"dummy"
"210536",3,0,0,3,"dummy"
"210538",0,0,4,4,"dummy"
"210540",11,6,3,20,"dummy"
"210542",0,6,3,9,"dummy"
"210543",1,2,0,3,"dummy"
"210544",2,2,0,4,"dummy"
"210545",0,4,0,4,"dummy"
"210546",0,2,0,2,"dummy"
"210550",0,0,1,1,"dummy"
"210551",0,2,0,2,"dummy"
"210552",0,2,0,2,"dummy"
"210553",0,0,1,1,"dummy"
"210554",0,0,2,2,"dummy"
"210555",2,0,0,2,"dummy"
"210556",5,6,1,12,"dummy"
"210559",0,0,1,1,"dummy"
"210560",0,0,1,1,"dummy"
"210561",0,0,1,1,"dummy"
"210562",0,0,1,1,"dummy"
"210563",0,0,1,1,"dummy"
"210589",0,0,0,0,"dummy"
"210592",3,3,0,6,"dummy"
"210594",1,3,0,4,"dummy"
"210595",5,6,1,12,"dummy"
"210596",3,4,1,8,"dummy"
"210597",5,4,0,9,"dummy"
"210599",0,52,1,53,"dummy"
"210601",0,0,1,1,"dummy"
"210603",0,0,1,1,"dummy"
"210604",0,0,0,0,"dummy"
"210605",0,0,0,0,"dummy"
"210606",0,0,1,1,"dummy"
"210607",0,0,0,0,"dummy"
"210608",0,0,1,1,"dummy"
"210609",0,0,0,0,"dummy"
"210610",0,0,0,0,"dummy"
"210611",0,0,0,0,"dummy"
"210612",0,0,0,0,"dummy"
"210613",0,0,0,0,"dummy"
"210623",5,4,1,10,"dummy"
"210625",0,6,0,6,"dummy"
"210626",0,1,0,1,"dummy"
"210627",0,1,2,3,"dummy"
"210628",0,0,2,2,"dummy"
"210629",0,1,0,1,"dummy"
"210630",0,0,1,1,"dummy"
"210634",1,0,1,2,"dummy"
"210635",3,4,0,7,"dummy"
"210636",0,2,1,3,"dummy"
"210637",0,5,0,5,"dummy"
"210638",2,3,3,8,"dummy"
"210639",2,2,3,7,"dummy"
"210640",0,1,0,1,"dummy"
"210641",11,6,1,18,"dummy"
"210642",0,0,0,0,"dummy"
"210643",0,0,1,1,"dummy"
"210644",0,3,1,4,"dummy"
"210645",2,2,1,5,"dummy"
"210646",0,1,0,1,"dummy"
"210647",0,2,0,2,"dummy"
"210649",1,5,1,7,"dummy"
"210653",0,0,2,2,"dummy"
"210656",0,15,0,15,"dummy"
"210657",0,3,0,3,"dummy"
"210658",0,0,1,1,"dummy"
"210659",0,3,0,3,"dummy"
"210660",0,0,0,0,"dummy"
"210661",0,1,0,1,"dummy"
"210663",4,5,0,9,"dummy"
"210664",0,1,0,1,"dummy"
"210666",1,0,1,2,"dummy"
"210667",1,1,0,2,"dummy"
"210668",1,0,0,1,"dummy"
"210671",8,0,0,8,"dummy"
"210672",0,0,1,1,"dummy"
"210673",0,2,0,2,"dummy"
"210674",0,2,0,2,"dummy"
"210675",2,4,1,7,"dummy"
"210676",0,0,1,1,"dummy"
"210677",1,5,0,6,"dummy"
"210678",0,2,0,2,"dummy"
"210682",0,0,1,1,"dummy"
"210687",0,2,2,4,"dummy"
"210688",2,0,0,2,"dummy"
"210689",0,0,1,1,"dummy"
"210690",0,4,2,6,"dummy"
"210691",0,1,0,1,"dummy"
"210692",0,2,0,2,"dummy"
"210693",0,0,1,1,"dummy"
"210694",5,2,0,7,"dummy"
"210696",0,0,2,2,"dummy"
"210697",1,6,0,7,"dummy"
"210699",0,0,1,1,"dummy"
"210704",2,10,0,12,"dummy"
"210721",0,2,2,4,"dummy"
"210725",1,0,2,3,"dummy"
"210726",0,1,2,3,"dummy"
"210727",0,1,0,1,"dummy"
"210728",0,0,0,0,"dummy"
"210729",0,0,1,1,"dummy"
"210730",0,0,3,3,"dummy"
"210731",0,0,3,3,"dummy"
"210732",0,0,4,4,"dummy"
"210733",2,3,1,6,"dummy"
"210735",0,0,2,2,"dummy"
"210736",0,0,2,2,"dummy"
"210737",0,0,4,4,"dummy"
"210738",0,2,0,2,"dummy"
"210739",1,0,1,2,"dummy"
"210740",0,0,1,1,"dummy"
"210741",0,0,2,2,"dummy"
"210742",0,1,1,2,"dummy"
"210743",0,0,0,0,"dummy"
"210744",0,0,2,2,"dummy"
"210745",0,0,1,1,"dummy"
"210746",0,0,1,1,"dummy"
"210747",0,0,1,1,"dummy"
"210748",0,0,1,1,"dummy"
"210749",0,0,1,1,"dummy"
"210750",0,0,1,1,"dummy"
"210751",0,0,1,1,"dummy"
"210752",0,0,1,1,"dummy"
"210753",0,0,1,1,"dummy"
"210754",0,0,1,1,"dummy"
"210755",0,0,1,1,"dummy"
"210756",0,0,1,1,"dummy"
"210757",0,0,1,1,"dummy"
"210758",0,0,1,1,"dummy"
"210761",0,2,0,2,"dummy"
"210762",0,3,0,3,"dummy"
"210763",0,0,0,0,"dummy"
"210764",0,1,0,1,"dummy"
"210765",0,1,0,1,"dummy"
"210766",6,18,1,25,"dummy"
"210767",0,0,0,0,"dummy"
"210768",0,0,0,0,"dummy"
"210771",0,0,1,1,"dummy"
"210772",1,1,0,2,"dummy"
"210773",0,1,0,1,"dummy"
"210774",1,4,4,9,"dummy"
"210775",1,2,0,3,"dummy"
"210777",4,2,0,6,"dummy"
"210778",0,0,1,1,"dummy"
"210787",0,0,2,2,"dummy"
"210788",0,0,2,2,"dummy"
"210791",0,0,3,3,"dummy"
"210792",0,1,0,1,"dummy"
"210793",0,2,0,2,"dummy"
"210794",3,0,0,3,"dummy"
"210795",1,3,0,4,"dummy"
"210796",0,1,0,1,"dummy"
"210798",0,13,1,14,"dummy"
"210799",0,1,0,1,"dummy"
"210800",10,4,3,17,"dummy"
"210807",0,0,0,0,"dummy"
"210808",0,0,0,0,"dummy"
"210809",0,0,0,0,"dummy"
"210810",0,0,0,0,"dummy"
"210817",0,0,1,1,"dummy"
"210819",0,1,0,1,"dummy"
"210823",0,1,0,1,"dummy"
"210836",0,2,0,2,"dummy"
"210837",0,0,1,1,"dummy"
"210838",0,0,1,1,"dummy"
"210841",3,0,0,3,"dummy"
"210842",0,1,0,1,"dummy"
"210850",0,0,1,1,"dummy"
"210852",0,0,3,3,"dummy"
"210853",1,1,0,2,"dummy"
"210854",0,1,0,1,"dummy"
"210855",1,0,0,1,"dummy"
"210866",0,1,0,1,"dummy"
"210874",2,3,0,5,"dummy"
"210875",0,0,1,1,"dummy"
"210876",0,0,0,0,"dummy"
"210877",0,0,0,0,"dummy"
"210881",6,2,1,9,"dummy"
"210882",1,0,0,1,"dummy"
"210885",1,1,0,2,"dummy"
"210886",0,0,1,1,"dummy"
"210887",0,0,1,1,"dummy"
"210894",0,0,1,1,"dummy"
"210895",0,2,0,2,"dummy"
"210896",0,2,3,5,"dummy"
"210899",0,0,1,1,"dummy"
"210902",0,1,0,1,"dummy"
"210903",0,17,0,17,"dummy"
"210904",0,2,0,2,"dummy"
"210906",0,0,1,1,"dummy"
"210909",2,0,3,5,"dummy"
"210910",1,0,0,1,"dummy"
"210911",0,1,0,1,"dummy"
"210912",0,1,1,2,"dummy"
"210914",0,7,0,7,"dummy"
"210915",0,1,0,1,"dummy"
"210927",2,0,3,5,"dummy"
"210930",0,0,1,1,"dummy"
"211024",0,0,1,1,"dummy"
"210935",2,0,0,2,"dummy"
"210936",0,1,0,1,"dummy"
"210938",0,0,1,1,"dummy"
"210939",0,0,0,0,"dummy"
"210945",0,2,0,2,"dummy"
"210946",0,0,0,0,"dummy"
"210947",0,0,0,0,"dummy"
"210948",1,0,1,2,"dummy"
"210949",0,1,0,1,"dummy"
"210950",0,1,0,1,"dummy"
"210951",1,0,0,1,"dummy"
"210952",3,3,1,7,"dummy"
"210953",0,0,2,2,"dummy"
"210955",0,0,0,0,"dummy"
"210957",0,0,2,2,"dummy"
"210958",0,1,0,1,"dummy"
"210960",0,1,0,1,"dummy"
"210961",0,2,1,3,"dummy"
"210962",17,12,3,32,"dummy"
"210963",0,6,0,6,"dummy"
"210964",0,2,0,2,"dummy"
"210966",1,0,0,1,"dummy"
"210967",0,0,1,1,"dummy"
"210971",0,0,1,1,"dummy"
"210972",0,1,0,1,"dummy"
"210977",0,3,0,3,"dummy"
"210978",0,0,0,0,"dummy"
"210979",2,1,0,3,"dummy"
"210980",1,0,0,1,"dummy"
"210982",1,0,0,1,"dummy"
"210983",0,0,0,0,"dummy"
"210984",8,2,0,10,"dummy"
"210985",13,7,4,24,"dummy"
"210987",1,3,0,4,"dummy"
"210989",1,2,1,4,"dummy"
"210990",5,2,0,7,"dummy"
"210991",3,5,0,8,"dummy"
"210992",0,1,0,1,"dummy"
"210993",0,0,1,1,"dummy"
"210994",5,1,0,6,"dummy"
"210995",0,0,1,1,"dummy"
"210996",0,0,2,2,"dummy"
"210999",0,0,1,1,"dummy"
"211001",9,1,0,10,"dummy"
"211002",1,2,0,3,"dummy"
"211003",0,0,2,2,"dummy"
"211004",0,0,0,0,"dummy"
"211005",0,0,0,0,"dummy"
"211006",20,23,0,43,"dummy"
"211007",23,0,0,23,"dummy"
"211008",0,0,0,0,"dummy"
"211010",0,0,1,1,"dummy"
"211011",5,11,0,16,"dummy"
"211012",0,0,1,1,"dummy"
"211013",0,2,0,2,"dummy"
"211015",2,12,5,19,"dummy"
"211016",0,0,9,9,"dummy"
"211020",0,1,0,1,"dummy"
"211021",0,0,0,0,"dummy"
"211022",5,6,0,11,"dummy"
"211025",0,0,1,1,"dummy"
"211032",0,0,0,0,"dummy"
"211033",0,0,0,0,"dummy"
"211034",0,0,1,1,"dummy"
"211035",1,0,0,1,"dummy"
"211036",0,0,0,0,"dummy"
"211037",0,0,0,0,"dummy"
"211038",0,0,0,0,"dummy"
"211039",0,0,0,0,"dummy"
"211040",0,0,1,1,"dummy"
"211041",0,0,0,0,"dummy"
"211042",0,0,0,0,"dummy"
"211044",0,0,2,2,"dummy"
"211045",0,1,1,2,"dummy"
"211046",4,1,0,5,"dummy"
"211048",1,1,0,2,"dummy"
"211049",0,1,0,1,"dummy"
"211050",2,4,0,6,"dummy"
"211051",3,2,2,7,"dummy"
"211054",0,5,0,5,"dummy"
"211055",0,2,0,2,"dummy"
"211056",3,7,3,13,"dummy"
"211058",0,0,1,1,"dummy"
"211059",0,1,0,1,"dummy"
"211061",0,1,0,1,"dummy"
"211062",0,0,2,2,"dummy"
"211063",0,0,1,1,"dummy"
"211067",9,6,1,16,"dummy"
"211068",1,2,0,3,"dummy"
"211069",2,2,0,4,"dummy"
"211070",3,1,0,4,"dummy"
"211071",1,0,1,2,"dummy"
"211072",0,1,0,1,"dummy"
"211076",0,1,1,2,"dummy"
"211079",0,0,0,0,"dummy"
"211081",0,1,1,2,"dummy"
"211082",0,0,1,1,"dummy"
"211083",0,0,2,2,"dummy"
"211084",0,1,1,2,"dummy"
"211085",0,0,2,2,"dummy"
"211086",0,0,0,0,"dummy"
"211087",0,0,0,0,"dummy"
"211088",12,10,0,22,"dummy"
"211090",3,6,0,9,"dummy"
"211092",1,0,0,1,"dummy"
"211093",0,1,0,1,"dummy"
"211095",12,2,3,17,"dummy"
"211096",3,0,0,3,"dummy"
"211097",0,1,0,1,"dummy"
"211098",0,1,0,1,"dummy"
"211099",0,1,0,1,"dummy"
"211100",2,4,0,6,"dummy"
"211120",2,2,5,9,"dummy"
"211121",0,0,1,1,"dummy"
"211122",2,2,5,9,"dummy"
"211123",0,0,0,0,"dummy"
"211124",0,0,0,0,"dummy"
"211126",2,4,0,6,"dummy"
"211127",0,2,0,2,"dummy"
"211128",0,2,0,2,"dummy"
"211129",10,2,0,12,"dummy"
"211130",0,2,0,2,"dummy"
"211131",0,0,0,0,"dummy"
"211132",0,0,3,3,"dummy"
"211133",0,5,0,5,"dummy"
"211136",0,13,1,14,"dummy"
"211137",0,0,1,1,"dummy"
"211138",0,5,1,6,"dummy"
"211139",0,1,1,2,"dummy"
"211140",1,0,0,1,"dummy"
"211141",2,3,1,6,"dummy"
"211160",0,1,0,1,"dummy"
"211161",2,0,0,2,"dummy"
"211162",1,2,0,3,"dummy"
"211164",0,0,0,0,"dummy"
"211165",0,1,0,1,"dummy"
"211167",3,17,0,20,"dummy"
"211172",1,0,0,1,"dummy"
"211173",0,0,1,1,"dummy"
"211175",1,2,0,3,"dummy"
"211176",3,1,0,4,"dummy"
"211178",0,1,1,2,"dummy"
"211179",1,0,1,2,"dummy"
"211196",0,0,1,1,"dummy"
"211197",0,2,0,2,"dummy"
"211198",0,0,0,0,"dummy"
"211199",0,0,1,1,"dummy"
"211200",0,0,1,1,"dummy"
"211201",0,0,2,2,"dummy"
"211218",4,10,3,17,"dummy"
"211219",0,0,8,8,"dummy"
"211242",2,0,4,6,"dummy"
"211248",0,1,4,5,"dummy"
"211249",0,1,0,1,"dummy"
"211250",1,0,0,1,"dummy"
"211256",0,0,0,0,"dummy"
"211257",0,0,0,0,"dummy"
"211273",2,2,0,4,"dummy"
"211274",0,2,0,2,"dummy"
"211275",0,21,0,21,"dummy"
"211276",0,10,0,10,"dummy"
"211277",0,0,2,2,"dummy"
"211278",0,2,0,2,"dummy"
"211279",0,6,0,6,"dummy"
"211280",0,0,2,2,"dummy"
"211281",0,6,0,6,"dummy"
"211282",0,4,1,5,"dummy"
"211283",0,6,0,6,"dummy"
"211284",0,8,0,8,"dummy"
"211285",0,0,1,1,"dummy"
"211286",1,0,0,1,"dummy"
"211313",0,1,0,1,"dummy"
"211338",0,0,1,1,"dummy"
"211339",0,0,1,1,"dummy"
"211340",0,1,0,1,"dummy"
"211345",0,0,1,1,"dummy"
"211346",0,1,0,1,"dummy"
"211347",1,2,0,3,"dummy"
"211350",1,6,0,7,"dummy"
"211360",2,18,1,21,"dummy"
"211361",2,8,1,11,"dummy"
"211362",7,1,1,9,"dummy"
"211363",0,2,0,2,"dummy"
"211364",0,1,0,1,"dummy"
"211365",0,1,0,1,"dummy"
"211366",1,0,0,1,"dummy"
"211371",0,0,4,4,"dummy"
"211391",0,0,0,0,"dummy"
"211392",5,0,2,7,"dummy"
"211393",0,0,0,0,"dummy"
"211181",0,0,1,1,"dummy"
"211182",0,9,1,10,"dummy"
"211183",0,2,0,2,"dummy"
"211184",1,0,0,1,"dummy"
"211187",1,0,1,2,"dummy"
"211188",1,3,4,8,"dummy"
"211191",0,0,1,1,"dummy"
"211192",0,0,1,1,"dummy"
"211193",0,0,1,1,"dummy"
"211194",0,0,1,1,"dummy"
"211205",0,6,0,6,"dummy"
"211206",0,1,0,1,"dummy"
"211207",1,3,0,4,"dummy"
"211208",0,0,1,1,"dummy"
"211221",0,1,0,1,"dummy"
"211222",0,2,0,2,"dummy"
"211223",3,4,1,8,"dummy"
"211224",0,1,0,1,"dummy"
"211225",0,0,1,1,"dummy"
"211226",0,8,1,9,"dummy"
"211227",2,2,0,4,"dummy"
"211228",22,13,3,38,"dummy"
"211229",3,0,2,5,"dummy"
"211232",5,0,0,5,"dummy"
"211233",5,5,1,11,"dummy"
"211234",0,0,1,1,"dummy"
"211235",0,2,0,2,"dummy"
"211236",3,0,0,3,"dummy"
"211237",2,1,0,3,"dummy"
"211238",3,0,1,4,"dummy"
"211239",0,0,1,1,"dummy"
"211240",0,0,1,1,"dummy"
"211244",0,0,2,2,"dummy"
"211245",0,0,1,1,"dummy"
"211246",9,2,2,13,"dummy"
"211252",4,20,2,26,"dummy"
"211259",2,0,0,2,"dummy"
"211260",1,7,1,9,"dummy"
"211261",0,1,0,1,"dummy"
"211270",0,0,0,0,"dummy"
"211271",0,0,1,1,"dummy"
"211288",0,1,0,1,"dummy"
"211289",1,1,1,3,"dummy"
"211290",1,1,0,2,"dummy"
"211291",0,0,0,0,"dummy"
"211295",4,8,2,14,"dummy"
"211296",13,3,2,18,"dummy"
"211299",0,5,0,5,"dummy"
"211300",5,0,0,5,"dummy"
"211301",0,2,0,2,"dummy"
"211302",4,5,4,13,"dummy"
"211303",0,8,2,10,"dummy"
"211304",0,2,0,2,"dummy"
"211307",2,2,0,4,"dummy"
"211315",0,1,0,1,"dummy"
"211316",0,0,1,1,"dummy"
"211317",0,2,0,2,"dummy"
"211318",0,2,0,2,"dummy"
"211319",3,5,5,13,"dummy"
"211320",0,1,0,1,"dummy"
"211335",0,0,0,0,"dummy"
"211336",0,0,2,2,"dummy"
"211352",1,3,2,6,"dummy"
"211353",6,7,0,13,"dummy"
"211354",1,0,0,1,"dummy"
"211355",2,2,2,6,"dummy"
"211356",3,3,2,8,"dummy"
"211373",0,0,0,0,"dummy"
"211376",0,0,0,0,"dummy"
"211377",1,4,1,6,"dummy"
"211378",8,5,3,16,"dummy"
"211379",2,5,2,9,"dummy"
"211380",0,1,0,1,"dummy"
"211381",3,9,3,15,"dummy"
"211382",1,0,0,1,"dummy"
"211387",0,1,0,1,"dummy"
"211388",1,0,1,2,"dummy"
"211389",0,1,0,1,"dummy"
"211477",2,4,0,6,"dummy"
"211478",0,2,0,2,"dummy"
"211479",0,2,0,2,"dummy"
"211480",10,2,0,12,"dummy"
"211481",0,2,0,2,"dummy"
"211482",0,0,0,0,"dummy"
"211483",0,0,3,3,"dummy"
"211484",0,5,0,5,"dummy"
"211485",1,0,1,2,"dummy"
"211488",0,0,1,1,"dummy"
"211489",0,0,3,3,"dummy"
"211490",0,3,0,3,"dummy"
"211491",0,0,1,1,"dummy"
"211492",0,1,0,1,"dummy"
"211493",0,0,0,0,"dummy"
"211494",0,1,0,1,"dummy"
"211495",0,6,0,6,"dummy"
"211496",0,2,0,2,"dummy"
"211497",0,1,0,1,"dummy"
"211498",3,5,1,9,"dummy"
"211499",5,3,2,10,"dummy"
"211500",0,0,2,2,"dummy"
"211501",3,5,2,10,"dummy"
"211502",5,3,3,11,"dummy"
"211503",2,5,1,8,"dummy"
"211510",0,0,0,0,"dummy"
"211525",1,0,1,2,"dummy"
"211526",9,6,0,15,"dummy"
"211527",0,2,0,2,"dummy"
"211528",0,1,0,1,"dummy"
"211529",0,2,0,2,"dummy"
"211530",1,1,0,2,"dummy"
"211531",0,0,0,0,"dummy"
"211532",2,0,0,2,"dummy"
"211533",0,1,0,1,"dummy"
"211534",0,3,0,3,"dummy"
"211535",0,1,3,4,"dummy"
"211536",1,4,0,5,"dummy"
"211537",1,4,0,5,"dummy"
"211538",2,11,0,13,"dummy"
"211539",8,2,1,11,"dummy"
"211540",0,0,0,0,"dummy"
"211541",17,5,0,22,"dummy"
"211542",10,12,1,23,"dummy"
"211543",1,7,0,8,"dummy"
"211583",2,3,0,5,"dummy"
"211650",1,0,0,1,"dummy"
"211651",0,5,0,5,"dummy"
"211652",0,2,0,2,"dummy"
"211682",1,6,0,7,"dummy"
"211683",0,1,0,1,"dummy"
"211684",1,0,0,1,"dummy"
"211685",0,2,0,2,"dummy"
"211734",0,1,0,1,"dummy"
"211745",0,5,0,5,"dummy"
"211748",0,2,3,5,"dummy"
"211751",0,0,5,5,"dummy"
"211752",0,1,0,1,"dummy"
"211755",0,0,0,0,"dummy"
"211756",0,0,0,0,"dummy"
"211757",0,0,1,1,"dummy"
"211762",0,0,1,1,"dummy"
"211763",0,0,1,1,"dummy"
"211470",0,0,0,0,"dummy"
"211471",0,0,1,1,"dummy"
"211472",0,0,0,0,"dummy"
"211473",3,3,0,6,"dummy"
"211505",0,0,1,1,"dummy"
"211506",0,0,0,0,"dummy"
"211507",0,0,0,0,"dummy"
"211508",0,1,0,1,"dummy"
"211580",0,1,1,2,"dummy"
"211581",0,1,0,1,"dummy"
"211587",0,0,0,0,"dummy"
"211588",0,0,0,0,"dummy"
"211589",0,1,0,1,"dummy"
"211590",0,0,0,0,"dummy"
"211591",0,0,0,0,"dummy"
"211592",0,0,0,0,"dummy"
"211593",0,0,0,0,"dummy"
"211594",2,0,0,2,"dummy"
"211595",0,1,1,2,"dummy"
"211596",0,3,0,3,"dummy"
"211597",0,0,0,0,"dummy"
"211598",0,0,0,0,"dummy"
"211648",16,2,2,20,"dummy"
"211654",2,0,0,2,"dummy"
"211655",0,0,0,0,"dummy"
"211669",0,1,0,1,"dummy"
"211670",0,1,0,1,"dummy"
"211671",0,0,1,1,"dummy"
"211672",2,2,0,4,"dummy"
"211673",0,2,0,2,"dummy"
"211674",0,0,0,0,"dummy"
"211675",0,3,1,4,"dummy"
"211676",0,0,1,1,"dummy"
"211677",2,0,0,2,"dummy"
"211678",1,0,0,1,"dummy"
"211687",0,2,0,2,"dummy"
"211688",5,2,1,8,"dummy"
"211689",2,2,0,4,"dummy"
"211690",0,2,0,2,"dummy"
"211691",0,6,0,6,"dummy"
"211692",0,2,0,2,"dummy"
"211693",0,2,0,2,"dummy"
"211694",0,2,0,2,"dummy"
"211695",4,7,0,11,"dummy"
"211696",0,4,0,4,"dummy"
"211697",0,2,0,2,"dummy"
"211698",6,0,0,6,"dummy"
"211699",0,3,0,3,"dummy"
"211700",0,0,2,2,"dummy"
"211701",1,3,0,4,"dummy"
"211702",0,0,1,1,"dummy"
"211703",0,0,1,1,"dummy"
"211704",7,0,3,10,"dummy"
"211705",0,0,1,1,"dummy"
"211706",0,0,1,1,"dummy"
"211707",0,0,1,1,"dummy"
"211708",0,0,1,1,"dummy"
"211709",0,0,1,1,"dummy"
"211710",10,17,0,27,"dummy"
"211713",0,1,0,1,"dummy"
"211714",0,0,2,2,"dummy"
"211715",0,1,0,1,"dummy"
"211716",0,2,0,2,"dummy"
"211717",5,1,2,8,"dummy"
"211718",0,1,0,1,"dummy"
"211719",0,0,1,1,"dummy"
"211720",0,0,1,1,"dummy"
"211721",0,1,0,1,"dummy"
"211722",0,0,1,1,"dummy"
"211723",0,0,1,1,"dummy"
"211724",0,0,0,0,"dummy"
"211725",1,0,0,1,"dummy"
"211726",0,0,1,1,"dummy"
"211727",3,0,0,3,"dummy"
"211728",1,0,0,1,"dummy"
"211729",0,4,0,4,"dummy"
"211730",0,0,4,4,"dummy"
"211731",3,1,0,4,"dummy"
"211732",2,1,0,3,"dummy"
"211738",1,1,1,3,"dummy"
"211739",0,4,0,4,"dummy"
"211740",1,12,4,17,"dummy"
"211741",3,0,0,3,"dummy"
"211742",5,0,0,5,"dummy"
"211743",0,1,0,1,"dummy"
"211767",0,0,1,1,"dummy"
"211768",1,1,0,2,"dummy"
"211769",0,2,0,2,"dummy"
"211770",0,0,1,1,"dummy"
"211771",0,1,0,1,"dummy"
"211774",0,0,2,2,"dummy"
"211775",4,47,3,54,"dummy"
"211776",0,5,0,5,"dummy"
"211797",0,1,0,1,"dummy"
"211802",2,4,0,6,"dummy"
"211803",0,2,0,2,"dummy"
"211804",0,2,0,2,"dummy"
"211805",10,2,0,12,"dummy"
"211806",0,2,0,2,"dummy"
"211807",0,0,0,0,"dummy"
"211808",0,0,3,3,"dummy"
"211811",0,0,1,1,"dummy"
"211812",0,0,0,0,"dummy"
"211813",0,1,0,1,"dummy"
"211814",1,2,0,3,"dummy"
"211815",0,1,0,1,"dummy"
"211816",1,10,1,12,"dummy"
"211817",1,1,0,2,"dummy"
"211818",0,1,0,1,"dummy"
"211819",7,2,0,9,"dummy"
"211820",0,1,0,1,"dummy"
"211821",0,0,1,1,"dummy"
"211822",0,0,2,2,"dummy"
"211823",0,0,1,1,"dummy"
"211829",0,0,1,1,"dummy"
"211834",0,0,0,0,"dummy"
"211835",2,0,0,2,"dummy"
"211836",2,1,0,3,"dummy"
"211837",0,1,0,1,"dummy"
"211842",0,2,1,3,"dummy"
"211846",0,3,0,3,"dummy"
"211847",1,3,0,4,"dummy"
"211863",0,2,2,4,"dummy"
"211864",1,2,0,3,"dummy"
"211865",2,2,2,6,"dummy"
"211866",0,1,0,1,"dummy"
"211867",2,4,0,6,"dummy"
"211784",0,13,0,13,"dummy"
"211785",9,27,4,40,"dummy"
"211786",0,1,0,1,"dummy"
"211787",3,2,0,5,"dummy"
"211788",0,0,7,7,"dummy"
"211793",2,2,0,4,"dummy"
"211794",1,0,0,1,"dummy"
"211795",1,1,1,3,"dummy"
"211799",0,4,0,4,"dummy"
"211800",0,1,0,1,"dummy"
"211825",0,3,0,3,"dummy"
"211826",2,0,1,3,"dummy"
"211827",1,0,1,2,"dummy"
"211844",0,2,0,2,"dummy"
"211849",0,0,3,3,"dummy"
"211850",0,0,2,2,"dummy"
"211851",0,0,1,1,"dummy"
"211852",0,0,1,1,"dummy"
"211853",0,0,0,0,"dummy"
"211854",0,0,1,1,"dummy"
"211855",0,0,1,1,"dummy"
"211856",0,0,1,1,"dummy"
"211857",0,0,2,2,"dummy"
"211858",0,0,1,1,"dummy"
"211861",0,1,1,2,"dummy"
"211877",6,0,0,6,"dummy"
"211878",2,5,2,9,"dummy"
"211888",0,0,2,2,"dummy"
"211889",41,30,2,73,"dummy"
"211890",0,19,2,21,"dummy"
"211891",0,1,0,1,"dummy"
"211910",3,3,1,7,"dummy"
"211911",1,0,0,1,"dummy"
"211917",0,1,0,1,"dummy"
"211948",2,0,0,2,"dummy"
"211949",1,0,0,1,"dummy"
"211954",0,0,2,2,"dummy"
"211955",0,0,1,1,"dummy"
"211968",0,0,0,0,"dummy"
"211988",0,7,0,7,"dummy"
"211989",3,2,0,5,"dummy"
"211990",1,0,0,1,"dummy"
"211994",0,4,0,4,"dummy"
"211995",0,1,0,1,"dummy"
"211996",1,3,0,4,"dummy"
"211999",0,0,2,2,"dummy"
"212000",0,0,1,1,"dummy"
"212001",0,2,2,4,"dummy"
"212002",0,1,0,1,"dummy"
"212003",0,0,2,2,"dummy"
"212008",0,0,2,2,"dummy"
"212009",2,1,3,6,"dummy"
"212010",4,3,1,8,"dummy"
"212011",0,1,0,1,"dummy"
"212014",0,0,0,0,"dummy"
"212015",1,1,2,4,"dummy"
"212018",0,3,0,3,"dummy"
"212046",0,0,2,2,"dummy"
"212047",0,0,1,1,"dummy"
"212048",0,0,2,2,"dummy"
"212049",0,2,1,3,"dummy"
"212050",1,2,0,3,"dummy"
"212051",12,30,0,42,"dummy"
"211868",0,0,0,0,"dummy"
"211869",2,3,0,5,"dummy"
"211870",1,4,1,6,"dummy"
"211871",2,2,1,5,"dummy"
"211874",1,2,0,3,"dummy"
"211875",0,0,0,0,"dummy"
"211880",0,0,1,1,"dummy"
"211881",3,12,1,16,"dummy"
"211884",2,0,3,5,"dummy"
"211915",0,3,2,5,"dummy"
"211925",2,4,0,6,"dummy"
"211926",0,2,0,2,"dummy"
"211927",0,2,0,2,"dummy"
"211928",10,2,0,12,"dummy"
"211929",0,2,0,2,"dummy"
"211930",0,0,0,0,"dummy"
"211931",0,0,3,3,"dummy"
"211934",0,1,0,1,"dummy"
"211935",0,0,0,0,"dummy"
"211936",0,0,0,0,"dummy"
"211937",0,0,0,0,"dummy"
"211938",0,7,0,7,"dummy"
"211939",1,3,1,5,"dummy"
"211940",0,7,0,7,"dummy"
"211941",6,4,1,11,"dummy"
"211942",5,1,0,6,"dummy"
"211943",0,0,0,0,"dummy"
"211944",0,0,1,1,"dummy"
"211945",0,0,0,0,"dummy"
"211946",0,1,0,1,"dummy"
"211951",0,0,0,0,"dummy"
"211952",0,1,0,1,"dummy"
"211957",0,0,1,1,"dummy"
"211958",0,1,0,1,"dummy"
"211959",0,0,1,1,"dummy"
"211972",0,7,0,7,"dummy"
"211973",2,4,1,7,"dummy"
"211974",0,0,2,2,"dummy"
"211975",0,5,0,5,"dummy"
"211978",6,10,2,18,"dummy"
"211979",1,2,4,7,"dummy"
"211980",2,2,0,4,"dummy"
"211981",1,2,1,4,"dummy"
"211982",0,0,2,2,"dummy"
"211983",0,0,0,0,"dummy"
"211984",0,0,1,1,"dummy"
"211985",0,4,0,4,"dummy"
"211986",0,3,1,4,"dummy"
"211992",0,1,0,1,"dummy"
"212005",6,0,0,6,"dummy"
"212006",2,5,2,9,"dummy"
"212022",0,2,0,2,"dummy"
"212023",2,0,0,2,"dummy"
"212034",1,1,0,2,"dummy"
"212035",0,0,1,1,"dummy"
"212036",0,1,0,1,"dummy"
"212037",0,0,1,1,"dummy"
"212038",0,2,0,2,"dummy"
"212039",0,1,0,1,"dummy"
"212042",0,0,0,0,"dummy"
"212053",5,7,0,12,"dummy"
"212054",0,0,0,0,"dummy"
"212055",0,3,0,3,"dummy"
"212066",1,1,0,2,"dummy"
"212077",1,10,4,15,"dummy"
"212078",1,6,1,8,"dummy"
"212079",0,1,0,1,"dummy"
"212080",0,0,0,0,"dummy"
"212057",11,3,4,18,"dummy"
"212058",5,12,4,21,"dummy"
"212059",9,3,4,16,"dummy"
"212060",0,2,0,2,"dummy"
"212061",0,1,0,1,"dummy"
"212062",1,2,1,4,"dummy"
"212068",0,1,0,1,"dummy"
"212069",0,1,0,1,"dummy"
"212070",0,0,1,1,"dummy"
"212071",0,0,1,1,"dummy"
"212072",0,5,0,5,"dummy"
"212073",0,0,1,1,"dummy"
"212099",0,0,2,2,"dummy"
"212100",8,4,1,13,"dummy"
"212101",0,0,1,1,"dummy"
"212102",0,0,1,1,"dummy"
"212115",0,0,1,1,"dummy"
"212116",0,0,0,0,"dummy"
"212119",2,7,0,9,"dummy"
"212125",0,9,0,9,"dummy"
"212135",0,0,1,1,"dummy"
"212163",0,0,2,2,"dummy"
"212164",0,1,0,1,"dummy"
"212165",13,5,2,20,"dummy"
"212209",0,0,2,2,"dummy"
"212214",0,0,2,2,"dummy"
"212223",0,0,0,0,"dummy"
"212224",0,0,0,0,"dummy"
"212227",0,21,0,21,"dummy"
"212230",0,0,0,0,"dummy"
"212231",0,0,0,0,"dummy"
"212247",1,2,3,6,"dummy"
"212252",0,0,1,1,"dummy"
"212253",0,1,0,1,"dummy"
"212254",1,0,0,1,"dummy"
"212255",1,0,0,1,"dummy"
"212256",1,0,0,1,"dummy"
"212257",1,1,0,2,"dummy"
"212258",3,1,0,4,"dummy"
"212259",0,1,0,1,"dummy"
"212267",0,0,0,0,"dummy"
"212268",1,2,1,4,"dummy"
"212104",0,8,0,8,"dummy"
"212105",0,0,5,5,"dummy"
"212106",5,7,0,12,"dummy"
"212109",0,1,0,1,"dummy"
"212121",0,0,1,1,"dummy"
"212127",0,1,0,1,"dummy"
"212130",0,0,2,2,"dummy"
"212131",0,1,0,1,"dummy"
"212171",2,0,3,5,"dummy"
"212172",1,0,0,1,"dummy"
"212173",0,1,0,1,"dummy"
"212174",0,1,1,2,"dummy"
"212177",0,0,1,1,"dummy"
"212178",0,0,3,3,"dummy"
"212181",0,1,0,1,"dummy"
"212202",0,0,1,1,"dummy"
"212203",0,1,0,1,"dummy"
"212204",0,0,1,1,"dummy"
"212205",0,0,1,1,"dummy"
"212206",0,0,0,0,"dummy"
"212207",10,17,1,28,"dummy"
"212211",0,4,0,4,"dummy"
"212212",3,0,1,4,"dummy"
"212216",0,0,1,1,"dummy"
"212217",0,0,1,1,"dummy"
"212243",1,0,1,2,"dummy"
"212244",1,2,1,4,"dummy"
"212245",1,0,2,3,"dummy"
"212261",0,0,1,1,"dummy"
"212262",2,4,1,7,"dummy"
"212263",0,3,2,5,"dummy"
"212264",0,1,0,1,"dummy"
"212265",3,0,2,5,"dummy"
"212270",0,4,0,4,"dummy"
"212271",3,12,0,15,"dummy"
"212272",0,2,4,6,"dummy"
"212280",3,0,0,3,"dummy"
"212281",0,3,0,3,"dummy"
"212283",0,1,0,1,"dummy"
"212286",1,1,0,2,"dummy"
"212298",0,0,2,2,"dummy"
"212299",0,0,2,2,"dummy"
"212301",0,2,0,2,"dummy"
"212302",0,2,1,3,"dummy"
"212303",0,1,0,1,"dummy"
"212306",0,1,0,1,"dummy"
"212310",1,0,3,4,"dummy"
"212311",0,0,0,0,"dummy"
"212312",0,1,1,2,"dummy"
"212313",0,1,0,1,"dummy"
"212314",2,2,1,5,"dummy"
"212317",0,0,3,3,"dummy"
"212320",0,3,0,3,"dummy"
"212321",0,2,2,4,"dummy"
"212322",1,0,0,1,"dummy"
"212323",1,0,1,2,"dummy"
"212324",0,1,0,1,"dummy"
"212325",0,0,0,0,"dummy"
"212326",0,0,0,0,"dummy"
"212327",1,0,0,1,"dummy"
"212329",0,0,0,0,"dummy"
"212332",1,9,1,11,"dummy"
"212339",0,0,1,1,"dummy"
"212340",0,0,1,1,"dummy"
"212341",0,1,0,1,"dummy"
"212342",0,1,0,1,"dummy"
"212343",0,3,0,3,"dummy"
"212346",0,0,1,1,"dummy"
"212347",1,3,0,4,"dummy"
"212348",0,0,1,1,"dummy"
"212349",0,0,2,2,"dummy"
"212357",0,0,0,0,"dummy"
"212359",0,1,4,5,"dummy"
"212360",0,0,1,1,"dummy"
"212361",0,0,1,1,"dummy"
"212362",2,1,0,3,"dummy"
"212363",0,0,1,1,"dummy"
"212383",0,0,3,3,"dummy"
"212393",4,5,2,11,"dummy"
"212394",0,0,0,0,"dummy"
"212395",1,0,0,1,"dummy"
"212396",0,0,0,0,"dummy"
"212397",0,0,0,0,"dummy"
"212398",0,0,0,0,"dummy"
"212399",0,0,1,1,"dummy"
"212412",0,2,0,2,"dummy"
"212413",3,0,2,5,"dummy"
"212415",0,1,0,1,"dummy"
"212418",0,3,0,3,"dummy"
"212419",0,2,1,3,"dummy"
"212421",0,1,0,1,"dummy"
"212422",0,0,0,0,"dummy"
"212423",0,0,0,0,"dummy"
"212424",0,0,0,0,"dummy"
"212425",0,0,0,0,"dummy"
"212426",0,0,0,0,"dummy"
"212427",0,0,0,0,"dummy"
"212428",0,0,0,0,"dummy"
"212429",0,0,0,0,"dummy"
"212430",0,0,0,0,"dummy"
"212431",0,0,0,0,"dummy"
"212432",0,0,1,1,"dummy"
"212433",0,0,0,0,"dummy"
"212434",0,0,0,0,"dummy"
"212435",0,0,0,0,"dummy"
"212442",0,0,1,1,"dummy"
"212444",0,1,1,2,"dummy"
"212445",0,0,1,1,"dummy"
"212446",1,1,0,2,"dummy"
"212447",0,1,0,1,"dummy"
"212448",1,2,1,4,"dummy"
"212449",0,2,1,3,"dummy"
"212450",2,4,0,6,"dummy"
"212451",2,3,2,7,"dummy"
"212453",0,0,1,1,"dummy"
"212454",6,6,1,13,"dummy"
"212455",0,3,1,4,"dummy"
"212460",3,3,2,8,"dummy"
"212461",1,5,0,6,"dummy"
"212462",8,10,12,30,"dummy"
"212463",1,3,0,4,"dummy"
"212464",0,10,0,10,"dummy"
"212465",2,7,0,9,"dummy"
"212466",1,0,0,1,"dummy"
"212467",0,0,1,1,"dummy"
"212468",2,2,0,4,"dummy"
"212471",1,0,8,9,"dummy"
"212472",0,0,4,4,"dummy"
"212473",0,2,0,2,"dummy"
"212474",1,0,0,1,"dummy"
"212475",0,0,1,1,"dummy"
"212476",5,6,9,20,"dummy"
"212477",0,1,0,1,"dummy"
"212478",7,7,1,15,"dummy"
"212479",0,2,0,2,"dummy"
"212480",4,2,3,9,"dummy"
"212497",0,0,0,0,"dummy"
"212520",0,0,7,7,"dummy"
"212521",4,10,0,14,"dummy"
"212522",2,0,0,2,"dummy"
"212523",0,6,0,6,"dummy"
"212524",2,2,0,4,"dummy"
"212525",0,0,1,1,"dummy"
"212530",0,0,0,0,"dummy"
"212533",0,0,1,1,"dummy"
"212534",0,0,3,3,"dummy"
"212536",0,0,1,1,"dummy"
"212537",0,0,0,0,"dummy"
"212596",0,0,3,3,"dummy"
"212597",0,0,2,2,"dummy"
"212598",0,10,0,10,"dummy"
"212599",3,0,0,3,"dummy"
"212600",2,8,1,11,"dummy"
"212601",0,1,3,4,"dummy"
"212602",2,2,0,4,"dummy"
"212604",3,0,2,5,"dummy"
"212605",0,2,0,2,"dummy"
"212606",1,0,1,2,"dummy"
"212607",0,0,1,1,"dummy"
"212608",0,0,1,1,"dummy"
"212614",0,0,1,1,"dummy"
"212618",0,0,0,0,"dummy"
"212619",0,0,1,1,"dummy"
"212620",0,0,0,0,"dummy"
"212621",0,0,0,0,"dummy"
"212622",1,2,0,3,"dummy"
"212623",2,1,1,4,"dummy"
"212624",0,0,1,1,"dummy"
"212625",0,0,0,0,"dummy"
"212626",0,0,2,2,"dummy"
"212627",0,0,0,0,"dummy"
"212628",0,0,1,1,"dummy"
"212629",0,0,0,0,"dummy"
"212632",0,3,0,3,"dummy"
"212633",0,1,0,1,"dummy"
"212636",0,0,1,1,"dummy"
"212639",8,5,2,15,"dummy"
"212640",8,1,0,9,"dummy"
"212641",3,10,5,18,"dummy"
"212643",1,1,1,3,"dummy"
"212644",0,0,1,1,"dummy"
"212645",0,0,1,1,"dummy"
"212648",0,3,2,5,"dummy"
"212649",1,4,0,5,"dummy"
"212650",0,1,0,1,"dummy"
"212651",0,1,1,2,"dummy"
"212652",0,4,3,7,"dummy"
"212653",0,1,1,2,"dummy"
"212654",0,1,0,1,"dummy"
"212655",9,2,5,16,"dummy"
"212656",0,1,1,2,"dummy"
"212657",0,1,1,2,"dummy"
"212658",5,2,5,12,"dummy"
"212663",0,0,0,0,"dummy"
"212668",0,11,0,11,"dummy"
"212669",1,2,1,4,"dummy"
"212670",0,6,0,6,"dummy"
"212671",0,2,0,2,"dummy"
"212672",7,4,0,11,"dummy"
"212673",0,4,1,5,"dummy"
"212675",0,0,3,3,"dummy"
"212676",0,0,1,1,"dummy"
"212677",0,1,0,1,"dummy"
"212678",12,5,3,20,"dummy"
"212681",8,13,3,24,"dummy"
"212684",0,0,1,1,"dummy"
"212685",0,0,2,2,"dummy"
"212686",2,0,4,6,"dummy"
"212687",0,0,4,4,"dummy"
"212688",0,0,1,1,"dummy"
"212691",1,19,5,25,"dummy"
"212694",0,3,0,3,"dummy"
"212695",0,5,2,7,"dummy"
"212696",0,0,1,1,"dummy"
"212697",2,4,0,6,"dummy"
"212698",0,1,0,1,"dummy"
"212700",0,0,1,1,"dummy"
"212706",2,1,1,4,"dummy"
"212707",0,0,0,0,"dummy"
"212708",0,0,4,4,"dummy"
"212709",0,0,1,1,"dummy"
"212710",0,0,0,0,"dummy"
"212712",2,9,0,11,"dummy"
"212717",0,4,1,5,"dummy"
"212720",0,1,1,2,"dummy"
"212725",0,1,1,2,"dummy"
"212726",0,1,0,1,"dummy"
"212728",0,0,1,1,"dummy"
"212730",6,2,0,8,"dummy"
"212731",0,0,1,1,"dummy"
"212732",0,0,2,2,"dummy"
"212733",0,0,2,2,"dummy"
"212734",0,0,1,1,"dummy"
"212735",0,0,0,0,"dummy"
"212736",1,1,0,2,"dummy"
"212737",1,1,0,2,"dummy"
"212738",1,1,0,2,"dummy"
"212739",0,0,1,1,"dummy"
"212740",0,0,1,1,"dummy"
"212746",0,1,0,1,"dummy"
"212751",0,0,1,1,"dummy"
"212752",0,0,1,1,"dummy"
"212753",0,0,2,2,"dummy"
"212754",26,3,7,36,"dummy"
"212759",0,6,2,8,"dummy"
"212760",0,0,0,0,"dummy"
"212761",0,1,0,1,"dummy"
"212762",0,0,1,1,"dummy"
"212763",3,5,0,8,"dummy"
"212764",0,0,0,0,"dummy"
"212823",1,6,0,7,"dummy"
"212824",0,0,2,2,"dummy"
"212825",1,3,0,4,"dummy"
"212827",0,1,0,1,"dummy"
"212828",4,1,0,5,"dummy"
"212829",0,3,0,3,"dummy"
"212830",0,1,0,1,"dummy"
"212839",0,0,0,0,"dummy"
"212840",0,0,1,1,"dummy"
"212842",0,1,0,1,"dummy"
"212843",3,17,0,20,"dummy"
"212863",0,0,1,1,"dummy"
"212866",0,1,0,1,"dummy"
"212868",0,1,0,1,"dummy"
"212872",0,4,0,4,"dummy"
"212880",0,1,1,2,"dummy"
"212882",0,4,0,4,"dummy"
"212883",0,1,1,2,"dummy"
"212884",0,4,0,4,"dummy"
"212885",2,1,0,3,"dummy"
"212886",0,2,0,2,"dummy"
"212887",0,2,0,2,"dummy"
"212892",1,7,2,10,"dummy"
"212926",0,0,1,1,"dummy"
"212927",0,14,0,14,"dummy"
"212929",0,0,2,2,"dummy"
"212930",0,1,0,1,"dummy"
"212931",0,1,0,1,"dummy"
"212932",0,0,0,0,"dummy"
"212933",0,0,0,0,"dummy"
"212934",0,0,0,0,"dummy"
"212935",1,2,2,5,"dummy"
"212936",0,0,1,1,"dummy"
"212937",1,3,1,5,"dummy"
"212938",2,1,0,3,"dummy"
"212939",4,5,1,10,"dummy"
"212940",0,0,0,0,"dummy"
"212941",6,5,0,11,"dummy"
"212942",5,5,0,10,"dummy"
"212943",0,1,1,2,"dummy"
"212944",13,2,2,17,"dummy"
"212956",0,0,0,0,"dummy"
"212957",0,0,1,1,"dummy"
"212958",0,0,0,0,"dummy"
"212959",0,0,1,1,"dummy"
"212960",0,0,0,0,"dummy"
"212970",0,1,0,1,"dummy"
"212997",0,2,0,2,"dummy"
"212998",0,0,2,2,"dummy"
"212999",0,2,0,2,"dummy"
"213000",0,1,0,1,"dummy"
"213001",4,7,2,13,"dummy"
"213002",0,2,0,2,"dummy"
"213003",0,1,0,1,"dummy"
"213004",0,2,0,2,"dummy"
"213011",0,0,1,1,"dummy"
"213018",0,0,0,0,"dummy"
"213019",0,0,1,1,"dummy"
"213020",3,0,0,3,"dummy"
"213021",0,0,1,1,"dummy"
"213022",0,1,0,1,"dummy"
"213023",0,2,0,2,"dummy"
"213026",1,0,1,2,"dummy"
"213030",0,0,0,0,"dummy"
"213031",0,0,0,0,"dummy"
"213032",0,0,0,0,"dummy"
"213033",0,0,0,0,"dummy"
"213055",0,2,0,2,"dummy"
"213056",0,1,1,2,"dummy"
"213057",7,19,1,27,"dummy"
"213063",1,1,0,2,"dummy"
"213064",0,0,3,3,"dummy"
"213074",0,0,1,1,"dummy"
"213075",0,1,0,1,"dummy"
"213076",0,0,1,1,"dummy"
"213083",0,0,0,0,"dummy"
"213089",19,2,2,23,"dummy"
"213094",0,0,1,1,"dummy"
"213104",0,0,0,0,"dummy"
"213130",1,0,1,2,"dummy"
"213131",0,0,2,2,"dummy"
"213132",1,0,0,1,"dummy"
"213133",0,3,4,7,"dummy"
"213144",0,6,0,6,"dummy"
"213149",0,0,1,1,"dummy"
"213154",0,6,0,6,"dummy"
"213288",2,0,0,2,"dummy"
"213289",2,9,3,14,"dummy"
"213317",0,2,0,2,"dummy"
"213324",0,3,1,4,"dummy"
"213329",1,3,0,4,"dummy"
"213330",0,0,1,1,"dummy"
"213331",2,1,1,4,"dummy"
"213332",0,15,2,17,"dummy"
"212968",0,0,2,2,"dummy"
"212972",0,0,2,2,"dummy"
"212973",0,0,1,1,"dummy"
"212974",0,0,0,0,"dummy"
"212975",2,7,2,11,"dummy"
"212976",1,0,0,1,"dummy"
"212977",0,10,0,10,"dummy"
"212978",2,2,2,6,"dummy"
"212981",7,3,0,10,"dummy"
"212982",0,1,0,1,"dummy"
"212983",0,1,0,1,"dummy"
"212984",0,1,0,1,"dummy"
"212985",0,2,0,2,"dummy"
"212986",0,1,0,1,"dummy"
"212987",1,2,1,4,"dummy"
"212988",0,0,1,1,"dummy"
"213013",0,0,0,0,"dummy"
"213014",0,0,0,0,"dummy"
"213015",0,1,0,1,"dummy"
"213016",0,1,1,2,"dummy"
"213035",0,2,0,2,"dummy"
"213036",0,0,1,1,"dummy"
"213037",0,2,0,2,"dummy"
"213038",0,0,0,0,"dummy"
"213039",0,0,0,0,"dummy"
"213040",0,1,0,1,"dummy"
"213041",0,0,0,0,"dummy"
"213053",0,0,1,1,"dummy"
"213061",0,0,0,0,"dummy"
"213066",0,4,0,4,"dummy"
"213067",6,5,2,13,"dummy"
"213072",1,0,0,1,"dummy"
"213085",0,1,0,1,"dummy"
"213098",2,0,0,2,"dummy"
"213101",4,0,1,5,"dummy"
"213102",0,0,0,0,"dummy"
"213106",1,1,1,3,"dummy"
"213107",0,1,0,1,"dummy"
"213108",0,1,0,1,"dummy"
"213109",0,0,1,1,"dummy"
"213127",5,0,1,6,"dummy"
"213128",10,12,1,23,"dummy"
"213135",0,1,0,1,"dummy"
"213136",0,0,1,1,"dummy"
"213137",0,1,0,1,"dummy"
"213138",0,3,0,3,"dummy"
"213139",3,0,0,3,"dummy"
"213140",0,0,2,2,"dummy"
"213141",0,0,1,1,"dummy"
"213142",0,2,0,2,"dummy"
"213160",0,5,0,5,"dummy"
"213161",0,1,0,1,"dummy"
"213162",0,2,0,2,"dummy"
"213163",0,10,0,10,"dummy"
"213164",8,4,1,13,"dummy"
"213165",0,0,1,1,"dummy"
"213166",0,0,1,1,"dummy"
"213167",0,1,0,1,"dummy"
"213168",1,1,0,2,"dummy"
"213169",1,1,0,2,"dummy"
"213170",0,1,0,1,"dummy"
"213171",0,0,1,1,"dummy"
"213172",1,1,0,2,"dummy"
"213175",2,2,0,4,"dummy"
"213176",2,0,0,2,"dummy"
"213177",0,1,0,1,"dummy"
"213178",2,3,1,6,"dummy"
"213179",0,0,1,1,"dummy"
"213180",1,1,0,2,"dummy"
"213181",0,3,0,3,"dummy"
"213182",0,0,0,0,"dummy"
"213291",4,5,0,9,"dummy"
"213292",0,0,1,1,"dummy"
"213293",0,4,1,5,"dummy"
"213294",0,0,1,1,"dummy"
"213295",0,1,0,1,"dummy"
"213296",5,5,2,12,"dummy"
"213297",0,1,0,1,"dummy"
"213302",0,0,2,2,"dummy"
"213309",0,3,1,4,"dummy"
"213310",0,11,0,11,"dummy"
"213311",0,1,0,1,"dummy"
"213312",0,1,1,2,"dummy"
"213315",0,8,5,13,"dummy"
"213321",10,1,0,11,"dummy"
"213322",1,1,0,2,"dummy"
"213339",1,0,0,1,"dummy"
"213340",0,0,2,2,"dummy"
"213341",3,3,2,8,"dummy"
"213359",0,1,0,1,"dummy"
"213360",1,3,0,4,"dummy"
"213361",0,1,0,1,"dummy"
"213366",12,13,1,26,"dummy"
"213367",1,5,0,6,"dummy"
"213368",0,1,0,1,"dummy"
"213369",6,7,14,27,"dummy"
"213370",0,1,0,1,"dummy"
"213371",2,2,1,5,"dummy"
"213372",13,24,4,41,"dummy"
"213373",0,0,2,2,"dummy"
"213374",1,2,3,6,"dummy"
"213375",0,2,2,4,"dummy"
"213376",1,4,0,5,"dummy"
"213377",0,2,1,3,"dummy"
"213378",6,8,3,17,"dummy"
"213379",0,0,2,2,"dummy"
"213380",0,1,0,1,"dummy"
"213388",0,0,1,1,"dummy"
"213393",0,1,1,2,"dummy"
"213398",0,0,8,8,"dummy"
"213402",2,2,1,5,"dummy"
"213420",2,0,3,5,"dummy"
"213434",2,0,3,5,"dummy"
"213441",2,2,2,6,"dummy"
"213442",0,0,1,1,"dummy"
"213451",12,58,2,72,"dummy"
"213455",0,0,2,2,"dummy"
"213459",0,1,0,1,"dummy"
"213460",1,2,0,3,"dummy"
"213467",0,1,0,1,"dummy"
"213468",1,1,0,2,"dummy"
"213469",0,1,0,1,"dummy"
"213470",0,1,0,1,"dummy"
"213471",0,1,0,1,"dummy"
"213472",0,1,0,1,"dummy"
"213333",0,0,0,0,"dummy"
"213334",0,1,0,1,"dummy"
"213335",1,3,1,5,"dummy"
"213336",6,5,1,12,"dummy"
"213337",0,1,1,2,"dummy"
"213343",0,2,0,2,"dummy"
"213346",3,8,2,13,"dummy"
"213347",0,1,0,1,"dummy"
"213348",0,12,0,12,"dummy"
"213349",6,6,0,12,"dummy"
"213350",0,1,0,1,"dummy"
"213353",12,2,0,14,"dummy"
"213354",1,3,0,4,"dummy"
"213355",0,0,0,0,"dummy"
"213356",0,1,0,1,"dummy"
"213357",1,0,0,1,"dummy"
"213363",0,0,2,2,"dummy"
"213364",7,9,4,20,"dummy"
"213382",1,8,0,9,"dummy"
"213395",11,1,0,12,"dummy"
"213396",0,2,0,2,"dummy"
"213400",1,3,4,8,"dummy"
"213404",0,0,1,1,"dummy"
"213405",0,0,2,2,"dummy"
"213406",0,0,1,1,"dummy"
"213407",0,0,0,0,"dummy"
"213408",2,0,0,2,"dummy"
"213409",0,0,1,1,"dummy"
"213410",3,2,0,5,"dummy"
"213411",0,1,0,1,"dummy"
"213412",0,1,0,1,"dummy"
"213413",0,0,1,1,"dummy"
"213414",0,0,1,1,"dummy"
"213415",0,2,0,2,"dummy"
"213416",0,1,0,1,"dummy"
"213422",3,5,0,8,"dummy"
"213431",0,0,0,0,"dummy"
"213432",0,0,1,1,"dummy"
"213453",0,1,0,1,"dummy"
"213457",0,0,0,0,"dummy"
"213462",0,0,1,1,"dummy"
"213463",6,8,0,14,"dummy"
"213464",0,0,5,5,"dummy"
"213465",0,0,5,5,"dummy"
"213495",4,9,3,16,"dummy"
"213496",0,0,0,0,"dummy"
"213497",0,0,0,0,"dummy"
"213498",0,0,0,0,"dummy"
"213499",0,0,0,0,"dummy"
"213500",0,0,0,0,"dummy"
"213501",0,0,1,1,"dummy"
"213502",6,6,0,12,"dummy"
"213505",0,0,1,1,"dummy"
"213493",0,0,1,1,"dummy"
"213526",0,2,0,2,"dummy"
"213527",0,0,1,1,"dummy"
"213528",0,0,1,1,"dummy"
"213529",0,0,1,1,"dummy"
"213530",0,0,1,1,"dummy"
"213531",0,0,0,0,"dummy"
"213532",0,0,1,1,"dummy"
"213533",0,0,1,1,"dummy"
"213534",0,0,1,1,"dummy"
"213535",0,0,1,1,"dummy"
"213536",0,0,1,1,"dummy"
"213537",0,0,1,1,"dummy"
"213538",0,0,1,1,"dummy"
"213539",0,0,1,1,"dummy"
"213540",0,0,1,1,"dummy"
"213541",0,0,1,1,"dummy"
"213542",0,0,1,1,"dummy"
"213543",0,0,1,1,"dummy"
"213544",0,0,1,1,"dummy"
"213545",0,0,1,1,"dummy"
"213546",0,0,1,1,"dummy"
"213547",0,0,1,1,"dummy"
"213548",0,0,1,1,"dummy"
"213549",0,0,1,1,"dummy"
"213550",0,0,1,1,"dummy"
"213551",0,0,1,1,"dummy"
"213552",0,0,1,1,"dummy"
"213553",0,0,1,1,"dummy"
"213554",0,0,1,1,"dummy"
"213555",0,0,1,1,"dummy"
"213556",0,0,1,1,"dummy"
"213557",0,0,1,1,"dummy"
"213558",0,0,1,1,"dummy"
"213559",0,0,1,1,"dummy"
"213560",0,0,1,1,"dummy"
"213561",0,0,1,1,"dummy"
"213562",0,0,1,1,"dummy"
"213563",0,0,1,1,"dummy"
"213564",0,0,1,1,"dummy"
"213565",0,0,1,1,"dummy"
"213566",0,0,1,1,"dummy"
"213567",0,0,1,1,"dummy"
"213568",0,0,1,1,"dummy"
"213569",0,0,1,1,"dummy"
"213570",0,0,1,1,"dummy"
"213571",0,0,1,1,"dummy"
"213572",0,0,1,1,"dummy"
"213573",0,0,1,1,"dummy"
"213574",0,0,1,1,"dummy"
"213575",0,0,1,1,"dummy"
"213576",0,0,1,1,"dummy"
"213577",0,0,1,1,"dummy"
"213578",0,0,1,1,"dummy"
"213579",0,0,1,1,"dummy"
"213580",0,0,1,1,"dummy"
"213581",0,0,1,1,"dummy"
"213582",0,0,1,1,"dummy"
"213583",0,0,1,1,"dummy"
"213584",0,0,1,1,"dummy"
"213585",0,0,1,1,"dummy"
"213586",0,0,1,1,"dummy"
"213587",0,0,1,1,"dummy"
"213588",0,0,1,1,"dummy"
"213589",0,0,1,1,"dummy"
"213590",0,0,1,1,"dummy"
"213591",0,0,1,1,"dummy"
"213592",0,0,1,1,"dummy"
"213593",0,0,1,1,"dummy"
"213594",0,0,1,1,"dummy"
"213595",0,0,1,1,"dummy"
"213596",0,0,1,1,"dummy"
"213597",0,0,1,1,"dummy"
"213598",0,0,1,1,"dummy"
"213599",0,0,1,1,"dummy"
"213600",0,0,1,1,"dummy"
"213601",0,0,1,1,"dummy"
"213602",0,0,1,1,"dummy"
"213603",0,0,1,1,"dummy"
"213604",0,0,1,1,"dummy"
"213605",0,0,1,1,"dummy"
"213608",0,1,1,2,"dummy"
"213609",1,1,0,2,"dummy"
"213612",0,0,2,2,"dummy"
"213615",0,1,0,1,"dummy"
"213617",2,0,0,2,"dummy"
"213618",0,4,0,4,"dummy"
"213623",0,3,0,3,"dummy"
"213624",0,1,0,1,"dummy"
"213625",0,3,0,3,"dummy"
"213628",0,0,1,1,"dummy"
"213630",0,0,2,2,"dummy"
"213635",2,4,0,6,"dummy"
"213636",0,2,0,2,"dummy"
"213637",0,2,0,2,"dummy"
"213638",10,2,0,12,"dummy"
"213639",0,2,0,2,"dummy"
"213640",0,0,0,0,"dummy"
"213641",0,0,3,3,"dummy"
"213643",6,0,0,6,"dummy"
"213644",2,5,2,9,"dummy"
"213657",0,1,0,1,"dummy"
"213659",2,2,1,5,"dummy"
"213661",0,1,0,1,"dummy"
"213662",1,0,0,1,"dummy"
"213667",1,12,0,13,"dummy"
"213668",0,0,1,1,"dummy"
"213669",0,1,0,1,"dummy"
"213670",0,0,7,7,"dummy"
"213674",1,2,0,3,"dummy"
"213675",0,0,1,1,"dummy"
"213676",0,0,1,1,"dummy"
"213677",0,0,1,1,"dummy"
"213678",0,1,0,1,"dummy"
"213680",14,0,3,17,"dummy"
"213681",1,0,2,3,"dummy"
"213684",0,3,1,4,"dummy"
"213685",0,4,1,5,"dummy"
"213686",8,13,10,31,"dummy"
"213687",0,0,0,0,"dummy"
"213688",2,2,1,5,"dummy"
"213690",0,1,0,1,"dummy"
"213696",5,2,0,7,"dummy"
"213699",0,0,1,1,"dummy"
"213700",1,0,0,1,"dummy"
"213702",0,0,1,1,"dummy"
"213705",6,10,0,16,"dummy"
"213706",4,2,0,6,"dummy"
"213711",0,0,1,1,"dummy"
"213712",19,20,3,42,"dummy"
"213713",4,4,1,9,"dummy"
"213714",7,4,3,14,"dummy"
"213715",0,0,0,0,"dummy"
"213716",0,0,1,1,"dummy"
"213717",0,0,1,1,"dummy"
"213718",0,0,1,1,"dummy"
"213719",3,0,1,4,"dummy"
"213720",2,2,5,9,"dummy"
"213721",0,0,0,0,"dummy"
"213722",1,0,1,2,"dummy"
"213723",2,2,0,4,"dummy"
"213724",0,0,1,1,"dummy"
"213725",0,0,1,1,"dummy"
"213726",0,0,1,1,"dummy"
"213727",0,0,1,1,"dummy"
"213728",0,2,0,2,"dummy"
"213729",0,0,2,2,"dummy"
"213730",0,0,1,1,"dummy"
"213731",0,0,1,1,"dummy"
"213732",0,5,1,6,"dummy"
"213733",1,0,0,1,"dummy"
"213734",0,0,1,1,"dummy"
"213735",0,1,0,1,"dummy"
"213736",0,0,1,1,"dummy"
"213737",0,0,1,1,"dummy"
"213738",3,0,0,3,"dummy"
"213739",0,0,1,1,"dummy"
"213740",0,0,1,1,"dummy"
"213741",0,0,1,1,"dummy"
"213742",0,0,1,1,"dummy"
"213743",0,0,1,1,"dummy"
"213744",10,10,1,21,"dummy"
"213745",0,0,2,2,"dummy"
"213746",0,0,1,1,"dummy"
"213747",0,0,1,1,"dummy"
"213751",0,5,2,7,"dummy"
"213756",0,3,0,3,"dummy"
"213757",1,4,1,6,"dummy"
"213759",0,0,1,1,"dummy"
"213760",7,1,1,9,"dummy"
"213761",0,1,1,2,"dummy"
"213762",1,5,2,8,"dummy"
"213763",6,3,0,9,"dummy"
"213764",0,0,1,1,"dummy"
"213765",3,1,0,4,"dummy"
"213766",0,0,0,0,"dummy"
"213767",0,1,0,1,"dummy"
"213768",0,0,1,1,"dummy"
"213769",0,0,0,0,"dummy"
"213771",0,0,0,0,"dummy"
"213773",0,3,5,8,"dummy"
"213774",6,6,2,14,"dummy"
"213775",0,2,1,3,"dummy"
"213776",3,3,3,9,"dummy"
"213777",0,0,2,2,"dummy"
"213778",3,0,3,6,"dummy"
"213779",0,1,0,1,"dummy"
"213780",1,0,0,1,"dummy"
"213781",0,1,0,1,"dummy"
"213782",2,7,0,9,"dummy"
"213783",6,1,3,10,"dummy"
"213784",0,0,1,1,"dummy"
"213785",9,7,2,18,"dummy"
"213786",0,0,1,1,"dummy"
"213787",0,0,1,1,"dummy"
"213788",0,0,1,1,"dummy"
"213789",0,0,1,1,"dummy"
"213790",0,0,1,1,"dummy"
"213792",0,3,0,3,"dummy"
"213793",0,1,0,1,"dummy"
"213794",0,1,0,1,"dummy"
"213795",0,0,1,1,"dummy"
"213796",0,1,0,1,"dummy"
"213797",0,1,0,1,"dummy"
"213798",0,4,0,4,"dummy"
"213801",0,0,1,1,"dummy"
"213802",0,0,1,1,"dummy"
"213803",0,0,1,1,"dummy"
"213804",0,0,1,1,"dummy"
"213805",1,0,0,1,"dummy"
"213806",0,1,0,1,"dummy"
"213807",1,1,0,2,"dummy"
"213808",0,0,0,0,"dummy"
"213809",0,0,1,1,"dummy"
"213810",0,1,2,3,"dummy"
"213811",0,5,1,6,"dummy"
"213812",0,0,0,0,"dummy"
"213813",1,1,0,2,"dummy"
"213814",0,4,0,4,"dummy"
"213815",0,0,3,3,"dummy"
"213816",3,8,2,13,"dummy"
"213817",0,0,1,1,"dummy"
"213818",0,1,0,1,"dummy"
"213819",0,0,1,1,"dummy"
"213820",0,0,2,2,"dummy"
"213821",0,2,0,2,"dummy"
"213822",1,0,2,3,"dummy"
"213823",3,3,0,6,"dummy"
"213825",0,0,1,1,"dummy"
"213826",0,0,1,1,"dummy"
"213827",0,0,2,2,"dummy"
"213828",26,3,7,36,"dummy"
"213830",1,4,0,5,"dummy"
"213833",1,12,2,15,"dummy"
"213835",0,0,1,1,"dummy"
"213836",0,0,1,1,"dummy"
"213843",0,0,3,3,"dummy"
"213845",4,4,1,9,"dummy"
"213847",0,1,0,1,"dummy"
"213848",1,2,0,3,"dummy"
"213864",0,1,0,1,"dummy"
"213869",0,3,1,4,"dummy"
"213870",0,3,0,3,"dummy"
"213872",0,0,1,1,"dummy"
"213874",0,1,0,1,"dummy"
"213875",0,0,2,2,"dummy"
"213876",1,0,0,1,"dummy"
"213877",0,1,0,1,"dummy"
"213878",0,7,0,7,"dummy"
"213879",2,4,2,8,"dummy"
"213880",1,1,1,3,"dummy"
"213881",0,0,2,2,"dummy"
"213882",0,0,2,2,"dummy"
"213883",0,2,0,2,"dummy"
"213884",0,0,2,2,"dummy"
"213885",2,3,1,6,"dummy"
"213890",0,1,1,2,"dummy"
"213892",0,3,0,3,"dummy"
"213893",1,5,0,6,"dummy"
"213902",0,0,1,1,"dummy"
"213903",0,0,0,0,"dummy"
"213905",0,2,0,2,"dummy"
"213906",0,1,2,3,"dummy"
"213907",0,8,1,9,"dummy"
"213908",0,2,0,2,"dummy"
"213909",2,0,0,2,"dummy"
"213910",0,2,0,2,"dummy"
"213911",0,2,0,2,"dummy"
"213912",0,1,0,1,"dummy"
"213913",1,0,0,1,"dummy"
"213914",12,4,1,17,"dummy"
"213915",0,0,4,4,"dummy"
"213916",2,8,2,12,"dummy"
"213917",1,0,0,1,"dummy"
"213918",0,0,0,0,"dummy"
"213919",1,1,0,2,"dummy"
"213920",1,0,0,1,"dummy"
"213921",0,0,4,4,"dummy"
"213922",0,0,4,4,"dummy"
"213923",0,0,4,4,"dummy"
"213924",0,0,4,4,"dummy"
"213925",0,2,0,2,"dummy"
"213926",0,0,4,4,"dummy"
"213927",0,0,1,1,"dummy"
"213928",0,1,5,6,"dummy"
"213929",0,0,1,1,"dummy"
"213930",0,0,1,1,"dummy"
"213932",0,0,1,1,"dummy"
"213936",0,0,2,2,"dummy"
"213937",0,0,1,1,"dummy"
"213939",1,3,3,7,"dummy"
"213940",0,1,0,1,"dummy"
"213941",0,7,0,7,"dummy"
"213942",2,2,1,5,"dummy"
"213943",6,2,6,14,"dummy"
"213944",1,2,3,6,"dummy"
"213945",1,1,0,2,"dummy"
"213946",0,1,0,1,"dummy"
"213947",0,0,2,2,"dummy"
"213948",0,2,0,2,"dummy"
"213949",0,0,2,2,"dummy"
"213950",0,2,0,2,"dummy"
"213951",3,1,2,6,"dummy"
"213953",17,20,5,42,"dummy"
"213954",1,1,0,2,"dummy"
"213955",0,0,0,0,"dummy"
"213956",0,1,4,5,"dummy"
"213957",0,0,1,1,"dummy"
"213958",0,0,7,7,"dummy"
"213960",0,1,0,1,"dummy"
"213962",0,1,1,2,"dummy"
"213963",8,4,3,15,"dummy"
"213964",6,4,0,10,"dummy"
"213965",0,1,0,1,"dummy"
"213966",1,0,0,1,"dummy"
"213967",1,1,3,5,"dummy"
"213976",1,0,0,1,"dummy"
"213986",0,0,1,1,"dummy"
"213990",0,0,0,0,"dummy"
"213991",0,0,1,1,"dummy"
"213992",0,0,1,1,"dummy"
"213993",0,0,1,1,"dummy"
"213994",2,1,1,4,"dummy"
"213995",0,3,1,4,"dummy"
"213996",0,3,0,3,"dummy"
"213997",0,1,0,1,"dummy"
"213998",8,0,3,11,"dummy"
"213999",0,1,0,1,"dummy"
"214000",0,0,1,1,"dummy"
"214001",1,0,1,2,"dummy"
"214002",0,0,1,1,"dummy"
"214003",0,0,1,1,"dummy"
"214004",0,0,1,1,"dummy"
"214006",1,0,0,1,"dummy"
"214010",0,3,0,3,"dummy"
"214011",0,0,1,1,"dummy"
"214012",0,1,0,1,"dummy"
"214013",0,1,0,1,"dummy"
"214017",1,3,0,4,"dummy"
"214018",0,5,5,10,"dummy"
"214019",0,2,2,4,"dummy"
"214022",0,0,2,2,"dummy"
"214027",0,1,0,1,"dummy"
"214028",0,1,0,1,"dummy"
"214029",1,1,0,2,"dummy"
"214030",0,2,0,2,"dummy"
"214031",0,2,0,2,"dummy"
"214032",0,2,0,2,"dummy"
"214033",0,1,0,1,"dummy"
"214034",0,1,0,1,"dummy"
"214035",0,0,3,3,"dummy"
"214036",1,1,0,2,"dummy"
"214037",0,0,2,2,"dummy"
"214038",5,3,1,9,"dummy"
"214039",0,1,0,1,"dummy"
"214041",6,0,0,6,"dummy"
"214042",0,1,0,1,"dummy"
"214043",0,0,0,0,"dummy"
"214044",0,1,0,1,"dummy"
"214045",0,0,1,1,"dummy"
"214046",2,4,0,6,"dummy"
"214047",12,0,1,13,"dummy"
"214048",0,1,0,1,"dummy"
"214049",0,1,0,1,"dummy"
"214050",0,2,0,2,"dummy"
"214051",2,0,0,2,"dummy"
"214055",4,8,0,12,"dummy"
"214056",0,1,0,1,"dummy"
"214057",0,0,1,1,"dummy"
"214058",0,0,1,1,"dummy"
"214059",0,0,1,1,"dummy"
"214064",0,0,2,2,"dummy"
"214065",0,0,0,0,"dummy"
"214066",1,1,1,3,"dummy"
"214073",0,0,2,2,"dummy"
"214089",0,1,0,1,"dummy"
"214090",0,0,1,1,"dummy"
"214091",0,1,0,1,"dummy"
"214092",1,0,0,1,"dummy"
"214094",27,4,3,34,"dummy"
"214105",0,1,0,1,"dummy"
"214106",0,0,1,1,"dummy"
"214107",0,0,0,0,"dummy"
"214111",0,2,2,4,"dummy"
"214112",0,1,0,1,"dummy"
"214115",0,1,0,1,"dummy"
"214116",0,4,0,4,"dummy"
"214117",0,1,0,1,"dummy"
"214119",0,0,1,1,"dummy"
"214120",0,0,2,2,"dummy"
"214121",0,0,1,1,"dummy"
"214122",0,0,0,0,"dummy"
"214123",2,0,0,2,"dummy"
"214124",0,0,1,1,"dummy"
"214125",3,2,0,5,"dummy"
"214126",0,1,0,1,"dummy"
"214127",0,1,0,1,"dummy"
"214128",0,0,1,1,"dummy"
"214129",0,0,1,1,"dummy"
"214130",0,2,0,2,"dummy"
"214131",0,1,0,1,"dummy"
"214132",0,0,0,0,"dummy"
"214133",0,2,0,2,"dummy"
"214134",4,1,0,5,"dummy"
"214135",1,0,0,1,"dummy"
"214136",0,0,0,0,"dummy"
"214137",0,0,0,0,"dummy"
"214138",0,0,0,0,"dummy"
"214139",4,5,0,9,"dummy"
"214140",2,0,0,2,"dummy"
"214142",0,0,1,1,"dummy"
"214143",0,0,1,1,"dummy"
"214144",0,0,1,1,"dummy"
"214145",2,1,1,4,"dummy"
"214146",0,0,1,1,"dummy"
"214147",1,1,0,2,"dummy"
"214148",1,2,2,5,"dummy"
"214149",0,0,2,2,"dummy"
"214150",0,0,0,0,"dummy"
"214151",1,3,3,7,"dummy"
"214152",0,1,0,1,"dummy"
"214153",0,3,0,3,"dummy"
"214154",7,3,3,13,"dummy"
"214155",0,4,0,4,"dummy"
"214156",1,0,1,2,"dummy"
"214158",2,2,1,5,"dummy"
"214159",1,0,1,2,"dummy"
"214160",1,0,2,3,"dummy"
"214161",1,9,2,12,"dummy"
"214163",0,0,0,0,"dummy"
"214164",0,0,0,0,"dummy"
"214165",0,0,0,0,"dummy"
"214168",8,2,3,13,"dummy"
"214169",0,0,1,1,"dummy"
"214170",3,1,1,5,"dummy"
"214172",0,0,0,0,"dummy"
"214173",0,0,1,1,"dummy"
"214174",0,0,2,2,"dummy"
"214175",0,0,1,1,"dummy"
"214176",0,0,1,1,"dummy"
"214177",0,0,2,2,"dummy"
"214178",0,0,1,1,"dummy"
"214179",4,6,3,13,"dummy"
"214180",0,0,1,1,"dummy"
"214181",0,0,1,1,"dummy"
"214182",0,0,1,1,"dummy"
"214183",16,12,0,28,"dummy"
"214185",0,3,0,3,"dummy"
"214186",1,0,0,1,"dummy"
"214191",0,5,0,5,"dummy"
"214193",1,2,0,3,"dummy"
"214194",0,3,1,4,"dummy"
"214195",18,9,2,29,"dummy"
"214196",8,29,3,40,"dummy"
"214197",0,2,0,2,"dummy"
"214198",3,5,0,8,"dummy"
"214199",0,1,0,1,"dummy"
"214200",0,2,0,2,"dummy"
"214201",1,0,1,2,"dummy"
"214202",0,0,0,0,"dummy"
"214203",0,1,0,1,"dummy"
"214204",1,0,1,2,"dummy"
"214205",0,0,0,0,"dummy"
"214206",0,0,1,1,"dummy"
"214207",0,0,1,1,"dummy"
"214208",0,4,0,4,"dummy"
"214209",2,2,0,4,"dummy"
"214210",0,4,0,4,"dummy"
"214211",5,0,0,5,"dummy"
"214212",0,4,0,4,"dummy"
"214213",6,1,0,7,"dummy"
"214214",0,4,0,4,"dummy"
"214215",0,1,0,1,"dummy"
"214217",0,1,0,1,"dummy"
"214218",3,1,3,7,"dummy"
"214219",0,1,0,1,"dummy"
"214220",0,1,0,1,"dummy"
"214221",0,0,1,1,"dummy"
"214231",0,0,0,0,"dummy"
"214232",0,0,0,0,"dummy"
"214233",0,1,0,1,"dummy"
"214234",0,1,0,1,"dummy"
"214235",13,5,0,18,"dummy"
"214238",0,18,0,18,"dummy"
"214239",0,0,1,1,"dummy"
"214240",0,0,1,1,"dummy"
"214242",0,11,0,11,"dummy"
"214245",0,0,1,1,"dummy"
"214246",4,1,0,5,"dummy"
"214247",0,1,0,1,"dummy"
"214248",0,0,0,0,"dummy"
"214249",0,1,0,1,"dummy"
"214250",0,2,0,2,"dummy"
"214251",0,0,1,1,"dummy"
"214252",1,0,0,1,"dummy"
"214253",0,1,0,1,"dummy"
"214254",10,4,4,18,"dummy"
"214255",0,0,1,1,"dummy"
"214256",0,0,1,1,"dummy"
"214257",2,2,0,4,"dummy"
"214258",0,0,1,1,"dummy"
"214292",0,2,0,2,"dummy"
"214293",0,2,0,2,"dummy"
"214296",0,7,0,7,"dummy"
"214297",0,0,1,1,"dummy"
"214298",0,0,1,1,"dummy"
"214299",0,1,0,1,"dummy"
"214300",0,0,2,2,"dummy"
"214301",1,5,0,6,"dummy"
"214302",7,4,3,14,"dummy"
"214321",0,4,0,4,"dummy"
"214322",0,0,1,1,"dummy"
"214323",0,0,1,1,"dummy"
"214324",0,2,0,2,"dummy"
"214325",0,0,0,0,"dummy"
"214326",0,0,0,0,"dummy"
"214327",0,0,1,1,"dummy"
"214328",0,0,0,0,"dummy"
"214329",0,2,0,2,"dummy"
"214330",0,0,1,1,"dummy"
"214331",0,0,2,2,"dummy"
"214332",0,0,1,1,"dummy"
"214333",0,0,0,0,"dummy"
"214334",0,0,0,0,"dummy"
"214335",0,1,0,1,"dummy"
"214336",0,0,0,0,"dummy"
"214337",0,0,0,0,"dummy"
"214338",0,0,1,1,"dummy"
"214339",0,0,1,1,"dummy"
"214340",0,0,1,1,"dummy"
"214341",0,0,1,1,"dummy"
"214342",0,0,0,0,"dummy"
"214345",0,1,0,1,"dummy"
"214346",0,0,0,0,"dummy"
"214347",0,1,0,1,"dummy"
"214348",0,4,2,6,"dummy"
"214349",0,0,0,0,"dummy"
"214350",0,2,0,2,"dummy"
"214351",0,0,2,2,"dummy"
"214362",3,56,7,66,"dummy"
"214363",3,0,1,4,"dummy"
"214364",1,14,0,15,"dummy"
"214410",0,1,2,3,"dummy"
"214411",0,0,0,0,"dummy"
"214412",0,1,0,1,"dummy"
"214413",4,0,2,6,"dummy"
"214414",1,0,0,1,"dummy"
"214415",0,0,0,0,"dummy"
"214416",0,0,0,0,"dummy"
"214434",0,1,1,2,"dummy"
"214438",0,0,1,1,"dummy"
"214441",0,4,0,4,"dummy"
"214442",0,0,1,1,"dummy"
"214443",1,1,0,2,"dummy"
"214444",0,3,1,4,"dummy"
"214454",0,0,1,1,"dummy"
"214455",0,5,0,5,"dummy"
"214456",5,8,0,13,"dummy"
"214457",0,0,1,1,"dummy"
"214458",2,3,1,6,"dummy"
"214459",0,2,0,2,"dummy"
"214460",0,1,0,1,"dummy"
"214461",1,1,0,2,"dummy"
"214462",1,0,0,1,"dummy"
"214463",1,0,1,2,"dummy"
"214262",1,2,2,5,"dummy"
"214277",0,11,0,11,"dummy"
"214278",3,8,5,16,"dummy"
"214279",9,0,0,9,"dummy"
"214280",0,1,1,2,"dummy"
"214281",5,2,2,9,"dummy"
"214282",3,2,0,5,"dummy"
"214283",0,3,0,3,"dummy"
"214284",0,3,0,3,"dummy"
"214285",0,1,0,1,"dummy"
"214286",1,0,1,2,"dummy"
"214287",0,1,3,4,"dummy"
"214288",0,0,1,1,"dummy"
"214289",0,1,0,1,"dummy"
"214290",0,1,0,1,"dummy"
"214319",0,1,0,1,"dummy"
"214353",0,1,0,1,"dummy"
"214354",3,8,1,12,"dummy"
"214355",0,5,0,5,"dummy"
"214356",2,1,1,4,"dummy"
"214357",0,0,1,1,"dummy"
"214358",0,0,1,1,"dummy"
"214359",0,1,0,1,"dummy"
"214360",1,1,1,3,"dummy"
"214366",0,1,0,1,"dummy"
"214367",0,1,0,1,"dummy"
"214368",0,0,1,1,"dummy"
"214369",0,0,1,1,"dummy"
"214370",0,1,0,1,"dummy"
"214371",1,0,0,1,"dummy"
"214372",0,3,0,3,"dummy"
"214373",0,0,1,1,"dummy"
"214374",1,1,0,2,"dummy"
"214375",0,0,2,2,"dummy"
"214376",0,0,1,1,"dummy"
"214377",0,0,1,1,"dummy"
"214378",0,0,1,1,"dummy"
"214379",0,0,1,1,"dummy"
"214380",0,0,1,1,"dummy"
"214381",0,0,2,2,"dummy"
"214382",0,0,2,2,"dummy"
"214383",0,2,0,2,"dummy"
"214384",0,1,0,1,"dummy"
"214385",0,1,0,1,"dummy"
"214386",0,1,0,1,"dummy"
"214387",0,0,0,0,"dummy"
"214388",0,1,0,1,"dummy"
"214389",0,1,0,1,"dummy"
"214390",0,1,0,1,"dummy"
"214391",0,1,0,1,"dummy"
"214392",0,1,0,1,"dummy"
"214393",0,1,0,1,"dummy"
"214394",0,1,0,1,"dummy"
"214395",0,1,0,1,"dummy"
"214396",1,0,0,1,"dummy"
"214397",1,0,0,1,"dummy"
"214398",0,0,1,1,"dummy"
"214399",1,0,0,1,"dummy"
"214400",0,0,2,2,"dummy"
"214401",0,0,2,2,"dummy"
"214402",0,0,2,2,"dummy"
"214403",1,1,0,2,"dummy"
"214404",1,1,0,2,"dummy"
"214418",0,0,1,1,"dummy"
"214419",0,0,1,1,"dummy"
"214420",0,0,1,1,"dummy"
"214421",0,0,1,1,"dummy"
"214422",0,0,1,1,"dummy"
"214423",0,0,1,1,"dummy"
"214424",0,0,1,1,"dummy"
"214425",0,0,1,1,"dummy"
"214426",0,0,2,2,"dummy"
"214427",0,3,1,4,"dummy"
"214428",0,1,0,1,"dummy"
"214429",0,0,1,1,"dummy"
"214430",0,1,0,1,"dummy"
"214431",0,0,1,1,"dummy"
"214432",0,0,1,1,"dummy"
"214436",4,0,0,4,"dummy"
"214446",0,0,1,1,"dummy"
"214468",4,7,2,13,"dummy"
"214515",0,2,0,2,"dummy"
"214516",0,0,1,1,"dummy"
"214517",0,0,1,1,"dummy"
"214464",2,5,0,7,"dummy"
"214470",0,0,1,1,"dummy"
"214471",2,3,0,5,"dummy"
"214472",0,1,0,1,"dummy"
"214473",0,1,0,1,"dummy"
"214474",2,10,1,13,"dummy"
"214475",0,2,0,2,"dummy"
"214476",0,1,0,1,"dummy"
"214477",1,3,0,4,"dummy"
"214478",1,1,0,2,"dummy"
"214479",1,1,0,2,"dummy"
"214480",2,1,2,5,"dummy"
"214481",0,1,0,1,"dummy"
"214482",1,3,0,4,"dummy"
"214483",0,2,0,2,"dummy"
"214484",2,1,1,4,"dummy"
"214485",6,2,3,11,"dummy"
"214486",0,1,1,2,"dummy"
"214487",0,0,1,1,"dummy"
"214488",0,1,0,1,"dummy"
"214489",0,4,0,4,"dummy"
"214490",0,1,0,1,"dummy"
"214491",2,2,0,4,"dummy"
"214492",0,0,1,1,"dummy"
"214493",0,0,0,0,"dummy"
"214494",2,2,0,4,"dummy"
"214495",2,2,1,5,"dummy"
"214496",0,0,1,1,"dummy"
"214497",2,2,1,5,"dummy"
"214498",0,0,2,2,"dummy"
"214499",2,2,1,5,"dummy"
"214500",0,0,1,1,"dummy"
"214501",0,0,1,1,"dummy"
"214502",0,0,1,1,"dummy"
"214503",0,0,2,2,"dummy"
"214504",0,1,1,2,"dummy"
"214505",0,0,1,1,"dummy"
"214508",0,1,1,2,"dummy"
"214513",1,8,0,9,"dummy"
"214534",1,0,4,5,"dummy"
"214535",6,0,0,6,"dummy"
"214564",0,0,0,0,"dummy"
"214577",0,0,0,0,"dummy"
"214578",0,0,0,0,"dummy"
"214585",0,0,0,0,"dummy"
"214586",0,1,0,1,"dummy"
"214587",0,0,1,1,"dummy"
"214618",1,0,0,1,"dummy"
"214626",0,0,3,3,"dummy"
"214640",0,0,1,1,"dummy"
"214649",0,0,0,0,"dummy"
"214650",4,2,2,8,"dummy"
"214651",0,0,2,2,"dummy"
"214672",1,0,0,1,"dummy"
"214691",0,13,2,15,"dummy"
"214707",0,0,1,1,"dummy"
"214708",0,0,1,1,"dummy"
"214714",0,0,1,1,"dummy"
"214715",0,1,0,1,"dummy"
"214720",1,2,0,3,"dummy"
"214721",1,5,0,6,"dummy"
"214722",2,6,4,12,"dummy"
"214518",0,0,1,1,"dummy"
"214519",0,0,1,1,"dummy"
"214520",0,0,1,1,"dummy"
"214537",9,33,0,42,"dummy"
"214542",0,0,0,0,"dummy"
"214543",0,0,0,0,"dummy"
"214544",0,0,0,0,"dummy"
"214545",0,0,0,0,"dummy"
"214546",0,0,1,1,"dummy"
"214547",0,0,0,0,"dummy"
"214548",0,0,0,0,"dummy"
"214549",0,1,0,1,"dummy"
"214550",0,0,0,0,"dummy"
"214551",0,0,0,0,"dummy"
"214552",0,0,0,0,"dummy"
"214553",0,0,0,0,"dummy"
"214554",0,0,0,0,"dummy"
"214555",0,0,0,0,"dummy"
"214556",0,0,0,0,"dummy"
"214557",0,1,0,1,"dummy"
"214560",0,0,2,2,"dummy"
"214561",1,0,2,3,"dummy"
"214562",0,2,1,3,"dummy"
"214566",0,0,1,1,"dummy"
"214567",0,2,1,3,"dummy"
"214570",2,1,0,3,"dummy"
"214571",2,1,0,3,"dummy"
"214572",1,0,0,1,"dummy"
"214573",0,0,1,1,"dummy"
"214574",1,0,0,1,"dummy"
"214575",0,0,1,1,"dummy"
"214589",0,0,0,0,"dummy"
"214620",8,0,3,11,"dummy"
"214621",0,1,0,1,"dummy"
"214622",0,1,0,1,"dummy"
"214623",0,1,0,1,"dummy"
"214624",0,1,0,1,"dummy"
"214642",0,0,0,0,"dummy"
"214643",0,1,0,1,"dummy"
"214644",0,1,0,1,"dummy"
"214647",5,6,1,12,"dummy"
"214680",0,0,1,1,"dummy"
"214683",2,2,2,6,"dummy"
"214684",3,3,0,6,"dummy"
"214685",0,0,1,1,"dummy"
"214686",0,4,0,4,"dummy"
"214689",2,6,0,8,"dummy"
"214693",0,2,0,2,"dummy"
"214694",2,0,0,2,"dummy"
"214695",0,1,2,3,"dummy"
"214696",0,8,0,8,"dummy"
"214697",0,1,0,1,"dummy"
"214698",0,4,2,6,"dummy"
"214699",1,3,2,6,"dummy"
"214710",0,0,1,1,"dummy"
"214711",1,1,0,2,"dummy"
"214712",0,0,1,1,"dummy"
"214717",0,2,0,2,"dummy"
"214718",0,2,1,3,"dummy"
"214724",0,0,1,1,"dummy"
"214725",0,0,1,1,"dummy"
"214726",0,0,1,1,"dummy"
"214727",0,0,1,1,"dummy"
"214728",0,0,1,1,"dummy"
"214729",0,0,1,1,"dummy"
"214730",0,0,1,1,"dummy"
"214731",0,0,1,1,"dummy"
"214732",5,2,1,8,"dummy"
"214733",0,4,1,5,"dummy"
"214734",3,1,0,4,"dummy"
"214737",3,0,1,4,"dummy"
"214738",0,5,1,6,"dummy"
"214739",2,2,0,4,"dummy"
"214740",1,1,1,3,"dummy"
"214763",0,0,2,2,"dummy"
"214767",0,1,0,1,"dummy"
"214771",0,1,0,1,"dummy"
"214772",0,2,0,2,"dummy"
"214788",0,2,0,2,"dummy"
"214789",0,3,0,3,"dummy"
"214792",12,6,1,19,"dummy"
"214793",1,14,0,15,"dummy"
"214794",7,9,1,17,"dummy"
"214795",1,2,0,3,"dummy"
"214796",0,3,0,3,"dummy"
"214797",1,0,0,1,"dummy"
"214798",0,1,0,1,"dummy"
"214799",2,1,0,3,"dummy"
"214800",0,1,0,1,"dummy"
"214801",2,0,0,2,"dummy"
"214806",1,1,3,5,"dummy"
"214807",0,1,0,1,"dummy"
"214808",1,0,0,1,"dummy"
"214809",1,0,1,2,"dummy"
"214810",0,1,1,2,"dummy"
"214816",3,8,3,14,"dummy"
"214817",0,2,0,2,"dummy"
"214818",0,1,0,1,"dummy"
"214819",6,0,0,6,"dummy"
"214820",0,8,0,8,"dummy"
"214821",1,5,4,10,"dummy"
"214822",0,3,0,3,"dummy"
"214823",0,0,1,1,"dummy"
"214844",0,0,1,1,"dummy"
"214845",0,0,1,1,"dummy"
"214846",1,1,1,3,"dummy"
"214847",0,0,1,1,"dummy"
"214855",27,0,2,29,"dummy"
"214856",0,0,1,1,"dummy"
"214857",0,0,1,1,"dummy"
"214858",0,0,1,1,"dummy"
"214859",0,1,3,4,"dummy"
"214860",0,0,1,1,"dummy"
"214867",0,2,0,2,"dummy"
"214868",0,0,2,2,"dummy"
"214898",0,2,0,2,"dummy"
"214899",0,1,0,1,"dummy"
"214902",0,0,0,0,"dummy"
"214903",0,1,0,1,"dummy"
"214904",6,0,0,6,"dummy"
"214905",0,23,0,23,"dummy"
"214906",0,2,0,2,"dummy"
"214907",0,1,1,2,"dummy"
"214908",0,0,2,2,"dummy"
"214909",0,0,1,1,"dummy"
"214910",0,0,1,1,"dummy"
"214911",3,3,0,6,"dummy"
"214915",0,0,3,3,"dummy"
"214921",0,0,0,0,"dummy"
"214925",2,0,1,3,"dummy"
"214937",0,1,0,1,"dummy"
"214938",0,12,0,12,"dummy"
"214961",4,18,3,25,"dummy"
"214962",14,8,2,24,"dummy"
"214963",0,1,0,1,"dummy"
"214964",1,4,0,5,"dummy"
"214965",0,3,1,4,"dummy"
"214966",18,12,3,33,"dummy"
"214967",1,2,1,4,"dummy"
"214968",0,3,1,4,"dummy"
"214969",0,0,1,1,"dummy"
"214974",2,2,0,4,"dummy"
"215044",0,9,0,9,"dummy"
"215045",2,14,2,18,"dummy"
"215046",0,2,0,2,"dummy"
"215047",0,0,1,1,"dummy"
"215048",0,5,0,5,"dummy"
"214765",0,2,0,2,"dummy"
"214769",0,0,1,1,"dummy"
"214774",0,0,1,1,"dummy"
"214777",0,1,1,2,"dummy"
"214778",0,1,0,1,"dummy"
"214779",1,0,1,2,"dummy"
"214780",0,5,0,5,"dummy"
"214781",0,0,1,1,"dummy"
"214782",0,1,0,1,"dummy"
"214783",0,1,0,1,"dummy"
"214784",0,1,0,1,"dummy"
"214803",0,0,0,0,"dummy"
"214804",0,0,0,0,"dummy"
"214814",0,0,2,2,"dummy"
"214825",0,0,1,1,"dummy"
"214826",1,0,0,1,"dummy"
"214827",0,0,1,1,"dummy"
"214828",0,1,0,1,"dummy"
"214829",0,0,1,1,"dummy"
"214830",4,0,0,4,"dummy"
"214831",9,5,0,14,"dummy"
"214832",3,2,1,6,"dummy"
"214833",0,1,1,2,"dummy"
"214834",0,0,0,0,"dummy"
"214835",1,4,0,5,"dummy"
"214836",0,1,0,1,"dummy"
"214837",2,1,0,3,"dummy"
"214849",0,7,0,7,"dummy"
"214852",0,1,1,2,"dummy"
"214853",0,0,2,2,"dummy"
"214862",0,0,1,1,"dummy"
"214863",0,1,0,1,"dummy"
"214864",0,1,0,1,"dummy"
"214865",0,2,0,2,"dummy"
"214870",0,2,0,2,"dummy"
"214871",0,0,1,1,"dummy"
"214872",2,16,0,18,"dummy"
"214873",2,3,0,5,"dummy"
"214874",0,1,0,1,"dummy"
"214875",2,0,0,2,"dummy"
"214876",3,4,0,7,"dummy"
"214877",0,2,0,2,"dummy"
"214878",4,6,0,10,"dummy"
"214879",2,4,0,6,"dummy"
"214880",13,10,0,23,"dummy"
"214881",0,4,0,4,"dummy"
"214882",2,3,0,5,"dummy"
"214883",0,1,0,1,"dummy"
"214884",3,6,0,9,"dummy"
"214885",0,0,1,1,"dummy"
"214886",0,0,2,2,"dummy"
"214887",0,0,1,1,"dummy"
"214888",0,3,0,3,"dummy"
"214889",0,1,1,2,"dummy"
"214890",1,4,0,5,"dummy"
"214891",13,4,0,17,"dummy"
"214892",0,1,0,1,"dummy"
"214893",1,0,0,1,"dummy"
"214894",3,9,1,13,"dummy"
"214895",0,1,0,1,"dummy"
"214896",0,2,0,2,"dummy"
"214913",0,0,1,1,"dummy"
"214917",0,3,0,3,"dummy"
"214918",0,6,0,6,"dummy"
"214919",0,1,1,2,"dummy"
"214923",6,6,3,15,"dummy"
"214927",0,0,0,0,"dummy"
"214928",0,0,0,0,"dummy"
"214931",0,0,1,1,"dummy"
"214932",0,0,1,1,"dummy"
"214933",0,2,0,2,"dummy"
"214976",0,0,1,1,"dummy"
"215029",0,2,0,2,"dummy"
"215034",0,3,1,4,"dummy"
"215037",0,0,2,2,"dummy"
"215038",3,3,0,6,"dummy"
"215039",0,1,0,1,"dummy"
"215040",0,0,0,0,"dummy"
"215041",0,4,1,5,"dummy"
"215042",1,0,1,2,"dummy"
"215050",0,0,1,1,"dummy"
"215051",1,2,2,5,"dummy"
"215052",0,1,0,1,"dummy"
"215074",0,0,1,1,"dummy"
"215081",1,2,0,3,"dummy"
"215089",3,0,2,5,"dummy"
"215090",0,4,0,4,"dummy"
"215091",0,1,2,3,"dummy"
"215092",1,0,0,1,"dummy"
"215093",0,3,2,5,"dummy"
"215094",0,1,2,3,"dummy"
"215113",2,0,0,2,"dummy"
"215114",0,1,1,2,"dummy"
"215116",2,0,1,3,"dummy"
"215117",0,0,1,1,"dummy"
"215118",2,1,4,7,"dummy"
"215119",1,0,1,2,"dummy"
"215121",0,4,1,5,"dummy"
"215122",0,0,2,2,"dummy"
"215123",0,14,0,14,"dummy"
"215124",2,3,2,7,"dummy"
"215135",0,0,2,2,"dummy"
"215137",0,3,0,3,"dummy"
"215139",0,2,0,2,"dummy"
"215140",0,2,0,2,"dummy"
"215141",1,0,1,2,"dummy"
"215142",0,0,1,1,"dummy"
"215143",0,0,1,1,"dummy"
"215144",3,0,0,3,"dummy"
"215145",0,1,0,1,"dummy"
"215148",0,0,1,1,"dummy"
"215149",0,0,3,3,"dummy"
"215150",0,0,0,0,"dummy"
"215152",0,1,0,1,"dummy"
"215154",0,1,0,1,"dummy"
"215155",0,1,0,1,"dummy"
"215156",0,1,0,1,"dummy"
"215157",0,1,0,1,"dummy"
"215158",0,1,0,1,"dummy"
"215159",0,1,0,1,"dummy"
"215160",0,1,0,1,"dummy"
"215161",0,1,0,1,"dummy"
"215162",0,1,0,1,"dummy"
"215163",0,1,0,1,"dummy"
"215164",0,1,0,1,"dummy"
"215165",0,0,0,0,"dummy"
"215167",3,3,1,7,"dummy"
"215170",4,2,0,6,"dummy"
"215171",0,3,0,3,"dummy"
"215173",5,3,0,8,"dummy"
"215174",1,1,0,2,"dummy"
"215175",0,3,0,3,"dummy"
"215176",0,1,0,1,"dummy"
"215177",0,9,1,10,"dummy"
"215178",0,2,0,2,"dummy"
"215183",2,3,4,9,"dummy"
"215184",2,0,0,2,"dummy"
"215185",1,0,4,5,"dummy"
"215187",10,4,1,15,"dummy"
"215189",0,0,1,1,"dummy"
"215190",0,0,0,0,"dummy"
"215191",0,0,0,0,"dummy"
"215192",3,1,1,5,"dummy"
"215193",4,1,2,7,"dummy"
"215194",1,0,0,1,"dummy"
"215199",1,0,2,3,"dummy"
"215200",0,0,1,1,"dummy"
"215201",0,3,0,3,"dummy"
"215203",0,0,0,0,"dummy"
"215204",5,2,0,7,"dummy"
"215205",1,0,0,1,"dummy"
"215206",0,0,1,1,"dummy"
"215207",2,0,0,2,"dummy"
"215208",0,0,1,1,"dummy"
"215209",0,0,1,1,"dummy"
"215210",0,2,0,2,"dummy"
"215211",3,0,0,3,"dummy"
"215212",0,1,0,1,"dummy"
"215213",1,0,0,1,"dummy"
"215216",1,5,0,6,"dummy"
"215217",0,2,0,2,"dummy"
"215218",0,1,1,2,"dummy"
"215219",7,4,3,14,"dummy"
"215220",2,2,0,4,"dummy"
"215223",2,0,3,5,"dummy"
"215226",0,14,0,14,"dummy"
"215228",0,6,0,6,"dummy"
"215229",0,0,0,0,"dummy"
"215230",0,0,0,0,"dummy"
"215234",0,1,0,1,"dummy"
"215235",22,1,2,25,"dummy"
"215238",0,0,1,1,"dummy"
"215239",0,0,1,1,"dummy"
"215241",0,2,0,2,"dummy"
"215242",0,0,0,0,"dummy"
"215243",0,1,1,2,"dummy"
"215244",1,1,4,6,"dummy"
"215245",1,1,1,3,"dummy"
"215248",5,8,2,15,"dummy"
"215249",0,1,1,2,"dummy"
"215250",0,1,0,1,"dummy"
"215251",0,1,0,1,"dummy"
"215252",0,3,0,3,"dummy"
"215260",0,1,0,1,"dummy"
"215261",0,1,0,1,"dummy"
"215262",0,0,1,1,"dummy"
"215266",0,1,0,1,"dummy"
"215267",0,0,1,1,"dummy"
"215272",0,0,0,0,"dummy"
"215276",0,0,1,1,"dummy"
"215277",0,0,1,1,"dummy"
"215278",0,0,1,1,"dummy"
"215279",0,0,1,1,"dummy"
"215294",2,2,2,6,"dummy"
"215296",0,2,1,3,"dummy"
"215303",0,0,1,1,"dummy"
"215304",14,3,4,21,"dummy"
"215305",0,0,1,1,"dummy"
"215306",0,0,1,1,"dummy"
"215308",0,0,1,1,"dummy"
"215315",2,2,0,4,"dummy"
"215316",1,1,1,3,"dummy"
"215317",1,1,0,2,"dummy"
"215318",0,1,1,2,"dummy"
"215319",0,0,1,1,"dummy"
"215320",1,3,3,7,"dummy"
"215321",0,0,1,1,"dummy"
"215322",0,5,0,5,"dummy"
"215323",0,0,1,1,"dummy"
"215330",2,2,0,4,"dummy"
"215331",0,0,0,0,"dummy"
"215332",0,1,0,1,"dummy"
"215333",0,1,0,1,"dummy"
"215335",0,0,1,1,"dummy"
"215336",0,0,1,1,"dummy"
"215337",0,0,1,1,"dummy"
"215338",1,0,0,1,"dummy"
"215341",0,1,0,1,"dummy"
"215345",0,0,1,1,"dummy"
"215348",0,0,0,0,"dummy"
"215349",0,4,0,4,"dummy"
"215350",1,1,1,3,"dummy"
"215363",1,4,0,5,"dummy"
"215364",29,5,3,37,"dummy"
"215365",3,1,0,4,"dummy"
"215366",0,0,1,1,"dummy"
"215367",0,0,1,1,"dummy"
"215369",0,0,1,1,"dummy"
"215371",0,12,0,12,"dummy"
"215372",2,0,1,3,"dummy"
"215373",0,0,1,1,"dummy"
"215375",0,0,0,0,"dummy"
"215377",1,0,0,1,"dummy"
"215378",0,0,2,2,"dummy"
"215379",0,1,0,1,"dummy"
"215380",0,11,1,12,"dummy"
"215381",1,0,0,1,"dummy"
"215382",0,0,1,1,"dummy"
"215386",1,3,0,4,"dummy"
"215389",0,2,0,2,"dummy"
"215390",0,1,0,1,"dummy"
"215394",0,1,0,1,"dummy"
"215395",0,0,1,1,"dummy"
"215396",0,0,1,1,"dummy"
"215399",0,0,1,1,"dummy"
"215400",0,3,10,13,"dummy"
"215401",0,0,3,3,"dummy"
"215402",15,8,2,25,"dummy"
"215403",7,1,1,9,"dummy"
"215406",3,11,2,16,"dummy"
"215407",0,1,0,1,"dummy"
"215408",5,2,0,7,"dummy"
"215409",2,6,1,9,"dummy"
"215410",2,1,0,3,"dummy"
"215411",0,0,1,1,"dummy"
"215412",0,2,0,2,"dummy"
"215413",2,0,2,4,"dummy"
"215414",0,2,1,3,"dummy"
"215416",0,0,0,0,"dummy"
"215417",0,0,0,0,"dummy"
"215419",0,1,0,1,"dummy"
"215420",1,0,0,1,"dummy"
"215421",0,0,1,1,"dummy"
"215422",1,1,0,2,"dummy"
"215423",0,0,1,1,"dummy"
"215424",0,0,0,0,"dummy"
"215425",0,0,0,0,"dummy"
"215426",0,0,0,0,"dummy"
"215428",0,2,0,2,"dummy"
"215429",0,2,0,2,"dummy"
"215430",2,2,0,4,"dummy"
"215431",1,2,3,6,"dummy"
"215432",0,1,1,2,"dummy"
"215433",0,0,1,1,"dummy"
"215434",0,0,0,0,"dummy"
"215435",0,1,0,1,"dummy"
"215436",1,6,0,7,"dummy"
"215437",5,10,7,22,"dummy"
"215441",2,5,2,9,"dummy"
"215444",0,1,2,3,"dummy"
"215445",0,0,0,0,"dummy"
"215446",0,1,0,1,"dummy"
"215447",4,0,2,6,"dummy"
"215448",1,0,0,1,"dummy"
"215449",0,0,0,0,"dummy"
"215450",0,0,0,0,"dummy"
"215454",0,1,0,1,"dummy"
"215455",0,0,0,0,"dummy"
"215456",0,0,1,1,"dummy"
"215471",15,7,5,27,"dummy"
"215472",0,0,1,1,"dummy"
"215477",0,0,1,1,"dummy"
"215485",2,10,0,12,"dummy"
"215490",0,11,0,11,"dummy"
"215491",0,1,1,2,"dummy"
"215492",1,0,0,1,"dummy"
"215493",1,4,0,5,"dummy"
"215494",1,1,0,2,"dummy"
"215495",1,1,1,3,"dummy"
"215496",2,0,0,2,"dummy"
"215497",0,1,1,2,"dummy"
"215498",0,1,0,1,"dummy"
"215515",0,0,0,0,"dummy"
"215519",1,1,6,8,"dummy"
"215520",0,0,0,0,"dummy"
"215521",0,1,2,3,"dummy"
"215522",0,0,1,1,"dummy"
"215523",0,0,4,4,"dummy"
"215524",0,1,1,2,"dummy"
"215525",0,0,1,1,"dummy"
"215528",0,1,0,1,"dummy"
"215540",0,1,0,1,"dummy"
"215541",0,1,0,1,"dummy"
"215542",0,1,0,1,"dummy"
"215543",0,1,0,1,"dummy"
"215544",0,0,0,0,"dummy"
"215545",2,0,0,2,"dummy"
"215546",1,0,0,1,"dummy"
"215552",14,33,8,55,"dummy"
"215553",0,1,0,1,"dummy"
"215554",1,11,0,12,"dummy"
"215576",0,0,0,0,"dummy"
"215577",0,0,0,0,"dummy"
"215606",0,1,3,4,"dummy"
"215607",0,0,1,1,"dummy"
"215608",0,0,1,1,"dummy"
"215609",1,1,1,3,"dummy"
"215634",0,0,1,1,"dummy"
"215635",1,1,2,4,"dummy"
"215636",0,1,0,1,"dummy"
"215637",0,0,0,0,"dummy"
"215638",1,0,1,2,"dummy"
"215639",0,0,0,0,"dummy"
"215640",0,1,0,1,"dummy"
"215641",1,0,0,1,"dummy"
"215642",0,2,0,2,"dummy"
"215643",0,0,1,1,"dummy"
"215644",0,2,0,2,"dummy"
"215645",0,0,1,1,"dummy"
"215646",0,0,1,1,"dummy"
"215647",0,0,1,1,"dummy"
"215648",0,0,1,1,"dummy"
"215649",0,0,1,1,"dummy"
"215650",0,0,1,1,"dummy"
"215651",0,0,1,1,"dummy"
"215652",0,0,1,1,"dummy"
"215653",0,0,1,1,"dummy"
"215654",0,0,1,1,"dummy"
"215655",0,0,1,1,"dummy"
"215656",0,0,1,1,"dummy"
"215657",0,0,1,1,"dummy"
"215658",0,0,1,1,"dummy"
"215659",0,0,1,1,"dummy"
"215660",0,0,1,1,"dummy"
"215661",0,0,1,1,"dummy"
"215662",0,0,1,1,"dummy"
"215663",0,0,1,1,"dummy"
"215667",0,0,2,2,"dummy"
"215668",5,4,4,13,"dummy"
"215669",2,6,0,8,"dummy"
"215670",3,1,5,9,"dummy"
"215671",0,2,0,2,"dummy"
"215458",0,1,0,1,"dummy"
"215459",0,4,0,4,"dummy"
"215460",0,2,0,2,"dummy"
"215461",0,0,2,2,"dummy"
"215462",5,3,1,9,"dummy"
"215463",3,3,0,6,"dummy"
"215468",0,0,1,1,"dummy"
"215469",0,1,0,1,"dummy"
"215487",0,2,0,2,"dummy"
"215488",0,1,0,1,"dummy"
"215500",2,2,0,4,"dummy"
"215503",2,2,1,5,"dummy"
"215506",0,1,0,1,"dummy"
"215507",0,1,0,1,"dummy"
"215510",0,1,0,1,"dummy"
"215513",0,0,1,1,"dummy"
"215517",0,1,0,1,"dummy"
"215530",0,1,3,4,"dummy"
"215531",5,6,0,11,"dummy"
"215534",6,1,0,7,"dummy"
"215535",1,1,0,2,"dummy"
"215536",0,0,1,1,"dummy"
"215537",0,0,1,1,"dummy"
"215538",0,0,1,1,"dummy"
"215550",0,0,1,1,"dummy"
"215556",0,0,1,1,"dummy"
"215557",0,0,1,1,"dummy"
"215579",0,0,1,1,"dummy"
"215580",0,0,3,3,"dummy"
"215581",6,8,2,16,"dummy"
"215582",3,3,2,8,"dummy"
"215583",4,1,1,6,"dummy"
"215584",0,4,0,4,"dummy"
"215585",0,0,0,0,"dummy"
"215586",0,1,0,1,"dummy"
"215587",0,0,1,1,"dummy"
"215588",0,1,0,1,"dummy"
"215589",2,0,0,2,"dummy"
"215590",0,2,0,2,"dummy"
"215591",0,0,1,1,"dummy"
"215592",0,1,1,2,"dummy"
"215593",0,0,1,1,"dummy"
"215594",0,0,2,2,"dummy"
"215595",0,0,0,0,"dummy"
"215596",0,0,0,0,"dummy"
"215597",0,0,1,1,"dummy"
"215598",0,0,0,0,"dummy"
"215599",0,1,1,2,"dummy"
"215600",1,0,1,2,"dummy"
"215601",1,0,1,2,"dummy"
"215602",3,2,0,5,"dummy"
"215603",0,0,0,0,"dummy"
"215604",0,0,1,1,"dummy"
"215616",0,2,2,4,"dummy"
"215617",0,0,1,1,"dummy"
"215618",0,3,0,3,"dummy"
"215621",0,0,1,1,"dummy"
"215628",0,0,1,1,"dummy"
"215629",0,4,2,6,"dummy"
"215630",0,0,1,1,"dummy"
"215665",0,1,0,1,"dummy"
"215695",0,0,1,1,"dummy"
"215674",0,0,1,1,"dummy"
"215684",1,2,1,4,"dummy"
"215687",0,0,1,1,"dummy"
"215701",3,10,2,15,"dummy"
"215702",3,10,2,15,"dummy"
"215703",0,4,1,5,"dummy"
"215719",0,1,0,1,"dummy"
"215720",1,0,0,1,"dummy"
"215721",0,0,1,1,"dummy"
"215722",2,0,1,3,"dummy"
"215723",1,2,1,4,"dummy"
"215724",0,1,0,1,"dummy"
"215725",1,0,0,1,"dummy"
"215726",4,4,2,10,"dummy"
"215775",0,1,0,1,"dummy"
"215776",0,3,0,3,"dummy"
"215781",0,3,0,3,"dummy"
"215782",9,0,0,9,"dummy"
"215783",2,1,0,3,"dummy"
"215784",0,1,1,2,"dummy"
"215792",0,4,1,5,"dummy"
"215793",12,0,2,14,"dummy"
"215794",0,1,0,1,"dummy"
"215795",10,11,5,26,"dummy"
"215796",12,2,1,15,"dummy"
"215810",1,1,1,3,"dummy"
"215813",0,1,0,1,"dummy"
"215814",1,2,0,3,"dummy"
"215827",12,30,4,46,"dummy"
"215828",16,16,3,35,"dummy"
"215829",0,1,0,1,"dummy"
"215830",0,0,1,1,"dummy"
"215831",6,9,4,19,"dummy"
"215832",1,0,0,1,"dummy"
"215833",0,0,1,1,"dummy"
"215834",0,0,2,2,"dummy"
"215835",0,0,1,1,"dummy"
"215836",0,0,1,1,"dummy"
"215840",0,0,1,1,"dummy"
"215850",0,1,0,1,"dummy"
"215851",0,2,0,2,"dummy"
"215852",3,1,0,4,"dummy"
"215853",20,22,0,42,"dummy"
"215854",0,33,0,33,"dummy"
"215855",3,3,0,6,"dummy"
"215856",0,1,0,1,"dummy"
"215860",4,0,3,7,"dummy"
"215861",2,2,0,4,"dummy"
"215876",3,10,2,15,"dummy"
"215877",7,2,3,12,"dummy"
"215878",0,2,0,2,"dummy"
"215879",2,0,0,2,"dummy"
"215880",0,3,0,3,"dummy"
"215881",0,4,0,4,"dummy"
"215882",1,1,0,2,"dummy"
"215883",4,5,5,14,"dummy"
"215884",0,0,2,2,"dummy"
"215885",0,0,1,1,"dummy"
"215886",0,0,1,1,"dummy"
"215887",2,2,0,4,"dummy"
"215888",1,0,0,1,"dummy"
"215889",0,0,1,1,"dummy"
"215890",0,6,0,6,"dummy"
"215891",0,2,0,2,"dummy"
"215892",2,1,0,3,"dummy"
"215896",0,1,0,1,"dummy"
"215897",0,0,0,0,"dummy"
"215898",0,6,0,6,"dummy"
"215899",0,0,1,1,"dummy"
"215900",0,0,2,2,"dummy"
"215901",0,0,2,2,"dummy"
"215906",2,2,2,6,"dummy"
"215907",0,0,2,2,"dummy"
"215908",1,0,1,2,"dummy"
"215913",0,0,1,1,"dummy"
"215914",0,0,1,1,"dummy"
"215696",1,5,0,6,"dummy"
"215697",0,1,2,3,"dummy"
"215698",2,0,0,2,"dummy"
"215699",0,0,1,1,"dummy"
"215705",0,0,1,1,"dummy"
"215706",0,2,0,2,"dummy"
"215707",3,0,0,3,"dummy"
"215708",0,3,1,4,"dummy"
"215713",0,0,1,1,"dummy"
"215714",0,0,1,1,"dummy"
"215715",0,0,4,4,"dummy"
"215716",0,1,0,1,"dummy"
"215717",1,1,1,3,"dummy"
"215728",1,0,1,2,"dummy"
"215729",1,0,0,1,"dummy"
"215730",2,2,3,7,"dummy"
"215731",0,0,0,0,"dummy"
"215732",0,0,0,0,"dummy"
"215733",0,0,0,0,"dummy"
"215738",0,1,1,2,"dummy"
"215739",2,4,4,10,"dummy"
"215740",0,2,1,3,"dummy"
"215741",0,0,1,1,"dummy"
"215742",0,0,1,1,"dummy"
"215743",22,23,9,54,"dummy"
"215744",7,6,8,21,"dummy"
"215745",0,0,1,1,"dummy"
"215746",0,2,3,5,"dummy"
"215747",3,3,6,12,"dummy"
"215748",4,4,7,15,"dummy"
"215749",3,3,6,12,"dummy"
"215750",0,0,1,1,"dummy"
"215751",0,1,0,1,"dummy"
"215752",0,3,0,3,"dummy"
"215753",0,0,3,3,"dummy"
"215754",0,0,1,1,"dummy"
"215755",0,1,0,1,"dummy"
"215756",7,3,3,13,"dummy"
"215757",0,0,2,2,"dummy"
"215758",3,3,0,6,"dummy"
"215759",3,3,0,6,"dummy"
"215760",9,14,3,26,"dummy"
"215761",0,0,4,4,"dummy"
"215762",34,3,4,41,"dummy"
"215763",0,0,0,0,"dummy"
"215764",0,0,0,0,"dummy"
"215765",0,0,0,0,"dummy"
"215768",0,6,0,6,"dummy"
"215769",1,0,0,1,"dummy"
"215770",0,0,0,0,"dummy"
"215771",6,7,4,17,"dummy"
"215772",0,6,0,6,"dummy"
"215773",3,0,2,5,"dummy"
"215786",0,7,0,7,"dummy"
"215787",5,19,0,24,"dummy"
"215788",12,3,0,15,"dummy"
"215789",0,0,1,1,"dummy"
"215790",0,6,0,6,"dummy"
"215798",0,1,2,3,"dummy"
"215799",1,0,2,3,"dummy"
"215800",0,7,0,7,"dummy"
"215801",3,0,0,3,"dummy"
"215802",0,1,0,1,"dummy"
"215803",0,0,1,1,"dummy"
"215804",7,0,0,7,"dummy"
"215820",0,1,0,1,"dummy"
"215821",2,2,0,4,"dummy"
"215822",0,2,0,2,"dummy"
"215823",0,2,0,2,"dummy"
"215824",0,0,0,0,"dummy"
"215825",0,1,0,1,"dummy"
"215842",6,0,2,8,"dummy"
"215858",0,2,1,3,"dummy"
"215868",1,4,0,5,"dummy"
"215869",0,2,0,2,"dummy"
"215870",3,1,3,7,"dummy"
"215871",2,2,1,5,"dummy"
"215872",3,5,0,8,"dummy"
"215873",3,6,0,9,"dummy"
"215874",2,2,3,7,"dummy"
"215894",0,0,0,0,"dummy"
"215903",0,1,2,3,"dummy"
"215904",0,0,1,1,"dummy"
"215910",0,0,1,1,"dummy"
"215911",0,0,1,1,"dummy"
"215921",0,12,0,12,"dummy"
"215927",4,2,3,9,"dummy"
"215928",2,4,0,6,"dummy"
"215929",0,0,1,1,"dummy"
"215930",0,0,1,1,"dummy"
"215931",0,0,1,1,"dummy"
"215932",0,0,1,1,"dummy"
"215933",0,0,1,1,"dummy"
"215934",0,0,1,1,"dummy"
"215951",0,0,1,1,"dummy"
"215973",3,6,0,9,"dummy"
"215974",0,0,1,1,"dummy"
"215975",2,1,1,4,"dummy"
"215991",2,0,0,2,"dummy"
"216004",0,1,0,1,"dummy"
"216005",1,0,0,1,"dummy"
"216006",4,1,0,5,"dummy"
"216007",0,0,3,3,"dummy"
"216008",5,2,2,9,"dummy"
"216009",2,5,1,8,"dummy"
"216015",6,7,0,13,"dummy"
"216016",1,0,0,1,"dummy"
"216017",3,8,0,11,"dummy"
"216018",6,2,0,8,"dummy"
"216037",4,11,4,19,"dummy"
"216040",0,0,1,1,"dummy"
"216041",0,0,1,1,"dummy"
"216042",0,1,1,2,"dummy"
"216043",0,0,1,1,"dummy"
"216044",0,0,2,2,"dummy"
"216045",0,0,1,1,"dummy"
"216046",2,1,1,4,"dummy"
"216047",0,0,1,1,"dummy"
"216048",0,0,1,1,"dummy"
"216049",0,0,1,1,"dummy"
"216069",2,4,0,6,"dummy"
"216070",0,2,0,2,"dummy"
"216071",0,2,0,2,"dummy"
"216072",10,2,0,12,"dummy"
"216073",0,2,0,2,"dummy"
"216074",0,0,0,0,"dummy"
"216086",0,1,0,1,"dummy"
"215915",4,0,1,5,"dummy"
"215916",6,6,3,15,"dummy"
"215917",0,0,1,1,"dummy"
"215957",0,0,0,0,"dummy"
"215958",0,0,0,0,"dummy"
"215966",0,1,0,1,"dummy"
"215969",2,2,1,5,"dummy"
"215970",0,0,1,1,"dummy"
"215971",1,0,0,1,"dummy"
"215977",0,0,0,0,"dummy"
"215978",2,1,1,4,"dummy"
"215979",1,6,0,7,"dummy"
"215980",2,6,2,10,"dummy"
"215983",0,0,1,1,"dummy"
"215984",13,3,1,17,"dummy"
"215985",1,0,0,1,"dummy"
"215986",1,1,1,3,"dummy"
"215987",0,0,0,0,"dummy"
"215993",14,2,1,17,"dummy"
"215994",0,0,2,2,"dummy"
"215997",0,0,1,1,"dummy"
"215998",0,0,1,1,"dummy"
"216013",8,1,3,12,"dummy"
"216022",0,0,0,0,"dummy"
"216023",0,0,1,1,"dummy"
"216027",0,0,1,1,"dummy"
"216028",2,0,0,2,"dummy"
"216029",0,1,0,1,"dummy"
"216030",15,5,1,21,"dummy"
"216031",0,1,1,2,"dummy"
"216032",0,0,1,1,"dummy"
"216033",0,1,3,4,"dummy"
"216034",0,2,0,2,"dummy"
"216035",0,0,1,1,"dummy"
"216063",0,0,0,0,"dummy"
"216076",10,2,1,13,"dummy"
"216077",0,0,1,1,"dummy"
"216078",2,0,0,2,"dummy"
"216079",5,3,3,11,"dummy"
"216080",0,0,1,1,"dummy"
"216081",3,9,2,14,"dummy"
"216082",0,0,1,1,"dummy"
"216100",0,0,1,1,"dummy"
"216101",0,0,1,1,"dummy"
"216102",0,0,1,1,"dummy"
"216103",0,0,1,1,"dummy"
"216104",0,0,1,1,"dummy"
"216105",0,0,1,1,"dummy"
"216106",0,0,1,1,"dummy"
"216107",0,0,1,1,"dummy"
"216111",2,7,2,11,"dummy"
"216112",1,2,0,3,"dummy"
"216114",0,1,3,4,"dummy"
"216115",0,1,1,2,"dummy"
"216117",0,2,0,2,"dummy"
"216118",0,0,2,2,"dummy"
"216119",6,6,3,15,"dummy"
"216123",1,0,0,1,"dummy"
"216124",1,2,4,7,"dummy"
"216125",4,1,2,7,"dummy"
"216142",0,0,2,2,"dummy"
"216143",0,1,0,1,"dummy"
"216144",0,4,2,6,"dummy"
"216146",0,2,1,3,"dummy"
"216147",0,1,0,1,"dummy"
"216148",1,4,0,5,"dummy"
"216149",0,1,0,1,"dummy"
"216150",10,5,0,15,"dummy"
"216151",0,1,0,1,"dummy"
"216168",0,3,1,4,"dummy"
"216169",0,2,0,2,"dummy"
"216172",0,1,0,1,"dummy"
"216173",2,2,1,5,"dummy"
"216174",0,0,1,1,"dummy"
"216175",0,4,0,4,"dummy"
"216180",3,1,1,5,"dummy"
"216185",0,8,0,8,"dummy"
"216186",0,1,0,1,"dummy"
"216187",0,1,0,1,"dummy"
"216188",0,1,0,1,"dummy"
"216189",0,1,0,1,"dummy"
"216190",0,1,0,1,"dummy"
"216191",0,1,0,1,"dummy"
"216192",10,10,0,20,"dummy"
"216193",0,0,1,1,"dummy"
"216194",0,0,1,1,"dummy"
"216198",0,0,1,1,"dummy"
"216199",0,0,1,1,"dummy"
"216200",0,0,1,1,"dummy"
"216203",5,7,1,13,"dummy"
"216204",0,5,0,5,"dummy"
"216205",0,1,0,1,"dummy"
"216206",0,1,0,1,"dummy"
"216207",0,1,1,2,"dummy"
"216208",0,4,0,4,"dummy"
"216209",4,5,0,9,"dummy"
"216210",4,1,0,5,"dummy"
"216211",0,1,0,1,"dummy"
"216212",0,0,1,1,"dummy"
"216213",0,1,0,1,"dummy"
"216214",0,1,0,1,"dummy"
"216215",0,1,0,1,"dummy"
"216216",0,1,0,1,"dummy"
"216217",0,1,0,1,"dummy"
"216222",6,2,2,10,"dummy"
"216223",0,4,2,6,"dummy"
"216225",0,0,1,1,"dummy"
"216226",10,15,1,26,"dummy"
"216227",0,5,0,5,"dummy"
"216228",1,2,1,4,"dummy"
"216229",0,0,1,1,"dummy"
"216230",1,1,2,4,"dummy"
"216231",0,0,1,1,"dummy"
"216232",0,0,0,0,"dummy"
"216239",0,1,0,1,"dummy"
"216240",0,0,1,1,"dummy"
"216241",0,1,0,1,"dummy"
"216243",1,2,0,3,"dummy"
"216244",1,9,1,11,"dummy"
"216250",2,4,0,6,"dummy"
"216251",0,2,0,2,"dummy"
"216252",0,2,0,2,"dummy"
"216253",10,2,0,12,"dummy"
"216254",0,2,0,2,"dummy"
"216255",0,0,0,0,"dummy"
"216259",6,7,3,16,"dummy"
"216260",8,0,1,9,"dummy"
"216261",0,1,0,1,"dummy"
"216262",0,2,2,4,"dummy"
"216264",0,1,0,1,"dummy"
"216265",0,0,1,1,"dummy"
"216266",1,0,0,1,"dummy"
"216269",10,11,6,27,"dummy"
"216270",0,2,0,2,"dummy"
"216271",1,0,0,1,"dummy"
"216272",0,1,0,1,"dummy"
"216273",6,13,1,20,"dummy"
"216274",0,0,3,3,"dummy"
"216275",0,1,1,2,"dummy"
"216276",0,2,0,2,"dummy"
"216277",3,4,0,7,"dummy"
"216278",26,0,0,26,"dummy"
"216280",0,0,1,1,"dummy"
"216281",0,0,0,0,"dummy"
"216283",0,3,1,4,"dummy"
"216284",5,1,2,8,"dummy"
"216299",4,3,2,9,"dummy"
"216300",3,4,2,9,"dummy"
"216301",0,0,2,2,"dummy"
"216302",0,0,0,0,"dummy"
"216303",0,0,1,1,"dummy"
"216304",0,0,0,0,"dummy"
"216305",0,0,0,0,"dummy"
"216306",2,0,0,2,"dummy"
"216307",0,2,0,2,"dummy"
"216308",0,0,0,0,"dummy"
"216309",0,0,0,0,"dummy"
"216310",0,0,2,2,"dummy"
"216311",3,4,2,9,"dummy"
"216314",1,1,0,2,"dummy"
"216315",1,0,1,2,"dummy"
"216316",3,8,0,11,"dummy"
"216317",2,3,1,6,"dummy"
"216318",1,1,0,2,"dummy"
"216320",0,2,0,2,"dummy"
"216321",2,0,0,2,"dummy"
"216322",1,1,0,2,"dummy"
"216323",1,5,1,7,"dummy"
"216324",0,3,0,3,"dummy"
"216326",0,0,1,1,"dummy"
"216382",0,0,1,1,"dummy"
"216383",0,1,0,1,"dummy"
"216386",0,0,2,2,"dummy"
"216390",0,1,0,1,"dummy"
"216391",4,0,2,6,"dummy"
"216393",0,0,0,0,"dummy"
"216394",0,8,0,8,"dummy"
"216395",1,5,0,6,"dummy"
"216396",0,0,0,0,"dummy"
"216397",0,0,1,1,"dummy"
"216398",0,0,1,1,"dummy"
"216399",4,3,5,12,"dummy"
"216402",0,0,0,0,"dummy"
"216403",14,1,0,15,"dummy"
"216404",0,0,0,0,"dummy"
"216405",1,0,4,5,"dummy"
"216416",0,1,2,3,"dummy"
"216417",0,0,1,1,"dummy"
"216418",0,0,1,1,"dummy"
"216421",0,0,1,1,"dummy"
"216432",0,1,0,1,"dummy"
"216433",0,0,1,1,"dummy"
"216434",0,1,2,3,"dummy"
"216435",0,0,0,0,"dummy"
"216437",6,8,2,16,"dummy"
"216456",0,1,0,1,"dummy"
"216457",16,2,0,18,"dummy"
"216458",0,0,1,1,"dummy"
"216459",0,0,1,1,"dummy"
"216462",1,0,0,1,"dummy"
"216465",0,1,0,1,"dummy"
"216467",1,1,0,2,"dummy"
"216468",0,1,0,1,"dummy"
"216469",1,0,0,1,"dummy"
"216470",0,1,0,1,"dummy"
"216472",0,3,0,3,"dummy"
"216473",3,1,0,4,"dummy"
"216487",0,0,1,1,"dummy"
"216488",0,3,0,3,"dummy"
"216489",0,0,1,1,"dummy"
"216490",0,1,1,2,"dummy"
"216493",0,1,0,1,"dummy"
"216496",2,4,0,6,"dummy"
"216497",0,2,0,2,"dummy"
"216498",0,2,0,2,"dummy"
"216499",10,2,0,12,"dummy"
"216500",0,2,0,2,"dummy"
"216501",0,0,0,0,"dummy"
"216502",0,0,3,3,"dummy"
"216503",0,5,0,5,"dummy"
"216504",1,0,1,2,"dummy"
"216524",0,0,1,1,"dummy"
"216525",0,0,1,1,"dummy"
"216528",10,2,3,15,"dummy"
"216529",0,0,2,2,"dummy"
"216532",0,1,0,1,"dummy"
"216533",0,1,0,1,"dummy"
"216539",0,1,0,1,"dummy"
"216540",8,4,0,12,"dummy"
"216541",15,17,7,39,"dummy"
"216542",0,1,0,1,"dummy"
"216549",6,0,0,6,"dummy"
"216550",2,5,2,9,"dummy"
"216555",2,0,1,3,"dummy"
"216556",0,1,0,1,"dummy"
"216558",2,1,1,4,"dummy"
"216559",0,0,2,2,"dummy"
"216560",0,0,1,1,"dummy"
"216561",0,0,1,1,"dummy"
"216562",0,0,1,1,"dummy"
"216563",0,0,1,1,"dummy"
"216564",0,0,1,1,"dummy"
"216565",0,0,2,2,"dummy"
"216566",0,1,2,3,"dummy"
"216567",0,0,1,1,"dummy"
"216568",0,0,1,1,"dummy"
"216569",0,2,1,3,"dummy"
"216570",0,1,0,1,"dummy"
"216589",0,0,1,1,"dummy"
"216590",0,0,1,1,"dummy"
"216595",3,3,0,6,"dummy"
"216610",3,7,0,10,"dummy"
"216621",0,0,0,0,"dummy"
"216622",0,0,0,0,"dummy"
"216623",0,0,0,0,"dummy"
"216624",0,0,0,0,"dummy"
"216625",0,1,2,3,"dummy"
"216631",0,8,0,8,"dummy"
"216632",0,5,0,5,"dummy"
"216633",0,2,0,2,"dummy"
"216634",2,1,0,3,"dummy"
"216635",0,1,2,3,"dummy"
"216636",0,1,0,1,"dummy"
"216637",1,0,2,3,"dummy"
"216646",0,2,0,2,"dummy"
"216647",0,5,5,10,"dummy"
"216648",1,1,5,7,"dummy"
"216649",0,1,0,1,"dummy"
"216650",1,4,10,15,"dummy"
"216651",0,1,2,3,"dummy"
"216652",0,6,0,6,"dummy"
"216653",0,2,0,2,"dummy"
"216654",0,8,0,8,"dummy"
"216655",0,1,0,1,"dummy"
"216656",1,1,1,3,"dummy"
"216657",0,0,1,1,"dummy"
"216658",0,3,0,3,"dummy"
"216659",5,2,0,7,"dummy"
"216660",0,9,0,9,"dummy"
"216661",0,2,0,2,"dummy"
"216662",0,0,1,1,"dummy"
"216663",0,0,1,1,"dummy"
"216664",16,1,0,17,"dummy"
"216665",52,45,5,102,"dummy"
"216666",5,14,0,19,"dummy"
"216667",4,4,0,8,"dummy"
"216668",0,0,1,1,"dummy"
"216669",0,2,0,2,"dummy"
"216670",0,2,0,2,"dummy"
"216671",0,2,1,3,"dummy"
"216672",0,0,1,1,"dummy"
"216673",0,3,0,3,"dummy"
"216674",9,0,0,9,"dummy"
"216675",12,8,1,21,"dummy"
"216676",0,0,1,1,"dummy"
"216677",0,10,0,10,"dummy"
"216683",0,0,2,2,"dummy"
"216690",0,0,1,1,"dummy"
"216691",1,0,0,1,"dummy"
"216692",0,0,1,1,"dummy"
"216719",3,3,1,7,"dummy"
"216720",0,0,0,0,"dummy"
"216721",0,0,0,0,"dummy"
"216722",0,0,0,0,"dummy"
"216723",1,0,0,1,"dummy"
"216724",0,0,0,0,"dummy"
"216725",0,1,0,1,"dummy"
"216726",2,7,2,11,"dummy"
"216727",0,0,0,0,"dummy"
"216733",0,11,0,11,"dummy"
"216736",1,2,0,3,"dummy"
"216741",0,0,1,1,"dummy"
"216770",0,1,0,1,"dummy"
"216778",11,0,1,12,"dummy"
"216779",0,4,0,4,"dummy"
"216780",0,3,0,3,"dummy"
"216783",0,0,1,1,"dummy"
"216784",0,0,1,1,"dummy"
"216785",0,0,1,1,"dummy"
"216572",3,4,1,8,"dummy"
"216573",0,1,0,1,"dummy"
"216574",2,14,0,16,"dummy"
"216575",5,4,1,10,"dummy"
"216592",0,1,0,1,"dummy"
"216593",0,0,1,1,"dummy"
"216597",2,2,0,4,"dummy"
"216598",3,10,0,13,"dummy"
"216599",5,5,0,10,"dummy"
"216600",0,2,0,2,"dummy"
"216607",0,0,0,0,"dummy"
"216608",0,0,3,3,"dummy"
"216619",0,2,0,2,"dummy"
"216629",0,9,0,9,"dummy"
"216643",9,5,1,15,"dummy"
"216644",5,9,1,15,"dummy"
"216681",3,3,2,8,"dummy"
"216700",0,1,1,2,"dummy"
"216703",0,2,0,2,"dummy"
"216704",0,1,0,1,"dummy"
"216705",3,3,0,6,"dummy"
"216706",0,1,0,1,"dummy"
"216707",0,1,0,1,"dummy"
"216708",0,3,0,3,"dummy"
"216709",0,2,0,2,"dummy"
"216710",0,1,0,1,"dummy"
"216711",0,0,1,1,"dummy"
"216714",5,7,2,14,"dummy"
"216715",1,0,0,1,"dummy"
"216729",3,0,0,3,"dummy"
"216730",1,1,0,2,"dummy"
"216731",1,1,3,5,"dummy"
"216738",3,5,4,12,"dummy"
"216739",0,0,1,1,"dummy"
"216743",0,1,1,2,"dummy"
"216744",9,2,0,11,"dummy"
"216745",0,3,0,3,"dummy"
"216746",2,1,0,3,"dummy"
"216747",0,1,0,1,"dummy"
"216748",0,8,0,8,"dummy"
"216749",0,3,1,4,"dummy"
"216760",2,9,2,13,"dummy"
"216761",3,3,1,7,"dummy"
"216762",7,1,0,8,"dummy"
"216765",0,6,0,6,"dummy"
"216766",6,1,0,7,"dummy"
"216767",2,2,4,8,"dummy"
"216768",0,0,1,1,"dummy"
"216774",0,0,2,2,"dummy"
"216775",0,9,2,11,"dummy"
"216776",0,0,2,2,"dummy"
"216807",0,0,1,1,"dummy"
"216808",0,0,1,1,"dummy"
"216809",0,0,1,1,"dummy"
"216813",0,1,1,2,"dummy"
"216814",0,0,1,1,"dummy"
"216818",2,0,0,2,"dummy"
"216821",0,1,0,1,"dummy"
"216824",0,0,1,1,"dummy"
"216832",0,0,0,0,"dummy"
"216833",0,0,1,1,"dummy"
"216834",3,0,0,3,"dummy"
"216835",0,0,1,1,"dummy"
"216836",0,1,0,1,"dummy"
"216837",1,2,0,3,"dummy"
"216838",0,5,0,5,"dummy"
"216839",5,0,0,5,"dummy"
"216786",0,0,1,1,"dummy"
"216787",0,0,1,1,"dummy"
"216788",0,0,1,1,"dummy"
"216789",0,0,1,1,"dummy"
"216790",0,0,1,1,"dummy"
"216791",0,0,1,1,"dummy"
"216798",2,1,0,3,"dummy"
"216799",1,1,0,2,"dummy"
"216800",0,1,0,1,"dummy"
"216801",2,0,0,2,"dummy"
"216802",4,0,1,5,"dummy"
"216803",18,3,1,22,"dummy"
"216804",2,0,3,5,"dummy"
"216805",0,0,1,1,"dummy"
"216811",0,1,0,1,"dummy"
"216816",0,0,1,1,"dummy"
"216864",1,0,0,1,"dummy"
"216865",0,1,0,1,"dummy"
"216868",0,2,0,2,"dummy"
"216869",0,2,1,3,"dummy"
"216870",0,1,0,1,"dummy"
"216871",0,0,1,1,"dummy"
"216872",1,1,0,2,"dummy"
"216873",1,1,0,2,"dummy"
"216874",0,0,3,3,"dummy"
"216891",0,0,0,0,"dummy"
"216892",0,0,0,0,"dummy"
"216893",0,0,0,0,"dummy"
"216894",0,0,0,0,"dummy"
"216895",0,0,0,0,"dummy"
"216896",0,0,0,0,"dummy"
"216897",0,0,0,0,"dummy"
"216898",0,0,0,0,"dummy"
"216899",0,0,0,0,"dummy"
"216900",0,0,0,0,"dummy"
"216901",1,3,0,4,"dummy"
"216902",0,1,0,1,"dummy"
"216903",0,0,0,0,"dummy"
"216904",0,2,0,2,"dummy"
"216905",0,0,1,1,"dummy"
"216906",0,0,0,0,"dummy"
"216907",0,0,0,0,"dummy"
"216908",0,0,0,0,"dummy"
"216909",0,0,0,0,"dummy"
"216910",0,0,0,0,"dummy"
"216911",0,6,0,6,"dummy"
"216912",0,0,0,0,"dummy"
"216913",0,0,0,0,"dummy"
"216914",0,0,0,0,"dummy"
"216915",0,0,0,0,"dummy"
"216916",0,0,0,0,"dummy"
"216917",0,0,0,0,"dummy"
"216918",0,0,0,0,"dummy"
"216919",0,0,0,0,"dummy"
"216920",6,0,0,6,"dummy"
"216921",0,0,0,0,"dummy"
"216922",0,0,0,0,"dummy"
"216923",0,0,0,0,"dummy"
"216924",0,0,0,0,"dummy"
"216925",0,0,0,0,"dummy"
"216926",0,0,0,0,"dummy"
"216927",0,0,0,0,"dummy"
"216928",0,0,1,1,"dummy"
"216929",0,0,0,0,"dummy"
"216930",0,0,0,0,"dummy"
"216931",0,0,0,0,"dummy"
"216932",0,0,0,0,"dummy"
"216933",0,0,0,0,"dummy"
"216934",0,0,2,2,"dummy"
"216935",0,0,0,0,"dummy"
"216936",0,0,0,0,"dummy"
"216937",0,0,0,0,"dummy"
"216941",2,0,0,2,"dummy"
"216942",3,4,3,10,"dummy"
"216943",2,1,0,3,"dummy"
"216944",0,0,1,1,"dummy"
"216947",0,2,0,2,"dummy"
"216948",0,1,0,1,"dummy"
"216949",0,1,0,1,"dummy"
"216950",0,0,1,1,"dummy"
"216951",0,0,1,1,"dummy"
"216954",0,1,0,1,"dummy"
"216961",0,0,1,1,"dummy"
"216964",0,2,0,2,"dummy"
"216840",0,5,0,5,"dummy"
"216841",0,0,0,0,"dummy"
"216842",0,0,0,0,"dummy"
"216843",1,1,0,2,"dummy"
"216844",4,1,0,5,"dummy"
"216845",1,0,0,1,"dummy"
"216846",0,0,0,0,"dummy"
"216847",0,0,0,0,"dummy"
"216848",0,0,0,0,"dummy"
"216853",0,0,0,0,"dummy"
"216858",0,0,1,1,"dummy"
"216861",0,0,1,1,"dummy"
"216862",11,13,0,24,"dummy"
"216878",0,0,0,0,"dummy"
"216879",0,0,0,0,"dummy"
"216882",0,8,0,8,"dummy"
"216885",5,2,0,7,"dummy"
"216886",0,1,0,1,"dummy"
"216887",0,1,0,1,"dummy"
"216888",0,2,0,2,"dummy"
"216889",0,1,0,1,"dummy"
"216939",2,2,2,6,"dummy"
"216977",0,1,0,1,"dummy"
"217014",0,0,1,1,"dummy"
"217015",0,2,0,2,"dummy"
"217018",0,3,0,3,"dummy"
"217146",10,7,1,18,"dummy"
"217147",14,9,0,23,"dummy"
"217158",1,0,0,1,"dummy"
"217159",0,1,0,1,"dummy"
"217160",0,0,1,1,"dummy"
"217161",1,5,1,7,"dummy"
"217162",5,3,1,9,"dummy"
"217163",0,0,1,1,"dummy"
"217164",1,4,1,6,"dummy"
"217165",0,0,1,1,"dummy"
"217166",0,0,1,1,"dummy"
"217167",0,1,1,2,"dummy"
"217182",0,0,1,1,"dummy"
"217183",0,0,0,0,"dummy"
"217184",3,0,1,4,"dummy"
"217191",0,0,0,0,"dummy"
"217192",0,0,0,0,"dummy"
"217195",0,2,0,2,"dummy"
"217198",0,0,1,1,"dummy"
"217205",4,0,0,4,"dummy"
"217206",0,1,0,1,"dummy"
"217228",0,0,0,0,"dummy"
"217233",0,0,0,0,"dummy"
"217236",1,0,0,1,"dummy"
"217240",2,2,3,7,"dummy"
"217241",0,2,0,2,"dummy"
"217242",0,0,4,4,"dummy"
"217243",9,0,1,10,"dummy"
"217244",0,0,1,1,"dummy"
"217245",0,0,2,2,"dummy"
"217246",0,0,1,1,"dummy"
"217247",0,0,1,1,"dummy"
"217248",0,0,1,1,"dummy"
"217249",0,0,1,1,"dummy"
"217252",0,0,3,3,"dummy"
"217253",0,1,1,2,"dummy"
"217254",0,1,0,1,"dummy"
"217255",0,2,1,3,"dummy"
"217256",0,1,0,1,"dummy"
"216965",0,1,0,1,"dummy"
"216966",0,1,0,1,"dummy"
"216967",0,1,0,1,"dummy"
"216968",0,1,2,3,"dummy"
"216971",0,0,0,0,"dummy"
"216972",8,6,3,17,"dummy"
"216973",6,8,3,17,"dummy"
"216974",0,0,2,2,"dummy"
"216975",8,6,1,15,"dummy"
"216979",0,7,3,10,"dummy"
"216982",5,13,1,19,"dummy"
"216983",0,0,4,4,"dummy"
"216984",3,4,3,10,"dummy"
"216985",0,1,2,3,"dummy"
"216986",0,5,0,5,"dummy"
"216987",0,1,0,1,"dummy"
"216988",0,0,1,1,"dummy"
"216989",2,0,0,2,"dummy"
"216990",1,1,2,4,"dummy"
"217003",0,3,0,3,"dummy"
"217004",1,0,0,1,"dummy"
"217005",0,3,1,4,"dummy"
"217006",1,0,0,1,"dummy"
"217007",1,0,0,1,"dummy"
"217008",0,1,0,1,"dummy"
"217009",0,0,1,1,"dummy"
"217010",2,1,1,4,"dummy"
"217072",0,0,0,0,"dummy"
"217075",0,0,1,1,"dummy"
"217076",0,1,0,1,"dummy"
"217077",0,1,0,1,"dummy"
"217078",1,0,0,1,"dummy"
"217079",0,0,1,1,"dummy"
"217080",0,0,1,1,"dummy"
"217081",0,0,1,1,"dummy"
"217082",0,0,1,1,"dummy"
"217083",0,0,1,1,"dummy"
"217084",0,2,0,2,"dummy"
"217087",0,0,1,1,"dummy"
"217140",0,0,1,1,"dummy"
"217141",0,0,1,1,"dummy"
"217142",1,3,3,7,"dummy"
"217143",0,0,1,1,"dummy"
"217144",0,0,1,1,"dummy"
"217149",17,17,2,36,"dummy"
"217150",17,20,2,39,"dummy"
"217151",0,7,0,7,"dummy"
"217152",1,2,0,3,"dummy"
"217153",0,0,0,0,"dummy"
"217154",4,5,0,9,"dummy"
"217155",0,3,0,3,"dummy"
"217156",54,20,2,76,"dummy"
"217169",0,1,0,1,"dummy"
"217170",1,1,0,2,"dummy"
"217171",0,0,0,0,"dummy"
"217188",0,0,0,0,"dummy"
"217189",0,0,0,0,"dummy"
"217200",0,1,0,1,"dummy"
"217201",1,0,0,1,"dummy"
"217202",2,5,0,7,"dummy"
"217203",0,0,2,2,"dummy"
"217208",1,6,1,8,"dummy"
"217209",0,0,1,1,"dummy"
"217210",0,1,0,1,"dummy"
"217211",0,0,1,1,"dummy"
"217212",0,0,1,1,"dummy"
"217213",17,4,0,21,"dummy"
"217214",5,2,2,9,"dummy"
"217215",0,0,0,0,"dummy"
"217216",4,15,0,19,"dummy"
"217217",0,16,2,18,"dummy"
"217218",0,0,1,1,"dummy"
"217219",0,0,1,1,"dummy"
"217220",3,2,2,7,"dummy"
"217221",1,0,1,2,"dummy"
"217222",0,6,9,15,"dummy"
"217223",0,6,0,6,"dummy"
"217224",2,0,0,2,"dummy"
"217225",0,2,0,2,"dummy"
"217226",1,0,0,1,"dummy"
"217238",0,0,1,1,"dummy"
"217260",2,0,0,2,"dummy"
"217272",2,0,1,3,"dummy"
"217273",0,3,1,4,"dummy"
"217274",0,0,1,1,"dummy"
"217275",1,0,0,1,"dummy"
"217276",0,1,0,1,"dummy"
"217277",0,0,1,1,"dummy"
"217278",1,3,0,4,"dummy"
"217279",6,2,2,10,"dummy"
"217280",0,0,1,1,"dummy"
"217281",0,0,1,1,"dummy"
"217282",1,2,0,3,"dummy"
"217283",2,0,0,2,"dummy"
"217284",0,1,0,1,"dummy"
"217304",0,1,0,1,"dummy"
"217305",0,1,0,1,"dummy"
"217306",0,1,0,1,"dummy"
"217307",0,1,0,1,"dummy"
"217308",0,1,0,1,"dummy"
"217351",11,2,0,13,"dummy"
"217352",9,6,0,15,"dummy"
"217353",0,0,0,0,"dummy"
"217354",0,0,2,2,"dummy"
"217362",6,0,0,6,"dummy"
"217363",2,5,2,9,"dummy"
"217366",0,1,0,1,"dummy"
"217367",0,2,0,2,"dummy"
"217368",0,0,0,0,"dummy"
"217369",1,0,0,1,"dummy"
"217370",0,0,0,0,"dummy"
"217371",1,0,0,1,"dummy"
"217393",4,2,1,7,"dummy"
"217394",0,3,1,4,"dummy"
"217397",0,2,0,2,"dummy"
"217404",0,0,3,3,"dummy"
"217422",0,0,0,0,"dummy"
"217423",0,1,0,1,"dummy"
"217424",0,0,0,0,"dummy"
"217425",1,0,0,1,"dummy"
"217426",0,0,0,0,"dummy"
"217427",0,1,0,1,"dummy"
"217435",2,2,3,7,"dummy"
"217439",0,0,0,0,"dummy"
"217440",0,0,0,0,"dummy"
"217446",0,1,0,1,"dummy"
"217447",0,0,2,2,"dummy"
"217448",0,1,0,1,"dummy"
"217449",3,5,0,8,"dummy"
"217450",7,5,5,17,"dummy"
"217451",2,1,0,3,"dummy"
"217452",1,0,2,3,"dummy"
"217453",5,2,1,8,"dummy"
"217454",0,1,0,1,"dummy"
"217455",0,1,0,1,"dummy"
"217492",0,11,0,11,"dummy"
"217506",1,0,0,1,"dummy"
"217507",0,0,1,1,"dummy"
"217508",0,0,1,1,"dummy"
"217509",1,0,0,1,"dummy"
"217510",4,4,0,8,"dummy"
"217511",0,2,0,2,"dummy"
"217517",0,0,1,1,"dummy"
"217518",0,0,1,1,"dummy"
"217560",0,2,0,2,"dummy"
"217257",0,1,0,1,"dummy"
"217258",0,0,1,1,"dummy"
"217262",0,1,0,1,"dummy"
"217267",2,9,0,11,"dummy"
"217268",1,2,0,3,"dummy"
"217269",0,1,0,1,"dummy"
"217270",11,12,0,23,"dummy"
"217286",0,0,0,0,"dummy"
"217287",0,0,0,0,"dummy"
"217301",0,0,1,1,"dummy"
"217302",2,0,0,2,"dummy"
"217326",0,0,1,1,"dummy"
"217329",0,0,1,1,"dummy"
"217330",2,0,0,2,"dummy"
"217331",0,1,0,1,"dummy"
"217332",0,3,0,3,"dummy"
"217333",3,0,0,3,"dummy"
"217334",0,0,1,1,"dummy"
"217335",0,1,0,1,"dummy"
"217336",0,0,0,0,"dummy"
"217337",4,3,1,8,"dummy"
"217338",5,1,0,6,"dummy"
"217339",0,0,1,1,"dummy"
"217340",0,1,1,2,"dummy"
"217341",3,3,2,8,"dummy"
"217342",1,0,0,1,"dummy"
"217345",2,0,0,2,"dummy"
"217346",0,0,1,1,"dummy"
"217347",0,0,1,1,"dummy"
"217348",0,1,0,1,"dummy"
"217349",0,0,1,1,"dummy"
"217373",0,0,1,1,"dummy"
"217374",0,0,1,1,"dummy"
"217375",0,5,0,5,"dummy"
"217376",0,0,2,2,"dummy"
"217377",0,0,0,0,"dummy"
"217378",0,0,0,0,"dummy"
"217379",0,0,9,9,"dummy"
"217380",0,0,1,1,"dummy"
"217381",0,0,1,1,"dummy"
"217382",0,2,11,13,"dummy"
"217383",0,0,3,3,"dummy"
"217384",0,0,3,3,"dummy"
"217385",2,0,6,8,"dummy"
"217386",0,0,3,3,"dummy"
"217387",0,0,3,3,"dummy"
"217388",0,0,6,6,"dummy"
"217389",0,0,6,6,"dummy"
"217390",0,0,3,3,"dummy"
"217391",0,0,9,9,"dummy"
"217429",1,3,2,6,"dummy"
"217430",3,7,0,10,"dummy"
"217431",1,0,0,1,"dummy"
"217432",0,0,1,1,"dummy"
"217433",0,0,0,0,"dummy"
"217437",1,0,0,1,"dummy"
"217442",0,1,0,1,"dummy"
"217443",9,3,1,13,"dummy"
"217444",1,4,0,5,"dummy"
"217478",0,1,0,1,"dummy"
"217481",1,3,0,4,"dummy"
"217484",1,3,1,5,"dummy"
"217485",2,1,0,3,"dummy"
"217486",0,0,0,0,"dummy"
"217487",0,1,0,1,"dummy"
"217488",0,0,0,0,"dummy"
"217489",0,1,0,1,"dummy"
"217490",0,0,1,1,"dummy"
"217494",1,0,0,1,"dummy"
"217495",0,1,0,1,"dummy"
"217498",4,1,0,5,"dummy"
"217499",2,1,1,4,"dummy"
"217500",0,0,0,0,"dummy"
"217501",0,4,0,4,"dummy"
"217502",1,4,0,5,"dummy"
"217503",1,0,1,2,"dummy"
"217504",7,0,0,7,"dummy"
"217513",0,2,0,2,"dummy"
"217514",1,2,0,3,"dummy"
"217515",2,1,4,7,"dummy"
"217520",1,0,0,1,"dummy"
"217564",0,0,1,1,"dummy"
"217565",0,1,0,1,"dummy"
"217566",0,0,1,1,"dummy"
"217561",0,1,1,2,"dummy"
"217562",3,4,2,9,"dummy"
"217569",0,1,0,1,"dummy"
"217570",0,1,0,1,"dummy"
"217571",6,2,0,8,"dummy"
"217576",0,1,0,1,"dummy"
"217577",0,1,4,5,"dummy"
"217579",0,7,0,7,"dummy"
"217580",0,0,1,1,"dummy"
"217581",0,0,1,1,"dummy"
"217587",0,0,1,1,"dummy"
"217591",4,1,0,5,"dummy"
"217592",2,1,1,4,"dummy"
"217593",0,0,0,0,"dummy"
"217594",0,4,0,4,"dummy"
"217595",1,4,0,5,"dummy"
"217596",1,0,1,2,"dummy"
"217597",7,0,0,7,"dummy"
"217600",0,3,0,3,"dummy"
"217602",0,0,0,0,"dummy"
"217604",0,0,1,1,"dummy"
"217605",0,1,0,1,"dummy"
"217606",0,1,0,1,"dummy"
"217607",0,1,0,1,"dummy"
"217608",1,0,0,1,"dummy"
"217609",0,2,0,2,"dummy"
"217610",0,0,3,3,"dummy"
"217611",0,1,1,2,"dummy"
"217612",0,1,1,2,"dummy"
"217613",0,0,2,2,"dummy"
"217614",1,3,2,6,"dummy"
"217615",3,3,0,6,"dummy"
"217616",3,3,2,8,"dummy"
"217617",3,3,0,6,"dummy"
"217619",3,12,0,15,"dummy"
"217620",11,5,1,17,"dummy"
"217621",0,2,0,2,"dummy"
"217623",0,0,1,1,"dummy"
"217625",0,0,1,1,"dummy"
"217626",5,0,3,8,"dummy"
"217627",4,2,0,6,"dummy"
"217630",28,7,4,39,"dummy"
"217631",7,4,2,13,"dummy"
"217633",2,2,2,6,"dummy"
"217638",11,0,0,11,"dummy"
"217639",1,0,0,1,"dummy"
"217640",0,0,0,0,"dummy"
"217641",2,0,0,2,"dummy"
"217642",0,0,0,0,"dummy"
"217643",0,1,1,2,"dummy"
"217644",0,1,0,1,"dummy"
"217646",0,3,0,3,"dummy"
"217647",0,2,0,2,"dummy"
"217648",0,0,1,1,"dummy"
"217649",0,0,2,2,"dummy"
"217650",0,0,3,3,"dummy"
"217652",0,0,1,1,"dummy"
"217655",0,4,2,6,"dummy"
"217658",3,2,4,9,"dummy"
"217660",0,0,0,0,"dummy"
"217663",5,10,0,15,"dummy"
"217665",0,1,0,1,"dummy"
"217666",0,2,0,2,"dummy"
"217667",8,1,0,9,"dummy"
"217668",2,1,0,3,"dummy"
"217670",0,3,0,3,"dummy"
"217671",0,0,1,1,"dummy"
"217674",0,0,1,1,"dummy"
"217675",0,1,0,1,"dummy"
"217676",0,0,1,1,"dummy"
"217681",3,12,1,16,"dummy"
"217682",2,1,0,3,"dummy"
"217683",0,3,0,3,"dummy"
"217684",0,6,1,7,"dummy"
"217686",0,0,1,1,"dummy"
"217687",0,0,1,1,"dummy"
"217688",0,0,1,1,"dummy"
"217689",0,0,1,1,"dummy"
"217695",0,0,0,0,"dummy"
"217696",0,0,1,1,"dummy"
"217697",3,0,0,3,"dummy"
"217698",0,0,1,1,"dummy"
"217699",0,1,0,1,"dummy"
"217700",0,0,0,0,"dummy"
"217701",0,0,1,1,"dummy"
"217702",0,2,0,2,"dummy"
"217706",0,1,0,1,"dummy"
"217707",0,0,0,0,"dummy"
"217708",0,0,1,1,"dummy"
"217709",0,3,0,3,"dummy"
"217710",5,0,0,5,"dummy"
"217711",0,1,0,1,"dummy"
"217713",0,0,1,1,"dummy"
"217714",0,0,1,1,"dummy"
"217719",3,4,1,8,"dummy"
"217720",0,24,0,24,"dummy"
"217721",0,9,0,9,"dummy"
"217722",4,12,2,18,"dummy"
"217723",0,4,0,4,"dummy"
"217724",0,0,1,1,"dummy"
"217725",1,4,0,5,"dummy"
"217726",4,7,0,11,"dummy"
"217727",9,4,0,13,"dummy"
"217728",0,10,0,10,"dummy"
"217729",0,1,1,2,"dummy"
"217730",0,2,0,2,"dummy"
"217731",0,0,1,1,"dummy"
"217732",0,2,0,2,"dummy"
"217750",1,1,0,2,"dummy"
"217751",1,1,0,2,"dummy"
"217753",0,0,0,0,"dummy"
"217755",10,1,0,11,"dummy"
"217756",0,0,0,0,"dummy"
"217757",0,0,0,0,"dummy"
"217758",3,0,4,7,"dummy"
"217759",0,1,0,1,"dummy"
"217762",0,0,3,3,"dummy"
"217764",0,2,3,5,"dummy"
"217765",0,2,0,2,"dummy"
"217803",0,0,0,0,"dummy"
"217804",0,0,0,0,"dummy"
"217805",0,0,1,1,"dummy"
"217806",0,0,1,1,"dummy"
"217807",0,0,1,1,"dummy"
"217808",0,0,0,0,"dummy"
"217809",0,0,0,0,"dummy"
"217810",0,0,0,0,"dummy"
"217811",0,0,0,0,"dummy"
"217812",0,0,1,1,"dummy"
"217813",0,0,0,0,"dummy"
"217814",0,0,0,0,"dummy"
"217815",0,1,0,1,"dummy"
"217816",0,0,0,0,"dummy"
"217817",0,0,0,0,"dummy"
"217818",0,0,0,0,"dummy"
"217819",0,0,0,0,"dummy"
"217820",0,0,0,0,"dummy"
"217821",0,0,0,0,"dummy"
"217822",0,0,0,0,"dummy"
"217823",0,0,0,0,"dummy"
"217825",0,1,0,1,"dummy"
"217829",18,1,0,19,"dummy"
"217831",0,1,0,1,"dummy"
"217837",0,1,1,2,"dummy"
"217838",0,0,1,1,"dummy"
"217839",4,1,0,5,"dummy"
"217840",0,1,2,3,"dummy"
"217841",0,0,1,1,"dummy"
"217842",2,0,0,2,"dummy"
"217843",0,0,0,0,"dummy"
"217868",0,0,1,1,"dummy"
"217869",0,0,1,1,"dummy"
"217870",0,3,0,3,"dummy"
"217871",0,1,3,4,"dummy"
"217872",8,8,0,16,"dummy"
"217873",5,0,1,6,"dummy"
"217874",1,0,0,1,"dummy"
"217875",0,0,1,1,"dummy"
"217876",0,0,1,1,"dummy"
"217877",0,1,0,1,"dummy"
"217879",0,1,0,1,"dummy"
"217880",0,5,0,5,"dummy"
"217881",1,11,0,12,"dummy"
"217882",0,0,1,1,"dummy"
"217883",0,0,1,1,"dummy"
"217884",5,0,0,5,"dummy"
"217885",3,0,0,3,"dummy"
"217893",1,0,0,1,"dummy"
"217894",0,1,0,1,"dummy"
"217897",0,0,2,2,"dummy"
"217898",0,0,1,1,"dummy"
"217900",2,4,0,6,"dummy"
"217901",0,2,0,2,"dummy"
"217902",0,2,0,2,"dummy"
"217903",10,2,0,12,"dummy"
"217904",0,2,0,2,"dummy"
"217905",0,0,0,0,"dummy"
"217906",0,0,3,3,"dummy"
"217936",0,0,2,2,"dummy"
"217937",0,0,0,0,"dummy"
"217941",2,2,0,4,"dummy"
"217943",0,0,1,1,"dummy"
"217944",0,4,0,4,"dummy"
"217945",0,4,3,7,"dummy"
"217946",0,0,1,1,"dummy"
"217949",0,1,0,1,"dummy"
"217951",0,0,0,0,"dummy"
"217952",0,0,0,0,"dummy"
"217956",0,4,0,4,"dummy"
"217957",0,1,0,1,"dummy"
"217961",0,1,0,1,"dummy"
"217962",0,1,0,1,"dummy"
"217963",0,2,0,2,"dummy"
"217966",0,9,1,10,"dummy"
"217967",0,0,1,1,"dummy"
"217968",0,0,1,1,"dummy"
"217969",0,2,0,2,"dummy"
"217970",1,2,0,3,"dummy"
"217971",0,0,1,1,"dummy"
"217972",0,0,1,1,"dummy"
"217973",1,2,1,4,"dummy"
"217974",0,0,1,1,"dummy"
"217976",1,1,0,2,"dummy"
"217977",3,1,2,6,"dummy"
"217978",1,1,2,4,"dummy"
"217979",0,1,0,1,"dummy"
"217980",1,1,0,2,"dummy"
"217982",0,0,3,3,"dummy"
"217985",2,0,0,2,"dummy"
"217986",0,1,0,1,"dummy"
"217987",0,2,0,2,"dummy"
"217988",0,2,0,2,"dummy"
"217989",0,2,0,2,"dummy"
"217990",0,12,0,12,"dummy"
"217999",1,0,0,1,"dummy"
"218000",2,0,0,2,"dummy"
"218001",0,1,0,1,"dummy"
"218002",0,1,0,1,"dummy"
"218003",1,3,1,5,"dummy"
"218004",0,1,0,1,"dummy"
"218005",0,1,1,2,"dummy"
"218006",0,0,1,1,"dummy"
"218007",0,1,0,1,"dummy"
"218020",0,0,2,2,"dummy"
"218024",0,0,1,1,"dummy"
"218033",0,2,0,2,"dummy"
"218034",2,0,0,2,"dummy"
"218035",0,2,0,2,"dummy"
"218037",0,0,1,1,"dummy"
"218038",0,0,1,1,"dummy"
"218039",0,0,1,1,"dummy"
"218041",0,0,0,0,"dummy"
"218043",0,0,1,1,"dummy"
"218044",0,0,1,1,"dummy"
"218060",0,2,0,2,"dummy"
"218061",0,1,0,1,"dummy"
"218062",0,1,0,1,"dummy"
"218063",0,1,0,1,"dummy"
"218064",0,2,0,2,"dummy"
"218065",1,1,0,2,"dummy"
"218066",4,12,0,16,"dummy"
"218067",1,1,0,2,"dummy"
"218068",0,0,0,0,"dummy"
"218071",0,0,0,0,"dummy"
"218074",1,0,0,1,"dummy"
"218075",0,0,1,1,"dummy"
"218076",2,0,0,2,"dummy"
"218077",0,0,1,1,"dummy"
"218078",0,2,0,2,"dummy"
"218079",0,2,0,2,"dummy"
"218080",1,0,0,1,"dummy"
"218082",0,3,1,4,"dummy"
"218083",1,0,0,1,"dummy"
"218084",0,1,0,1,"dummy"
"218085",1,0,1,2,"dummy"
"218086",0,1,0,1,"dummy"
"218087",2,0,1,3,"dummy"
"218088",0,0,0,0,"dummy"
"218089",0,5,0,5,"dummy"
"218092",1,7,1,9,"dummy"
"218093",1,2,1,4,"dummy"
"218105",6,3,0,9,"dummy"
"218106",0,1,0,1,"dummy"
"218110",0,18,0,18,"dummy"
"218116",18,25,2,45,"dummy"
"218117",0,0,3,3,"dummy"
"218118",0,0,1,1,"dummy"
"218122",1,2,0,3,"dummy"
"218135",0,1,0,1,"dummy"
"218136",1,0,1,2,"dummy"
"218139",0,0,1,1,"dummy"
"218141",0,1,0,1,"dummy"
"218142",0,1,0,1,"dummy"
"218153",0,0,1,1,"dummy"
"218154",1,0,0,1,"dummy"
"218155",0,0,1,1,"dummy"
"218156",0,1,2,3,"dummy"
"218157",0,0,3,3,"dummy"
"218158",0,0,1,1,"dummy"
"218159",0,0,1,1,"dummy"
"218160",0,0,1,1,"dummy"
"218161",0,0,2,2,"dummy"
"218162",0,0,2,2,"dummy"
"218163",0,0,1,1,"dummy"
"218164",0,3,0,3,"dummy"
"218165",0,1,0,1,"dummy"
"218166",0,0,2,2,"dummy"
"218167",0,0,2,2,"dummy"
"218168",0,5,0,5,"dummy"
"218169",0,0,2,2,"dummy"
"218170",0,0,2,2,"dummy"
"218172",0,0,1,1,"dummy"
"218173",0,1,0,1,"dummy"
"218174",2,1,0,3,"dummy"
"218175",0,0,2,2,"dummy"
"218176",0,1,0,1,"dummy"
"218178",6,10,2,18,"dummy"
"218179",0,0,2,2,"dummy"
"218180",0,0,1,1,"dummy"
"218181",0,2,0,2,"dummy"
"218183",0,1,0,1,"dummy"
"218185",0,0,3,3,"dummy"
"218186",7,0,0,7,"dummy"
"218187",0,4,0,4,"dummy"
"218188",0,0,2,2,"dummy"
"218191",0,5,0,5,"dummy"
"218192",0,2,0,2,"dummy"
"218193",2,1,0,3,"dummy"
"218194",11,0,2,13,"dummy"
"218197",0,0,2,2,"dummy"
"218200",0,1,1,2,"dummy"
"218201",0,0,1,1,"dummy"
"218205",1,2,3,6,"dummy"
"218206",1,2,1,4,"dummy"
"218207",2,1,0,3,"dummy"
"218211",0,4,0,4,"dummy"
"218213",0,1,0,1,"dummy"
"218220",0,1,0,1,"dummy"
"218221",0,1,0,1,"dummy"
"218222",1,0,0,1,"dummy"
"218223",0,2,0,2,"dummy"
"218224",0,1,0,1,"dummy"
"218225",0,4,0,4,"dummy"
"218226",0,0,3,3,"dummy"
"218227",2,2,0,4,"dummy"
"218228",2,1,0,3,"dummy"
"218229",0,0,1,1,"dummy"
"218230",0,0,0,0,"dummy"
"218232",0,1,0,1,"dummy"
"218233",0,1,2,3,"dummy"
"218235",0,2,0,2,"dummy"
"218236",0,1,0,1,"dummy"
"218239",0,2,0,2,"dummy"
"218243",0,0,1,1,"dummy"
"218244",0,0,1,1,"dummy"
"218245",5,1,1,7,"dummy"
"218246",0,1,1,2,"dummy"
"218247",0,0,1,1,"dummy"
"218248",0,2,0,2,"dummy"
"218250",0,0,0,0,"dummy"
"218251",4,0,0,4,"dummy"
"218252",0,3,0,3,"dummy"
"218253",6,2,2,10,"dummy"
"218254",0,1,0,1,"dummy"
"218255",1,1,0,2,"dummy"
"218256",1,1,0,2,"dummy"
"218257",0,1,0,1,"dummy"
"218258",1,2,1,4,"dummy"
"218259",1,1,2,4,"dummy"
"218260",0,5,0,5,"dummy"
"218261",0,4,1,5,"dummy"
"218262",0,1,0,1,"dummy"
"218263",3,6,0,9,"dummy"
"218264",5,2,0,7,"dummy"
"218265",0,1,0,1,"dummy"
"218266",1,1,0,2,"dummy"
"218267",2,4,1,7,"dummy"
"218268",0,1,0,1,"dummy"
"218270",0,8,0,8,"dummy"
"218271",2,4,2,8,"dummy"
"218272",0,2,0,2,"dummy"
"218273",0,2,0,2,"dummy"
"218274",1,2,0,3,"dummy"
"218275",0,1,0,1,"dummy"
"218276",3,2,1,6,"dummy"
"218277",1,0,0,1,"dummy"
"218278",1,0,1,2,"dummy"
"218279",0,0,1,1,"dummy"
"218281",0,0,1,1,"dummy"
"218283",2,3,2,7,"dummy"
"218284",0,1,1,2,"dummy"
"218285",0,1,0,1,"dummy"
"218286",0,1,0,1,"dummy"
"218289",2,4,0,6,"dummy"
"218290",0,2,0,2,"dummy"
"218291",0,2,0,2,"dummy"
"218292",10,2,0,12,"dummy"
"218293",0,2,0,2,"dummy"
"218294",0,0,0,0,"dummy"
"218295",0,0,3,3,"dummy"
"218296",0,5,0,5,"dummy"
"218297",1,0,1,2,"dummy"
"218302",3,3,1,7,"dummy"
"218303",1,0,0,1,"dummy"
"218312",1,9,0,10,"dummy"
"218314",0,2,0,2,"dummy"
"218315",1,2,1,4,"dummy"
"218316",2,2,2,6,"dummy"
"218318",0,0,1,1,"dummy"
"218319",0,0,2,2,"dummy"
"218320",0,0,1,1,"dummy"
"218321",0,0,1,1,"dummy"
"218322",0,0,1,1,"dummy"
"218325",0,0,1,1,"dummy"
"218327",3,1,1,5,"dummy"
"218328",0,1,2,3,"dummy"
"218329",0,3,0,3,"dummy"
"218331",9,0,3,12,"dummy"
"218332",1,5,0,6,"dummy"
"218333",0,0,0,0,"dummy"
"218334",0,2,0,2,"dummy"
"218335",0,0,1,1,"dummy"
"218337",0,1,0,1,"dummy"
"218338",1,3,1,5,"dummy"
"218339",0,0,1,1,"dummy"
"218340",0,0,1,1,"dummy"
"218381",0,1,0,1,"dummy"
"218382",0,0,0,0,"dummy"
"218383",0,2,0,2,"dummy"
"218384",1,0,0,1,"dummy"
"218385",0,0,1,1,"dummy"
"218398",0,0,1,1,"dummy"
"218399",4,2,2,8,"dummy"
"218400",0,0,2,2,"dummy"
"218401",0,0,0,0,"dummy"
"218402",1,1,0,2,"dummy"
"218410",0,0,1,1,"dummy"
"218413",4,2,0,6,"dummy"
"218420",10,7,0,17,"dummy"
"218421",1,6,1,8,"dummy"
"218422",1,0,0,1,"dummy"
"218423",3,4,0,7,"dummy"
"218424",0,1,2,3,"dummy"
"218425",1,2,0,3,"dummy"
"218426",0,0,1,1,"dummy"
"218427",0,4,1,5,"dummy"
"218428",8,2,1,11,"dummy"
"218429",0,4,0,4,"dummy"
"218430",2,1,0,3,"dummy"
"218433",1,0,0,1,"dummy"
"218475",0,1,0,1,"dummy"
"218476",0,2,0,2,"dummy"
"218505",0,1,3,4,"dummy"
"218506",5,0,0,5,"dummy"
"218539",0,5,0,5,"dummy"
"218540",0,1,0,1,"dummy"
"218541",0,0,2,2,"dummy"
"218542",0,5,1,6,"dummy"
"218543",5,0,1,6,"dummy"
"218544",0,1,0,1,"dummy"
"218545",0,1,1,2,"dummy"
"218546",2,1,0,3,"dummy"
"218547",8,8,1,17,"dummy"
"218548",0,1,0,1,"dummy"
"218551",0,0,0,0,"dummy"
"218556",9,7,5,21,"dummy"
"218557",3,4,2,9,"dummy"
"218558",0,0,0,0,"dummy"
"218559",0,0,0,0,"dummy"
"218560",0,2,0,2,"dummy"
"218561",8,5,1,14,"dummy"
"218562",0,2,0,2,"dummy"
"218563",0,1,0,1,"dummy"
"218564",0,1,0,1,"dummy"
"218565",0,1,0,1,"dummy"
"218568",1,3,1,5,"dummy"
"218569",0,2,0,2,"dummy"
"218581",0,0,1,1,"dummy"
"218582",0,0,0,0,"dummy"
"218585",0,0,1,1,"dummy"
"218586",2,3,0,5,"dummy"
"218615",8,7,1,16,"dummy"
"218616",0,0,1,1,"dummy"
"218617",0,0,1,1,"dummy"
"218618",0,4,0,4,"dummy"
"218619",0,1,0,1,"dummy"
"218620",2,2,1,5,"dummy"
"218621",1,2,0,3,"dummy"
"218625",1,1,0,2,"dummy"
"218626",0,2,1,3,"dummy"
"218627",1,1,0,2,"dummy"
"218630",0,1,0,1,"dummy"
"218638",0,0,1,1,"dummy"
"218668",1,0,1,2,"dummy"
"218348",3,1,0,4,"dummy"
"218349",0,1,1,2,"dummy"
"218350",0,0,1,1,"dummy"
"218351",2,0,0,2,"dummy"
"218352",0,2,0,2,"dummy"
"218353",0,0,2,2,"dummy"
"218354",3,5,1,9,"dummy"
"218355",2,3,0,5,"dummy"
"218356",3,0,0,3,"dummy"
"218357",0,1,0,1,"dummy"
"218358",0,6,0,6,"dummy"
"218359",0,0,2,2,"dummy"
"218360",4,18,1,23,"dummy"
"218361",0,1,0,1,"dummy"
"218362",0,0,1,1,"dummy"
"218387",0,1,0,1,"dummy"
"218388",1,2,0,3,"dummy"
"218389",11,2,0,13,"dummy"
"218390",4,0,0,4,"dummy"
"218391",0,6,0,6,"dummy"
"218392",0,2,1,3,"dummy"
"218393",2,0,2,4,"dummy"
"218394",6,6,8,20,"dummy"
"218395",0,0,2,2,"dummy"
"218396",6,1,0,7,"dummy"
"218404",0,8,0,8,"dummy"
"218407",0,0,0,0,"dummy"
"218408",23,3,1,27,"dummy"
"218417",0,2,0,2,"dummy"
"218418",9,6,3,18,"dummy"
"218435",0,0,1,1,"dummy"
"218436",3,3,0,6,"dummy"
"218437",11,4,1,16,"dummy"
"218438",1,1,0,2,"dummy"
"218439",0,1,0,1,"dummy"
"218440",2,0,0,2,"dummy"
"218441",0,1,0,1,"dummy"
"218442",2,3,0,5,"dummy"
"218443",3,2,0,5,"dummy"
"218444",0,0,0,0,"dummy"
"218445",1,2,0,3,"dummy"
"218446",2,1,0,3,"dummy"
"218447",0,0,1,1,"dummy"
"218448",0,0,1,1,"dummy"
"218449",4,4,1,9,"dummy"
"218453",0,2,0,2,"dummy"
"218454",0,0,2,2,"dummy"
"218455",2,2,1,5,"dummy"
"218456",1,4,1,6,"dummy"
"218457",0,1,0,1,"dummy"
"218466",0,1,0,1,"dummy"
"218467",0,0,1,1,"dummy"
"218468",0,1,0,1,"dummy"
"218469",0,0,3,3,"dummy"
"218472",6,0,0,6,"dummy"
"218473",2,5,2,9,"dummy"
"218508",5,2,1,8,"dummy"
"218537",1,0,0,1,"dummy"
"218553",0,0,0,0,"dummy"
"218554",1,1,0,2,"dummy"
"218571",0,11,1,12,"dummy"
"218572",0,2,2,4,"dummy"
"218573",0,6,1,7,"dummy"
"218574",0,0,1,1,"dummy"
"218575",0,1,0,1,"dummy"
"218576",2,0,0,2,"dummy"
"218577",0,0,2,2,"dummy"
"218578",0,0,0,0,"dummy"
"218579",0,1,0,1,"dummy"
"218588",5,5,1,11,"dummy"
"218589",0,0,1,1,"dummy"
"218590",0,0,0,0,"dummy"
"218595",0,0,1,1,"dummy"
"218596",0,2,0,2,"dummy"
"218597",0,3,0,3,"dummy"
"218598",4,0,0,4,"dummy"
"218599",0,0,1,1,"dummy"
"218600",0,0,1,1,"dummy"
"218601",0,0,1,1,"dummy"
"218602",0,0,5,5,"dummy"
"218603",0,0,1,1,"dummy"
"218608",1,7,0,8,"dummy"
"218609",7,2,0,9,"dummy"
"218612",1,1,1,3,"dummy"
"218613",1,13,1,15,"dummy"
"218623",0,0,3,3,"dummy"
"218632",2,3,4,9,"dummy"
"218635",1,1,0,2,"dummy"
"218636",0,0,0,0,"dummy"
"218693",0,8,1,9,"dummy"
"218694",0,1,1,2,"dummy"
"218695",1,7,0,8,"dummy"
"218712",29,7,3,39,"dummy"
"218713",1,0,0,1,"dummy"
"218714",1,0,0,1,"dummy"
"218754",0,0,0,0,"dummy"
"218755",0,8,1,9,"dummy"
"218756",0,1,1,2,"dummy"
"218757",0,0,0,0,"dummy"
"218758",0,0,1,1,"dummy"
"218775",0,1,6,7,"dummy"
"218776",0,0,1,1,"dummy"
"218777",2,0,1,3,"dummy"
"218778",1,0,0,1,"dummy"
"218779",0,0,1,1,"dummy"
"218780",0,0,6,6,"dummy"
"218788",0,1,0,1,"dummy"
"218789",3,2,1,6,"dummy"
"218799",0,0,1,1,"dummy"
"218800",0,1,0,1,"dummy"
"218804",0,0,1,1,"dummy"
"218805",0,0,1,1,"dummy"
"218806",0,0,1,1,"dummy"
"218807",0,0,1,1,"dummy"
"218815",0,0,1,1,"dummy"
"218816",3,6,0,9,"dummy"
"218817",0,0,0,0,"dummy"
"218818",5,0,2,7,"dummy"
"218688",0,0,1,1,"dummy"
"218689",0,1,0,1,"dummy"
"218718",4,6,1,11,"dummy"
"218719",0,0,0,0,"dummy"
"218720",1,13,1,15,"dummy"
"218721",3,0,0,3,"dummy"
"218722",0,1,0,1,"dummy"
"218723",3,7,0,10,"dummy"
"218724",1,0,0,1,"dummy"
"218725",0,1,0,1,"dummy"
"218726",0,0,3,3,"dummy"
"218729",2,23,5,30,"dummy"
"218730",7,4,4,15,"dummy"
"218738",1,0,0,1,"dummy"
"218745",0,0,0,0,"dummy"
"218746",0,0,0,0,"dummy"
"218749",0,1,0,1,"dummy"
"218750",0,0,0,0,"dummy"
"218751",0,1,0,1,"dummy"
"218752",0,1,0,1,"dummy"
"218764",0,1,0,1,"dummy"
"218765",0,1,0,1,"dummy"
"218768",0,0,6,6,"dummy"
"218769",0,0,1,1,"dummy"
"218772",1,1,0,2,"dummy"
"218773",2,1,1,4,"dummy"
"218782",0,0,2,2,"dummy"
"218783",0,0,1,1,"dummy"
"218784",0,0,3,3,"dummy"
"218785",7,0,0,7,"dummy"
"218786",2,4,1,7,"dummy"
"218791",0,0,0,0,"dummy"
"218792",0,0,0,0,"dummy"
"218793",0,0,0,0,"dummy"
"218794",2,1,2,5,"dummy"
"218795",0,0,1,1,"dummy"
"218796",1,3,2,6,"dummy"
"218797",1,0,1,2,"dummy"
"218802",1,0,0,1,"dummy"
"218811",0,1,0,1,"dummy"
"218820",0,1,0,1,"dummy"
"218823",5,0,1,6,"dummy"
"218824",0,0,2,2,"dummy"
"218825",5,5,0,10,"dummy"
"218828",4,8,0,12,"dummy"
"218829",0,1,0,1,"dummy"
"218830",0,0,1,1,"dummy"
"218831",0,0,1,1,"dummy"
"218832",0,0,1,1,"dummy"
"218878",2,1,0,3,"dummy"
"218879",0,1,0,1,"dummy"
"218882",0,0,1,1,"dummy"
"218883",0,0,1,1,"dummy"
"218884",0,0,1,1,"dummy"
"218885",0,0,2,2,"dummy"
"218886",0,0,1,1,"dummy"
"218887",0,0,0,0,"dummy"
"218888",0,0,1,1,"dummy"
"218889",0,0,1,1,"dummy"
"218890",0,0,1,1,"dummy"
"218891",0,0,2,2,"dummy"
"218892",4,2,3,9,"dummy"
"218893",0,1,0,1,"dummy"
"218894",1,2,3,6,"dummy"
"218895",0,3,1,4,"dummy"
"218896",0,1,8,9,"dummy"
"218897",0,0,1,1,"dummy"
"218902",1,4,0,5,"dummy"
"218903",2,2,3,7,"dummy"
"218905",0,1,0,1,"dummy"
"218908",0,0,0,0,"dummy"
"218909",0,0,3,3,"dummy"
"218910",0,0,0,0,"dummy"
"218912",0,0,0,0,"dummy"
"218917",0,3,0,3,"dummy"
"218918",0,1,4,5,"dummy"
"218921",0,0,1,1,"dummy"
"218922",2,5,3,10,"dummy"
"218924",3,1,1,5,"dummy"
"218926",0,0,2,2,"dummy"
"218928",0,7,1,8,"dummy"
"218929",4,9,2,15,"dummy"
"218930",0,1,0,1,"dummy"
"218931",0,3,0,3,"dummy"
"218932",3,0,1,4,"dummy"
"218933",0,1,0,1,"dummy"
"218934",5,2,0,7,"dummy"
"218936",2,0,0,2,"dummy"
"218937",0,0,1,1,"dummy"
"218938",0,0,0,0,"dummy"
"218939",0,2,1,3,"dummy"
"218940",0,0,1,1,"dummy"
"218941",0,0,1,1,"dummy"
"218942",0,0,1,1,"dummy"
"218943",0,0,1,1,"dummy"
"218944",0,0,0,0,"dummy"
"218945",0,0,1,1,"dummy"
"218946",0,0,0,0,"dummy"
"218962",0,0,0,0,"dummy"
"218966",0,1,0,1,"dummy"
"218969",0,0,2,2,"dummy"
"218970",1,4,4,9,"dummy"
"218972",0,0,0,0,"dummy"
"218973",1,20,2,23,"dummy"
"218982",0,0,0,0,"dummy"
"218986",15,9,0,24,"dummy"
"218987",2,0,0,2,"dummy"
"218988",0,1,1,2,"dummy"
"218989",0,1,1,2,"dummy"
"218990",0,1,0,1,"dummy"
"218991",2,1,2,5,"dummy"
"218992",0,7,0,7,"dummy"
"218993",2,2,0,4,"dummy"
"218996",3,0,0,3,"dummy"
"218997",0,0,1,1,"dummy"
"218998",1,0,0,1,"dummy"
"218999",4,4,1,9,"dummy"
"219000",1,0,0,1,"dummy"
"219001",0,0,1,1,"dummy"
"219002",0,1,0,1,"dummy"
"219004",0,2,0,2,"dummy"
"219005",0,2,0,2,"dummy"
"219006",0,1,0,1,"dummy"
"219007",2,5,0,7,"dummy"
"219008",0,1,0,1,"dummy"
"219009",2,0,0,2,"dummy"
"219010",0,1,0,1,"dummy"
"219011",0,0,3,3,"dummy"
"219012",1,1,0,2,"dummy"
"219013",0,1,0,1,"dummy"
"219014",0,1,0,1,"dummy"
"219015",0,3,2,5,"dummy"
"219023",0,1,0,1,"dummy"
"219025",0,1,0,1,"dummy"
"219027",0,2,0,2,"dummy"
"219028",1,3,0,4,"dummy"
"219029",1,1,0,2,"dummy"
"219030",1,1,1,3,"dummy"
"219031",1,1,0,2,"dummy"
"219034",0,2,1,3,"dummy"
"219035",0,1,0,1,"dummy"
"219036",1,0,0,1,"dummy"
"219037",0,1,0,1,"dummy"
"219039",0,1,0,1,"dummy"
"219040",2,5,0,7,"dummy"
"219041",0,1,0,1,"dummy"
"219043",1,3,1,5,"dummy"
"219044",1,8,1,10,"dummy"
"219045",1,4,1,6,"dummy"
"219047",0,1,0,1,"dummy"
"219048",0,1,0,1,"dummy"
"219054",0,0,1,1,"dummy"
"219056",0,2,0,2,"dummy"
"219057",0,0,3,3,"dummy"
"219058",1,3,0,4,"dummy"
"219059",5,1,0,6,"dummy"
"219060",4,0,0,4,"dummy"
"219061",0,0,1,1,"dummy"
"219062",12,0,3,15,"dummy"
"219063",0,4,3,7,"dummy"
"219067",0,1,0,1,"dummy"
"219068",1,0,0,1,"dummy"
"219069",0,1,0,1,"dummy"
"219072",11,11,1,23,"dummy"
"219073",0,1,0,1,"dummy"
"219075",0,1,0,1,"dummy"
"219076",1,1,0,2,"dummy"
"219077",1,0,0,1,"dummy"
"219078",0,4,0,4,"dummy"
"219079",2,0,0,2,"dummy"
"219080",2,1,3,6,"dummy"
"219082",0,2,0,2,"dummy"
"219083",2,0,0,2,"dummy"
"219084",0,5,2,7,"dummy"
"219087",0,0,1,1,"dummy"
"219088",0,1,0,1,"dummy"
"219089",0,1,1,2,"dummy"
"219091",1,1,1,3,"dummy"
"219092",0,0,1,1,"dummy"
"219093",0,3,0,3,"dummy"
"219095",0,1,0,1,"dummy"
"219096",5,3,0,8,"dummy"
"219098",0,1,0,1,"dummy"
"219102",2,4,0,6,"dummy"
"219103",0,2,0,2,"dummy"
"219104",0,2,0,2,"dummy"
"219105",10,2,0,12,"dummy"
"219106",0,2,0,2,"dummy"
"219112",0,1,0,1,"dummy"
"219113",0,0,1,1,"dummy"
"219114",0,1,0,1,"dummy"
"219115",1,0,0,1,"dummy"
"219118",0,1,0,1,"dummy"
"219119",3,1,1,5,"dummy"
"219120",0,1,0,1,"dummy"
"219121",5,3,0,8,"dummy"
"219122",0,4,0,4,"dummy"
"219125",2,3,0,5,"dummy"
"219130",1,2,0,3,"dummy"
"219131",0,4,0,4,"dummy"
"219133",6,0,0,6,"dummy"
"219136",3,5,0,8,"dummy"
"219138",0,0,0,0,"dummy"
"219139",7,4,1,12,"dummy"
"219140",0,2,0,2,"dummy"
"219141",2,3,0,5,"dummy"
"219142",0,1,0,1,"dummy"
"219143",0,2,0,2,"dummy"
"219144",2,3,0,5,"dummy"
"219145",0,2,0,2,"dummy"
"219146",0,0,0,0,"dummy"
"219147",0,1,0,1,"dummy"
"219148",2,3,0,5,"dummy"
"219149",0,0,0,0,"dummy"
"219150",0,1,0,1,"dummy"
"219152",3,5,1,9,"dummy"
"219154",0,2,0,2,"dummy"
"219155",0,0,1,1,"dummy"
"219156",1,0,0,1,"dummy"
"219157",1,0,1,2,"dummy"
"219158",0,1,0,1,"dummy"
"219159",0,0,0,0,"dummy"
"219160",0,0,0,0,"dummy"
"219161",0,1,0,1,"dummy"
"219162",0,0,0,0,"dummy"
"219163",0,0,1,1,"dummy"
"219164",0,0,1,1,"dummy"
"219165",0,0,1,1,"dummy"
"219166",1,0,1,2,"dummy"
"219167",0,0,1,1,"dummy"
"219168",0,0,0,0,"dummy"
"219169",0,0,1,1,"dummy"
"219170",0,0,0,0,"dummy"
"219171",0,0,0,0,"dummy"
"219172",0,0,1,1,"dummy"
"219173",1,0,0,1,"dummy"
"219174",4,1,0,5,"dummy"
"219175",0,0,0,0,"dummy"
"219176",0,1,0,1,"dummy"
"219177",1,0,0,1,"dummy"
"219178",1,0,0,1,"dummy"
"219179",0,0,0,0,"dummy"
"219180",0,0,1,1,"dummy"
"219181",0,0,0,0,"dummy"
"219182",0,0,0,0,"dummy"
"219184",0,1,1,2,"dummy"
"219186",0,0,1,1,"dummy"
"219188",7,10,1,18,"dummy"
"219189",3,2,1,6,"dummy"
"219190",0,0,1,1,"dummy"
"219194",0,0,1,1,"dummy"
"219195",0,0,1,1,"dummy"
"219196",0,0,1,1,"dummy"
"219198",0,4,0,4,"dummy"
"219199",0,0,1,1,"dummy"
"219201",12,9,3,24,"dummy"
"219202",0,0,0,0,"dummy"
"219268",3,3,0,6,"dummy"
"219270",2,2,0,4,"dummy"
"219271",2,2,2,6,"dummy"
"219272",2,2,0,4,"dummy"
"219273",1,0,0,1,"dummy"
"219276",0,1,2,3,"dummy"
"219277",0,0,0,0,"dummy"
"219278",0,1,0,1,"dummy"
"219279",4,0,2,6,"dummy"
"219280",1,0,0,1,"dummy"
"219281",0,0,0,0,"dummy"
"219282",0,0,0,0,"dummy"
"219284",0,1,2,3,"dummy"
"219285",0,0,0,0,"dummy"
"219286",0,1,0,1,"dummy"
"219287",4,0,2,6,"dummy"
"219288",1,0,0,1,"dummy"
"219289",0,0,0,0,"dummy"
"219290",0,0,0,0,"dummy"
"219292",0,3,1,4,"dummy"
"219293",0,0,1,1,"dummy"
"219300",0,0,0,0,"dummy"
"219301",0,2,0,2,"dummy"
"219302",1,2,0,3,"dummy"
"219303",0,7,0,7,"dummy"
"219304",0,3,0,3,"dummy"
"219305",1,3,0,4,"dummy"
"219306",0,1,0,1,"dummy"
"219307",15,11,1,27,"dummy"
"219308",0,3,0,3,"dummy"
"219309",1,1,2,4,"dummy"
"219310",0,0,2,2,"dummy"
"219311",3,0,0,3,"dummy"
"219312",3,0,0,3,"dummy"
"219313",0,2,0,2,"dummy"
"219314",2,0,0,2,"dummy"
"219315",0,4,0,4,"dummy"
"219316",0,0,1,1,"dummy"
"219317",0,0,1,1,"dummy"
"219318",6,6,0,12,"dummy"
"219319",5,6,3,14,"dummy"
"219320",0,1,0,1,"dummy"
"219321",0,3,0,3,"dummy"
"219322",0,1,0,1,"dummy"
"219324",0,1,0,1,"dummy"
"219325",0,0,1,1,"dummy"
"219333",1,0,1,2,"dummy"
"219334",0,0,2,2,"dummy"
"219335",1,0,0,1,"dummy"
"219336",0,3,4,7,"dummy"
"219337",0,2,0,2,"dummy"
"219347",1,2,0,3,"dummy"
"219348",1,1,0,2,"dummy"
"219349",1,0,1,2,"dummy"
"219352",0,0,0,0,"dummy"
"219353",1,0,0,1,"dummy"
"219355",0,0,1,1,"dummy"
"219356",11,7,2,20,"dummy"
"219374",0,0,0,0,"dummy"
"219376",1,1,1,3,"dummy"
"219377",0,1,1,2,"dummy"
"219378",0,2,0,2,"dummy"
"219379",0,2,0,2,"dummy"
"219380",1,0,0,1,"dummy"
"219382",0,0,1,1,"dummy"
"219383",1,1,0,2,"dummy"
"219384",0,0,1,1,"dummy"
"219385",0,0,1,1,"dummy"
"219386",1,1,0,2,"dummy"
"219389",1,1,0,2,"dummy"
"219390",0,6,0,6,"dummy"
"219391",5,5,0,10,"dummy"
"219392",0,2,0,2,"dummy"
"219393",0,1,0,1,"dummy"
"219394",0,4,0,4,"dummy"
"219395",3,3,0,6,"dummy"
"219396",1,1,0,2,"dummy"
"219397",2,2,0,4,"dummy"
"219398",0,0,1,1,"dummy"
"219399",0,2,0,2,"dummy"
"219400",2,0,0,2,"dummy"
"219401",0,0,1,1,"dummy"
"219402",0,6,0,6,"dummy"
"219403",0,6,2,8,"dummy"
"219404",6,0,2,8,"dummy"
"219405",1,4,0,5,"dummy"
"219406",0,2,0,2,"dummy"
"219407",0,1,0,1,"dummy"
"219409",0,1,0,1,"dummy"
"219411",0,0,1,1,"dummy"
"219412",0,0,0,0,"dummy"
"219414",1,0,0,1,"dummy"
"219468",0,0,1,1,"dummy"
"219469",0,0,1,1,"dummy"
"219471",3,3,0,6,"dummy"
"219484",0,1,0,1,"dummy"
"219485",8,9,0,17,"dummy"
"219486",1,0,0,1,"dummy"
"219487",2,2,0,4,"dummy"
"219488",3,2,1,6,"dummy"
"219489",1,0,1,2,"dummy"
"219490",0,1,0,1,"dummy"
"219491",1,0,0,1,"dummy"
"219492",0,1,0,1,"dummy"
"219493",1,3,0,4,"dummy"
"219494",0,3,0,3,"dummy"
"219495",0,2,0,2,"dummy"
"219496",0,0,1,1,"dummy"
"219497",2,2,0,4,"dummy"
"219498",1,0,0,1,"dummy"
"219504",0,1,0,1,"dummy"
"219508",1,5,0,6,"dummy"
"219509",0,1,0,1,"dummy"
"219512",28,0,0,28,"dummy"
"219515",0,0,2,2,"dummy"
"219516",3,0,0,3,"dummy"
"219518",0,1,0,1,"dummy"
"219521",0,0,6,6,"dummy"
"219522",0,0,8,8,"dummy"
"219525",0,1,0,1,"dummy"
"219528",0,0,1,1,"dummy"
"219529",0,0,0,0,"dummy"
"219532",0,3,1,4,"dummy"
"219534",3,0,0,3,"dummy"
"219535",0,1,0,1,"dummy"
"219536",1,0,0,1,"dummy"
"219539",0,6,1,7,"dummy"
"219543",1,0,0,1,"dummy"
"219544",0,0,1,1,"dummy"
"219545",0,0,2,2,"dummy"
"219546",0,2,2,4,"dummy"
"219547",0,0,2,2,"dummy"
"219548",2,7,2,11,"dummy"
"219549",3,8,0,11,"dummy"
"219550",0,0,2,2,"dummy"
"219551",6,3,0,9,"dummy"
"219552",0,2,0,2,"dummy"
"219553",0,0,1,1,"dummy"
"219554",5,0,1,6,"dummy"
"219555",0,0,2,2,"dummy"
"219556",5,5,0,10,"dummy"
"219560",0,2,0,2,"dummy"
"219561",0,1,0,1,"dummy"
"219570",0,0,0,0,"dummy"
"219573",0,0,0,0,"dummy"
"219574",0,0,0,0,"dummy"
"219576",1,0,0,1,"dummy"
"219579",3,3,0,6,"dummy"
"219581",2,4,3,9,"dummy"
"219582",0,0,1,1,"dummy"
"219583",0,0,5,5,"dummy"
"219584",8,13,5,26,"dummy"
"219585",1,0,1,2,"dummy"
"219586",0,2,0,2,"dummy"
"219587",2,0,0,2,"dummy"
"219588",5,3,2,10,"dummy"
"219590",0,2,1,3,"dummy"
"219592",0,0,2,2,"dummy"
"219593",0,0,2,2,"dummy"
"219594",0,0,0,0,"dummy"
"219599",5,0,0,5,"dummy"
"219600",0,0,0,0,"dummy"
"219601",0,1,0,1,"dummy"
"219603",1,1,0,2,"dummy"
"219604",0,1,1,2,"dummy"
"219605",0,0,1,1,"dummy"
"219606",0,3,0,3,"dummy"
"219607",1,0,0,1,"dummy"
"219608",3,5,0,8,"dummy"
"219609",0,0,1,1,"dummy"
"219610",2,2,0,4,"dummy"
"219611",0,3,0,3,"dummy"
"219612",8,1,1,10,"dummy"
"219613",6,6,3,15,"dummy"
"219614",1,0,1,2,"dummy"
"219615",0,1,0,1,"dummy"
"219616",6,2,3,11,"dummy"
"219617",2,0,1,3,"dummy"
"219619",0,1,0,1,"dummy"
"219623",3,13,1,17,"dummy"
"219626",1,2,5,8,"dummy"
"219627",0,2,0,2,"dummy"
"219628",2,2,1,5,"dummy"
"219629",1,3,0,4,"dummy"
"219631",1,0,0,1,"dummy"
"219632",10,0,0,10,"dummy"
"219633",12,0,0,12,"dummy"
"219634",0,2,0,2,"dummy"
"219635",0,1,0,1,"dummy"
"219636",1,2,0,3,"dummy"
"219637",0,0,0,0,"dummy"
"219638",2,3,0,5,"dummy"
"219641",0,0,1,1,"dummy"
"219642",0,0,1,1,"dummy"
"219644",1,3,0,4,"dummy"
"219645",0,0,0,0,"dummy"
"219646",0,0,0,0,"dummy"
"219647",0,0,0,0,"dummy"
"219648",0,0,0,0,"dummy"
"219649",5,1,0,6,"dummy"
"219657",5,14,2,21,"dummy"
"219658",14,8,2,24,"dummy"
"219659",0,2,0,2,"dummy"
"219660",0,0,0,0,"dummy"
"219661",0,0,1,1,"dummy"
"219662",1,2,0,3,"dummy"
"219663",4,2,0,6,"dummy"
"219666",0,0,1,1,"dummy"
"219667",5,5,4,14,"dummy"
"219669",0,0,1,1,"dummy"
"219670",0,0,1,1,"dummy"
"219673",0,1,0,1,"dummy"
"219674",0,1,0,1,"dummy"
"219675",0,1,0,1,"dummy"
"219676",4,5,0,9,"dummy"
"219677",0,2,0,2,"dummy"
"219678",0,1,0,1,"dummy"
"219679",0,3,0,3,"dummy"
"219680",5,0,0,5,"dummy"
"219681",0,1,0,1,"dummy"
"219682",0,2,0,2,"dummy"
"219683",14,11,3,28,"dummy"
"219684",1,1,0,2,"dummy"
"219685",0,1,0,1,"dummy"
"219686",0,0,0,0,"dummy"
"219693",0,1,0,1,"dummy"
"219694",1,0,0,1,"dummy"
"219696",0,0,0,0,"dummy"
"219697",1,4,3,8,"dummy"
"219699",0,0,1,1,"dummy"
"219703",0,0,1,1,"dummy"
"219704",0,0,1,1,"dummy"
"219707",6,0,0,6,"dummy"
"219718",0,2,0,2,"dummy"
"219719",0,4,0,4,"dummy"
"219720",0,1,0,1,"dummy"
"219721",1,0,0,1,"dummy"
"219722",1,0,0,1,"dummy"
"219724",1,1,1,3,"dummy"
"219725",4,8,3,15,"dummy"
"219726",0,2,0,2,"dummy"
"219728",2,13,2,17,"dummy"
"219731",5,1,0,6,"dummy"
"219733",0,0,3,3,"dummy"
"219734",0,8,2,10,"dummy"
"219736",3,0,1,4,"dummy"
"219743",0,0,7,7,"dummy"
"219749",0,1,0,1,"dummy"
"219750",1,3,0,4,"dummy"
"219751",0,1,0,1,"dummy"
"219761",0,1,0,1,"dummy"
"219762",6,1,1,8,"dummy"
"219763",3,11,5,19,"dummy"
"219764",0,0,1,1,"dummy"
"219765",3,15,0,18,"dummy"
"219770",0,2,0,2,"dummy"
"219771",0,1,0,1,"dummy"
"219775",0,1,0,1,"dummy"
"219776",0,1,0,1,"dummy"
"219777",0,4,0,4,"dummy"
"219779",0,2,1,3,"dummy"
"219780",1,2,0,3,"dummy"
"219782",0,3,1,4,"dummy"
"219783",0,1,1,2,"dummy"
"219784",1,7,1,9,"dummy"
"219785",2,3,0,5,"dummy"
"219786",3,3,0,6,"dummy"
"219787",8,0,0,8,"dummy"
"219788",0,0,1,1,"dummy"
"219790",2,1,0,3,"dummy"
"219793",0,1,0,1,"dummy"
"219794",0,0,1,1,"dummy"
"219795",0,1,5,6,"dummy"
"219796",0,0,1,1,"dummy"
"219797",1,0,1,2,"dummy"
"219798",0,0,1,1,"dummy"
"219800",1,1,1,3,"dummy"
"219801",4,0,0,4,"dummy"
"219802",0,0,0,0,"dummy"
"219803",0,1,0,1,"dummy"
"219804",0,0,0,0,"dummy"
"219805",0,0,0,0,"dummy"
"219806",7,0,1,8,"dummy"
"219807",0,0,0,0,"dummy"
"219808",0,4,0,4,"dummy"
"219811",0,1,0,1,"dummy"
"219812",2,3,0,5,"dummy"
"219813",3,3,0,6,"dummy"
"219814",0,2,0,2,"dummy"
"219815",0,2,0,2,"dummy"
"219817",0,1,0,1,"dummy"
"219818",0,1,0,1,"dummy"
"219820",0,0,0,0,"dummy"
"219824",0,0,1,1,"dummy"
"219825",2,2,0,4,"dummy"
"219827",0,0,1,1,"dummy"
"219828",0,2,0,2,"dummy"
"219834",5,17,1,23,"dummy"
"219835",2,2,0,4,"dummy"
"219836",8,11,1,20,"dummy"
"219837",1,2,2,5,"dummy"
"219838",0,1,0,1,"dummy"
"219840",0,1,0,1,"dummy"
"219842",0,0,0,0,"dummy"
"219844",0,1,1,2,"dummy"
"219845",0,1,0,1,"dummy"
"219846",8,8,0,16,"dummy"
"219847",2,4,0,6,"dummy"
"219848",0,3,0,3,"dummy"
"219862",1,2,0,3,"dummy"
"219863",4,2,0,6,"dummy"
"219864",3,6,0,9,"dummy"
"219865",0,0,1,1,"dummy"
"219866",0,0,1,1,"dummy"
"219867",1,0,1,2,"dummy"
"219868",2,2,4,8,"dummy"
"219869",2,8,1,11,"dummy"
"219877",1,2,1,4,"dummy"
"219878",0,1,0,1,"dummy"
"219879",0,3,0,3,"dummy"
"219880",0,1,0,1,"dummy"
"219881",0,0,1,1,"dummy"
"219882",1,0,0,1,"dummy"
"219883",0,1,0,1,"dummy"
"219884",0,0,1,1,"dummy"
"219885",1,0,0,1,"dummy"
"219886",1,0,1,2,"dummy"
"219887",0,0,0,0,"dummy"
"219888",0,1,0,1,"dummy"
"219891",0,0,2,2,"dummy"
"219892",0,0,2,2,"dummy"
"219893",2,2,3,7,"dummy"
"219894",0,0,1,1,"dummy"
"219895",0,2,0,2,"dummy"
"219896",0,2,0,2,"dummy"
"219897",5,9,3,17,"dummy"
"219898",0,1,0,1,"dummy"
"219899",1,4,1,6,"dummy"
"219900",0,4,0,4,"dummy"
"219901",0,1,0,1,"dummy"
"219924",0,3,1,4,"dummy"
"219925",0,1,0,1,"dummy"
"219926",0,1,0,1,"dummy"
"219927",1,4,0,5,"dummy"
"219928",0,0,1,1,"dummy"
"219929",0,0,0,0,"dummy"
"219930",3,0,0,3,"dummy"
"219931",0,0,3,3,"dummy"
"219932",0,1,0,1,"dummy"
"219933",0,1,0,1,"dummy"
"219943",0,0,1,1,"dummy"
"219944",0,1,0,1,"dummy"
"219945",1,4,0,5,"dummy"
"219946",5,9,3,17,"dummy"
"219955",0,0,0,0,"dummy"
"219956",0,0,0,0,"dummy"
"219957",0,1,0,1,"dummy"
"219960",0,0,0,0,"dummy"
"219968",0,0,1,1,"dummy"
"219969",0,17,1,18,"dummy"
"219970",17,0,0,17,"dummy"
"219973",4,0,0,4,"dummy"
"219979",0,0,1,1,"dummy"
"219980",2,0,2,4,"dummy"
"219988",0,1,0,1,"dummy"
"219994",0,0,2,2,"dummy"
"219998",0,0,0,0,"dummy"
"219999",0,0,1,1,"dummy"
"220000",0,0,3,3,"dummy"
"220007",17,12,2,31,"dummy"
"220008",1,0,0,1,"dummy"
"220009",0,0,5,5,"dummy"
"220010",2,0,0,2,"dummy"
"220011",4,3,5,12,"dummy"
"220012",2,2,4,8,"dummy"
"220013",0,1,0,1,"dummy"
"220025",1,0,2,3,"dummy"
"220026",0,0,2,2,"dummy"
"220027",3,4,0,7,"dummy"
"220028",0,3,0,3,"dummy"
"220029",2,2,1,5,"dummy"
"220030",0,0,1,1,"dummy"
"220031",0,0,1,1,"dummy"
"220032",0,0,2,2,"dummy"
"220033",0,0,1,1,"dummy"
"220034",23,10,1,34,"dummy"
"220035",0,22,1,23,"dummy"
"220036",0,0,1,1,"dummy"
"220037",0,0,2,2,"dummy"
"220038",17,2,0,19,"dummy"
"220039",0,0,0,0,"dummy"
"220044",0,4,0,4,"dummy"
"220045",1,2,0,3,"dummy"
"220046",0,1,0,1,"dummy"
"220047",0,1,0,1,"dummy"
"219872",0,0,1,1,"dummy"
"219873",5,1,3,9,"dummy"
"219903",1,3,2,6,"dummy"
"219904",0,1,0,1,"dummy"
"219905",0,0,3,3,"dummy"
"219906",0,0,2,2,"dummy"
"219909",0,1,0,1,"dummy"
"219912",0,28,2,30,"dummy"
"219913",28,3,4,35,"dummy"
"219914",0,0,1,1,"dummy"
"219915",0,0,0,0,"dummy"
"219916",0,0,1,1,"dummy"
"219917",1,1,0,2,"dummy"
"219922",0,2,3,5,"dummy"
"219939",2,0,0,2,"dummy"
"219940",0,3,3,6,"dummy"
"219941",1,1,1,3,"dummy"
"219948",3,1,0,4,"dummy"
"219949",7,10,1,18,"dummy"
"219950",3,0,0,3,"dummy"
"219953",14,2,2,18,"dummy"
"219962",2,0,1,3,"dummy"
"219963",0,0,1,1,"dummy"
"219966",0,7,0,7,"dummy"
"219975",0,0,2,2,"dummy"
"219986",3,2,1,6,"dummy"
"219990",1,0,0,1,"dummy"
"219996",0,0,2,2,"dummy"
"220002",0,0,0,0,"dummy"
"220003",0,0,1,1,"dummy"
"220004",0,0,0,0,"dummy"
"220005",0,0,1,1,"dummy"
"220015",3,4,1,8,"dummy"
"220016",0,3,0,3,"dummy"
"220017",3,6,0,9,"dummy"
"220018",5,2,0,7,"dummy"
"220019",0,1,0,1,"dummy"
"220020",0,0,2,2,"dummy"
"220021",0,1,0,1,"dummy"
"220022",2,2,0,4,"dummy"
"220023",0,0,1,1,"dummy"
"220041",10,0,0,10,"dummy"
"220042",2,1,0,3,"dummy"
"220049",0,1,0,1,"dummy"
"220050",0,1,0,1,"dummy"
"220051",1,0,0,1,"dummy"
"220052",2,2,1,5,"dummy"
"220053",1,0,0,1,"dummy"
"220054",0,1,0,1,"dummy"
"220068",0,3,1,4,"dummy"
"220069",0,1,0,1,"dummy"
"220070",0,11,0,11,"dummy"
"220073",1,4,0,5,"dummy"
"220091",1,0,0,1,"dummy"
"220096",2,7,2,11,"dummy"
"220097",11,19,1,31,"dummy"
"220110",1,1,0,2,"dummy"
"220111",3,4,1,8,"dummy"
"220112",0,0,1,1,"dummy"
"220113",0,1,0,1,"dummy"
"220114",1,0,0,1,"dummy"
"220115",0,1,0,1,"dummy"
"220116",2,2,1,5,"dummy"
"220117",0,1,0,1,"dummy"
"220118",0,0,4,4,"dummy"
"220126",0,2,0,2,"dummy"
"220084",3,3,0,6,"dummy"
"220085",0,3,1,4,"dummy"
"220086",0,0,0,0,"dummy"
"220087",1,0,1,2,"dummy"
"220122",0,1,0,1,"dummy"
"220123",2,0,0,2,"dummy"
"220124",0,0,1,1,"dummy"
"220130",3,9,0,12,"dummy"
"220131",0,11,0,11,"dummy"
"220154",1,8,0,9,"dummy"
"220159",0,0,1,1,"dummy"
"220162",0,0,1,1,"dummy"
"220165",0,1,0,1,"dummy"
"220166",17,0,0,17,"dummy"
"220167",0,1,0,1,"dummy"
"220171",0,2,1,3,"dummy"
"220172",2,10,1,13,"dummy"
"220173",0,0,1,1,"dummy"
"220174",1,1,0,2,"dummy"
"220175",0,0,1,1,"dummy"
"220179",0,0,1,1,"dummy"
"220180",0,0,1,1,"dummy"
"220181",0,0,1,1,"dummy"
"220182",0,0,0,0,"dummy"
"220183",0,1,0,1,"dummy"
"220184",0,0,1,1,"dummy"
"220185",0,1,1,2,"dummy"
"220186",0,0,1,1,"dummy"
"220187",0,0,1,1,"dummy"
"220188",0,0,1,1,"dummy"
"220149",1,5,4,10,"dummy"
"220150",0,3,0,3,"dummy"
"220151",0,1,0,1,"dummy"
"220152",0,0,1,1,"dummy"
"220169",0,0,1,1,"dummy"
"220177",0,0,1,1,"dummy"
"220192",0,2,1,3,"dummy"
"220193",0,3,0,3,"dummy"
"220195",0,0,1,1,"dummy"
"220196",0,0,1,1,"dummy"
"220197",0,0,1,1,"dummy"
"220202",6,8,1,15,"dummy"
"220204",0,0,1,1,"dummy"
"220206",0,1,0,1,"dummy"
"220208",0,1,0,1,"dummy"
"220210",1,5,3,9,"dummy"
"220214",0,0,1,1,"dummy"
"220215",3,1,0,4,"dummy"
"220216",0,1,2,3,"dummy"
"220218",0,0,1,1,"dummy"
"220220",0,25,1,26,"dummy"
"220221",3,4,0,7,"dummy"
"220222",10,0,0,10,"dummy"
"220224",2,5,0,7,"dummy"
"220225",0,1,0,1,"dummy"
"220227",2,4,0,6,"dummy"
"220228",0,2,0,2,"dummy"
"220229",0,2,0,2,"dummy"
"220230",10,2,0,12,"dummy"
"220231",0,2,0,2,"dummy"
"220232",0,0,0,0,"dummy"
"220240",2,0,0,2,"dummy"
"220241",0,0,0,0,"dummy"
"220256",8,17,1,26,"dummy"
"220257",14,3,5,22,"dummy"
"220258",1,1,6,8,"dummy"
"220259",0,1,1,2,"dummy"
"220262",0,0,1,1,"dummy"
"220263",0,0,1,1,"dummy"
"220264",0,3,0,3,"dummy"
"220265",0,1,3,4,"dummy"
"220266",8,8,0,16,"dummy"
"220267",5,0,1,6,"dummy"
"220268",1,0,0,1,"dummy"
"220269",0,0,1,1,"dummy"
"220270",0,0,1,1,"dummy"
"220271",2,2,0,4,"dummy"
"220272",0,1,0,1,"dummy"
"220273",0,13,5,18,"dummy"
"220274",0,1,0,1,"dummy"
"220275",0,0,2,2,"dummy"
"220276",0,0,2,2,"dummy"
"220277",0,0,2,2,"dummy"
"220278",1,2,0,3,"dummy"
"220279",1,1,0,2,"dummy"
"220280",0,0,1,1,"dummy"
"220284",9,13,8,30,"dummy"
"220285",7,0,0,7,"dummy"
"220286",0,0,3,3,"dummy"
"220290",0,0,1,1,"dummy"
"220292",8,0,0,8,"dummy"
"220293",0,0,1,1,"dummy"
"220294",0,3,0,3,"dummy"
"220295",1,1,0,2,"dummy"
"220296",0,14,0,14,"dummy"
"220297",0,3,0,3,"dummy"
"220299",0,0,3,3,"dummy"
"220310",0,1,0,1,"dummy"
"220311",2,0,0,2,"dummy"
"220312",0,2,0,2,"dummy"
"220313",0,4,0,4,"dummy"
"220314",0,0,1,1,"dummy"
"220315",0,0,1,1,"dummy"
"220316",0,0,1,1,"dummy"
"220317",0,0,1,1,"dummy"
"220318",0,2,0,2,"dummy"
"220320",0,8,0,8,"dummy"
"220321",0,1,0,1,"dummy"
"220322",0,11,0,11,"dummy"
"220323",0,2,0,2,"dummy"
"220324",0,1,0,1,"dummy"
"220325",1,4,1,6,"dummy"
"220326",0,2,1,3,"dummy"
"220327",0,1,0,1,"dummy"
"220328",0,8,0,8,"dummy"
"220329",0,0,1,1,"dummy"
"220331",0,2,1,3,"dummy"
"220333",5,2,2,9,"dummy"
"220334",1,0,0,1,"dummy"
"220335",0,0,1,1,"dummy"
"220336",0,0,1,1,"dummy"
"220338",2,0,0,2,"dummy"
"220339",0,1,0,1,"dummy"
"220340",1,0,0,1,"dummy"
"220342",0,0,1,1,"dummy"
"220343",0,0,1,1,"dummy"
"220344",0,1,0,1,"dummy"
"220345",0,0,1,1,"dummy"
"220346",1,2,0,3,"dummy"
"220347",0,1,0,1,"dummy"
"220348",1,1,0,2,"dummy"
"220349",1,1,0,2,"dummy"
"220351",0,0,1,1,"dummy"
"220352",0,0,1,1,"dummy"
"220354",0,0,1,1,"dummy"
"220355",0,1,0,1,"dummy"
"220357",10,5,0,15,"dummy"
"220374",0,1,0,1,"dummy"
"220379",0,0,1,1,"dummy"
"220380",0,0,1,1,"dummy"
"220381",0,1,0,1,"dummy"
"220382",2,2,1,5,"dummy"
"220383",0,2,0,2,"dummy"
"220384",0,1,0,1,"dummy"
"220385",0,10,0,10,"dummy"
"220386",22,11,1,34,"dummy"
"220387",11,24,1,36,"dummy"
"220388",0,11,0,11,"dummy"
"220389",0,0,0,0,"dummy"
"220390",16,3,1,20,"dummy"
"220391",3,16,1,20,"dummy"
"220393",1,2,2,5,"dummy"
"220395",2,0,3,5,"dummy"
"220401",0,0,1,1,"dummy"
"220402",0,0,0,0,"dummy"
"220404",0,5,0,5,"dummy"
"220405",0,0,1,1,"dummy"
"220406",0,0,1,1,"dummy"
"220407",0,0,1,1,"dummy"
"220408",0,1,0,1,"dummy"
"220409",0,0,1,1,"dummy"
"220413",4,9,4,17,"dummy"
"220414",1,0,0,1,"dummy"
"220416",0,0,1,1,"dummy"
"220418",2,2,1,5,"dummy"
"220420",0,0,1,1,"dummy"
"220421",14,0,4,18,"dummy"
"220422",0,0,3,3,"dummy"
"220423",0,0,1,1,"dummy"
"220424",0,5,0,5,"dummy"
"220428",0,0,1,1,"dummy"
"220444",0,4,0,4,"dummy"
"220445",6,3,0,9,"dummy"
"220446",0,0,2,2,"dummy"
"220447",0,0,1,1,"dummy"
"220449",0,1,0,1,"dummy"
"220451",0,2,0,2,"dummy"
"220452",2,0,0,2,"dummy"
"220454",0,0,0,0,"dummy"
"220461",2,4,1,7,"dummy"
"220462",0,3,0,3,"dummy"
"220463",0,2,0,2,"dummy"
"220468",0,0,1,1,"dummy"
"220469",0,0,1,1,"dummy"
"220470",0,0,1,1,"dummy"
"220471",0,0,2,2,"dummy"
"220472",0,0,1,1,"dummy"
"220473",0,2,0,2,"dummy"
"220474",0,0,1,1,"dummy"
"220487",0,0,0,0,"dummy"
"220488",9,26,5,40,"dummy"
"220489",29,9,3,41,"dummy"
"220490",0,0,0,0,"dummy"
"220491",0,0,0,0,"dummy"
"220492",0,2,0,2,"dummy"
"220493",2,2,0,4,"dummy"
"220494",0,1,0,1,"dummy"
"220495",0,1,0,1,"dummy"
"220496",0,1,0,1,"dummy"
"220497",0,1,0,1,"dummy"
"220498",1,0,0,1,"dummy"
"220499",0,0,0,0,"dummy"
"220500",1,3,0,4,"dummy"
"220501",7,12,2,21,"dummy"
"220502",3,4,1,8,"dummy"
"220503",0,2,0,2,"dummy"
"220504",1,0,0,1,"dummy"
"220505",0,0,2,2,"dummy"
"220506",0,0,1,1,"dummy"
"220507",2,1,1,4,"dummy"
"220508",6,6,3,15,"dummy"
"220509",2,5,0,7,"dummy"
"220510",1,0,0,1,"dummy"
"220511",0,0,0,0,"dummy"
"220512",0,0,1,1,"dummy"
"220513",0,0,1,1,"dummy"
"220514",10,0,2,12,"dummy"
"220515",1,0,1,2,"dummy"
"220516",0,1,0,1,"dummy"
"220517",2,2,0,4,"dummy"
"220518",6,20,2,28,"dummy"
"220519",0,0,3,3,"dummy"
"220520",20,6,2,28,"dummy"
"220521",0,0,1,1,"dummy"
"220522",0,1,0,1,"dummy"
"220523",2,3,0,5,"dummy"
"220524",13,39,3,55,"dummy"
"220525",0,1,0,1,"dummy"
"220526",2,4,1,7,"dummy"
"220527",27,11,2,40,"dummy"
"220528",0,3,0,3,"dummy"
"220529",1,0,0,1,"dummy"
"220530",0,1,0,1,"dummy"
"220534",2,5,0,7,"dummy"
"220535",0,3,0,3,"dummy"
"220536",1,0,3,4,"dummy"
"220537",0,0,0,0,"dummy"
"220538",0,6,0,6,"dummy"
"220539",2,0,0,2,"dummy"
"220540",1,13,2,16,"dummy"
"220541",15,9,0,24,"dummy"
"220542",1,1,0,2,"dummy"
"220543",1,1,0,2,"dummy"
"220545",0,2,0,2,"dummy"
"220546",1,8,0,9,"dummy"
"220547",2,1,1,4,"dummy"
"220548",0,1,0,1,"dummy"
"220549",5,3,0,8,"dummy"
"220550",0,3,0,3,"dummy"
"220551",1,0,0,1,"dummy"
"220552",2,2,1,5,"dummy"
"220555",2,0,2,4,"dummy"
"220568",5,7,1,13,"dummy"
"220569",1,4,4,9,"dummy"
"220570",0,2,0,2,"dummy"
"220571",0,2,0,2,"dummy"
"220572",4,0,0,4,"dummy"
"220573",12,7,3,22,"dummy"
"220574",0,0,1,1,"dummy"
"220575",3,6,0,9,"dummy"
"220608",0,2,1,3,"dummy"
"220609",0,1,0,1,"dummy"
"220610",0,1,0,1,"dummy"
"220611",0,0,1,1,"dummy"
"220616",0,0,0,0,"dummy"
"220617",0,0,0,0,"dummy"
"220620",0,0,4,4,"dummy"
"220621",0,0,4,4,"dummy"
"220622",0,0,1,1,"dummy"
"220623",0,0,4,4,"dummy"
"220697",0,4,0,4,"dummy"
"220698",0,0,1,1,"dummy"
"220699",0,1,1,2,"dummy"
"220700",0,1,0,1,"dummy"
"220701",3,0,3,6,"dummy"
"220702",2,2,1,5,"dummy"
"220703",0,1,0,1,"dummy"
"220704",0,1,0,1,"dummy"
"220705",1,1,0,2,"dummy"
"220728",0,5,0,5,"dummy"
"220732",1,0,0,1,"dummy"
"220733",0,0,2,2,"dummy"
"220734",0,1,1,2,"dummy"
"220735",0,0,2,2,"dummy"
"220736",2,1,0,3,"dummy"
"220737",0,8,1,9,"dummy"
"220738",0,2,1,3,"dummy"
"220739",2,5,0,7,"dummy"
"220740",0,0,1,1,"dummy"
"220741",1,0,0,1,"dummy"
"220742",0,1,0,1,"dummy"
"220743",4,2,0,6,"dummy"
"220744",0,1,2,3,"dummy"
"220745",1,2,0,3,"dummy"
"220746",0,1,1,2,"dummy"
"220750",0,7,2,9,"dummy"
"220751",0,0,1,1,"dummy"
"220754",0,2,0,2,"dummy"
"220760",0,0,1,1,"dummy"
"220761",0,0,1,1,"dummy"
"220762",0,2,1,3,"dummy"
"220763",2,3,0,5,"dummy"
"220764",3,5,4,12,"dummy"
"220767",0,3,0,3,"dummy"
"220768",0,0,1,1,"dummy"
"220787",0,0,1,1,"dummy"
"220788",0,1,0,1,"dummy"
"220789",2,0,1,3,"dummy"
"220790",0,0,1,1,"dummy"
"220791",0,0,1,1,"dummy"
"220792",0,0,3,3,"dummy"
"220793",0,0,1,1,"dummy"
"220799",0,1,0,1,"dummy"
"220800",4,15,4,23,"dummy"
"220801",0,0,1,1,"dummy"
"220811",1,0,1,2,"dummy"
"220812",0,0,1,1,"dummy"
"220813",0,0,1,1,"dummy"
"220814",1,1,0,2,"dummy"
"220815",0,1,0,1,"dummy"
"220557",0,2,0,2,"dummy"
"220558",0,0,0,0,"dummy"
"220559",1,2,1,4,"dummy"
"220560",0,0,0,0,"dummy"
"220561",0,1,0,1,"dummy"
"220562",0,3,0,3,"dummy"
"220563",0,1,0,1,"dummy"
"220566",1,5,3,9,"dummy"
"220577",0,0,0,0,"dummy"
"220578",0,0,0,0,"dummy"
"220584",2,14,3,19,"dummy"
"220587",0,8,0,8,"dummy"
"220590",0,1,0,1,"dummy"
"220591",0,0,1,1,"dummy"
"220592",0,2,0,2,"dummy"
"220593",1,3,1,5,"dummy"
"220594",0,1,0,1,"dummy"
"220595",0,1,0,1,"dummy"
"220596",3,4,0,7,"dummy"
"220597",0,0,1,1,"dummy"
"220602",0,1,0,1,"dummy"
"220603",0,4,0,4,"dummy"
"220604",3,0,0,3,"dummy"
"220625",0,3,0,3,"dummy"
"220658",0,2,0,2,"dummy"
"220659",0,1,2,3,"dummy"
"220660",0,13,0,13,"dummy"
"220661",0,0,1,1,"dummy"
"220662",0,0,1,1,"dummy"
"220663",8,0,0,8,"dummy"
"220664",0,4,0,4,"dummy"
"220665",1,0,0,1,"dummy"
"220666",0,3,0,3,"dummy"
"220667",1,2,1,4,"dummy"
"220668",0,0,0,0,"dummy"
"220669",1,4,0,5,"dummy"
"220670",5,11,0,16,"dummy"
"220671",11,0,0,11,"dummy"
"220724",0,1,0,1,"dummy"
"220730",1,9,1,11,"dummy"
"220748",0,0,2,2,"dummy"
"220756",0,0,1,1,"dummy"
"220757",0,0,1,1,"dummy"
"220758",0,0,1,1,"dummy"
"220785",0,1,1,2,"dummy"
"220797",0,1,0,1,"dummy"
"220820",0,4,0,4,"dummy"
"220830",6,6,1,13,"dummy"
"220859",3,0,2,5,"dummy"
"220816",5,13,0,18,"dummy"
"220817",0,1,0,1,"dummy"
"220818",0,1,0,1,"dummy"
"220832",0,0,0,0,"dummy"
"220833",2,2,0,4,"dummy"
"220834",2,2,0,4,"dummy"
"220835",0,0,0,0,"dummy"
"220836",5,5,1,11,"dummy"
"220837",5,0,0,5,"dummy"
"220838",0,0,1,1,"dummy"
"220839",0,0,1,1,"dummy"
"220840",0,2,2,4,"dummy"
"220845",0,0,0,0,"dummy"
"220846",8,6,2,16,"dummy"
"220863",0,2,0,2,"dummy"
"220864",0,4,0,4,"dummy"
"220865",21,9,0,30,"dummy"
"220866",0,2,0,2,"dummy"
"220867",0,1,0,1,"dummy"
"220899",4,3,0,7,"dummy"
"220906",1,0,0,1,"dummy"
"220907",0,0,3,3,"dummy"
"220908",0,1,0,1,"dummy"
"220909",7,0,1,8,"dummy"
"220921",7,5,0,12,"dummy"
"220924",0,1,1,2,"dummy"
"220925",0,0,0,0,"dummy"
"220926",0,3,0,3,"dummy"
"220927",0,2,0,2,"dummy"
"220928",0,1,0,1,"dummy"
"220929",0,0,1,1,"dummy"
"220930",6,2,1,9,"dummy"
"220931",0,1,0,1,"dummy"
"220932",6,6,0,12,"dummy"
"220933",0,0,0,0,"dummy"
"220934",2,2,0,4,"dummy"
"220935",6,6,0,12,"dummy"
"220936",1,0,2,3,"dummy"
"220937",0,1,0,1,"dummy"
"220938",1,0,2,3,"dummy"
"220939",0,1,0,1,"dummy"
"220940",2,3,1,6,"dummy"
"220941",0,0,1,1,"dummy"
"220942",1,0,0,1,"dummy"
"220943",0,2,0,2,"dummy"
"220970",0,4,0,4,"dummy"
"220971",0,0,1,1,"dummy"
"220972",4,2,1,7,"dummy"
"220973",0,5,5,10,"dummy"
"220974",4,0,0,4,"dummy"
"220975",0,8,0,8,"dummy"
"220976",0,4,0,4,"dummy"
"220977",0,3,0,3,"dummy"
"220978",0,1,0,1,"dummy"
"220979",0,2,0,2,"dummy"
"221051",0,11,2,13,"dummy"
"221052",0,0,1,1,"dummy"
"221061",2,0,3,5,"dummy"
"221062",1,2,0,3,"dummy"
"221082",0,1,3,4,"dummy"
"221088",1,1,1,3,"dummy"
"221097",0,0,2,2,"dummy"
"221098",0,0,1,1,"dummy"
"221099",0,0,1,1,"dummy"
"221100",0,0,1,1,"dummy"
"220901",2,3,0,5,"dummy"
"220902",1,0,0,1,"dummy"
"220903",0,0,1,1,"dummy"
"220904",0,1,0,1,"dummy"
"220913",1,1,0,2,"dummy"
"220914",0,0,1,1,"dummy"
"220915",0,3,0,3,"dummy"
"220916",1,8,2,11,"dummy"
"220917",0,1,1,2,"dummy"
"220918",1,0,1,2,"dummy"
"220919",2,0,0,2,"dummy"
"220945",0,0,1,1,"dummy"
"220946",30,1,2,33,"dummy"
"220947",1,0,0,1,"dummy"
"220952",13,4,1,18,"dummy"
"220966",0,0,1,1,"dummy"
"220967",2,2,0,4,"dummy"
"220968",0,1,0,1,"dummy"
"220990",3,3,2,8,"dummy"
"220991",6,2,0,8,"dummy"
"220992",2,0,0,2,"dummy"
"220993",0,2,0,2,"dummy"
"221017",0,1,0,1,"dummy"
"221018",0,1,0,1,"dummy"
"221019",0,0,0,0,"dummy"
"221022",4,14,4,22,"dummy"
"221036",8,0,0,8,"dummy"
"221037",15,6,3,24,"dummy"
"221040",9,1,5,15,"dummy"
"221045",0,7,0,7,"dummy"
"221046",1,0,0,1,"dummy"
"221049",0,0,1,1,"dummy"
"221054",0,5,0,5,"dummy"
"221055",0,0,1,1,"dummy"
"221056",0,0,1,1,"dummy"
"221057",6,1,0,7,"dummy"
"221058",2,2,0,4,"dummy"
"221059",0,0,1,1,"dummy"
"221064",3,9,4,16,"dummy"
"221069",2,19,1,22,"dummy"
"221070",0,0,0,0,"dummy"
"221071",0,0,1,1,"dummy"
"221072",0,1,0,1,"dummy"
"221073",2,6,0,8,"dummy"
"221074",4,3,0,7,"dummy"
"221075",0,0,1,1,"dummy"
"221076",1,0,0,1,"dummy"
"221077",0,0,0,0,"dummy"
"221080",0,1,1,2,"dummy"
"221086",1,0,0,1,"dummy"
"221090",0,0,0,0,"dummy"
"221093",0,10,0,10,"dummy"
"221094",11,1,0,12,"dummy"
"221095",0,2,0,2,"dummy"
"221105",0,2,0,2,"dummy"
"221130",1,0,0,1,"dummy"
"221131",1,2,0,3,"dummy"
"221132",1,0,0,1,"dummy"
"221146",0,1,0,1,"dummy"
"221147",0,8,0,8,"dummy"
"221148",2,6,1,9,"dummy"
"221101",0,0,1,1,"dummy"
"221102",0,0,1,1,"dummy"
"221103",0,0,1,1,"dummy"
"221134",2,0,1,3,"dummy"
"221135",1,1,1,3,"dummy"
"221138",0,0,1,1,"dummy"
"221139",0,1,0,1,"dummy"
"221142",0,0,0,0,"dummy"
"221150",1,1,0,2,"dummy"
"221151",0,0,0,0,"dummy"
"221152",0,2,0,2,"dummy"
"221235",0,1,0,1,"dummy"
"221261",0,0,1,1,"dummy"
"221262",0,0,1,1,"dummy"
"221263",0,0,2,2,"dummy"
"221264",0,0,1,1,"dummy"
"221265",2,0,0,2,"dummy"
"221266",0,0,1,1,"dummy"
"221267",0,0,1,1,"dummy"
"221268",0,0,1,1,"dummy"
"221269",0,1,0,1,"dummy"
"221270",0,2,0,2,"dummy"
"221271",0,2,0,2,"dummy"
"221272",0,1,0,1,"dummy"
"221273",0,2,0,2,"dummy"
"221274",2,2,0,4,"dummy"
"221275",0,2,0,2,"dummy"
"221276",2,2,0,4,"dummy"
"221277",2,2,0,4,"dummy"
"221278",2,2,0,4,"dummy"
"221279",4,1,0,5,"dummy"
"221280",1,0,0,1,"dummy"
"221281",0,2,0,2,"dummy"
"221282",0,0,0,0,"dummy"
"221283",0,0,0,0,"dummy"
"221284",0,0,0,0,"dummy"
"221285",4,0,0,4,"dummy"
"221290",0,1,0,1,"dummy"
"221291",1,2,0,3,"dummy"
"221292",0,2,0,2,"dummy"
"221293",0,1,0,1,"dummy"
"221294",0,2,0,2,"dummy"
"221299",0,0,1,1,"dummy"
"221300",0,5,0,5,"dummy"
"221301",0,0,1,1,"dummy"
"221302",0,1,0,1,"dummy"
"221303",0,0,1,1,"dummy"
"221304",0,1,0,1,"dummy"
"221305",8,0,3,11,"dummy"
"221306",0,3,1,4,"dummy"
"221313",0,2,0,2,"dummy"
"221314",2,0,0,2,"dummy"
"221315",0,0,1,1,"dummy"
"221324",0,0,1,1,"dummy"
"221325",0,0,4,4,"dummy"
"221326",0,0,1,1,"dummy"
"221363",0,4,0,4,"dummy"
"221364",0,0,1,1,"dummy"
"221365",0,1,1,2,"dummy"
"221366",0,1,0,1,"dummy"
"221367",3,0,3,6,"dummy"
"221368",0,0,0,0,"dummy"
"221369",0,1,0,1,"dummy"
"221154",0,1,0,1,"dummy"
"221155",0,0,1,1,"dummy"
"221156",0,0,1,1,"dummy"
"221166",14,4,0,18,"dummy"
"221167",6,0,1,7,"dummy"
"221168",0,0,0,0,"dummy"
"221169",0,0,0,0,"dummy"
"221170",0,0,1,1,"dummy"
"221171",0,0,1,1,"dummy"
"221172",1,1,1,3,"dummy"
"221173",0,1,0,1,"dummy"
"221174",0,0,1,1,"dummy"
"221175",0,3,1,4,"dummy"
"221176",3,0,0,3,"dummy"
"221177",1,0,0,1,"dummy"
"221178",2,0,0,2,"dummy"
"221179",0,1,3,4,"dummy"
"221180",4,0,0,4,"dummy"
"221181",0,0,0,0,"dummy"
"221182",0,1,0,1,"dummy"
"221183",0,7,0,7,"dummy"
"221186",1,1,0,2,"dummy"
"221187",0,1,1,2,"dummy"
"221188",0,0,1,1,"dummy"
"221189",0,2,0,2,"dummy"
"221192",0,1,0,1,"dummy"
"221193",0,3,0,3,"dummy"
"221194",2,0,0,2,"dummy"
"221197",0,0,1,1,"dummy"
"221198",0,0,0,0,"dummy"
"221199",0,11,0,11,"dummy"
"221200",24,11,0,35,"dummy"
"221201",0,1,0,1,"dummy"
"221202",0,1,0,1,"dummy"
"221203",0,0,1,1,"dummy"
"221204",0,0,1,1,"dummy"
"221205",3,0,0,3,"dummy"
"221206",2,1,0,3,"dummy"
"221207",0,0,1,1,"dummy"
"221208",0,0,5,5,"dummy"
"221227",1,0,0,1,"dummy"
"221228",5,3,1,9,"dummy"
"221229",0,0,2,2,"dummy"
"221230",0,1,0,1,"dummy"
"221231",0,12,1,13,"dummy"
"221232",0,3,0,3,"dummy"
"221233",0,1,0,1,"dummy"
"221237",1,0,0,1,"dummy"
"221238",0,2,1,3,"dummy"
"221252",0,2,0,2,"dummy"
"221253",3,0,0,3,"dummy"
"221254",0,1,0,1,"dummy"
"221255",0,2,0,2,"dummy"
"221256",1,0,1,2,"dummy"
"221259",2,0,2,4,"dummy"
"221310",0,13,0,13,"dummy"
"221311",0,0,1,1,"dummy"
"221358",0,0,0,0,"dummy"
"221359",0,0,0,0,"dummy"
"221360",0,0,0,0,"dummy"
"221361",0,0,0,0,"dummy"
"221372",1,2,2,5,"dummy"
"221373",0,0,0,0,"dummy"
"221374",0,0,0,0,"dummy"
"221377",0,0,0,0,"dummy"
"221378",0,1,0,1,"dummy"
"221379",0,0,2,2,"dummy"
"221380",0,0,1,1,"dummy"
"221398",0,0,2,2,"dummy"
"221399",0,0,1,1,"dummy"
"221405",0,0,1,1,"dummy"
"221408",0,0,0,0,"dummy"
"221423",3,3,0,6,"dummy"
"221424",10,0,4,14,"dummy"
"221425",6,0,0,6,"dummy"
"221426",0,1,0,1,"dummy"
"221370",1,1,0,2,"dummy"
"221382",0,3,0,3,"dummy"
"221386",11,0,4,15,"dummy"
"221394",0,0,1,1,"dummy"
"221395",0,1,0,1,"dummy"
"221396",0,0,2,2,"dummy"
"221401",0,0,1,1,"dummy"
"221417",0,0,1,1,"dummy"
"221418",0,0,2,2,"dummy"
"221419",0,4,0,4,"dummy"
"221420",5,5,7,17,"dummy"
"221421",0,0,1,1,"dummy"
"221433",1,0,2,3,"dummy"
"221434",0,0,0,0,"dummy"
"221427",2,8,1,11,"dummy"
"221428",0,1,0,1,"dummy"
"221429",0,1,0,1,"dummy"
"221430",5,11,0,16,"dummy"
"221431",1,0,0,1,"dummy"
"221436",1,0,0,1,"dummy"
"221437",0,0,1,1,"dummy"
"221438",0,0,1,1,"dummy"
"221439",0,0,1,1,"dummy"
"221482",0,0,3,3,"dummy"
"221483",0,1,0,1,"dummy"
"221487",5,7,0,12,"dummy"
"221488",2,4,0,6,"dummy"
"221490",0,0,1,1,"dummy"
"221491",0,0,1,1,"dummy"
"221492",0,0,1,1,"dummy"
"221493",0,0,1,1,"dummy"
"221494",0,0,1,1,"dummy"
"221495",0,0,1,1,"dummy"
"221496",0,0,1,1,"dummy"
"221497",0,0,1,1,"dummy"
"221498",0,0,1,1,"dummy"
"221499",0,0,1,1,"dummy"
"221500",0,0,1,1,"dummy"
"221501",0,0,1,1,"dummy"
"221502",0,0,1,1,"dummy"
"221503",0,0,1,1,"dummy"
"221504",0,0,1,1,"dummy"
"221506",0,9,0,9,"dummy"
"221507",0,0,0,0,"dummy"
"221508",5,3,4,12,"dummy"
"221510",0,2,0,2,"dummy"
"221511",0,0,1,1,"dummy"
"221513",0,0,3,3,"dummy"
"221514",0,0,0,0,"dummy"
"221515",0,4,0,4,"dummy"
"221516",0,1,0,1,"dummy"
"221517",0,0,2,2,"dummy"
"221519",0,1,0,1,"dummy"
"221520",0,0,0,0,"dummy"
"221521",0,0,0,0,"dummy"
"221523",0,0,1,1,"dummy"
"221525",0,3,0,3,"dummy"
"221527",0,1,0,1,"dummy"
"221529",0,0,1,1,"dummy"
"221530",3,2,1,6,"dummy"
"221531",2,5,1,8,"dummy"
"221538",0,9,0,9,"dummy"
"221539",0,1,0,1,"dummy"
"221540",0,1,0,1,"dummy"
"221545",0,0,1,1,"dummy"
"221550",1,0,0,1,"dummy"
"221551",0,1,3,4,"dummy"
"221553",0,1,0,1,"dummy"
"221554",17,0,0,17,"dummy"
"221555",0,1,0,1,"dummy"
"221567",0,6,0,6,"dummy"
"221568",0,0,1,1,"dummy"
"221573",4,8,0,12,"dummy"
"221574",0,3,0,3,"dummy"
"221578",0,0,1,1,"dummy"
"221580",0,0,1,1,"dummy"
"221585",0,0,2,2,"dummy"
"221586",0,0,2,2,"dummy"
"221587",0,0,2,2,"dummy"
"221588",0,0,2,2,"dummy"
"221589",2,2,2,6,"dummy"
"221596",1,2,0,3,"dummy"
"221597",1,1,0,2,"dummy"
"221598",3,5,0,8,"dummy"
"221600",0,0,1,1,"dummy"
"221601",1,0,2,3,"dummy"
"221602",0,0,1,1,"dummy"
"221603",0,0,1,1,"dummy"
"221605",0,0,2,2,"dummy"
"221606",0,0,2,2,"dummy"
"221607",0,2,0,2,"dummy"
"221612",0,0,0,0,"dummy"
"221613",0,1,0,1,"dummy"
"221614",0,0,1,1,"dummy"
"221618",0,0,1,1,"dummy"
"221619",0,0,1,1,"dummy"
"221620",0,0,1,1,"dummy"
"221624",0,3,1,4,"dummy"
"221625",0,1,0,1,"dummy"
"221626",0,0,1,1,"dummy"
"221627",0,0,1,1,"dummy"
"221629",0,0,1,1,"dummy"
"221632",0,1,0,1,"dummy"
"221634",3,0,0,3,"dummy"
"221635",3,1,0,4,"dummy"
"221637",0,0,2,2,"dummy"
"221639",0,0,3,3,"dummy"
"221641",0,2,0,2,"dummy"
"221642",0,1,0,1,"dummy"
"221644",0,2,0,2,"dummy"
"221650",6,0,1,7,"dummy"
"221651",0,6,1,7,"dummy"
"221653",1,10,0,11,"dummy"
"221654",9,18,4,31,"dummy"
"221657",0,0,2,2,"dummy"
"221658",0,0,2,2,"dummy"
"221660",0,1,0,1,"dummy"
"221663",0,0,1,1,"dummy"
"221664",0,1,0,1,"dummy"
"221665",0,2,0,2,"dummy"
"221666",0,0,0,0,"dummy"
"221667",0,1,0,1,"dummy"
"221668",1,1,2,4,"dummy"
"221669",0,0,1,1,"dummy"
"221671",1,7,0,8,"dummy"
"221672",3,6,0,9,"dummy"
"221673",0,1,0,1,"dummy"
"221674",0,2,0,2,"dummy"
"221675",0,2,1,3,"dummy"
"221676",0,1,0,1,"dummy"
"221677",1,0,0,1,"dummy"
"221678",0,1,0,1,"dummy"
"221680",0,3,0,3,"dummy"
"221681",4,4,0,8,"dummy"
"221682",4,6,0,10,"dummy"
"221683",1,2,0,3,"dummy"
"221684",0,1,0,1,"dummy"
"221685",1,0,1,2,"dummy"
"221686",3,3,0,6,"dummy"
"221687",0,1,0,1,"dummy"
"221688",0,0,0,0,"dummy"
"221689",0,2,0,2,"dummy"
"221690",1,1,1,3,"dummy"
"221691",0,4,0,4,"dummy"
"221692",0,0,3,3,"dummy"
"221693",0,3,3,6,"dummy"
"221694",3,0,3,6,"dummy"
"221695",0,0,3,3,"dummy"
"221698",0,0,1,1,"dummy"
"221699",0,0,1,1,"dummy"
"221700",0,0,1,1,"dummy"
"221702",4,1,0,5,"dummy"
"221703",0,1,0,1,"dummy"
"221704",3,0,2,5,"dummy"
"221705",0,2,0,2,"dummy"
"221706",0,1,0,1,"dummy"
"221707",0,0,1,1,"dummy"
"221708",3,6,0,9,"dummy"
"221709",1,1,0,2,"dummy"
"221710",1,0,0,1,"dummy"
"221711",0,0,0,0,"dummy"
"221712",0,0,0,0,"dummy"
"221713",0,0,1,1,"dummy"
"221714",0,2,0,2,"dummy"
"221715",0,3,0,3,"dummy"
"221716",0,0,1,1,"dummy"
"221717",1,9,0,10,"dummy"
"221718",2,8,4,14,"dummy"
"221725",0,3,0,3,"dummy"
"221726",0,1,1,2,"dummy"
"221727",0,2,5,7,"dummy"
"221728",0,0,3,3,"dummy"
"221729",0,0,1,1,"dummy"
"221730",0,1,0,1,"dummy"
"221731",0,0,1,1,"dummy"
"221732",0,0,1,1,"dummy"
"221733",0,0,1,1,"dummy"
"221734",4,0,1,5,"dummy"
"221735",1,1,0,2,"dummy"
"221736",1,1,0,2,"dummy"
"221737",0,1,0,1,"dummy"
"221738",0,1,0,1,"dummy"
"221739",8,6,7,21,"dummy"
"221740",0,2,0,2,"dummy"
"221741",0,0,1,1,"dummy"
"221742",0,0,3,3,"dummy"
"221743",0,0,1,1,"dummy"
"221744",0,0,3,3,"dummy"
"221745",0,2,0,2,"dummy"
"221746",1,0,0,1,"dummy"
"221747",0,4,1,5,"dummy"
"221748",0,9,0,9,"dummy"
"221749",1,7,1,9,"dummy"
"221750",0,0,1,1,"dummy"
"221751",0,3,1,4,"dummy"
"221752",0,0,1,1,"dummy"
"221755",0,0,0,0,"dummy"
"221756",1,0,1,2,"dummy"
"221757",0,3,0,3,"dummy"
"221758",0,0,1,1,"dummy"
"221759",2,2,0,4,"dummy"
"221761",0,0,0,0,"dummy"
"221764",0,3,2,5,"dummy"
"221765",3,0,0,3,"dummy"
"221766",0,1,0,1,"dummy"
"221767",2,3,1,6,"dummy"
"221770",2,4,0,6,"dummy"
"221771",0,2,0,2,"dummy"
"221772",0,2,0,2,"dummy"
"221773",10,2,0,12,"dummy"
"221774",0,2,0,2,"dummy"
"221775",0,0,0,0,"dummy"
"221776",0,0,3,3,"dummy"
"221777",0,5,0,5,"dummy"
"221778",1,0,1,2,"dummy"
"221780",0,0,1,1,"dummy"
"221781",0,1,0,1,"dummy"
"221782",9,5,1,15,"dummy"
"221783",2,7,0,9,"dummy"
"221785",1,2,0,3,"dummy"
"221788",0,0,1,1,"dummy"
"221791",2,2,0,4,"dummy"
"221792",0,1,0,1,"dummy"
"221794",0,1,0,1,"dummy"
"221795",0,1,0,1,"dummy"
"221796",1,0,3,4,"dummy"
"221797",0,0,2,2,"dummy"
"221798",5,21,2,28,"dummy"
"221799",9,7,0,16,"dummy"
"221800",7,2,6,15,"dummy"
"221801",0,4,2,6,"dummy"
"221802",0,1,0,1,"dummy"
"221803",0,2,1,3,"dummy"
"221804",0,5,0,5,"dummy"
"221805",0,0,2,2,"dummy"
"221806",0,0,2,2,"dummy"
"221807",0,0,1,1,"dummy"
"221808",0,0,2,2,"dummy"
"221809",1,0,1,2,"dummy"
"221810",0,0,2,2,"dummy"
"221811",0,0,4,4,"dummy"
"221818",2,1,1,4,"dummy"
"221819",0,0,2,2,"dummy"
"221820",3,1,0,4,"dummy"
"221831",2,2,0,4,"dummy"
"221832",0,0,1,1,"dummy"
"221836",0,2,0,2,"dummy"
"221837",0,22,1,23,"dummy"
"221838",0,0,0,0,"dummy"
"221839",3,3,0,6,"dummy"
"221841",0,2,0,2,"dummy"
"221842",3,1,1,5,"dummy"
"221843",1,3,1,5,"dummy"
"221845",0,0,1,1,"dummy"
"221848",0,1,1,2,"dummy"
"221849",0,1,3,4,"dummy"
"221850",0,2,2,4,"dummy"
"221852",3,3,1,7,"dummy"
"221862",0,6,3,9,"dummy"
"221863",1,2,1,4,"dummy"
"221864",0,2,0,2,"dummy"
"221866",1,3,0,4,"dummy"
"221888",0,1,0,1,"dummy"
"221891",3,9,0,12,"dummy"
"221892",10,1,0,11,"dummy"
"221893",3,0,2,5,"dummy"
"221894",0,4,1,5,"dummy"
"221895",0,1,0,1,"dummy"
"221921",0,0,1,1,"dummy"
"221922",0,0,2,2,"dummy"
"221923",4,2,3,9,"dummy"
"221924",4,6,0,10,"dummy"
"221925",0,0,0,0,"dummy"
"221926",4,4,0,8,"dummy"
"221927",2,7,3,12,"dummy"
"221928",0,1,0,1,"dummy"
"221929",0,0,1,1,"dummy"
"221932",1,7,5,13,"dummy"
"221933",0,11,0,11,"dummy"
"221934",0,17,1,18,"dummy"
"221935",0,5,1,6,"dummy"
"221936",0,0,2,2,"dummy"
"221937",1,2,7,10,"dummy"
"221938",1,1,2,4,"dummy"
"221939",0,1,2,3,"dummy"
"221940",0,1,2,3,"dummy"
"221941",0,10,0,10,"dummy"
"221942",0,0,2,2,"dummy"
"221943",0,0,4,4,"dummy"
"221944",0,12,0,12,"dummy"
"221945",0,0,4,4,"dummy"
"221946",0,0,4,4,"dummy"
"221947",0,0,4,4,"dummy"
"221948",0,1,0,1,"dummy"
"221949",0,0,4,4,"dummy"
"221950",0,0,4,4,"dummy"
"221951",0,0,2,2,"dummy"
"221952",3,5,2,10,"dummy"
"221953",0,1,1,2,"dummy"
"221954",1,0,5,6,"dummy"
"221955",0,1,1,2,"dummy"
"221956",0,0,2,2,"dummy"
"221957",0,0,4,4,"dummy"
"221958",14,19,8,41,"dummy"
"221959",0,0,1,1,"dummy"
"221960",0,0,1,1,"dummy"
"221963",1,2,0,3,"dummy"
"221964",2,4,2,8,"dummy"
"221965",4,3,1,8,"dummy"
"221966",0,0,1,1,"dummy"
"221967",2,3,0,5,"dummy"
"221968",0,0,2,2,"dummy"
"221969",0,0,1,1,"dummy"
"221970",2,3,2,7,"dummy"
"221972",8,9,0,17,"dummy"
"221973",0,2,0,2,"dummy"
"221974",0,1,0,1,"dummy"
"221975",2,2,0,4,"dummy"
"221976",0,1,0,1,"dummy"
"221977",1,1,0,2,"dummy"
"221978",0,1,0,1,"dummy"
"221983",0,2,2,4,"dummy"
"221985",2,1,0,3,"dummy"
"221986",0,3,0,3,"dummy"
"221987",0,0,0,0,"dummy"
"221988",3,5,2,10,"dummy"
"221991",0,0,0,0,"dummy"
"221992",1,2,3,6,"dummy"
"222023",3,0,0,3,"dummy"
"222052",0,5,0,5,"dummy"
"222053",0,3,0,3,"dummy"
"222054",0,2,0,2,"dummy"
"222055",0,2,0,2,"dummy"
"222056",0,0,0,0,"dummy"
"222057",0,1,0,1,"dummy"
"222058",0,1,0,1,"dummy"
"222059",1,0,3,4,"dummy"
"222060",3,0,0,3,"dummy"
"222062",2,2,0,4,"dummy"
"222063",0,0,0,0,"dummy"
"222065",4,0,0,4,"dummy"
"222066",0,0,1,1,"dummy"
"222067",0,0,1,1,"dummy"
"222069",0,0,1,1,"dummy"
"222071",0,0,0,0,"dummy"
"222072",0,1,0,1,"dummy"
"222073",0,0,0,0,"dummy"
"222075",0,1,0,1,"dummy"
"222076",0,10,0,10,"dummy"
"222077",9,2,2,13,"dummy"
"222078",0,1,0,1,"dummy"
"222079",0,1,0,1,"dummy"
"222083",6,0,0,6,"dummy"
"222084",4,9,0,13,"dummy"
"222087",1,4,3,8,"dummy"
"222088",0,0,1,1,"dummy"
"222089",0,0,1,1,"dummy"
"222092",0,0,1,1,"dummy"
"222097",0,1,0,1,"dummy"
"222098",1,0,1,2,"dummy"
"222167",0,1,0,1,"dummy"
"222168",0,3,0,3,"dummy"
"222169",0,1,0,1,"dummy"
"222171",0,0,0,0,"dummy"
"222173",0,1,0,1,"dummy"
"222174",0,0,2,2,"dummy"
"222175",0,0,1,1,"dummy"
"222176",2,0,0,2,"dummy"
"222177",0,1,2,3,"dummy"
"222178",1,4,1,6,"dummy"
"222179",0,0,1,1,"dummy"
"222180",0,1,0,1,"dummy"
"222182",1,3,0,4,"dummy"
"222183",0,0,1,1,"dummy"
"222184",0,0,1,1,"dummy"
"222187",1,0,0,1,"dummy"
"222188",0,1,0,1,"dummy"
"222189",0,2,0,2,"dummy"
"222190",0,1,0,1,"dummy"
"222191",0,1,0,1,"dummy"
"222192",1,14,0,15,"dummy"
"222193",0,1,1,2,"dummy"
"222194",1,5,0,6,"dummy"
"222195",1,0,0,1,"dummy"
"222196",4,1,0,5,"dummy"
"222198",0,0,1,1,"dummy"
"222199",5,6,6,17,"dummy"
"222212",3,1,0,4,"dummy"
"222215",0,5,1,6,"dummy"
"222216",1,1,0,2,"dummy"
"222217",1,1,0,2,"dummy"
"222218",0,2,0,2,"dummy"
"222219",1,1,0,2,"dummy"
"222220",0,0,1,1,"dummy"
"222221",1,1,0,2,"dummy"
"222222",0,0,1,1,"dummy"
"222223",0,1,0,1,"dummy"
"222225",0,0,0,0,"dummy"
"222228",2,2,0,4,"dummy"
"222229",4,0,1,5,"dummy"
"222230",0,4,1,5,"dummy"
"222231",4,0,0,4,"dummy"
"222232",0,0,0,0,"dummy"
"222233",5,10,0,15,"dummy"
"222234",0,0,1,1,"dummy"
"222235",0,1,1,2,"dummy"
"222236",0,0,1,1,"dummy"
"222237",0,0,1,1,"dummy"
"222238",0,0,1,1,"dummy"
"222239",0,0,1,1,"dummy"
"222240",11,2,4,17,"dummy"
"222241",0,0,0,0,"dummy"
"222243",2,4,0,6,"dummy"
"222244",0,2,0,2,"dummy"
"222245",0,2,0,2,"dummy"
"222246",10,2,0,12,"dummy"
"222247",0,2,0,2,"dummy"
"222248",0,0,0,0,"dummy"
"222249",0,0,3,3,"dummy"
"222252",4,0,0,4,"dummy"
"222253",5,5,0,10,"dummy"
"222254",10,8,0,18,"dummy"
"222255",8,5,1,14,"dummy"
"222256",0,0,0,0,"dummy"
"222259",1,0,0,1,"dummy"
"222260",0,0,1,1,"dummy"
"222263",0,4,0,4,"dummy"
"222264",1,0,0,1,"dummy"
"222265",2,2,0,4,"dummy"
"222266",0,4,0,4,"dummy"
"222267",4,0,0,4,"dummy"
"222268",0,1,0,1,"dummy"
"222269",0,2,0,2,"dummy"
"222270",0,0,0,0,"dummy"
"222271",0,6,0,6,"dummy"
"222272",1,0,0,1,"dummy"
"222273",0,3,0,3,"dummy"
"222274",2,1,0,3,"dummy"
"222275",0,0,0,0,"dummy"
"222276",0,1,0,1,"dummy"
"222277",0,7,0,7,"dummy"
"222278",7,2,1,10,"dummy"
"222279",2,1,0,3,"dummy"
"222280",0,3,0,3,"dummy"
"222281",1,2,0,3,"dummy"
"222293",0,0,0,0,"dummy"
"222295",0,0,1,1,"dummy"
"222299",0,0,0,0,"dummy"
"222300",0,0,0,0,"dummy"
"222304",1,0,0,1,"dummy"
"222305",7,0,0,7,"dummy"
"222308",0,2,0,2,"dummy"
"222309",0,1,0,1,"dummy"
"222312",0,5,0,5,"dummy"
"222313",0,0,5,5,"dummy"
"222314",0,2,0,2,"dummy"
"222317",0,1,0,1,"dummy"
"222318",0,1,0,1,"dummy"
"222319",5,3,0,8,"dummy"
"222320",0,2,0,2,"dummy"
"222321",0,1,0,1,"dummy"
"222322",0,0,0,0,"dummy"
"222324",0,3,0,3,"dummy"
"222325",0,1,0,1,"dummy"
"222326",1,1,0,2,"dummy"
"222327",0,1,0,1,"dummy"
"222328",0,1,0,1,"dummy"
"222329",0,2,0,2,"dummy"
"222330",0,0,0,0,"dummy"
"222331",0,0,0,0,"dummy"
"222332",0,0,2,2,"dummy"
"222333",5,1,0,6,"dummy"
"222334",1,0,0,1,"dummy"
"222335",0,0,0,0,"dummy"
"222336",0,0,0,0,"dummy"
"222337",2,0,0,2,"dummy"
"222349",0,0,0,0,"dummy"
"222350",0,0,0,0,"dummy"
"222351",0,0,0,0,"dummy"
"222352",0,0,0,0,"dummy"
"222353",0,0,0,0,"dummy"
"222354",0,0,0,0,"dummy"
"222355",0,0,0,0,"dummy"
"222356",0,0,0,0,"dummy"
"222357",0,0,0,0,"dummy"
"222358",0,0,0,0,"dummy"
"222359",0,0,0,0,"dummy"
"222360",0,0,0,0,"dummy"
"222361",0,0,0,0,"dummy"
"222362",0,0,0,0,"dummy"
"222363",0,0,0,0,"dummy"
"222364",0,0,0,0,"dummy"
"222365",0,0,0,0,"dummy"
"222366",0,0,0,0,"dummy"
"222367",0,0,0,0,"dummy"
"222368",0,0,0,0,"dummy"
"222369",0,0,0,0,"dummy"
"222370",0,0,0,0,"dummy"
"222371",0,0,0,0,"dummy"
"222372",0,0,0,0,"dummy"
"222373",0,0,0,0,"dummy"
"222374",0,0,0,0,"dummy"
"222375",0,0,0,0,"dummy"
"222376",0,0,0,0,"dummy"
"222377",0,0,0,0,"dummy"
"222378",0,1,0,1,"dummy"
"222379",0,0,0,0,"dummy"
"222380",0,0,1,1,"dummy"
"222381",1,0,0,1,"dummy"
"222382",0,1,0,1,"dummy"
"222383",0,0,0,0,"dummy"
"222384",0,0,1,1,"dummy"
"222385",0,0,1,1,"dummy"
"222386",1,0,0,1,"dummy"
"222387",0,1,0,1,"dummy"
"222388",1,0,0,1,"dummy"
"222389",0,1,0,1,"dummy"
"222390",0,0,1,1,"dummy"
"222391",1,0,0,1,"dummy"
"222392",0,1,0,1,"dummy"
"222393",0,0,1,1,"dummy"
"222394",1,0,0,1,"dummy"
"222395",0,0,0,0,"dummy"
"222396",0,1,0,1,"dummy"
"222397",0,0,0,0,"dummy"
"222398",0,0,1,1,"dummy"
"222399",0,0,1,1,"dummy"
"222400",0,0,1,1,"dummy"
"222401",1,0,0,1,"dummy"
"222402",0,0,0,0,"dummy"
"222403",0,0,0,0,"dummy"
"222404",0,1,0,1,"dummy"
"222405",0,0,1,1,"dummy"
"222406",0,0,1,1,"dummy"
"222407",0,0,1,1,"dummy"
"222408",0,0,1,1,"dummy"
"222409",0,0,1,1,"dummy"
"222410",0,0,1,1,"dummy"
"222411",0,0,1,1,"dummy"
"222412",0,1,0,1,"dummy"
"222413",2,0,0,2,"dummy"
"222414",0,1,0,1,"dummy"
"222415",0,0,1,1,"dummy"
"222416",0,0,1,1,"dummy"
"222417",0,0,1,1,"dummy"
"222418",0,0,1,1,"dummy"
"222419",0,0,1,1,"dummy"
"222420",0,0,1,1,"dummy"
"222421",0,0,1,1,"dummy"
"222422",0,0,1,1,"dummy"
"222423",0,0,1,1,"dummy"
"222424",0,0,1,1,"dummy"
"222425",0,0,1,1,"dummy"
"222426",0,0,1,1,"dummy"
"222427",0,0,1,1,"dummy"
"222428",0,0,1,1,"dummy"
"222429",0,0,1,1,"dummy"
"222430",0,0,1,1,"dummy"
"222431",0,0,1,1,"dummy"
"222432",0,0,1,1,"dummy"
"222433",0,0,1,1,"dummy"
"222434",0,0,1,1,"dummy"
"222435",0,0,1,1,"dummy"
"222436",0,0,1,1,"dummy"
"222437",0,0,1,1,"dummy"
"222438",0,0,1,1,"dummy"
"222439",0,0,1,1,"dummy"
"222440",0,0,1,1,"dummy"
"222441",0,0,1,1,"dummy"
"222442",0,0,1,1,"dummy"
"222443",0,0,1,1,"dummy"
"222444",0,0,1,1,"dummy"
"222445",0,0,1,1,"dummy"
"222446",0,0,1,1,"dummy"
"222447",0,0,1,1,"dummy"
"222448",0,0,1,1,"dummy"
"222450",0,0,1,1,"dummy"
"222451",0,2,0,2,"dummy"
"222452",0,1,1,2,"dummy"
"222455",0,1,1,2,"dummy"
"222456",1,1,0,2,"dummy"
"222467",0,4,0,4,"dummy"
"222468",0,4,0,4,"dummy"
"222474",0,1,0,1,"dummy"
"222475",0,8,3,11,"dummy"
"222476",0,3,0,3,"dummy"
"222477",0,2,0,2,"dummy"
"222478",1,1,1,3,"dummy"
"222488",0,0,1,1,"dummy"
"222489",0,0,1,1,"dummy"
"222491",2,5,2,9,"dummy"
"222493",0,0,1,1,"dummy"
"222494",0,0,1,1,"dummy"
"222495",0,0,1,1,"dummy"
"222497",1,0,1,2,"dummy"
"222498",0,0,1,1,"dummy"
"222518",0,15,0,15,"dummy"
"222521",0,0,0,0,"dummy"
"222522",0,0,0,0,"dummy"
"222523",0,0,0,0,"dummy"
"222524",0,0,0,0,"dummy"
"222525",0,0,0,0,"dummy"
"222526",0,0,0,0,"dummy"
"222527",0,0,0,0,"dummy"
"222528",0,0,0,0,"dummy"
"222529",0,0,0,0,"dummy"
"222531",0,0,2,2,"dummy"
"222532",1,3,0,4,"dummy"
"222533",0,1,0,1,"dummy"
"222534",0,0,1,1,"dummy"
"222535",0,0,1,1,"dummy"
"222536",0,0,1,1,"dummy"
"222537",2,3,1,6,"dummy"
"222538",0,1,0,1,"dummy"
"222539",0,0,1,1,"dummy"
"222541",0,0,5,5,"dummy"
"222543",0,6,5,11,"dummy"
"222545",0,1,0,1,"dummy"
"222546",0,1,0,1,"dummy"
"222547",0,1,0,1,"dummy"
"222563",1,2,0,3,"dummy"
"222564",3,2,1,6,"dummy"
"222565",0,0,0,0,"dummy"
"222566",2,3,1,6,"dummy"
"222567",2,2,0,4,"dummy"
"222568",0,2,0,2,"dummy"
"222569",0,0,0,0,"dummy"
"222570",0,1,0,1,"dummy"
"222571",0,0,0,0,"dummy"
"222572",1,8,0,9,"dummy"
"222574",0,2,0,2,"dummy"
"222575",0,2,0,2,"dummy"
"222581",0,0,0,0,"dummy"
"222582",0,0,1,1,"dummy"
"222583",0,0,0,0,"dummy"
"222584",0,0,1,1,"dummy"
"222588",0,0,2,2,"dummy"
"222589",0,0,2,2,"dummy"
"222590",0,0,1,1,"dummy"
"222591",0,0,1,1,"dummy"
"222592",0,0,2,2,"dummy"
"222596",0,2,0,2,"dummy"
"222599",1,1,0,2,"dummy"
"222601",0,0,1,1,"dummy"
"222602",0,1,0,1,"dummy"
"222605",2,3,4,9,"dummy"
"222606",3,1,0,4,"dummy"
"222607",0,0,1,1,"dummy"
"222609",0,3,0,3,"dummy"
"222615",0,0,0,0,"dummy"
"222617",6,9,2,17,"dummy"
"222618",1,3,0,4,"dummy"
"222622",0,2,1,3,"dummy"
"222674",2,5,2,9,"dummy"
"222679",2,10,1,13,"dummy"
"222681",4,3,0,7,"dummy"
"222682",0,1,0,1,"dummy"
"222683",0,0,0,0,"dummy"
"222684",0,0,0,0,"dummy"
"222686",3,1,1,5,"dummy"
"222691",3,3,3,9,"dummy"
"222692",0,0,0,0,"dummy"
"222693",4,0,2,6,"dummy"
"222694",0,3,0,3,"dummy"
"222700",0,1,0,1,"dummy"
"222703",1,5,1,7,"dummy"
"222705",0,0,1,1,"dummy"
"222707",0,0,3,3,"dummy"
"222708",0,1,0,1,"dummy"
"222715",0,3,0,3,"dummy"
"222716",9,5,2,16,"dummy"
"222768",0,0,0,0,"dummy"
"222769",0,0,0,0,"dummy"
"222770",0,0,1,1,"dummy"
"222771",0,0,1,1,"dummy"
"222772",0,0,1,1,"dummy"
"222787",0,2,2,4,"dummy"
"222788",1,0,0,1,"dummy"
"222804",0,0,1,1,"dummy"
"222809",3,8,0,11,"dummy"
"222810",0,0,1,1,"dummy"
"222811",2,1,0,3,"dummy"
"222812",7,7,1,15,"dummy"
"222813",1,1,0,2,"dummy"
"222814",0,1,0,1,"dummy"
"222815",2,5,0,7,"dummy"
"222816",1,1,0,2,"dummy"
"222817",0,0,1,1,"dummy"
"222818",0,0,1,1,"dummy"
"222819",0,2,0,2,"dummy"
"222820",1,0,0,1,"dummy"
"222821",0,1,0,1,"dummy"
"222822",0,0,1,1,"dummy"
"222833",1,1,0,2,"dummy"
"222834",1,1,0,2,"dummy"
"222835",0,0,1,1,"dummy"
"222836",1,3,0,4,"dummy"
"222837",6,1,1,8,"dummy"
"222841",0,0,3,3,"dummy"
"222842",0,1,0,1,"dummy"
"222843",1,15,0,16,"dummy"
"222844",16,2,0,18,"dummy"
"222845",1,2,6,9,"dummy"
"222846",0,0,4,4,"dummy"
"222847",2,0,2,4,"dummy"
"222848",0,6,0,6,"dummy"
"222855",0,4,1,5,"dummy"
"222856",1,2,0,3,"dummy"
"222857",0,0,1,1,"dummy"
"222858",0,0,1,1,"dummy"
"222859",0,0,1,1,"dummy"
"222860",0,0,1,1,"dummy"
"222861",0,0,1,1,"dummy"
"222862",0,0,1,1,"dummy"
"222863",0,0,1,1,"dummy"
"222864",0,0,1,1,"dummy"
"222865",0,0,1,1,"dummy"
"222866",0,0,1,1,"dummy"
"222867",0,0,1,1,"dummy"
"222868",0,2,0,2,"dummy"
"222869",2,0,1,3,"dummy"
"222870",0,0,1,1,"dummy"
"222871",0,0,1,1,"dummy"
"222872",0,0,1,1,"dummy"
"222873",0,0,1,1,"dummy"
"222874",0,0,1,1,"dummy"
"222875",0,0,1,1,"dummy"
"222876",0,2,0,2,"dummy"
"222877",1,0,1,2,"dummy"
"222878",0,0,1,1,"dummy"
"222879",0,0,1,1,"dummy"
"222880",0,0,1,1,"dummy"
"222881",0,0,1,1,"dummy"
"222882",0,0,1,1,"dummy"
"222883",0,0,1,1,"dummy"
"222884",0,0,1,1,"dummy"
"222885",0,0,1,1,"dummy"
"222886",0,0,1,1,"dummy"
"222887",0,0,1,1,"dummy"
"222888",0,0,2,2,"dummy"
"222889",0,0,1,1,"dummy"
"222890",0,0,1,1,"dummy"
"222891",0,0,1,1,"dummy"
"222892",1,3,1,5,"dummy"
"222893",0,0,1,1,"dummy"
"222894",14,3,2,19,"dummy"
"222897",0,1,1,2,"dummy"
"222898",7,4,3,14,"dummy"
"222899",1,8,4,13,"dummy"
"222710",1,4,1,6,"dummy"
"222711",2,3,2,7,"dummy"
"222712",1,2,1,4,"dummy"
"222713",2,3,0,5,"dummy"
"222718",0,1,0,1,"dummy"
"222719",2,0,2,4,"dummy"
"222726",0,0,1,1,"dummy"
"222729",4,1,1,6,"dummy"
"222730",1,1,2,4,"dummy"
"222731",6,0,0,6,"dummy"
"222732",0,0,1,1,"dummy"
"222733",2,0,0,2,"dummy"
"222734",0,0,1,1,"dummy"
"222735",2,2,0,4,"dummy"
"222736",2,0,0,2,"dummy"
"222737",0,1,0,1,"dummy"
"222738",1,0,0,1,"dummy"
"222739",2,0,0,2,"dummy"
"222740",0,2,0,2,"dummy"
"222741",1,0,0,1,"dummy"
"222742",0,0,1,1,"dummy"
"222757",0,1,0,1,"dummy"
"222758",0,0,1,1,"dummy"
"222759",0,0,1,1,"dummy"
"222760",0,0,1,1,"dummy"
"222761",0,10,0,10,"dummy"
"222762",1,1,0,2,"dummy"
"222763",3,9,0,12,"dummy"
"222764",0,0,1,1,"dummy"
"222765",1,2,0,3,"dummy"
"222766",0,2,0,2,"dummy"
"222790",0,1,0,1,"dummy"
"222791",0,8,0,8,"dummy"
"222792",1,1,0,2,"dummy"
"222793",1,1,0,2,"dummy"
"222794",1,1,0,2,"dummy"
"222795",1,1,0,2,"dummy"
"222796",0,0,1,1,"dummy"
"222797",0,3,2,5,"dummy"
"222798",7,0,1,8,"dummy"
"222799",0,1,1,2,"dummy"
"222800",1,6,1,8,"dummy"
"222801",1,1,0,2,"dummy"
"222802",1,8,3,12,"dummy"
"222806",15,17,2,34,"dummy"
"222807",0,1,0,1,"dummy"
"222824",7,10,1,18,"dummy"
"222827",2,4,0,6,"dummy"
"222828",0,2,0,2,"dummy"
"222829",0,2,0,2,"dummy"
"222830",10,2,0,12,"dummy"
"222831",0,2,0,2,"dummy"
"222839",0,0,1,1,"dummy"
"222850",1,24,2,27,"dummy"
"222851",0,0,1,1,"dummy"
"222852",0,0,2,2,"dummy"
"222853",1,0,0,1,"dummy"
"222945",0,0,0,0,"dummy"
"222946",1,11,0,12,"dummy"
"222950",0,0,1,1,"dummy"
"222951",0,0,1,1,"dummy"
"223030",0,0,2,2,"dummy"
"223031",0,1,0,1,"dummy"
"223047",0,5,1,6,"dummy"
"223053",2,2,1,5,"dummy"
"223054",0,2,0,2,"dummy"
"223055",0,2,0,2,"dummy"
"223056",0,0,0,0,"dummy"
"223057",1,2,0,3,"dummy"
"223074",3,2,0,5,"dummy"
"223075",0,0,1,1,"dummy"
"223076",0,0,1,1,"dummy"
"222948",1,1,1,3,"dummy"
"223009",0,8,0,8,"dummy"
"223028",4,0,0,4,"dummy"
"223035",0,1,0,1,"dummy"
"223036",0,1,0,1,"dummy"
"223037",18,0,3,21,"dummy"
"223038",0,0,1,1,"dummy"
"223039",0,2,0,2,"dummy"
"223040",2,0,0,2,"dummy"
"223049",1,1,1,3,"dummy"
"223050",2,2,0,4,"dummy"
"223051",0,0,1,1,"dummy"
"223059",0,4,0,4,"dummy"
"223060",0,1,0,1,"dummy"
"223061",0,5,1,6,"dummy"
"223066",11,30,1,42,"dummy"
"223067",1,1,1,3,"dummy"
"223068",0,0,0,0,"dummy"
"223071",3,16,2,21,"dummy"
"223072",0,0,0,0,"dummy"
"223108",0,0,1,1,"dummy"
"223077",0,0,1,1,"dummy"
"223078",0,1,0,1,"dummy"
"223079",2,2,4,8,"dummy"
"223080",0,0,1,1,"dummy"
"223081",0,0,1,1,"dummy"
"223082",0,0,1,1,"dummy"
"223083",0,0,1,1,"dummy"
"223084",0,0,1,1,"dummy"
"223085",1,5,0,6,"dummy"
"223086",0,0,1,1,"dummy"
"223087",0,0,2,2,"dummy"
"223088",0,0,1,1,"dummy"
"223089",0,0,1,1,"dummy"
"223090",0,0,1,1,"dummy"
"223091",0,0,1,1,"dummy"
"223092",2,2,0,4,"dummy"
"223093",0,0,1,1,"dummy"
"223094",0,0,1,1,"dummy"
"223095",0,0,1,1,"dummy"
"223096",0,1,0,1,"dummy"
"223097",0,3,1,4,"dummy"
"223098",0,0,1,1,"dummy"
"223099",0,0,1,1,"dummy"
"223100",1,1,0,2,"dummy"
"223101",0,0,1,1,"dummy"
"223102",0,0,1,1,"dummy"
"223103",0,0,1,1,"dummy"
"223104",0,0,1,1,"dummy"
"223105",0,0,1,1,"dummy"
"223106",0,0,1,1,"dummy"
"223110",11,5,0,16,"dummy"
"223113",0,0,4,4,"dummy"
"223116",1,8,2,11,"dummy"
"223117",0,0,1,1,"dummy"
"223118",0,1,0,1,"dummy"
"223121",0,0,0,0,"dummy"
"223122",1,3,0,4,"dummy"
"223125",0,1,0,1,"dummy"
"223126",0,1,0,1,"dummy"
"223127",18,0,3,21,"dummy"
"223128",0,0,1,1,"dummy"
"223129",0,2,0,2,"dummy"
"223130",2,0,0,2,"dummy"
"223132",7,7,0,14,"dummy"
"223134",0,0,1,1,"dummy"
"223135",0,0,1,1,"dummy"
"223138",1,1,3,5,"dummy"
"223139",0,1,1,2,"dummy"
"223140",0,2,0,2,"dummy"
"223141",2,1,0,3,"dummy"
"223143",13,5,3,21,"dummy"
"223144",0,2,0,2,"dummy"
"223147",0,1,0,1,"dummy"
"223151",0,0,2,2,"dummy"
"223152",0,0,1,1,"dummy"
"223153",2,2,1,5,"dummy"
"223156",1,0,0,1,"dummy"
"223157",1,0,0,1,"dummy"
"223159",0,0,1,1,"dummy"
"223160",0,0,1,1,"dummy"
"223161",0,0,1,1,"dummy"
"223162",0,0,1,1,"dummy"
"223163",0,0,1,1,"dummy"
"223164",0,0,1,1,"dummy"
"223165",0,0,1,1,"dummy"
"223166",0,0,1,1,"dummy"
"223167",0,0,1,1,"dummy"
"223171",2,0,0,2,"dummy"
"223189",3,1,0,4,"dummy"
"223191",1,2,0,3,"dummy"
"223192",0,0,1,1,"dummy"
"223194",2,2,1,5,"dummy"
"223195",0,0,1,1,"dummy"
"223197",0,7,3,10,"dummy"
"223198",1,0,0,1,"dummy"
"223200",0,3,0,3,"dummy"
"223201",0,1,0,1,"dummy"
"223202",1,0,1,2,"dummy"
"223205",1,0,0,1,"dummy"
"223206",0,1,0,1,"dummy"
"223215",15,0,0,15,"dummy"
"223218",1,4,0,5,"dummy"
"223219",0,1,0,1,"dummy"
"223220",1,1,0,2,"dummy"
"223221",1,1,0,2,"dummy"
"223222",1,1,0,2,"dummy"
"223223",1,1,0,2,"dummy"
"223224",0,0,1,1,"dummy"
"223225",0,1,0,1,"dummy"
"223228",0,1,0,1,"dummy"
"223229",0,1,0,1,"dummy"
"223230",2,2,0,4,"dummy"
"223231",0,0,2,2,"dummy"
"223233",0,1,0,1,"dummy"
"223234",0,0,1,1,"dummy"
"223235",0,0,1,1,"dummy"
"223239",0,1,0,1,"dummy"
"223243",0,0,1,1,"dummy"
"223244",0,0,1,1,"dummy"
"223245",0,0,1,1,"dummy"
"223246",0,0,1,1,"dummy"
"223247",0,0,1,1,"dummy"
"223248",0,0,1,1,"dummy"
"223249",0,0,1,1,"dummy"
"223250",0,0,1,1,"dummy"
"223251",0,3,1,4,"dummy"
"223252",1,0,1,2,"dummy"
"223253",0,0,1,1,"dummy"
"223263",2,8,0,10,"dummy"
"223264",0,0,1,1,"dummy"
"223265",0,0,1,1,"dummy"
"223266",1,7,3,11,"dummy"
"223270",0,0,1,1,"dummy"
"223272",12,1,1,14,"dummy"
"223273",0,2,1,3,"dummy"
"223274",0,0,0,0,"dummy"
"223275",3,3,2,8,"dummy"
"223276",3,2,1,6,"dummy"
"223277",0,0,1,1,"dummy"
"223278",0,0,1,1,"dummy"
"223279",0,0,1,1,"dummy"
"223284",0,0,3,3,"dummy"
"223285",0,0,1,1,"dummy"
"223286",0,0,1,1,"dummy"
"223287",2,0,0,2,"dummy"
"223288",0,2,0,2,"dummy"
"223289",0,1,0,1,"dummy"
"223290",0,0,0,0,"dummy"
"223291",2,6,3,11,"dummy"
"223292",7,7,4,18,"dummy"
"223293",0,9,0,9,"dummy"
"223294",2,3,2,7,"dummy"
"223295",0,0,1,1,"dummy"
"223296",0,1,0,1,"dummy"
"223297",0,3,0,3,"dummy"
"223298",2,2,2,6,"dummy"
"223299",3,3,0,6,"dummy"
"223303",5,9,0,14,"dummy"
"223305",9,3,4,16,"dummy"
"223306",1,2,1,4,"dummy"
"223307",0,0,0,0,"dummy"
"223308",0,4,1,5,"dummy"
"223309",2,0,0,2,"dummy"
"223311",0,0,0,0,"dummy"
"223312",0,0,1,1,"dummy"
"223315",0,1,0,1,"dummy"
"223316",0,1,0,1,"dummy"
"223317",4,9,2,15,"dummy"
"223318",0,0,1,1,"dummy"
"223320",0,0,1,1,"dummy"
"223323",2,1,0,3,"dummy"
"223324",1,4,0,5,"dummy"
"223325",3,3,2,8,"dummy"
"223328",0,0,1,1,"dummy"
"223331",0,0,1,1,"dummy"
"223333",0,1,0,1,"dummy"
"223334",0,0,1,1,"dummy"
"223337",0,0,0,0,"dummy"
"223338",5,0,2,7,"dummy"
"223339",0,0,0,0,"dummy"
"223352",0,0,0,0,"dummy"
"223353",0,0,0,0,"dummy"
"223362",1,0,2,3,"dummy"
"223363",1,0,0,1,"dummy"
"223365",9,1,0,10,"dummy"
"223367",0,1,0,1,"dummy"
"223369",0,0,0,0,"dummy"
"223370",0,0,1,1,"dummy"
"223371",0,0,0,0,"dummy"
"223372",0,0,1,1,"dummy"
"223373",0,0,0,0,"dummy"
"223375",5,17,1,23,"dummy"
"223376",15,1,1,17,"dummy"
"223380",5,0,0,5,"dummy"
"223381",0,3,0,3,"dummy"
"223382",5,9,0,14,"dummy"
"223383",0,0,1,1,"dummy"
"223384",2,2,0,4,"dummy"
"223385",0,0,4,4,"dummy"
"223386",0,1,3,4,"dummy"
"223387",2,0,0,2,"dummy"
"223388",0,1,0,1,"dummy"
"223389",0,0,0,0,"dummy"
"223390",0,0,0,0,"dummy"
"223392",1,1,3,5,"dummy"
"223393",0,0,1,1,"dummy"
"223394",0,4,0,4,"dummy"
"223395",0,0,1,1,"dummy"
"223396",3,1,1,5,"dummy"
"223397",0,0,1,1,"dummy"
"223398",0,0,1,1,"dummy"
"223399",0,1,0,1,"dummy"
"223400",0,1,0,1,"dummy"
"223401",1,1,0,2,"dummy"
"223402",4,4,1,9,"dummy"
"223403",4,1,0,5,"dummy"
"223404",1,0,1,2,"dummy"
"223405",0,0,1,1,"dummy"
"223406",0,0,1,1,"dummy"
"223407",1,1,3,5,"dummy"
"223408",0,0,1,1,"dummy"
"223409",0,2,1,3,"dummy"
"223410",0,1,0,1,"dummy"
"223411",1,1,0,2,"dummy"
"223412",4,1,0,5,"dummy"
"223413",0,0,1,1,"dummy"
"223414",1,1,1,3,"dummy"
"223415",0,0,1,1,"dummy"
"223416",0,1,1,2,"dummy"
"223417",0,0,1,1,"dummy"
"223418",1,1,1,3,"dummy"
"223419",0,0,1,1,"dummy"
"223420",0,0,2,2,"dummy"
"223421",0,0,1,1,"dummy"
"223422",0,0,1,1,"dummy"
"223423",0,0,1,1,"dummy"
"223424",7,2,2,11,"dummy"
"223425",0,0,1,1,"dummy"
"223426",0,0,3,3,"dummy"
"223427",0,0,2,2,"dummy"
"223428",0,0,1,1,"dummy"
"223429",2,1,0,3,"dummy"
"223430",0,0,1,1,"dummy"
"223431",0,0,1,1,"dummy"
"223432",0,0,1,1,"dummy"
"223433",0,0,1,1,"dummy"
"223434",0,1,1,2,"dummy"
"223435",0,0,1,1,"dummy"
"223436",0,0,1,1,"dummy"
"223439",0,3,0,3,"dummy"
"223440",0,1,0,1,"dummy"
"223441",0,1,0,1,"dummy"
"223442",0,1,0,1,"dummy"
"223477",1,1,0,2,"dummy"
"223478",1,0,1,2,"dummy"
"223479",0,0,1,1,"dummy"
"223480",0,1,0,1,"dummy"
"223481",5,1,0,6,"dummy"
"223485",2,0,3,5,"dummy"
"223494",0,0,0,0,"dummy"
"223495",0,0,0,0,"dummy"
"223558",0,2,0,2,"dummy"
"223559",1,0,0,1,"dummy"
"223560",2,1,1,4,"dummy"
"223561",0,2,0,2,"dummy"
"223562",2,0,0,2,"dummy"
"223563",0,0,0,0,"dummy"
"223564",0,0,2,2,"dummy"
"223565",0,0,0,0,"dummy"
"223566",0,0,2,2,"dummy"
"223567",0,0,2,2,"dummy"
"223572",0,4,1,5,"dummy"
"223573",6,7,0,13,"dummy"
"223578",0,1,0,1,"dummy"
"223585",0,1,0,1,"dummy"
"223588",1,1,0,2,"dummy"
"223600",15,17,2,34,"dummy"
"223604",0,0,0,0,"dummy"
"223605",0,0,2,2,"dummy"
"223606",0,0,2,2,"dummy"
"223618",0,1,1,2,"dummy"
"223621",1,29,2,32,"dummy"
"223622",3,6,2,11,"dummy"
"223623",26,14,1,41,"dummy"
"223624",0,5,0,5,"dummy"
"223625",0,1,0,1,"dummy"
"223626",0,0,1,1,"dummy"
"223627",0,0,0,0,"dummy"
"223628",0,0,0,0,"dummy"
"223629",0,0,0,0,"dummy"
"223630",0,0,0,0,"dummy"
"223631",1,0,0,1,"dummy"
"223632",0,0,0,0,"dummy"
"223633",3,1,0,4,"dummy"
"223634",0,0,1,1,"dummy"
"223648",0,0,3,3,"dummy"
"223649",0,4,2,6,"dummy"
"223652",0,0,0,0,"dummy"
"223653",1,0,0,1,"dummy"
"223654",0,0,1,1,"dummy"
"223655",2,0,0,2,"dummy"
"223656",0,0,1,1,"dummy"
"223657",0,1,0,1,"dummy"
"223658",0,2,0,2,"dummy"
"223670",1,2,0,3,"dummy"
"223671",0,0,1,1,"dummy"
"223682",0,0,1,1,"dummy"
"223683",0,3,3,6,"dummy"
"223688",2,0,0,2,"dummy"
"223693",1,0,1,2,"dummy"
"223444",0,0,1,1,"dummy"
"223451",1,5,0,6,"dummy"
"223452",0,2,0,2,"dummy"
"223465",0,1,0,1,"dummy"
"223468",3,9,0,12,"dummy"
"223469",5,11,1,17,"dummy"
"223470",1,0,0,1,"dummy"
"223471",2,2,0,4,"dummy"
"223472",16,0,2,18,"dummy"
"223473",1,1,0,2,"dummy"
"223483",0,0,1,1,"dummy"
"223489",5,8,1,14,"dummy"
"223490",0,3,0,3,"dummy"
"223491",1,0,0,1,"dummy"
"223492",0,1,0,1,"dummy"
"223511",3,5,0,8,"dummy"
"223512",0,1,0,1,"dummy"
"223513",1,0,0,1,"dummy"
"223514",0,0,1,1,"dummy"
"223517",0,0,0,0,"dummy"
"223518",1,1,0,2,"dummy"
"223519",0,1,0,1,"dummy"
"223520",0,1,0,1,"dummy"
"223521",0,0,1,1,"dummy"
"223522",0,1,0,1,"dummy"
"223523",0,1,0,1,"dummy"
"223524",0,1,0,1,"dummy"
"223525",0,2,0,2,"dummy"
"223526",0,1,0,1,"dummy"
"223527",0,1,0,1,"dummy"
"223528",1,5,0,6,"dummy"
"223529",0,0,1,1,"dummy"
"223530",0,1,0,1,"dummy"
"223531",0,1,0,1,"dummy"
"223532",0,1,0,1,"dummy"
"223533",0,0,1,1,"dummy"
"223534",0,1,0,1,"dummy"
"223535",4,2,0,6,"dummy"
"223536",0,0,1,1,"dummy"
"223537",0,0,1,1,"dummy"
"223538",0,14,0,14,"dummy"
"223539",3,2,0,5,"dummy"
"223540",2,1,0,3,"dummy"
"223541",0,3,0,3,"dummy"
"223542",0,0,1,1,"dummy"
"223543",1,0,0,1,"dummy"
"223544",0,1,0,1,"dummy"
"223545",1,0,0,1,"dummy"
"223546",3,1,1,5,"dummy"
"223547",0,0,1,1,"dummy"
"223548",1,0,0,1,"dummy"
"223549",2,1,0,3,"dummy"
"223550",0,2,0,2,"dummy"
"223551",0,0,1,1,"dummy"
"223552",0,1,0,1,"dummy"
"223553",2,0,0,2,"dummy"
"223554",0,0,1,1,"dummy"
"223555",0,2,1,3,"dummy"
"223556",0,3,0,3,"dummy"
"223569",0,0,1,1,"dummy"
"223570",0,2,2,4,"dummy"
"223582",0,1,0,1,"dummy"
"223583",2,2,0,4,"dummy"
"223590",0,0,2,2,"dummy"
"223591",0,0,2,2,"dummy"
"223592",0,9,1,10,"dummy"
"223593",0,1,0,1,"dummy"
"223594",0,0,2,2,"dummy"
"223595",17,0,2,19,"dummy"
"223596",0,0,2,2,"dummy"
"223608",0,0,1,1,"dummy"
"223609",0,0,1,1,"dummy"
"223610",0,0,1,1,"dummy"
"223611",0,0,1,1,"dummy"
"223612",0,0,1,1,"dummy"
"223613",0,0,1,1,"dummy"
"223614",0,0,2,2,"dummy"
"223615",0,0,1,1,"dummy"
"223616",0,0,1,1,"dummy"
"223636",0,0,0,0,"dummy"
"223637",0,0,0,0,"dummy"
"223638",0,0,1,1,"dummy"
"223639",0,0,4,4,"dummy"
"223640",0,1,0,1,"dummy"
"223641",1,12,3,16,"dummy"
"223644",3,31,0,34,"dummy"
"223645",0,6,0,6,"dummy"
"223646",0,0,1,1,"dummy"
"223660",5,6,1,12,"dummy"
"223661",12,12,3,27,"dummy"
"223662",1,9,0,10,"dummy"
"223663",0,8,0,8,"dummy"
"223666",0,12,2,14,"dummy"
"223675",4,5,0,9,"dummy"
"223676",0,1,0,1,"dummy"
"223677",0,0,1,1,"dummy"
"223678",0,0,1,1,"dummy"
"223685",0,1,0,1,"dummy"
"223686",0,1,0,1,"dummy"
"223695",1,2,0,3,"dummy"
"223696",0,1,0,1,"dummy"
"223697",1,3,0,4,"dummy"
"223698",0,1,0,1,"dummy"
"223699",0,0,0,0,"dummy"
"223700",0,0,1,1,"dummy"
"223704",0,0,0,0,"dummy"
"223705",0,0,1,1,"dummy"
"223706",1,0,0,1,"dummy"
"223707",0,0,1,1,"dummy"
"223708",2,0,0,2,"dummy"
"223709",1,6,2,9,"dummy"
"223717",0,1,0,1,"dummy"
"223720",0,0,5,5,"dummy"
"223723",3,8,3,14,"dummy"
"223724",6,0,0,6,"dummy"
"223725",0,6,0,6,"dummy"
"223728",0,1,0,1,"dummy"
"223736",0,0,0,0,"dummy"
"223737",0,1,0,1,"dummy"
"223738",0,9,0,9,"dummy"
"223739",0,1,1,2,"dummy"
"223740",9,0,2,11,"dummy"
"223741",0,2,4,6,"dummy"
"223745",0,0,1,1,"dummy"
"223776",0,1,1,2,"dummy"
"223777",2,0,0,2,"dummy"
"223811",0,1,0,1,"dummy"
"223812",0,0,1,1,"dummy"
"223820",0,1,0,1,"dummy"
"223821",2,1,0,3,"dummy"
"223822",0,2,0,2,"dummy"
"223823",0,1,0,1,"dummy"
"223824",3,3,1,7,"dummy"
"223825",2,0,0,2,"dummy"
"223826",1,4,1,6,"dummy"
"223827",1,4,0,5,"dummy"
"223828",0,1,0,1,"dummy"
"223829",1,0,0,1,"dummy"
"223848",1,1,2,4,"dummy"
"223849",0,1,0,1,"dummy"
"223850",2,0,3,5,"dummy"
"223851",3,0,1,4,"dummy"
"223854",1,0,3,4,"dummy"
"223855",0,2,0,2,"dummy"
"223856",1,0,0,1,"dummy"
"223857",2,2,2,6,"dummy"
"223858",0,0,1,1,"dummy"
"223859",0,0,3,3,"dummy"
"223860",2,2,3,7,"dummy"
"223864",0,0,3,3,"dummy"
"223865",0,0,3,3,"dummy"
"223866",0,0,1,1,"dummy"
"223702",1,0,0,1,"dummy"
"223713",3,2,3,8,"dummy"
"223714",0,1,4,5,"dummy"
"223732",0,1,0,1,"dummy"
"223733",0,0,1,1,"dummy"
"223734",0,1,1,2,"dummy"
"223743",0,0,1,1,"dummy"
"223747",5,6,0,11,"dummy"
"223748",1,0,1,2,"dummy"
"223753",1,11,0,12,"dummy"
"223754",6,15,0,21,"dummy"
"223755",2,7,1,10,"dummy"
"223756",5,1,3,9,"dummy"
"223757",2,1,1,4,"dummy"
"223758",5,1,1,7,"dummy"
"223759",5,6,0,11,"dummy"
"223760",2,2,0,4,"dummy"
"223761",3,4,0,7,"dummy"
"223762",0,2,0,2,"dummy"
"223763",34,2,0,36,"dummy"
"223764",3,1,1,5,"dummy"
"223765",3,0,0,3,"dummy"
"223766",7,2,2,11,"dummy"
"223767",6,0,0,6,"dummy"
"223768",0,1,0,1,"dummy"
"223769",1,0,1,2,"dummy"
"223770",0,2,0,2,"dummy"
"223773",2,9,0,11,"dummy"
"223774",2,4,0,6,"dummy"
"223779",0,0,1,1,"dummy"
"223780",0,0,1,1,"dummy"
"223781",0,0,1,1,"dummy"
"223782",0,0,1,1,"dummy"
"223783",1,0,1,2,"dummy"
"223784",0,0,1,1,"dummy"
"223785",0,0,1,1,"dummy"
"223788",0,0,0,0,"dummy"
"223791",3,1,1,5,"dummy"
"223792",1,1,0,2,"dummy"
"223793",13,4,0,17,"dummy"
"223798",0,0,2,2,"dummy"
"223799",7,7,2,16,"dummy"
"223800",0,0,1,1,"dummy"
"223801",3,3,1,7,"dummy"
"223802",0,1,0,1,"dummy"
"223803",3,4,2,9,"dummy"
"223804",4,3,2,9,"dummy"
"223805",0,1,0,1,"dummy"
"223806",0,0,1,1,"dummy"
"223807",0,2,0,2,"dummy"
"223814",0,1,0,1,"dummy"
"223815",0,1,0,1,"dummy"
"223816",0,3,2,5,"dummy"
"223817",2,3,0,5,"dummy"
"223818",3,0,1,4,"dummy"
"223837",3,5,5,13,"dummy"
"223838",3,2,2,7,"dummy"
"223839",0,1,0,1,"dummy"
"223840",1,1,0,2,"dummy"
"223841",0,1,3,4,"dummy"
"223842",2,4,0,6,"dummy"
"223843",0,1,1,2,"dummy"
"223844",0,0,1,1,"dummy"
"223845",2,2,0,4,"dummy"
"223846",2,2,0,4,"dummy"
"223868",11,0,2,13,"dummy"
"223869",0,1,0,1,"dummy"
"223870",1,11,3,15,"dummy"
"223894",0,5,0,5,"dummy"
"223895",0,1,0,1,"dummy"
"223896",0,1,0,1,"dummy"
"223897",0,0,0,0,"dummy"
"223931",0,5,1,6,"dummy"
"223932",0,2,0,2,"dummy"
"223933",1,6,0,7,"dummy"
"223934",0,2,0,2,"dummy"
"223935",5,2,3,10,"dummy"
"223936",0,1,0,1,"dummy"
"223937",1,2,0,3,"dummy"
"223938",0,2,0,2,"dummy"
"223872",1,0,0,1,"dummy"
"223887",34,3,5,42,"dummy"
"223888",3,34,5,42,"dummy"
"223889",0,0,1,1,"dummy"
"223890",35,2,4,41,"dummy"
"223891",0,2,0,2,"dummy"
"223892",0,0,1,1,"dummy"
"223899",2,1,1,4,"dummy"
"223900",2,1,1,4,"dummy"
"223901",2,0,0,2,"dummy"
"223902",2,1,0,3,"dummy"
"223903",2,0,0,2,"dummy"
"223904",3,2,0,5,"dummy"
"223905",0,1,1,2,"dummy"
"223906",0,0,1,1,"dummy"
"223907",2,0,0,2,"dummy"
"223908",0,3,0,3,"dummy"
"223909",0,0,0,0,"dummy"
"223910",2,0,0,2,"dummy"
"223911",0,2,0,2,"dummy"
"223912",1,0,0,1,"dummy"
"223913",2,0,0,2,"dummy"
"223914",3,1,0,4,"dummy"
"223915",1,0,0,1,"dummy"
"223918",0,0,0,0,"dummy"
"223919",0,0,1,1,"dummy"
"223920",1,8,0,9,"dummy"
"223921",0,0,1,1,"dummy"
"223922",0,1,0,1,"dummy"
"223923",0,6,0,6,"dummy"
"223924",5,0,0,5,"dummy"
"223925",0,0,3,3,"dummy"
"223926",1,0,0,1,"dummy"
"223927",0,0,0,0,"dummy"
"223943",0,1,0,1,"dummy"
"223944",0,1,0,1,"dummy"
"223953",0,0,2,2,"dummy"
"223956",2,2,5,9,"dummy"
"224024",0,6,1,7,"dummy"
"224025",0,1,0,1,"dummy"
"224026",0,2,2,4,"dummy"
"224027",0,2,1,3,"dummy"
"224028",1,1,1,3,"dummy"
"224029",1,0,1,2,"dummy"
"224030",2,1,0,3,"dummy"
"224031",0,1,0,1,"dummy"
"224055",0,2,0,2,"dummy"
"224056",0,2,0,2,"dummy"
"224057",2,1,0,3,"dummy"
"224058",1,2,0,3,"dummy"
"224059",10,2,0,12,"dummy"
"224060",0,0,2,2,"dummy"
"224063",0,3,0,3,"dummy"
"224074",1,0,0,1,"dummy"
"224119",0,0,1,1,"dummy"
"224120",0,2,1,3,"dummy"
"224121",0,0,1,1,"dummy"
"224160",0,0,2,2,"dummy"
"224172",0,0,0,0,"dummy"
"224173",0,0,0,0,"dummy"
"224174",0,0,0,0,"dummy"
"224175",0,0,0,0,"dummy"
"224181",0,4,0,4,"dummy"
"224182",0,0,1,1,"dummy"
"224183",0,0,1,1,"dummy"
"224186",0,0,1,1,"dummy"
"224187",1,1,0,2,"dummy"
"224188",0,3,2,5,"dummy"
"224189",0,0,1,1,"dummy"
"224190",0,1,1,2,"dummy"
"224191",0,0,0,0,"dummy"
"224192",0,1,0,1,"dummy"
"224195",1,0,0,1,"dummy"
"224196",0,4,2,6,"dummy"
"224197",2,0,0,2,"dummy"
"223939",0,0,1,1,"dummy"
"223940",3,0,0,3,"dummy"
"223941",2,0,0,2,"dummy"
"223946",1,1,0,2,"dummy"
"223947",0,0,0,0,"dummy"
"223948",1,6,0,7,"dummy"
"223949",7,9,4,20,"dummy"
"223950",0,1,0,1,"dummy"
"223951",0,1,1,2,"dummy"
"223962",0,0,1,1,"dummy"
"223963",6,1,1,8,"dummy"
"223964",0,0,1,1,"dummy"
"223965",1,2,1,4,"dummy"
"223966",1,0,0,1,"dummy"
"223967",0,0,1,1,"dummy"
"223968",1,2,1,4,"dummy"
"223969",3,0,0,3,"dummy"
"223970",0,0,0,0,"dummy"
"223971",0,1,0,1,"dummy"
"223972",1,0,0,1,"dummy"
"223973",0,4,1,5,"dummy"
"223974",0,5,1,6,"dummy"
"223975",0,0,1,1,"dummy"
"223976",0,0,0,0,"dummy"
"223977",11,2,1,14,"dummy"
"223978",0,0,1,1,"dummy"
"223979",0,0,1,1,"dummy"
"223980",0,1,0,1,"dummy"
"223981",1,0,0,1,"dummy"
"223982",0,5,0,5,"dummy"
"223983",0,0,1,1,"dummy"
"223984",0,2,0,2,"dummy"
"223985",0,1,0,1,"dummy"
"223986",0,0,0,0,"dummy"
"223987",0,0,2,2,"dummy"
"223988",1,0,2,3,"dummy"
"223989",0,0,1,1,"dummy"
"223990",3,3,0,6,"dummy"
"223991",0,0,1,1,"dummy"
"223992",0,0,1,1,"dummy"
"223993",3,3,2,8,"dummy"
"223994",0,0,1,1,"dummy"
"223995",0,0,1,1,"dummy"
"223996",0,0,1,1,"dummy"
"223997",0,0,2,2,"dummy"
"223998",0,0,2,2,"dummy"
"223999",0,0,2,2,"dummy"
"224000",0,0,2,2,"dummy"
"224001",0,1,0,1,"dummy"
"224002",1,0,0,1,"dummy"
"224003",0,0,2,2,"dummy"
"224004",0,0,2,2,"dummy"
"224005",0,0,2,2,"dummy"
"224006",2,0,0,2,"dummy"
"224007",0,0,0,0,"dummy"
"224008",1,1,0,2,"dummy"
"224009",0,0,2,2,"dummy"
"224010",0,1,0,1,"dummy"
"224011",0,0,2,2,"dummy"
"224012",1,0,0,1,"dummy"
"224013",1,1,0,2,"dummy"
"224014",0,0,0,0,"dummy"
"224015",0,0,0,0,"dummy"
"224016",0,0,1,1,"dummy"
"224017",0,0,1,1,"dummy"
"224018",0,0,1,1,"dummy"
"224019",0,1,1,2,"dummy"
"224020",0,0,1,1,"dummy"
"224021",0,0,1,1,"dummy"
"224022",0,0,1,1,"dummy"
"224035",3,3,4,10,"dummy"
"224036",2,1,1,4,"dummy"
"224037",3,7,1,11,"dummy"
"224038",0,1,1,2,"dummy"
"224041",0,0,1,1,"dummy"
"224042",0,0,1,1,"dummy"
"224048",0,0,0,0,"dummy"
"224053",0,6,0,6,"dummy"
"224065",0,0,0,0,"dummy"
"224066",1,0,0,1,"dummy"
"224067",0,2,0,2,"dummy"
"224123",1,0,0,1,"dummy"
"224124",0,1,0,1,"dummy"
"224133",3,9,0,12,"dummy"
"224136",0,0,1,1,"dummy"
"224137",0,0,1,1,"dummy"
"224138",0,3,0,3,"dummy"
"224139",0,1,3,4,"dummy"
"224140",8,8,0,16,"dummy"
"224141",5,0,1,6,"dummy"
"224142",1,0,0,1,"dummy"
"224143",0,0,1,1,"dummy"
"224144",0,0,1,1,"dummy"
"224145",2,2,0,4,"dummy"
"224146",0,1,0,1,"dummy"
"224147",0,13,5,18,"dummy"
"224148",0,1,0,1,"dummy"
"224149",0,0,2,2,"dummy"
"224150",0,0,2,2,"dummy"
"224151",0,0,2,2,"dummy"
"224152",1,2,0,3,"dummy"
"224153",1,1,0,2,"dummy"
"224154",0,0,1,1,"dummy"
"224155",0,0,0,0,"dummy"
"224156",0,0,0,0,"dummy"
"224162",6,0,0,6,"dummy"
"224163",0,0,1,1,"dummy"
"224164",0,0,1,1,"dummy"
"224165",0,0,1,1,"dummy"
"224177",1,4,0,5,"dummy"
"224178",0,2,0,2,"dummy"
"224179",0,1,0,1,"dummy"
"224199",0,3,0,3,"dummy"
"224200",0,0,1,1,"dummy"
"224201",0,2,0,2,"dummy"
"224202",0,1,1,2,"dummy"
"224205",0,3,1,4,"dummy"
"224206",0,1,0,1,"dummy"
"224207",0,3,0,3,"dummy"
"224208",0,1,1,2,"dummy"
"224209",0,7,0,7,"dummy"
"224210",0,0,1,1,"dummy"
"224211",0,1,0,1,"dummy"
"224212",1,10,0,11,"dummy"
"224213",0,1,0,1,"dummy"
"224214",0,0,6,6,"dummy"
"224215",0,2,0,2,"dummy"
"224220",0,0,0,0,"dummy"
"224243",12,1,0,13,"dummy"
"224244",0,0,1,1,"dummy"
"224245",0,3,0,3,"dummy"
"224246",0,3,0,3,"dummy"
"224247",5,9,1,15,"dummy"
"224248",0,0,1,1,"dummy"
"224249",9,0,0,9,"dummy"
"224250",2,0,0,2,"dummy"
"224262",0,0,0,0,"dummy"
"224263",0,0,0,0,"dummy"
"224273",0,0,1,1,"dummy"
"224274",0,0,0,0,"dummy"
"224279",0,2,0,2,"dummy"
"224280",0,14,2,16,"dummy"
"224281",0,6,0,6,"dummy"
"224282",0,1,2,3,"dummy"
"224283",0,3,0,3,"dummy"
"224284",4,5,1,10,"dummy"
"224285",10,4,1,15,"dummy"
"224286",8,6,0,14,"dummy"
"224289",0,1,0,1,"dummy"
"224290",0,2,0,2,"dummy"
"224291",0,0,1,1,"dummy"
"224292",0,1,0,1,"dummy"
"224293",0,1,0,1,"dummy"
"224294",0,0,1,1,"dummy"
"224297",0,1,0,1,"dummy"
"224298",0,1,0,1,"dummy"
"224299",0,1,0,1,"dummy"
"224300",0,1,0,1,"dummy"
"224301",1,0,0,1,"dummy"
"224305",1,0,0,1,"dummy"
"224306",0,0,1,1,"dummy"
"224315",0,1,1,2,"dummy"
"224316",0,0,0,0,"dummy"
"224224",0,0,1,1,"dummy"
"224227",0,0,1,1,"dummy"
"224228",0,0,1,1,"dummy"
"224235",2,0,0,2,"dummy"
"224236",3,4,1,8,"dummy"
"224237",0,2,0,2,"dummy"
"224238",0,3,0,3,"dummy"
"224239",0,1,0,1,"dummy"
"224240",3,3,0,6,"dummy"
"224241",0,1,0,1,"dummy"
"224252",0,0,0,0,"dummy"
"224257",1,8,3,12,"dummy"
"224258",0,0,1,1,"dummy"
"224259",1,1,0,2,"dummy"
"224260",0,0,1,1,"dummy"
"224265",0,1,0,1,"dummy"
"224266",0,7,0,7,"dummy"
"224267",1,0,0,1,"dummy"
"224268",0,2,0,2,"dummy"
"224269",0,1,0,1,"dummy"
"224270",1,5,0,6,"dummy"
"224271",0,1,1,2,"dummy"
"224276",0,0,0,0,"dummy"
"224277",0,0,0,0,"dummy"
"224303",0,0,1,1,"dummy"
"224310",4,5,1,10,"dummy"
"224311",0,2,1,3,"dummy"
"224312",2,2,0,4,"dummy"
"224313",0,1,2,3,"dummy"
"224318",0,1,0,1,"dummy"
"224319",0,9,1,10,"dummy"
"224320",0,3,0,3,"dummy"
"224321",2,0,0,2,"dummy"
"224322",0,2,0,2,"dummy"
"224323",0,1,0,1,"dummy"
"224324",0,0,2,2,"dummy"
"224328",0,0,1,1,"dummy"
"224331",0,1,0,1,"dummy"
"224341",0,0,1,1,"dummy"
"224344",0,0,0,0,"dummy"
"224345",0,0,0,0,"dummy"
"224346",0,0,0,0,"dummy"
"224347",0,1,0,1,"dummy"
"224348",0,1,1,2,"dummy"
"224349",0,0,1,1,"dummy"
"224350",0,0,0,0,"dummy"
"224356",0,0,0,0,"dummy"
"224359",0,0,0,0,"dummy"
"224360",0,1,0,1,"dummy"
"224389",0,0,1,1,"dummy"
"224390",0,0,1,1,"dummy"
"224391",0,1,2,3,"dummy"
"224392",0,0,1,1,"dummy"
"224393",3,10,2,15,"dummy"
"224394",0,2,0,2,"dummy"
"224385",3,0,0,3,"dummy"
"224384",0,5,0,5,"dummy"
"224383",0,3,0,3,"dummy"
"224382",2,0,0,2,"dummy"
"224381",0,1,0,1,"dummy"
"224380",0,1,0,1,"dummy"
"224379",0,13,0,13,"dummy"
"224457",0,0,0,0,"dummy"
"224458",5,0,2,7,"dummy"
"224459",0,0,0,0,"dummy"
"224479",0,0,0,0,"dummy"
"224480",0,0,1,1,"dummy"
"224481",0,1,0,1,"dummy"
"224482",3,2,4,9,"dummy"
"224483",1,1,0,2,"dummy"
"224486",0,12,0,12,"dummy"
"224326",0,1,1,2,"dummy"
"224333",0,0,1,1,"dummy"
"224354",0,14,0,14,"dummy"
"224374",0,2,0,2,"dummy"
"224375",0,4,0,4,"dummy"
"224387",0,1,4,5,"dummy"
"224388",0,0,2,2,"dummy"
"224439",0,12,0,12,"dummy"
"224445",0,2,0,2,"dummy"
"224446",0,0,3,3,"dummy"
"224447",1,3,0,4,"dummy"
"224448",5,1,0,6,"dummy"
"224449",4,0,0,4,"dummy"
"224450",0,0,1,1,"dummy"
"224451",12,0,3,15,"dummy"
"224452",0,4,3,7,"dummy"
"224455",0,2,0,2,"dummy"
"224461",1,0,0,1,"dummy"
"224462",6,20,0,26,"dummy"
"224463",6,3,0,9,"dummy"
"224464",0,6,1,7,"dummy"
"224465",6,8,5,19,"dummy"
"224466",0,3,1,4,"dummy"
"224467",0,3,0,3,"dummy"
"224468",0,0,3,3,"dummy"
"224469",0,0,2,2,"dummy"
"224470",0,0,1,1,"dummy"
"224471",0,1,0,1,"dummy"
"224472",1,0,0,1,"dummy"
"224477",1,2,0,3,"dummy"
"224488",0,0,3,3,"dummy"
"224489",1,2,0,3,"dummy"
"224497",0,0,1,1,"dummy"
"224491",0,0,1,1,"dummy"
"224492",0,1,0,1,"dummy"
"224493",2,1,0,3,"dummy"
"224499",12,12,2,26,"dummy"
"224505",8,17,0,25,"dummy"
"224506",2,0,0,2,"dummy"
"224507",2,2,5,9,"dummy"
"224515",2,2,1,5,"dummy"
"224516",0,0,1,1,"dummy"
"224523",0,3,0,3,"dummy"
"224525",0,1,0,1,"dummy"
"224528",0,0,1,1,"dummy"
"224530",0,0,0,0,"dummy"
"224531",0,1,0,1,"dummy"
"224532",0,0,1,1,"dummy"
"224533",0,2,0,2,"dummy"
"224535",6,0,0,6,"dummy"
"224536",2,5,2,9,"dummy"
"224543",0,1,0,1,"dummy"
"224544",0,1,0,1,"dummy"
"224545",0,0,1,1,"dummy"
"224547",1,6,0,7,"dummy"
"224548",0,0,1,1,"dummy"
"224551",2,1,1,4,"dummy"
"224554",0,0,2,2,"dummy"
"224555",0,0,2,2,"dummy"
"224556",0,0,2,2,"dummy"
"224557",0,0,2,2,"dummy"
"224558",0,0,2,2,"dummy"
"224559",0,0,2,2,"dummy"
"224560",0,0,2,2,"dummy"
"224561",0,0,2,2,"dummy"
"224562",0,0,2,2,"dummy"
"224563",0,1,0,1,"dummy"
"224564",0,0,2,2,"dummy"
"224565",0,0,2,2,"dummy"
"224566",0,0,2,2,"dummy"
"224568",2,0,1,3,"dummy"
"224572",0,0,0,0,"dummy"
"224573",0,0,0,0,"dummy"
"224575",0,0,1,1,"dummy"
"224576",0,0,1,1,"dummy"
"224577",0,0,1,1,"dummy"
"224580",1,1,0,2,"dummy"
"224581",0,1,0,1,"dummy"
"224582",0,3,0,3,"dummy"
"224584",1,5,0,6,"dummy"
"224586",0,0,2,2,"dummy"
"224588",1,4,0,5,"dummy"
"224591",2,1,2,5,"dummy"
"224593",0,1,0,1,"dummy"
"224594",0,0,1,1,"dummy"
"224595",0,1,0,1,"dummy"
"224596",2,8,0,10,"dummy"
"224597",1,1,0,2,"dummy"
"224602",6,8,4,18,"dummy"
"224603",0,1,0,1,"dummy"
"224614",12,5,1,18,"dummy"
"224626",0,1,0,1,"dummy"
"224627",0,14,0,14,"dummy"
"224628",0,2,0,2,"dummy"
"224629",0,1,0,1,"dummy"
"224631",1,1,0,2,"dummy"
"224632",0,6,0,6,"dummy"
"224633",0,0,1,1,"dummy"
"224637",3,5,2,10,"dummy"
"224638",1,0,0,1,"dummy"
"224639",25,12,1,38,"dummy"
"224641",4,2,3,9,"dummy"
"224645",0,1,1,2,"dummy"
"224646",1,21,0,22,"dummy"
"224647",0,2,0,2,"dummy"
"224648",1,2,1,4,"dummy"
"224649",1,2,0,3,"dummy"
"224650",0,0,0,0,"dummy"
"224652",0,0,0,0,"dummy"
"224653",0,0,1,1,"dummy"
"224654",6,0,0,6,"dummy"
"224655",0,0,0,0,"dummy"
"224656",0,0,0,0,"dummy"
"224657",2,0,0,2,"dummy"
"224658",0,0,0,0,"dummy"
"224659",0,0,1,1,"dummy"
"224660",1,1,0,2,"dummy"
"224661",1,1,0,2,"dummy"
"224662",0,0,0,0,"dummy"
"224663",1,1,0,2,"dummy"
"224664",0,0,1,1,"dummy"
"224665",0,0,0,0,"dummy"
"224666",0,1,0,1,"dummy"
"224667",0,0,1,1,"dummy"
"224668",0,3,1,4,"dummy"
"224669",3,0,0,3,"dummy"
"224670",0,0,0,0,"dummy"
"224671",0,0,0,0,"dummy"
"224672",2,0,0,2,"dummy"
"224673",0,1,3,4,"dummy"
"224674",0,0,4,4,"dummy"
"224675",4,0,0,4,"dummy"
"224676",0,0,0,0,"dummy"
"224677",0,0,0,0,"dummy"
"224678",0,1,0,1,"dummy"
"224679",0,0,0,0,"dummy"
"224680",0,1,0,1,"dummy"
"224681",0,0,0,0,"dummy"
"224743",1,6,0,7,"dummy"
"224744",0,0,4,4,"dummy"
"224745",0,0,2,2,"dummy"
"224747",0,0,1,1,"dummy"
"224748",0,0,1,1,"dummy"
"224749",0,0,2,2,"dummy"
"224750",0,0,0,0,"dummy"
"224751",0,0,2,2,"dummy"
"224752",0,0,1,1,"dummy"
"224753",0,0,1,1,"dummy"
"224756",0,4,0,4,"dummy"
"224757",0,0,1,1,"dummy"
"224758",0,3,0,3,"dummy"
"224759",0,1,0,1,"dummy"
"224762",0,0,1,1,"dummy"
"224763",0,2,0,2,"dummy"
"224764",1,2,1,4,"dummy"
"224765",0,5,0,5,"dummy"
"224766",0,2,0,2,"dummy"
"224767",2,0,0,2,"dummy"
"224768",0,6,0,6,"dummy"
"224769",0,2,1,3,"dummy"
"224770",0,1,1,2,"dummy"
"224771",0,0,1,1,"dummy"
"224772",0,0,1,1,"dummy"
"224773",0,0,2,2,"dummy"
"224774",0,2,0,2,"dummy"
"224775",0,1,0,1,"dummy"
"224776",14,20,1,35,"dummy"
"224777",2,3,1,6,"dummy"
"224780",2,0,0,2,"dummy"
"224781",0,0,0,0,"dummy"
"224783",0,0,5,5,"dummy"
"224784",0,2,5,7,"dummy"
"224785",0,0,2,2,"dummy"
"224786",1,0,0,1,"dummy"
"224788",2,6,2,10,"dummy"
"224789",0,3,0,3,"dummy"
"224790",0,11,1,12,"dummy"
"224791",0,7,0,7,"dummy"
"224792",0,10,0,10,"dummy"
"224794",0,2,0,2,"dummy"
"224795",1,1,0,2,"dummy"
"224796",9,1,4,14,"dummy"
"224797",1,2,1,4,"dummy"
"224799",0,0,2,2,"dummy"
"224800",0,0,2,2,"dummy"
"224802",0,2,0,2,"dummy"
"224812",0,3,3,6,"dummy"
"224813",0,3,1,4,"dummy"
"224814",1,0,1,2,"dummy"
"224815",0,0,2,2,"dummy"
"224843",3,4,2,9,"dummy"
"224844",4,3,2,9,"dummy"
"224845",0,0,1,1,"dummy"
"224848",1,2,0,3,"dummy"
"224849",0,5,0,5,"dummy"
"224850",0,3,1,4,"dummy"
"224851",3,0,0,3,"dummy"
"224852",3,6,0,9,"dummy"
"224853",3,4,0,7,"dummy"
"224854",0,0,0,0,"dummy"
"224855",1,2,1,4,"dummy"
"224856",0,0,0,0,"dummy"
"224857",3,0,0,3,"dummy"
"224860",1,0,4,5,"dummy"
"224862",3,4,0,7,"dummy"
"224863",1,1,0,2,"dummy"
"224864",0,2,0,2,"dummy"
"224865",9,1,7,17,"dummy"
"224866",6,22,7,35,"dummy"
"224867",3,2,0,5,"dummy"
"224868",0,0,3,3,"dummy"
"224869",53,0,0,53,"dummy"
"224871",0,0,1,1,"dummy"
"224872",1,1,0,2,"dummy"
"224873",9,0,2,11,"dummy"
"224874",0,0,0,0,"dummy"
"224875",0,9,2,11,"dummy"
"224877",1,1,0,2,"dummy"
"224879",0,0,1,1,"dummy"
"224880",1,2,2,5,"dummy"
"224881",0,0,0,0,"dummy"
"224888",0,0,1,1,"dummy"
"224889",0,1,0,1,"dummy"
"224890",0,0,3,3,"dummy"
"224891",0,1,0,1,"dummy"
"224892",0,0,1,1,"dummy"
"224893",0,3,0,3,"dummy"
"224895",3,9,0,12,"dummy"
"224896",4,4,3,11,"dummy"
"224897",0,0,1,1,"dummy"
"224898",0,2,0,2,"dummy"
"224899",0,2,0,2,"dummy"
"224900",0,1,3,4,"dummy"
"224901",0,0,1,1,"dummy"
"224907",0,1,0,1,"dummy"
"224908",0,1,0,1,"dummy"
"224909",0,0,0,0,"dummy"
"224913",0,0,0,0,"dummy"
"224914",0,0,2,2,"dummy"
"224915",0,1,0,1,"dummy"
"224916",2,0,0,2,"dummy"
"224918",3,6,0,9,"dummy"
"224919",1,0,1,2,"dummy"
"224921",1,1,0,2,"dummy"
"224922",1,1,0,2,"dummy"
"224923",0,0,1,1,"dummy"
"224925",5,2,4,11,"dummy"
"224930",0,0,2,2,"dummy"
"224934",0,0,1,1,"dummy"
"224935",1,0,1,2,"dummy"
"224936",0,0,1,1,"dummy"
"224937",0,0,0,0,"dummy"
"224938",0,0,1,1,"dummy"
"224939",0,2,0,2,"dummy"
"224940",0,1,0,1,"dummy"
"224941",0,0,1,1,"dummy"
"224942",0,1,0,1,"dummy"
"224943",0,0,1,1,"dummy"
"224944",0,0,0,0,"dummy"
"224945",0,0,1,1,"dummy"
"224946",0,0,1,1,"dummy"
"224947",0,0,0,0,"dummy"
"224951",0,1,2,3,"dummy"
"224952",0,1,0,1,"dummy"
"224954",0,0,1,1,"dummy"
"224955",0,3,0,3,"dummy"
"225011",0,1,0,1,"dummy"
"225013",0,0,2,2,"dummy"
"225014",0,0,1,1,"dummy"
"225015",0,0,1,1,"dummy"
"225017",1,0,0,1,"dummy"
"225018",2,0,1,3,"dummy"
"225019",0,0,0,0,"dummy"
"225020",0,1,0,1,"dummy"
"225021",8,1,0,9,"dummy"
"225022",0,0,0,0,"dummy"
"225023",0,0,0,0,"dummy"
"225024",1,10,0,11,"dummy"
"225025",7,1,0,8,"dummy"
"225026",2,0,3,5,"dummy"
"225054",0,0,0,0,"dummy"
"225057",0,0,0,0,"dummy"
"225063",0,0,1,1,"dummy"
"225064",0,1,0,1,"dummy"
"225065",5,1,0,6,"dummy"
"225066",0,4,0,4,"dummy"
"225067",0,0,1,1,"dummy"
"225068",0,0,1,1,"dummy"
"225069",0,1,0,1,"dummy"
"225070",0,0,3,3,"dummy"
"225071",0,2,2,4,"dummy"
"225072",7,2,4,13,"dummy"
"225073",2,3,1,6,"dummy"
"225074",2,7,0,9,"dummy"
"225077",19,1,1,21,"dummy"
"225078",1,0,1,2,"dummy"
"225080",5,1,4,10,"dummy"
"225082",0,0,1,1,"dummy"
"225083",0,0,1,1,"dummy"
"225084",6,11,1,18,"dummy"
"225085",0,1,0,1,"dummy"
"225087",0,1,3,4,"dummy"
"225088",0,2,0,2,"dummy"
"225090",0,3,1,4,"dummy"
"225106",0,0,0,0,"dummy"
"225107",0,0,0,0,"dummy"
"225109",0,1,0,1,"dummy"
"225110",2,2,1,5,"dummy"
"225111",0,1,0,1,"dummy"
"225112",0,0,1,1,"dummy"
"225113",2,3,0,5,"dummy"
"225114",0,2,0,2,"dummy"
"225115",0,0,2,2,"dummy"
"225119",0,1,0,1,"dummy"
"225120",0,0,1,1,"dummy"
"225121",0,1,0,1,"dummy"
"225122",0,0,1,1,"dummy"
"225123",0,1,0,1,"dummy"
"225128",0,20,4,24,"dummy"
"225129",0,0,7,7,"dummy"
"225131",0,3,1,4,"dummy"
"225132",0,2,2,4,"dummy"
"225133",5,6,0,11,"dummy"
"225136",0,4,0,4,"dummy"
"225137",1,0,0,1,"dummy"
"225140",0,1,0,1,"dummy"
"225141",0,0,1,1,"dummy"
"225143",0,1,0,1,"dummy"
"225144",0,8,0,8,"dummy"
"225145",1,3,0,4,"dummy"
"225146",0,0,1,1,"dummy"
"225148",0,2,0,2,"dummy"
"225150",0,0,2,2,"dummy"
"225152",0,1,1,2,"dummy"
"225153",0,0,0,0,"dummy"
"225159",0,1,0,1,"dummy"
"225160",0,4,1,5,"dummy"
"225163",0,0,1,1,"dummy"
"225164",4,5,1,10,"dummy"
"225165",0,3,0,3,"dummy"
"225170",0,0,1,1,"dummy"
"225171",0,0,1,1,"dummy"
"225172",0,0,1,1,"dummy"
"225173",0,0,1,1,"dummy"
"225174",0,0,1,1,"dummy"
"225177",1,9,4,14,"dummy"
"225179",0,1,0,1,"dummy"
"225180",0,1,0,1,"dummy"
"225181",0,1,0,1,"dummy"
"225182",6,2,0,8,"dummy"
"225183",3,0,0,3,"dummy"
"225184",3,3,0,6,"dummy"
"225185",5,9,2,16,"dummy"
"225186",0,1,0,1,"dummy"
"225187",0,0,1,1,"dummy"
"225188",0,0,2,2,"dummy"
"225189",0,1,0,1,"dummy"
"225190",0,0,1,1,"dummy"
"225192",0,0,1,1,"dummy"
"225193",2,1,0,3,"dummy"
"225194",6,21,4,31,"dummy"
"225195",0,0,1,1,"dummy"
"225196",4,3,0,7,"dummy"
"225197",0,2,0,2,"dummy"
"225198",0,4,0,4,"dummy"
"225199",0,0,0,0,"dummy"
"225200",0,1,0,1,"dummy"
"225201",0,3,1,4,"dummy"
"225202",7,1,1,9,"dummy"
"225203",0,1,1,2,"dummy"
"225204",0,8,2,10,"dummy"
"225205",0,7,0,7,"dummy"
"225206",1,0,0,1,"dummy"
"225208",0,0,2,2,"dummy"
"225209",0,0,2,2,"dummy"
"225212",0,11,2,13,"dummy"
"225215",0,14,1,15,"dummy"
"225216",17,33,5,55,"dummy"
"225217",18,1,7,26,"dummy"
"225218",0,8,1,9,"dummy"
"225219",0,1,0,1,"dummy"
"225220",0,3,0,3,"dummy"
"225221",0,3,0,3,"dummy"
"225222",0,5,0,5,"dummy"
"225223",0,0,1,1,"dummy"
"225224",8,2,1,11,"dummy"
"225225",0,0,1,1,"dummy"
"225226",0,0,6,6,"dummy"
"225227",1,6,2,9,"dummy"
"225228",1,0,0,1,"dummy"
"225229",0,2,0,2,"dummy"
"225231",0,4,0,4,"dummy"
"225233",0,1,0,1,"dummy"
"225237",0,0,3,3,"dummy"
"225238",0,0,3,3,"dummy"
"225239",0,0,1,1,"dummy"
"225240",0,0,1,1,"dummy"
"225242",2,2,0,4,"dummy"
"225243",1,2,0,3,"dummy"
"225244",1,3,1,5,"dummy"
"225245",0,0,1,1,"dummy"
"225247",0,1,0,1,"dummy"
"225248",0,1,0,1,"dummy"
"225249",0,0,2,2,"dummy"
"225251",1,15,3,19,"dummy"
"225252",0,0,0,0,"dummy"
"225253",0,10,0,10,"dummy"
"225254",0,4,1,5,"dummy"
"225255",3,3,2,8,"dummy"
"225256",9,10,4,23,"dummy"
"225257",0,0,1,1,"dummy"
"225258",0,1,1,2,"dummy"
"225259",0,0,1,1,"dummy"
"225260",0,2,1,3,"dummy"
"225261",7,2,1,10,"dummy"
"225262",11,16,0,27,"dummy"
"225263",0,2,0,2,"dummy"
"225264",0,1,6,7,"dummy"
"225265",0,0,2,2,"dummy"
"225266",0,0,1,1,"dummy"
"225267",19,5,3,27,"dummy"
"225268",9,8,4,21,"dummy"
"225269",0,2,0,2,"dummy"
"225271",0,2,0,2,"dummy"
"225272",8,2,1,11,"dummy"
"225273",0,14,1,15,"dummy"
"225277",0,0,0,0,"dummy"
"225278",0,0,0,0,"dummy"
"225279",0,1,0,1,"dummy"
"225280",0,0,0,0,"dummy"
"225281",0,0,0,0,"dummy"
"225283",0,0,2,2,"dummy"
"225284",0,0,1,1,"dummy"
"225288",3,8,2,13,"dummy"
"225289",0,0,0,0,"dummy"
"225290",0,0,0,0,"dummy"
"225291",34,11,4,49,"dummy"
"225292",0,0,0,0,"dummy"
"225293",0,0,0,0,"dummy"
"225307",1,0,2,3,"dummy"
"225308",0,1,2,3,"dummy"
"225309",1,1,0,2,"dummy"
"225344",0,1,0,1,"dummy"
"225346",0,0,0,0,"dummy"
"225347",1,0,0,1,"dummy"
"225348",0,0,1,1,"dummy"
"225349",2,0,0,2,"dummy"
"225350",0,0,1,1,"dummy"
"225351",0,1,0,1,"dummy"
"225352",0,2,0,2,"dummy"
"225355",0,2,0,2,"dummy"
"225356",3,2,3,8,"dummy"
"225357",2,4,0,6,"dummy"
"225358",0,2,0,2,"dummy"
"225359",0,3,0,3,"dummy"
"225360",5,8,0,13,"dummy"
"225361",7,4,2,13,"dummy"
"225362",2,0,1,3,"dummy"
"225363",3,3,0,6,"dummy"
"225364",0,2,0,2,"dummy"
"225365",0,8,0,8,"dummy"
"225366",0,2,0,2,"dummy"
"225367",0,1,0,1,"dummy"
"225368",1,3,0,4,"dummy"
"225369",0,2,0,2,"dummy"
"225370",4,0,0,4,"dummy"
"225371",1,0,0,1,"dummy"
"225372",0,0,1,1,"dummy"
"225373",24,16,0,40,"dummy"
"225376",0,8,1,9,"dummy"
"225377",1,4,1,6,"dummy"
"225378",19,29,3,51,"dummy"
"225379",5,3,1,9,"dummy"
"225380",0,0,2,2,"dummy"
"225381",1,2,0,3,"dummy"
"225382",0,1,0,1,"dummy"
"225388",0,0,0,0,"dummy"
"225389",4,6,1,11,"dummy"
"225390",1,1,0,2,"dummy"
"225391",3,0,1,4,"dummy"
"225392",0,1,1,2,"dummy"
"225393",5,2,1,8,"dummy"
"225394",1,4,1,6,"dummy"
"225395",2,0,0,2,"dummy"
"225396",0,4,1,5,"dummy"
"225397",0,1,1,2,"dummy"
"225398",0,6,0,6,"dummy"
"225399",8,14,1,23,"dummy"
"225400",1,1,0,2,"dummy"
"225401",1,8,1,10,"dummy"
"225402",0,2,0,2,"dummy"
"225403",2,5,0,7,"dummy"
"225409",0,0,1,1,"dummy"
"225410",0,0,1,1,"dummy"
"225411",1,1,4,6,"dummy"
"225424",0,1,0,1,"dummy"
"225425",1,1,0,2,"dummy"
"225426",1,1,0,2,"dummy"
"225427",0,1,0,1,"dummy"
"225428",1,0,0,1,"dummy"
"225429",0,1,0,1,"dummy"
"225430",1,2,0,3,"dummy"
"225431",2,1,0,3,"dummy"
"225432",4,2,2,8,"dummy"
"225433",1,0,0,1,"dummy"
"225434",0,1,0,1,"dummy"
"225435",2,0,0,2,"dummy"
"225436",0,2,0,2,"dummy"
"225437",1,0,0,1,"dummy"
"225438",1,1,0,2,"dummy"
"225439",0,0,3,3,"dummy"
"225440",0,1,0,1,"dummy"
"225441",0,0,1,1,"dummy"
"225442",0,0,3,3,"dummy"
"225444",0,1,0,1,"dummy"
"225446",1,1,0,2,"dummy"
"225447",1,1,0,2,"dummy"
"225451",0,0,1,1,"dummy"
"225457",0,1,0,1,"dummy"
"225458",0,1,0,1,"dummy"
"225463",0,3,0,3,"dummy"
"225465",4,4,3,11,"dummy"
"225466",0,0,1,1,"dummy"
"225467",1,1,2,4,"dummy"
"225470",0,0,2,2,"dummy"
"225471",0,0,2,2,"dummy"
"225472",0,0,1,1,"dummy"
"225473",0,0,1,1,"dummy"
"225475",0,7,3,10,"dummy"
"225476",1,0,0,1,"dummy"
"225477",0,1,0,1,"dummy"
"225480",2,6,0,8,"dummy"
"225481",0,0,0,0,"dummy"
"225486",2,0,0,2,"dummy"
"225487",0,0,0,0,"dummy"
"225489",1,0,0,1,"dummy"
"225491",0,0,2,2,"dummy"
"225492",0,0,1,1,"dummy"
"225494",0,0,0,0,"dummy"
"225495",0,1,0,1,"dummy"
"225496",0,0,1,1,"dummy"
"225497",0,0,0,0,"dummy"
"225499",0,4,0,4,"dummy"
"225508",4,0,2,6,"dummy"
"225511",2,0,0,2,"dummy"
"225515",3,6,3,12,"dummy"
"225516",0,1,12,13,"dummy"
"225517",0,0,0,0,"dummy"
"225518",3,0,1,4,"dummy"
"225519",0,1,0,1,"dummy"
"225520",1,10,0,11,"dummy"
"225521",7,22,2,31,"dummy"
"225522",0,4,0,4,"dummy"
"225523",11,14,0,25,"dummy"
"225524",2,4,0,6,"dummy"
"225525",3,0,0,3,"dummy"
"225526",1,0,0,1,"dummy"
"225527",1,0,0,1,"dummy"
"225528",7,0,0,7,"dummy"
"225529",8,0,0,8,"dummy"
"225530",1,4,2,7,"dummy"
"225531",0,0,2,2,"dummy"
"225536",0,0,1,1,"dummy"
"225537",0,1,0,1,"dummy"
"225538",0,0,1,1,"dummy"
"225539",0,0,1,1,"dummy"
"225540",1,1,0,2,"dummy"
"225541",0,1,0,1,"dummy"
"225543",0,9,0,9,"dummy"
"225544",8,11,2,21,"dummy"
"225545",4,5,0,9,"dummy"
"225546",1,3,0,4,"dummy"
"225547",0,1,0,1,"dummy"
"225548",0,1,0,1,"dummy"
"225549",0,0,1,1,"dummy"
"225550",0,1,0,1,"dummy"
"225551",0,0,1,1,"dummy"
"225552",0,1,0,1,"dummy"
"225553",0,1,0,1,"dummy"
"225554",0,0,1,1,"dummy"
"225555",0,0,1,1,"dummy"
"225556",1,1,0,2,"dummy"
"225557",0,0,1,1,"dummy"
"225558",0,0,1,1,"dummy"
"225559",0,0,1,1,"dummy"
"225560",0,3,0,3,"dummy"
"225561",1,0,0,1,"dummy"
"225562",1,0,0,1,"dummy"
"225563",0,0,1,1,"dummy"
"225564",2,0,2,4,"dummy"
"225565",0,0,1,1,"dummy"
"225568",0,5,0,5,"dummy"
"225569",7,3,1,11,"dummy"
"225570",0,0,1,1,"dummy"
"225571",0,0,1,1,"dummy"
"225572",0,0,1,1,"dummy"
"225573",0,0,1,1,"dummy"
"225574",0,0,1,1,"dummy"
"225575",0,0,1,1,"dummy"
"225576",0,0,0,0,"dummy"
"225577",0,0,1,1,"dummy"
"225582",1,0,0,1,"dummy"
"225583",0,0,1,1,"dummy"
"225584",2,0,0,2,"dummy"
"225585",0,0,1,1,"dummy"
"225586",0,2,0,2,"dummy"
"225587",0,2,0,2,"dummy"
"225588",2,0,0,2,"dummy"
"225589",0,2,0,2,"dummy"
"225590",1,0,0,1,"dummy"
"225591",0,0,0,0,"dummy"
"225592",4,1,0,5,"dummy"
"225593",1,0,0,1,"dummy"
"225594",0,0,0,0,"dummy"
"225595",0,0,0,0,"dummy"
"225605",3,3,0,6,"dummy"
"225608",0,0,1,1,"dummy"
"225611",0,0,1,1,"dummy"
"225612",0,0,1,1,"dummy"
"225613",0,0,1,1,"dummy"
"225614",0,0,1,1,"dummy"
"225615",0,0,1,1,"dummy"
"225616",0,0,4,4,"dummy"
"225617",0,0,1,1,"dummy"
"225618",0,0,1,1,"dummy"
"225619",0,0,1,1,"dummy"
"225620",0,0,1,1,"dummy"
"225640",0,1,0,1,"dummy"
"225641",0,1,0,1,"dummy"
"225642",2,0,3,5,"dummy"
"225643",4,3,0,7,"dummy"
"225644",0,1,0,1,"dummy"
"225645",0,0,0,0,"dummy"
"225648",6,22,1,29,"dummy"
"225651",2,1,0,3,"dummy"
"225658",0,22,2,24,"dummy"
"225659",0,2,1,3,"dummy"
"225660",2,3,1,6,"dummy"
"225661",7,3,0,10,"dummy"
"225662",0,1,0,1,"dummy"
"225663",0,2,0,2,"dummy"
"225664",0,1,0,1,"dummy"
"225675",0,0,1,1,"dummy"
"225676",0,0,1,1,"dummy"
"225677",0,0,1,1,"dummy"
"225684",0,2,1,3,"dummy"
"225685",0,3,0,3,"dummy"
"225699",0,0,0,0,"dummy"
"225715",11,2,2,15,"dummy"
"225716",0,1,0,1,"dummy"
"225739",0,0,0,0,"dummy"
"225740",0,0,0,0,"dummy"
"225741",0,0,0,0,"dummy"
"225742",0,0,0,0,"dummy"
"225757",0,0,3,3,"dummy"
"225758",0,0,3,3,"dummy"
"225759",4,2,1,7,"dummy"
"225764",0,0,1,1,"dummy"
"225765",2,10,0,12,"dummy"
"225766",0,1,0,1,"dummy"
"225769",0,0,1,1,"dummy"
"225770",2,0,0,2,"dummy"
"225771",0,8,0,8,"dummy"
"225804",4,4,3,11,"dummy"
"225805",2,4,0,6,"dummy"
"225806",0,0,1,1,"dummy"
"225807",0,2,0,2,"dummy"
"225808",0,0,1,1,"dummy"
"225809",0,0,2,2,"dummy"
"225810",0,0,2,2,"dummy"
"225811",0,0,2,2,"dummy"
"225812",0,3,0,3,"dummy"
"225813",0,0,1,1,"dummy"
"225814",0,4,1,5,"dummy"
"225815",0,2,0,2,"dummy"
"225816",3,4,1,8,"dummy"
"225845",0,1,0,1,"dummy"
"225846",0,0,1,1,"dummy"
"225597",1,0,0,1,"dummy"
"225598",1,4,0,5,"dummy"
"225622",0,2,0,2,"dummy"
"225627",0,10,0,10,"dummy"
"225632",2,10,0,12,"dummy"
"225633",0,3,0,3,"dummy"
"225634",13,5,2,20,"dummy"
"225637",1,1,0,2,"dummy"
"225638",0,0,3,3,"dummy"
"225653",0,0,0,0,"dummy"
"225654",0,0,0,0,"dummy"
"225655",0,0,0,0,"dummy"
"225656",0,0,0,0,"dummy"
"225666",0,3,2,5,"dummy"
"225667",9,0,4,13,"dummy"
"225670",0,0,0,0,"dummy"
"225671",0,1,0,1,"dummy"
"225687",1,9,3,13,"dummy"
"225688",0,4,2,6,"dummy"
"225689",0,1,4,5,"dummy"
"225690",1,1,0,2,"dummy"
"225691",0,0,7,7,"dummy"
"225692",0,0,2,2,"dummy"
"225693",0,1,8,9,"dummy"
"225694",0,2,2,4,"dummy"
"225695",0,12,2,14,"dummy"
"225696",8,3,9,20,"dummy"
"225697",0,0,9,9,"dummy"
"225701",0,3,0,3,"dummy"
"225718",0,0,1,1,"dummy"
"225719",0,0,0,0,"dummy"
"225720",0,0,0,0,"dummy"
"225775",1,0,0,1,"dummy"
"225776",14,16,6,36,"dummy"
"225777",0,1,1,2,"dummy"
"225778",0,1,0,1,"dummy"
"225779",0,3,3,6,"dummy"
"225780",3,5,6,14,"dummy"
"225781",4,9,2,15,"dummy"
"225782",0,2,0,2,"dummy"
"225783",0,2,0,2,"dummy"
"225784",30,45,5,80,"dummy"
"225785",39,30,5,74,"dummy"
"225786",1,2,0,3,"dummy"
"225787",2,7,0,9,"dummy"
"225788",9,1,0,10,"dummy"
"225789",6,10,0,16,"dummy"
"225790",8,5,3,16,"dummy"
"225791",0,1,0,1,"dummy"
"225792",15,25,6,46,"dummy"
"225793",2,0,0,2,"dummy"
"225794",4,12,6,22,"dummy"
"225795",1,0,0,1,"dummy"
"225796",2,3,2,7,"dummy"
"225797",5,5,0,10,"dummy"
"225798",0,1,0,1,"dummy"
"225799",0,0,1,1,"dummy"
"225800",4,0,3,7,"dummy"
"225818",0,1,1,2,"dummy"
"225819",0,2,0,2,"dummy"
"225820",0,0,1,1,"dummy"
"225821",0,1,0,1,"dummy"
"225822",1,0,1,2,"dummy"
"225823",0,1,0,1,"dummy"
"225824",2,0,1,3,"dummy"
"225825",0,0,1,1,"dummy"
"225826",0,0,1,1,"dummy"
"225827",0,2,0,2,"dummy"
"225828",0,0,1,1,"dummy"
"225829",0,1,0,1,"dummy"
"225830",0,0,1,1,"dummy"
"225831",0,0,1,1,"dummy"
"225832",0,1,0,1,"dummy"
"225833",0,0,1,1,"dummy"
"225834",0,0,1,1,"dummy"
"225835",0,0,1,1,"dummy"
"225836",0,0,1,1,"dummy"
"225837",1,14,2,17,"dummy"
"225843",0,0,1,1,"dummy"
"225852",1,5,0,6,"dummy"
"225853",1,0,0,1,"dummy"
"225854",0,0,1,1,"dummy"
"225866",0,0,1,1,"dummy"
"225867",13,10,7,30,"dummy"
"225868",0,0,1,1,"dummy"
"225869",0,0,1,1,"dummy"
"225870",2,3,1,6,"dummy"
"225871",0,0,1,1,"dummy"
"225872",6,1,5,12,"dummy"
"225873",0,4,1,5,"dummy"
"225885",0,1,0,1,"dummy"
"225886",0,1,0,1,"dummy"
"225889",0,1,2,3,"dummy"
"225890",1,0,1,2,"dummy"
"225891",3,0,1,4,"dummy"
"225892",1,0,0,1,"dummy"
"225893",0,0,0,0,"dummy"
"225901",3,1,1,5,"dummy"
"225902",1,2,1,4,"dummy"
"225903",2,2,4,8,"dummy"
"225906",2,2,0,4,"dummy"
"225907",4,0,1,5,"dummy"
"225908",13,1,2,16,"dummy"
"225921",16,1,0,17,"dummy"
"225922",0,1,0,1,"dummy"
"225923",23,10,2,35,"dummy"
"225924",0,0,1,1,"dummy"
"225925",0,0,0,0,"dummy"
"225926",0,4,0,4,"dummy"
"225933",0,1,2,3,"dummy"
"225934",0,1,0,1,"dummy"
"225935",0,2,0,2,"dummy"
"225952",0,0,1,1,"dummy"
"225953",0,0,1,1,"dummy"
"225954",0,0,1,1,"dummy"
"225955",10,0,0,10,"dummy"
"225965",0,1,0,1,"dummy"
"225966",2,2,0,4,"dummy"
"225967",2,1,0,3,"dummy"
"225968",0,0,1,1,"dummy"
"225969",3,2,1,6,"dummy"
"225992",0,5,2,7,"dummy"
"225993",1,6,1,8,"dummy"
"225994",0,9,0,9,"dummy"
"225995",0,2,0,2,"dummy"
"225996",2,0,0,2,"dummy"
"225997",22,15,0,37,"dummy"
"225998",0,0,0,0,"dummy"
"225999",0,0,0,0,"dummy"
"226000",0,0,0,0,"dummy"
"226001",0,1,0,1,"dummy"
"226002",0,1,0,1,"dummy"
"226003",0,0,1,1,"dummy"
"226004",0,0,0,0,"dummy"
"226005",4,0,0,4,"dummy"
"226006",0,0,0,0,"dummy"
"225847",0,0,0,0,"dummy"
"225856",6,7,4,17,"dummy"
"225857",0,1,1,2,"dummy"
"225858",0,0,1,1,"dummy"
"225859",1,0,0,1,"dummy"
"225860",0,0,1,1,"dummy"
"225861",0,0,1,1,"dummy"
"225862",0,0,1,1,"dummy"
"225863",0,2,0,2,"dummy"
"225864",2,0,0,2,"dummy"
"225875",0,2,0,2,"dummy"
"225876",0,1,0,1,"dummy"
"225877",0,1,0,1,"dummy"
"225878",0,2,0,2,"dummy"
"225879",0,0,3,3,"dummy"
"225880",0,1,0,1,"dummy"
"225881",0,0,1,1,"dummy"
"225895",0,0,0,0,"dummy"
"225896",0,1,0,1,"dummy"
"225897",0,4,1,5,"dummy"
"225910",0,0,2,2,"dummy"
"225913",0,1,1,2,"dummy"
"225914",0,1,0,1,"dummy"
"225915",0,0,1,1,"dummy"
"225916",0,0,1,1,"dummy"
"225919",0,1,0,1,"dummy"
"225930",0,0,0,0,"dummy"
"225931",0,0,0,0,"dummy"
"225937",0,1,2,3,"dummy"
"225938",0,1,0,1,"dummy"
"225957",0,3,0,3,"dummy"
"225958",0,13,1,14,"dummy"
"225959",13,0,0,13,"dummy"
"225960",1,0,0,1,"dummy"
"225961",0,0,1,1,"dummy"
"225962",0,0,0,0,"dummy"
"225963",0,0,1,1,"dummy"
"225973",0,0,0,0,"dummy"
"225974",0,0,0,0,"dummy"
"225975",0,0,0,0,"dummy"
"225976",0,0,0,0,"dummy"
"225977",0,0,0,0,"dummy"
"225978",0,5,1,6,"dummy"
"225979",1,1,0,2,"dummy"
"225980",0,0,0,0,"dummy"
"225981",7,0,1,8,"dummy"
"225982",0,0,0,0,"dummy"
"225983",0,0,0,0,"dummy"
"225984",1,0,0,1,"dummy"
"225985",0,0,0,0,"dummy"
"225986",0,0,0,0,"dummy"
"225987",0,0,0,0,"dummy"
"225988",0,0,0,0,"dummy"
"225989",0,0,0,0,"dummy"
"225990",0,0,0,0,"dummy"
"226008",2,1,0,3,"dummy"
"226009",0,1,0,1,"dummy"
"226011",0,2,1,3,"dummy"
"226012",0,0,0,0,"dummy"
"226013",0,0,3,3,"dummy"
"226016",1,0,1,2,"dummy"
"226020",0,0,1,1,"dummy"
"226021",0,0,1,1,"dummy"
"226023",0,1,0,1,"dummy"
"226024",0,1,0,1,"dummy"
"226025",0,2,0,2,"dummy"
"226028",0,2,1,3,"dummy"
"226029",0,0,1,1,"dummy"
"226030",0,2,0,2,"dummy"
"226031",1,3,1,5,"dummy"
"226033",1,8,1,10,"dummy"
"226036",0,0,0,0,"dummy"
"226037",0,7,0,7,"dummy"
"226038",1,6,0,7,"dummy"
"226039",2,0,0,2,"dummy"
"226040",1,0,0,1,"dummy"
"226042",23,1,4,28,"dummy"
"226045",0,0,0,0,"dummy"
"226046",2,1,3,6,"dummy"
"226047",0,2,1,3,"dummy"
"226048",0,0,2,2,"dummy"
"226049",2,9,1,12,"dummy"
"226050",0,0,1,1,"dummy"
"226051",8,4,5,17,"dummy"
"226052",2,9,4,15,"dummy"
"226053",13,2,7,22,"dummy"
"226054",0,0,3,3,"dummy"
"226058",0,0,1,1,"dummy"
"226059",0,0,1,1,"dummy"
"226060",0,0,1,1,"dummy"
"226061",0,0,1,1,"dummy"
"226062",0,0,1,1,"dummy"
"226063",0,0,0,0,"dummy"
"226064",0,2,1,3,"dummy"
"226065",1,2,0,3,"dummy"
"226072",2,5,0,7,"dummy"
"226073",0,3,0,3,"dummy"
"226074",1,0,3,4,"dummy"
"226075",0,0,0,0,"dummy"
"226076",0,6,0,6,"dummy"
"226077",2,0,0,2,"dummy"
"226078",1,13,2,16,"dummy"
"226079",15,9,0,24,"dummy"
"226080",1,1,0,2,"dummy"
"226081",1,1,0,2,"dummy"
"226083",0,3,0,3,"dummy"
"226084",0,1,0,1,"dummy"
"226085",1,12,4,17,"dummy"
"226086",1,1,0,2,"dummy"
"226087",1,0,0,1,"dummy"
"226091",0,3,0,3,"dummy"
"226092",0,1,0,1,"dummy"
"226093",0,2,0,2,"dummy"
"226094",6,0,0,6,"dummy"
"226096",0,1,0,1,"dummy"
"226097",0,3,0,3,"dummy"
"226098",3,0,3,6,"dummy"
"226099",0,2,0,2,"dummy"
"226100",2,0,1,3,"dummy"
"226101",1,1,0,2,"dummy"
"226102",1,1,0,2,"dummy"
"226103",0,0,1,1,"dummy"
"226104",0,1,0,1,"dummy"
"226105",1,0,0,1,"dummy"
"226106",1,6,0,7,"dummy"
"226107",6,1,0,7,"dummy"
"226108",0,1,0,1,"dummy"
"226109",0,1,0,1,"dummy"
"226110",0,0,1,1,"dummy"
"226112",0,0,1,1,"dummy"
"226113",1,0,1,2,"dummy"
"226114",0,0,1,1,"dummy"
"226115",0,1,1,2,"dummy"
"226118",4,6,2,12,"dummy"
"226119",0,1,0,1,"dummy"
"226120",0,1,0,1,"dummy"
"226123",0,0,1,1,"dummy"
"226124",0,1,1,2,"dummy"
"226125",0,0,1,1,"dummy"
"226133",0,1,0,1,"dummy"
"226135",0,1,0,1,"dummy"
"226136",2,0,0,2,"dummy"
"226145",9,3,2,14,"dummy"
"226150",0,1,0,1,"dummy"
"226153",4,12,2,18,"dummy"
"226154",1,0,0,1,"dummy"
"226167",3,3,3,9,"dummy"
"226168",3,1,0,4,"dummy"
"226169",0,0,1,1,"dummy"
"226170",0,2,1,3,"dummy"
"226171",1,0,0,1,"dummy"
"226173",0,2,0,2,"dummy"
"226177",0,3,0,3,"dummy"
"226178",0,3,0,3,"dummy"
"226183",1,0,0,1,"dummy"
"226185",0,1,0,1,"dummy"
"226189",1,3,2,6,"dummy"
"226190",3,1,0,4,"dummy"
"226191",0,0,3,3,"dummy"
"226196",0,0,3,3,"dummy"
"226199",3,14,3,20,"dummy"
"226200",0,0,0,0,"dummy"
"226201",7,7,0,14,"dummy"
"226202",0,1,0,1,"dummy"
"226203",1,0,0,1,"dummy"
"226233",0,2,1,3,"dummy"
"226235",0,0,3,3,"dummy"
"226237",0,0,1,1,"dummy"
"226239",0,4,0,4,"dummy"
"226240",0,0,1,1,"dummy"
"226242",0,1,0,1,"dummy"
"226245",0,0,3,3,"dummy"
"226246",0,3,0,3,"dummy"
"226247",0,0,1,1,"dummy"
"226248",3,0,0,3,"dummy"
"226249",12,0,3,15,"dummy"
"226259",0,0,2,2,"dummy"
"226260",0,5,0,5,"dummy"
"226261",1,0,2,3,"dummy"
"226262",1,2,2,5,"dummy"
"226263",3,0,1,4,"dummy"
"226264",0,3,0,3,"dummy"
"226265",0,1,0,1,"dummy"
"226266",0,0,1,1,"dummy"
"226267",0,3,0,3,"dummy"
"226268",0,1,1,2,"dummy"
"226269",0,1,1,2,"dummy"
"226272",0,0,0,0,"dummy"
"226274",0,6,0,6,"dummy"
"226275",1,5,0,6,"dummy"
"226276",5,1,0,6,"dummy"
"226277",1,5,1,7,"dummy"
"226278",2,4,0,6,"dummy"
"226279",2,0,0,2,"dummy"
"226280",0,0,1,1,"dummy"
"226281",3,3,0,6,"dummy"
"226283",0,0,1,1,"dummy"
"226284",0,0,1,1,"dummy"
"226285",2,2,0,4,"dummy"
"226286",0,8,0,8,"dummy"
"226287",0,0,1,1,"dummy"
"226288",0,0,1,1,"dummy"
"226291",0,0,1,1,"dummy"
"226294",0,1,0,1,"dummy"
"226301",2,3,1,6,"dummy"
"226302",0,0,1,1,"dummy"
"226303",0,5,0,5,"dummy"
"226304",0,0,0,0,"dummy"
"226305",3,0,0,3,"dummy"
"226306",12,0,2,14,"dummy"
"226307",0,0,1,1,"dummy"
"226308",0,0,1,1,"dummy"
"226309",0,10,1,11,"dummy"
"226312",1,1,1,3,"dummy"
"226322",0,0,0,0,"dummy"
"226323",0,2,0,2,"dummy"
"226324",0,0,1,1,"dummy"
"226325",0,1,0,1,"dummy"
"226348",2,15,1,18,"dummy"
"226349",4,4,1,9,"dummy"
"226350",0,1,0,1,"dummy"
"226351",0,0,2,2,"dummy"
"226352",2,0,2,4,"dummy"
"226353",0,0,1,1,"dummy"
"226354",0,0,1,1,"dummy"
"226357",0,1,0,1,"dummy"
"226358",1,1,1,3,"dummy"
"226359",0,2,0,2,"dummy"
"226360",9,3,2,14,"dummy"
"226361",0,1,0,1,"dummy"
"226362",0,4,1,5,"dummy"
"226363",0,2,0,2,"dummy"
"226364",0,3,0,3,"dummy"
"226365",3,0,0,3,"dummy"
"226366",0,1,0,1,"dummy"
"226367",6,0,1,7,"dummy"
"226368",0,1,0,1,"dummy"
"226376",0,1,0,1,"dummy"
"226377",1,0,0,1,"dummy"
"226380",0,4,0,4,"dummy"
"226383",0,2,2,4,"dummy"
"226384",0,0,1,1,"dummy"
"226385",1,0,0,1,"dummy"
"226386",0,0,2,2,"dummy"
"226387",0,0,1,1,"dummy"
"226388",0,2,1,3,"dummy"
"226415",0,0,2,2,"dummy"
"226416",0,0,1,1,"dummy"
"226417",1,1,1,3,"dummy"
"226418",4,4,0,8,"dummy"
"226419",0,0,1,1,"dummy"
"226420",0,1,0,1,"dummy"
"226421",2,1,0,3,"dummy"
"226422",0,1,0,1,"dummy"
"226423",0,1,0,1,"dummy"
"226426",0,0,1,1,"dummy"
"226427",0,0,1,1,"dummy"
"226428",0,1,2,3,"dummy"
"226429",1,0,2,3,"dummy"
"226430",1,5,2,8,"dummy"
"226439",0,2,0,2,"dummy"
"226442",0,1,0,1,"dummy"
"226447",0,1,0,1,"dummy"
"226456",1,4,3,8,"dummy"
"226474",0,1,0,1,"dummy"
"226475",0,0,1,1,"dummy"
"226480",0,6,2,8,"dummy"
"226481",0,1,0,1,"dummy"
"226482",0,0,4,4,"dummy"
"226483",0,1,0,1,"dummy"
"226484",0,0,1,1,"dummy"
"226485",0,0,1,1,"dummy"
"226486",0,0,1,1,"dummy"
"226487",0,0,1,1,"dummy"
"226493",0,2,2,4,"dummy"
"226494",1,0,0,1,"dummy"
"226501",0,2,0,2,"dummy"
"226504",0,0,1,1,"dummy"
"226505",0,0,1,1,"dummy"
"226506",1,1,1,3,"dummy"
"226507",0,1,0,1,"dummy"
"226508",0,1,0,1,"dummy"
"226509",0,0,1,1,"dummy"
"226510",12,0,0,12,"dummy"
"226511",0,1,0,1,"dummy"
"226512",0,1,0,1,"dummy"
"226513",3,3,1,7,"dummy"
"226514",0,0,2,2,"dummy"
"226515",0,1,0,1,"dummy"
"226516",0,1,0,1,"dummy"
"226517",0,4,0,4,"dummy"
"226518",5,7,0,12,"dummy"
"226314",0,3,0,3,"dummy"
"226315",3,5,4,12,"dummy"
"226316",0,1,1,2,"dummy"
"226317",0,1,3,4,"dummy"
"226318",1,0,0,1,"dummy"
"226319",0,1,3,4,"dummy"
"226320",3,1,0,4,"dummy"
"226327",8,10,5,23,"dummy"
"226328",0,1,0,1,"dummy"
"226331",0,2,0,2,"dummy"
"226332",1,0,1,2,"dummy"
"226339",0,0,0,0,"dummy"
"226340",0,0,0,0,"dummy"
"226370",1,0,1,2,"dummy"
"226371",0,0,2,2,"dummy"
"226372",1,0,0,1,"dummy"
"226373",0,3,4,7,"dummy"
"226374",0,2,0,2,"dummy"
"226390",10,19,0,29,"dummy"
"226391",0,4,0,4,"dummy"
"226392",4,5,2,11,"dummy"
"226393",0,5,0,5,"dummy"
"226394",0,0,0,0,"dummy"
"226395",1,11,1,13,"dummy"
"226396",0,5,2,7,"dummy"
"226397",0,5,0,5,"dummy"
"226398",0,0,1,1,"dummy"
"226399",0,1,0,1,"dummy"
"226400",12,21,4,37,"dummy"
"226401",22,8,5,35,"dummy"
"226402",6,21,4,31,"dummy"
"226403",0,0,1,1,"dummy"
"226404",0,0,4,4,"dummy"
"226405",0,6,0,6,"dummy"
"226406",0,0,2,2,"dummy"
"226409",0,0,1,1,"dummy"
"226412",0,0,3,3,"dummy"
"226413",0,0,1,1,"dummy"
"226444",0,1,1,2,"dummy"
"226445",1,0,1,2,"dummy"
"226449",0,4,0,4,"dummy"
"226452",0,0,1,1,"dummy"
"226458",0,0,0,0,"dummy"
"226459",0,0,0,0,"dummy"
"226462",0,0,1,1,"dummy"
"226463",0,0,1,1,"dummy"
"226489",0,0,3,3,"dummy"
"226490",0,0,1,1,"dummy"
"226491",0,0,1,1,"dummy"
"226496",0,3,0,3,"dummy"
"226497",9,10,0,19,"dummy"
"226498",4,6,0,10,"dummy"
"226499",0,0,1,1,"dummy"
"226527",0,0,1,1,"dummy"
"226528",0,0,1,1,"dummy"
"226529",0,0,2,2,"dummy"
"226530",26,3,7,36,"dummy"
"226619",0,1,0,1,"dummy"
"226620",0,1,0,1,"dummy"
"226621",0,0,1,1,"dummy"
"226622",0,1,1,2,"dummy"
"226519",1,2,0,3,"dummy"
"226520",3,3,3,9,"dummy"
"226521",6,5,1,12,"dummy"
"226522",0,2,0,2,"dummy"
"226523",0,2,0,2,"dummy"
"226536",4,21,3,28,"dummy"
"226537",0,0,1,1,"dummy"
"226538",1,3,0,4,"dummy"
"226539",0,0,0,0,"dummy"
"226540",1,1,0,2,"dummy"
"226541",5,4,0,9,"dummy"
"226542",4,5,7,16,"dummy"
"226543",0,0,7,7,"dummy"
"226544",0,1,0,1,"dummy"
"226545",0,0,2,2,"dummy"
"226546",0,0,1,1,"dummy"
"226547",1,1,0,2,"dummy"
"226548",0,0,1,1,"dummy"
"226549",0,3,0,3,"dummy"
"226550",1,0,2,3,"dummy"
"226551",0,9,0,9,"dummy"
"226552",4,4,0,8,"dummy"
"226553",0,1,1,2,"dummy"
"226554",8,8,3,19,"dummy"
"226557",0,1,0,1,"dummy"
"226560",1,3,1,5,"dummy"
"226561",0,0,2,2,"dummy"
"226562",5,6,1,12,"dummy"
"226563",2,5,0,7,"dummy"
"226564",2,0,0,2,"dummy"
"226565",0,6,0,6,"dummy"
"226566",2,1,0,3,"dummy"
"226567",0,2,0,2,"dummy"
"226578",0,0,1,1,"dummy"
"226579",0,0,1,1,"dummy"
"226580",0,0,1,1,"dummy"
"226581",0,0,1,1,"dummy"
"226582",0,0,1,1,"dummy"
"226583",0,0,1,1,"dummy"
"226609",31,23,0,54,"dummy"
"226610",1,0,0,1,"dummy"
"226611",1,0,0,1,"dummy"
"226612",0,2,0,2,"dummy"
"226613",0,1,1,2,"dummy"
"226614",0,1,1,2,"dummy"
"226615",2,2,1,5,"dummy"
"226630",0,0,0,0,"dummy"
"226631",0,1,0,1,"dummy"
"226637",0,0,1,1,"dummy"
"226638",0,0,0,0,"dummy"
"226639",0,1,0,1,"dummy"
"226640",1,2,0,3,"dummy"
"226641",0,1,0,1,"dummy"
"226642",1,10,1,12,"dummy"
"226643",1,1,0,2,"dummy"
"226644",0,0,1,1,"dummy"
"226645",0,0,1,1,"dummy"
"226646",0,1,0,1,"dummy"
"226647",7,2,0,9,"dummy"
"226648",0,1,0,1,"dummy"
"226649",0,0,1,1,"dummy"
"226650",0,0,1,1,"dummy"
"226651",0,0,1,1,"dummy"
"226652",0,0,2,2,"dummy"
"226653",0,0,1,1,"dummy"
"226654",0,1,1,2,"dummy"
"226655",0,8,0,8,"dummy"
"226656",0,0,0,0,"dummy"
"226659",7,0,0,7,"dummy"
"226660",0,0,1,1,"dummy"
"226661",9,17,4,30,"dummy"
"226662",3,0,2,5,"dummy"
"226663",0,0,1,1,"dummy"
"226664",0,0,1,1,"dummy"
"226665",0,0,0,0,"dummy"
"226666",0,0,1,1,"dummy"
"226667",1,1,0,2,"dummy"
"226668",1,1,0,2,"dummy"
"226669",0,1,0,1,"dummy"
"226670",0,0,1,1,"dummy"
"226671",0,0,1,1,"dummy"
"226672",0,0,1,1,"dummy"
"226673",0,2,2,4,"dummy"
"226674",0,0,1,1,"dummy"
"226675",0,0,1,1,"dummy"
"226676",0,0,1,1,"dummy"
"226677",0,0,1,1,"dummy"
"226678",0,0,1,1,"dummy"
"226679",0,0,1,1,"dummy"
"226682",0,5,0,5,"dummy"
"226683",0,0,1,1,"dummy"
"226704",0,0,1,1,"dummy"
"226705",0,0,0,0,"dummy"
"226743",0,0,1,1,"dummy"
"226744",0,0,1,1,"dummy"
"226745",0,0,1,1,"dummy"
"226746",0,0,1,1,"dummy"
"226749",18,28,3,49,"dummy"
"226778",2,4,0,6,"dummy"
"226779",0,2,0,2,"dummy"
"226780",0,2,0,2,"dummy"
"226781",10,2,0,12,"dummy"
"226782",0,2,0,2,"dummy"
"226783",0,0,0,0,"dummy"
"226784",0,0,3,3,"dummy"
"226785",0,5,0,5,"dummy"
"226786",1,0,1,2,"dummy"
"226791",3,5,2,10,"dummy"
"226792",0,0,0,0,"dummy"
"226806",0,0,1,1,"dummy"
"226807",0,0,0,0,"dummy"
"226808",0,2,1,3,"dummy"
"226809",2,1,3,6,"dummy"
"226810",3,0,0,3,"dummy"
"226813",0,0,1,1,"dummy"
"226814",0,0,1,1,"dummy"
"226815",9,10,3,22,"dummy"
"226816",0,0,1,1,"dummy"
"226817",0,0,1,1,"dummy"
"226818",0,0,1,1,"dummy"
"226819",0,0,1,1,"dummy"
"226820",0,0,1,1,"dummy"
"226821",0,5,0,5,"dummy"
"226826",0,0,2,2,"dummy"
"226829",1,0,0,1,"dummy"
"226688",19,24,3,46,"dummy"
"226697",1,1,0,2,"dummy"
"226698",0,1,0,1,"dummy"
"226699",1,0,0,1,"dummy"
"226700",0,0,1,1,"dummy"
"226711",0,0,1,1,"dummy"
"226714",0,1,1,2,"dummy"
"226715",14,0,0,14,"dummy"
"226721",4,5,0,9,"dummy"
"226788",0,0,0,0,"dummy"
"226789",11,0,2,13,"dummy"
"226831",0,0,1,1,"dummy"
"226843",1,0,1,2,"dummy"
"226846",0,5,0,5,"dummy"
"226849",8,1,0,9,"dummy"
"226850",1,10,0,11,"dummy"
"226851",1,1,0,2,"dummy"
"226852",1,0,0,1,"dummy"
"226853",0,1,0,1,"dummy"
"226854",0,1,0,1,"dummy"
"226855",0,1,0,1,"dummy"
"226856",0,0,1,1,"dummy"
"226857",1,1,0,2,"dummy"
"226858",0,0,0,0,"dummy"
"226859",0,0,1,1,"dummy"
"226860",1,1,0,2,"dummy"
"226861",0,1,0,1,"dummy"
"226862",0,1,0,1,"dummy"
"226863",0,1,0,1,"dummy"
"226864",0,1,0,1,"dummy"
"226865",0,0,1,1,"dummy"
"226866",1,1,0,2,"dummy"
"226867",0,0,1,1,"dummy"
"226870",1,2,0,3,"dummy"
"226871",2,1,0,3,"dummy"
"226873",0,0,1,1,"dummy"
"226878",0,6,2,8,"dummy"
"226879",1,8,0,9,"dummy"
"226888",0,0,0,0,"dummy"
"226889",0,0,1,1,"dummy"
"226902",1,0,2,3,"dummy"
"226903",0,0,1,1,"dummy"
"226915",0,3,0,3,"dummy"
"226916",0,8,0,8,"dummy"
"226917",2,5,0,7,"dummy"
"226918",2,2,0,4,"dummy"
"226919",2,4,0,6,"dummy"
"226920",3,3,1,7,"dummy"
"226959",1,5,1,7,"dummy"
"226979",0,1,0,1,"dummy"
"226980",5,31,1,37,"dummy"
"226981",0,1,0,1,"dummy"
"226982",0,1,2,3,"dummy"
"226983",0,3,0,3,"dummy"
"226984",1,2,1,4,"dummy"
"226985",0,0,1,1,"dummy"
"226986",0,1,0,1,"dummy"
"226997",0,0,1,1,"dummy"
"227001",4,2,0,6,"dummy"
"227002",0,0,2,2,"dummy"
"227003",3,2,1,6,"dummy"
"227004",0,0,0,0,"dummy"
"227005",0,0,0,0,"dummy"
"227006",2,1,2,5,"dummy"
"227007",0,0,0,0,"dummy"
"227021",0,0,0,0,"dummy"
"227022",0,0,0,0,"dummy"
"227138",0,0,1,1,"dummy"
"227139",0,0,1,1,"dummy"
"227140",0,0,1,1,"dummy"
"227141",0,0,1,1,"dummy"
"227142",0,0,1,1,"dummy"
"227143",0,0,1,1,"dummy"
"227144",0,0,1,1,"dummy"
"227145",0,0,1,1,"dummy"
"227146",0,0,1,1,"dummy"
"227147",0,0,1,1,"dummy"
"227148",0,0,1,1,"dummy"
"227149",0,0,1,1,"dummy"
"227150",0,0,1,1,"dummy"
"227151",5,1,2,8,"dummy"
"227152",0,0,1,1,"dummy"
"227153",0,0,0,0,"dummy"
"227154",0,0,1,1,"dummy"
"227170",1,1,0,2,"dummy"
"227178",2,2,0,4,"dummy"
"226881",4,12,0,16,"dummy"
"226886",1,23,3,27,"dummy"
"226891",0,1,1,2,"dummy"
"226892",2,0,0,2,"dummy"
"226893",1,14,1,16,"dummy"
"226894",0,0,1,1,"dummy"
"226895",0,1,0,1,"dummy"
"226896",0,1,3,4,"dummy"
"226897",1,0,3,4,"dummy"
"226900",0,1,0,1,"dummy"
"226905",0,4,0,4,"dummy"
"226906",0,0,1,1,"dummy"
"226907",0,1,0,1,"dummy"
"226908",0,3,0,3,"dummy"
"226909",0,2,0,2,"dummy"
"226922",0,2,0,2,"dummy"
"226923",0,0,3,3,"dummy"
"226924",0,4,0,4,"dummy"
"226925",0,2,0,2,"dummy"
"226926",2,0,0,2,"dummy"
"226927",0,1,0,1,"dummy"
"226928",3,1,2,6,"dummy"
"226963",0,0,1,1,"dummy"
"226964",0,0,1,1,"dummy"
"226965",0,0,1,1,"dummy"
"226966",0,1,0,1,"dummy"
"226967",0,0,1,1,"dummy"
"226968",1,0,0,1,"dummy"
"226969",0,1,1,2,"dummy"
"226970",3,2,3,8,"dummy"
"226971",0,0,1,1,"dummy"
"226972",2,0,0,2,"dummy"
"226973",0,2,0,2,"dummy"
"226974",0,1,0,1,"dummy"
"226975",0,1,1,2,"dummy"
"226976",0,1,4,5,"dummy"
"226977",1,1,0,2,"dummy"
"226990",0,0,1,1,"dummy"
"226993",0,0,1,1,"dummy"
"226999",1,0,0,1,"dummy"
"227014",0,0,1,1,"dummy"
"227015",0,2,0,2,"dummy"
"227016",0,0,2,2,"dummy"
"227017",0,1,0,1,"dummy"
"227018",0,0,2,2,"dummy"
"227019",11,4,1,16,"dummy"
"227028",0,1,0,1,"dummy"
"227029",0,11,2,13,"dummy"
"227160",0,1,0,1,"dummy"
"227161",0,3,0,3,"dummy"
"227162",0,1,0,1,"dummy"
"227163",0,2,0,2,"dummy"
"227164",2,2,0,4,"dummy"
"227167",0,0,1,1,"dummy"
"227168",0,0,1,1,"dummy"
"227172",1,13,1,15,"dummy"
"227173",0,1,0,1,"dummy"
"227174",10,17,1,28,"dummy"
"227175",0,27,0,27,"dummy"
"227176",0,2,0,2,"dummy"
"227180",1,0,0,1,"dummy"
"227185",0,1,0,1,"dummy"
"227186",0,0,1,1,"dummy"
"227187",0,0,1,1,"dummy"
"227188",0,0,1,1,"dummy"
"227190",0,1,0,1,"dummy"
"227197",3,0,0,3,"dummy"
"227199",0,2,0,2,"dummy"
"227200",0,0,0,0,"dummy"
"227201",0,1,0,1,"dummy"
"227204",2,2,0,4,"dummy"
"227205",0,0,2,2,"dummy"
"227206",0,1,2,3,"dummy"
"227207",2,2,0,4,"dummy"
"227208",2,0,0,2,"dummy"
"227209",0,2,0,2,"dummy"
"227211",0,0,0,0,"dummy"
"227212",2,1,1,4,"dummy"
"227224",0,6,0,6,"dummy"
"227232",0,0,1,1,"dummy"
"227234",0,1,0,1,"dummy"
"227235",0,0,1,1,"dummy"
"227237",0,1,0,1,"dummy"
"227238",0,3,0,3,"dummy"
"227239",0,9,4,13,"dummy"
"227240",0,1,0,1,"dummy"
"227241",1,2,1,4,"dummy"
"227242",1,1,2,4,"dummy"
"227243",0,1,0,1,"dummy"
"227244",0,2,0,2,"dummy"
"227245",0,1,1,2,"dummy"
"227257",5,3,3,11,"dummy"
"227259",2,0,0,2,"dummy"
"227260",0,0,1,1,"dummy"
"227261",0,0,1,1,"dummy"
"227262",0,0,0,0,"dummy"
"227263",0,0,1,1,"dummy"
"227264",0,0,2,2,"dummy"
"227265",0,0,2,2,"dummy"
"227266",0,0,2,2,"dummy"
"227267",1,1,2,4,"dummy"
"227268",5,19,1,25,"dummy"
"227269",0,1,2,3,"dummy"
"227270",0,0,2,2,"dummy"
"227271",0,1,3,4,"dummy"
"227272",0,0,1,1,"dummy"
"227273",0,0,2,2,"dummy"
"227274",0,0,2,2,"dummy"
"227275",0,0,2,2,"dummy"
"227276",0,0,2,2,"dummy"
"227277",0,0,2,2,"dummy"
"227278",0,0,2,2,"dummy"
"227279",0,0,2,2,"dummy"
"227280",0,0,2,2,"dummy"
"227282",0,0,1,1,"dummy"
"227284",0,0,1,1,"dummy"
"227288",4,2,0,6,"dummy"
"227289",0,1,1,2,"dummy"
"227290",0,0,1,1,"dummy"
"227291",0,1,0,1,"dummy"
"227292",0,0,1,1,"dummy"
"227293",0,0,1,1,"dummy"
"227294",1,1,1,3,"dummy"
"227295",0,1,0,1,"dummy"
"227296",0,4,0,4,"dummy"
"227297",0,2,0,2,"dummy"
"227298",0,1,0,1,"dummy"
"227299",0,1,0,1,"dummy"
"227300",0,1,0,1,"dummy"
"227301",0,0,1,1,"dummy"
"227302",7,2,2,11,"dummy"
"227303",0,1,0,1,"dummy"
"227304",0,1,0,1,"dummy"
"227305",0,0,1,1,"dummy"
"227308",0,1,0,1,"dummy"
"227319",2,0,2,4,"dummy"
"227320",0,0,1,1,"dummy"
"227321",0,0,1,1,"dummy"
"227322",0,0,1,1,"dummy"
"227323",0,0,1,1,"dummy"
"227324",0,0,1,1,"dummy"
"227327",0,2,0,2,"dummy"
"227329",11,1,0,12,"dummy"
"227330",0,2,0,2,"dummy"
"227335",0,0,0,0,"dummy"
"227336",0,2,0,2,"dummy"
"227337",0,0,0,0,"dummy"
"227338",0,0,1,1,"dummy"
"227339",0,0,0,0,"dummy"
"227341",0,1,0,1,"dummy"
"227361",0,0,3,3,"dummy"
"227363",0,1,0,1,"dummy"
"227364",6,3,0,9,"dummy"
"227365",1,13,0,14,"dummy"
"227366",0,1,0,1,"dummy"
"227367",9,8,0,17,"dummy"
"227369",0,1,0,1,"dummy"
"227370",0,0,0,0,"dummy"
"227371",1,2,0,3,"dummy"
"227372",2,2,0,4,"dummy"
"227373",2,8,0,10,"dummy"
"227374",1,2,0,3,"dummy"
"227375",0,1,3,4,"dummy"
"227376",1,1,0,2,"dummy"
"227377",1,0,3,4,"dummy"
"227378",0,1,3,4,"dummy"
"227379",0,1,0,1,"dummy"
"227380",10,6,2,18,"dummy"
"227381",2,0,0,2,"dummy"
"227382",0,0,1,1,"dummy"
"227383",16,7,5,28,"dummy"
"227384",7,4,2,13,"dummy"
"227385",1,3,1,5,"dummy"
"227386",9,1,0,10,"dummy"
"227387",3,1,1,5,"dummy"
"227388",0,4,1,5,"dummy"
"227389",5,0,1,6,"dummy"
"227390",0,0,0,0,"dummy"
"227398",0,0,2,2,"dummy"
"227399",0,0,2,2,"dummy"
"227400",0,0,2,2,"dummy"
"227402",2,0,0,2,"dummy"
"227403",2,1,1,4,"dummy"
"227405",5,0,0,5,"dummy"
"227406",1,0,0,1,"dummy"
"227413",0,1,0,1,"dummy"
"227414",1,0,1,2,"dummy"
"227422",0,0,1,1,"dummy"
"227423",1,0,0,1,"dummy"
"227424",0,0,1,1,"dummy"
"227425",0,0,3,3,"dummy"
"227426",0,0,1,1,"dummy"
"227427",0,2,0,2,"dummy"
"227428",0,0,1,1,"dummy"
"227429",0,0,1,1,"dummy"
"227430",0,0,1,1,"dummy"
"227431",0,0,1,1,"dummy"
"227432",0,0,2,2,"dummy"
"227433",0,0,1,1,"dummy"
"227434",0,0,1,1,"dummy"
"227435",0,0,4,4,"dummy"
"227436",2,3,8,13,"dummy"
"227437",0,0,1,1,"dummy"
"227438",0,4,3,7,"dummy"
"227439",1,0,3,4,"dummy"
"227440",0,3,0,3,"dummy"
"227441",0,0,1,1,"dummy"
"227442",0,0,4,4,"dummy"
"227443",0,1,4,5,"dummy"
"227444",0,0,1,1,"dummy"
"227445",1,3,4,8,"dummy"
"227446",0,0,4,4,"dummy"
"227447",0,0,4,4,"dummy"
"227448",0,0,1,1,"dummy"
"227449",0,0,4,4,"dummy"
"227450",0,0,1,1,"dummy"
"227451",0,0,1,1,"dummy"
"227452",0,0,4,4,"dummy"
"227453",0,0,5,5,"dummy"
"227454",0,0,5,5,"dummy"
"227457",1,14,2,17,"dummy"
"227460",1,0,2,3,"dummy"
"227463",0,0,0,0,"dummy"
"227464",0,1,0,1,"dummy"
"227465",0,2,0,2,"dummy"
"227469",0,1,0,1,"dummy"
"227470",5,2,3,10,"dummy"
"227471",2,5,2,9,"dummy"
"227481",3,10,2,15,"dummy"
"227483",0,1,1,2,"dummy"
"227484",0,1,0,1,"dummy"
"227487",2,5,2,9,"dummy"
"227535",0,1,1,2,"dummy"
"227536",0,0,1,1,"dummy"
"227537",0,5,2,7,"dummy"
"227538",0,0,1,1,"dummy"
"227544",0,0,2,2,"dummy"
"227545",0,0,1,1,"dummy"
"227547",0,0,1,1,"dummy"
"227548",0,0,1,1,"dummy"
"227549",0,0,1,1,"dummy"
"227553",0,1,2,3,"dummy"
"227554",2,2,1,5,"dummy"
"227555",1,0,0,1,"dummy"
"227557",0,7,0,7,"dummy"
"227571",4,4,1,9,"dummy"
"227572",4,4,1,9,"dummy"
"227573",2,2,2,6,"dummy"
"227574",0,0,1,1,"dummy"
"227575",22,23,0,45,"dummy"
"227576",21,27,0,48,"dummy"
"227581",2,5,2,9,"dummy"
"227593",0,1,0,1,"dummy"
"227594",1,0,0,1,"dummy"
"227595",0,1,0,1,"dummy"
"227596",0,1,0,1,"dummy"
"227598",1,1,0,2,"dummy"
"227599",4,15,5,24,"dummy"
"227600",6,6,1,13,"dummy"
"227601",0,4,3,7,"dummy"
"227602",4,0,1,5,"dummy"
"227603",0,0,1,1,"dummy"
"227604",0,0,0,0,"dummy"
"227605",0,0,1,1,"dummy"
"227606",0,0,0,0,"dummy"
"227607",0,1,0,1,"dummy"
"227608",0,0,0,0,"dummy"
"227609",0,0,1,1,"dummy"
"227615",0,2,0,2,"dummy"
"227618",1,0,0,1,"dummy"
"227619",4,12,2,18,"dummy"
"227622",0,4,0,4,"dummy"
"227623",3,10,0,13,"dummy"
"227624",0,3,0,3,"dummy"
"227625",0,5,0,5,"dummy"
"227627",0,0,3,3,"dummy"
"227628",3,2,0,5,"dummy"
"227652",7,6,1,14,"dummy"
"227653",3,3,1,7,"dummy"
"227654",1,0,1,2,"dummy"
"227655",0,0,1,1,"dummy"
"227659",0,1,0,1,"dummy"
"227660",2,8,0,10,"dummy"
"227661",0,0,1,1,"dummy"
"227662",0,0,0,0,"dummy"
"227663",0,2,0,2,"dummy"
"227664",0,1,0,1,"dummy"
"227665",0,2,0,2,"dummy"
"227666",1,1,0,2,"dummy"
"227667",1,2,0,3,"dummy"
"227668",2,0,4,6,"dummy"
"227670",0,0,1,1,"dummy"
"227671",0,12,1,13,"dummy"
"227672",5,5,1,11,"dummy"
"227674",9,0,0,9,"dummy"
"227677",0,1,0,1,"dummy"
"227678",0,3,0,3,"dummy"
"227679",0,3,1,4,"dummy"
"227680",1,0,2,3,"dummy"
"227681",3,14,0,17,"dummy"
"227682",0,2,1,3,"dummy"
"227683",0,2,0,2,"dummy"
"227684",3,15,0,18,"dummy"
"227685",2,0,0,2,"dummy"
"227686",1,0,0,1,"dummy"
"227687",0,1,0,1,"dummy"
"227688",1,2,2,5,"dummy"
"227689",0,1,0,1,"dummy"
"227690",21,8,3,32,"dummy"
"227691",1,5,0,6,"dummy"
"227692",0,1,0,1,"dummy"
"227693",0,4,0,4,"dummy"
"227694",0,1,2,3,"dummy"
"227695",0,2,0,2,"dummy"
"227696",0,0,0,0,"dummy"
"227697",0,4,0,4,"dummy"
"227698",12,0,3,15,"dummy"
"227699",0,14,3,17,"dummy"
"227700",11,0,3,14,"dummy"
"227701",0,0,1,1,"dummy"
"227702",0,3,0,3,"dummy"
"227703",0,1,0,1,"dummy"
"227704",0,0,1,1,"dummy"
"227705",0,0,0,0,"dummy"
"227706",0,0,0,0,"dummy"
"227707",0,0,0,0,"dummy"
"227708",0,0,0,0,"dummy"
"227709",1,0,1,2,"dummy"
"227710",0,2,0,2,"dummy"
"227712",2,5,5,12,"dummy"
"227728",0,1,0,1,"dummy"
"227729",2,1,0,3,"dummy"
"227730",1,3,0,4,"dummy"
"227731",1,5,5,11,"dummy"
"227732",0,0,1,1,"dummy"
"227733",0,0,0,0,"dummy"
"227739",0,0,0,0,"dummy"
"227740",0,0,0,0,"dummy"
"227762",0,0,1,1,"dummy"
"227763",12,10,2,24,"dummy"
"227795",0,3,0,3,"dummy"
"227798",4,8,1,13,"dummy"
"227799",0,5,0,5,"dummy"
"227802",0,0,0,0,"dummy"
"227804",2,0,3,5,"dummy"
"227809",1,2,1,4,"dummy"
"227811",0,0,0,0,"dummy"
"227812",0,0,1,1,"dummy"
"227814",0,0,1,1,"dummy"
"227815",3,2,0,5,"dummy"
"227816",6,20,3,29,"dummy"
"227817",0,1,0,1,"dummy"
"227821",1,1,1,3,"dummy"
"227822",1,2,2,5,"dummy"
"227823",2,3,0,5,"dummy"
"227824",1,6,3,10,"dummy"
"227825",7,0,1,8,"dummy"
"227826",0,7,1,8,"dummy"
"227828",0,1,0,1,"dummy"
"227829",0,1,0,1,"dummy"
"227831",5,15,2,22,"dummy"
"227832",0,1,0,1,"dummy"
"227833",0,2,0,2,"dummy"
"227834",0,10,0,10,"dummy"
"227835",0,1,0,1,"dummy"
"227836",0,1,0,1,"dummy"
"227837",1,2,0,3,"dummy"
"227838",0,3,0,3,"dummy"
"227839",5,0,0,5,"dummy"
"227840",6,12,2,20,"dummy"
"227841",0,2,0,2,"dummy"
"227842",3,0,0,3,"dummy"
"227843",8,9,1,18,"dummy"
"227851",0,0,1,1,"dummy"
"227852",0,0,1,1,"dummy"
"227853",1,0,1,2,"dummy"
"227854",0,1,0,1,"dummy"
"227855",1,0,1,2,"dummy"
"227856",2,2,0,4,"dummy"
"227857",0,1,3,4,"dummy"
"227860",22,5,2,29,"dummy"
"227861",7,16,2,25,"dummy"
"227863",0,0,1,1,"dummy"
"227864",0,0,1,1,"dummy"
"227866",0,2,0,2,"dummy"
"227872",0,2,0,2,"dummy"
"227873",1,0,1,2,"dummy"
"227877",0,0,0,0,"dummy"
"227878",0,3,1,4,"dummy"
"227879",0,1,0,1,"dummy"
"227882",0,0,0,0,"dummy"
"227884",17,0,4,21,"dummy"
"227885",1,9,3,13,"dummy"
"227888",0,2,0,2,"dummy"
"227889",0,0,1,1,"dummy"
"227895",0,0,2,2,"dummy"
"227896",0,0,1,1,"dummy"
"227899",0,1,0,1,"dummy"
"227900",0,0,0,0,"dummy"
"227901",0,0,0,0,"dummy"
"227902",0,0,0,0,"dummy"
"227903",0,0,0,0,"dummy"
"227904",0,0,1,1,"dummy"
"227905",0,0,0,0,"dummy"
"227906",0,0,0,0,"dummy"
"227907",0,0,0,0,"dummy"
"227908",0,1,0,1,"dummy"
"227909",0,0,0,0,"dummy"
"227910",0,0,0,0,"dummy"
"227911",0,0,0,0,"dummy"
"227912",0,0,0,0,"dummy"
"227913",0,0,0,0,"dummy"
"227914",0,0,0,0,"dummy"
"227915",0,0,0,0,"dummy"
"227916",0,1,0,1,"dummy"
"227918",2,2,0,4,"dummy"
"227920",0,3,0,3,"dummy"
"227926",2,1,0,3,"dummy"
"227929",1,0,0,1,"dummy"
"227930",0,1,0,1,"dummy"
"227931",7,17,4,28,"dummy"
"227936",3,5,1,9,"dummy"
"227937",3,0,1,4,"dummy"
"227938",0,3,1,4,"dummy"
"227940",1,4,0,5,"dummy"
"227941",0,8,0,8,"dummy"
"227943",3,0,3,6,"dummy"
"227945",0,4,0,4,"dummy"
"227947",0,2,1,3,"dummy"
"227948",0,3,0,3,"dummy"
"227952",1,2,1,4,"dummy"
"227953",1,0,0,1,"dummy"
"227957",0,1,0,1,"dummy"
"227958",1,1,1,3,"dummy"
"227959",0,0,1,1,"dummy"
"227960",2,2,0,4,"dummy"
"227962",1,6,0,7,"dummy"
"227963",2,2,1,5,"dummy"
"227964",0,1,0,1,"dummy"
"227978",7,2,3,12,"dummy"
"227979",0,1,0,1,"dummy"
"227982",0,1,0,1,"dummy"
"227983",0,0,1,1,"dummy"
"227984",1,0,0,1,"dummy"
"227989",13,4,0,17,"dummy"
"227990",10,14,2,26,"dummy"
"228009",0,2,0,2,"dummy"
"228010",0,0,1,1,"dummy"
"228011",0,0,2,2,"dummy"
"228012",0,0,1,1,"dummy"
"228014",0,0,0,0,"dummy"
"228019",0,1,0,1,"dummy"
"228020",0,4,0,4,"dummy"
"228021",0,0,1,1,"dummy"
"228022",0,1,0,1,"dummy"
"228023",0,0,1,1,"dummy"
"228024",0,1,0,1,"dummy"
"228025",0,0,1,1,"dummy"
"228026",0,1,0,1,"dummy"
"228027",1,3,0,4,"dummy"
"228028",0,1,0,1,"dummy"
"228029",1,4,0,5,"dummy"
"228030",0,1,0,1,"dummy"
"228034",4,20,1,25,"dummy"
"228035",0,1,0,1,"dummy"
"228043",0,0,0,0,"dummy"
"228044",0,0,1,1,"dummy"
"228048",2,0,0,2,"dummy"
"228049",0,4,1,5,"dummy"
"228050",0,0,0,0,"dummy"
"228051",0,0,0,0,"dummy"
"228052",0,0,0,0,"dummy"
"228053",0,0,2,2,"dummy"
"228054",5,2,0,7,"dummy"
"228055",1,4,0,5,"dummy"
"228056",0,0,1,1,"dummy"
"228057",0,0,1,1,"dummy"
"228058",2,1,2,5,"dummy"
"228091",1,1,0,2,"dummy"
"228092",0,0,2,2,"dummy"
"228093",0,1,0,1,"dummy"
"228094",1,4,1,6,"dummy"
"228095",0,0,2,2,"dummy"
"228096",0,1,0,1,"dummy"
"228097",0,1,0,1,"dummy"
"228098",0,2,0,2,"dummy"
"228099",0,1,0,1,"dummy"
"228101",0,1,1,2,"dummy"
"228102",2,1,2,5,"dummy"
"228103",0,0,1,1,"dummy"
"228104",0,0,1,1,"dummy"
"228105",1,0,1,2,"dummy"
"228115",0,0,1,1,"dummy"
"228116",1,0,0,1,"dummy"
"228118",4,3,1,8,"dummy"
"228119",9,2,1,12,"dummy"
"228120",1,2,1,4,"dummy"
"228122",0,0,4,4,"dummy"
"228124",3,8,3,14,"dummy"
"228125",3,0,1,4,"dummy"
"228126",12,15,0,27,"dummy"
"228127",0,4,0,4,"dummy"
"228128",0,1,0,1,"dummy"
"228137",0,0,1,1,"dummy"
"228138",0,0,1,1,"dummy"
"228139",0,0,1,1,"dummy"
"228150",0,0,1,1,"dummy"
"228151",0,0,1,1,"dummy"
"228156",1,0,0,1,"dummy"
"228165",0,2,0,2,"dummy"
"228166",0,1,2,3,"dummy"
"228167",0,8,1,9,"dummy"
"228168",0,2,0,2,"dummy"
"228169",2,0,0,2,"dummy"
"228170",0,2,0,2,"dummy"
"228171",0,2,0,2,"dummy"
"228172",0,1,0,1,"dummy"
"228173",1,0,0,1,"dummy"
"228174",12,4,1,17,"dummy"
"228175",0,0,4,4,"dummy"
"228176",2,8,2,12,"dummy"
"228177",1,0,0,1,"dummy"
"228178",0,0,0,0,"dummy"
"228179",1,1,0,2,"dummy"
"228180",1,0,0,1,"dummy"
"228181",0,0,4,4,"dummy"
"228182",0,0,4,4,"dummy"
"228183",0,0,4,4,"dummy"
"228184",0,0,4,4,"dummy"
"228185",0,2,0,2,"dummy"
"228186",0,0,4,4,"dummy"
"228187",0,0,1,1,"dummy"
"228188",0,1,5,6,"dummy"
"228189",0,0,1,1,"dummy"
"228190",0,0,1,1,"dummy"
"228191",0,0,2,2,"dummy"
"228192",0,0,1,1,"dummy"
"228193",0,0,2,2,"dummy"
"228194",0,0,1,1,"dummy"
"228195",0,0,1,1,"dummy"
"228196",0,0,1,1,"dummy"
"228197",0,2,2,4,"dummy"
"228219",0,10,1,11,"dummy"
"228220",0,3,1,4,"dummy"
"228223",0,0,0,0,"dummy"
"228224",2,6,0,8,"dummy"
"228227",3,3,2,8,"dummy"
"228228",3,1,0,4,"dummy"
"228231",0,1,0,1,"dummy"
"228232",1,0,0,1,"dummy"
"228233",0,5,0,5,"dummy"
"228234",0,1,0,1,"dummy"
"228235",6,7,1,14,"dummy"
"228246",0,0,1,1,"dummy"
"228275",0,4,0,4,"dummy"
"228276",0,1,0,1,"dummy"
"228277",0,1,0,1,"dummy"
"228278",0,0,4,4,"dummy"
"228279",0,1,4,5,"dummy"
"228280",1,1,1,3,"dummy"
"228281",1,1,6,8,"dummy"
"228352",2,7,3,12,"dummy"
"228355",0,0,0,0,"dummy"
"228356",1,0,0,1,"dummy"
"228357",0,0,1,1,"dummy"
"228358",2,0,0,2,"dummy"
"228359",0,0,1,1,"dummy"
"228360",0,1,0,1,"dummy"
"228361",0,2,0,2,"dummy"
"228362",0,0,0,0,"dummy"
"228363",0,0,0,0,"dummy"
"228364",4,0,0,4,"dummy"
"228365",0,0,0,0,"dummy"
"228366",0,0,0,0,"dummy"
"228388",0,1,0,1,"dummy"
"228389",0,1,0,1,"dummy"
"228390",0,6,0,6,"dummy"
"228141",0,1,0,1,"dummy"
"228142",11,0,1,12,"dummy"
"228147",0,0,1,1,"dummy"
"228148",0,0,0,0,"dummy"
"228153",0,0,1,1,"dummy"
"228154",0,0,1,1,"dummy"
"228158",0,2,0,2,"dummy"
"228159",0,0,0,0,"dummy"
"228160",0,0,0,0,"dummy"
"228201",0,0,2,2,"dummy"
"228204",0,2,0,2,"dummy"
"228211",0,1,2,3,"dummy"
"228212",0,0,0,0,"dummy"
"228213",0,1,0,1,"dummy"
"228214",4,0,2,6,"dummy"
"228215",1,0,0,1,"dummy"
"228216",0,0,0,0,"dummy"
"228217",0,0,0,0,"dummy"
"228269",0,0,1,1,"dummy"
"228270",0,0,1,1,"dummy"
"228271",0,1,0,1,"dummy"
"228272",1,0,0,1,"dummy"
"228273",0,0,0,0,"dummy"
"228287",2,2,0,4,"dummy"
"228288",1,7,0,8,"dummy"
"228289",2,5,1,8,"dummy"
"228290",0,1,0,1,"dummy"
"228291",0,0,1,1,"dummy"
"228292",0,1,0,1,"dummy"
"228293",1,2,0,3,"dummy"
"228385",16,6,0,22,"dummy"
"228386",4,4,0,8,"dummy"
"228408",0,4,1,5,"dummy"
"228409",0,4,0,4,"dummy"
"228415",0,8,1,9,"dummy"
"228416",0,0,1,1,"dummy"
"228417",1,0,0,1,"dummy"
"228418",7,5,0,12,"dummy"
"228419",0,3,0,3,"dummy"
"228420",0,3,0,3,"dummy"
"228421",3,5,1,9,"dummy"
"228422",3,2,0,5,"dummy"
"228423",2,0,0,2,"dummy"
"228424",0,2,1,3,"dummy"
"228425",1,1,0,2,"dummy"
"228426",1,3,1,5,"dummy"
"228427",0,2,0,2,"dummy"
"228439",0,1,0,1,"dummy"
"228440",0,0,1,1,"dummy"
"228441",0,2,0,2,"dummy"
"228442",0,0,1,1,"dummy"
"228443",0,1,0,1,"dummy"
"228444",0,0,1,1,"dummy"
"228411",7,5,0,12,"dummy"
"228429",0,1,0,1,"dummy"
"228430",0,0,1,1,"dummy"
"228431",0,1,0,1,"dummy"
"228432",1,0,0,1,"dummy"
"228433",0,0,1,1,"dummy"
"228434",0,1,0,1,"dummy"
"228435",0,2,0,2,"dummy"
"228436",0,0,1,1,"dummy"
"228437",0,5,0,5,"dummy"
"228449",0,8,5,13,"dummy"
"228450",2,0,0,2,"dummy"
"228457",3,5,1,9,"dummy"
"228458",1,1,3,5,"dummy"
"228459",1,1,3,5,"dummy"
"228461",8,5,2,15,"dummy"
"228463",0,0,1,1,"dummy"
"228464",3,3,2,8,"dummy"
"228466",0,0,1,1,"dummy"
"228475",2,0,0,2,"dummy"
"228476",0,2,0,2,"dummy"
"228478",1,25,3,29,"dummy"
"228479",0,1,0,1,"dummy"
"228481",3,1,1,5,"dummy"
"228482",2,0,0,2,"dummy"
"228483",3,2,1,6,"dummy"
"228484",2,0,0,2,"dummy"
"228485",0,0,3,3,"dummy"
"228487",0,0,1,1,"dummy"
"228488",0,2,0,2,"dummy"
"228489",3,0,0,3,"dummy"
"228490",9,9,2,20,"dummy"
"228491",0,0,1,1,"dummy"
"228492",0,0,1,1,"dummy"
"228493",2,0,0,2,"dummy"
"228495",0,1,0,1,"dummy"
"228496",3,0,0,3,"dummy"
"228497",0,8,0,8,"dummy"
"228498",15,2,1,18,"dummy"
"228499",1,7,1,9,"dummy"
"228514",7,3,4,14,"dummy"
"228515",1,1,1,3,"dummy"
"228516",1,1,1,3,"dummy"
"228524",0,2,3,5,"dummy"
"228525",0,1,0,1,"dummy"
"228527",4,1,0,5,"dummy"
"228530",0,1,0,1,"dummy"
"228531",0,1,0,1,"dummy"
"228535",1,0,0,1,"dummy"
"228537",0,0,0,0,"dummy"
"228538",0,0,0,0,"dummy"
"228540",3,4,0,7,"dummy"
"228541",0,0,1,1,"dummy"
"228542",0,0,1,1,"dummy"
"228545",4,20,1,25,"dummy"
"228546",0,1,0,1,"dummy"
"228547",4,2,1,7,"dummy"
"228550",0,0,0,0,"dummy"
"228554",1,10,1,12,"dummy"
"228555",0,0,1,1,"dummy"
"228556",5,0,1,6,"dummy"
"228557",0,1,0,1,"dummy"
"228558",0,15,0,15,"dummy"
"228559",0,0,2,2,"dummy"
"228560",0,1,0,1,"dummy"
"228561",0,1,0,1,"dummy"
"228562",0,0,3,3,"dummy"
"228563",1,0,0,1,"dummy"
"228564",14,0,0,14,"dummy"
"228565",1,0,0,1,"dummy"
"228566",0,3,0,3,"dummy"
"228567",0,3,1,4,"dummy"
"228568",0,0,1,1,"dummy"
"228569",0,0,3,3,"dummy"
"228573",0,3,0,3,"dummy"
"228577",0,1,0,1,"dummy"
"228579",0,0,1,1,"dummy"
"228580",2,1,1,4,"dummy"
"228583",0,1,0,1,"dummy"
"228585",1,3,2,6,"dummy"
"228586",0,0,1,1,"dummy"
"228589",0,0,1,1,"dummy"
"228592",4,7,1,12,"dummy"
"228593",0,2,0,2,"dummy"
"228594",0,3,3,6,"dummy"
"228595",10,1,0,11,"dummy"
"228596",0,2,0,2,"dummy"
"228597",0,0,1,1,"dummy"
"228599",0,3,0,3,"dummy"
"228600",6,22,1,29,"dummy"
"228601",0,0,3,3,"dummy"
"228602",0,3,0,3,"dummy"
"228603",2,2,0,4,"dummy"
"228604",0,1,0,1,"dummy"
"228605",0,0,0,0,"dummy"
"228606",6,2,0,8,"dummy"
"228608",2,1,1,4,"dummy"
"228609",0,1,0,1,"dummy"
"228611",0,1,0,1,"dummy"
"228612",0,0,0,0,"dummy"
"228615",0,0,1,1,"dummy"
"228622",0,1,0,1,"dummy"
"228623",0,0,1,1,"dummy"
"228628",0,2,1,3,"dummy"
"228629",0,2,0,2,"dummy"
"228630",0,4,0,4,"dummy"
"228636",1,6,0,7,"dummy"
"228637",1,0,0,1,"dummy"
"228638",1,0,1,2,"dummy"
"228639",0,0,1,1,"dummy"
"228640",0,0,1,1,"dummy"
"228641",0,0,1,1,"dummy"
"228643",2,2,1,5,"dummy"
"228645",0,1,0,1,"dummy"
"228646",0,7,0,7,"dummy"
"228647",2,0,0,2,"dummy"
"228649",2,3,0,5,"dummy"
"228650",0,1,0,1,"dummy"
"228651",10,26,3,39,"dummy"
"228653",3,4,1,8,"dummy"
"228656",0,5,1,6,"dummy"
"228657",5,1,0,6,"dummy"
"228664",0,0,1,1,"dummy"
"228665",1,0,0,1,"dummy"
"228666",0,0,2,2,"dummy"
"228667",1,1,2,4,"dummy"
"228668",0,0,2,2,"dummy"
"228669",0,0,2,2,"dummy"
"228670",0,0,2,2,"dummy"
"228673",0,0,1,1,"dummy"
"228674",1,0,0,1,"dummy"
"228678",3,4,0,7,"dummy"
"228696",0,0,1,1,"dummy"
"228720",0,0,1,1,"dummy"
"228723",0,1,0,1,"dummy"
"228724",13,13,0,26,"dummy"
"228725",11,0,0,11,"dummy"
"228736",8,9,2,19,"dummy"
"228737",0,1,0,1,"dummy"
"228738",0,1,0,1,"dummy"
"228741",2,0,0,2,"dummy"
"228755",8,8,2,18,"dummy"
"228756",0,0,1,1,"dummy"
"228757",0,1,1,2,"dummy"
"228758",0,0,2,2,"dummy"
"228759",0,0,2,2,"dummy"
"228760",0,0,2,2,"dummy"
"228761",0,0,1,1,"dummy"
"228767",21,0,0,21,"dummy"
"228768",18,2,0,20,"dummy"
"228786",0,2,0,2,"dummy"
"228793",1,1,0,2,"dummy"
"228799",12,8,8,28,"dummy"
"228803",3,1,0,4,"dummy"
"228804",8,1,0,9,"dummy"
"228809",0,3,0,3,"dummy"
"228810",25,4,4,33,"dummy"
"228811",1,18,3,22,"dummy"
"228812",30,57,7,94,"dummy"
"228813",0,0,2,2,"dummy"
"228814",3,5,2,10,"dummy"
"228815",0,6,0,6,"dummy"
"228816",4,8,1,13,"dummy"
"228817",0,0,0,0,"dummy"
"228818",59,8,7,74,"dummy"
"228819",1,2,0,3,"dummy"
"228820",2,0,1,3,"dummy"
"228821",0,2,0,2,"dummy"
"228822",0,2,1,3,"dummy"
"228823",2,2,0,4,"dummy"
"228824",0,0,1,1,"dummy"
"228825",0,4,1,5,"dummy"
"228826",0,0,1,1,"dummy"
"228827",0,2,0,2,"dummy"
"228828",21,24,9,54,"dummy"
"228829",3,2,0,5,"dummy"
"228830",0,6,1,7,"dummy"
"228831",6,0,0,6,"dummy"
"228832",0,6,0,6,"dummy"
"228837",0,5,0,5,"dummy"
"228838",0,1,0,1,"dummy"
"228867",0,0,1,1,"dummy"
"228868",0,1,0,1,"dummy"
"228869",4,15,3,22,"dummy"
"228870",2,1,0,3,"dummy"
"228877",0,7,0,7,"dummy"
"228878",0,2,0,2,"dummy"
"228879",0,2,4,6,"dummy"
"228880",1,1,1,3,"dummy"
"228881",0,3,0,3,"dummy"
"228882",0,1,0,1,"dummy"
"228883",1,1,0,2,"dummy"
"228884",0,1,0,1,"dummy"
"228885",0,0,0,0,"dummy"
"228886",0,0,1,1,"dummy"
"228887",0,0,1,1,"dummy"
"228888",0,1,0,1,"dummy"
"228900",0,0,0,0,"dummy"
"228901",1,3,2,6,"dummy"
"228904",0,1,0,1,"dummy"
"228905",0,1,1,2,"dummy"
"228906",0,0,1,1,"dummy"
"228907",17,1,0,18,"dummy"
"228908",0,0,0,0,"dummy"
"228909",5,1,3,9,"dummy"
"228691",0,0,0,0,"dummy"
"228692",1,0,1,2,"dummy"
"228693",0,0,0,0,"dummy"
"228694",0,3,2,5,"dummy"
"228707",0,0,1,1,"dummy"
"228708",0,1,0,1,"dummy"
"228713",2,0,3,5,"dummy"
"228716",1,1,0,2,"dummy"
"228717",1,1,5,7,"dummy"
"228718",1,0,5,6,"dummy"
"228743",0,0,1,1,"dummy"
"228744",22,1,2,25,"dummy"
"228745",0,0,1,1,"dummy"
"228746",0,0,1,1,"dummy"
"228747",0,0,1,1,"dummy"
"228752",6,0,0,6,"dummy"
"228753",2,5,2,9,"dummy"
"228763",0,2,0,2,"dummy"
"228764",0,1,0,1,"dummy"
"228765",0,3,0,3,"dummy"
"228772",1,4,2,7,"dummy"
"228773",0,0,1,1,"dummy"
"228774",2,0,2,4,"dummy"
"228775",3,17,1,21,"dummy"
"228776",2,3,3,8,"dummy"
"228777",48,0,0,48,"dummy"
"228778",0,0,0,0,"dummy"
"228779",0,0,0,0,"dummy"
"228780",0,0,0,0,"dummy"
"228788",0,0,0,0,"dummy"
"228789",0,1,0,1,"dummy"
"228790",0,0,1,1,"dummy"
"228791",0,1,0,1,"dummy"
"228795",0,3,4,7,"dummy"
"228801",0,0,0,0,"dummy"
"228806",3,3,4,10,"dummy"
"228807",1,0,1,2,"dummy"
"228840",0,0,1,1,"dummy"
"228841",0,0,1,1,"dummy"
"228844",0,3,1,4,"dummy"
"228845",1,0,0,1,"dummy"
"228861",0,1,0,1,"dummy"
"228862",1,2,0,3,"dummy"
"228863",0,0,0,0,"dummy"
"228864",2,0,0,2,"dummy"
"228865",0,0,0,0,"dummy"
"228872",0,2,3,5,"dummy"
"228873",0,0,2,2,"dummy"
"228874",0,0,0,0,"dummy"
"228875",2,2,0,4,"dummy"
"228892",1,0,0,1,"dummy"
"228895",0,2,0,2,"dummy"
"228896",0,0,0,0,"dummy"
"228897",0,1,0,1,"dummy"
"228898",0,1,0,1,"dummy"
"228970",0,1,0,1,"dummy"
"228971",4,3,1,8,"dummy"
"228988",13,15,2,30,"dummy"
"228989",0,0,0,0,"dummy"
"228990",0,0,1,1,"dummy"
"228991",0,0,0,0,"dummy"
"228992",15,3,1,19,"dummy"
"228993",0,1,0,1,"dummy"
"228994",0,0,1,1,"dummy"
"228999",0,0,0,0,"dummy"
"229000",0,0,0,0,"dummy"
"229001",0,0,0,0,"dummy"
"229002",0,0,0,0,"dummy"
"229003",0,0,0,0,"dummy"
"228910",2,1,1,4,"dummy"
"228911",2,4,0,6,"dummy"
"228912",1,2,0,3,"dummy"
"228913",5,1,1,7,"dummy"
"228914",0,2,0,2,"dummy"
"228915",0,1,0,1,"dummy"
"228916",2,0,0,2,"dummy"
"228917",0,0,0,0,"dummy"
"228918",0,6,0,6,"dummy"
"228919",0,0,1,1,"dummy"
"228920",3,0,0,3,"dummy"
"228921",1,4,0,5,"dummy"
"228922",0,0,1,1,"dummy"
"228923",2,2,0,4,"dummy"
"228924",0,0,1,1,"dummy"
"228925",1,0,2,3,"dummy"
"228926",7,3,3,13,"dummy"
"228927",0,0,2,2,"dummy"
"228928",0,0,1,1,"dummy"
"228929",0,0,1,1,"dummy"
"228973",0,1,0,1,"dummy"
"228974",0,0,1,1,"dummy"
"228975",0,3,0,3,"dummy"
"228976",3,0,0,3,"dummy"
"228977",0,0,0,0,"dummy"
"228982",0,2,0,2,"dummy"
"228983",4,0,1,5,"dummy"
"228984",0,1,0,1,"dummy"
"228985",0,1,0,1,"dummy"
"228986",0,1,0,1,"dummy"
"228996",0,6,0,6,"dummy"
"228997",0,2,0,2,"dummy"
"229014",0,6,1,7,"dummy"
"229024",1,12,0,13,"dummy"
"229025",1,2,0,3,"dummy"
"229026",0,1,0,1,"dummy"
"229043",0,2,0,2,"dummy"
"229044",8,3,3,14,"dummy"
"229045",2,1,0,3,"dummy"
"229079",1,0,0,1,"dummy"
"229080",3,0,0,3,"dummy"
"229102",2,2,2,6,"dummy"
"229103",1,0,0,1,"dummy"
"229104",1,0,0,1,"dummy"
"229107",0,0,1,1,"dummy"
"229108",0,0,1,1,"dummy"
"229109",2,0,2,4,"dummy"
"229110",0,0,1,1,"dummy"
"229115",0,2,0,2,"dummy"
"229119",1,1,4,6,"dummy"
"229133",2,0,0,2,"dummy"
"229134",3,3,1,7,"dummy"
"229135",0,0,1,1,"dummy"
"229136",0,2,0,2,"dummy"
"229137",1,7,0,8,"dummy"
"229138",0,0,1,1,"dummy"
"229139",3,6,1,10,"dummy"
"229140",0,0,1,1,"dummy"
"229141",4,1,0,5,"dummy"
"229142",3,2,1,6,"dummy"
"229147",3,2,4,9,"dummy"
"229004",0,0,0,0,"dummy"
"229005",0,0,0,0,"dummy"
"229006",0,0,0,0,"dummy"
"229007",0,1,0,1,"dummy"
"229018",0,1,0,1,"dummy"
"229019",0,0,3,3,"dummy"
"229020",0,0,2,2,"dummy"
"229021",0,0,2,2,"dummy"
"229022",5,7,0,12,"dummy"
"229028",0,2,3,5,"dummy"
"229029",2,3,1,6,"dummy"
"229030",0,1,1,2,"dummy"
"229031",2,0,0,2,"dummy"
"229032",0,0,1,1,"dummy"
"229033",6,7,1,14,"dummy"
"229034",3,10,2,15,"dummy"
"229035",11,6,1,18,"dummy"
"229047",0,1,0,1,"dummy"
"229048",1,5,1,7,"dummy"
"229049",0,1,0,1,"dummy"
"229050",4,2,0,6,"dummy"
"229051",0,0,0,0,"dummy"
"229052",0,1,1,2,"dummy"
"229053",1,2,0,3,"dummy"
"229054",0,1,0,1,"dummy"
"229055",13,3,0,16,"dummy"
"229056",4,13,1,18,"dummy"
"229057",13,3,0,16,"dummy"
"229058",3,12,0,15,"dummy"
"229059",2,1,0,3,"dummy"
"229060",0,0,1,1,"dummy"
"229063",0,3,1,4,"dummy"
"229064",0,6,3,9,"dummy"
"229065",1,1,0,2,"dummy"
"229066",0,5,2,7,"dummy"
"229067",5,3,1,9,"dummy"
"229068",3,3,0,6,"dummy"
"229069",2,0,0,2,"dummy"
"229070",7,0,1,8,"dummy"
"229071",0,6,1,7,"dummy"
"229072",5,0,0,5,"dummy"
"229073",6,11,0,17,"dummy"
"229074",12,6,0,18,"dummy"
"229075",0,1,0,1,"dummy"
"229117",0,1,0,1,"dummy"
"229121",1,0,0,1,"dummy"
"229124",0,0,0,0,"dummy"
"229125",23,2,3,28,"dummy"
"229126",2,5,1,8,"dummy"
"229127",5,2,1,8,"dummy"
"229128",0,1,0,1,"dummy"
"229129",2,0,1,3,"dummy"
"229158",0,1,0,1,"dummy"
"229159",9,0,0,9,"dummy"
"229171",0,0,1,1,"dummy"
"229172",0,3,2,5,"dummy"
"229175",0,0,2,2,"dummy"
"229178",0,1,0,1,"dummy"
"229179",4,3,2,9,"dummy"
"229180",0,3,0,3,"dummy"
"229181",0,0,1,1,"dummy"
"229182",0,0,1,1,"dummy"
"229183",0,0,1,1,"dummy"
"229184",0,2,2,4,"dummy"
"229185",2,6,0,8,"dummy"
"229198",0,0,0,0,"dummy"
"229199",0,0,0,0,"dummy"
"229200",1,0,0,1,"dummy"
"229201",0,0,2,2,"dummy"
"229202",0,0,0,0,"dummy"
"229203",0,0,0,0,"dummy"
"229204",0,0,0,0,"dummy"
"229205",0,0,0,0,"dummy"
"229220",0,0,0,0,"dummy"
"229221",2,1,5,8,"dummy"
"229222",0,1,3,4,"dummy"
"229223",0,10,1,11,"dummy"
"229224",0,2,0,2,"dummy"
"229161",0,4,0,4,"dummy"
"229162",0,4,0,4,"dummy"
"229163",0,1,0,1,"dummy"
"229164",1,5,0,6,"dummy"
"229165",2,1,1,4,"dummy"
"229166",0,0,2,2,"dummy"
"229167",0,5,0,5,"dummy"
"229187",4,5,0,9,"dummy"
"229188",0,0,1,1,"dummy"
"229189",0,4,1,5,"dummy"
"229190",0,0,1,1,"dummy"
"229191",0,1,0,1,"dummy"
"229192",5,5,2,12,"dummy"
"229193",0,1,0,1,"dummy"
"229196",0,2,0,2,"dummy"
"229207",1,1,0,2,"dummy"
"229208",0,1,2,3,"dummy"
"229209",0,0,1,1,"dummy"
"229210",0,0,4,4,"dummy"
"229211",0,3,0,3,"dummy"
"229212",1,0,2,3,"dummy"
"229213",0,0,5,5,"dummy"
"229214",0,0,1,1,"dummy"
"229215",0,2,0,2,"dummy"
"229216",1,1,0,2,"dummy"
"229217",1,2,5,8,"dummy"
"229218",0,1,4,5,"dummy"
"229237",0,0,1,1,"dummy"
"229255",0,2,0,2,"dummy"
"229296",0,4,1,5,"dummy"
"229297",0,2,1,3,"dummy"
"229298",0,0,1,1,"dummy"
"229299",8,6,1,15,"dummy"
"229300",0,2,2,4,"dummy"
"229301",3,5,0,8,"dummy"
"229302",0,23,4,27,"dummy"
"229303",0,0,1,1,"dummy"
"229304",1,6,0,7,"dummy"
"229305",0,0,1,1,"dummy"
"229306",0,2,1,3,"dummy"
"229307",0,4,0,4,"dummy"
"229308",1,4,0,5,"dummy"
"229309",0,5,0,5,"dummy"
"229310",0,1,0,1,"dummy"
"229311",44,2,0,46,"dummy"
"229312",1,3,0,4,"dummy"
"229313",2,1,0,3,"dummy"
"229314",8,13,4,25,"dummy"
"229315",0,0,1,1,"dummy"
"229316",0,9,2,11,"dummy"
"229317",0,0,1,1,"dummy"
"229318",0,0,0,0,"dummy"
"229319",0,2,0,2,"dummy"
"229320",0,0,2,2,"dummy"
"229325",0,0,1,1,"dummy"
"229328",0,2,0,2,"dummy"
"229329",1,1,0,2,"dummy"
"229330",1,21,3,25,"dummy"
"229331",0,1,0,1,"dummy"
"229332",22,1,3,26,"dummy"
"229333",1,24,4,29,"dummy"
"229334",0,3,0,3,"dummy"
"229335",0,1,0,1,"dummy"
"229339",0,1,0,1,"dummy"
"229340",0,0,1,1,"dummy"
"229225",3,4,0,7,"dummy"
"229226",0,1,0,1,"dummy"
"229227",0,2,1,3,"dummy"
"229228",0,1,0,1,"dummy"
"229229",0,0,2,2,"dummy"
"229230",0,0,2,2,"dummy"
"229231",1,1,1,3,"dummy"
"229232",0,1,0,1,"dummy"
"229233",6,7,0,13,"dummy"
"229234",2,1,0,3,"dummy"
"229235",0,1,0,1,"dummy"
"229322",0,0,1,1,"dummy"
"229323",0,0,1,1,"dummy"
"229337",0,0,1,1,"dummy"
"229346",1,0,0,1,"dummy"
"229386",0,2,0,2,"dummy"
"229390",0,1,0,1,"dummy"
"229391",3,2,0,5,"dummy"
"229394",0,0,1,1,"dummy"
"229395",0,3,0,3,"dummy"
"229400",8,8,6,22,"dummy"
"229401",8,8,5,21,"dummy"
"229402",0,0,1,1,"dummy"
"229403",0,0,3,3,"dummy"
"229404",6,6,3,15,"dummy"
"229405",0,0,2,2,"dummy"
"229406",0,0,1,1,"dummy"
"229407",0,0,1,1,"dummy"
"229408",0,0,2,2,"dummy"
"229409",0,0,1,1,"dummy"
"229410",0,0,2,2,"dummy"
"229411",0,0,2,2,"dummy"
"229412",0,0,2,2,"dummy"
"229413",0,0,1,1,"dummy"
"229414",0,0,2,2,"dummy"
"229415",0,0,2,2,"dummy"
"229416",0,0,2,2,"dummy"
"229417",0,0,2,2,"dummy"
"229418",0,0,2,2,"dummy"
"229419",0,0,2,2,"dummy"
"229420",0,0,2,2,"dummy"
"229421",0,0,2,2,"dummy"
"229422",0,0,2,2,"dummy"
"229423",0,0,2,2,"dummy"
"229424",0,0,2,2,"dummy"
"229425",0,0,2,2,"dummy"
"229426",0,0,2,2,"dummy"
"229427",0,0,2,2,"dummy"
"229428",0,0,2,2,"dummy"
"229443",0,4,2,6,"dummy"
"229444",0,1,0,1,"dummy"
"229445",0,0,0,0,"dummy"
"229457",0,0,1,1,"dummy"
"229462",1,1,0,2,"dummy"
"229463",4,0,4,8,"dummy"
"229466",2,2,0,4,"dummy"
"229467",2,2,0,4,"dummy"
"229468",9,0,0,9,"dummy"
"229469",0,0,0,0,"dummy"
"229470",36,0,0,36,"dummy"
"229471",0,0,0,0,"dummy"
"229472",1,0,0,1,"dummy"
"229473",0,0,3,3,"dummy"
"229474",0,0,1,1,"dummy"
"229475",0,0,0,0,"dummy"
"229476",0,0,0,0,"dummy"
"229477",0,0,0,0,"dummy"
"229478",0,0,1,1,"dummy"
"229479",0,0,1,1,"dummy"
"229480",0,0,0,0,"dummy"
"229481",71,17,9,97,"dummy"
"229491",3,4,0,7,"dummy"
"229492",0,0,1,1,"dummy"
"229493",3,4,0,7,"dummy"
"229494",4,3,0,7,"dummy"
"229499",0,0,0,0,"dummy"
"229500",0,1,1,2,"dummy"
"229501",0,0,0,0,"dummy"
"229502",1,1,1,3,"dummy"
"229503",3,1,0,4,"dummy"
"229341",10,3,3,16,"dummy"
"229342",0,0,0,0,"dummy"
"229348",0,0,1,1,"dummy"
"229349",0,0,1,1,"dummy"
"229350",0,0,1,1,"dummy"
"229351",0,0,1,1,"dummy"
"229352",1,1,2,4,"dummy"
"229353",0,0,1,1,"dummy"
"229354",0,0,1,1,"dummy"
"229355",0,2,1,3,"dummy"
"229356",0,1,0,1,"dummy"
"229357",4,1,0,5,"dummy"
"229358",0,0,1,1,"dummy"
"229359",0,1,1,2,"dummy"
"229360",0,0,1,1,"dummy"
"229361",0,0,2,2,"dummy"
"229362",0,0,1,1,"dummy"
"229363",0,0,1,1,"dummy"
"229364",0,0,1,1,"dummy"
"229365",3,2,2,7,"dummy"
"229366",0,0,1,1,"dummy"
"229367",0,0,2,2,"dummy"
"229368",0,0,1,1,"dummy"
"229369",1,0,0,1,"dummy"
"229370",1,1,0,2,"dummy"
"229371",0,0,1,1,"dummy"
"229372",0,0,1,1,"dummy"
"229373",0,0,1,1,"dummy"
"229374",0,0,1,1,"dummy"
"229375",0,0,1,1,"dummy"
"229376",0,0,1,1,"dummy"
"229377",0,0,1,1,"dummy"
"229378",0,1,1,2,"dummy"
"229379",0,0,1,1,"dummy"
"229380",0,0,3,3,"dummy"
"229388",1,2,0,3,"dummy"
"229397",1,0,0,1,"dummy"
"229398",2,0,0,2,"dummy"
"229432",0,0,1,1,"dummy"
"229433",1,2,0,3,"dummy"
"229434",0,2,0,2,"dummy"
"229435",0,2,0,2,"dummy"
"229436",5,4,1,10,"dummy"
"229437",8,6,1,15,"dummy"
"229453",0,0,3,3,"dummy"
"229483",0,7,0,7,"dummy"
"229484",0,1,0,1,"dummy"
"229485",6,0,0,6,"dummy"
"229486",0,0,0,0,"dummy"
"229489",0,0,1,1,"dummy"
"229523",0,0,1,1,"dummy"
"229524",0,4,0,4,"dummy"
"229527",0,4,0,4,"dummy"
"229546",2,2,0,4,"dummy"
"229558",0,0,1,1,"dummy"
"229559",0,4,0,4,"dummy"
"229563",0,1,0,1,"dummy"
"229581",0,0,1,1,"dummy"
"229582",6,5,2,13,"dummy"
"229583",1,0,0,1,"dummy"
"229611",0,1,0,1,"dummy"
"229612",0,0,1,1,"dummy"
"229613",0,0,1,1,"dummy"
"229614",0,2,0,2,"dummy"
"229615",0,1,0,1,"dummy"
"229616",0,2,1,3,"dummy"
"229617",0,1,0,1,"dummy"
"229504",0,0,0,0,"dummy"
"229505",6,0,0,6,"dummy"
"229529",0,11,0,11,"dummy"
"229530",1,1,1,3,"dummy"
"229531",4,1,2,7,"dummy"
"229532",1,4,0,5,"dummy"
"229535",2,2,0,4,"dummy"
"229536",0,0,1,1,"dummy"
"229537",0,0,1,1,"dummy"
"229538",0,1,0,1,"dummy"
"229539",0,0,0,0,"dummy"
"229542",0,0,1,1,"dummy"
"229543",0,0,0,0,"dummy"
"229544",0,0,0,0,"dummy"
"229553",8,19,3,30,"dummy"
"229556",1,0,0,1,"dummy"
"229561",4,6,2,12,"dummy"
"229565",1,0,0,1,"dummy"
"229566",3,5,0,8,"dummy"
"229573",0,0,1,1,"dummy"
"229579",0,6,0,6,"dummy"
"229585",0,0,1,1,"dummy"
"229586",1,1,0,2,"dummy"
"229587",0,0,0,0,"dummy"
"229588",0,0,0,0,"dummy"
"229589",0,4,0,4,"dummy"
"229590",11,15,2,28,"dummy"
"229591",1,0,0,1,"dummy"
"229592",0,0,1,1,"dummy"
"229593",2,7,0,9,"dummy"
"229594",1,3,0,4,"dummy"
"229595",1,0,0,1,"dummy"
"229596",7,1,0,8,"dummy"
"229597",0,2,0,2,"dummy"
"229598",0,0,0,0,"dummy"
"229599",0,1,0,1,"dummy"
"229600",0,1,0,1,"dummy"
"229601",0,1,0,1,"dummy"
"229602",15,14,4,33,"dummy"
"229607",1,1,0,2,"dummy"
"229608",1,1,5,7,"dummy"
"229609",1,0,5,6,"dummy"
"229632",2,2,2,6,"dummy"
"229633",0,2,0,2,"dummy"
"229651",0,0,0,0,"dummy"
"229654",0,1,0,1,"dummy"
"229657",0,0,3,3,"dummy"
"229658",0,0,1,1,"dummy"
"229659",7,10,1,18,"dummy"
"229660",0,0,1,1,"dummy"
"229618",0,2,1,3,"dummy"
"229619",6,4,5,15,"dummy"
"229620",0,2,3,5,"dummy"
"229621",0,1,0,1,"dummy"
"229622",1,1,1,3,"dummy"
"229623",1,0,0,1,"dummy"
"229624",0,2,0,2,"dummy"
"229625",0,1,1,2,"dummy"
"229626",0,0,2,2,"dummy"
"229629",0,1,3,4,"dummy"
"229630",1,0,0,1,"dummy"
"229635",1,1,0,2,"dummy"
"229636",1,1,0,2,"dummy"
"229637",0,2,0,2,"dummy"
"229640",0,1,0,1,"dummy"
"229641",0,1,0,1,"dummy"
"229642",11,3,2,16,"dummy"
"229643",0,2,1,3,"dummy"
"229644",2,1,1,4,"dummy"
"229645",1,2,1,4,"dummy"
"229646",2,7,1,10,"dummy"
"229647",3,1,0,4,"dummy"
"229648",0,0,1,1,"dummy"
"229649",4,0,0,4,"dummy"
"229676",0,1,0,1,"dummy"
"229682",0,3,0,3,"dummy"
"229687",0,0,0,0,"dummy"
"229688",0,0,0,0,"dummy"
"229689",0,3,0,3,"dummy"
"229690",4,0,0,4,"dummy"
"229691",0,0,0,0,"dummy"
"229693",0,1,0,1,"dummy"
"229694",0,4,0,4,"dummy"
"229695",0,1,0,1,"dummy"
"229696",2,2,0,4,"dummy"
"229698",2,9,0,11,"dummy"
"229699",0,1,0,1,"dummy"
"229700",4,17,6,27,"dummy"
"229701",23,11,7,41,"dummy"
"229702",0,3,0,3,"dummy"
"229705",2,2,2,6,"dummy"
"229706",3,1,2,6,"dummy"
"229707",1,3,1,5,"dummy"
"229708",3,3,0,6,"dummy"
"229709",4,2,1,7,"dummy"
"229711",0,0,0,0,"dummy"
"229714",0,7,3,10,"dummy"
"229715",0,2,0,2,"dummy"
"229724",0,8,0,8,"dummy"
"229725",0,2,0,2,"dummy"
"229726",0,0,1,1,"dummy"
"229727",0,1,1,2,"dummy"
"229728",0,10,0,10,"dummy"
"229732",8,0,3,11,"dummy"
"229733",0,0,0,0,"dummy"
"229737",0,1,1,2,"dummy"
"229739",0,10,0,10,"dummy"
"229740",0,0,1,1,"dummy"
"229741",0,0,1,1,"dummy"
"229747",0,1,0,1,"dummy"
"229759",0,1,3,4,"dummy"
"229760",1,1,0,2,"dummy"
"229764",0,0,1,1,"dummy"
"229767",0,0,1,1,"dummy"
"229768",0,0,2,2,"dummy"
"229769",0,8,0,8,"dummy"
"229774",0,0,1,1,"dummy"
"229775",0,0,1,1,"dummy"
"229776",0,0,1,1,"dummy"
"229777",0,0,1,1,"dummy"
"229778",0,0,1,1,"dummy"
"229779",0,0,0,0,"dummy"
"229780",0,1,0,1,"dummy"
"229781",0,0,1,1,"dummy"
"229782",0,0,0,0,"dummy"
"229783",0,0,0,0,"dummy"
"229784",0,2,0,2,"dummy"
"229785",0,0,0,0,"dummy"
"229786",0,3,0,3,"dummy"
"229787",0,0,1,1,"dummy"
"229788",1,3,0,4,"dummy"
"229789",0,0,1,1,"dummy"
"229790",0,1,0,1,"dummy"
"229791",0,0,1,1,"dummy"
"229792",0,0,0,0,"dummy"
"229793",0,0,1,1,"dummy"
"229794",0,0,1,1,"dummy"
"229795",0,0,1,1,"dummy"
"229796",0,0,1,1,"dummy"
"229798",0,3,0,3,"dummy"
"229799",0,3,0,3,"dummy"
"229800",0,7,0,7,"dummy"
"229801",0,1,0,1,"dummy"
"229802",3,9,1,13,"dummy"
"229809",0,0,1,1,"dummy"
"229811",2,10,4,16,"dummy"
"229812",0,0,0,0,"dummy"
"229813",1,0,2,3,"dummy"
"229814",1,0,2,3,"dummy"
"229848",0,2,0,2,"dummy"
"229849",0,0,3,3,"dummy"
"229851",1,7,0,8,"dummy"
"229852",0,1,0,1,"dummy"
"229853",0,5,0,5,"dummy"
"229854",0,4,0,4,"dummy"
"229855",4,0,0,4,"dummy"
"229856",0,4,0,4,"dummy"
"229857",0,0,0,0,"dummy"
"229858",2,0,0,2,"dummy"
"229859",0,0,1,1,"dummy"
"229860",0,0,0,0,"dummy"
"229861",0,0,1,1,"dummy"
"229862",1,0,0,1,"dummy"
"229863",0,0,1,1,"dummy"
"229864",0,2,0,2,"dummy"
"229865",1,6,0,7,"dummy"
"229866",0,0,0,0,"dummy"
"229867",2,1,1,4,"dummy"
"229868",4,2,0,6,"dummy"
"229869",0,0,0,0,"dummy"
"229870",0,0,2,2,"dummy"
"229871",7,0,1,8,"dummy"
"229872",16,8,2,26,"dummy"
"229876",0,0,1,1,"dummy"
"229877",0,0,1,1,"dummy"
"229878",0,0,1,1,"dummy"
"229879",0,0,1,1,"dummy"
"229882",0,0,2,2,"dummy"
"229883",0,1,1,2,"dummy"
"229884",8,2,1,11,"dummy"
"229886",0,0,1,1,"dummy"
"229887",0,0,1,1,"dummy"
"229888",0,0,1,1,"dummy"
"229889",0,0,1,1,"dummy"
"229890",0,0,1,1,"dummy"
"229891",0,0,1,1,"dummy"
"229892",0,0,1,1,"dummy"
"229893",0,0,1,1,"dummy"
"229894",0,0,1,1,"dummy"
"229895",0,0,1,1,"dummy"
"229896",0,0,1,1,"dummy"
"229897",0,0,1,1,"dummy"
"229898",0,0,1,1,"dummy"
"229899",0,0,1,1,"dummy"
"229900",0,1,0,1,"dummy"
"229901",0,0,1,1,"dummy"
"229902",0,0,1,1,"dummy"
"229903",0,0,1,1,"dummy"
"229904",0,0,1,1,"dummy"
"229905",0,0,1,1,"dummy"
"229906",0,0,1,1,"dummy"
"229907",0,0,1,1,"dummy"
"229908",0,0,1,1,"dummy"
"229909",0,0,1,1,"dummy"
"229910",0,0,1,1,"dummy"
"229911",0,0,1,1,"dummy"
"229912",4,5,0,9,"dummy"
"229922",3,4,0,7,"dummy"
"229925",0,1,0,1,"dummy"
"229926",6,14,4,24,"dummy"
"229927",0,1,0,1,"dummy"
"229928",0,1,0,1,"dummy"
"229929",0,0,1,1,"dummy"
"229930",0,0,1,1,"dummy"
"229931",0,0,1,1,"dummy"
"229932",0,0,1,1,"dummy"
"229933",0,0,0,0,"dummy"
"229934",16,12,4,32,"dummy"
"229935",1,0,0,1,"dummy"
"229936",1,3,1,5,"dummy"
"229937",1,1,0,2,"dummy"
"229938",0,1,0,1,"dummy"
"229939",1,0,0,1,"dummy"
"229940",2,3,0,5,"dummy"
"229941",0,0,1,1,"dummy"
"229942",0,0,1,1,"dummy"
"229943",0,0,1,1,"dummy"
"229946",0,0,2,2,"dummy"
"229959",1,0,2,3,"dummy"
"229960",0,1,2,3,"dummy"
"229961",2,0,0,2,"dummy"
"229962",0,0,0,0,"dummy"
"229963",0,3,0,3,"dummy"
"229976",0,0,0,0,"dummy"
"229977",0,0,0,0,"dummy"
"230004",0,1,0,1,"dummy"
"230016",0,0,0,0,"dummy"
"230017",0,0,0,0,"dummy"
"230018",0,0,2,2,"dummy"
"230019",0,0,0,0,"dummy"
"230020",1,0,0,1,"dummy"
"230023",0,0,0,0,"dummy"
"230024",0,2,0,2,"dummy"
"230025",1,0,0,1,"dummy"
"230026",0,1,0,1,"dummy"
"230027",2,0,0,2,"dummy"
"230037",0,1,0,1,"dummy"
"230043",0,0,1,1,"dummy"
"230044",0,1,0,1,"dummy"
"230054",0,0,1,1,"dummy"
"230055",0,1,0,1,"dummy"
"230072",0,0,1,1,"dummy"
"230073",1,8,2,11,"dummy"
"230076",2,0,5,7,"dummy"
"230079",0,1,2,3,"dummy"
"230100",0,0,0,0,"dummy"
"230103",0,6,1,7,"dummy"
"230104",15,5,2,22,"dummy"
"230115",0,8,0,8,"dummy"
"230116",0,13,0,13,"dummy"
"230117",0,0,1,1,"dummy"
"230118",0,1,0,1,"dummy"
"230119",1,4,1,6,"dummy"
"230120",0,1,0,1,"dummy"
"230121",0,8,0,8,"dummy"
"230161",0,0,0,0,"dummy"
"229914",0,1,0,1,"dummy"
"229915",0,0,4,4,"dummy"
"229916",0,1,0,1,"dummy"
"229917",0,2,0,2,"dummy"
"229918",0,1,0,1,"dummy"
"229953",0,0,4,4,"dummy"
"229954",0,0,4,4,"dummy"
"229957",0,0,0,0,"dummy"
"229965",6,0,0,6,"dummy"
"229966",2,5,2,9,"dummy"
"229969",0,0,1,1,"dummy"
"229970",2,0,0,2,"dummy"
"229971",0,0,0,0,"dummy"
"229974",1,0,0,1,"dummy"
"229979",4,7,0,11,"dummy"
"230000",0,1,2,3,"dummy"
"230006",0,3,0,3,"dummy"
"230007",0,0,1,1,"dummy"
"230008",2,0,0,2,"dummy"
"230009",0,2,0,2,"dummy"
"230010",4,2,1,7,"dummy"
"230011",0,1,0,1,"dummy"
"230012",1,3,1,5,"dummy"
"230013",0,1,0,1,"dummy"
"230014",3,1,0,4,"dummy"
"230039",4,5,3,12,"dummy"
"230040",8,13,1,22,"dummy"
"230041",0,0,0,0,"dummy"
"230052",2,6,3,11,"dummy"
"230057",0,0,1,1,"dummy"
"230058",0,0,1,1,"dummy"
"230059",1,0,0,1,"dummy"
"230060",0,1,1,2,"dummy"
"230061",0,2,0,2,"dummy"
"230062",0,0,3,3,"dummy"
"230065",0,1,0,1,"dummy"
"230066",11,13,2,26,"dummy"
"230067",0,1,0,1,"dummy"
"230068",0,0,1,1,"dummy"
"230069",0,3,0,3,"dummy"
"230070",0,1,0,1,"dummy"
"230081",0,3,0,3,"dummy"
"230082",0,3,0,3,"dummy"
"230083",1,0,0,1,"dummy"
"230084",1,4,0,5,"dummy"
"230085",0,0,0,0,"dummy"
"230086",0,2,0,2,"dummy"
"230094",0,0,1,1,"dummy"
"230095",2,1,1,4,"dummy"
"230096",0,0,1,1,"dummy"
"230108",0,25,0,25,"dummy"
"230109",7,5,0,12,"dummy"
"230110",16,7,2,25,"dummy"
"230113",0,0,1,1,"dummy"
"230130",0,4,0,4,"dummy"
"230131",3,2,0,5,"dummy"
"230132",0,4,0,4,"dummy"
"230133",2,6,1,9,"dummy"
"230134",2,0,0,2,"dummy"
"230135",0,2,0,2,"dummy"
"230136",0,0,3,3,"dummy"
"230137",0,0,3,3,"dummy"
"230138",0,0,2,2,"dummy"
"230139",0,0,1,1,"dummy"
"230140",0,1,0,1,"dummy"
"230141",0,0,0,0,"dummy"
"230149",4,1,1,6,"dummy"
"230150",0,0,1,1,"dummy"
"230151",0,0,1,1,"dummy"
"230152",0,1,0,1,"dummy"
"230153",0,0,1,1,"dummy"
"230156",0,4,1,5,"dummy"
"230157",0,0,1,1,"dummy"
"230158",0,0,1,1,"dummy"
"230159",0,1,2,3,"dummy"
"230167",0,9,1,10,"dummy"
"230168",9,0,1,10,"dummy"
"230173",0,1,0,1,"dummy"
"230174",0,1,0,1,"dummy"
"230179",0,1,0,1,"dummy"
"230180",15,13,2,30,"dummy"
"230181",0,1,0,1,"dummy"
"230182",1,9,0,10,"dummy"
"230183",1,10,0,11,"dummy"
"230184",0,0,5,5,"dummy"
"230196",0,2,0,2,"dummy"
"230197",7,7,3,17,"dummy"
"230198",1,0,0,1,"dummy"
"230199",0,3,0,3,"dummy"
"230200",1,3,0,4,"dummy"
"230201",9,0,1,10,"dummy"
"230202",0,9,1,10,"dummy"
"230203",11,1,3,15,"dummy"
"230204",0,10,1,11,"dummy"
"230205",0,0,0,0,"dummy"
"230206",0,0,0,0,"dummy"
"230207",0,0,1,1,"dummy"
"230208",0,0,0,0,"dummy"
"230231",0,1,0,1,"dummy"
"230238",2,2,2,6,"dummy"
"230239",0,0,1,1,"dummy"
"230240",0,1,1,2,"dummy"
"230241",2,8,0,10,"dummy"
"230242",0,1,0,1,"dummy"
"230243",0,1,0,1,"dummy"
"230244",0,1,0,1,"dummy"
"230245",1,2,0,3,"dummy"
"230246",0,0,1,1,"dummy"
"230247",2,2,0,4,"dummy"
"230248",0,1,1,2,"dummy"
"230249",3,3,0,6,"dummy"
"230250",2,6,0,8,"dummy"
"230251",0,1,1,2,"dummy"
"230252",1,1,1,3,"dummy"
"230253",0,1,1,2,"dummy"
"230254",0,0,0,0,"dummy"
"230255",0,0,2,2,"dummy"
"230256",1,1,0,2,"dummy"
"230257",0,1,0,1,"dummy"
"230260",0,0,0,0,"dummy"
"230263",0,1,0,1,"dummy"
"230273",0,0,1,1,"dummy"
"230274",0,3,1,4,"dummy"
"230275",0,0,1,1,"dummy"
"230281",4,1,0,5,"dummy"
"230291",0,0,1,1,"dummy"
"230297",0,2,0,2,"dummy"
"230311",2,1,0,3,"dummy"
"230314",0,1,0,1,"dummy"
"230315",3,4,2,9,"dummy"
"230318",33,14,3,50,"dummy"
"230319",2,4,1,7,"dummy"
"230320",0,0,1,1,"dummy"
"230321",0,6,0,6,"dummy"
"230322",8,23,3,34,"dummy"
"230323",0,0,1,1,"dummy"
"230324",28,0,2,30,"dummy"
"230325",0,0,0,0,"dummy"
"230326",1,0,0,1,"dummy"
"230341",2,0,0,2,"dummy"
"230351",1,0,1,2,"dummy"
"230352",0,0,0,0,"dummy"
"230389",0,1,1,2,"dummy"
"230170",14,26,3,43,"dummy"
"230171",0,4,0,4,"dummy"
"230176",0,0,0,0,"dummy"
"230177",1,1,2,4,"dummy"
"230186",0,1,1,2,"dummy"
"230187",0,2,0,2,"dummy"
"230188",0,5,0,5,"dummy"
"230189",2,5,1,8,"dummy"
"230190",0,0,0,0,"dummy"
"230210",0,0,0,0,"dummy"
"230213",1,1,0,2,"dummy"
"230227",0,0,1,1,"dummy"
"230233",4,2,1,7,"dummy"
"230234",2,3,0,5,"dummy"
"230235",1,0,0,1,"dummy"
"230236",0,0,2,2,"dummy"
"230269",0,0,2,2,"dummy"
"230277",0,1,0,1,"dummy"
"230278",8,0,0,8,"dummy"
"230279",4,1,0,5,"dummy"
"230283",0,11,0,11,"dummy"
"230286",0,1,0,1,"dummy"
"230289",1,0,0,1,"dummy"
"230293",2,0,2,4,"dummy"
"230299",0,0,1,1,"dummy"
"230300",0,1,0,1,"dummy"
"230301",4,6,3,13,"dummy"
"230302",0,2,0,2,"dummy"
"230308",0,0,1,1,"dummy"
"230309",1,8,0,9,"dummy"
"230328",0,0,0,0,"dummy"
"230329",2,2,2,6,"dummy"
"230330",0,2,0,2,"dummy"
"230331",0,0,0,0,"dummy"
"230332",0,0,0,0,"dummy"
"230333",0,0,0,0,"dummy"
"230354",0,0,2,2,"dummy"
"230357",1,13,1,15,"dummy"
"230358",0,0,0,0,"dummy"
"230385",0,2,1,3,"dummy"
"230386",4,0,1,5,"dummy"
"230387",0,1,0,1,"dummy"
"230397",8,8,1,17,"dummy"
"230407",1,0,0,1,"dummy"
"230408",8,4,6,18,"dummy"
"230409",0,0,1,1,"dummy"
"230410",4,1,0,5,"dummy"
"230411",0,0,1,1,"dummy"
"230412",0,1,0,1,"dummy"
"230413",0,1,0,1,"dummy"
"230452",0,1,0,1,"dummy"
"230453",6,14,4,24,"dummy"
"230454",0,1,0,1,"dummy"
"230455",0,1,0,1,"dummy"
"230456",0,0,1,1,"dummy"
"230457",0,0,1,1,"dummy"
"230458",0,0,1,1,"dummy"
"230459",0,0,1,1,"dummy"
"230460",0,0,0,0,"dummy"
"230461",16,12,4,32,"dummy"
"230462",1,0,0,1,"dummy"
"230463",1,3,1,5,"dummy"
"230464",1,1,0,2,"dummy"
"230465",0,1,0,1,"dummy"
"230466",1,0,0,1,"dummy"
"230393",1,3,1,5,"dummy"
"230394",3,3,0,6,"dummy"
"230395",0,0,1,1,"dummy"
"230399",2,0,0,2,"dummy"
"230419",0,8,0,8,"dummy"
"230420",0,0,1,1,"dummy"
"230482",0,1,0,1,"dummy"
"230485",0,0,1,1,"dummy"
"230486",1,0,0,1,"dummy"
"230489",0,1,0,1,"dummy"
"230498",0,0,1,1,"dummy"
"230499",4,1,0,5,"dummy"
"230500",0,1,1,2,"dummy"
"230501",0,0,1,1,"dummy"
"230502",0,1,0,1,"dummy"
"230503",0,1,0,1,"dummy"
"230504",0,2,0,2,"dummy"
"230505",8,3,0,11,"dummy"
"230506",0,1,0,1,"dummy"
"230507",1,1,0,2,"dummy"
"230508",0,1,0,1,"dummy"
"230509",0,4,0,4,"dummy"
"230510",0,1,0,1,"dummy"
"230511",3,1,0,4,"dummy"
"230512",0,0,0,0,"dummy"
"230513",0,1,0,1,"dummy"
"230521",1,0,0,1,"dummy"
"230526",0,1,1,2,"dummy"
"230527",3,3,5,11,"dummy"
"230528",0,1,1,2,"dummy"
"230529",1,4,3,8,"dummy"
"230530",0,2,1,3,"dummy"
"230531",2,2,0,4,"dummy"
"230532",0,0,1,1,"dummy"
"230533",0,1,0,1,"dummy"
"230546",0,8,0,8,"dummy"
"230547",0,2,0,2,"dummy"
"230548",0,2,0,2,"dummy"
"230558",0,1,1,2,"dummy"
"230559",0,0,3,3,"dummy"
"230560",0,2,1,3,"dummy"
"230561",0,0,2,2,"dummy"
"230567",11,10,2,23,"dummy"
"230568",2,0,0,2,"dummy"
"230569",1,1,0,2,"dummy"
"230570",0,0,1,1,"dummy"
"230571",0,0,1,1,"dummy"
"230572",8,6,3,17,"dummy"
"230573",6,8,3,17,"dummy"
"230574",8,6,2,16,"dummy"
"230575",8,1,1,10,"dummy"
"230576",0,0,1,1,"dummy"
"230577",0,0,1,1,"dummy"
"230582",0,2,1,3,"dummy"
"230583",0,3,0,3,"dummy"
"230584",0,2,1,3,"dummy"
"230585",1,2,1,4,"dummy"
"230588",1,1,1,3,"dummy"
"230595",2,2,0,4,"dummy"
"230596",0,6,0,6,"dummy"
"230604",0,0,0,0,"dummy"
"230611",2,1,0,3,"dummy"
"230617",0,1,0,1,"dummy"
"230628",1,4,2,7,"dummy"
"230629",1,1,0,2,"dummy"
"230630",3,0,1,4,"dummy"
"230631",0,0,1,1,"dummy"
"230632",0,0,1,1,"dummy"
"230654",0,4,0,4,"dummy"
"230655",2,0,0,2,"dummy"
"230467",2,3,0,5,"dummy"
"230468",0,0,1,1,"dummy"
"230469",0,0,1,1,"dummy"
"230470",0,0,1,1,"dummy"
"230473",0,0,0,0,"dummy"
"230474",0,0,0,0,"dummy"
"230475",0,0,0,0,"dummy"
"230476",0,0,0,0,"dummy"
"230477",0,3,0,3,"dummy"
"230478",2,0,0,2,"dummy"
"230479",0,1,0,1,"dummy"
"230480",0,1,0,1,"dummy"
"230491",0,0,2,2,"dummy"
"230492",0,0,3,3,"dummy"
"230493",4,6,0,10,"dummy"
"230496",1,1,0,2,"dummy"
"230519",12,4,0,16,"dummy"
"230535",0,6,0,6,"dummy"
"230536",12,2,0,14,"dummy"
"230539",5,2,0,7,"dummy"
"230540",0,0,1,1,"dummy"
"230541",0,0,1,1,"dummy"
"230542",0,0,1,1,"dummy"
"230543",1,0,1,2,"dummy"
"230544",4,3,1,8,"dummy"
"230550",0,1,3,4,"dummy"
"230551",0,0,1,1,"dummy"
"230552",0,2,0,2,"dummy"
"230553",0,0,0,0,"dummy"
"230554",0,2,0,2,"dummy"
"230555",0,0,0,0,"dummy"
"230556",3,3,3,9,"dummy"
"230563",0,1,3,4,"dummy"
"230564",0,2,0,2,"dummy"
"230565",0,0,0,0,"dummy"
"230579",0,4,0,4,"dummy"
"230580",0,4,1,5,"dummy"
"230600",7,0,3,10,"dummy"
"230601",0,0,5,5,"dummy"
"230602",1,0,3,4,"dummy"
"230613",1,0,0,1,"dummy"
"230619",0,1,0,1,"dummy"
"230620",1,4,0,5,"dummy"
"230621",0,1,0,1,"dummy"
"230622",0,3,0,3,"dummy"
"230623",1,2,0,3,"dummy"
"230624",0,0,2,2,"dummy"
"230625",1,1,0,2,"dummy"
"230626",1,1,0,2,"dummy"
"230634",0,0,2,2,"dummy"
"230635",0,4,0,4,"dummy"
"230636",2,1,1,4,"dummy"
"230637",0,1,0,1,"dummy"
"230638",0,1,0,1,"dummy"
"230639",0,1,0,1,"dummy"
"230640",0,2,0,2,"dummy"
"230641",0,2,0,2,"dummy"
"230642",1,0,0,1,"dummy"
"230643",1,0,0,1,"dummy"
"230644",0,0,0,0,"dummy"
"230645",0,0,1,1,"dummy"
"230646",0,0,1,1,"dummy"
"230649",1,2,0,3,"dummy"
"230650",0,0,1,1,"dummy"
"230651",0,0,1,1,"dummy"
"230652",0,0,1,1,"dummy"
"230691",7,0,5,12,"dummy"
"230696",1,4,2,7,"dummy"
"230703",0,1,0,1,"dummy"
"230658",2,4,0,6,"dummy"
"230659",0,2,0,2,"dummy"
"230660",0,2,0,2,"dummy"
"230661",10,2,0,12,"dummy"
"230662",0,2,0,2,"dummy"
"230663",0,0,0,0,"dummy"
"230664",0,0,3,3,"dummy"
"230667",0,1,0,1,"dummy"
"230668",7,17,2,26,"dummy"
"230669",0,1,1,2,"dummy"
"230670",0,3,0,3,"dummy"
"230671",0,1,0,1,"dummy"
"230672",1,1,3,5,"dummy"
"230673",0,0,2,2,"dummy"
"230674",0,0,1,1,"dummy"
"230675",2,0,0,2,"dummy"
"230676",0,0,1,1,"dummy"
"230677",1,1,2,4,"dummy"
"230678",0,1,0,1,"dummy"
"230679",0,0,1,1,"dummy"
"230680",0,3,0,3,"dummy"
"230681",4,4,0,8,"dummy"
"230682",2,0,0,2,"dummy"
"230683",0,0,1,1,"dummy"
"230684",0,0,2,2,"dummy"
"230685",0,0,1,1,"dummy"
"230686",1,0,0,1,"dummy"
"230687",0,1,1,2,"dummy"
"230688",0,1,0,1,"dummy"
"230689",0,0,1,1,"dummy"
"230709",0,1,0,1,"dummy"
"230710",0,1,0,1,"dummy"
"230711",1,2,0,3,"dummy"
"230712",1,0,0,1,"dummy"
"230733",0,3,0,3,"dummy"
"230734",0,0,1,1,"dummy"
"230755",0,2,1,3,"dummy"
"230756",0,0,0,0,"dummy"
"230781",0,0,1,1,"dummy"
"230784",0,0,3,3,"dummy"
"230787",38,28,5,71,"dummy"
"230788",3,3,4,10,"dummy"
"230789",0,0,0,0,"dummy"
"230790",5,3,1,9,"dummy"
"230791",0,0,1,1,"dummy"
"230792",2,2,0,4,"dummy"
"230793",0,0,1,1,"dummy"
"230794",0,1,0,1,"dummy"
"230795",2,0,0,2,"dummy"
"230796",0,0,0,0,"dummy"
"230797",0,1,0,1,"dummy"
"230798",0,0,0,0,"dummy"
"230799",0,0,2,2,"dummy"
"230800",0,0,0,0,"dummy"
"230801",0,2,0,2,"dummy"
"230802",2,0,0,2,"dummy"
"230805",7,3,0,10,"dummy"
"230806",3,7,3,13,"dummy"
"230807",0,0,1,1,"dummy"
"230871",0,0,1,1,"dummy"
"230874",10,24,2,36,"dummy"
"230875",0,1,0,1,"dummy"
"230876",0,0,0,0,"dummy"
"230877",0,0,1,1,"dummy"
"230886",7,3,1,11,"dummy"
"230892",0,2,0,2,"dummy"
"230912",1,1,0,2,"dummy"
"230913",0,3,0,3,"dummy"
"230914",0,0,0,0,"dummy"
"230915",0,3,0,3,"dummy"
"230916",0,7,0,7,"dummy"
"230917",0,6,0,6,"dummy"
"230918",0,0,1,1,"dummy"
"230919",0,0,1,1,"dummy"
"230920",0,0,1,1,"dummy"
"230923",0,0,1,1,"dummy"
"230924",0,3,0,3,"dummy"
"230736",0,0,1,1,"dummy"
"230737",3,9,5,17,"dummy"
"230738",0,1,0,1,"dummy"
"230739",7,0,0,7,"dummy"
"230740",3,0,0,3,"dummy"
"230741",0,0,0,0,"dummy"
"230879",0,0,2,2,"dummy"
"230880",0,0,0,0,"dummy"
"230881",0,1,1,2,"dummy"
"230882",0,0,0,0,"dummy"
"230883",0,1,0,1,"dummy"
"230884",1,8,1,10,"dummy"
"230888",4,8,1,13,"dummy"
"230889",5,0,1,6,"dummy"
"230890",0,1,0,1,"dummy"
"230894",0,1,0,1,"dummy"
"230895",0,0,1,1,"dummy"
"230898",0,1,0,1,"dummy"
"230899",1,2,0,3,"dummy"
"230900",0,1,0,1,"dummy"
"230901",19,5,3,27,"dummy"
"230902",0,2,0,2,"dummy"
"230903",1,0,0,1,"dummy"
"230926",0,2,1,3,"dummy"
"230934",0,4,2,6,"dummy"
"230940",0,0,1,1,"dummy"
"230973",5,3,0,8,"dummy"
"230976",0,1,0,1,"dummy"
"230942",0,5,0,5,"dummy"
"230943",0,1,0,1,"dummy"
"230944",0,1,0,1,"dummy"
"230947",0,0,1,1,"dummy"
"230948",1,0,1,2,"dummy"
"230949",0,0,1,1,"dummy"
"230950",0,0,1,1,"dummy"
"230951",0,0,1,1,"dummy"
"230952",0,0,1,1,"dummy"
"230953",0,0,1,1,"dummy"
"230954",0,0,1,1,"dummy"
"230955",0,0,1,1,"dummy"
"230956",0,0,1,1,"dummy"
"230957",0,0,1,1,"dummy"
"230958",0,0,1,1,"dummy"
"230959",0,0,1,1,"dummy"
"230960",0,0,1,1,"dummy"
"230961",0,0,1,1,"dummy"
"230962",0,0,1,1,"dummy"
"230963",0,0,1,1,"dummy"
"230964",0,0,1,1,"dummy"
"230965",0,0,1,1,"dummy"
"230966",0,0,1,1,"dummy"
"230967",0,0,1,1,"dummy"
"230968",0,0,1,1,"dummy"
"230971",0,1,0,1,"dummy"
"230980",0,1,0,1,"dummy"
"230986",0,1,3,4,"dummy"
"230988",7,0,0,7,"dummy"
"230991",0,0,2,2,"dummy"
"230992",0,1,0,1,"dummy"
"230993",0,0,2,2,"dummy"
"230994",1,0,0,1,"dummy"
"230995",0,0,1,1,"dummy"
"230997",0,0,1,1,"dummy"
"230999",0,2,0,2,"dummy"
"231000",0,10,0,10,"dummy"
"231002",3,3,0,6,"dummy"
"231007",0,0,1,1,"dummy"
"231008",0,1,0,1,"dummy"
"231009",8,6,5,19,"dummy"
"231010",4,24,0,28,"dummy"
"231011",31,11,5,47,"dummy"
"231012",1,0,0,1,"dummy"
"231015",0,0,1,1,"dummy"
"231016",0,0,1,1,"dummy"
"231017",0,2,0,2,"dummy"
"231018",0,2,0,2,"dummy"
"231019",0,0,1,1,"dummy"
"231020",0,0,1,1,"dummy"
"231021",1,1,1,3,"dummy"
"231022",0,0,1,1,"dummy"
"231023",1,0,0,1,"dummy"
"231024",2,0,1,3,"dummy"
"231025",0,1,0,1,"dummy"
"231026",0,1,0,1,"dummy"
"231027",0,1,1,2,"dummy"
"231028",0,0,1,1,"dummy"
"231029",0,0,1,1,"dummy"
"231030",0,1,0,1,"dummy"
"231031",0,1,0,1,"dummy"
"231032",3,0,0,3,"dummy"
"231033",0,1,0,1,"dummy"
"231034",0,1,0,1,"dummy"
"231036",0,2,0,2,"dummy"
"231044",0,13,0,13,"dummy"
"231045",1,9,0,10,"dummy"
"231046",0,1,0,1,"dummy"
"231047",0,1,0,1,"dummy"
"231048",14,1,3,18,"dummy"
"231049",1,0,0,1,"dummy"
"231050",0,0,1,1,"dummy"
"231051",0,3,2,5,"dummy"
"231053",0,0,1,1,"dummy"
"231054",0,0,1,1,"dummy"
"231055",2,2,0,4,"dummy"
"231056",0,0,0,0,"dummy"
"231057",0,0,1,1,"dummy"
"231061",0,0,0,0,"dummy"
"231063",1,0,0,1,"dummy"
"231065",1,0,1,2,"dummy"
"231067",0,0,1,1,"dummy"
"231068",0,0,1,1,"dummy"
"231069",0,0,2,2,"dummy"
"231070",26,3,7,36,"dummy"
"231074",4,3,0,7,"dummy"
"231075",0,0,1,1,"dummy"
"231076",0,0,2,2,"dummy"
"231077",2,5,3,10,"dummy"
"231078",1,0,1,2,"dummy"
"231079",0,0,1,1,"dummy"
"231080",0,0,1,1,"dummy"
"231081",0,0,1,1,"dummy"
"231082",1,9,1,11,"dummy"
"231083",9,1,1,11,"dummy"
"231084",1,9,1,11,"dummy"
"231085",9,1,1,11,"dummy"
"231086",0,1,0,1,"dummy"
"231087",0,1,0,1,"dummy"
"231088",1,0,1,2,"dummy"
"231089",0,0,1,1,"dummy"
"231090",0,0,1,1,"dummy"
"231091",0,1,2,3,"dummy"
"231092",0,0,1,1,"dummy"
"231119",1,0,0,1,"dummy"
"231120",1,2,1,4,"dummy"
"231121",1,0,0,1,"dummy"
"231122",0,0,0,0,"dummy"
"231123",0,3,1,4,"dummy"
"231125",0,1,0,1,"dummy"
"231126",0,0,2,2,"dummy"
"231129",0,0,1,1,"dummy"
"231146",0,1,0,1,"dummy"
"231157",2,0,0,2,"dummy"
"231158",0,2,0,2,"dummy"
"231162",6,7,5,18,"dummy"
"231163",11,9,0,20,"dummy"
"231164",1,1,3,5,"dummy"
"231165",0,1,0,1,"dummy"
"231167",1,0,0,1,"dummy"
"231168",0,0,0,0,"dummy"
"231169",0,0,0,0,"dummy"
"231170",0,0,0,0,"dummy"
"231171",0,0,0,0,"dummy"
"231172",0,0,0,0,"dummy"
"231173",0,0,0,0,"dummy"
"231177",0,5,0,5,"dummy"
"231178",0,0,0,0,"dummy"
"231179",0,1,0,1,"dummy"
"231180",1,4,1,6,"dummy"
"231183",8,2,3,13,"dummy"
"231184",2,34,1,37,"dummy"
"231185",0,2,1,3,"dummy"
"231188",0,2,0,2,"dummy"
"231191",0,0,1,1,"dummy"
"231192",0,1,0,1,"dummy"
"231193",4,2,0,6,"dummy"
"231199",2,2,0,4,"dummy"
"231202",7,12,0,19,"dummy"
"231203",2,2,0,4,"dummy"
"231206",1,11,0,12,"dummy"
"231207",0,4,0,4,"dummy"
"231208",0,2,0,2,"dummy"
"231211",0,2,0,2,"dummy"
"231212",0,1,0,1,"dummy"
"231213",0,1,0,1,"dummy"
"231214",0,1,0,1,"dummy"
"231215",0,0,0,0,"dummy"
"231218",0,0,0,0,"dummy"
"231219",0,0,0,0,"dummy"
"231220",1,11,1,13,"dummy"
"231221",0,0,0,0,"dummy"
"231222",0,1,0,1,"dummy"
"231223",0,0,0,0,"dummy"
"231224",0,0,2,2,"dummy"
"231225",4,2,1,7,"dummy"
"231226",18,2,2,22,"dummy"
"231227",0,1,0,1,"dummy"
"231230",0,3,0,3,"dummy"
"231239",0,0,1,1,"dummy"
"231241",6,1,1,8,"dummy"
"231242",0,0,1,1,"dummy"
"231243",0,8,3,11,"dummy"
"231244",0,0,1,1,"dummy"
"231245",0,0,2,2,"dummy"
"231247",1,0,0,1,"dummy"
"231249",0,1,0,1,"dummy"
"231251",5,0,0,5,"dummy"
"231253",0,1,0,1,"dummy"
"231254",1,0,0,1,"dummy"
"231257",6,2,3,11,"dummy"
"231258",0,1,1,2,"dummy"
"231261",0,0,1,1,"dummy"
"231262",0,2,1,3,"dummy"
"231263",0,0,2,2,"dummy"
"231264",0,0,1,1,"dummy"
"231265",0,0,0,0,"dummy"
"231266",0,1,0,1,"dummy"
"231267",1,2,0,3,"dummy"
"231268",0,1,0,1,"dummy"
"231269",1,10,1,12,"dummy"
"231270",1,1,0,2,"dummy"
"231271",0,1,0,1,"dummy"
"231272",7,2,0,9,"dummy"
"231273",0,1,0,1,"dummy"
"231274",0,0,1,1,"dummy"
"231275",0,0,1,1,"dummy"
"231276",0,0,2,2,"dummy"
"231277",0,0,1,1,"dummy"
"231294",0,0,1,1,"dummy"
"231295",0,5,0,5,"dummy"
"231296",0,2,2,4,"dummy"
"231302",0,0,2,2,"dummy"
"231367",6,6,2,14,"dummy"
"231371",0,0,2,2,"dummy"
"231372",0,0,1,1,"dummy"
"231373",0,0,1,1,"dummy"
"231374",0,0,1,1,"dummy"
"231375",5,9,1,15,"dummy"
"231383",0,0,1,1,"dummy"
"231384",0,0,1,1,"dummy"
"231385",1,0,0,1,"dummy"
"231386",1,2,0,3,"dummy"
"231387",0,0,2,2,"dummy"
"231389",0,1,0,1,"dummy"
"231390",0,1,0,1,"dummy"
"231392",0,0,1,1,"dummy"
"231393",2,2,0,4,"dummy"
"231397",0,5,0,5,"dummy"
"231398",2,8,0,10,"dummy"
"231399",0,2,2,4,"dummy"
"231400",2,3,2,7,"dummy"
"231401",6,3,0,9,"dummy"
"231402",0,1,0,1,"dummy"
"231403",0,2,0,2,"dummy"
"231404",0,0,0,0,"dummy"
"231405",0,0,1,1,"dummy"
"231406",2,2,0,4,"dummy"
"231407",2,0,0,2,"dummy"
"231408",0,0,2,2,"dummy"
"231409",0,0,3,3,"dummy"
"231410",0,2,0,2,"dummy"
"231417",0,0,2,2,"dummy"
"231418",0,0,1,1,"dummy"
"231419",0,1,0,1,"dummy"
"231420",0,1,0,1,"dummy"
"231430",0,3,0,3,"dummy"
"231431",0,0,1,1,"dummy"
"231439",0,0,1,1,"dummy"
"231459",0,0,0,0,"dummy"
"231460",0,2,0,2,"dummy"
"231461",0,0,0,0,"dummy"
"231462",0,0,1,1,"dummy"
"231463",0,0,0,0,"dummy"
"231464",0,0,1,1,"dummy"
"231465",0,0,0,0,"dummy"
"231466",1,2,0,3,"dummy"
"231467",0,0,1,1,"dummy"
"231468",0,0,1,1,"dummy"
"231469",0,0,1,1,"dummy"
"231470",0,0,0,0,"dummy"
"231471",0,0,1,1,"dummy"
"231472",0,0,1,1,"dummy"
"231473",0,0,1,1,"dummy"
"231474",0,0,1,1,"dummy"
"231475",0,0,0,0,"dummy"
"231476",0,0,0,0,"dummy"
"231477",1,10,0,11,"dummy"
"231478",0,0,1,1,"dummy"
"231479",9,1,0,10,"dummy"
"231480",0,0,1,1,"dummy"
"231481",0,0,1,1,"dummy"
"231482",0,0,1,1,"dummy"
"231483",0,0,0,0,"dummy"
"231484",0,0,0,0,"dummy"
"231485",0,0,1,1,"dummy"
"231486",0,0,1,1,"dummy"
"231487",0,0,0,0,"dummy"
"231488",0,0,0,0,"dummy"
"231489",0,0,0,0,"dummy"
"231490",0,0,0,0,"dummy"
"231491",0,0,0,0,"dummy"
"231492",0,0,0,0,"dummy"
"231493",1,0,0,1,"dummy"
"231494",0,1,0,1,"dummy"
"231495",0,0,0,0,"dummy"
"231496",8,11,1,20,"dummy"
"231497",0,0,1,1,"dummy"
"231498",0,0,1,1,"dummy"
"231499",0,0,1,1,"dummy"
"231502",0,0,0,0,"dummy"
"231503",0,2,0,2,"dummy"
"231534",0,0,1,1,"dummy"
"231538",11,3,2,16,"dummy"
"231539",0,0,1,1,"dummy"
"231540",0,2,0,2,"dummy"
"231541",0,1,0,1,"dummy"
"231547",1,1,0,2,"dummy"
"231559",0,1,0,1,"dummy"
"231560",0,1,0,1,"dummy"
"231561",1,0,0,1,"dummy"
"231572",1,3,2,6,"dummy"
"231573",0,1,0,1,"dummy"
"231395",5,3,0,8,"dummy"
"231412",0,0,1,1,"dummy"
"231413",0,0,1,1,"dummy"
"231422",3,8,2,13,"dummy"
"231433",1,2,0,3,"dummy"
"231443",0,0,0,0,"dummy"
"231444",1,3,0,4,"dummy"
"231445",3,0,0,3,"dummy"
"231446",2,0,0,2,"dummy"
"231449",3,2,1,6,"dummy"
"231452",0,3,0,3,"dummy"
"231453",1,5,2,8,"dummy"
"231505",3,11,0,14,"dummy"
"231506",0,0,0,0,"dummy"
"231509",1,2,1,4,"dummy"
"231512",0,3,0,3,"dummy"
"231513",4,12,2,18,"dummy"
"231514",0,1,0,1,"dummy"
"231515",0,0,0,0,"dummy"
"231516",0,1,1,2,"dummy"
"231517",0,0,1,1,"dummy"
"231524",2,0,3,5,"dummy"
"231531",0,0,1,1,"dummy"
"231532",0,0,1,1,"dummy"
"231536",0,1,0,1,"dummy"
"231543",0,1,0,1,"dummy"
"231544",1,0,0,1,"dummy"
"231545",0,0,0,0,"dummy"
"231553",3,7,0,10,"dummy"
"231563",0,0,6,6,"dummy"
"231564",0,0,2,2,"dummy"
"231575",1,3,1,5,"dummy"
"231576",3,1,2,6,"dummy"
"231577",0,0,1,1,"dummy"
"231578",0,0,1,1,"dummy"
"231579",0,0,1,1,"dummy"
"231617",5,4,4,13,"dummy"
"231618",0,0,1,1,"dummy"
"231619",0,0,1,1,"dummy"
"231620",2,0,0,2,"dummy"
"231621",0,0,1,1,"dummy"
"231622",0,0,1,1,"dummy"
"231623",0,0,1,1,"dummy"
"231624",0,0,1,1,"dummy"
"231625",0,0,1,1,"dummy"
"231626",0,0,1,1,"dummy"
"231629",0,1,0,1,"dummy"
"231630",0,3,0,3,"dummy"
"231631",0,1,0,1,"dummy"
"231632",0,1,0,1,"dummy"
"231633",9,0,0,9,"dummy"
"231634",0,5,0,5,"dummy"
"231639",0,0,1,1,"dummy"
"231644",4,2,3,9,"dummy"
"231645",1,0,0,1,"dummy"
"231646",0,1,0,1,"dummy"
"231647",0,0,1,1,"dummy"
"231676",0,0,2,2,"dummy"
"231600",0,4,0,4,"dummy"
"231601",2,8,1,11,"dummy"
"231602",0,1,0,1,"dummy"
"231614",0,0,2,2,"dummy"
"231615",0,2,1,3,"dummy"
"231636",4,3,2,9,"dummy"
"231637",5,11,2,18,"dummy"
"231641",0,0,1,1,"dummy"
"231642",0,1,1,2,"dummy"
"231649",9,3,1,13,"dummy"
"231650",1,0,0,1,"dummy"
"231651",2,0,0,2,"dummy"
"231652",1,0,0,1,"dummy"
"231653",1,1,0,2,"dummy"
"231654",0,1,0,1,"dummy"
"231655",0,1,0,1,"dummy"
"231662",0,0,1,1,"dummy"
"231663",0,1,0,1,"dummy"
"231664",0,0,6,6,"dummy"
"231665",0,6,1,7,"dummy"
"231666",7,18,0,25,"dummy"
"231667",4,0,0,4,"dummy"
"231679",0,0,1,1,"dummy"
"231680",0,0,2,2,"dummy"
"231681",0,5,1,6,"dummy"
"231682",0,0,1,1,"dummy"
"231683",0,0,1,1,"dummy"
"231684",0,4,0,4,"dummy"
"231685",0,1,0,1,"dummy"
"231686",40,7,6,53,"dummy"
"231687",0,1,0,1,"dummy"
"231688",0,1,0,1,"dummy"
"231695",1,0,0,1,"dummy"
"231703",3,0,0,3,"dummy"
"231704",6,1,0,7,"dummy"
"231705",0,2,0,2,"dummy"
"231706",1,0,0,1,"dummy"
"231707",0,0,1,1,"dummy"
"231708",2,11,0,13,"dummy"
"231709",0,0,1,1,"dummy"
"231710",0,0,1,1,"dummy"
"231711",4,4,3,11,"dummy"
"231714",2,3,0,5,"dummy"
"231715",7,6,0,13,"dummy"
"231716",1,4,1,6,"dummy"
"231717",1,1,0,2,"dummy"
"231720",8,0,1,9,"dummy"
"231727",0,0,1,1,"dummy"
"231728",2,1,0,3,"dummy"
"231729",0,3,0,3,"dummy"
"231730",1,0,0,1,"dummy"
"231731",2,0,0,2,"dummy"
"231732",0,4,0,4,"dummy"
"231733",1,0,0,1,"dummy"
"231734",1,0,0,1,"dummy"
"231735",4,0,0,4,"dummy"
"231736",0,4,0,4,"dummy"
"231780",1,5,3,9,"dummy"
"231781",0,4,0,4,"dummy"
"231782",0,1,0,1,"dummy"
"231783",6,0,0,6,"dummy"
"231784",2,0,1,3,"dummy"
"231785",2,0,1,3,"dummy"
"231786",5,2,1,8,"dummy"
"231789",0,2,0,2,"dummy"
"231790",0,1,0,1,"dummy"
"231791",0,0,1,1,"dummy"
"231792",0,1,1,2,"dummy"
"231793",0,1,0,1,"dummy"
"231794",3,1,2,6,"dummy"
"231795",0,0,1,1,"dummy"
"231677",0,0,1,1,"dummy"
"231690",0,0,1,1,"dummy"
"231691",0,0,2,2,"dummy"
"231699",4,4,0,8,"dummy"
"231700",2,0,0,2,"dummy"
"231701",0,1,0,1,"dummy"
"231738",0,2,1,3,"dummy"
"231741",0,0,1,1,"dummy"
"231742",2,1,1,4,"dummy"
"231743",1,1,1,3,"dummy"
"231744",0,5,3,8,"dummy"
"231765",0,1,0,1,"dummy"
"231766",0,0,2,2,"dummy"
"231767",0,7,0,7,"dummy"
"231768",0,1,0,1,"dummy"
"231769",1,0,0,1,"dummy"
"231770",0,1,0,1,"dummy"
"231771",0,1,0,1,"dummy"
"231772",0,2,0,2,"dummy"
"231773",8,0,0,8,"dummy"
"231774",0,6,0,6,"dummy"
"231775",0,2,0,2,"dummy"
"231776",0,1,0,1,"dummy"
"231777",0,1,0,1,"dummy"
"231778",0,1,0,1,"dummy"
"231803",3,34,1,38,"dummy"
"231808",0,2,0,2,"dummy"
"231809",2,0,0,2,"dummy"
"231810",2,0,0,2,"dummy"
"231811",5,6,5,16,"dummy"
"231812",0,0,1,1,"dummy"
"231813",0,1,2,3,"dummy"
"231814",1,2,0,3,"dummy"
"231815",0,5,0,5,"dummy"
"231816",0,1,0,1,"dummy"
"231817",8,12,0,20,"dummy"
"231818",3,1,0,4,"dummy"
"231819",1,0,1,2,"dummy"
"231820",16,9,1,26,"dummy"
"231821",0,2,0,2,"dummy"
"231822",0,1,0,1,"dummy"
"231825",1,0,0,1,"dummy"
"231826",0,1,0,1,"dummy"
"231827",2,0,0,2,"dummy"
"231828",0,1,0,1,"dummy"
"231831",0,0,1,1,"dummy"
"231838",3,48,1,52,"dummy"
"231839",4,0,0,4,"dummy"
"231840",2,0,1,3,"dummy"
"231841",0,2,0,2,"dummy"
"231842",0,1,0,1,"dummy"
"231843",2,2,0,4,"dummy"
"231844",0,1,0,1,"dummy"
"231845",0,1,0,1,"dummy"
"231846",0,1,0,1,"dummy"
"231847",1,0,0,1,"dummy"
"231860",3,3,0,6,"dummy"
"231861",18,9,3,30,"dummy"
"231862",0,0,1,1,"dummy"
"231865",0,4,0,4,"dummy"
"231874",0,1,0,1,"dummy"
"231887",0,0,2,2,"dummy"
"231888",0,2,0,2,"dummy"
"231891",0,0,0,0,"dummy"
"231892",0,0,0,0,"dummy"
"231893",0,0,0,0,"dummy"
"231910",0,2,0,2,"dummy"
"231849",1,10,1,12,"dummy"
"231881",0,0,0,0,"dummy"
"231882",0,0,0,0,"dummy"
"231895",1,0,2,3,"dummy"
"231896",0,0,1,1,"dummy"
"231897",0,1,3,4,"dummy"
"231898",0,0,2,2,"dummy"
"231901",0,8,1,9,"dummy"
"231912",0,4,2,6,"dummy"
"231915",2,1,1,4,"dummy"
"231916",0,0,1,1,"dummy"
"231932",1,1,0,2,"dummy"
"231933",0,0,1,1,"dummy"
"231934",0,0,2,2,"dummy"
"231935",0,0,1,1,"dummy"
"231936",0,0,1,1,"dummy"
"231937",0,0,1,1,"dummy"
"231938",0,0,1,1,"dummy"
"231939",0,0,1,1,"dummy"
"231940",0,0,1,1,"dummy"
"231941",0,0,1,1,"dummy"
"231942",0,3,2,5,"dummy"
"231943",2,1,0,3,"dummy"
"231956",0,1,0,1,"dummy"
"231973",0,0,2,2,"dummy"
"231974",27,1,0,28,"dummy"
"231975",7,9,3,19,"dummy"
"231978",0,4,0,4,"dummy"
"231979",0,10,0,10,"dummy"
"231980",0,0,1,1,"dummy"
"231981",5,9,0,14,"dummy"
"231982",2,3,0,5,"dummy"
"231983",1,0,0,1,"dummy"
"231984",0,0,0,0,"dummy"
"231985",0,1,0,1,"dummy"
"231986",0,0,1,1,"dummy"
"231987",0,0,1,1,"dummy"
"231990",0,1,0,1,"dummy"
"231991",2,5,0,7,"dummy"
"231992",0,1,0,1,"dummy"
"231993",0,1,0,1,"dummy"
"231994",0,1,0,1,"dummy"
"231995",0,1,0,1,"dummy"
"231996",0,0,0,0,"dummy"
"231997",0,0,1,1,"dummy"
"231998",0,0,1,1,"dummy"
"231999",0,1,1,2,"dummy"
"232000",2,0,0,2,"dummy"
"232001",1,0,0,1,"dummy"
"232014",0,5,0,5,"dummy"
"232015",3,2,0,5,"dummy"
"232016",0,1,0,1,"dummy"
"232017",0,5,0,5,"dummy"
"232018",3,4,0,7,"dummy"
"232019",0,1,0,1,"dummy"
"232020",0,1,0,1,"dummy"
"232021",0,2,0,2,"dummy"
"232022",0,0,1,1,"dummy"
"232023",0,2,0,2,"dummy"
"232024",0,0,2,2,"dummy"
"232025",11,7,2,20,"dummy"
"232026",0,4,0,4,"dummy"
"232027",2,0,1,3,"dummy"
"232028",2,0,0,2,"dummy"
"232029",6,5,3,14,"dummy"
"232030",0,1,0,1,"dummy"
"232031",5,6,3,14,"dummy"
"232032",1,0,2,3,"dummy"
"232033",0,2,0,2,"dummy"
"232034",0,1,0,1,"dummy"
"232035",1,5,0,6,"dummy"
"232036",2,0,1,3,"dummy"
"232037",0,2,0,2,"dummy"
"232038",2,0,1,3,"dummy"
"232039",5,0,0,5,"dummy"
"232040",0,2,0,2,"dummy"
"232041",2,3,1,6,"dummy"
"232042",0,2,1,3,"dummy"
"232043",5,0,0,5,"dummy"
"232044",10,4,1,15,"dummy"
"231926",8,12,0,20,"dummy"
"231927",0,0,0,0,"dummy"
"231928",4,45,0,49,"dummy"
"231929",1,2,0,3,"dummy"
"231930",0,1,0,1,"dummy"
"231945",0,1,1,2,"dummy"
"231953",0,2,0,2,"dummy"
"231954",1,0,0,1,"dummy"
"231958",0,0,0,0,"dummy"
"231959",0,1,0,1,"dummy"
"231964",1,8,0,9,"dummy"
"231965",0,2,1,3,"dummy"
"231966",1,5,3,9,"dummy"
"231967",0,0,1,1,"dummy"
"231968",0,0,2,2,"dummy"
"231969",0,0,1,1,"dummy"
"231970",0,0,1,1,"dummy"
"231971",0,0,1,1,"dummy"
"232003",5,7,4,16,"dummy"
"232006",0,1,2,3,"dummy"
"232007",0,0,0,0,"dummy"
"232008",0,1,0,1,"dummy"
"232009",4,0,2,6,"dummy"
"232010",1,0,0,1,"dummy"
"232011",0,0,0,0,"dummy"
"232012",0,0,0,0,"dummy"
"232093",0,0,0,0,"dummy"
"232094",0,0,0,0,"dummy"
"232097",4,11,0,15,"dummy"
"232098",1,0,1,2,"dummy"
"232099",0,2,0,2,"dummy"
"232108",1,0,0,1,"dummy"
"232109",0,1,0,1,"dummy"
"232110",0,1,0,1,"dummy"
"232113",0,0,1,1,"dummy"
"232114",0,0,1,1,"dummy"
"232115",0,0,1,1,"dummy"
"232116",0,0,1,1,"dummy"
"232123",0,1,0,1,"dummy"
"232124",0,1,0,1,"dummy"
"232128",0,1,0,1,"dummy"
"232129",0,0,1,1,"dummy"
"232137",0,0,1,1,"dummy"
"232144",6,16,5,27,"dummy"
"232150",0,0,0,0,"dummy"
"232151",1,5,0,6,"dummy"
"232152",2,0,0,2,"dummy"
"232155",3,0,0,3,"dummy"
"232156",0,0,0,0,"dummy"
"232045",1,1,1,3,"dummy"
"232046",0,0,1,1,"dummy"
"232047",0,0,1,1,"dummy"
"232048",0,0,1,1,"dummy"
"232049",0,0,1,1,"dummy"
"232050",0,0,1,1,"dummy"
"232051",0,0,1,1,"dummy"
"232052",0,0,1,1,"dummy"
"232053",6,4,2,12,"dummy"
"232054",0,0,1,1,"dummy"
"232055",0,2,1,3,"dummy"
"232056",3,1,0,4,"dummy"
"232057",0,0,1,1,"dummy"
"232058",0,0,1,1,"dummy"
"232059",0,0,1,1,"dummy"
"232060",0,0,1,1,"dummy"
"232061",0,0,1,1,"dummy"
"232064",0,0,0,0,"dummy"
"232065",0,0,0,0,"dummy"
"232085",4,6,3,13,"dummy"
"232086",0,2,0,2,"dummy"
"232087",0,8,0,8,"dummy"
"232088",7,3,1,11,"dummy"
"232089",9,0,0,9,"dummy"
"232090",0,0,1,1,"dummy"
"232091",1,1,0,2,"dummy"
"232101",0,1,0,1,"dummy"
"232102",0,3,0,3,"dummy"
"232103",0,2,0,2,"dummy"
"232104",1,0,0,1,"dummy"
"232105",0,5,0,5,"dummy"
"232106",0,2,0,2,"dummy"
"232118",2,2,1,5,"dummy"
"232119",0,0,1,1,"dummy"
"232120",0,2,0,2,"dummy"
"232121",1,5,0,6,"dummy"
"232126",0,2,0,2,"dummy"
"232131",0,0,0,0,"dummy"
"232134",0,1,1,2,"dummy"
"232135",0,0,1,1,"dummy"
"232158",1,6,2,9,"dummy"
"232233",3,4,0,7,"dummy"
"232234",0,4,1,5,"dummy"
"232235",1,0,1,2,"dummy"
"232301",0,0,1,1,"dummy"
"232303",1,2,2,5,"dummy"
"232309",3,0,0,3,"dummy"
"232310",0,0,0,0,"dummy"
"232313",0,0,2,2,"dummy"
"232314",0,0,1,1,"dummy"
"232317",0,0,2,2,"dummy"
"232318",0,1,0,1,"dummy"
"232319",0,0,1,1,"dummy"
"232320",0,0,1,1,"dummy"
"232321",0,0,1,1,"dummy"
"232323",0,0,1,1,"dummy"
"232326",1,6,3,10,"dummy"
"232328",34,9,4,47,"dummy"
"232329",0,3,1,4,"dummy"
"232330",8,3,1,12,"dummy"
"232331",0,0,1,1,"dummy"
"232332",0,0,2,2,"dummy"
"232333",2,0,0,2,"dummy"
"232334",0,3,0,3,"dummy"
"232337",0,0,2,2,"dummy"
"232339",0,5,0,5,"dummy"
"232343",0,1,0,1,"dummy"
"232344",1,2,0,3,"dummy"
"232345",0,4,2,6,"dummy"
"232349",0,0,1,1,"dummy"
"232352",0,0,0,0,"dummy"
"232353",0,0,2,2,"dummy"
"232354",0,3,1,4,"dummy"
"232355",0,0,1,1,"dummy"
"232356",0,0,1,1,"dummy"
"232357",0,0,1,1,"dummy"
"232361",2,0,3,5,"dummy"
"232363",0,5,0,5,"dummy"
"232386",0,1,0,1,"dummy"
"232388",5,17,1,23,"dummy"
"232389",0,2,0,2,"dummy"
"232390",0,0,1,1,"dummy"
"232391",11,17,8,36,"dummy"
"232392",13,13,0,26,"dummy"
"232393",0,1,0,1,"dummy"
"232394",8,8,1,17,"dummy"
"232395",0,0,1,1,"dummy"
"232396",14,3,0,17,"dummy"
"232397",0,1,0,1,"dummy"
"232398",0,2,0,2,"dummy"
"232399",0,3,0,3,"dummy"
"232400",0,5,0,5,"dummy"
"232401",1,0,0,1,"dummy"
"232402",0,0,1,1,"dummy"
"232403",0,2,0,2,"dummy"
"232404",0,1,0,1,"dummy"
"232405",0,1,0,1,"dummy"
"232406",31,4,0,35,"dummy"
"232407",0,1,1,2,"dummy"
"232408",1,0,0,1,"dummy"
"232409",0,1,1,2,"dummy"
"232412",2,3,0,5,"dummy"
"232416",6,7,1,14,"dummy"
"232417",1,1,0,2,"dummy"
"232418",2,0,0,2,"dummy"
"232419",0,1,0,1,"dummy"
"232420",0,0,1,1,"dummy"
"232421",0,0,0,0,"dummy"
"232422",0,0,0,0,"dummy"
"232423",0,1,0,1,"dummy"
"232455",0,0,0,0,"dummy"
"232466",2,3,0,5,"dummy"
"232467",8,9,4,21,"dummy"
"232468",0,2,0,2,"dummy"
"232469",9,0,3,12,"dummy"
"232470",3,4,1,8,"dummy"
"232471",1,0,1,2,"dummy"
"232473",0,5,0,5,"dummy"
"232474",0,2,0,2,"dummy"
"232475",2,0,3,5,"dummy"
"232476",0,3,0,3,"dummy"
"232477",0,0,1,1,"dummy"
"232478",0,1,1,2,"dummy"
"232479",1,0,0,1,"dummy"
"232480",2,0,0,2,"dummy"
"232481",0,0,2,2,"dummy"
"232482",1,1,1,3,"dummy"
"232484",1,0,1,2,"dummy"
"232485",0,1,1,2,"dummy"
"232486",0,1,1,2,"dummy"
"232487",0,3,0,3,"dummy"
"232493",0,2,0,2,"dummy"
"232494",1,16,4,21,"dummy"
"232503",0,0,2,2,"dummy"
"232504",0,1,1,2,"dummy"
"232511",0,0,1,1,"dummy"
"232512",1,0,0,1,"dummy"
"232513",0,0,1,1,"dummy"
"232514",1,20,3,24,"dummy"
"232515",2,7,6,15,"dummy"
"232516",0,2,0,2,"dummy"
"232517",4,1,0,5,"dummy"
"232518",22,5,3,30,"dummy"
"232519",0,0,1,1,"dummy"
"232520",0,0,1,1,"dummy"
"232521",0,0,2,2,"dummy"
"232522",0,0,1,1,"dummy"
"232523",3,6,0,9,"dummy"
"232525",0,1,0,1,"dummy"
"232530",0,0,1,1,"dummy"
"232531",0,2,0,2,"dummy"
"232532",0,0,2,2,"dummy"
"232534",0,0,1,1,"dummy"
"232535",0,1,0,1,"dummy"
"232537",0,0,2,2,"dummy"
"232538",0,0,1,1,"dummy"
"232539",0,6,1,7,"dummy"
"232540",2,0,0,2,"dummy"
"232547",0,1,0,1,"dummy"
"232548",2,3,2,7,"dummy"
"232549",0,2,0,2,"dummy"
"232550",0,1,2,3,"dummy"
"232551",2,10,1,13,"dummy"
"232552",0,1,0,1,"dummy"
"232553",3,0,1,4,"dummy"
"232554",2,0,0,2,"dummy"
"232562",0,0,1,1,"dummy"
"232564",40,13,5,58,"dummy"
"232565",0,1,0,1,"dummy"
"232566",0,2,0,2,"dummy"
"232567",0,1,0,1,"dummy"
"232581",0,1,0,1,"dummy"
"232582",0,0,1,1,"dummy"
"232584",1,2,3,6,"dummy"
"232606",5,8,0,13,"dummy"
"232619",2,5,0,7,"dummy"
"232620",0,0,1,1,"dummy"
"232621",12,10,3,25,"dummy"
"232622",0,0,0,0,"dummy"
"232623",0,0,0,0,"dummy"
"232624",0,0,0,0,"dummy"
"232625",2,3,0,5,"dummy"
"232626",1,2,0,3,"dummy"
"232627",4,3,1,8,"dummy"
"232628",0,0,0,0,"dummy"
"232629",0,0,0,0,"dummy"
"232630",0,1,0,1,"dummy"
"232631",2,2,1,5,"dummy"
"232632",3,1,1,5,"dummy"
"232633",0,0,0,0,"dummy"
"232634",0,0,0,0,"dummy"
"232635",0,0,0,0,"dummy"
"232649",0,1,0,1,"dummy"
"232650",2,6,2,10,"dummy"
"232651",6,2,2,10,"dummy"
"232652",0,1,0,1,"dummy"
"232653",2,5,2,9,"dummy"
"232657",0,0,1,1,"dummy"
"232658",0,0,1,1,"dummy"
"232661",0,13,1,14,"dummy"
"232664",0,1,0,1,"dummy"
"232665",2,6,3,11,"dummy"
"232666",0,1,0,1,"dummy"
"232668",1,0,1,2,"dummy"
"232669",0,1,0,1,"dummy"
"232670",0,0,1,1,"dummy"
"232671",0,1,1,2,"dummy"
"232672",0,0,1,1,"dummy"
"232674",9,11,0,20,"dummy"
"232675",4,6,0,10,"dummy"
"232676",12,9,3,24,"dummy"
"232677",0,2,0,2,"dummy"
"232679",0,0,1,1,"dummy"
"232681",0,8,0,8,"dummy"
"232682",0,0,0,0,"dummy"
"232683",0,0,1,1,"dummy"
"232685",0,0,1,1,"dummy"
"232686",0,6,1,7,"dummy"
"232687",0,0,1,1,"dummy"
"232691",0,0,0,0,"dummy"
"232692",5,0,2,7,"dummy"
"232693",0,0,0,0,"dummy"
"232697",3,1,1,5,"dummy"
"232702",0,2,0,2,"dummy"
"232703",0,1,0,1,"dummy"
"232704",3,1,1,5,"dummy"
"232705",0,1,0,1,"dummy"
"232706",1,0,0,1,"dummy"
"232707",0,5,1,6,"dummy"
"232708",0,1,0,1,"dummy"
"232709",7,2,2,11,"dummy"
"232710",1,1,0,2,"dummy"
"232712",0,1,0,1,"dummy"
"232713",4,5,1,10,"dummy"
"232714",2,4,1,7,"dummy"
"232717",3,2,1,6,"dummy"
"232718",1,0,0,1,"dummy"
"232719",1,1,0,2,"dummy"
"232720",0,0,1,1,"dummy"
"232721",0,1,0,1,"dummy"
"232722",1,0,0,1,"dummy"
"232723",6,10,1,17,"dummy"
"232724",4,8,0,12,"dummy"
"232725",0,0,0,0,"dummy"
"232726",10,1,0,11,"dummy"
"232737",4,21,2,27,"dummy"
"232739",1,0,2,3,"dummy"
"232740",1,0,0,1,"dummy"
"232741",0,1,0,1,"dummy"
"232742",0,1,0,1,"dummy"
"232743",0,0,1,1,"dummy"
"232744",1,0,0,1,"dummy"
"232745",2,2,0,4,"dummy"
"232746",0,0,1,1,"dummy"
"232747",0,1,0,1,"dummy"
"232748",0,0,2,2,"dummy"
"232749",0,1,3,4,"dummy"
"232752",0,1,0,1,"dummy"
"232753",0,1,0,1,"dummy"
"232754",1,5,0,6,"dummy"
"232755",0,1,0,1,"dummy"
"232826",0,6,0,6,"dummy"
"232828",0,0,0,0,"dummy"
"232829",0,0,1,1,"dummy"
"232844",0,1,0,1,"dummy"
"232850",0,1,0,1,"dummy"
"232851",0,0,1,1,"dummy"
"232852",0,0,3,3,"dummy"
"232853",2,0,1,3,"dummy"
"232855",0,0,1,1,"dummy"
"232857",0,0,1,1,"dummy"
"232859",0,1,0,1,"dummy"
"232861",0,1,0,1,"dummy"
"232862",2,1,0,3,"dummy"
"232863",0,0,0,0,"dummy"
"232864",0,2,1,3,"dummy"
"232865",1,1,0,2,"dummy"
"232866",0,0,0,0,"dummy"
"232867",2,2,0,4,"dummy"
"232868",3,2,0,5,"dummy"
"232869",0,0,2,2,"dummy"
"232871",0,0,0,0,"dummy"
"232872",0,0,0,0,"dummy"
"232875",1,1,0,2,"dummy"
"232876",2,3,1,6,"dummy"
"232878",3,4,0,7,"dummy"
"232879",0,2,0,2,"dummy"
"232880",0,0,1,1,"dummy"
"232881",1,0,0,1,"dummy"
"232882",0,0,1,1,"dummy"
"232883",0,0,1,1,"dummy"
"232884",0,0,2,2,"dummy"
"232885",0,0,1,1,"dummy"
"232886",2,2,0,4,"dummy"
"232887",0,0,1,1,"dummy"
"232893",0,0,2,2,"dummy"
"232894",0,0,2,2,"dummy"
"232895",0,0,0,0,"dummy"
"232896",0,0,0,0,"dummy"
"232897",0,0,0,0,"dummy"
"232898",0,0,0,0,"dummy"
"232899",0,1,0,1,"dummy"
"232907",4,3,6,13,"dummy"
"232912",0,0,1,1,"dummy"
"232915",0,0,2,2,"dummy"
"232916",2,0,0,2,"dummy"
"232919",0,0,1,1,"dummy"
"232923",0,0,3,3,"dummy"
"232929",1,11,6,18,"dummy"
"232933",0,3,0,3,"dummy"
"232934",0,3,0,3,"dummy"
"232935",0,0,0,0,"dummy"
"232936",0,2,0,2,"dummy"
"232937",0,2,0,2,"dummy"
"232938",0,2,0,2,"dummy"
"232939",0,2,0,2,"dummy"
"232940",0,2,0,2,"dummy"
"232941",0,0,1,1,"dummy"
"232942",0,0,1,1,"dummy"
"232943",0,0,1,1,"dummy"
"232944",0,0,0,0,"dummy"
"232951",0,1,0,1,"dummy"
"232968",0,0,1,1,"dummy"
"233032",4,1,0,5,"dummy"
"233033",0,0,1,1,"dummy"
"233034",0,0,1,1,"dummy"
"233035",0,5,0,5,"dummy"
"233036",0,1,0,1,"dummy"
"233037",0,1,0,1,"dummy"
"233038",0,1,0,1,"dummy"
"233058",0,0,0,0,"dummy"
"233059",0,0,0,0,"dummy"
"233060",0,0,1,1,"dummy"
"233064",0,1,0,1,"dummy"
"233065",1,5,1,7,"dummy"
"233066",0,12,0,12,"dummy"
"233076",0,1,0,1,"dummy"
"233077",0,1,2,3,"dummy"
"233078",0,1,0,1,"dummy"
"233079",17,1,0,18,"dummy"
"233080",0,1,0,1,"dummy"
"233081",0,0,0,0,"dummy"
"233082",1,2,0,3,"dummy"
"233083",1,1,0,2,"dummy"
"233084",0,1,0,1,"dummy"
"233085",2,6,0,8,"dummy"
"233086",1,0,0,1,"dummy"
"233087",0,0,0,0,"dummy"
"233088",0,1,0,1,"dummy"
"233089",0,1,0,1,"dummy"
"233090",0,0,1,1,"dummy"
"233091",0,2,0,2,"dummy"
"233092",0,2,0,2,"dummy"
"233093",0,3,1,4,"dummy"
"233094",0,0,0,0,"dummy"
"233095",1,0,0,1,"dummy"
"233096",0,0,0,0,"dummy"
"233097",0,1,0,1,"dummy"
"233098",0,0,0,0,"dummy"
"233099",0,0,0,0,"dummy"
"233103",1,0,0,1,"dummy"
"233110",2,0,0,2,"dummy"
"232901",0,1,0,1,"dummy"
"232921",2,1,1,4,"dummy"
"232925",0,0,2,2,"dummy"
"232931",0,1,0,1,"dummy"
"232955",5,8,0,13,"dummy"
"232956",3,2,0,5,"dummy"
"232957",2,6,0,8,"dummy"
"232958",6,2,0,8,"dummy"
"232959",0,1,0,1,"dummy"
"232960",4,9,0,13,"dummy"
"232961",6,2,0,8,"dummy"
"232962",0,0,1,1,"dummy"
"232970",4,0,0,4,"dummy"
"232971",1,3,0,4,"dummy"
"232972",0,0,0,0,"dummy"
"233024",0,1,0,1,"dummy"
"233025",0,0,1,1,"dummy"
"233026",0,0,1,1,"dummy"
"233042",0,2,0,2,"dummy"
"233043",2,7,0,9,"dummy"
"233044",0,1,0,1,"dummy"
"233045",0,2,0,2,"dummy"
"233046",4,13,5,22,"dummy"
"233047",0,0,0,0,"dummy"
"233048",8,2,7,17,"dummy"
"233049",0,1,0,1,"dummy"
"233050",1,3,0,4,"dummy"
"233051",2,0,0,2,"dummy"
"233052",1,1,0,2,"dummy"
"233053",1,0,0,1,"dummy"
"233056",0,0,0,0,"dummy"
"233062",6,6,3,15,"dummy"
"233068",2,4,0,6,"dummy"
"233069",0,2,0,2,"dummy"
"233070",0,2,0,2,"dummy"
"233071",10,2,0,12,"dummy"
"233072",0,2,0,2,"dummy"
"233073",0,0,0,0,"dummy"
"233074",0,0,3,3,"dummy"
"233101",1,0,1,2,"dummy"
"233105",0,0,1,1,"dummy"
"233106",2,4,2,8,"dummy"
"233107",1,0,0,1,"dummy"
"233108",2,0,0,2,"dummy"
"233139",1,14,2,17,"dummy"
"233140",16,30,2,48,"dummy"
"233141",4,12,0,16,"dummy"
"233142",0,2,5,7,"dummy"
"233143",0,10,1,11,"dummy"
"233144",0,1,0,1,"dummy"
"233145",3,4,0,7,"dummy"
"233146",6,7,0,13,"dummy"
"233147",0,0,4,4,"dummy"
"233181",0,0,2,2,"dummy"
"233182",1,0,1,2,"dummy"
"233204",0,0,0,0,"dummy"
"233205",1,2,0,3,"dummy"
"233206",4,0,0,4,"dummy"
"233207",0,0,0,0,"dummy"
"233208",0,0,0,0,"dummy"
"233209",0,0,0,0,"dummy"
"233210",0,0,0,0,"dummy"
"233211",0,2,0,2,"dummy"
"233222",2,3,0,5,"dummy"
"233223",0,0,1,1,"dummy"
"233224",8,3,0,11,"dummy"
"233225",1,0,0,1,"dummy"
"233226",1,6,0,7,"dummy"
"233227",0,1,1,2,"dummy"
"233228",2,2,0,4,"dummy"
"233229",0,5,1,6,"dummy"
"233184",3,5,1,9,"dummy"
"233185",5,3,1,9,"dummy"
"233186",2,2,0,4,"dummy"
"233187",3,18,2,23,"dummy"
"233188",0,1,0,1,"dummy"
"233189",0,0,0,0,"dummy"
"233190",16,0,2,18,"dummy"
"233191",2,3,0,5,"dummy"
"233192",0,0,1,1,"dummy"
"233193",1,2,0,3,"dummy"
"233196",0,0,0,0,"dummy"
"233213",3,0,0,3,"dummy"
"233214",16,2,2,20,"dummy"
"233215",0,2,0,2,"dummy"
"233218",0,2,0,2,"dummy"
"233219",1,1,1,3,"dummy"
"233220",0,3,0,3,"dummy"
"233293",0,0,0,0,"dummy"
"233294",0,0,0,0,"dummy"
"233301",0,1,0,1,"dummy"
"233302",0,0,2,2,"dummy"
"233303",0,0,1,1,"dummy"
"233304",1,1,0,2,"dummy"
"233305",0,1,0,1,"dummy"
"233306",3,26,0,29,"dummy"
"233307",0,0,1,1,"dummy"
"233308",0,0,1,1,"dummy"
"233314",0,0,0,0,"dummy"
"233315",0,1,0,1,"dummy"
"233316",0,1,0,1,"dummy"
"233317",2,1,1,4,"dummy"
"233318",5,1,0,6,"dummy"
"233372",0,0,1,1,"dummy"
"233376",0,0,1,1,"dummy"
"233377",1,0,0,1,"dummy"
"233378",0,0,1,1,"dummy"
"233379",5,17,1,23,"dummy"
"233380",16,5,2,23,"dummy"
"233381",0,1,0,1,"dummy"
"233382",2,4,0,6,"dummy"
"233383",0,2,0,2,"dummy"
"233384",1,0,0,1,"dummy"
"233385",1,0,1,2,"dummy"
"233386",0,0,0,0,"dummy"
"233387",0,2,0,2,"dummy"
"233388",3,0,0,3,"dummy"
"233389",0,1,0,1,"dummy"
"233390",1,0,3,4,"dummy"
"233391",3,8,4,15,"dummy"
"233392",0,3,1,4,"dummy"
"233393",0,0,1,1,"dummy"
"233394",0,3,0,3,"dummy"
"233395",3,3,1,7,"dummy"
"233396",0,3,0,3,"dummy"
"233397",2,0,0,2,"dummy"
"233398",1,0,0,1,"dummy"
"233399",0,0,1,1,"dummy"
"233400",0,0,1,1,"dummy"
"233401",0,0,1,1,"dummy"
"233402",0,0,1,1,"dummy"
"233403",0,0,1,1,"dummy"
"233404",0,1,1,2,"dummy"
"233405",0,0,1,1,"dummy"
"233406",0,0,1,1,"dummy"
"233407",0,0,1,1,"dummy"
"233408",0,0,0,0,"dummy"
"233409",2,3,0,5,"dummy"
"233410",0,0,1,1,"dummy"
"233411",1,0,0,1,"dummy"
"233412",3,4,0,7,"dummy"
"233413",0,0,1,1,"dummy"
"233414",1,1,1,3,"dummy"
"233415",6,6,0,12,"dummy"
"233230",0,1,0,1,"dummy"
"233231",1,2,0,3,"dummy"
"233232",0,0,1,1,"dummy"
"233233",0,2,0,2,"dummy"
"233234",1,1,0,2,"dummy"
"233235",0,8,0,8,"dummy"
"233236",0,0,1,1,"dummy"
"233237",1,3,0,4,"dummy"
"233238",0,1,0,1,"dummy"
"233239",0,1,0,1,"dummy"
"233240",0,1,0,1,"dummy"
"233241",0,2,0,2,"dummy"
"233242",0,1,0,1,"dummy"
"233243",0,3,1,4,"dummy"
"233244",0,0,1,1,"dummy"
"233245",0,2,0,2,"dummy"
"233246",0,0,1,1,"dummy"
"233249",0,0,2,2,"dummy"
"233250",0,0,1,1,"dummy"
"233251",0,0,2,2,"dummy"
"233252",0,0,1,1,"dummy"
"233253",3,0,0,3,"dummy"
"233254",0,1,0,1,"dummy"
"233255",0,0,1,1,"dummy"
"233256",0,0,1,1,"dummy"
"233257",0,0,1,1,"dummy"
"233258",0,0,1,1,"dummy"
"233259",0,0,0,0,"dummy"
"233260",0,0,1,1,"dummy"
"233261",0,0,1,1,"dummy"
"233262",0,0,1,1,"dummy"
"233263",0,0,1,1,"dummy"
"233264",0,0,1,1,"dummy"
"233265",0,0,1,1,"dummy"
"233266",0,0,1,1,"dummy"
"233267",0,0,1,1,"dummy"
"233268",0,0,1,1,"dummy"
"233269",0,0,0,0,"dummy"
"233270",0,0,1,1,"dummy"
"233271",0,0,1,1,"dummy"
"233272",0,0,1,1,"dummy"
"233277",0,1,0,1,"dummy"
"233278",1,3,2,6,"dummy"
"233279",0,1,2,3,"dummy"
"233280",1,1,0,2,"dummy"
"233281",0,0,2,2,"dummy"
"233282",0,1,1,2,"dummy"
"233283",1,2,0,3,"dummy"
"233284",5,5,0,10,"dummy"
"233285",5,4,0,9,"dummy"
"233286",2,3,0,5,"dummy"
"233287",0,2,1,3,"dummy"
"233290",0,3,1,4,"dummy"
"233291",0,0,0,0,"dummy"
"233320",0,1,0,1,"dummy"
"233321",0,0,1,1,"dummy"
"233322",1,0,1,2,"dummy"
"233323",0,0,1,1,"dummy"
"233326",0,2,0,2,"dummy"
"233327",4,0,0,4,"dummy"
"233328",5,3,1,9,"dummy"
"233329",0,0,1,1,"dummy"
"233330",0,2,0,2,"dummy"
"233331",0,0,0,0,"dummy"
"233332",1,1,0,2,"dummy"
"233333",0,0,0,0,"dummy"
"233334",0,1,1,2,"dummy"
"233335",0,0,0,0,"dummy"
"233336",0,0,1,1,"dummy"
"233337",0,0,0,0,"dummy"
"233338",0,2,0,2,"dummy"
"233339",0,0,1,1,"dummy"
"233340",0,0,2,2,"dummy"
"233341",0,0,1,1,"dummy"
"233342",0,1,0,1,"dummy"
"233343",0,0,1,1,"dummy"
"233344",0,0,1,1,"dummy"
"233345",0,0,1,1,"dummy"
"233346",0,0,1,1,"dummy"
"233347",0,0,0,0,"dummy"
"233348",0,9,1,10,"dummy"
"233349",0,0,1,1,"dummy"
"233350",9,1,0,10,"dummy"
"233351",0,0,1,1,"dummy"
"233352",0,0,1,1,"dummy"
"233353",0,0,0,0,"dummy"
"233354",0,0,0,0,"dummy"
"233355",0,0,1,1,"dummy"
"233356",0,0,1,1,"dummy"
"233357",0,0,0,0,"dummy"
"233358",0,0,0,0,"dummy"
"233359",0,0,0,0,"dummy"
"233360",1,0,0,1,"dummy"
"233361",0,1,0,1,"dummy"
"233362",0,0,0,0,"dummy"
"233363",2,9,1,12,"dummy"
"233364",0,1,0,1,"dummy"
"233365",0,0,1,1,"dummy"
"233366",0,0,1,1,"dummy"
"233369",0,0,1,1,"dummy"
"233370",0,1,0,1,"dummy"
"233374",0,1,1,2,"dummy"
"233425",1,2,0,3,"dummy"
"233426",1,0,0,1,"dummy"
"233429",0,0,0,0,"dummy"
"233430",0,0,0,0,"dummy"
"233433",0,1,0,1,"dummy"
"233445",1,0,0,1,"dummy"
"233446",2,2,0,4,"dummy"
"233447",2,0,0,2,"dummy"
"233448",0,6,0,6,"dummy"
"233449",1,0,0,1,"dummy"
"233450",0,2,1,3,"dummy"
"233451",0,1,0,1,"dummy"
"233452",0,0,1,1,"dummy"
"233453",0,3,0,3,"dummy"
"233454",0,0,1,1,"dummy"
"233455",1,4,0,5,"dummy"
"233456",2,0,0,2,"dummy"
"233480",0,0,1,1,"dummy"
"233481",33,1,2,36,"dummy"
"233482",1,0,0,1,"dummy"
"233485",0,0,2,2,"dummy"
"233486",1,1,2,4,"dummy"
"233487",0,1,0,1,"dummy"
"233488",0,1,0,1,"dummy"
"233489",5,1,1,7,"dummy"
"233490",0,1,0,1,"dummy"
"233491",3,1,0,4,"dummy"
"233492",0,2,0,2,"dummy"
"233493",5,4,1,10,"dummy"
"233494",0,1,0,1,"dummy"
"233495",1,0,0,1,"dummy"
"233496",1,18,1,20,"dummy"
"233497",2,0,0,2,"dummy"
"233498",1,0,0,1,"dummy"
"233501",0,0,3,3,"dummy"
"233510",0,4,0,4,"dummy"
"233511",0,1,0,1,"dummy"
"233512",0,1,0,1,"dummy"
"233513",1,2,0,3,"dummy"
"233514",0,1,0,1,"dummy"
"233515",0,3,3,6,"dummy"
"233516",2,5,0,7,"dummy"
"233523",4,0,3,7,"dummy"
"233524",0,2,0,2,"dummy"
"233525",1,2,1,4,"dummy"
"233526",0,0,1,1,"dummy"
"233527",1,0,1,2,"dummy"
"233528",0,3,1,4,"dummy"
"233529",0,1,0,1,"dummy"
"233530",0,1,0,1,"dummy"
"233531",0,2,0,2,"dummy"
"233532",1,0,0,1,"dummy"
"233533",0,0,4,4,"dummy"
"233534",1,0,0,1,"dummy"
"233535",0,0,3,3,"dummy"
"233536",0,0,1,1,"dummy"
"233537",0,1,0,1,"dummy"
"233538",0,0,2,2,"dummy"
"233539",0,3,3,6,"dummy"
"233540",0,0,1,1,"dummy"
"233541",0,0,1,1,"dummy"
"233544",0,0,1,1,"dummy"
"233545",0,0,1,1,"dummy"
"233546",2,3,0,5,"dummy"
"233552",0,5,0,5,"dummy"
"233553",0,5,0,5,"dummy"
"233554",0,0,1,1,"dummy"
"233565",0,0,1,1,"dummy"
"233566",0,0,2,2,"dummy"
"233567",0,0,1,1,"dummy"
"233568",9,1,2,12,"dummy"
"233569",0,0,1,1,"dummy"
"233570",0,0,1,1,"dummy"
"233571",0,0,1,1,"dummy"
"233572",0,2,0,2,"dummy"
"233575",0,0,1,1,"dummy"
"233576",0,0,1,1,"dummy"
"233416",0,0,1,1,"dummy"
"233417",0,0,1,1,"dummy"
"233418",0,0,1,1,"dummy"
"233419",0,0,1,1,"dummy"
"233420",0,0,1,1,"dummy"
"233421",0,0,1,1,"dummy"
"233422",0,0,1,1,"dummy"
"233423",0,0,1,1,"dummy"
"233435",5,7,3,15,"dummy"
"233438",0,0,1,1,"dummy"
"233439",0,0,1,1,"dummy"
"233440",0,0,2,2,"dummy"
"233441",0,0,2,2,"dummy"
"233442",0,2,2,4,"dummy"
"233443",0,1,0,1,"dummy"
"233458",1,2,0,3,"dummy"
"233459",0,1,0,1,"dummy"
"233460",0,3,0,3,"dummy"
"233461",0,1,0,1,"dummy"
"233462",0,4,0,4,"dummy"
"233463",0,1,0,1,"dummy"
"233464",0,1,0,1,"dummy"
"233465",0,1,0,1,"dummy"
"233466",0,1,0,1,"dummy"
"233469",2,0,2,4,"dummy"
"233505",1,1,0,2,"dummy"
"233506",0,1,0,1,"dummy"
"233507",0,2,0,2,"dummy"
"233508",6,0,0,6,"dummy"
"233548",0,1,0,1,"dummy"
"233549",3,2,0,5,"dummy"
"233550",0,4,1,5,"dummy"
"233558",10,19,3,32,"dummy"
"233561",2,0,1,3,"dummy"
"233562",0,0,0,0,"dummy"
"233563",8,1,1,10,"dummy"
"233588",0,2,1,3,"dummy"
"233593",0,1,0,1,"dummy"
"233594",0,1,0,1,"dummy"
"233595",2,1,0,3,"dummy"
"233596",1,2,0,3,"dummy"
"233597",0,0,0,0,"dummy"
"233598",2,2,0,4,"dummy"
"233599",2,3,0,5,"dummy"
"233605",0,5,0,5,"dummy"
"233606",0,1,1,2,"dummy"
"233607",0,0,1,1,"dummy"
"233639",0,0,1,1,"dummy"
"233649",0,16,4,20,"dummy"
"233650",7,0,2,9,"dummy"
"233651",0,0,1,1,"dummy"
"233652",5,0,1,6,"dummy"
"233655",6,0,0,6,"dummy"
"233656",2,5,2,9,"dummy"
"233577",0,0,1,1,"dummy"
"233578",0,0,1,1,"dummy"
"233579",0,0,1,1,"dummy"
"233584",0,15,0,15,"dummy"
"233601",5,4,1,10,"dummy"
"233602",0,1,0,1,"dummy"
"233603",7,3,2,12,"dummy"
"233609",0,1,0,1,"dummy"
"233610",3,8,0,11,"dummy"
"233611",0,1,0,1,"dummy"
"233612",0,0,1,1,"dummy"
"233613",0,0,2,2,"dummy"
"233635",0,0,1,1,"dummy"
"233636",0,3,0,3,"dummy"
"233637",0,1,0,1,"dummy"
"233643",0,3,0,3,"dummy"
"233646",0,0,1,1,"dummy"
"233647",7,0,2,9,"dummy"
"233658",5,2,2,9,"dummy"
"233659",0,0,0,0,"dummy"
"233660",5,18,2,25,"dummy"
"233661",0,1,0,1,"dummy"
"233662",0,1,0,1,"dummy"
"233663",0,3,0,3,"dummy"
"233664",21,1,0,22,"dummy"
"233667",0,1,0,1,"dummy"
"233672",0,0,1,1,"dummy"
"233673",0,0,1,1,"dummy"
"233676",0,1,2,3,"dummy"
"233732",0,1,0,1,"dummy"
"233733",0,1,0,1,"dummy"
"233734",0,2,0,2,"dummy"
"233735",0,6,0,6,"dummy"
"233736",2,0,0,2,"dummy"
"233737",0,0,6,6,"dummy"
"233738",0,0,2,2,"dummy"
"233739",0,2,0,2,"dummy"
"233740",2,0,0,2,"dummy"
"233741",0,2,0,2,"dummy"
"233742",0,2,0,2,"dummy"
"233743",0,0,1,1,"dummy"
"233744",0,1,5,6,"dummy"
"233745",31,5,3,39,"dummy"
"233758",0,4,1,5,"dummy"
"233762",1,0,0,1,"dummy"
"233765",0,3,0,3,"dummy"
"233766",0,1,0,1,"dummy"
"233767",0,1,0,1,"dummy"
"233769",1,10,0,11,"dummy"
"233770",44,1,2,47,"dummy"
"233771",0,2,0,2,"dummy"
"233772",0,1,0,1,"dummy"
"233773",3,6,0,9,"dummy"
"233775",0,0,0,0,"dummy"
"233776",0,0,0,0,"dummy"
"233777",0,1,0,1,"dummy"
"233783",0,1,0,1,"dummy"
"233784",0,0,3,3,"dummy"
"233785",0,1,0,1,"dummy"
"233786",1,1,0,2,"dummy"
"233787",1,0,0,1,"dummy"
"233789",0,0,1,1,"dummy"
"233790",2,0,2,4,"dummy"
"233792",0,0,0,0,"dummy"
"233793",0,10,0,10,"dummy"
"233794",0,2,0,2,"dummy"
"233797",0,1,0,1,"dummy"
"233799",0,0,0,0,"dummy"
"233800",3,4,0,7,"dummy"
"233802",0,6,0,6,"dummy"
"233804",14,21,6,41,"dummy"
"233805",1,0,0,1,"dummy"
"233806",0,3,0,3,"dummy"
"233807",1,0,0,1,"dummy"
"233808",1,1,0,2,"dummy"
"233809",0,0,1,1,"dummy"
"233810",0,0,1,1,"dummy"
"233811",0,2,1,3,"dummy"
"233812",0,0,1,1,"dummy"
"233815",0,0,1,1,"dummy"
"233816",0,2,0,2,"dummy"
"233817",0,0,1,1,"dummy"
"233818",0,0,1,1,"dummy"
"233826",5,1,0,6,"dummy"
"233827",0,3,0,3,"dummy"
"233828",0,0,1,1,"dummy"
"233829",1,4,2,7,"dummy"
"233831",0,11,0,11,"dummy"
"233850",8,8,1,17,"dummy"
"233851",3,2,1,6,"dummy"
"233852",0,2,0,2,"dummy"
"233853",1,1,1,3,"dummy"
"233854",0,1,0,1,"dummy"
"233855",1,2,0,3,"dummy"
"233856",0,1,0,1,"dummy"
"233858",2,5,1,8,"dummy"
"233859",7,1,2,10,"dummy"
"233862",0,3,0,3,"dummy"
"233877",0,0,0,0,"dummy"
"233881",0,0,0,0,"dummy"
"233882",0,0,1,1,"dummy"
"233883",0,0,1,1,"dummy"
"233884",0,0,1,1,"dummy"
"233885",0,0,1,1,"dummy"
"233888",1,0,3,4,"dummy"
"233890",0,2,0,2,"dummy"
"233901",2,2,0,4,"dummy"
"233902",0,1,0,1,"dummy"
"233907",0,2,0,2,"dummy"
"233908",0,0,8,8,"dummy"
"233909",0,2,0,2,"dummy"
"233910",0,2,0,2,"dummy"
"233911",0,0,1,1,"dummy"
"233913",0,0,1,1,"dummy"
"233914",29,2,1,32,"dummy"
"233915",1,0,0,1,"dummy"
"233922",0,0,2,2,"dummy"
"233923",2,1,4,7,"dummy"
"233924",2,1,6,9,"dummy"
"233925",0,1,1,2,"dummy"
"233926",1,0,0,1,"dummy"
"233927",0,0,1,1,"dummy"
"233929",0,0,2,2,"dummy"
"233931",0,0,2,2,"dummy"
"233932",1,2,1,4,"dummy"
"233933",3,1,2,6,"dummy"
"233938",0,0,1,1,"dummy"
"233939",0,0,0,0,"dummy"
"233940",0,0,1,1,"dummy"
"233994",0,0,4,4,"dummy"
"233995",1,0,0,1,"dummy"
"233997",0,0,1,1,"dummy"
"233998",0,0,1,1,"dummy"
"233999",0,0,3,3,"dummy"
"234000",0,0,1,1,"dummy"
"234001",0,0,1,1,"dummy"
"234004",0,0,1,1,"dummy"
"234006",2,0,4,6,"dummy"
"234007",1,3,0,4,"dummy"
"234008",0,6,0,6,"dummy"
"234009",0,2,0,2,"dummy"
"234011",0,0,2,2,"dummy"
"234013",0,0,2,2,"dummy"
"234014",0,0,1,1,"dummy"
"234015",0,0,1,1,"dummy"
"234016",0,0,1,1,"dummy"
"234017",0,0,1,1,"dummy"
"234018",5,3,1,9,"dummy"
"234022",0,2,2,4,"dummy"
"234023",1,0,0,1,"dummy"
"234043",1,1,3,5,"dummy"
"234044",0,0,0,0,"dummy"
"234045",0,1,0,1,"dummy"
"234047",6,3,1,10,"dummy"
"234048",2,5,0,7,"dummy"
"234052",0,0,1,1,"dummy"
"234058",0,1,0,1,"dummy"
"234062",1,0,0,1,"dummy"
"234064",0,0,0,0,"dummy"
"234067",7,5,1,13,"dummy"
"234072",1,1,0,2,"dummy"
"234073",2,8,0,10,"dummy"
"234074",8,4,0,12,"dummy"
"234075",0,0,1,1,"dummy"
"234076",12,13,3,28,"dummy"
"234077",0,0,1,1,"dummy"
"234079",0,0,1,1,"dummy"
"234082",0,0,1,1,"dummy"
"234086",2,6,2,10,"dummy"
"234087",0,1,0,1,"dummy"
"234089",3,0,2,5,"dummy"
"234090",0,0,2,2,"dummy"
"234092",3,20,3,26,"dummy"
"234094",0,0,0,0,"dummy"
"234095",0,0,0,0,"dummy"
"234096",0,2,0,2,"dummy"
"234100",0,1,0,1,"dummy"
"234101",0,1,1,2,"dummy"
"234102",0,1,0,1,"dummy"
"234103",0,0,1,1,"dummy"
"234104",0,1,0,1,"dummy"
"234105",0,1,0,1,"dummy"
"234106",0,2,0,2,"dummy"
"234107",2,2,0,4,"dummy"
"234108",0,0,1,1,"dummy"
"234109",0,0,1,1,"dummy"
"234110",0,4,0,4,"dummy"
"234111",0,1,0,1,"dummy"
"234112",9,5,1,15,"dummy"
"234113",5,0,1,6,"dummy"
"234114",4,4,0,8,"dummy"
"234118",0,1,1,2,"dummy"
"234119",3,0,0,3,"dummy"
"234120",1,0,0,1,"dummy"
"234121",0,1,0,1,"dummy"
"234122",3,3,0,6,"dummy"
"234124",0,1,0,1,"dummy"
"234125",2,0,0,2,"dummy"
"234126",0,0,4,4,"dummy"
"234127",1,0,0,1,"dummy"
"234135",0,1,0,1,"dummy"
"234136",0,1,1,2,"dummy"
"234137",1,2,0,3,"dummy"
"234138",0,0,1,1,"dummy"
"234139",1,0,1,2,"dummy"
"234140",1,3,0,4,"dummy"
"234141",0,1,0,1,"dummy"
"234142",0,2,3,5,"dummy"
"234143",0,0,1,1,"dummy"
"234148",0,0,3,3,"dummy"
"234149",0,1,0,1,"dummy"
"234150",0,1,0,1,"dummy"
"234154",0,1,0,1,"dummy"
"234155",0,1,1,2,"dummy"
"234156",0,0,1,1,"dummy"
"234166",0,17,2,19,"dummy"
"234167",0,1,0,1,"dummy"
"234168",0,2,0,2,"dummy"
"234169",0,1,1,2,"dummy"
"234172",0,2,0,2,"dummy"
"234173",4,14,2,20,"dummy"
"234207",0,1,0,1,"dummy"
"234211",0,1,0,1,"dummy"
"234212",0,7,1,8,"dummy"
"234288",4,2,1,7,"dummy"
"234289",0,0,1,1,"dummy"
"234290",6,9,0,15,"dummy"
"234291",0,2,0,2,"dummy"
"234293",0,0,1,1,"dummy"
"234294",0,2,0,2,"dummy"
"234295",0,1,0,1,"dummy"
"234296",5,1,0,6,"dummy"
"234297",1,0,0,1,"dummy"
"234298",0,2,0,2,"dummy"
"234301",0,1,0,1,"dummy"
"234303",0,1,0,1,"dummy"
"234304",0,1,0,1,"dummy"
"234306",1,1,0,2,"dummy"
"234307",1,0,1,2,"dummy"
"234308",0,0,0,0,"dummy"
"234309",0,0,0,0,"dummy"
"234310",0,0,0,0,"dummy"
"234311",9,5,0,14,"dummy"
"234312",0,0,0,0,"dummy"
"234313",0,8,0,8,"dummy"
"234314",0,0,0,0,"dummy"
"234315",0,0,0,0,"dummy"
"234316",0,0,0,0,"dummy"
"234319",3,5,3,11,"dummy"
"234328",8,4,1,13,"dummy"
"234329",0,0,3,3,"dummy"
"234332",0,0,1,1,"dummy"
"234337",0,0,0,0,"dummy"
"234338",7,1,2,10,"dummy"
"234339",5,4,1,10,"dummy"
"234340",0,2,0,2,"dummy"
"234341",0,0,1,1,"dummy"
"234342",0,0,1,1,"dummy"
"234343",0,0,1,1,"dummy"
"234347",0,2,0,2,"dummy"
"234348",0,1,0,1,"dummy"
"234349",0,1,0,1,"dummy"
"234350",5,7,0,12,"dummy"
"234351",0,1,0,1,"dummy"
"234381",1,1,0,2,"dummy"
"234382",0,2,0,2,"dummy"
"234387",0,0,1,1,"dummy"
"234389",0,0,0,0,"dummy"
"234390",0,0,0,0,"dummy"
"234391",0,0,1,1,"dummy"
"234392",0,0,1,1,"dummy"
"234393",0,0,1,1,"dummy"
"234396",0,1,0,1,"dummy"
"234397",9,1,0,10,"dummy"
"234398",1,0,0,1,"dummy"
"234399",4,5,1,10,"dummy"
"234400",0,1,0,1,"dummy"
"234401",0,4,0,4,"dummy"
"234406",0,0,0,0,"dummy"
"234407",0,0,2,2,"dummy"
"234409",0,0,0,0,"dummy"
"234410",6,7,2,15,"dummy"
"234411",0,0,3,3,"dummy"
"234413",0,0,1,1,"dummy"
"234414",0,2,0,2,"dummy"
"234415",0,0,1,1,"dummy"
"234418",0,0,1,1,"dummy"
"234419",0,0,1,1,"dummy"
"234420",1,1,1,3,"dummy"
"234421",1,0,0,1,"dummy"
"234422",0,1,0,1,"dummy"
"234423",0,2,0,2,"dummy"
"234424",2,0,0,2,"dummy"
"234425",1,0,0,1,"dummy"
"234439",1,0,0,1,"dummy"
"234440",0,0,1,1,"dummy"
"234446",2,5,5,12,"dummy"
"234447",6,1,0,7,"dummy"
"234448",2,2,4,8,"dummy"
"234449",3,1,3,7,"dummy"
"234450",0,0,1,1,"dummy"
"234451",0,1,0,1,"dummy"
"234455",0,1,0,1,"dummy"
"234456",3,0,2,5,"dummy"
"234464",0,0,1,1,"dummy"
"234465",0,0,2,2,"dummy"
"234466",0,0,0,0,"dummy"
"234468",0,4,0,4,"dummy"
"234479",1,2,2,5,"dummy"
"234490",0,0,2,2,"dummy"
"234511",0,13,0,13,"dummy"
"234512",0,1,0,1,"dummy"
"234513",0,0,1,1,"dummy"
"234514",10,3,0,13,"dummy"
"234515",0,0,0,0,"dummy"
"234516",3,9,0,12,"dummy"
"234519",0,1,0,1,"dummy"
"234520",0,1,0,1,"dummy"
"234521",2,0,0,2,"dummy"
"234522",0,1,0,1,"dummy"
"234523",0,6,0,6,"dummy"
"234524",0,2,0,2,"dummy"
"234525",4,3,0,7,"dummy"
"234526",0,2,0,2,"dummy"
"234527",0,3,1,4,"dummy"
"234528",5,0,1,6,"dummy"
"234529",0,3,1,4,"dummy"
"234530",0,5,1,6,"dummy"
"234558",0,3,0,3,"dummy"
"234561",2,2,1,5,"dummy"
"234562",0,0,0,0,"dummy"
"234563",0,3,0,3,"dummy"
"234602",21,5,1,27,"dummy"
"234603",0,1,1,2,"dummy"
"234604",1,0,0,1,"dummy"
"234605",0,7,0,7,"dummy"
"234606",7,1,0,8,"dummy"
"234607",1,0,0,1,"dummy"
"234608",0,0,0,0,"dummy"
"234609",0,0,0,0,"dummy"
"234620",12,9,6,27,"dummy"
"234623",4,2,3,9,"dummy"
"234624",0,1,0,1,"dummy"
"234625",0,1,0,1,"dummy"
"234631",0,1,0,1,"dummy"
"234632",0,0,1,1,"dummy"
"234633",0,2,0,2,"dummy"
"234634",0,0,1,1,"dummy"
"234635",0,1,0,1,"dummy"
"234636",0,0,1,1,"dummy"
"234648",0,2,0,2,"dummy"
"234649",2,0,0,2,"dummy"
"234650",0,1,0,1,"dummy"
"234651",5,5,1,11,"dummy"
"234652",0,6,0,6,"dummy"
"234653",3,3,0,6,"dummy"
"234678",1,2,0,3,"dummy"
"234679",1,2,0,3,"dummy"
"234680",0,3,0,3,"dummy"
"234681",1,2,1,4,"dummy"
"234685",1,0,0,1,"dummy"
"234686",0,4,0,4,"dummy"
"234687",13,1,0,14,"dummy"
"234688",0,0,0,0,"dummy"
"234689",0,6,0,6,"dummy"
"234690",0,2,1,3,"dummy"
"234691",1,9,0,10,"dummy"
"234692",0,1,1,2,"dummy"
"234693",0,1,0,1,"dummy"
"234694",0,1,1,2,"dummy"
"234695",3,1,0,4,"dummy"
"234476",0,0,1,1,"dummy"
"234477",0,0,1,1,"dummy"
"234481",2,12,1,15,"dummy"
"234482",0,0,0,0,"dummy"
"234483",9,20,1,30,"dummy"
"234484",20,3,4,27,"dummy"
"234485",4,0,0,4,"dummy"
"234486",0,0,1,1,"dummy"
"234487",0,4,0,4,"dummy"
"234488",1,6,0,7,"dummy"
"234544",0,0,1,1,"dummy"
"234545",0,1,2,3,"dummy"
"234546",7,11,16,34,"dummy"
"234547",0,0,2,2,"dummy"
"234554",0,14,0,14,"dummy"
"234555",0,1,1,2,"dummy"
"234556",1,0,0,1,"dummy"
"234600",0,3,0,3,"dummy"
"234613",0,1,0,1,"dummy"
"234616",0,0,0,0,"dummy"
"234617",5,0,2,7,"dummy"
"234618",0,0,0,0,"dummy"
"234629",1,6,0,7,"dummy"
"234638",2,2,0,4,"dummy"
"234639",0,1,0,1,"dummy"
"234640",1,0,0,1,"dummy"
"234641",0,1,0,1,"dummy"
"234642",0,0,1,1,"dummy"
"234643",0,2,0,2,"dummy"
"234644",0,0,1,1,"dummy"
"234645",0,1,0,1,"dummy"
"234646",0,0,1,1,"dummy"
"234655",0,1,0,1,"dummy"
"234656",0,0,1,1,"dummy"
"234673",0,1,0,1,"dummy"
"234674",0,1,0,1,"dummy"
"234683",0,1,0,1,"dummy"
"234697",0,0,0,0,"dummy"
"234803",2,4,0,6,"dummy"
"234804",0,1,1,2,"dummy"
"234805",0,6,0,6,"dummy"
"234809",0,0,1,1,"dummy"
"234810",0,0,1,1,"dummy"
"234811",0,0,1,1,"dummy"
"234812",0,0,1,1,"dummy"
"234813",0,2,0,2,"dummy"
"234814",0,0,1,1,"dummy"
"234815",0,1,0,1,"dummy"
"234816",0,0,1,1,"dummy"
"234817",0,1,0,1,"dummy"
"234863",2,2,0,4,"dummy"
"234864",0,0,1,1,"dummy"
"234733",0,0,1,1,"dummy"
"234734",0,1,0,1,"dummy"
"234807",0,1,0,1,"dummy"
"234847",0,1,0,1,"dummy"
"234848",0,0,1,1,"dummy"
"234851",2,0,2,4,"dummy"
"234854",0,0,0,0,"dummy"
"234855",0,0,0,0,"dummy"
"234856",0,0,0,0,"dummy"
"234857",0,0,1,1,"dummy"
"234882",5,12,1,18,"dummy"
"234883",2,0,0,2,"dummy"
"234884",0,1,0,1,"dummy"
"234927",0,0,0,0,"dummy"
"234865",0,1,0,1,"dummy"
"234866",0,2,0,2,"dummy"
"234867",0,0,0,0,"dummy"
"234868",0,0,0,0,"dummy"
"234869",0,1,0,1,"dummy"
"234870",4,0,0,4,"dummy"
"234871",0,0,0,0,"dummy"
"234872",0,0,0,0,"dummy"
"234873",0,0,0,0,"dummy"
"234874",0,0,0,0,"dummy"
"234875",3,0,0,3,"dummy"
"234886",0,0,1,1,"dummy"
"234887",2,1,1,4,"dummy"
"234888",0,0,1,1,"dummy"
"234891",3,2,1,6,"dummy"
"234892",3,4,0,7,"dummy"
"234893",0,3,0,3,"dummy"
"234894",4,3,0,7,"dummy"
"234895",5,4,0,9,"dummy"
"234896",9,7,1,17,"dummy"
"234899",0,2,0,2,"dummy"
"234906",4,3,1,8,"dummy"
"234907",0,0,1,1,"dummy"
"234908",0,1,0,1,"dummy"
"234909",0,0,1,1,"dummy"
"234910",2,4,0,6,"dummy"
"234911",38,26,6,70,"dummy"
"234912",4,14,1,19,"dummy"
"234921",0,1,0,1,"dummy"
"234936",0,0,0,0,"dummy"
"234940",0,1,1,2,"dummy"
"234942",0,1,0,1,"dummy"
"234945",0,0,1,1,"dummy"
"234946",2,3,0,5,"dummy"
"234947",0,1,0,1,"dummy"
"234948",0,17,0,17,"dummy"
"234950",0,0,1,1,"dummy"
"234951",0,0,1,1,"dummy"
"234952",0,1,0,1,"dummy"
"234953",0,0,1,1,"dummy"
"234954",0,5,3,8,"dummy"
"234963",0,10,4,14,"dummy"
"234965",0,0,0,0,"dummy"
"234966",1,4,3,8,"dummy"
"234970",8,9,4,21,"dummy"
"234972",0,3,1,4,"dummy"
"234973",0,3,0,3,"dummy"
"234974",0,13,0,13,"dummy"
"234975",1,10,1,12,"dummy"
"234976",2,0,0,2,"dummy"
"234978",0,2,0,2,"dummy"
"234979",0,2,0,2,"dummy"
"234980",0,1,0,1,"dummy"
"234981",0,0,2,2,"dummy"
"234982",0,0,1,1,"dummy"
"234983",0,0,1,1,"dummy"
"234985",0,1,0,1,"dummy"
"234986",0,5,0,5,"dummy"
"234988",0,0,1,1,"dummy"
"234989",0,1,1,2,"dummy"
"234990",0,0,1,1,"dummy"
"234991",0,0,0,0,"dummy"
"234993",0,1,0,1,"dummy"
"234994",0,2,1,3,"dummy"
"235003",1,4,3,8,"dummy"
"235004",0,4,1,5,"dummy"
"235021",3,2,2,7,"dummy"
"235022",1,0,2,3,"dummy"
"235023",0,0,1,1,"dummy"
"235025",0,0,0,0,"dummy"
"235026",0,1,0,1,"dummy"
"235027",2,4,0,6,"dummy"
"235028",1,2,0,3,"dummy"
"235029",0,0,1,1,"dummy"
"235030",0,1,0,1,"dummy"
"235031",0,0,1,1,"dummy"
"235032",0,0,1,1,"dummy"
"235047",0,0,1,1,"dummy"
"235048",0,12,0,12,"dummy"
"235049",0,2,0,2,"dummy"
"235050",1,0,0,1,"dummy"
"235051",2,1,0,3,"dummy"
"235052",0,2,0,2,"dummy"
"235053",0,0,1,1,"dummy"
"235054",0,1,0,1,"dummy"
"235055",0,0,1,1,"dummy"
"235056",2,1,0,3,"dummy"
"235057",0,0,1,1,"dummy"
"235058",24,0,1,25,"dummy"
"235059",0,0,0,0,"dummy"
"235060",0,0,0,0,"dummy"
"235061",0,2,0,2,"dummy"
"235062",0,1,0,1,"dummy"
"235063",0,1,0,1,"dummy"
"235064",0,0,1,1,"dummy"
"235065",0,3,0,3,"dummy"
"235067",1,4,1,6,"dummy"
"235072",0,0,0,0,"dummy"
"235073",1,1,1,3,"dummy"
"235074",0,1,0,1,"dummy"
"235075",0,1,0,1,"dummy"
"235076",0,0,1,1,"dummy"
"235077",0,1,0,1,"dummy"
"235078",0,5,0,5,"dummy"
"235079",0,1,0,1,"dummy"
"235080",0,1,1,2,"dummy"
"235081",0,0,0,0,"dummy"
"235082",0,1,0,1,"dummy"
"235083",0,1,0,1,"dummy"
"235084",0,0,0,0,"dummy"
"235085",0,0,0,0,"dummy"
"235086",0,0,0,0,"dummy"
"235087",0,1,0,1,"dummy"
"235088",0,1,0,1,"dummy"
"235089",0,1,0,1,"dummy"
"235090",0,2,0,2,"dummy"
"235091",0,1,1,2,"dummy"
"235092",0,1,0,1,"dummy"
"235093",2,10,0,12,"dummy"
"235094",0,4,0,4,"dummy"
"235098",1,0,1,2,"dummy"
"235099",0,1,0,1,"dummy"
"235101",7,3,0,10,"dummy"
"235102",0,0,0,0,"dummy"
"235103",0,0,0,0,"dummy"
"235104",0,0,0,0,"dummy"
"235105",0,0,0,0,"dummy"
"235106",0,0,0,0,"dummy"
"235111",0,0,1,1,"dummy"
"235115",0,4,0,4,"dummy"
"235117",6,0,0,6,"dummy"
"235118",2,5,2,9,"dummy"
"235120",0,0,0,0,"dummy"
"235121",0,0,0,0,"dummy"
"235122",0,0,0,0,"dummy"
"235123",0,1,0,1,"dummy"
"235130",0,1,0,1,"dummy"
"235132",0,1,0,1,"dummy"
"235133",0,0,1,1,"dummy"
"235134",0,1,0,1,"dummy"
"235135",0,6,0,6,"dummy"
"235136",0,2,0,2,"dummy"
"235138",1,4,2,7,"dummy"
"235139",0,0,0,0,"dummy"
"235147",0,1,2,3,"dummy"
"235149",0,1,1,2,"dummy"
"235161",8,6,3,17,"dummy"
"235163",1,0,2,3,"dummy"
"235174",1,1,1,3,"dummy"
"235175",0,2,0,2,"dummy"
"235177",0,2,0,2,"dummy"
"235178",0,1,0,1,"dummy"
"235179",0,2,0,2,"dummy"
"235180",1,4,0,5,"dummy"
"235181",0,6,0,6,"dummy"
"235183",0,4,0,4,"dummy"
"235184",0,1,0,1,"dummy"
"235185",0,1,0,1,"dummy"
"235187",4,5,3,12,"dummy"
"235188",0,1,0,1,"dummy"
"235189",0,1,0,1,"dummy"
"235190",2,0,3,5,"dummy"
"235191",3,0,1,4,"dummy"
"235193",0,3,0,3,"dummy"
"235194",0,1,0,1,"dummy"
"235195",1,1,0,2,"dummy"
"235196",1,2,0,3,"dummy"
"235197",0,1,0,1,"dummy"
"235198",1,0,2,3,"dummy"
"235199",0,0,0,0,"dummy"
"235200",3,4,3,10,"dummy"
"235201",0,0,2,2,"dummy"
"235202",1,2,0,3,"dummy"
"235204",1,0,0,1,"dummy"
"235205",5,0,0,5,"dummy"
"235206",0,0,0,0,"dummy"
"235207",0,0,0,0,"dummy"
"235208",0,0,0,0,"dummy"
"235209",0,0,0,0,"dummy"
"235210",0,0,0,0,"dummy"
"235211",1,0,1,2,"dummy"
"235212",0,1,0,1,"dummy"
"235213",1,0,0,1,"dummy"
"235219",0,0,0,0,"dummy"
"235220",0,0,0,0,"dummy"
"235224",0,0,0,0,"dummy"
"235225",0,0,1,1,"dummy"
"235227",0,3,0,3,"dummy"
"235228",3,0,0,3,"dummy"
"235229",0,2,0,2,"dummy"
"235230",0,3,0,3,"dummy"
"235231",0,0,1,1,"dummy"
"235238",0,13,1,14,"dummy"
"235239",0,2,2,4,"dummy"
"235242",0,0,0,0,"dummy"
"235243",1,3,1,5,"dummy"
"235244",0,1,0,1,"dummy"
"235245",0,0,1,1,"dummy"
"235247",0,10,0,10,"dummy"
"235249",0,4,0,4,"dummy"
"235252",1,1,0,2,"dummy"
"235253",0,0,0,0,"dummy"
"235254",0,0,1,1,"dummy"
"235255",0,0,1,1,"dummy"
"235258",0,0,0,0,"dummy"
"235261",3,3,0,6,"dummy"
"235262",4,6,5,15,"dummy"
"235264",0,0,0,0,"dummy"
"235265",5,0,2,7,"dummy"
"235266",0,0,0,0,"dummy"
"235285",2,4,0,6,"dummy"
"235286",0,2,0,2,"dummy"
"235287",0,2,0,2,"dummy"
"235288",10,2,0,12,"dummy"
"235289",0,2,0,2,"dummy"
"235409",0,1,0,1,"dummy"
"235410",0,3,0,3,"dummy"
"235411",9,9,0,18,"dummy"
"235412",2,2,0,4,"dummy"
"235413",9,9,0,18,"dummy"
"235414",0,5,0,5,"dummy"
"235415",0,0,1,1,"dummy"
"235416",4,1,5,10,"dummy"
"235417",0,2,1,3,"dummy"
"235418",0,0,1,1,"dummy"
"235419",0,4,0,4,"dummy"
"235420",1,0,1,2,"dummy"
"235421",0,1,0,1,"dummy"
"235422",7,7,0,14,"dummy"
"235423",2,0,0,2,"dummy"
"235424",0,3,0,3,"dummy"
"235425",8,2,0,10,"dummy"
"235426",0,1,0,1,"dummy"
"235427",2,3,0,5,"dummy"
"235428",15,19,2,36,"dummy"
"235429",1,1,0,2,"dummy"
"235430",1,1,1,3,"dummy"
"235431",0,1,4,5,"dummy"
"235432",0,0,1,1,"dummy"
"235433",0,11,0,11,"dummy"
"235434",1,2,1,4,"dummy"
"235435",0,0,1,1,"dummy"
"235436",0,0,1,1,"dummy"
"235437",0,0,1,1,"dummy"
"235438",0,1,0,1,"dummy"
"235454",0,0,2,2,"dummy"
"235461",0,0,1,1,"dummy"
"235462",0,1,0,1,"dummy"
"235463",7,2,0,9,"dummy"
"235464",0,1,0,1,"dummy"
"235473",0,1,0,1,"dummy"
"235477",1,1,0,2,"dummy"
"235478",1,1,0,2,"dummy"
"235492",0,4,0,4,"dummy"
"235493",4,7,0,11,"dummy"
"235494",0,2,0,2,"dummy"
"235495",1,6,1,8,"dummy"
"235498",0,0,1,1,"dummy"
"235499",1,0,0,1,"dummy"
"235500",0,3,0,3,"dummy"
"235501",0,4,1,5,"dummy"
"235504",4,4,1,9,"dummy"
"235505",5,6,2,13,"dummy"
"235506",3,3,1,7,"dummy"
"235507",2,6,0,8,"dummy"
"235519",1,1,0,2,"dummy"
"235520",0,1,1,2,"dummy"
"235521",7,17,0,24,"dummy"
"235522",0,2,0,2,"dummy"
"235523",1,0,0,1,"dummy"
"235524",0,2,0,2,"dummy"
"235567",1,6,0,7,"dummy"
"235573",1,2,0,3,"dummy"
"235574",2,1,0,3,"dummy"
"235272",0,2,3,5,"dummy"
"235273",0,0,3,3,"dummy"
"235274",1,2,1,4,"dummy"
"235277",0,0,1,1,"dummy"
"235278",0,0,0,0,"dummy"
"235279",0,0,3,3,"dummy"
"235304",1,0,0,1,"dummy"
"235305",0,1,0,1,"dummy"
"235306",0,2,0,2,"dummy"
"235307",0,0,1,1,"dummy"
"235308",0,0,0,0,"dummy"
"235309",7,7,0,14,"dummy"
"235310",0,0,1,1,"dummy"
"235313",0,2,3,5,"dummy"
"235314",13,1,3,17,"dummy"
"235319",0,0,1,1,"dummy"
"235320",6,1,1,8,"dummy"
"235321",0,0,1,1,"dummy"
"235322",1,2,1,4,"dummy"
"235323",1,0,0,1,"dummy"
"235324",0,0,1,1,"dummy"
"235325",1,2,1,4,"dummy"
"235326",3,0,0,3,"dummy"
"235327",0,0,0,0,"dummy"
"235328",0,1,0,1,"dummy"
"235329",1,0,0,1,"dummy"
"235330",0,4,1,5,"dummy"
"235331",0,5,1,6,"dummy"
"235332",0,0,1,1,"dummy"
"235333",0,0,0,0,"dummy"
"235334",11,2,1,14,"dummy"
"235335",0,0,1,1,"dummy"
"235336",0,0,1,1,"dummy"
"235337",0,1,0,1,"dummy"
"235338",1,0,0,1,"dummy"
"235339",0,5,0,5,"dummy"
"235340",0,0,1,1,"dummy"
"235341",0,2,0,2,"dummy"
"235342",0,1,0,1,"dummy"
"235343",0,0,0,0,"dummy"
"235344",0,0,2,2,"dummy"
"235345",1,0,2,3,"dummy"
"235346",0,0,1,1,"dummy"
"235347",3,3,0,6,"dummy"
"235348",0,0,1,1,"dummy"
"235349",0,0,1,1,"dummy"
"235350",3,3,2,8,"dummy"
"235351",0,0,1,1,"dummy"
"235352",0,0,1,1,"dummy"
"235353",0,0,1,1,"dummy"
"235354",0,0,2,2,"dummy"
"235355",0,0,2,2,"dummy"
"235356",0,0,2,2,"dummy"
"235357",0,0,2,2,"dummy"
"235358",0,1,0,1,"dummy"
"235359",1,0,0,1,"dummy"
"235360",0,0,2,2,"dummy"
"235361",0,0,2,2,"dummy"
"235362",0,0,2,2,"dummy"
"235363",2,0,0,2,"dummy"
"235364",0,0,0,0,"dummy"
"235365",1,1,0,2,"dummy"
"235366",0,0,2,2,"dummy"
"235367",0,1,0,1,"dummy"
"235368",0,0,2,2,"dummy"
"235369",1,0,0,1,"dummy"
"235370",1,1,0,2,"dummy"
"235371",0,0,0,0,"dummy"
"235372",0,0,0,0,"dummy"
"235373",0,0,1,1,"dummy"
"235374",0,0,1,1,"dummy"
"235375",0,0,1,1,"dummy"
"235376",0,1,1,2,"dummy"
"235377",0,0,1,1,"dummy"
"235378",0,0,1,1,"dummy"
"235379",0,0,1,1,"dummy"
"235387",0,0,1,1,"dummy"
"235388",0,1,0,1,"dummy"
"235389",0,0,1,1,"dummy"
"235394",0,0,1,1,"dummy"
"235397",1,2,0,3,"dummy"
"235398",0,1,0,1,"dummy"
"235399",0,0,1,1,"dummy"
"235400",0,0,3,3,"dummy"
"235401",0,0,1,1,"dummy"
"235402",2,2,0,4,"dummy"
"235403",0,0,1,1,"dummy"
"235404",0,0,1,1,"dummy"
"235405",0,0,1,1,"dummy"
"235406",4,4,2,10,"dummy"
"235407",0,0,2,2,"dummy"
"235442",0,11,0,11,"dummy"
"235443",2,12,0,14,"dummy"
"235444",4,2,0,6,"dummy"
"235445",1,0,0,1,"dummy"
"235446",0,0,0,0,"dummy"
"235447",1,2,0,3,"dummy"
"235448",0,4,0,4,"dummy"
"235449",0,3,0,3,"dummy"
"235450",0,0,1,1,"dummy"
"235451",0,0,1,1,"dummy"
"235452",0,0,2,2,"dummy"
"235456",1,1,0,2,"dummy"
"235457",0,0,0,0,"dummy"
"235458",23,8,3,34,"dummy"
"235459",0,1,0,1,"dummy"
"235466",0,0,0,0,"dummy"
"235467",0,1,1,2,"dummy"
"235468",0,13,0,13,"dummy"
"235469",0,0,0,0,"dummy"
"235470",5,4,2,11,"dummy"
"235471",0,1,0,1,"dummy"
"235475",2,0,2,4,"dummy"
"235484",9,0,0,9,"dummy"
"235485",2,0,0,2,"dummy"
"235486",0,2,0,2,"dummy"
"235487",0,0,2,2,"dummy"
"235509",0,0,1,1,"dummy"
"235516",0,0,1,1,"dummy"
"235517",7,5,0,12,"dummy"
"235526",1,1,0,2,"dummy"
"235527",0,2,0,2,"dummy"
"235528",0,1,0,1,"dummy"
"235529",1,0,0,1,"dummy"
"235530",0,1,0,1,"dummy"
"235533",0,5,0,5,"dummy"
"235534",0,1,0,1,"dummy"
"235535",0,1,0,1,"dummy"
"235536",0,4,1,5,"dummy"
"235539",0,2,0,2,"dummy"
"235540",0,0,0,0,"dummy"
"235541",0,0,0,0,"dummy"
"235542",0,0,0,0,"dummy"
"235543",0,0,0,0,"dummy"
"235544",0,0,0,0,"dummy"
"235547",0,2,1,3,"dummy"
"235548",0,0,0,0,"dummy"
"235551",0,0,0,0,"dummy"
"235552",0,0,0,0,"dummy"
"235553",0,0,1,1,"dummy"
"235554",0,0,0,0,"dummy"
"235555",0,0,0,0,"dummy"
"235556",6,0,0,6,"dummy"
"235557",0,0,0,0,"dummy"
"235558",0,0,0,0,"dummy"
"235559",0,0,0,0,"dummy"
"235560",0,0,0,0,"dummy"
"235561",0,2,2,4,"dummy"
"235564",0,0,1,1,"dummy"
"235565",0,0,1,1,"dummy"
"235576",0,1,0,1,"dummy"
"235585",1,0,1,2,"dummy"
"235586",0,0,1,1,"dummy"
"235590",0,0,1,1,"dummy"
"235591",4,2,2,8,"dummy"
"235592",0,0,2,2,"dummy"
"235593",0,0,0,0,"dummy"
"235594",0,3,0,3,"dummy"
"235633",0,0,1,1,"dummy"
"235636",0,0,3,3,"dummy"
"235640",0,1,0,1,"dummy"
"235641",0,0,1,1,"dummy"
"235642",0,2,0,2,"dummy"
"235643",1,2,1,4,"dummy"
"235653",0,0,1,1,"dummy"
"235654",0,0,0,0,"dummy"
"235655",0,0,1,1,"dummy"
"235656",0,0,1,1,"dummy"
"235657",0,0,1,1,"dummy"
"235580",0,0,1,1,"dummy"
"235581",0,0,1,1,"dummy"
"235582",0,1,0,1,"dummy"
"235583",3,0,3,6,"dummy"
"235588",0,0,2,2,"dummy"
"235638",0,0,2,2,"dummy"
"235647",0,4,2,6,"dummy"
"235648",0,1,0,1,"dummy"
"235649",0,0,0,0,"dummy"
"235659",5,0,0,5,"dummy"
"235660",0,4,1,5,"dummy"
"235661",3,1,2,6,"dummy"
"235662",0,1,1,2,"dummy"
"235663",0,0,0,0,"dummy"
"235664",0,0,1,1,"dummy"
"235665",0,1,0,1,"dummy"
"235666",1,0,0,1,"dummy"
"235667",0,1,0,1,"dummy"
"235668",1,0,0,1,"dummy"
"235669",0,0,0,0,"dummy"
"235670",0,0,0,0,"dummy"
"235671",0,1,0,1,"dummy"
"235672",0,0,0,0,"dummy"
"235673",0,2,1,3,"dummy"
"235674",0,0,1,1,"dummy"
"235675",1,1,1,3,"dummy"
"235676",1,2,0,3,"dummy"
"235677",0,0,0,0,"dummy"
"235678",0,0,0,0,"dummy"
"235679",0,0,0,0,"dummy"
"235680",0,0,0,0,"dummy"
"235681",0,0,0,0,"dummy"
"235682",0,0,0,0,"dummy"
"235683",0,0,0,0,"dummy"
"235684",0,0,0,0,"dummy"
"235685",0,0,0,0,"dummy"
"235686",0,0,1,1,"dummy"
"235687",0,0,1,1,"dummy"
"235688",0,0,0,0,"dummy"
"235689",0,1,0,1,"dummy"
"235690",1,5,0,6,"dummy"
"235691",0,1,0,1,"dummy"
"235692",8,1,0,9,"dummy"
"235693",1,0,0,1,"dummy"
"235694",0,0,1,1,"dummy"
"235727",0,0,0,0,"dummy"
"235728",0,0,0,0,"dummy"
"235757",4,11,0,15,"dummy"
"235758",4,1,0,5,"dummy"
"235759",3,7,0,10,"dummy"
"235762",0,0,0,0,"dummy"
"235763",0,0,0,0,"dummy"
"235766",3,1,0,4,"dummy"
"235772",0,2,0,2,"dummy"
"235773",0,0,0,0,"dummy"
"235737",0,3,0,3,"dummy"
"235738",0,0,0,0,"dummy"
"235741",0,8,0,8,"dummy"
"235742",2,0,0,2,"dummy"
"235743",0,0,1,1,"dummy"
"235744",3,0,0,3,"dummy"
"235745",0,0,1,1,"dummy"
"235746",0,2,0,2,"dummy"
"235747",0,1,0,1,"dummy"
"235748",0,1,2,3,"dummy"
"235749",0,1,0,1,"dummy"
"235750",1,2,0,3,"dummy"
"235751",6,7,0,13,"dummy"
"235752",1,1,0,2,"dummy"
"235753",0,1,1,2,"dummy"
"235754",6,6,0,12,"dummy"
"235755",2,3,0,5,"dummy"
"235768",1,7,0,8,"dummy"
"235769",0,10,0,10,"dummy"
"235770",0,0,1,1,"dummy"
"235864",0,0,2,2,"dummy"
"235865",0,0,1,1,"dummy"
"235866",0,0,5,5,"dummy"
"235867",0,0,1,1,"dummy"
"235875",0,0,1,1,"dummy"
"235876",0,0,6,6,"dummy"
"235877",4,0,5,9,"dummy"
"235878",0,2,0,2,"dummy"
"235886",0,1,0,1,"dummy"
"235891",1,2,0,3,"dummy"
"235892",1,2,0,3,"dummy"
"235898",0,3,2,5,"dummy"
"235904",0,0,1,1,"dummy"
"235905",0,0,0,0,"dummy"
"235910",0,0,1,1,"dummy"
"235911",0,0,0,0,"dummy"
"235912",0,0,1,1,"dummy"
"235923",0,0,1,1,"dummy"
"235924",0,0,2,2,"dummy"
"235925",17,2,0,19,"dummy"
"235926",0,0,1,1,"dummy"
"235927",0,0,1,1,"dummy"
"235928",0,0,1,1,"dummy"
"235929",0,0,1,1,"dummy"
"235930",0,0,1,1,"dummy"
"235931",0,0,1,1,"dummy"
"235932",0,0,1,1,"dummy"
"235933",0,0,1,1,"dummy"
"235934",0,0,2,2,"dummy"
"235935",0,0,1,1,"dummy"
"235936",0,0,1,1,"dummy"
"235937",0,0,1,1,"dummy"
"235938",0,0,1,1,"dummy"
"235939",0,0,1,1,"dummy"
"235944",0,0,1,1,"dummy"
"235950",2,3,0,5,"dummy"
"235951",1,3,3,7,"dummy"
"235957",0,0,1,1,"dummy"
"235960",0,0,0,0,"dummy"
"235961",0,0,0,0,"dummy"
"235983",2,1,0,3,"dummy"
"235984",0,0,2,2,"dummy"
"236009",0,1,1,2,"dummy"
"236010",0,0,1,1,"dummy"
"236011",0,1,0,1,"dummy"
"236012",0,2,1,3,"dummy"
"236018",2,5,3,10,"dummy"
"236021",0,0,1,1,"dummy"
"236022",0,0,2,2,"dummy"
"236023",1,3,0,4,"dummy"
"236027",0,1,0,1,"dummy"
"235869",0,0,2,2,"dummy"
"235870",0,0,1,1,"dummy"
"235871",0,0,1,1,"dummy"
"235872",0,0,1,1,"dummy"
"235873",5,9,1,15,"dummy"
"235880",3,1,0,4,"dummy"
"235881",0,1,0,1,"dummy"
"235896",1,2,1,4,"dummy"
"235900",0,0,1,1,"dummy"
"235918",2,0,0,2,"dummy"
"235919",2,0,0,2,"dummy"
"235920",0,3,0,3,"dummy"
"235921",1,0,0,1,"dummy"
"235946",0,3,0,3,"dummy"
"235947",0,1,0,1,"dummy"
"235948",0,0,1,1,"dummy"
"235953",0,1,0,1,"dummy"
"235954",0,1,0,1,"dummy"
"235955",0,2,0,2,"dummy"
"235963",0,2,0,2,"dummy"
"235964",0,1,0,1,"dummy"
"235973",2,0,0,2,"dummy"
"235974",3,1,0,4,"dummy"
"235975",0,1,0,1,"dummy"
"235976",2,3,0,5,"dummy"
"235977",1,4,0,5,"dummy"
"235978",1,4,0,5,"dummy"
"235979",0,0,1,1,"dummy"
"235980",0,0,1,1,"dummy"
"235981",3,1,0,4,"dummy"
"236000",0,0,8,8,"dummy"
"236007",1,0,0,1,"dummy"
"236014",17,2,1,20,"dummy"
"236015",0,1,0,1,"dummy"
"236016",0,0,1,1,"dummy"
"236025",2,2,0,4,"dummy"
"236054",0,0,1,1,"dummy"
"236064",4,2,0,6,"dummy"
"236109",0,0,1,1,"dummy"
"236121",0,0,3,3,"dummy"
"236134",0,0,2,2,"dummy"
"236135",3,0,2,5,"dummy"
"236136",0,0,2,2,"dummy"
"236137",0,1,0,1,"dummy"
"236138",0,0,2,2,"dummy"
"236146",0,1,0,1,"dummy"
"236187",2,2,3,7,"dummy"
"236203",0,4,0,4,"dummy"
"236204",1,1,0,2,"dummy"
"236205",0,1,0,1,"dummy"
"236206",3,2,0,5,"dummy"
"236207",1,6,0,7,"dummy"
"236208",1,2,0,3,"dummy"
"236209",0,1,2,3,"dummy"
"236210",0,0,0,0,"dummy"
"236034",0,3,1,4,"dummy"
"236035",10,11,0,21,"dummy"
"236036",0,0,1,1,"dummy"
"236037",2,2,0,4,"dummy"
"236038",1,2,0,3,"dummy"
"236041",1,3,4,8,"dummy"
"236044",0,0,1,1,"dummy"
"236045",9,2,1,12,"dummy"
"236046",0,1,1,2,"dummy"
"236047",1,5,2,8,"dummy"
"236048",12,4,0,16,"dummy"
"236049",1,2,0,3,"dummy"
"236050",0,0,1,1,"dummy"
"236051",3,1,0,4,"dummy"
"236052",0,4,1,5,"dummy"
"236058",0,1,0,1,"dummy"
"236059",15,5,5,25,"dummy"
"236060",0,6,0,6,"dummy"
"236061",1,1,0,2,"dummy"
"236062",0,1,1,2,"dummy"
"236101",6,2,0,8,"dummy"
"236102",12,2,0,14,"dummy"
"236105",0,3,0,3,"dummy"
"236106",0,0,1,1,"dummy"
"236107",0,1,0,1,"dummy"
"236115",0,7,0,7,"dummy"
"236123",3,10,3,16,"dummy"
"236124",0,0,0,0,"dummy"
"236127",22,26,5,53,"dummy"
"236128",0,1,0,1,"dummy"
"236129",0,0,1,1,"dummy"
"236130",0,4,0,4,"dummy"
"236148",1,0,0,1,"dummy"
"236160",0,3,0,3,"dummy"
"236161",0,2,0,2,"dummy"
"236162",2,2,0,4,"dummy"
"236163",0,1,0,1,"dummy"
"236178",0,0,1,1,"dummy"
"236189",1,1,0,2,"dummy"
"236192",4,8,4,16,"dummy"
"236193",8,6,3,17,"dummy"
"236194",0,3,0,3,"dummy"
"236195",0,6,0,6,"dummy"
"236196",0,2,0,2,"dummy"
"236197",9,0,0,9,"dummy"
"236198",0,1,0,1,"dummy"
"236199",0,0,1,1,"dummy"
"236200",6,6,2,14,"dummy"
"236201",0,0,0,0,"dummy"
"236216",2,2,0,4,"dummy"
"236217",0,0,1,1,"dummy"
"236218",0,1,0,1,"dummy"
"236219",0,2,0,2,"dummy"
"236220",0,1,0,1,"dummy"
"236226",0,1,0,1,"dummy"
"236227",0,0,5,5,"dummy"
"236229",0,0,1,1,"dummy"
"236237",2,3,0,5,"dummy"
"236240",0,0,0,0,"dummy"
"236246",0,1,0,1,"dummy"
"236248",0,1,0,1,"dummy"
"236250",2,4,0,6,"dummy"
"236251",0,2,0,2,"dummy"
"236252",0,2,0,2,"dummy"
"236253",10,2,0,12,"dummy"
"236254",0,2,0,2,"dummy"
"236255",0,0,0,0,"dummy"
"236256",0,0,3,3,"dummy"
"236259",0,0,1,1,"dummy"
"236260",0,5,0,5,"dummy"
"236261",0,1,0,1,"dummy"
"236262",0,0,2,2,"dummy"
"236265",2,5,2,9,"dummy"
"236267",0,0,0,0,"dummy"
"236268",0,0,3,3,"dummy"
"236271",0,0,0,0,"dummy"
"236273",1,0,0,1,"dummy"
"236274",0,0,1,1,"dummy"
"236279",0,0,1,1,"dummy"
"236280",0,4,0,4,"dummy"
"236281",4,1,1,6,"dummy"
"236287",1,0,0,1,"dummy"
"236288",6,8,0,14,"dummy"
"236291",3,1,1,5,"dummy"
"236292",0,2,0,2,"dummy"
"236296",0,3,0,3,"dummy"
"236297",0,0,1,1,"dummy"
"236299",1,5,2,8,"dummy"
"236300",1,4,0,5,"dummy"
"236301",3,9,2,14,"dummy"
"236302",0,2,0,2,"dummy"
"236303",8,4,1,13,"dummy"
"236305",3,1,0,4,"dummy"
"236306",0,0,1,1,"dummy"
"236307",0,2,2,4,"dummy"
"236308",0,0,1,1,"dummy"
"236309",4,1,1,6,"dummy"
"236311",0,0,2,2,"dummy"
"236316",0,1,0,1,"dummy"
"236317",7,10,2,19,"dummy"
"236319",0,3,0,3,"dummy"
"236321",1,0,0,1,"dummy"
"236335",0,12,0,12,"dummy"
"236336",1,1,0,2,"dummy"
"236338",3,0,0,3,"dummy"
"236339",0,0,0,0,"dummy"
"236342",1,5,1,7,"dummy"
"236343",5,6,3,14,"dummy"
"236344",0,0,0,0,"dummy"
"236345",0,0,1,1,"dummy"
"236346",0,0,0,0,"dummy"
"236347",1,0,0,1,"dummy"
"236348",2,3,0,5,"dummy"
"236349",5,4,1,10,"dummy"
"236350",1,1,1,3,"dummy"
"236351",0,0,0,0,"dummy"
"236352",0,1,0,1,"dummy"
"236353",2,6,2,10,"dummy"
"236354",1,0,0,1,"dummy"
"236356",0,0,1,1,"dummy"
"236357",0,0,1,1,"dummy"
"236359",0,1,0,1,"dummy"
"236363",0,0,1,1,"dummy"
"236364",0,0,1,1,"dummy"
"236368",18,1,0,19,"dummy"
"236369",0,0,1,1,"dummy"
"236371",0,11,2,13,"dummy"
"236372",10,0,2,12,"dummy"
"236376",0,6,1,7,"dummy"
"236379",0,3,3,6,"dummy"
"236380",0,2,8,10,"dummy"
"236381",0,2,1,3,"dummy"
"236382",0,0,2,2,"dummy"
"236383",0,1,0,1,"dummy"
"236384",0,0,1,1,"dummy"
"236385",0,0,2,2,"dummy"
"236386",0,0,1,1,"dummy"
"236387",11,2,6,19,"dummy"
"236388",0,0,2,2,"dummy"
"236389",0,3,5,8,"dummy"
"236390",2,0,2,4,"dummy"
"236391",0,2,0,2,"dummy"
"236392",0,0,1,1,"dummy"
"236394",6,5,3,14,"dummy"
"236395",0,1,3,4,"dummy"
"236396",4,0,1,5,"dummy"
"236397",0,0,1,1,"dummy"
"236398",0,2,1,3,"dummy"
"236399",0,0,1,1,"dummy"
"236400",0,1,1,2,"dummy"
"236401",2,3,4,9,"dummy"
"236402",0,0,1,1,"dummy"
"236404",0,0,1,1,"dummy"
"236407",1,1,2,4,"dummy"
"236408",0,2,0,2,"dummy"
"236409",0,1,0,1,"dummy"
"236410",0,2,0,2,"dummy"
"236411",2,1,0,3,"dummy"
"236412",0,4,0,4,"dummy"
"236418",3,13,0,16,"dummy"
"236420",0,1,0,1,"dummy"
"236422",0,0,2,2,"dummy"
"236427",0,0,1,1,"dummy"
"236430",1,0,0,1,"dummy"
"236432",2,0,0,2,"dummy"
"236433",0,2,0,2,"dummy"
"236435",0,0,0,0,"dummy"
"236437",13,0,1,14,"dummy"
"236440",0,0,0,0,"dummy"
"236444",1,1,0,2,"dummy"
"236447",0,1,0,1,"dummy"
"236450",2,0,2,4,"dummy"
"236452",0,0,1,1,"dummy"
"236454",0,0,1,1,"dummy"
"236457",0,0,2,2,"dummy"
"236471",1,0,1,2,"dummy"
"236472",0,0,4,4,"dummy"
"236473",1,0,0,1,"dummy"
"236474",1,0,0,1,"dummy"
"236475",0,0,4,4,"dummy"
"236476",3,2,0,5,"dummy"
"236477",0,0,1,1,"dummy"
"236480",1,3,1,5,"dummy"
"236491",0,2,3,5,"dummy"
"236492",2,2,1,5,"dummy"
"236494",0,6,1,7,"dummy"
"236495",0,2,0,2,"dummy"
"236496",0,1,1,2,"dummy"
"236503",0,0,1,1,"dummy"
"236504",0,1,0,1,"dummy"
"236505",0,0,1,1,"dummy"
"236506",0,0,3,3,"dummy"
"236507",0,0,3,3,"dummy"
"236508",0,0,1,1,"dummy"
"236509",0,0,4,4,"dummy"
"236510",0,1,0,1,"dummy"
"236513",0,1,0,1,"dummy"
"236514",4,5,3,12,"dummy"
"236515",0,0,0,0,"dummy"
"236516",0,0,2,2,"dummy"
"236517",1,1,0,2,"dummy"
"236518",1,3,0,4,"dummy"
"236519",3,0,3,6,"dummy"
"236520",5,1,1,7,"dummy"
"236526",0,0,0,0,"dummy"
"236530",4,6,1,11,"dummy"
"236531",0,3,1,4,"dummy"
"236532",2,3,0,5,"dummy"
"236533",0,0,0,0,"dummy"
"236535",0,0,0,0,"dummy"
"236539",0,3,0,3,"dummy"
"236540",0,1,0,1,"dummy"
"236550",1,0,0,1,"dummy"
"236552",3,3,3,9,"dummy"
"236553",0,6,3,9,"dummy"
"236554",6,0,3,9,"dummy"
"236555",0,0,1,1,"dummy"
"236558",2,2,1,5,"dummy"
"236574",0,0,1,1,"dummy"
"236631",0,0,1,1,"dummy"
"236632",0,1,0,1,"dummy"
"236633",0,0,1,1,"dummy"
"236635",0,4,0,4,"dummy"
"236636",0,0,1,1,"dummy"
"236637",0,2,0,2,"dummy"
"236638",0,0,0,0,"dummy"
"236639",0,0,0,0,"dummy"
"236640",0,0,1,1,"dummy"
"236641",0,0,0,0,"dummy"
"236642",0,2,0,2,"dummy"
"236643",0,0,1,1,"dummy"
"236644",0,0,1,1,"dummy"
"236645",0,0,1,1,"dummy"
"236646",0,0,0,0,"dummy"
"236647",0,0,0,0,"dummy"
"236648",0,0,0,0,"dummy"
"236649",0,0,0,0,"dummy"
"236650",0,0,0,0,"dummy"
"236651",0,0,1,1,"dummy"
"236652",0,0,1,1,"dummy"
"236653",0,0,1,1,"dummy"
"236654",0,0,0,0,"dummy"
"236655",0,2,0,2,"dummy"
"236658",3,3,0,6,"dummy"
"236659",2,2,1,5,"dummy"
"236660",0,1,1,2,"dummy"
"236661",0,0,3,3,"dummy"
"236664",0,0,1,1,"dummy"
"236665",0,2,1,3,"dummy"
"236666",0,1,1,2,"dummy"
"236667",0,0,1,1,"dummy"
"236668",0,0,1,1,"dummy"
"236669",3,2,2,7,"dummy"
"236670",0,0,1,1,"dummy"
"236671",0,0,2,2,"dummy"
"236672",0,0,2,2,"dummy"
"236675",5,4,5,14,"dummy"
"236676",5,6,4,15,"dummy"
"236745",0,0,1,1,"dummy"
"236761",1,3,1,5,"dummy"
"236762",0,1,2,3,"dummy"
"236763",1,1,2,4,"dummy"
"236764",0,1,2,3,"dummy"
"236794",1,8,0,9,"dummy"
"236795",0,1,0,1,"dummy"
"236803",0,0,1,1,"dummy"
"236812",1,2,0,3,"dummy"
"236819",0,0,1,1,"dummy"
"236822",0,0,2,2,"dummy"
"236823",0,0,1,1,"dummy"
"236841",0,0,1,1,"dummy"
"236842",0,0,1,1,"dummy"
"236843",0,0,1,1,"dummy"
"236844",0,0,1,1,"dummy"
"236850",2,3,1,6,"dummy"
"236851",0,20,2,22,"dummy"
"236852",3,1,0,4,"dummy"
"236853",4,7,1,12,"dummy"
"236854",3,4,1,8,"dummy"
"236858",5,4,1,10,"dummy"
"236859",0,0,0,0,"dummy"
"236860",0,0,1,1,"dummy"
"236866",0,0,1,1,"dummy"
"236867",2,32,0,34,"dummy"
"236868",0,0,1,1,"dummy"
"236869",0,0,1,1,"dummy"
"236870",0,2,0,2,"dummy"
"236877",6,1,0,7,"dummy"
"236878",0,0,1,1,"dummy"
"236879",1,1,0,2,"dummy"
"236880",2,5,1,8,"dummy"
"236881",0,0,0,0,"dummy"
"236678",1,0,0,1,"dummy"
"236679",2,1,0,3,"dummy"
"236680",1,0,0,1,"dummy"
"236726",2,0,1,3,"dummy"
"236727",2,1,0,3,"dummy"
"236728",0,1,0,1,"dummy"
"236729",0,1,0,1,"dummy"
"236730",0,3,1,4,"dummy"
"236731",2,0,0,2,"dummy"
"236732",0,3,1,4,"dummy"
"236733",1,0,3,4,"dummy"
"236734",1,0,0,1,"dummy"
"236735",0,1,0,1,"dummy"
"236736",0,0,1,1,"dummy"
"236739",0,1,0,1,"dummy"
"236740",1,0,0,1,"dummy"
"236741",0,0,1,1,"dummy"
"236742",0,0,1,1,"dummy"
"236743",0,0,1,1,"dummy"
"236747",2,6,1,9,"dummy"
"236748",0,4,0,4,"dummy"
"236753",3,5,2,10,"dummy"
"236756",0,0,1,1,"dummy"
"236759",0,0,0,0,"dummy"
"236770",0,0,1,1,"dummy"
"236786",0,2,0,2,"dummy"
"236787",0,0,1,1,"dummy"
"236788",0,1,0,1,"dummy"
"236789",0,0,1,1,"dummy"
"236792",0,0,1,1,"dummy"
"236805",0,0,2,2,"dummy"
"236810",0,5,0,5,"dummy"
"236825",0,0,1,1,"dummy"
"236826",0,1,0,1,"dummy"
"236827",0,0,1,1,"dummy"
"236830",0,1,0,1,"dummy"
"236831",1,16,0,17,"dummy"
"236832",0,0,1,1,"dummy"
"236833",0,1,0,1,"dummy"
"236838",2,13,1,16,"dummy"
"236839",0,0,1,1,"dummy"
"236846",5,15,3,23,"dummy"
"236847",1,0,1,2,"dummy"
"236848",0,0,1,1,"dummy"
"236856",0,1,3,4,"dummy"
"236862",0,3,0,3,"dummy"
"236863",0,10,3,13,"dummy"
"236864",0,0,0,0,"dummy"
"236874",4,5,4,13,"dummy"
"236875",3,9,3,15,"dummy"
"236883",14,20,4,38,"dummy"
"236884",17,43,5,65,"dummy"
"236885",41,7,3,51,"dummy"
"236886",4,44,1,49,"dummy"
"236887",1,2,0,3,"dummy"
"236888",2,8,0,10,"dummy"
"236889",0,4,0,4,"dummy"
"236890",54,12,11,77,"dummy"
"236891",0,1,1,2,"dummy"
"236935",0,0,0,0,"dummy"
"236941",2,2,3,7,"dummy"
"236942",4,5,3,12,"dummy"
"236947",0,0,1,1,"dummy"
"236948",10,10,0,20,"dummy"
"236949",5,9,1,15,"dummy"
"236952",2,0,2,4,"dummy"
"236975",0,0,0,0,"dummy"
"236976",2,0,0,2,"dummy"
"236937",0,3,0,3,"dummy"
"236938",2,2,1,5,"dummy"
"236939",0,4,1,5,"dummy"
"236944",2,5,0,7,"dummy"
"236945",2,4,0,6,"dummy"
"236954",2,1,0,3,"dummy"
"236955",0,2,0,2,"dummy"
"236956",0,1,0,1,"dummy"
"236957",0,2,0,2,"dummy"
"236962",0,0,1,1,"dummy"
"236995",0,0,0,0,"dummy"
"236999",0,0,0,0,"dummy"
"237000",0,0,0,0,"dummy"
"237003",1,0,0,1,"dummy"
"237004",0,0,1,1,"dummy"
"237014",2,0,1,3,"dummy"
"237015",0,4,1,5,"dummy"
"237023",0,0,1,1,"dummy"
"237028",0,2,1,3,"dummy"
"237029",0,0,1,1,"dummy"
"237036",0,1,0,1,"dummy"
"237037",0,1,0,1,"dummy"
"237054",3,2,5,10,"dummy"
"237055",2,2,0,4,"dummy"
"237056",2,2,0,4,"dummy"
"237059",2,2,0,4,"dummy"
"237060",1,2,0,3,"dummy"
"237064",0,1,0,1,"dummy"
"237068",0,2,0,2,"dummy"
"237073",0,3,0,3,"dummy"
"237074",2,0,0,2,"dummy"
"237075",0,0,0,0,"dummy"
"237076",3,1,0,4,"dummy"
"237077",1,3,2,6,"dummy"
"237078",0,2,0,2,"dummy"
"237079",1,0,0,1,"dummy"
"237080",0,3,0,3,"dummy"
"237081",2,0,0,2,"dummy"
"237082",2,2,0,4,"dummy"
"237083",0,0,1,1,"dummy"
"237084",0,0,1,1,"dummy"
"237085",1,0,0,1,"dummy"
"237086",4,1,2,7,"dummy"
"237089",0,0,1,1,"dummy"
"237090",0,0,1,1,"dummy"
"237091",0,0,1,1,"dummy"
"237092",0,0,1,1,"dummy"
"237093",6,1,0,7,"dummy"
"237096",0,0,0,0,"dummy"
"237103",2,2,3,7,"dummy"
"237104",0,0,1,1,"dummy"
"237108",0,0,1,1,"dummy"
"237124",0,1,0,1,"dummy"
"237125",0,1,0,1,"dummy"
"237126",0,1,0,1,"dummy"
"237127",0,1,0,1,"dummy"
"237128",0,1,0,1,"dummy"
"237129",0,1,0,1,"dummy"
"237130",6,0,1,7,"dummy"
"237131",0,1,0,1,"dummy"
"237132",0,1,0,1,"dummy"
"237135",0,1,0,1,"dummy"
"237136",1,6,0,7,"dummy"
"236977",2,1,0,3,"dummy"
"236978",0,2,0,2,"dummy"
"236979",3,0,0,3,"dummy"
"236980",2,6,2,10,"dummy"
"236981",0,0,0,0,"dummy"
"236982",0,1,0,1,"dummy"
"236983",2,0,0,2,"dummy"
"236984",0,0,0,0,"dummy"
"236985",0,0,1,1,"dummy"
"236986",0,0,1,1,"dummy"
"236987",1,0,0,1,"dummy"
"236988",4,0,0,4,"dummy"
"236991",32,12,1,45,"dummy"
"236997",0,0,1,1,"dummy"
"237008",1,3,1,5,"dummy"
"237009",0,1,1,2,"dummy"
"237010",0,1,0,1,"dummy"
"237011",1,2,0,3,"dummy"
"237012",0,0,2,2,"dummy"
"237017",5,0,0,5,"dummy"
"237018",3,3,0,6,"dummy"
"237021",0,0,1,1,"dummy"
"237025",3,3,0,6,"dummy"
"237026",1,0,0,1,"dummy"
"237031",0,1,0,1,"dummy"
"237032",0,1,0,1,"dummy"
"237033",0,7,0,7,"dummy"
"237034",4,1,3,8,"dummy"
"237039",3,4,1,8,"dummy"
"237040",9,7,2,18,"dummy"
"237041",5,13,0,18,"dummy"
"237042",0,0,1,1,"dummy"
"237043",0,0,1,1,"dummy"
"237044",0,0,1,1,"dummy"
"237048",0,1,0,1,"dummy"
"237062",0,1,0,1,"dummy"
"237066",0,0,0,0,"dummy"
"237098",0,3,0,3,"dummy"
"237099",6,0,0,6,"dummy"
"237100",0,1,1,2,"dummy"
"237101",4,2,2,8,"dummy"
"237106",1,2,0,3,"dummy"
"237110",0,0,1,1,"dummy"
"237113",0,0,1,1,"dummy"
"237114",0,0,1,1,"dummy"
"237117",0,1,0,1,"dummy"
"237122",0,0,1,1,"dummy"
"237143",0,0,0,0,"dummy"
"237146",1,27,0,28,"dummy"
"237147",3,1,21,25,"dummy"
"237148",0,2,0,2,"dummy"
"237149",26,26,0,52,"dummy"
"237227",0,0,1,1,"dummy"
"237228",0,0,1,1,"dummy"
"237229",0,0,1,1,"dummy"
"237230",0,0,1,1,"dummy"
"237231",0,0,0,0,"dummy"
"237232",0,0,1,1,"dummy"
"237233",0,0,1,1,"dummy"
"237234",0,0,1,1,"dummy"
"237237",0,0,1,1,"dummy"
"237238",4,0,6,10,"dummy"
"237251",1,0,0,1,"dummy"
"237252",0,1,0,1,"dummy"
"237137",1,1,0,2,"dummy"
"237138",0,1,0,1,"dummy"
"237155",0,10,0,10,"dummy"
"237156",1,2,0,3,"dummy"
"237161",0,0,3,3,"dummy"
"237167",0,0,2,2,"dummy"
"237168",0,0,2,2,"dummy"
"237171",0,2,0,2,"dummy"
"237172",0,0,1,1,"dummy"
"237173",0,0,2,2,"dummy"
"237174",0,0,2,2,"dummy"
"237177",0,0,0,0,"dummy"
"237178",0,1,0,1,"dummy"
"237179",0,1,0,1,"dummy"
"237180",1,0,0,1,"dummy"
"237181",0,2,0,2,"dummy"
"237182",0,0,1,1,"dummy"
"237183",2,0,0,2,"dummy"
"237184",0,2,0,2,"dummy"
"237185",0,1,0,1,"dummy"
"237186",0,0,1,1,"dummy"
"237187",1,2,1,4,"dummy"
"237188",0,1,0,1,"dummy"
"237189",0,2,0,2,"dummy"
"237190",0,1,0,1,"dummy"
"237191",0,3,0,3,"dummy"
"237192",0,5,0,5,"dummy"
"237193",0,1,0,1,"dummy"
"237194",0,1,0,1,"dummy"
"237195",0,0,2,2,"dummy"
"237196",0,4,0,4,"dummy"
"237197",3,0,0,3,"dummy"
"237198",0,16,0,16,"dummy"
"237199",3,0,0,3,"dummy"
"237200",0,0,0,0,"dummy"
"237201",9,0,0,9,"dummy"
"237202",0,0,0,0,"dummy"
"237203",0,0,0,0,"dummy"
"237204",0,0,0,0,"dummy"
"237205",1,0,0,1,"dummy"
"237206",0,0,0,0,"dummy"
"237264",0,2,0,2,"dummy"
"237265",0,3,0,3,"dummy"
"237266",0,1,0,1,"dummy"
"237267",0,2,0,2,"dummy"
"237268",0,1,0,1,"dummy"
"237269",8,3,0,11,"dummy"
"237270",0,1,0,1,"dummy"
"237271",0,1,0,1,"dummy"
"237278",0,1,1,2,"dummy"
"237292",0,1,0,1,"dummy"
"237293",0,0,0,0,"dummy"
"237308",1,0,0,1,"dummy"
"237309",0,1,0,1,"dummy"
"237310",0,1,0,1,"dummy"
"237311",0,1,0,1,"dummy"
"237312",0,0,1,1,"dummy"
"237313",0,3,0,3,"dummy"
"237253",0,2,0,2,"dummy"
"237254",0,0,1,1,"dummy"
"237259",0,0,0,0,"dummy"
"237260",0,0,0,0,"dummy"
"237261",0,0,0,0,"dummy"
"237262",0,0,0,0,"dummy"
"237273",0,0,1,1,"dummy"
"237274",4,5,0,9,"dummy"
"237275",0,1,0,1,"dummy"
"237276",0,0,1,1,"dummy"
"237280",1,0,0,1,"dummy"
"237281",0,1,0,1,"dummy"
"237282",0,0,2,2,"dummy"
"237283",0,0,2,2,"dummy"
"237284",5,2,4,11,"dummy"
"237287",0,1,0,1,"dummy"
"237288",0,0,0,0,"dummy"
"237289",0,1,0,1,"dummy"
"237290",0,1,2,3,"dummy"
"237295",6,0,0,6,"dummy"
"237296",2,5,2,9,"dummy"
"237299",1,0,0,1,"dummy"
"237300",0,0,0,0,"dummy"
"237301",0,1,0,1,"dummy"
"237302",10,16,4,30,"dummy"
"237303",1,4,1,6,"dummy"
"237304",3,1,2,6,"dummy"
"237305",1,0,0,1,"dummy"
"237306",0,1,0,1,"dummy"
"237315",0,2,1,3,"dummy"
"237320",0,2,0,2,"dummy"
"237321",0,0,1,1,"dummy"
"237322",0,1,1,2,"dummy"
"237325",4,0,3,7,"dummy"
"237326",0,2,0,2,"dummy"
"237327",1,2,1,4,"dummy"
"237328",0,0,1,1,"dummy"
"237329",1,0,1,2,"dummy"
"237330",0,3,1,4,"dummy"
"237331",0,1,0,1,"dummy"
"237332",0,1,0,1,"dummy"
"237333",0,2,0,2,"dummy"
"237334",1,0,0,1,"dummy"
"237335",0,0,4,4,"dummy"
"237336",1,0,0,1,"dummy"
"237337",0,0,3,3,"dummy"
"237338",0,0,1,1,"dummy"
"237339",0,1,0,1,"dummy"
"237340",0,3,0,3,"dummy"
"237341",0,0,1,1,"dummy"
"237347",1,2,0,3,"dummy"
"237349",5,5,5,15,"dummy"
"237350",0,1,0,1,"dummy"
"237352",12,16,1,29,"dummy"
"237354",0,0,1,1,"dummy"
"237359",0,0,0,0,"dummy"
"237362",0,1,0,1,"dummy"
"237366",2,12,0,14,"dummy"
"237367",12,5,0,17,"dummy"
"237368",1,0,5,6,"dummy"
"237369",0,0,0,0,"dummy"
"237370",0,1,0,1,"dummy"
"237371",1,4,3,8,"dummy"
"237374",0,5,0,5,"dummy"
"237375",0,1,0,1,"dummy"
"237376",0,0,1,1,"dummy"
"237377",0,0,2,2,"dummy"
"237378",0,3,1,4,"dummy"
"237383",0,1,0,1,"dummy"
"237384",0,1,0,1,"dummy"
"237389",0,1,0,1,"dummy"
"237430",1,0,0,1,"dummy"
"237431",0,16,0,16,"dummy"
"237432",0,1,0,1,"dummy"
"237433",5,0,1,6,"dummy"
"237434",11,5,0,16,"dummy"
"237442",0,0,1,1,"dummy"
"237443",0,0,1,1,"dummy"
"237444",0,0,1,1,"dummy"
"237446",0,4,1,5,"dummy"
"237447",0,1,0,1,"dummy"
"237449",0,0,1,1,"dummy"
"237468",0,1,0,1,"dummy"
"237469",0,1,0,1,"dummy"
"237470",0,1,0,1,"dummy"
"237473",5,0,4,9,"dummy"
"237474",1,0,0,1,"dummy"
"237475",0,1,0,1,"dummy"
"237476",2,4,4,10,"dummy"
"237477",4,0,0,4,"dummy"
"237478",0,2,0,2,"dummy"
"237479",2,1,1,4,"dummy"
"237480",1,2,4,7,"dummy"
"237481",0,0,3,3,"dummy"
"237482",0,0,0,0,"dummy"
"237483",0,0,1,1,"dummy"
"237484",0,0,0,0,"dummy"
"237485",0,4,0,4,"dummy"
"237488",1,0,1,2,"dummy"
"237489",1,0,1,2,"dummy"
"237490",0,0,1,1,"dummy"
"237492",0,0,1,1,"dummy"
"237494",1,5,0,6,"dummy"
"237495",0,0,1,1,"dummy"
"237496",8,5,3,16,"dummy"
"237498",2,4,0,6,"dummy"
"237499",0,2,0,2,"dummy"
"237500",0,2,0,2,"dummy"
"237501",10,2,0,12,"dummy"
"237502",0,2,0,2,"dummy"
"237503",0,0,0,0,"dummy"
"237504",0,0,3,3,"dummy"
"237505",0,5,0,5,"dummy"
"237506",1,0,1,2,"dummy"
"237508",0,0,1,1,"dummy"
"237509",0,0,1,1,"dummy"
"237510",0,0,0,0,"dummy"
"237511",1,2,0,3,"dummy"
"237512",2,3,0,5,"dummy"
"237513",0,1,1,2,"dummy"
"237514",1,0,0,1,"dummy"
"237516",4,0,0,4,"dummy"
"237517",1,1,1,3,"dummy"
"237518",0,1,0,1,"dummy"
"237519",0,0,1,1,"dummy"
"237521",7,9,4,20,"dummy"
"237522",12,4,3,19,"dummy"
"237524",3,12,2,17,"dummy"
"237526",0,1,0,1,"dummy"
"237527",0,2,0,2,"dummy"
"237528",2,0,0,2,"dummy"
"237535",0,1,1,2,"dummy"
"237536",2,1,3,6,"dummy"
"237537",1,2,1,4,"dummy"
"237538",1,5,0,6,"dummy"
"237539",0,0,2,2,"dummy"
"237541",4,3,1,8,"dummy"
"237543",0,0,1,1,"dummy"
"237545",0,7,4,11,"dummy"
"237547",0,0,3,3,"dummy"
"237548",0,5,0,5,"dummy"
"237550",0,0,1,1,"dummy"
"237551",0,0,1,1,"dummy"
"237553",1,1,0,2,"dummy"
"237555",0,0,0,0,"dummy"
"237556",0,10,0,10,"dummy"
"237557",0,1,0,1,"dummy"
"237558",0,9,0,9,"dummy"
"237559",0,2,1,3,"dummy"
"237560",45,5,3,53,"dummy"
"237561",2,2,3,7,"dummy"
"237563",0,0,0,0,"dummy"
"237564",0,2,0,2,"dummy"
"237565",0,0,0,0,"dummy"
"237566",0,0,0,0,"dummy"
"237567",0,0,0,0,"dummy"
"237568",0,0,1,1,"dummy"
"237569",0,0,0,0,"dummy"
"237570",0,0,0,0,"dummy"
"237571",0,0,0,0,"dummy"
"237572",0,0,0,0,"dummy"
"237573",3,8,0,11,"dummy"
"237574",15,10,0,25,"dummy"
"237575",10,11,0,21,"dummy"
"237576",1,4,0,5,"dummy"
"237577",1,2,0,3,"dummy"
"237580",0,0,1,1,"dummy"
"237582",2,0,0,2,"dummy"
"237583",0,0,0,0,"dummy"
"237584",0,0,0,0,"dummy"
"237585",0,0,0,0,"dummy"
"237586",0,0,1,1,"dummy"
"237588",0,1,0,1,"dummy"
"237589",0,1,0,1,"dummy"
"237591",2,2,0,4,"dummy"
"237592",4,5,1,10,"dummy"
"237593",0,1,0,1,"dummy"
"237595",0,1,0,1,"dummy"
"237597",0,1,0,1,"dummy"
"237598",0,1,0,1,"dummy"
"237599",1,0,1,2,"dummy"
"237600",0,3,0,3,"dummy"
"237601",0,1,0,1,"dummy"
"237602",1,0,1,2,"dummy"
"237603",1,2,0,3,"dummy"
"237604",0,1,1,2,"dummy"
"237605",1,0,1,2,"dummy"
"237606",2,1,0,3,"dummy"
"237607",1,0,0,1,"dummy"
"237608",0,1,0,1,"dummy"
"237619",0,0,0,0,"dummy"
"237620",0,3,1,4,"dummy"
"237621",2,1,0,3,"dummy"
"237623",0,0,1,1,"dummy"
"237624",0,0,1,1,"dummy"
"237625",0,0,2,2,"dummy"
"237626",26,3,7,36,"dummy"
"237629",0,2,0,2,"dummy"
"237630",1,4,0,5,"dummy"
"237631",5,2,0,7,"dummy"
"237632",1,1,2,4,"dummy"
"237633",0,1,0,1,"dummy"
"237634",1,1,0,2,"dummy"
"237635",1,2,2,5,"dummy"
"237638",0,4,0,4,"dummy"
"237639",0,0,1,1,"dummy"
"237641",0,6,0,6,"dummy"
"237642",4,3,1,8,"dummy"
"237643",2,4,2,8,"dummy"
"237644",1,0,0,1,"dummy"
"237647",1,0,0,1,"dummy"
"237648",2,4,0,6,"dummy"
"237651",1,4,1,6,"dummy"
"237652",1,2,0,3,"dummy"
"237653",5,3,1,9,"dummy"
"237654",0,4,1,5,"dummy"
"237655",2,1,0,3,"dummy"
"237656",3,0,0,3,"dummy"
"237657",0,8,0,8,"dummy"
"237658",0,1,0,1,"dummy"
"237659",0,5,0,5,"dummy"
"237660",0,6,0,6,"dummy"
"237661",1,0,0,1,"dummy"
"237662",17,0,0,17,"dummy"
"237664",3,12,4,19,"dummy"
"237665",0,1,0,1,"dummy"
"237666",0,4,0,4,"dummy"
"237667",0,1,0,1,"dummy"
"237668",2,0,0,2,"dummy"
"237670",3,0,0,3,"dummy"
"237674",0,4,1,5,"dummy"
"237675",0,1,0,1,"dummy"
"237676",0,2,4,6,"dummy"
"237681",0,0,0,0,"dummy"
"237684",0,1,0,1,"dummy"
"237687",0,0,1,1,"dummy"
"237688",0,0,1,1,"dummy"
"237690",0,1,0,1,"dummy"
"237691",0,0,0,0,"dummy"
"237693",0,22,4,26,"dummy"
"237694",0,0,1,1,"dummy"
"237695",0,2,1,3,"dummy"
"237696",0,3,0,3,"dummy"
"237697",11,28,0,39,"dummy"
"237698",43,9,5,57,"dummy"
"237701",0,2,0,2,"dummy"
"237703",7,5,2,14,"dummy"
"237704",0,0,1,1,"dummy"
"237705",0,0,1,1,"dummy"
"237706",0,0,1,1,"dummy"
"237707",1,0,0,1,"dummy"
"237708",0,0,0,0,"dummy"
"237709",4,8,0,12,"dummy"
"237710",0,0,1,1,"dummy"
"237711",2,0,0,2,"dummy"
"237716",0,1,0,1,"dummy"
"237717",1,0,1,2,"dummy"
"237718",0,1,1,2,"dummy"
"237722",0,0,2,2,"dummy"
"237723",0,0,2,2,"dummy"
"237726",0,0,1,1,"dummy"
"237727",0,0,1,1,"dummy"
"237728",0,0,1,1,"dummy"
"237729",0,3,0,3,"dummy"
"237730",0,2,2,4,"dummy"
"237731",0,1,0,1,"dummy"
"237733",0,1,0,1,"dummy"
"237734",1,1,0,2,"dummy"
"237736",0,1,0,1,"dummy"
"237739",0,0,0,0,"dummy"
"237740",0,1,0,1,"dummy"
"237741",0,0,1,1,"dummy"
"237742",0,0,1,1,"dummy"
"237743",0,0,1,1,"dummy"
"237744",0,0,1,1,"dummy"
"237746",0,0,1,1,"dummy"
"237747",2,0,0,2,"dummy"
"237748",0,2,0,2,"dummy"
"237749",0,0,1,1,"dummy"
"237752",12,1,0,13,"dummy"
"237753",0,0,1,1,"dummy"
"237754",2,0,0,2,"dummy"
"237755",1,0,0,1,"dummy"
"237758",1,2,0,3,"dummy"
"237759",0,1,1,2,"dummy"
"237762",0,2,0,2,"dummy"
"237763",0,1,0,1,"dummy"
"237764",0,0,1,1,"dummy"
"237765",0,5,1,6,"dummy"
"237766",3,1,0,4,"dummy"
"237767",4,1,1,6,"dummy"
"237768",0,6,1,7,"dummy"
"237769",0,0,0,0,"dummy"
"237776",0,1,0,1,"dummy"
"237777",0,20,0,20,"dummy"
"237778",1,0,0,1,"dummy"
"237779",0,0,2,2,"dummy"
"237780",0,1,6,7,"dummy"
"237781",0,0,1,1,"dummy"
"237815",0,0,1,1,"dummy"
"237833",0,0,1,1,"dummy"
"237837",0,1,0,1,"dummy"
"237838",1,3,1,5,"dummy"
"237848",0,1,0,1,"dummy"
"237849",0,0,1,1,"dummy"
"237850",2,0,0,2,"dummy"
"237851",0,0,0,0,"dummy"
"237855",0,1,0,1,"dummy"
"237856",0,0,1,1,"dummy"
"237857",0,0,1,1,"dummy"
"237858",0,1,0,1,"dummy"
"237859",5,2,1,8,"dummy"
"237860",1,0,0,1,"dummy"
"237881",1,0,2,3,"dummy"
"237882",3,2,1,6,"dummy"
"237883",0,0,2,2,"dummy"
"237884",1,1,0,2,"dummy"
"237885",0,3,0,3,"dummy"
"237886",0,1,0,1,"dummy"
"237887",0,0,2,2,"dummy"
"237888",5,6,2,13,"dummy"
"237889",0,2,0,2,"dummy"
"237910",0,0,1,1,"dummy"
"237911",3,1,1,5,"dummy"
"237912",1,1,0,2,"dummy"
"237935",0,0,1,1,"dummy"
"237936",0,2,0,2,"dummy"
"237946",7,1,0,8,"dummy"
"237947",3,3,0,6,"dummy"
"237948",0,1,0,1,"dummy"
"237949",0,6,1,7,"dummy"
"237976",0,1,0,1,"dummy"
"237977",0,0,2,2,"dummy"
"237980",1,2,0,3,"dummy"
"237981",0,1,0,1,"dummy"
"237982",0,0,1,1,"dummy"
"237983",1,0,0,1,"dummy"
"238020",1,2,0,3,"dummy"
"238025",0,1,0,1,"dummy"
"238033",0,0,1,1,"dummy"
"238036",2,2,0,4,"dummy"
"238037",0,0,1,1,"dummy"
"238038",0,0,1,1,"dummy"
"238039",16,3,1,20,"dummy"
"238040",1,7,0,8,"dummy"
"238041",0,1,0,1,"dummy"
"238042",0,1,0,1,"dummy"
"238043",9,10,0,19,"dummy"
"238044",1,9,0,10,"dummy"
"238047",0,0,1,1,"dummy"
"238048",2,1,0,3,"dummy"
"238049",2,1,0,3,"dummy"
"238050",4,2,0,6,"dummy"
"238051",0,0,1,1,"dummy"
"238052",0,0,1,1,"dummy"
"238062",1,1,0,2,"dummy"
"237771",0,1,0,1,"dummy"
"237772",5,8,0,13,"dummy"
"237783",0,0,0,0,"dummy"
"237784",0,0,0,0,"dummy"
"237785",0,0,1,1,"dummy"
"237786",0,0,1,1,"dummy"
"237787",1,1,0,2,"dummy"
"237788",0,0,2,2,"dummy"
"237789",0,0,1,1,"dummy"
"237790",2,0,0,2,"dummy"
"237791",2,0,0,2,"dummy"
"237792",0,0,0,0,"dummy"
"237793",0,3,0,3,"dummy"
"237794",3,0,0,3,"dummy"
"237795",0,3,0,3,"dummy"
"237796",4,1,0,5,"dummy"
"237797",1,0,0,1,"dummy"
"237798",0,0,0,0,"dummy"
"237799",0,0,0,0,"dummy"
"237800",1,0,0,1,"dummy"
"237803",3,1,0,4,"dummy"
"237804",0,0,0,0,"dummy"
"237805",0,0,1,1,"dummy"
"237806",0,1,0,1,"dummy"
"237807",2,4,0,6,"dummy"
"237808",2,6,2,10,"dummy"
"237809",8,5,0,13,"dummy"
"237810",1,0,0,1,"dummy"
"237811",0,1,0,1,"dummy"
"237812",1,0,0,1,"dummy"
"237813",0,1,0,1,"dummy"
"237817",0,0,1,1,"dummy"
"237818",0,0,1,1,"dummy"
"237835",13,11,2,26,"dummy"
"237846",0,2,0,2,"dummy"
"237853",0,0,1,1,"dummy"
"237862",0,0,5,5,"dummy"
"237865",0,1,0,1,"dummy"
"237866",3,1,0,4,"dummy"
"237867",1,5,1,7,"dummy"
"237868",2,7,1,10,"dummy"
"237869",0,0,0,0,"dummy"
"237870",1,0,0,1,"dummy"
"237871",0,2,0,2,"dummy"
"237872",2,1,0,3,"dummy"
"237873",0,3,0,3,"dummy"
"237874",3,0,0,3,"dummy"
"237875",0,0,1,1,"dummy"
"237876",9,6,0,15,"dummy"
"237891",0,2,0,2,"dummy"
"237892",0,0,1,1,"dummy"
"237893",2,0,2,4,"dummy"
"237901",0,1,0,1,"dummy"
"237902",0,0,1,1,"dummy"
"237903",13,13,5,31,"dummy"
"237904",0,2,0,2,"dummy"
"237905",0,0,1,1,"dummy"
"237906",0,2,0,2,"dummy"
"237907",2,0,0,2,"dummy"
"237908",1,0,0,1,"dummy"
"237914",0,0,1,1,"dummy"
"237915",0,1,0,1,"dummy"
"237918",0,3,0,3,"dummy"
"237919",0,13,0,13,"dummy"
"237920",0,2,0,2,"dummy"
"237923",0,1,0,1,"dummy"
"237924",0,1,0,1,"dummy"
"237925",0,1,0,1,"dummy"
"237926",1,1,0,2,"dummy"
"237929",0,1,0,1,"dummy"
"237938",0,0,1,1,"dummy"
"237941",1,1,0,2,"dummy"
"237942",1,1,0,2,"dummy"
"237943",1,1,0,2,"dummy"
"237944",2,2,0,4,"dummy"
"237951",0,4,1,5,"dummy"
"237952",0,0,1,1,"dummy"
"237953",0,1,0,1,"dummy"
"237964",1,0,0,1,"dummy"
"237965",0,0,0,0,"dummy"
"237966",1,0,0,1,"dummy"
"237967",2,0,0,2,"dummy"
"237968",0,0,1,1,"dummy"
"237969",1,1,0,2,"dummy"
"237970",0,1,0,1,"dummy"
"237971",0,0,0,0,"dummy"
"237972",0,0,1,1,"dummy"
"237973",0,2,0,2,"dummy"
"237974",0,0,2,2,"dummy"
"237985",0,1,0,1,"dummy"
"237988",3,0,1,4,"dummy"
"237989",0,0,1,1,"dummy"
"237990",0,0,1,1,"dummy"
"237991",0,10,1,11,"dummy"
"237992",0,6,2,8,"dummy"
"237993",1,0,0,1,"dummy"
"237994",3,0,2,5,"dummy"
"237995",0,5,0,5,"dummy"
"237996",0,0,7,7,"dummy"
"237999",2,3,1,6,"dummy"
"238005",0,3,1,4,"dummy"
"238006",13,0,2,15,"dummy"
"238007",0,1,0,1,"dummy"
"238008",1,1,0,2,"dummy"
"238011",0,0,1,1,"dummy"
"238014",0,0,0,0,"dummy"
"238015",3,1,2,6,"dummy"
"238016",0,0,1,1,"dummy"
"238017",2,2,0,4,"dummy"
"238018",0,0,0,0,"dummy"
"238022",3,22,1,26,"dummy"
"238023",0,4,0,4,"dummy"
"238027",0,0,1,1,"dummy"
"238028",0,0,0,0,"dummy"
"238029",0,0,0,0,"dummy"
"238030",1,2,1,4,"dummy"
"238031",2,1,1,4,"dummy"
"238054",1,0,0,1,"dummy"
"238055",0,0,1,1,"dummy"
"238058",0,0,0,0,"dummy"
"238066",0,1,0,1,"dummy"
"238067",1,0,0,1,"dummy"
"238068",0,1,0,1,"dummy"
"238076",0,0,1,1,"dummy"
"238081",0,13,0,13,"dummy"
"238082",13,0,0,13,"dummy"
"238085",0,0,0,0,"dummy"
"238089",0,2,0,2,"dummy"
"238090",0,0,0,0,"dummy"
"238091",0,0,0,0,"dummy"
"238092",4,1,0,5,"dummy"
"238093",1,0,0,1,"dummy"
"238094",0,0,0,0,"dummy"
"238095",0,0,0,0,"dummy"
"238102",0,1,0,1,"dummy"
"238103",0,0,1,1,"dummy"
"238104",5,0,1,6,"dummy"
"238105",0,0,1,1,"dummy"
"238106",0,1,1,2,"dummy"
"238107",0,0,1,1,"dummy"
"238108",0,0,1,1,"dummy"
"238109",0,1,0,1,"dummy"
"238110",0,0,1,1,"dummy"
"238111",0,0,1,1,"dummy"
"238112",0,0,1,1,"dummy"
"238113",0,0,1,1,"dummy"
"238114",3,0,0,3,"dummy"
"238115",0,0,1,1,"dummy"
"238116",0,0,1,1,"dummy"
"238126",3,0,1,4,"dummy"
"238127",0,3,1,4,"dummy"
"238128",0,0,1,1,"dummy"
"238129",0,0,1,1,"dummy"
"238130",0,2,0,2,"dummy"
"238131",1,2,0,3,"dummy"
"238132",0,7,0,7,"dummy"
"238133",0,2,0,2,"dummy"
"238153",0,2,0,2,"dummy"
"238154",2,1,4,7,"dummy"
"238155",0,1,0,1,"dummy"
"238156",1,0,4,5,"dummy"
"238157",1,0,3,4,"dummy"
"238070",0,0,3,3,"dummy"
"238071",5,6,0,11,"dummy"
"238072",0,1,0,1,"dummy"
"238073",0,0,0,0,"dummy"
"238074",0,0,1,1,"dummy"
"238087",0,0,1,1,"dummy"
"238118",0,0,1,1,"dummy"
"238121",2,0,3,5,"dummy"
"238122",1,0,0,1,"dummy"
"238123",0,1,0,1,"dummy"
"238124",0,1,1,2,"dummy"
"238146",1,0,0,1,"dummy"
"238147",0,0,3,3,"dummy"
"238150",0,0,0,0,"dummy"
"238151",0,0,0,0,"dummy"
"238167",0,1,0,1,"dummy"
"238170",3,23,5,31,"dummy"
"238173",6,3,0,9,"dummy"
"238185",0,7,0,7,"dummy"
"238186",7,0,0,7,"dummy"
"238187",0,0,1,1,"dummy"
"238194",0,3,1,4,"dummy"
"238198",0,0,0,0,"dummy"
"238204",0,0,0,0,"dummy"
"238205",0,0,0,0,"dummy"
"238228",0,0,1,1,"dummy"
"238232",0,0,1,1,"dummy"
"238233",0,1,0,1,"dummy"
"238236",0,2,0,2,"dummy"
"238254",0,0,1,1,"dummy"
"238255",0,4,0,4,"dummy"
"238256",2,3,1,6,"dummy"
"238257",1,4,0,5,"dummy"
"238258",6,0,1,7,"dummy"
"238259",0,0,0,0,"dummy"
"238262",3,3,1,7,"dummy"
"238263",16,10,2,28,"dummy"
"238264",1,5,1,7,"dummy"
"238265",4,2,0,6,"dummy"
"238266",2,2,2,6,"dummy"
"238267",0,0,2,2,"dummy"
"238268",0,0,2,2,"dummy"
"238269",1,3,0,4,"dummy"
"238270",0,1,0,1,"dummy"
"238271",0,0,1,1,"dummy"
"238272",0,0,2,2,"dummy"
"238273",0,0,1,1,"dummy"
"238274",0,0,2,2,"dummy"
"238275",2,1,4,7,"dummy"
"238276",0,3,0,3,"dummy"
"238293",1,0,0,1,"dummy"
"238294",3,0,0,3,"dummy"
"238295",0,11,0,11,"dummy"
"238301",1,1,0,2,"dummy"
"238302",0,0,2,2,"dummy"
"238303",0,8,4,12,"dummy"
"238304",9,0,1,10,"dummy"
"238305",0,0,1,1,"dummy"
"238314",3,4,3,10,"dummy"
"238315",9,5,0,14,"dummy"
"238316",0,0,1,1,"dummy"
"238317",2,0,0,2,"dummy"
"238318",0,0,1,1,"dummy"
"238319",2,2,0,4,"dummy"
"238320",2,0,0,2,"dummy"
"238321",2,0,0,2,"dummy"
"238322",0,2,0,2,"dummy"
"238158",1,0,0,1,"dummy"
"238159",3,2,1,6,"dummy"
"238160",3,4,1,8,"dummy"
"238161",0,3,2,5,"dummy"
"238162",4,2,0,6,"dummy"
"238163",0,0,1,1,"dummy"
"238164",0,0,1,1,"dummy"
"238165",0,0,1,1,"dummy"
"238177",0,3,2,5,"dummy"
"238178",0,0,1,1,"dummy"
"238179",0,3,1,4,"dummy"
"238180",3,1,1,5,"dummy"
"238183",5,0,0,5,"dummy"
"238196",0,0,1,1,"dummy"
"238200",0,0,2,2,"dummy"
"238201",0,0,2,2,"dummy"
"238202",0,0,1,1,"dummy"
"238225",0,0,3,3,"dummy"
"238226",1,3,1,5,"dummy"
"238238",2,6,1,9,"dummy"
"238239",2,1,1,4,"dummy"
"238240",0,3,0,3,"dummy"
"238241",0,0,1,1,"dummy"
"238248",2,0,0,2,"dummy"
"238249",0,4,0,4,"dummy"
"238250",0,2,0,2,"dummy"
"238285",2,0,0,2,"dummy"
"238288",2,0,3,5,"dummy"
"238289",1,0,0,1,"dummy"
"238290",0,1,0,1,"dummy"
"238291",0,1,1,2,"dummy"
"238307",0,6,0,6,"dummy"
"238308",1,10,0,11,"dummy"
"238309",0,0,1,1,"dummy"
"238310",1,1,1,3,"dummy"
"238311",0,0,2,2,"dummy"
"238312",1,1,0,2,"dummy"
"238337",0,0,1,1,"dummy"
"238338",0,10,1,11,"dummy"
"238349",2,2,0,4,"dummy"
"238350",0,1,0,1,"dummy"
"238351",1,0,0,1,"dummy"
"238377",5,2,1,8,"dummy"
"238380",0,0,1,1,"dummy"
"238381",0,0,1,1,"dummy"
"238382",0,0,2,2,"dummy"
"238383",0,0,1,1,"dummy"
"238384",0,0,0,0,"dummy"
"238385",2,0,0,2,"dummy"
"238386",0,0,1,1,"dummy"
"238387",2,0,0,2,"dummy"
"238388",0,2,0,2,"dummy"
"238389",0,2,0,2,"dummy"
"238390",0,1,0,1,"dummy"
"238391",0,0,1,1,"dummy"
"238392",0,0,1,1,"dummy"
"238393",0,1,0,1,"dummy"
"238394",1,2,0,3,"dummy"
"238395",0,1,0,1,"dummy"
"238396",2,2,0,4,"dummy"
"238397",0,2,0,2,"dummy"
"238398",0,0,0,0,"dummy"
"238399",4,1,0,5,"dummy"
"238400",0,0,0,0,"dummy"
"238334",0,0,1,1,"dummy"
"238335",0,0,1,1,"dummy"
"238340",0,0,3,3,"dummy"
"238341",2,2,1,5,"dummy"
"238353",0,6,0,6,"dummy"
"238408",0,1,0,1,"dummy"
"238456",0,0,1,1,"dummy"
"238457",0,4,0,4,"dummy"
"238458",2,1,1,4,"dummy"
"238459",0,0,0,0,"dummy"
"238460",0,0,2,2,"dummy"
"238461",0,2,0,2,"dummy"
"238497",1,8,0,9,"dummy"
"238507",0,2,0,2,"dummy"
"238542",0,0,1,1,"dummy"
"238543",0,0,0,0,"dummy"
"238548",0,0,2,2,"dummy"
"238549",0,1,0,1,"dummy"
"238550",0,1,0,1,"dummy"
"238551",0,0,1,1,"dummy"
"238552",1,11,0,12,"dummy"
"238553",0,0,1,1,"dummy"
"238557",0,0,1,1,"dummy"
"238558",4,18,0,22,"dummy"
"238559",0,0,0,0,"dummy"
"238560",0,3,0,3,"dummy"
"238561",0,0,1,1,"dummy"
"238562",1,0,0,1,"dummy"
"238563",0,0,0,0,"dummy"
"238564",0,1,0,1,"dummy"
"238565",0,0,0,0,"dummy"
"238566",19,2,0,21,"dummy"
"238567",1,18,0,19,"dummy"
"238568",0,2,0,2,"dummy"
"238569",0,0,0,0,"dummy"
"238570",14,10,7,31,"dummy"
"238571",2,3,0,5,"dummy"
"238572",0,0,1,1,"dummy"
"238573",6,13,7,26,"dummy"
"238621",0,0,0,0,"dummy"
"238622",2,0,0,2,"dummy"
"238623",0,0,0,0,"dummy"
"238624",0,0,0,0,"dummy"
"238625",0,8,0,8,"dummy"
"238626",0,0,0,0,"dummy"
"238627",0,1,1,2,"dummy"
"238628",0,2,0,2,"dummy"
"238629",3,0,0,3,"dummy"
"238630",0,2,0,2,"dummy"
"238631",0,0,1,1,"dummy"
"238632",0,0,1,1,"dummy"
"238633",0,0,1,1,"dummy"
"238634",0,0,0,0,"dummy"
"238635",0,0,1,1,"dummy"
"238636",0,1,0,1,"dummy"
"238637",0,1,0,1,"dummy"
"238638",1,0,0,1,"dummy"
"238639",0,1,0,1,"dummy"
"238640",1,0,0,1,"dummy"
"238641",0,0,1,1,"dummy"
"238401",1,0,0,1,"dummy"
"238402",0,0,0,0,"dummy"
"238403",0,0,0,0,"dummy"
"238404",0,0,0,0,"dummy"
"238405",0,0,0,0,"dummy"
"238406",4,0,0,4,"dummy"
"238412",2,4,0,6,"dummy"
"238413",0,2,0,2,"dummy"
"238414",0,2,0,2,"dummy"
"238415",10,2,0,12,"dummy"
"238416",0,2,0,2,"dummy"
"238417",0,0,0,0,"dummy"
"238418",0,0,3,3,"dummy"
"238419",0,5,0,5,"dummy"
"238420",1,0,1,2,"dummy"
"238425",0,2,0,2,"dummy"
"238426",1,0,0,1,"dummy"
"238427",3,1,1,5,"dummy"
"238428",2,2,1,5,"dummy"
"238429",0,0,1,1,"dummy"
"238430",2,9,3,14,"dummy"
"238431",0,1,0,1,"dummy"
"238432",0,1,0,1,"dummy"
"238433",2,2,2,6,"dummy"
"238434",0,0,1,1,"dummy"
"238435",1,4,2,7,"dummy"
"238436",2,1,1,4,"dummy"
"238437",0,0,1,1,"dummy"
"238438",0,1,0,1,"dummy"
"238439",0,1,0,1,"dummy"
"238440",1,0,1,2,"dummy"
"238441",0,1,0,1,"dummy"
"238442",0,0,0,0,"dummy"
"238443",2,1,4,7,"dummy"
"238444",0,0,0,0,"dummy"
"238445",0,1,0,1,"dummy"
"238446",0,1,0,1,"dummy"
"238447",0,0,1,1,"dummy"
"238448",0,0,1,1,"dummy"
"238449",0,0,1,1,"dummy"
"238450",0,5,0,5,"dummy"
"238451",0,0,1,1,"dummy"
"238452",0,1,0,1,"dummy"
"238453",0,2,1,3,"dummy"
"238454",0,0,1,1,"dummy"
"238463",2,0,1,3,"dummy"
"238489",3,1,1,5,"dummy"
"238494",0,0,1,1,"dummy"
"238495",0,0,0,0,"dummy"
"238509",5,32,2,39,"dummy"
"238510",26,4,4,34,"dummy"
"238511",0,2,0,2,"dummy"
"238512",0,0,1,1,"dummy"
"238513",0,3,0,3,"dummy"
"238514",0,1,0,1,"dummy"
"238515",0,8,0,8,"dummy"
"238516",0,1,0,1,"dummy"
"238517",0,3,1,4,"dummy"
"238518",0,3,0,3,"dummy"
"238519",0,0,1,1,"dummy"
"238520",0,1,0,1,"dummy"
"238521",2,1,5,8,"dummy"
"238522",3,3,1,7,"dummy"
"238523",2,5,0,7,"dummy"
"238524",6,9,1,16,"dummy"
"238525",0,0,1,1,"dummy"
"238526",0,1,0,1,"dummy"
"238527",0,1,0,1,"dummy"
"238528",0,0,1,1,"dummy"
"238529",0,0,2,2,"dummy"
"238530",0,0,3,3,"dummy"
"238531",0,0,2,2,"dummy"
"238532",0,0,1,1,"dummy"
"238533",9,1,1,11,"dummy"
"238534",0,4,1,5,"dummy"
"238535",0,8,0,8,"dummy"
"238536",0,0,1,1,"dummy"
"238537",0,0,1,1,"dummy"
"238538",0,0,1,1,"dummy"
"238539",4,2,0,6,"dummy"
"238540",9,1,0,10,"dummy"
"238545",2,0,0,2,"dummy"
"238546",4,0,0,4,"dummy"
"238555",2,2,0,4,"dummy"
"238575",0,0,2,2,"dummy"
"238576",0,0,0,0,"dummy"
"238618",0,2,3,5,"dummy"
"238619",0,0,1,1,"dummy"
"238643",0,0,1,1,"dummy"
"238670",0,1,0,1,"dummy"
"238673",0,0,0,0,"dummy"
"238679",0,1,0,1,"dummy"
"238686",0,0,1,1,"dummy"
"238688",24,6,1,31,"dummy"
"238691",0,6,0,6,"dummy"
"238692",2,6,4,12,"dummy"
"238693",0,4,2,6,"dummy"
"238694",0,0,3,3,"dummy"
"238696",0,12,0,12,"dummy"
"238697",1,0,0,1,"dummy"
"238708",1,0,1,2,"dummy"
"238709",1,5,2,8,"dummy"
"238710",1,0,1,2,"dummy"
"238711",0,1,0,1,"dummy"
"238712",0,0,2,2,"dummy"
"238714",4,4,2,10,"dummy"
"238715",0,10,0,10,"dummy"
"238716",0,0,0,0,"dummy"
"238718",0,2,0,2,"dummy"
"238725",9,5,1,15,"dummy"
"238727",0,0,1,1,"dummy"
"238728",0,0,1,1,"dummy"
"238729",0,0,1,1,"dummy"
"238733",1,2,1,4,"dummy"
"238734",3,2,2,7,"dummy"
"238735",0,1,0,1,"dummy"
"238736",0,1,0,1,"dummy"
"238737",0,0,3,3,"dummy"
"238738",0,0,0,0,"dummy"
"238739",0,1,0,1,"dummy"
"238740",5,0,4,9,"dummy"
"238741",1,3,3,7,"dummy"
"238742",4,3,1,8,"dummy"
"238743",0,1,1,2,"dummy"
"238753",1,5,0,6,"dummy"
"238754",0,1,0,1,"dummy"
"238755",0,0,2,2,"dummy"
"238756",1,1,1,3,"dummy"
"238757",1,0,0,1,"dummy"
"238758",1,2,0,3,"dummy"
"238761",0,2,0,2,"dummy"
"238762",2,1,1,4,"dummy"
"238763",1,3,1,5,"dummy"
"238764",0,0,1,1,"dummy"
"238765",0,2,0,2,"dummy"
"238766",0,1,0,1,"dummy"
"238767",0,5,0,5,"dummy"
"238768",0,1,0,1,"dummy"
"238769",0,2,0,2,"dummy"
"238770",1,1,0,2,"dummy"
"238771",0,0,1,1,"dummy"
"238772",1,2,0,3,"dummy"
"238773",0,1,0,1,"dummy"
"238774",0,1,1,2,"dummy"
"238794",0,4,0,4,"dummy"
"238795",0,1,0,1,"dummy"
"238797",0,0,2,2,"dummy"
"238799",0,1,0,1,"dummy"
"238801",0,0,0,0,"dummy"
"238802",4,16,3,23,"dummy"
"238803",0,0,2,2,"dummy"
"238807",2,7,3,12,"dummy"
"238808",0,0,1,1,"dummy"
"238809",17,2,6,25,"dummy"
"238810",1,1,0,2,"dummy"
"238811",0,0,1,1,"dummy"
"238812",0,0,2,2,"dummy"
"238813",0,0,1,1,"dummy"
"238814",0,0,1,1,"dummy"
"238815",0,0,1,1,"dummy"
"238816",0,1,5,6,"dummy"
"238817",0,4,0,4,"dummy"
"238844",0,1,0,1,"dummy"
"238845",0,0,1,1,"dummy"
"238846",2,1,0,3,"dummy"
"238847",0,1,0,1,"dummy"
"238848",0,1,0,1,"dummy"
"238849",1,0,0,1,"dummy"
"238850",0,0,1,1,"dummy"
"238851",0,0,1,1,"dummy"
"238853",0,1,1,2,"dummy"
"238854",0,6,0,6,"dummy"
"238860",0,0,0,0,"dummy"
"238861",0,0,1,1,"dummy"
"238862",0,0,0,0,"dummy"
"238863",0,0,0,0,"dummy"
"238864",0,0,1,1,"dummy"
"238865",0,0,0,0,"dummy"
"238867",0,1,1,2,"dummy"
"238868",0,2,0,2,"dummy"
"238871",2,1,4,7,"dummy"
"238872",0,0,2,2,"dummy"
"238876",0,4,0,4,"dummy"
"238877",0,0,1,1,"dummy"
"238884",0,2,0,2,"dummy"
"238885",15,4,0,19,"dummy"
"238886",0,3,4,7,"dummy"
"238889",0,0,3,3,"dummy"
"238890",0,4,0,4,"dummy"
"238891",0,1,0,1,"dummy"
"238893",0,0,1,1,"dummy"
"238894",2,0,1,3,"dummy"
"238895",0,2,1,3,"dummy"
"238896",2,0,1,3,"dummy"
"238897",0,2,1,3,"dummy"
"238898",0,0,1,1,"dummy"
"238899",2,2,1,5,"dummy"
"238900",0,0,1,1,"dummy"
"238902",0,0,1,1,"dummy"
"238928",3,12,1,16,"dummy"
"238929",0,0,0,0,"dummy"
"238930",0,0,0,0,"dummy"
"238931",4,4,0,8,"dummy"
"238946",0,0,2,2,"dummy"
"238952",0,2,0,2,"dummy"
"238953",0,1,0,1,"dummy"
"238954",0,2,0,2,"dummy"
"238955",0,1,0,1,"dummy"
"238958",2,0,0,2,"dummy"
"238959",0,1,0,1,"dummy"
"238960",0,0,1,1,"dummy"
"238962",0,1,0,1,"dummy"
"238965",1,0,0,1,"dummy"
"238967",0,0,2,2,"dummy"
"238968",0,0,1,1,"dummy"
"238969",0,0,2,2,"dummy"
"238970",3,20,2,25,"dummy"
"238973",1,1,0,2,"dummy"
"238974",1,2,4,7,"dummy"
"238975",0,1,0,1,"dummy"
"238976",1,1,0,2,"dummy"
"238977",7,1,0,8,"dummy"
"238978",0,1,0,1,"dummy"
"238980",0,5,0,5,"dummy"
"238981",0,0,1,1,"dummy"
"238984",0,3,2,5,"dummy"
"238985",0,0,1,1,"dummy"
"238987",0,0,2,2,"dummy"
"238988",0,0,2,2,"dummy"
"238989",7,3,3,13,"dummy"
"238990",0,0,1,1,"dummy"
"238991",0,0,1,1,"dummy"
"238992",0,17,1,18,"dummy"
"238993",0,1,0,1,"dummy"
"238994",0,0,1,1,"dummy"
"239004",6,6,0,12,"dummy"
"239005",0,1,0,1,"dummy"
"239006",0,5,3,8,"dummy"
"239007",2,7,0,9,"dummy"
"239009",0,0,1,1,"dummy"
"239010",0,0,1,1,"dummy"
"239011",0,0,0,0,"dummy"
"239012",0,0,1,1,"dummy"
"239013",0,0,1,1,"dummy"
"239014",0,0,1,1,"dummy"
"239015",0,0,1,1,"dummy"
"239016",0,0,1,1,"dummy"
"239017",0,0,1,1,"dummy"
"239018",0,0,1,1,"dummy"
"239019",0,1,0,1,"dummy"
"239020",0,0,1,1,"dummy"
"239021",0,0,1,1,"dummy"
"239022",0,0,1,1,"dummy"
"239023",0,0,1,1,"dummy"
"239024",0,0,1,1,"dummy"
"239025",0,0,1,1,"dummy"
"239026",0,0,2,2,"dummy"
"239027",0,0,1,1,"dummy"
"239028",0,0,1,1,"dummy"
"239029",0,0,1,1,"dummy"
"239030",0,0,1,1,"dummy"
"239031",0,0,1,1,"dummy"
"239032",0,0,1,1,"dummy"
"239033",0,0,1,1,"dummy"
"239034",0,0,1,1,"dummy"
"239035",0,0,1,1,"dummy"
"239036",0,0,1,1,"dummy"
"239037",0,0,1,1,"dummy"
"239038",0,0,1,1,"dummy"
"239039",3,2,3,8,"dummy"
"239040",0,0,1,1,"dummy"
"239041",0,0,1,1,"dummy"
"239042",0,0,1,1,"dummy"
"239043",0,0,1,1,"dummy"
"239044",0,0,1,1,"dummy"
"239045",0,4,0,4,"dummy"
"239046",0,0,1,1,"dummy"
"239047",4,0,1,5,"dummy"
"239048",0,0,0,0,"dummy"
"239049",2,0,0,2,"dummy"
"239050",0,0,1,1,"dummy"
"239056",0,2,2,4,"dummy"
"239053",0,0,0,0,"dummy"
"239054",0,0,1,1,"dummy"
"239059",0,2,0,2,"dummy"
"239061",3,0,4,7,"dummy"
"239063",2,0,1,3,"dummy"
"239064",0,2,0,2,"dummy"
"239065",0,3,0,3,"dummy"
"239066",0,1,0,1,"dummy"
"239067",0,2,0,2,"dummy"
"239069",0,5,0,5,"dummy"
"239071",0,0,1,1,"dummy"
"239073",3,1,0,4,"dummy"
"239074",0,0,0,0,"dummy"
"239075",0,0,0,0,"dummy"
"239076",1,2,0,3,"dummy"
"239077",0,1,0,1,"dummy"
"239079",0,2,0,2,"dummy"
"239081",0,3,0,3,"dummy"
"239082",1,0,0,1,"dummy"
"239083",0,1,0,1,"dummy"
"239086",0,0,1,1,"dummy"
"239090",0,0,0,0,"dummy"
"239091",0,0,0,0,"dummy"
"239092",1,18,1,20,"dummy"
"239093",0,0,0,0,"dummy"
"239095",0,3,1,4,"dummy"
"239097",0,1,0,1,"dummy"
"239099",0,0,0,0,"dummy"
"239100",2,0,0,2,"dummy"
"239102",9,1,0,10,"dummy"
"239105",2,7,1,10,"dummy"
"239108",15,16,1,32,"dummy"
"239109",11,4,1,16,"dummy"
"239111",0,4,1,5,"dummy"
"239112",3,1,0,4,"dummy"
"239113",0,0,3,3,"dummy"
"239114",0,0,1,1,"dummy"
"239115",0,1,0,1,"dummy"
"239116",0,1,0,1,"dummy"
"239117",0,0,1,1,"dummy"
"239118",0,0,1,1,"dummy"
"239119",1,1,0,2,"dummy"
"239120",2,0,0,2,"dummy"
"239121",0,0,1,1,"dummy"
"239126",1,7,0,8,"dummy"
"239127",0,0,0,0,"dummy"
"239128",0,0,0,0,"dummy"
"239134",0,2,0,2,"dummy"
"239135",11,5,2,18,"dummy"
"239147",1,0,0,1,"dummy"
"239148",0,4,0,4,"dummy"
"239149",2,4,4,10,"dummy"
"239163",0,0,2,2,"dummy"
"239166",0,3,0,3,"dummy"
"239169",0,5,0,5,"dummy"
"239170",0,2,0,2,"dummy"
"239171",0,0,0,0,"dummy"
"239172",0,1,0,1,"dummy"
"239173",0,0,1,1,"dummy"
"239174",0,0,0,0,"dummy"
"239176",0,1,0,1,"dummy"
"239177",0,0,1,1,"dummy"
"239178",9,42,2,53,"dummy"
"239184",0,0,2,2,"dummy"
"239185",0,0,2,2,"dummy"
"239190",0,1,0,1,"dummy"
"239192",0,0,1,1,"dummy"
"239193",2,13,0,15,"dummy"
"239194",1,1,0,2,"dummy"
"239195",7,3,0,10,"dummy"
"239196",0,0,1,1,"dummy"
"239197",0,0,1,1,"dummy"
"239198",4,4,0,8,"dummy"
"239203",3,4,1,8,"dummy"
"239204",0,0,1,1,"dummy"
"239205",1,1,1,3,"dummy"
"239207",1,0,0,1,"dummy"
"239208",0,0,1,1,"dummy"
"239212",2,2,1,5,"dummy"
"239213",0,2,1,3,"dummy"
"239214",6,0,0,6,"dummy"
"239215",0,5,0,5,"dummy"
"239216",1,12,0,13,"dummy"
"239217",0,9,0,9,"dummy"
"239218",0,2,2,4,"dummy"
"239219",5,7,4,16,"dummy"
"239220",0,0,2,2,"dummy"
"239221",0,0,1,1,"dummy"
"239222",0,0,2,2,"dummy"
"239223",0,3,0,3,"dummy"
"239225",0,4,0,4,"dummy"
"239226",1,0,0,1,"dummy"
"239231",1,6,0,7,"dummy"
"239233",0,1,0,1,"dummy"
"239234",1,0,0,1,"dummy"
"239235",0,0,1,1,"dummy"
"239240",0,1,0,1,"dummy"
"239241",7,4,0,11,"dummy"
"239242",0,1,1,2,"dummy"
"239246",2,1,0,3,"dummy"
"239247",0,4,0,4,"dummy"
"239248",4,3,1,8,"dummy"
"239249",0,0,2,2,"dummy"
"239250",1,0,0,1,"dummy"
"239252",0,0,1,1,"dummy"
"239255",0,0,1,1,"dummy"
"239256",0,0,1,1,"dummy"
"239258",0,0,0,0,"dummy"
"239259",8,4,1,13,"dummy"
"239262",0,0,1,1,"dummy"
"239265",8,4,4,16,"dummy"
"239266",0,4,0,4,"dummy"
"239267",2,7,0,9,"dummy"
"239268",0,0,1,1,"dummy"
"239269",0,0,1,1,"dummy"
"239270",2,6,3,11,"dummy"
"239271",4,4,0,8,"dummy"
"239272",2,2,0,4,"dummy"
"239273",13,12,0,25,"dummy"
"239274",1,3,0,4,"dummy"
"239276",0,3,1,4,"dummy"
"239277",0,0,1,1,"dummy"
"239279",0,0,2,2,"dummy"
"239281",1,4,0,5,"dummy"
"239282",5,7,3,15,"dummy"
"239283",7,7,3,17,"dummy"
"239284",0,0,2,2,"dummy"
"239285",3,2,2,7,"dummy"
"239286",0,2,0,2,"dummy"
"239287",7,2,9,18,"dummy"
"239288",7,3,2,12,"dummy"
"239291",0,0,1,1,"dummy"
"239293",1,0,2,3,"dummy"
"239294",0,0,1,1,"dummy"
"239300",0,0,0,0,"dummy"
"239304",0,0,1,1,"dummy"
"239307",0,0,1,1,"dummy"
"239308",6,0,0,6,"dummy"
"239309",1,8,0,9,"dummy"
"239311",0,1,0,1,"dummy"
"239312",0,0,1,1,"dummy"
"239314",12,0,0,12,"dummy"
"239315",0,1,0,1,"dummy"
"239316",0,1,0,1,"dummy"
"239317",0,2,4,6,"dummy"
"239318",0,1,0,1,"dummy"
"239320",2,6,0,8,"dummy"
"239322",0,1,0,1,"dummy"
"239325",0,1,0,1,"dummy"
"239326",0,8,0,8,"dummy"
"239327",0,1,0,1,"dummy"
"239328",0,2,0,2,"dummy"
"239329",0,2,0,2,"dummy"
"239330",0,0,1,1,"dummy"
"239331",0,1,0,1,"dummy"
"239332",0,0,1,1,"dummy"
"239334",0,1,0,1,"dummy"
"239335",0,1,0,1,"dummy"
"239336",0,1,0,1,"dummy"
"239337",0,1,0,1,"dummy"
"239338",0,0,1,1,"dummy"
"239339",0,0,1,1,"dummy"
"239340",0,0,2,2,"dummy"
"239341",0,0,2,2,"dummy"
"239347",1,1,0,2,"dummy"
"239364",0,0,0,0,"dummy"
"239366",5,0,0,5,"dummy"
"239370",0,0,1,1,"dummy"
"239371",0,0,1,1,"dummy"
"239372",0,2,0,2,"dummy"
"239380",1,0,0,1,"dummy"
"239381",2,0,1,3,"dummy"
"239382",0,0,0,0,"dummy"
"239383",0,1,0,1,"dummy"
"239384",8,1,0,9,"dummy"
"239385",0,0,0,0,"dummy"
"239386",0,0,0,0,"dummy"
"239387",1,10,0,11,"dummy"
"239388",7,1,0,8,"dummy"
"239389",0,0,1,1,"dummy"
"239390",2,0,3,5,"dummy"
"239393",0,0,1,1,"dummy"
"239394",0,0,0,0,"dummy"
"239396",0,0,1,1,"dummy"
"239397",0,0,1,1,"dummy"
"239399",6,4,2,12,"dummy"
"239400",0,1,0,1,"dummy"
"239406",5,0,4,9,"dummy"
"239410",2,1,0,3,"dummy"
"239419",0,4,0,4,"dummy"
"239420",1,4,0,5,"dummy"
"239421",2,2,1,5,"dummy"
"239424",1,0,0,1,"dummy"
"239425",0,0,2,2,"dummy"
"239426",1,1,0,2,"dummy"
"239440",3,7,5,15,"dummy"
"239441",0,7,1,8,"dummy"
"239442",1,2,0,3,"dummy"
"239443",5,1,0,6,"dummy"
"239446",0,10,0,10,"dummy"
"239447",32,0,2,34,"dummy"
"239448",0,32,2,34,"dummy"
"239449",10,0,0,10,"dummy"
"239450",0,0,0,0,"dummy"
"239451",0,1,0,1,"dummy"
"239452",0,1,0,1,"dummy"
"239453",1,0,0,1,"dummy"
"239454",0,9,0,9,"dummy"
"239456",5,7,1,13,"dummy"
"239457",5,6,1,12,"dummy"
"239459",0,0,1,1,"dummy"
"239464",0,0,0,0,"dummy"
"239465",1,0,0,1,"dummy"
"239467",0,1,0,1,"dummy"
"239468",0,0,0,0,"dummy"
"239469",5,8,2,15,"dummy"
"239470",3,0,0,3,"dummy"
"239471",0,1,0,1,"dummy"
"239472",3,2,0,5,"dummy"
"239473",0,2,0,2,"dummy"
"239474",0,1,0,1,"dummy"
"239475",0,1,0,1,"dummy"
"239476",0,4,0,4,"dummy"
"239477",0,1,0,1,"dummy"
"239478",0,1,0,1,"dummy"
"239479",0,0,1,1,"dummy"
"239480",1,0,0,1,"dummy"
"239481",0,1,0,1,"dummy"
"239482",0,1,0,1,"dummy"
"239483",0,0,1,1,"dummy"
"239484",0,0,1,1,"dummy"
"239485",1,0,2,3,"dummy"
"239486",0,0,1,1,"dummy"
"239487",0,0,1,1,"dummy"
"239488",0,1,0,1,"dummy"
"239489",2,0,0,2,"dummy"
"239490",0,1,0,1,"dummy"
"239506",1,1,2,4,"dummy"
"239510",0,7,0,7,"dummy"
"239512",1,4,1,6,"dummy"
"239513",7,12,2,21,"dummy"
"239514",12,1,1,14,"dummy"
"239516",0,1,0,1,"dummy"
"239517",0,0,1,1,"dummy"
"239518",0,0,1,1,"dummy"
"239519",0,4,3,7,"dummy"
"239520",4,5,0,9,"dummy"
"239521",0,6,1,7,"dummy"
"239522",0,1,0,1,"dummy"
"239523",0,0,1,1,"dummy"
"239524",1,7,0,8,"dummy"
"239525",0,0,1,1,"dummy"
"239526",0,1,0,1,"dummy"
"239527",0,0,1,1,"dummy"
"239528",0,1,0,1,"dummy"
"239530",0,0,0,0,"dummy"
"239531",0,1,0,1,"dummy"
"239565",1,1,1,3,"dummy"
"239566",0,4,0,4,"dummy"
"239568",0,0,0,0,"dummy"
"239570",1,3,2,6,"dummy"
"239571",0,2,0,2,"dummy"
"239572",0,0,1,1,"dummy"
"239573",0,0,1,1,"dummy"
"239575",0,3,2,5,"dummy"
"239576",0,0,0,0,"dummy"
"239577",0,2,0,2,"dummy"
"239578",0,3,0,3,"dummy"
"239579",0,0,0,0,"dummy"
"239580",0,0,0,0,"dummy"
"239581",0,0,1,1,"dummy"
"239582",0,2,0,2,"dummy"
"239583",0,0,0,0,"dummy"
"239584",0,0,0,0,"dummy"
"239585",0,0,0,0,"dummy"
"239586",0,0,1,1,"dummy"
"239589",0,0,1,1,"dummy"
"239590",0,0,0,0,"dummy"
"239593",0,5,0,5,"dummy"
"239596",0,0,0,0,"dummy"
"239597",0,0,0,0,"dummy"
"239598",0,0,0,0,"dummy"
"239600",0,0,1,1,"dummy"
"239601",0,0,1,1,"dummy"
"239602",0,0,2,2,"dummy"
"239603",0,0,2,2,"dummy"
"239604",0,2,2,4,"dummy"
"239606",0,0,1,1,"dummy"
"239610",1,0,0,1,"dummy"
"239611",0,0,1,1,"dummy"
"239612",0,0,1,1,"dummy"
"239613",0,1,0,1,"dummy"
"239614",0,1,0,1,"dummy"
"239615",1,0,0,1,"dummy"
"239616",0,0,1,1,"dummy"
"239617",24,35,4,63,"dummy"
"239618",27,7,3,37,"dummy"
"239619",0,0,1,1,"dummy"
"239620",1,0,0,1,"dummy"
"239621",1,2,1,4,"dummy"
"239622",0,11,0,11,"dummy"
"239623",4,3,0,7,"dummy"
"239624",6,8,4,18,"dummy"
"239625",0,1,0,1,"dummy"
"239626",0,1,0,1,"dummy"
"239627",1,0,0,1,"dummy"
"239628",0,2,0,2,"dummy"
"239629",0,0,1,1,"dummy"
"239630",3,4,0,7,"dummy"
"239631",0,1,0,1,"dummy"
"239632",4,3,0,7,"dummy"
"239633",3,3,1,7,"dummy"
"239634",4,4,0,8,"dummy"
"239635",1,0,0,1,"dummy"
"239636",0,0,1,1,"dummy"
"239637",0,0,1,1,"dummy"
"239638",0,4,0,4,"dummy"
"239639",0,0,0,0,"dummy"
"239640",0,5,0,5,"dummy"
"239641",0,1,0,1,"dummy"
"239643",0,2,2,4,"dummy"
"239644",1,0,0,1,"dummy"
"239647",0,1,0,1,"dummy"
"239648",0,0,1,1,"dummy"
"239649",1,7,0,8,"dummy"
"239650",2,0,1,3,"dummy"
"239651",0,1,0,1,"dummy"
"239652",0,1,0,1,"dummy"
"239653",0,1,0,1,"dummy"
"239654",1,2,0,3,"dummy"
"239655",0,1,0,1,"dummy"
"239656",9,6,8,23,"dummy"
"239657",6,17,7,30,"dummy"
"239658",9,6,8,23,"dummy"
"239662",0,0,0,0,"dummy"
"239666",0,0,3,3,"dummy"
"239667",0,0,1,1,"dummy"
"239668",0,1,1,2,"dummy"
"239669",0,0,1,1,"dummy"
"239670",0,6,0,6,"dummy"
"239671",7,7,1,15,"dummy"
"239672",0,0,1,1,"dummy"
"239673",0,0,1,1,"dummy"
"239674",0,1,1,2,"dummy"
"239675",1,2,1,4,"dummy"
"239681",0,1,0,1,"dummy"
"239683",0,0,1,1,"dummy"
"239685",0,1,0,1,"dummy"
"239686",0,2,0,2,"dummy"
"239687",0,0,1,1,"dummy"
"239688",1,0,1,2,"dummy"
"239689",0,0,1,1,"dummy"
"239690",0,0,1,1,"dummy"
"239692",2,2,0,4,"dummy"
"239699",0,0,1,1,"dummy"
"239701",0,1,0,1,"dummy"
"239703",3,3,0,6,"dummy"
"239704",5,5,2,12,"dummy"
"239705",0,0,1,1,"dummy"
"239706",0,0,1,1,"dummy"
"239707",0,0,1,1,"dummy"
"239708",0,0,1,1,"dummy"
"239709",0,0,1,1,"dummy"
"239711",0,0,1,1,"dummy"
"239713",0,0,1,1,"dummy"
"239715",0,0,0,0,"dummy"
"239716",0,0,0,0,"dummy"
"239717",0,1,0,1,"dummy"
"239760",1,2,0,3,"dummy"
"239763",0,1,0,1,"dummy"
"239764",0,0,2,2,"dummy"
"239765",0,0,1,1,"dummy"
"239770",0,1,0,1,"dummy"
"239772",1,1,0,2,"dummy"
"239773",0,0,0,0,"dummy"
"239774",0,1,0,1,"dummy"
"239775",1,5,0,6,"dummy"
"239791",0,0,0,0,"dummy"
"239792",0,0,1,1,"dummy"
"239793",0,0,0,0,"dummy"
"239794",0,0,0,0,"dummy"
"239795",0,0,0,0,"dummy"
"239796",0,0,0,0,"dummy"
"239797",0,0,0,0,"dummy"
"239798",0,0,0,0,"dummy"
"239799",0,0,0,0,"dummy"
"239800",0,1,0,1,"dummy"
"239801",0,0,0,0,"dummy"
"239802",0,0,0,0,"dummy"
"239803",0,0,0,0,"dummy"
"239804",0,0,0,0,"dummy"
"239805",0,0,0,0,"dummy"
"239806",0,0,1,1,"dummy"
"239810",0,0,0,0,"dummy"
"239811",25,0,3,28,"dummy"
"239813",0,1,0,1,"dummy"
"239814",1,0,0,1,"dummy"
"239815",0,1,0,1,"dummy"
"239817",0,1,0,1,"dummy"
"239820",2,16,3,21,"dummy"
"239821",0,0,1,1,"dummy"
"239822",0,1,0,1,"dummy"
"239823",0,0,1,1,"dummy"
"239824",0,0,1,1,"dummy"
"239826",3,1,1,5,"dummy"
"239827",0,0,0,0,"dummy"
"239830",0,1,0,1,"dummy"
"239831",2,3,0,5,"dummy"
"239833",6,0,0,6,"dummy"
"239834",2,5,2,9,"dummy"
"239837",2,1,1,4,"dummy"
"239838",0,2,0,2,"dummy"
"239839",1,0,0,1,"dummy"
"239843",0,0,0,0,"dummy"
"239844",0,0,0,0,"dummy"
"239845",0,0,0,0,"dummy"
"239846",0,0,0,0,"dummy"
"239847",0,0,0,0,"dummy"
"239848",0,0,0,0,"dummy"
"239849",0,0,0,0,"dummy"
"239852",0,0,0,0,"dummy"
"239855",1,7,3,11,"dummy"
"239856",7,5,1,13,"dummy"
"239857",1,0,0,1,"dummy"
"239862",0,0,1,1,"dummy"
"239863",0,0,1,1,"dummy"
"239864",0,0,2,2,"dummy"
"239865",26,3,7,36,"dummy"
"239867",0,2,0,2,"dummy"
"239869",0,2,0,2,"dummy"
"239870",4,0,0,4,"dummy"
"239871",0,6,0,6,"dummy"
"239872",2,1,3,6,"dummy"
"239873",0,0,0,0,"dummy"
"239874",9,9,0,18,"dummy"
"239875",0,2,0,2,"dummy"
"239876",2,2,0,4,"dummy"
"239878",0,1,0,1,"dummy"
"239880",0,0,0,0,"dummy"
"239893",0,0,0,0,"dummy"
"239894",0,0,0,0,"dummy"
"239895",0,0,0,0,"dummy"
"239896",0,0,0,0,"dummy"
"239897",0,0,2,2,"dummy"
"239899",1,0,1,2,"dummy"
"239901",0,0,1,1,"dummy"
"239903",1,0,0,1,"dummy"
"239904",0,0,0,0,"dummy"
"239905",0,0,0,0,"dummy"
"239906",0,0,1,1,"dummy"
"239907",0,0,0,0,"dummy"
"239908",0,0,1,1,"dummy"
"239909",1,4,1,6,"dummy"
"239910",0,0,0,0,"dummy"
"239911",0,0,0,0,"dummy"
"239912",0,1,1,2,"dummy"
"239913",0,0,1,1,"dummy"
"239914",0,0,0,0,"dummy"
"239915",0,0,1,1,"dummy"
"239916",0,0,1,1,"dummy"
"239917",4,2,1,7,"dummy"
"239918",0,0,2,2,"dummy"
"239919",7,1,1,9,"dummy"
"239920",1,1,0,2,"dummy"
"239921",1,1,0,2,"dummy"
"239922",2,0,2,4,"dummy"
"239923",0,0,0,0,"dummy"
"239924",0,0,2,2,"dummy"
"239925",0,0,0,0,"dummy"
"239926",0,0,0,0,"dummy"
"239927",0,0,0,0,"dummy"
"239928",0,1,0,1,"dummy"
"239929",0,0,0,0,"dummy"
"239930",0,0,0,0,"dummy"
"239931",0,0,0,0,"dummy"
"239932",0,0,0,0,"dummy"
"239933",0,0,0,0,"dummy"
"239934",0,0,0,0,"dummy"
"239935",0,0,4,4,"dummy"
"239936",0,0,1,1,"dummy"
"239937",0,0,0,0,"dummy"
"239938",0,0,0,0,"dummy"
"239939",0,0,0,0,"dummy"
"239940",0,0,1,1,"dummy"
"239941",3,4,5,12,"dummy"
"239942",0,0,0,0,"dummy"
"239943",1,1,0,2,"dummy"
"239944",2,2,3,7,"dummy"
"239945",0,0,0,0,"dummy"
"239946",0,0,1,1,"dummy"
"239949",0,0,1,1,"dummy"
"239950",3,0,1,4,"dummy"
"239951",0,1,0,1,"dummy"
"239952",0,0,1,1,"dummy"
"239975",1,0,0,1,"dummy"
"239979",0,1,0,1,"dummy"
"239981",0,0,1,1,"dummy"
"239983",5,0,2,7,"dummy"
"239988",0,0,1,1,"dummy"
"239991",1,0,0,1,"dummy"
"239995",0,0,1,1,"dummy"
"239996",0,0,1,1,"dummy"
"239997",0,0,2,2,"dummy"
"239998",26,3,7,36,"dummy"
"240003",0,4,0,4,"dummy"
"240004",0,0,1,1,"dummy"
"240005",0,0,1,1,"dummy"
"240006",0,1,1,2,"dummy"
"240007",0,0,1,1,"dummy"
"240008",0,0,1,1,"dummy"
"240009",0,1,0,1,"dummy"
"240010",0,1,0,1,"dummy"
"240015",0,1,0,1,"dummy"
"240016",0,0,1,1,"dummy"
"240019",0,24,0,24,"dummy"
"240020",0,1,0,1,"dummy"
"240021",0,0,1,1,"dummy"
"240022",0,0,1,1,"dummy"
"240023",0,0,0,0,"dummy"
"240024",0,0,0,0,"dummy"
"240025",0,0,1,1,"dummy"
"240027",5,1,0,6,"dummy"
"240028",0,0,1,1,"dummy"
"240030",2,3,0,5,"dummy"
"240031",10,1,3,14,"dummy"
"240050",0,0,2,2,"dummy"
"240051",0,2,2,4,"dummy"
"240053",0,0,1,1,"dummy"
"240059",0,0,1,1,"dummy"
"240060",0,0,0,0,"dummy"
"240064",0,1,1,2,"dummy"
"240066",0,0,2,2,"dummy"
"240070",0,2,0,2,"dummy"
"240071",0,0,0,0,"dummy"
"240073",8,12,0,20,"dummy"
"240074",17,0,5,22,"dummy"
"240078",0,0,0,0,"dummy"
"240082",0,0,1,1,"dummy"
"240083",1,0,1,2,"dummy"
"240084",0,0,0,0,"dummy"
"240086",0,1,1,2,"dummy"
"240087",0,1,0,1,"dummy"
"240090",1,2,2,5,"dummy"
"240091",2,6,1,9,"dummy"
"240092",0,1,0,1,"dummy"
"240119",1,0,0,1,"dummy"
"240121",1,0,0,1,"dummy"
"240122",0,0,1,1,"dummy"
"240123",4,4,0,8,"dummy"
"240124",0,2,0,2,"dummy"
"240127",0,1,0,1,"dummy"
"240128",4,5,0,9,"dummy"
"240129",4,6,0,10,"dummy"
"240132",0,0,1,1,"dummy"
"240137",1,3,0,4,"dummy"
"240138",0,0,0,0,"dummy"
"240139",0,1,0,1,"dummy"
"240140",0,0,0,0,"dummy"
"240143",0,0,2,2,"dummy"
"240144",3,0,1,4,"dummy"
"240145",0,2,0,2,"dummy"
"240148",0,4,1,5,"dummy"
"240149",2,1,1,4,"dummy"
"240151",3,1,5,9,"dummy"
"240152",0,2,0,2,"dummy"
"240153",2,0,0,2,"dummy"
"240154",1,1,0,2,"dummy"
"240156",0,0,3,3,"dummy"
"240160",1,1,1,3,"dummy"
"240163",0,2,1,3,"dummy"
"240170",0,1,0,1,"dummy"
"240171",0,1,0,1,"dummy"
"240172",2,2,0,4,"dummy"
"240173",0,1,1,2,"dummy"
"240174",0,0,1,1,"dummy"
"240176",0,0,1,1,"dummy"
"240177",0,2,0,2,"dummy"
"240178",1,5,0,6,"dummy"
"240179",1,2,0,3,"dummy"
"240180",0,3,1,4,"dummy"
"240185",0,0,0,0,"dummy"
"240188",0,0,1,1,"dummy"
"240189",0,1,0,1,"dummy"
"240190",0,0,1,1,"dummy"
"240193",0,9,0,9,"dummy"
"240194",5,1,0,6,"dummy"
"240195",2,2,1,5,"dummy"
"240197",0,4,0,4,"dummy"
"240199",0,2,1,3,"dummy"
"240203",0,3,0,3,"dummy"
"240205",0,1,0,1,"dummy"
"240207",0,12,1,13,"dummy"
"240208",4,5,2,11,"dummy"
"240210",0,0,0,0,"dummy"
"240212",0,0,2,2,"dummy"
"240215",0,0,1,1,"dummy"
"240218",2,2,0,4,"dummy"
"240219",0,1,0,1,"dummy"
"240220",12,0,1,13,"dummy"
"240221",0,2,0,2,"dummy"
"240222",0,9,1,10,"dummy"
"240223",0,13,0,13,"dummy"
"240224",0,1,0,1,"dummy"
"240273",0,1,0,1,"dummy"
"240276",6,16,2,24,"dummy"
"240278",2,0,3,5,"dummy"
"240280",8,14,4,26,"dummy"
"240281",5,6,2,13,"dummy"
"240282",0,5,0,5,"dummy"
"240283",47,15,8,70,"dummy"
"240284",0,0,0,0,"dummy"
"240285",17,17,4,38,"dummy"
"240286",0,2,0,2,"dummy"
"240287",2,0,0,2,"dummy"
"240288",0,0,0,0,"dummy"
"240289",0,0,0,0,"dummy"
"240290",0,0,0,0,"dummy"
"240291",0,0,1,1,"dummy"
"240292",0,2,0,2,"dummy"
"240293",2,0,0,2,"dummy"
"240294",0,0,1,1,"dummy"
"240296",0,1,0,1,"dummy"
"240297",4,7,0,11,"dummy"
"240300",0,0,2,2,"dummy"
"240305",1,0,0,1,"dummy"
"240313",6,0,0,6,"dummy"
"240314",2,5,2,9,"dummy"
"240316",0,1,0,1,"dummy"
"240317",0,0,1,1,"dummy"
"240318",0,0,0,0,"dummy"
"240319",0,2,0,2,"dummy"
"240320",0,0,1,1,"dummy"
"240321",0,4,0,4,"dummy"
"240347",0,1,1,2,"dummy"
"240348",2,2,0,4,"dummy"
"240349",4,0,0,4,"dummy"
"240367",1,1,1,3,"dummy"
"240368",1,1,1,3,"dummy"
"240383",0,0,4,4,"dummy"
"240390",1,2,0,3,"dummy"
"240397",0,7,0,7,"dummy"
"240401",0,1,1,2,"dummy"
"240402",0,2,0,2,"dummy"
"240428",1,0,0,1,"dummy"
"240429",0,0,0,0,"dummy"
"240430",2,1,6,9,"dummy"
"240441",0,2,0,2,"dummy"
"240466",0,1,0,1,"dummy"
"240467",0,1,1,2,"dummy"
"240468",0,4,0,4,"dummy"
"240475",0,0,1,1,"dummy"
"240476",2,0,0,2,"dummy"
"240477",0,0,1,1,"dummy"
"240478",0,0,0,0,"dummy"
"240479",0,1,2,3,"dummy"
"240480",1,0,0,1,"dummy"
"240481",0,0,1,1,"dummy"
"240482",2,0,0,2,"dummy"
"240483",0,0,1,1,"dummy"
"240484",0,1,0,1,"dummy"
"240485",0,2,0,2,"dummy"
"240498",1,1,1,3,"dummy"
"240499",2,0,1,3,"dummy"
"240500",0,7,0,7,"dummy"
"240501",0,1,0,1,"dummy"
"240502",1,0,0,1,"dummy"
"240503",0,0,3,3,"dummy"
"240504",0,0,3,3,"dummy"
"240505",0,0,1,1,"dummy"
"240506",2,4,5,11,"dummy"
"240507",0,0,0,0,"dummy"
"240508",0,0,1,1,"dummy"
"240509",0,0,3,3,"dummy"
"240510",0,0,3,3,"dummy"
"240511",1,1,0,2,"dummy"
"240512",0,0,3,3,"dummy"
"240513",0,0,3,3,"dummy"
"240537",1,0,0,1,"dummy"
"240538",0,1,0,1,"dummy"
"240539",0,1,0,1,"dummy"
"240540",0,1,0,1,"dummy"
"240541",0,4,0,4,"dummy"
"240542",0,0,0,0,"dummy"
"240543",0,4,0,4,"dummy"
"240544",8,0,0,8,"dummy"
"240545",0,1,0,1,"dummy"
"240546",0,4,1,5,"dummy"
"240547",1,0,0,1,"dummy"
"240548",3,0,0,3,"dummy"
"240549",0,0,0,0,"dummy"
"240550",0,2,0,2,"dummy"
"240551",2,0,0,2,"dummy"
"240555",0,0,1,1,"dummy"
"240558",0,2,1,3,"dummy"
"240572",0,1,0,1,"dummy"
"240573",1,0,0,1,"dummy"
"240574",0,1,0,1,"dummy"
"240323",13,4,3,20,"dummy"
"240324",1,3,4,8,"dummy"
"240325",3,0,0,3,"dummy"
"240326",0,0,1,1,"dummy"
"240327",0,1,3,4,"dummy"
"240351",1,1,1,3,"dummy"
"240354",0,0,0,0,"dummy"
"240357",0,2,0,2,"dummy"
"240358",0,1,0,1,"dummy"
"240359",0,1,0,1,"dummy"
"240360",0,3,0,3,"dummy"
"240361",0,0,2,2,"dummy"
"240362",8,8,4,20,"dummy"
"240363",4,0,0,4,"dummy"
"240370",0,0,1,1,"dummy"
"240371",1,7,3,11,"dummy"
"240372",0,0,1,1,"dummy"
"240373",2,4,3,9,"dummy"
"240374",2,0,1,3,"dummy"
"240375",0,0,1,1,"dummy"
"240376",0,0,1,1,"dummy"
"240377",0,0,1,1,"dummy"
"240378",0,0,1,1,"dummy"
"240379",0,0,1,1,"dummy"
"240380",0,0,1,1,"dummy"
"240381",0,0,1,1,"dummy"
"240385",0,0,1,1,"dummy"
"240386",0,0,1,1,"dummy"
"240387",0,0,2,2,"dummy"
"240388",26,3,7,36,"dummy"
"240406",0,0,0,0,"dummy"
"240407",1,0,0,1,"dummy"
"240408",1,1,0,2,"dummy"
"240413",0,0,0,0,"dummy"
"240422",2,4,0,6,"dummy"
"240423",0,2,0,2,"dummy"
"240424",0,2,0,2,"dummy"
"240425",10,2,0,12,"dummy"
"240426",0,2,0,2,"dummy"
"240436",0,4,0,4,"dummy"
"240439",27,4,3,34,"dummy"
"240443",0,1,0,1,"dummy"
"240444",0,1,0,1,"dummy"
"240445",1,0,0,1,"dummy"
"240446",0,1,0,1,"dummy"
"240447",0,1,0,1,"dummy"
"240448",0,1,0,1,"dummy"
"240449",0,1,0,1,"dummy"
"240450",0,0,1,1,"dummy"
"240451",1,1,0,2,"dummy"
"240452",0,0,1,1,"dummy"
"240453",0,0,1,1,"dummy"
"240454",1,0,0,1,"dummy"
"240455",6,0,2,8,"dummy"
"240456",0,3,0,3,"dummy"
"240457",0,1,0,1,"dummy"
"240460",0,1,0,1,"dummy"
"240461",0,0,1,1,"dummy"
"240462",9,42,2,53,"dummy"
"240489",0,1,0,1,"dummy"
"240490",0,2,0,2,"dummy"
"240491",5,1,2,8,"dummy"
"240492",0,0,0,0,"dummy"
"240493",1,0,0,1,"dummy"
"240494",0,0,0,0,"dummy"
"240495",0,0,1,1,"dummy"
"240496",0,1,1,2,"dummy"
"240515",6,1,0,7,"dummy"
"240516",0,13,1,14,"dummy"
"240517",1,1,0,2,"dummy"
"240533",5,1,3,9,"dummy"
"240534",0,2,0,2,"dummy"
"240535",2,19,6,27,"dummy"
"240553",0,1,2,3,"dummy"
"240576",0,0,1,1,"dummy"
"240583",6,0,0,6,"dummy"
"240584",2,5,2,9,"dummy"
"240610",0,0,0,0,"dummy"
"240626",0,0,0,0,"dummy"
"240635",0,0,0,0,"dummy"
"240636",0,0,0,0,"dummy"
"240696",1,3,0,4,"dummy"
"240697",0,0,0,0,"dummy"
"240698",0,0,4,4,"dummy"
"240699",0,0,4,4,"dummy"
"240722",0,0,4,4,"dummy"
"240723",0,0,4,4,"dummy"
"240724",0,0,4,4,"dummy"
"240725",0,0,4,4,"dummy"
"240726",0,2,0,2,"dummy"
"240727",2,2,3,7,"dummy"
"240728",0,1,0,1,"dummy"
"240729",0,0,3,3,"dummy"
"240730",0,0,3,3,"dummy"
"240731",0,13,0,13,"dummy"
"240732",0,1,3,4,"dummy"
"240733",0,0,3,3,"dummy"
"240734",0,1,1,2,"dummy"
"240735",0,0,3,3,"dummy"
"240739",0,0,1,1,"dummy"
"240743",10,14,2,26,"dummy"
"240744",32,9,2,43,"dummy"
"240745",0,1,0,1,"dummy"
"240746",29,38,1,68,"dummy"
"240794",0,0,1,1,"dummy"
"240819",0,1,2,3,"dummy"
"240824",14,16,2,32,"dummy"
"240829",0,0,0,0,"dummy"
"240830",0,0,0,0,"dummy"
"240831",0,0,0,0,"dummy"
"240832",0,0,0,0,"dummy"
"240833",0,0,0,0,"dummy"
"240834",0,0,0,0,"dummy"
"240835",0,0,1,1,"dummy"
"240836",0,0,0,0,"dummy"
"240837",0,0,1,1,"dummy"
"240838",0,0,1,1,"dummy"
"240839",0,0,0,0,"dummy"
"240840",0,0,0,0,"dummy"
"240841",0,1,0,1,"dummy"
"240842",0,0,1,1,"dummy"
"240848",0,3,0,3,"dummy"
"240578",0,0,1,1,"dummy"
"240579",6,0,1,7,"dummy"
"240612",0,0,0,0,"dummy"
"240613",5,0,0,5,"dummy"
"240614",0,1,0,1,"dummy"
"240615",0,2,0,2,"dummy"
"240616",1,0,0,1,"dummy"
"240619",3,1,0,4,"dummy"
"240620",0,3,0,3,"dummy"
"240621",0,3,0,3,"dummy"
"240622",0,1,0,1,"dummy"
"240623",3,1,0,4,"dummy"
"240624",1,1,0,2,"dummy"
"240638",4,1,1,6,"dummy"
"240643",3,3,0,6,"dummy"
"240644",3,7,0,10,"dummy"
"240645",1,1,0,2,"dummy"
"240646",1,1,0,2,"dummy"
"240657",1,1,1,3,"dummy"
"240664",0,2,1,3,"dummy"
"240667",2,0,0,2,"dummy"
"240691",8,1,1,10,"dummy"
"240692",0,0,1,1,"dummy"
"240693",0,1,0,1,"dummy"
"240694",0,0,1,1,"dummy"
"240703",1,3,4,8,"dummy"
"240704",3,0,0,3,"dummy"
"240711",0,1,1,2,"dummy"
"240714",1,9,0,10,"dummy"
"240715",0,4,0,4,"dummy"
"240716",0,2,1,3,"dummy"
"240717",0,0,0,0,"dummy"
"240718",1,0,0,1,"dummy"
"240719",0,3,0,3,"dummy"
"240720",0,2,2,4,"dummy"
"240737",1,1,0,2,"dummy"
"240741",9,9,1,19,"dummy"
"240751",0,3,2,5,"dummy"
"240752",0,0,0,0,"dummy"
"240753",0,4,0,4,"dummy"
"240754",0,1,0,1,"dummy"
"240757",16,5,1,22,"dummy"
"240770",0,0,0,0,"dummy"
"240798",0,0,0,0,"dummy"
"240799",0,0,0,0,"dummy"
"240800",9,7,4,20,"dummy"
"240801",0,0,1,1,"dummy"
"240802",0,0,1,1,"dummy"
"240803",0,0,0,0,"dummy"
"240804",0,0,2,2,"dummy"
"240821",0,0,2,2,"dummy"
"240822",0,3,1,4,"dummy"
"240858",0,0,1,1,"dummy"
"240861",1,9,0,10,"dummy"
"240872",0,0,0,0,"dummy"
"240873",0,2,1,3,"dummy"
"240874",6,3,0,9,"dummy"
"240875",0,0,0,0,"dummy"
"240876",0,0,0,0,"dummy"
"240877",0,0,0,0,"dummy"
"240878",0,0,1,1,"dummy"
"240879",0,0,0,0,"dummy"
"240849",0,0,3,3,"dummy"
"240850",0,0,1,1,"dummy"
"240863",1,0,1,2,"dummy"
"240864",0,0,1,1,"dummy"
"240865",0,1,1,2,"dummy"
"240866",6,6,4,16,"dummy"
"240867",0,0,2,2,"dummy"
"240870",1,1,0,2,"dummy"
"240881",1,2,1,4,"dummy"
"240882",0,1,0,1,"dummy"
"240909",0,1,0,1,"dummy"
"240910",0,0,1,1,"dummy"
"240911",0,2,0,2,"dummy"
"240912",0,0,1,1,"dummy"
"240913",0,1,1,2,"dummy"
"240918",0,0,1,1,"dummy"
"240922",0,3,0,3,"dummy"
"240923",0,0,1,1,"dummy"
"240924",0,1,1,2,"dummy"
"240925",0,2,1,3,"dummy"
"240926",0,1,1,2,"dummy"
"240927",3,1,2,6,"dummy"
"240928",3,1,0,4,"dummy"
"240929",1,0,1,2,"dummy"
"240930",0,0,1,1,"dummy"
"240931",0,0,0,0,"dummy"
"240932",0,3,0,3,"dummy"
"240933",0,0,2,2,"dummy"
"240934",5,6,5,16,"dummy"
"240935",0,0,2,2,"dummy"
"240936",0,0,0,0,"dummy"
"240937",0,0,1,1,"dummy"
"240944",5,0,0,5,"dummy"
"240968",2,3,0,5,"dummy"
"240969",1,3,0,4,"dummy"
"240970",0,1,0,1,"dummy"
"240971",3,1,0,4,"dummy"
"240972",5,1,0,6,"dummy"
"240975",15,32,0,47,"dummy"
"240997",0,0,4,4,"dummy"
"240998",2,0,0,2,"dummy"
"240999",0,2,0,2,"dummy"
"241000",0,0,2,2,"dummy"
"241001",0,0,1,1,"dummy"
"241002",5,6,3,14,"dummy"
"241003",0,0,1,1,"dummy"
"241004",0,1,0,1,"dummy"
"241005",2,0,0,2,"dummy"
"241006",0,2,0,2,"dummy"
"240884",2,1,0,3,"dummy"
"240885",2,2,3,7,"dummy"
"240886",2,2,3,7,"dummy"
"240887",2,2,3,7,"dummy"
"240888",3,3,2,8,"dummy"
"240889",0,0,1,1,"dummy"
"240890",0,0,1,1,"dummy"
"240891",0,0,1,1,"dummy"
"240894",2,2,0,4,"dummy"
"240905",0,0,1,1,"dummy"
"240906",0,0,1,1,"dummy"
"240907",0,1,0,1,"dummy"
"240915",0,0,3,3,"dummy"
"240916",9,9,2,20,"dummy"
"240920",0,0,2,2,"dummy"
"240939",1,0,0,1,"dummy"
"240940",0,1,0,1,"dummy"
"240941",0,3,0,3,"dummy"
"240942",0,2,0,2,"dummy"
"240948",0,0,0,0,"dummy"
"240949",1,0,0,1,"dummy"
"240950",0,0,1,1,"dummy"
"240951",2,0,0,2,"dummy"
"240952",0,0,1,1,"dummy"
"240953",0,0,1,1,"dummy"
"240954",0,2,0,2,"dummy"
"240955",0,1,0,1,"dummy"
"240956",0,3,0,3,"dummy"
"240957",3,0,1,4,"dummy"
"240958",0,3,0,3,"dummy"
"240959",0,0,0,0,"dummy"
"240960",0,0,0,0,"dummy"
"240961",10,0,0,10,"dummy"
"240962",0,0,0,0,"dummy"
"240963",0,0,0,0,"dummy"
"240966",0,0,1,1,"dummy"
"240977",0,2,0,2,"dummy"
"240978",0,0,1,1,"dummy"
"240979",0,1,2,3,"dummy"
"240980",5,11,12,28,"dummy"
"240981",0,0,2,2,"dummy"
"240984",0,0,0,0,"dummy"
"241012",0,1,0,1,"dummy"
"241013",0,0,0,0,"dummy"
"241018",0,0,0,0,"dummy"
"241020",0,0,0,0,"dummy"
"241022",0,1,2,3,"dummy"
"241023",1,0,2,3,"dummy"
"241024",0,0,1,1,"dummy"
"241025",0,0,1,1,"dummy"
"241026",0,0,1,1,"dummy"
"241028",4,2,1,7,"dummy"
"241037",0,3,0,3,"dummy"
"241038",2,3,1,6,"dummy"
"241039",0,1,0,1,"dummy"
"241040",0,1,0,1,"dummy"
"241041",0,0,1,1,"dummy"
"241044",0,1,0,1,"dummy"
"241046",0,0,2,2,"dummy"
"241047",0,0,1,1,"dummy"
"241048",1,27,2,30,"dummy"
"241049",6,11,0,17,"dummy"
"241050",0,1,0,1,"dummy"
"241051",0,3,0,3,"dummy"
"241052",7,25,0,32,"dummy"
"241053",3,6,0,9,"dummy"
"241054",28,5,1,34,"dummy"
"241055",1,1,0,2,"dummy"
"241056",14,7,5,26,"dummy"
"241057",1,2,1,4,"dummy"
"241060",0,0,1,1,"dummy"
"241061",0,1,0,1,"dummy"
"241062",0,1,0,1,"dummy"
"241063",0,0,1,1,"dummy"
"241064",0,0,1,1,"dummy"
"241065",0,0,1,1,"dummy"
"241068",0,0,0,0,"dummy"
"241070",4,7,0,11,"dummy"
"241071",0,0,1,1,"dummy"
"241073",0,0,1,1,"dummy"
"241076",0,0,1,1,"dummy"
"241077",0,2,0,2,"dummy"
"241078",0,4,0,4,"dummy"
"241079",3,4,1,8,"dummy"
"241082",4,16,2,22,"dummy"
"241096",0,0,2,2,"dummy"
"241097",4,0,3,7,"dummy"
"241098",1,0,0,1,"dummy"
"241099",0,1,0,1,"dummy"
"241100",0,3,3,6,"dummy"
"241103",0,0,1,1,"dummy"
"241104",14,8,4,26,"dummy"
"241105",0,0,0,0,"dummy"
"241106",2,2,0,4,"dummy"
"241107",6,3,0,9,"dummy"
"241108",0,0,1,1,"dummy"
"241109",0,2,0,2,"dummy"
"241110",0,0,1,1,"dummy"
"241111",2,0,0,2,"dummy"
"241112",0,0,2,2,"dummy"
"241113",0,0,1,1,"dummy"
"241114",0,0,1,1,"dummy"
"241115",0,0,1,1,"dummy"
"241116",0,0,1,1,"dummy"
"241117",0,1,0,1,"dummy"
"241118",0,0,1,1,"dummy"
"241119",0,0,1,1,"dummy"
"241120",8,8,1,17,"dummy"
"241122",0,1,1,2,"dummy"
"241125",7,22,3,32,"dummy"
"241126",0,4,0,4,"dummy"
"241127",0,1,0,1,"dummy"
"241128",0,0,1,1,"dummy"
"241129",0,1,0,1,"dummy"
"241130",0,1,0,1,"dummy"
"241140",0,0,2,2,"dummy"
"241146",3,6,0,9,"dummy"
"241147",0,1,0,1,"dummy"
"241150",7,4,0,11,"dummy"
"241152",0,2,1,3,"dummy"
"241153",0,2,0,2,"dummy"
"241155",1,5,4,10,"dummy"
"241156",0,0,1,1,"dummy"
"241157",0,1,0,1,"dummy"
"241164",3,20,0,23,"dummy"
"241167",0,1,0,1,"dummy"
"241168",8,5,3,16,"dummy"
"241169",0,6,0,6,"dummy"
"241170",0,1,0,1,"dummy"
"241171",0,2,0,2,"dummy"
"241172",3,0,0,3,"dummy"
"241173",0,1,0,1,"dummy"
"241174",0,1,1,2,"dummy"
"241175",0,0,3,3,"dummy"
"241176",0,0,3,3,"dummy"
"241177",0,0,1,1,"dummy"
"241193",4,2,0,6,"dummy"
"241194",1,1,1,3,"dummy"
"241219",0,0,1,1,"dummy"
"241220",0,0,1,1,"dummy"
"241221",0,0,1,1,"dummy"
"241222",0,0,1,1,"dummy"
"241223",0,0,1,1,"dummy"
"241224",0,0,1,1,"dummy"
"241225",0,0,1,1,"dummy"
"241226",0,0,1,1,"dummy"
"241227",0,0,0,0,"dummy"
"241228",0,0,1,1,"dummy"
"241229",0,0,1,1,"dummy"
"241230",0,0,1,1,"dummy"
"241231",0,0,0,0,"dummy"
"241232",0,0,1,1,"dummy"
"241233",0,0,1,1,"dummy"
"241234",0,0,1,1,"dummy"
"241235",0,0,1,1,"dummy"
"241236",0,0,1,1,"dummy"
"241237",0,0,1,1,"dummy"
"241238",0,0,1,1,"dummy"
"241239",0,0,1,1,"dummy"
"241240",0,0,1,1,"dummy"
"241241",0,0,1,1,"dummy"
"241243",0,0,1,1,"dummy"
"241244",0,2,0,2,"dummy"
"241245",1,0,0,1,"dummy"
"241246",0,2,0,2,"dummy"
"241248",0,0,0,0,"dummy"
"241249",0,0,0,0,"dummy"
"241250",0,0,0,0,"dummy"
"241251",0,0,1,1,"dummy"
"241252",0,0,1,1,"dummy"
"241255",0,1,0,1,"dummy"
"241257",0,1,0,1,"dummy"
"241259",0,0,1,1,"dummy"
"241260",0,0,1,1,"dummy"
"241261",0,0,0,0,"dummy"
"241262",0,1,0,1,"dummy"
"241265",0,0,1,1,"dummy"
"241266",0,7,0,7,"dummy"
"241269",0,5,0,5,"dummy"
"241270",0,0,1,1,"dummy"
"241271",1,0,0,1,"dummy"
"241272",0,2,0,2,"dummy"
"241273",0,1,0,1,"dummy"
"241274",0,2,0,2,"dummy"
"241275",21,0,0,21,"dummy"
"241276",4,4,0,8,"dummy"
"241280",0,2,2,4,"dummy"
"241281",0,0,1,1,"dummy"
"241282",0,6,1,7,"dummy"
"241286",0,1,2,3,"dummy"
"241289",0,5,0,5,"dummy"
"241294",0,2,1,3,"dummy"
"241295",0,1,0,1,"dummy"
"241296",0,0,1,1,"dummy"
"241297",0,0,1,1,"dummy"
"241298",6,0,1,7,"dummy"
"241299",0,0,1,1,"dummy"
"241300",0,0,1,1,"dummy"
"241301",0,0,1,1,"dummy"
"241302",0,0,1,1,"dummy"
"241303",0,0,1,1,"dummy"
"241304",0,0,1,1,"dummy"
"241305",0,0,1,1,"dummy"
"241306",0,0,1,1,"dummy"
"241307",0,0,1,1,"dummy"
"241316",0,2,0,2,"dummy"
"241317",3,1,1,5,"dummy"
"241318",0,1,0,1,"dummy"
"241319",0,0,2,2,"dummy"
"241320",2,0,2,4,"dummy"
"241321",0,2,0,2,"dummy"
"241322",2,0,0,2,"dummy"
"241323",0,1,0,1,"dummy"
"241324",0,2,0,2,"dummy"
"241325",0,1,0,1,"dummy"
"241326",0,2,0,2,"dummy"
"241327",3,0,0,3,"dummy"
"241328",0,0,1,1,"dummy"
"241329",3,0,0,3,"dummy"
"241330",2,0,0,2,"dummy"
"241346",0,1,1,2,"dummy"
"241347",0,0,1,1,"dummy"
"241348",0,2,0,2,"dummy"
"241349",2,0,0,2,"dummy"
"241350",0,3,1,4,"dummy"
"241353",14,15,4,33,"dummy"
"241356",0,0,2,2,"dummy"
"241367",0,0,2,2,"dummy"
"241368",15,11,2,28,"dummy"
"241369",0,0,0,0,"dummy"
"241370",0,0,1,1,"dummy"
"241371",17,10,0,27,"dummy"
"241377",0,0,1,1,"dummy"
"241378",0,0,0,0,"dummy"
"241379",0,1,0,1,"dummy"
"241380",1,2,0,3,"dummy"
"241381",0,1,0,1,"dummy"
"241382",1,10,1,12,"dummy"
"241383",1,1,0,2,"dummy"
"241384",0,1,0,1,"dummy"
"241385",7,2,0,9,"dummy"
"241386",0,1,0,1,"dummy"
"241387",0,0,1,1,"dummy"
"241388",0,0,2,2,"dummy"
"241389",0,0,1,1,"dummy"
"241402",0,0,0,0,"dummy"
"241403",0,0,0,0,"dummy"
"241427",0,0,1,1,"dummy"
"241428",0,0,0,0,"dummy"
"241464",27,7,1,35,"dummy"
"241465",0,1,0,1,"dummy"
"241466",0,1,0,1,"dummy"
"241467",0,1,0,1,"dummy"
"241470",3,6,0,9,"dummy"
"241471",0,0,1,1,"dummy"
"241481",4,2,0,6,"dummy"
"241482",0,3,0,3,"dummy"
"241483",0,3,0,3,"dummy"
"241484",1,0,0,1,"dummy"
"241491",22,5,2,29,"dummy"
"241492",0,0,1,1,"dummy"
"241493",2,2,0,4,"dummy"
"241494",1,10,0,11,"dummy"
"241498",0,0,1,1,"dummy"
"241499",1,3,2,6,"dummy"
"241500",0,0,1,1,"dummy"
"241501",2,1,0,3,"dummy"
"241502",0,5,0,5,"dummy"
"241503",0,0,0,0,"dummy"
"241504",2,11,1,14,"dummy"
"241505",0,5,0,5,"dummy"
"241506",2,1,0,3,"dummy"
"241507",25,11,1,37,"dummy"
"241508",0,0,0,0,"dummy"
"241509",2,3,0,5,"dummy"
"241510",4,0,0,4,"dummy"
"241530",0,0,1,1,"dummy"
"241531",6,1,0,7,"dummy"
"241561",5,6,3,14,"dummy"
"241562",0,3,1,4,"dummy"
"241565",0,0,1,1,"dummy"
"241566",1,0,0,1,"dummy"
"241574",1,2,0,3,"dummy"
"241575",6,2,1,9,"dummy"
"241576",0,4,1,5,"dummy"
"241332",0,0,0,0,"dummy"
"241333",0,0,1,1,"dummy"
"241336",0,1,0,1,"dummy"
"241337",10,9,2,21,"dummy"
"241338",1,0,0,1,"dummy"
"241339",0,0,1,1,"dummy"
"241340",0,0,0,0,"dummy"
"241341",0,0,1,1,"dummy"
"241344",2,4,1,7,"dummy"
"241362",2,2,2,6,"dummy"
"241363",0,15,0,15,"dummy"
"241364",0,1,1,2,"dummy"
"241365",0,1,0,1,"dummy"
"241373",2,9,3,14,"dummy"
"241374",2,2,2,6,"dummy"
"241375",0,1,0,1,"dummy"
"241397",0,19,0,19,"dummy"
"241398",4,5,1,10,"dummy"
"241399",15,15,3,33,"dummy"
"241400",0,1,1,2,"dummy"
"241405",0,6,0,6,"dummy"
"241412",0,2,0,2,"dummy"
"241413",0,5,0,5,"dummy"
"241414",0,1,0,1,"dummy"
"241415",0,1,0,1,"dummy"
"241416",0,1,0,1,"dummy"
"241417",0,5,0,5,"dummy"
"241418",0,1,0,1,"dummy"
"241421",0,0,1,1,"dummy"
"241422",29,2,1,32,"dummy"
"241423",1,0,0,1,"dummy"
"241436",0,5,1,6,"dummy"
"241445",0,1,0,1,"dummy"
"241446",1,2,0,3,"dummy"
"241447",0,1,0,1,"dummy"
"241448",2,11,2,15,"dummy"
"241449",0,0,1,1,"dummy"
"241450",0,4,0,4,"dummy"
"241451",0,1,0,1,"dummy"
"241452",0,2,0,2,"dummy"
"241453",0,1,0,1,"dummy"
"241454",0,1,0,1,"dummy"
"241455",0,10,0,10,"dummy"
"241456",1,1,1,3,"dummy"
"241457",0,1,0,1,"dummy"
"241460",0,0,1,1,"dummy"
"241475",0,0,1,1,"dummy"
"241476",0,0,3,3,"dummy"
"241477",0,0,2,2,"dummy"
"241486",0,0,0,0,"dummy"
"241487",0,2,0,2,"dummy"
"241488",0,1,0,1,"dummy"
"241489",0,1,0,1,"dummy"
"241496",1,0,1,2,"dummy"
"241512",0,0,1,1,"dummy"
"241515",3,0,0,3,"dummy"
"241516",3,0,0,3,"dummy"
"241517",0,0,0,0,"dummy"
"241518",0,0,1,1,"dummy"
"241519",8,0,0,8,"dummy"
"241526",0,1,0,1,"dummy"
"241527",5,4,0,9,"dummy"
"241528",0,1,0,1,"dummy"
"241533",53,2,0,55,"dummy"
"241534",2,0,0,2,"dummy"
"241535",0,3,1,4,"dummy"
"241536",0,0,0,0,"dummy"
"241537",1,0,0,1,"dummy"
"241538",0,0,4,4,"dummy"
"241539",0,0,1,1,"dummy"
"241540",0,0,3,3,"dummy"
"241541",0,0,1,1,"dummy"
"241542",1,0,0,1,"dummy"
"241547",0,2,2,4,"dummy"
"241548",1,0,0,1,"dummy"
"241551",2,4,0,6,"dummy"
"241552",0,2,0,2,"dummy"
"241553",0,2,0,2,"dummy"
"241554",10,2,0,12,"dummy"
"241555",0,2,0,2,"dummy"
"241556",0,0,0,0,"dummy"
"241557",0,0,3,3,"dummy"
"241558",0,5,0,5,"dummy"
"241559",1,0,1,2,"dummy"
"241570",9,9,1,19,"dummy"
"241571",9,10,1,20,"dummy"
"241572",5,11,0,16,"dummy"
"241583",0,0,1,1,"dummy"
"241599",0,1,2,3,"dummy"
"241600",0,0,0,0,"dummy"
"241601",0,2,0,2,"dummy"
"241602",5,0,2,7,"dummy"
"241603",1,0,0,1,"dummy"
"241673",16,3,4,23,"dummy"
"241676",0,13,0,13,"dummy"
"241677",0,2,0,2,"dummy"
"241684",0,0,1,1,"dummy"
"241755",0,0,1,1,"dummy"
"241756",0,0,0,0,"dummy"
"241775",0,0,5,5,"dummy"
"241776",0,0,1,1,"dummy"
"241777",2,2,1,5,"dummy"
"241778",2,2,1,5,"dummy"
"241786",0,0,2,2,"dummy"
"241787",2,0,0,2,"dummy"
"241788",0,0,1,1,"dummy"
"241789",0,0,1,1,"dummy"
"241790",9,0,0,9,"dummy"
"241795",0,0,1,1,"dummy"
"241798",10,1,1,12,"dummy"
"241834",0,1,0,1,"dummy"
"241875",0,0,1,1,"dummy"
"241876",2,2,0,4,"dummy"
"241877",0,10,0,10,"dummy"
"241878",0,0,1,1,"dummy"
"241879",0,0,1,1,"dummy"
"241889",4,1,0,5,"dummy"
"241890",0,1,0,1,"dummy"
"241891",0,0,1,1,"dummy"
"241892",0,0,1,1,"dummy"
"241893",0,1,1,2,"dummy"
"241894",9,2,1,12,"dummy"
"241895",1,4,0,5,"dummy"
"241896",0,1,0,1,"dummy"
"241897",0,1,1,2,"dummy"
"241921",2,2,2,6,"dummy"
"241922",0,0,1,1,"dummy"
"241925",10,0,2,12,"dummy"
"241926",0,1,1,2,"dummy"
"241927",2,5,2,9,"dummy"
"241928",0,1,0,1,"dummy"
"241934",0,0,1,1,"dummy"
"241941",1,1,0,2,"dummy"
"241942",0,0,0,0,"dummy"
"241943",0,1,1,2,"dummy"
"241944",0,0,1,1,"dummy"
"241579",9,0,0,9,"dummy"
"241585",0,1,0,1,"dummy"
"241586",0,3,0,3,"dummy"
"241587",0,1,0,1,"dummy"
"241588",0,0,1,1,"dummy"
"241589",0,1,0,1,"dummy"
"241590",1,0,0,1,"dummy"
"241591",2,0,0,2,"dummy"
"241594",5,1,0,6,"dummy"
"241595",0,4,0,4,"dummy"
"241596",0,0,0,0,"dummy"
"241597",1,0,0,1,"dummy"
"241679",5,4,0,9,"dummy"
"241680",7,1,1,9,"dummy"
"241681",0,1,0,1,"dummy"
"241682",0,6,1,7,"dummy"
"241686",2,2,5,9,"dummy"
"241687",0,0,1,1,"dummy"
"241688",0,0,1,1,"dummy"
"241689",1,3,0,4,"dummy"
"241690",3,6,0,9,"dummy"
"241691",0,1,0,1,"dummy"
"241692",0,0,1,1,"dummy"
"241693",1,2,0,3,"dummy"
"241694",1,3,2,6,"dummy"
"241695",1,22,0,23,"dummy"
"241696",18,3,0,21,"dummy"
"241697",4,1,0,5,"dummy"
"241700",4,0,0,4,"dummy"
"241701",10,18,2,30,"dummy"
"241702",1,1,0,2,"dummy"
"241703",0,1,0,1,"dummy"
"241704",1,1,1,3,"dummy"
"241705",0,1,0,1,"dummy"
"241706",0,3,0,3,"dummy"
"241707",1,1,1,3,"dummy"
"241708",1,3,2,6,"dummy"
"241709",4,1,0,5,"dummy"
"241710",12,10,0,22,"dummy"
"241711",2,10,3,15,"dummy"
"241712",0,1,0,1,"dummy"
"241713",0,0,1,1,"dummy"
"241714",0,0,0,0,"dummy"
"241715",0,2,0,2,"dummy"
"241716",0,0,1,1,"dummy"
"241717",0,0,0,0,"dummy"
"241718",1,2,0,3,"dummy"
"241719",0,0,1,1,"dummy"
"241758",0,0,0,0,"dummy"
"241759",1,4,1,6,"dummy"
"241760",8,5,3,16,"dummy"
"241761",2,5,2,9,"dummy"
"241762",0,1,0,1,"dummy"
"241763",3,9,3,15,"dummy"
"241764",1,0,0,1,"dummy"
"241784",3,0,0,3,"dummy"
"241800",0,1,0,1,"dummy"
"241801",1,1,1,3,"dummy"
"241802",0,2,0,2,"dummy"
"241803",9,3,2,14,"dummy"
"241804",0,1,0,1,"dummy"
"241805",0,4,1,5,"dummy"
"241806",0,2,0,2,"dummy"
"241807",0,3,0,3,"dummy"
"241808",3,0,0,3,"dummy"
"241809",0,1,0,1,"dummy"
"241810",6,0,1,7,"dummy"
"241811",0,1,0,1,"dummy"
"241816",0,0,1,1,"dummy"
"241817",0,7,0,7,"dummy"
"241822",0,1,0,1,"dummy"
"241823",3,4,0,7,"dummy"
"241824",0,0,1,1,"dummy"
"241825",0,1,1,2,"dummy"
"241826",0,1,0,1,"dummy"
"241827",0,0,3,3,"dummy"
"241828",6,10,1,17,"dummy"
"241829",1,2,2,5,"dummy"
"241830",7,5,2,14,"dummy"
"241831",0,1,0,1,"dummy"
"241832",0,0,1,1,"dummy"
"241838",2,2,0,4,"dummy"
"241841",0,0,1,1,"dummy"
"241856",0,0,1,1,"dummy"
"241857",1,1,0,2,"dummy"
"241858",4,5,3,12,"dummy"
"241859",0,6,0,6,"dummy"
"241860",0,2,0,2,"dummy"
"241881",0,2,0,2,"dummy"
"241884",0,2,0,2,"dummy"
"241885",0,2,0,2,"dummy"
"241899",0,0,3,3,"dummy"
"241900",0,0,1,1,"dummy"
"241919",0,7,0,7,"dummy"
"241938",1,0,0,1,"dummy"
"241939",0,0,1,1,"dummy"
"241953",0,6,0,6,"dummy"
"241954",0,2,0,2,"dummy"
"241955",0,1,2,3,"dummy"
"241956",0,0,0,0,"dummy"
"241957",0,4,0,4,"dummy"
"241958",0,2,0,2,"dummy"
"241959",0,2,0,2,"dummy"
"241960",4,3,1,8,"dummy"
"241961",3,3,0,6,"dummy"
"241962",0,1,1,2,"dummy"
"241963",1,1,4,6,"dummy"
"241964",1,1,0,2,"dummy"
"241965",0,1,0,1,"dummy"
"241966",6,4,0,10,"dummy"
"241967",0,1,0,1,"dummy"
"241968",0,0,0,0,"dummy"
"241969",0,1,1,2,"dummy"
"241970",1,0,0,1,"dummy"
"241971",3,3,0,6,"dummy"
"241972",0,1,0,1,"dummy"
"241973",0,2,0,2,"dummy"
"241974",0,0,0,0,"dummy"
"241977",0,0,1,1,"dummy"
"241978",0,0,1,1,"dummy"
"241979",0,0,1,1,"dummy"
"241990",0,0,0,0,"dummy"
"242015",0,0,0,0,"dummy"
"242016",0,0,0,0,"dummy"
"242052",0,0,0,0,"dummy"
"242053",0,0,1,1,"dummy"
"242095",2,2,0,4,"dummy"
"241947",0,1,0,1,"dummy"
"241948",0,1,0,1,"dummy"
"241949",0,0,0,0,"dummy"
"241981",0,2,0,2,"dummy"
"241982",0,0,0,0,"dummy"
"241983",0,0,0,0,"dummy"
"241984",4,1,2,7,"dummy"
"241985",1,0,0,1,"dummy"
"241986",1,0,0,1,"dummy"
"241987",0,0,0,0,"dummy"
"241988",0,0,0,0,"dummy"
"241994",0,3,0,3,"dummy"
"241995",0,0,1,1,"dummy"
"241996",0,10,0,10,"dummy"
"241997",2,10,0,12,"dummy"
"242000",0,0,1,1,"dummy"
"242001",0,0,3,3,"dummy"
"242002",0,0,0,0,"dummy"
"242003",5,0,0,5,"dummy"
"242004",0,8,0,8,"dummy"
"242005",5,11,0,16,"dummy"
"242006",0,2,0,2,"dummy"
"242007",7,5,0,12,"dummy"
"242008",0,2,0,2,"dummy"
"242009",6,0,0,6,"dummy"
"242010",8,8,4,20,"dummy"
"242011",2,1,0,3,"dummy"
"242018",0,2,0,2,"dummy"
"242019",2,2,0,4,"dummy"
"242020",0,0,1,1,"dummy"
"242021",0,10,0,10,"dummy"
"242022",10,10,0,20,"dummy"
"242023",10,10,0,20,"dummy"
"242024",10,11,0,21,"dummy"
"242025",4,0,0,4,"dummy"
"242026",0,2,0,2,"dummy"
"242027",0,1,1,2,"dummy"
"242028",0,1,0,1,"dummy"
"242029",2,0,0,2,"dummy"
"242030",0,1,0,1,"dummy"
"242031",1,0,1,2,"dummy"
"242032",0,1,0,1,"dummy"
"242033",1,0,4,5,"dummy"
"242034",0,2,4,6,"dummy"
"242035",0,0,1,1,"dummy"
"242036",0,1,1,2,"dummy"
"242037",2,0,4,6,"dummy"
"242038",0,0,0,0,"dummy"
"242039",0,1,0,1,"dummy"
"242040",0,0,1,1,"dummy"
"242041",0,1,2,3,"dummy"
"242042",0,1,0,1,"dummy"
"242043",3,4,3,10,"dummy"
"242044",4,0,0,4,"dummy"
"242045",0,0,1,1,"dummy"
"242046",0,3,0,3,"dummy"
"242047",0,0,0,0,"dummy"
"242048",0,0,1,1,"dummy"
"242049",1,0,0,1,"dummy"
"242050",2,0,0,2,"dummy"
"242086",0,1,0,1,"dummy"
"242087",2,8,6,16,"dummy"
"242088",8,3,0,11,"dummy"
"242089",5,5,0,10,"dummy"
"242090",0,2,0,2,"dummy"
"242091",1,0,0,1,"dummy"
"242092",0,2,0,2,"dummy"
"242093",0,1,0,1,"dummy"
"242101",0,0,1,1,"dummy"
"242102",3,0,0,3,"dummy"
"242107",11,2,0,13,"dummy"
"242112",0,0,1,1,"dummy"
"242113",3,2,2,7,"dummy"
"242114",0,4,0,4,"dummy"
"242117",0,0,1,1,"dummy"
"242164",0,3,0,3,"dummy"
"242171",0,2,0,2,"dummy"
"242176",0,5,1,6,"dummy"
"242177",0,2,0,2,"dummy"
"242178",1,3,1,5,"dummy"
"242179",5,0,1,6,"dummy"
"242180",4,2,1,7,"dummy"
"242181",0,3,0,3,"dummy"
"242121",0,1,0,1,"dummy"
"242122",12,18,0,30,"dummy"
"242123",0,3,0,3,"dummy"
"242124",0,4,0,4,"dummy"
"242125",0,1,0,1,"dummy"
"242126",0,5,0,5,"dummy"
"242127",0,10,1,11,"dummy"
"242128",4,9,0,13,"dummy"
"242129",2,4,0,6,"dummy"
"242130",0,16,0,16,"dummy"
"242131",0,2,0,2,"dummy"
"242132",0,2,0,2,"dummy"
"242133",23,17,5,45,"dummy"
"242134",27,0,0,27,"dummy"
"242135",0,4,1,5,"dummy"
"242136",14,2,0,16,"dummy"
"242137",2,0,0,2,"dummy"
"242138",0,2,0,2,"dummy"
"242139",0,1,0,1,"dummy"
"242140",0,6,0,6,"dummy"
"242141",0,2,0,2,"dummy"
"242142",18,12,1,31,"dummy"
"242143",0,2,0,2,"dummy"
"242144",23,14,4,41,"dummy"
"242145",2,0,4,6,"dummy"
"242150",0,1,0,1,"dummy"
"242151",0,0,1,1,"dummy"
"242152",0,0,1,1,"dummy"
"242153",0,0,0,0,"dummy"
"242154",0,2,0,2,"dummy"
"242166",0,0,2,2,"dummy"
"242167",0,2,1,3,"dummy"
"242173",0,0,0,0,"dummy"
"242174",0,0,0,0,"dummy"
"242191",1,12,2,15,"dummy"
"242245",4,0,1,5,"dummy"
"242246",16,0,0,16,"dummy"
"242247",0,1,0,1,"dummy"
"242248",1,0,0,1,"dummy"
"242249",0,1,0,1,"dummy"
"242250",1,0,0,1,"dummy"
"242251",1,0,0,1,"dummy"
"242252",0,1,0,1,"dummy"
"242253",0,0,0,0,"dummy"
"242254",0,2,1,3,"dummy"
"242255",4,5,1,10,"dummy"
"242256",0,2,0,2,"dummy"
"242257",13,3,0,16,"dummy"
"242258",1,0,1,2,"dummy"
"242259",3,12,0,15,"dummy"
"242260",0,0,1,1,"dummy"
"242276",2,0,2,4,"dummy"
"242277",0,0,1,1,"dummy"
"242278",0,0,1,1,"dummy"
"242279",0,0,1,1,"dummy"
"242280",0,0,1,1,"dummy"
"242281",0,0,1,1,"dummy"
"242282",0,0,1,1,"dummy"
"242283",0,0,1,1,"dummy"
"242284",0,0,1,1,"dummy"
"242285",0,0,1,1,"dummy"
"242286",0,0,1,1,"dummy"
"242287",0,0,1,1,"dummy"
"242301",0,0,1,1,"dummy"
"242302",0,3,0,3,"dummy"
"242303",2,4,1,7,"dummy"
"242306",1,5,0,6,"dummy"
"242311",0,2,0,2,"dummy"
"242312",0,5,0,5,"dummy"
"242313",0,0,0,0,"dummy"
"242326",1,0,1,2,"dummy"
"242329",0,1,0,1,"dummy"
"242392",0,10,2,12,"dummy"
"242182",0,1,0,1,"dummy"
"242183",0,0,1,1,"dummy"
"242184",2,2,0,4,"dummy"
"242185",3,9,1,13,"dummy"
"242186",5,3,0,8,"dummy"
"242187",0,6,0,6,"dummy"
"242197",0,1,0,1,"dummy"
"242198",0,1,0,1,"dummy"
"242199",0,1,2,3,"dummy"
"242200",0,1,0,1,"dummy"
"242201",0,0,3,3,"dummy"
"242202",1,0,2,3,"dummy"
"242203",0,1,1,2,"dummy"
"242204",0,0,2,2,"dummy"
"242205",2,1,1,4,"dummy"
"242206",0,1,0,1,"dummy"
"242207",1,0,0,1,"dummy"
"242208",0,0,0,0,"dummy"
"242211",0,0,0,0,"dummy"
"242212",0,0,0,0,"dummy"
"242213",0,0,0,0,"dummy"
"242214",0,0,0,0,"dummy"
"242217",2,0,2,4,"dummy"
"242239",0,0,2,2,"dummy"
"242240",0,0,1,1,"dummy"
"242241",0,0,1,1,"dummy"
"242289",0,2,0,2,"dummy"
"242292",4,4,0,8,"dummy"
"242293",0,0,0,0,"dummy"
"242294",0,1,0,1,"dummy"
"242295",0,0,0,0,"dummy"
"242296",2,1,4,7,"dummy"
"242297",0,2,1,3,"dummy"
"242298",0,0,2,2,"dummy"
"242299",0,0,2,2,"dummy"
"242308",0,1,0,1,"dummy"
"242309",0,1,0,1,"dummy"
"242315",0,1,0,1,"dummy"
"242316",0,1,0,1,"dummy"
"242394",0,0,1,1,"dummy"
"242399",1,2,0,3,"dummy"
"242403",0,3,0,3,"dummy"
"242405",0,0,1,1,"dummy"
"242409",2,0,3,5,"dummy"
"242411",0,0,1,1,"dummy"
"242416",0,1,0,1,"dummy"
"242418",0,0,2,2,"dummy"
"242421",1,1,0,2,"dummy"
"242423",10,17,4,31,"dummy"
"242424",0,1,1,2,"dummy"
"242425",3,0,0,3,"dummy"
"242426",0,3,0,3,"dummy"
"242427",0,0,1,1,"dummy"
"242428",12,13,3,28,"dummy"
"242429",1,6,0,7,"dummy"
"242430",0,6,0,6,"dummy"
"242431",5,9,0,14,"dummy"
"242432",0,2,0,2,"dummy"
"242433",6,0,0,6,"dummy"
"242434",0,1,0,1,"dummy"
"242435",1,1,0,2,"dummy"
"242436",6,9,0,15,"dummy"
"242437",3,0,0,3,"dummy"
"242438",2,3,0,5,"dummy"
"242439",0,4,0,4,"dummy"
"242443",0,0,0,0,"dummy"
"242451",0,1,0,1,"dummy"
"242452",0,0,0,0,"dummy"
"242479",0,5,1,6,"dummy"
"242482",7,2,0,9,"dummy"
"242493",0,0,0,0,"dummy"
"242494",0,0,0,0,"dummy"
"242495",0,0,0,0,"dummy"
"242496",1,0,0,1,"dummy"
"242497",0,1,0,1,"dummy"
"242500",0,6,0,6,"dummy"
"242501",0,0,1,1,"dummy"
"242502",0,1,0,1,"dummy"
"242503",0,0,2,2,"dummy"
"242504",0,1,0,1,"dummy"
"242506",2,4,1,7,"dummy"
"242507",0,0,1,1,"dummy"
"242508",2,1,3,6,"dummy"
"242516",4,6,4,14,"dummy"
"242531",3,2,3,8,"dummy"
"242534",12,1,1,14,"dummy"
"242549",0,1,0,1,"dummy"
"242551",0,16,0,16,"dummy"
"242552",8,0,0,8,"dummy"
"242555",0,1,1,2,"dummy"
"242556",0,0,1,1,"dummy"
"242557",0,3,0,3,"dummy"
"242558",2,7,0,9,"dummy"
"242561",0,2,1,3,"dummy"
"242562",1,5,0,6,"dummy"
"242563",7,5,2,14,"dummy"
"242564",1,6,0,7,"dummy"
"242565",0,1,0,1,"dummy"
"242571",1,4,2,7,"dummy"
"242572",0,1,0,1,"dummy"
"242573",11,4,1,16,"dummy"
"242574",0,0,1,1,"dummy"
"242575",2,2,1,5,"dummy"
"242576",0,0,1,1,"dummy"
"242577",0,0,0,0,"dummy"
"242578",3,0,0,3,"dummy"
"242584",1,6,0,7,"dummy"
"242585",0,2,0,2,"dummy"
"242586",0,5,0,5,"dummy"
"242587",5,0,0,5,"dummy"
"242591",0,2,0,2,"dummy"
"242595",6,0,1,7,"dummy"
"242599",1,1,0,2,"dummy"
"242600",0,1,0,1,"dummy"
"242601",0,2,0,2,"dummy"
"242618",0,0,2,2,"dummy"
"242619",0,1,0,1,"dummy"
"242620",0,0,3,3,"dummy"
"242623",0,0,2,2,"dummy"
"242624",0,1,0,1,"dummy"
"242625",0,1,1,2,"dummy"
"242626",3,2,0,5,"dummy"
"242627",0,0,0,0,"dummy"
"242654",1,0,0,1,"dummy"
"242655",4,1,2,7,"dummy"
"242656",0,1,0,1,"dummy"
"242657",0,3,0,3,"dummy"
"242658",0,2,0,2,"dummy"
"242659",0,0,1,1,"dummy"
"242660",1,3,1,5,"dummy"
"242665",0,0,0,0,"dummy"
"242666",0,0,0,0,"dummy"
"242667",0,2,0,2,"dummy"
"242668",0,1,0,1,"dummy"
"242669",3,0,0,3,"dummy"
"242670",0,0,1,1,"dummy"
"242671",3,3,0,6,"dummy"
"242672",4,7,2,13,"dummy"
"242674",0,0,1,1,"dummy"
"242675",1,1,1,3,"dummy"
"242676",0,0,1,1,"dummy"
"242677",0,0,1,1,"dummy"
"242678",0,0,1,1,"dummy"
"242679",0,0,1,1,"dummy"
"242680",0,0,1,1,"dummy"
"242681",0,0,1,1,"dummy"
"242682",0,0,1,1,"dummy"
"242683",0,0,1,1,"dummy"
"242684",0,0,1,1,"dummy"
"242685",0,0,2,2,"dummy"
"242686",0,0,2,2,"dummy"
"242687",0,0,1,1,"dummy"
"242688",0,0,1,1,"dummy"
"242689",0,0,1,1,"dummy"
"242690",0,0,1,1,"dummy"
"242691",0,0,1,1,"dummy"
"242694",4,9,4,17,"dummy"
"242695",0,1,0,1,"dummy"
"242696",1,0,3,4,"dummy"
"242735",1,2,0,3,"dummy"
"242736",1,2,0,3,"dummy"
"242737",0,2,0,2,"dummy"
"242739",1,1,1,3,"dummy"
"242740",0,1,0,1,"dummy"
"242741",0,7,1,8,"dummy"
"242743",0,1,0,1,"dummy"
"242744",0,1,0,1,"dummy"
"242746",0,0,1,1,"dummy"
"242749",1,4,0,5,"dummy"
"242750",1,3,0,4,"dummy"
"242751",0,3,0,3,"dummy"
"242752",1,0,0,1,"dummy"
"242753",0,2,0,2,"dummy"
"242754",2,0,0,2,"dummy"
"242755",7,1,0,8,"dummy"
"242758",2,0,0,2,"dummy"
"242768",1,2,0,3,"dummy"
"242769",0,0,1,1,"dummy"
"242770",22,24,2,48,"dummy"
"242773",0,1,0,1,"dummy"
"242774",0,0,1,1,"dummy"
"242775",0,0,1,1,"dummy"
"242776",0,1,0,1,"dummy"
"242779",0,1,1,2,"dummy"
"242785",1,0,0,1,"dummy"
"242788",2,0,1,3,"dummy"
"242789",0,1,1,2,"dummy"
"242790",0,0,1,1,"dummy"
"242791",0,0,0,0,"dummy"
"242792",0,0,0,0,"dummy"
"242793",0,0,0,0,"dummy"
"242796",1,3,1,5,"dummy"
"242804",0,1,0,1,"dummy"
"242805",0,0,1,1,"dummy"
"242806",1,2,2,5,"dummy"
"242807",6,1,1,8,"dummy"
"242808",0,2,0,2,"dummy"
"242809",2,0,0,2,"dummy"
"242811",0,0,0,0,"dummy"
"242812",0,3,0,3,"dummy"
"242813",0,0,1,1,"dummy"
"242814",0,2,0,2,"dummy"
"242815",0,0,1,1,"dummy"
"242816",0,2,0,2,"dummy"
"242817",0,2,0,2,"dummy"
"242818",0,2,0,2,"dummy"
"242819",0,0,0,0,"dummy"
"242820",4,1,0,5,"dummy"
"242821",1,0,0,1,"dummy"
"242822",3,0,0,3,"dummy"
"242823",0,0,0,0,"dummy"
"242824",0,1,0,1,"dummy"
"242825",0,0,0,0,"dummy"
"242826",0,0,0,0,"dummy"
"242827",0,0,0,0,"dummy"
"242828",1,0,0,1,"dummy"
"242829",0,0,0,0,"dummy"
"242831",2,1,0,3,"dummy"
"242833",1,2,1,4,"dummy"
"242834",0,0,1,1,"dummy"
"242837",0,1,0,1,"dummy"
"242838",0,4,0,4,"dummy"
"242839",0,0,0,0,"dummy"
"242840",0,1,0,1,"dummy"
"242846",0,0,1,1,"dummy"
"242862",0,2,0,2,"dummy"
"242863",0,1,0,1,"dummy"
"242866",0,12,0,12,"dummy"
"242867",1,6,2,9,"dummy"
"242868",0,0,3,3,"dummy"
"242869",3,0,0,3,"dummy"
"242878",0,1,8,9,"dummy"
"242879",0,0,0,0,"dummy"
"242883",0,0,2,2,"dummy"
"242884",0,0,1,1,"dummy"
"242885",1,1,4,6,"dummy"
"242886",0,0,1,1,"dummy"
"242887",0,0,1,1,"dummy"
"242888",0,0,1,1,"dummy"
"242896",6,1,0,7,"dummy"
"242897",0,0,1,1,"dummy"
"242898",2,6,1,9,"dummy"
"242899",6,2,3,11,"dummy"
"242903",0,0,0,0,"dummy"
"242905",9,0,1,10,"dummy"
"242906",3,13,1,17,"dummy"
"242907",4,0,0,4,"dummy"
"242908",0,4,0,4,"dummy"
"242909",0,1,0,1,"dummy"
"242910",2,2,0,4,"dummy"
"242911",0,0,1,1,"dummy"
"242913",1,5,0,6,"dummy"
"242915",4,2,0,6,"dummy"
"242917",10,1,1,12,"dummy"
"242918",3,0,1,4,"dummy"
"242919",1,3,0,4,"dummy"
"242920",0,1,0,1,"dummy"
"242921",1,0,0,1,"dummy"
"242923",0,0,2,2,"dummy"
"242925",0,0,1,1,"dummy"
"242926",0,0,2,2,"dummy"
"242927",0,0,1,1,"dummy"
"242929",0,0,0,0,"dummy"
"242930",0,1,1,2,"dummy"
"242931",7,0,1,8,"dummy"
"242933",12,2,1,15,"dummy"
"242935",0,1,0,1,"dummy"
"242938",0,1,0,1,"dummy"
"242940",2,0,0,2,"dummy"
"242941",0,0,0,0,"dummy"
"242943",0,0,1,1,"dummy"
"242947",0,2,0,2,"dummy"
"242948",0,0,1,1,"dummy"
"242949",0,0,1,1,"dummy"
"242950",0,3,5,8,"dummy"
"242951",0,0,1,1,"dummy"
"242952",0,0,1,1,"dummy"
"242953",0,0,1,1,"dummy"
"242954",1,1,0,2,"dummy"
"242955",0,0,1,1,"dummy"
"242956",4,5,1,10,"dummy"
"242957",0,0,1,1,"dummy"
"242958",0,0,1,1,"dummy"
"242959",2,4,0,6,"dummy"
"242960",0,0,0,0,"dummy"
"242961",0,5,0,5,"dummy"
"242962",0,0,0,0,"dummy"
"242963",3,0,2,5,"dummy"
"242964",0,2,0,2,"dummy"
"242965",0,0,1,1,"dummy"
"242966",5,9,3,17,"dummy"
"242967",0,0,1,1,"dummy"
"242968",0,0,0,0,"dummy"
"242969",1,5,6,12,"dummy"
"242970",3,3,2,8,"dummy"
"242971",1,3,1,5,"dummy"
"242972",1,0,5,6,"dummy"
"242973",0,0,2,2,"dummy"
"242974",11,0,2,13,"dummy"
"242975",1,0,0,1,"dummy"
"242976",0,0,0,0,"dummy"
"242977",0,0,2,2,"dummy"
"242978",0,0,2,2,"dummy"
"242979",0,0,0,0,"dummy"
"242980",0,4,0,4,"dummy"
"242981",0,0,1,1,"dummy"
"242982",0,0,3,3,"dummy"
"242983",0,0,1,1,"dummy"
"242984",0,0,3,3,"dummy"
"242985",0,0,3,3,"dummy"
"242986",0,0,2,2,"dummy"
"242987",0,0,0,0,"dummy"
"242988",0,0,1,1,"dummy"
"242989",3,1,3,7,"dummy"
"242990",0,0,1,1,"dummy"
"242991",0,0,1,1,"dummy"
"242992",0,0,1,1,"dummy"
"242993",0,0,1,1,"dummy"
"242994",0,0,2,2,"dummy"
"242995",0,0,1,1,"dummy"
"242996",0,0,1,1,"dummy"
"242997",0,0,3,3,"dummy"
"242998",0,0,1,1,"dummy"
"242999",1,1,0,2,"dummy"
"243000",0,0,3,3,"dummy"
"243001",0,0,1,1,"dummy"
"243002",0,1,1,2,"dummy"
"243003",0,0,1,1,"dummy"
"243004",0,0,1,1,"dummy"
"243005",0,0,1,1,"dummy"
"243006",1,0,1,2,"dummy"
"243007",0,1,1,2,"dummy"
"243008",1,0,1,2,"dummy"
"243009",0,1,0,1,"dummy"
"243010",0,0,1,1,"dummy"
"243011",0,1,0,1,"dummy"
"243012",0,0,1,1,"dummy"
"243015",0,0,2,2,"dummy"
"243018",0,1,0,1,"dummy"
"243019",0,1,0,1,"dummy"
"243020",1,10,0,11,"dummy"
"243021",0,5,0,5,"dummy"
"243022",0,2,0,2,"dummy"
"243023",0,2,0,2,"dummy"
"243024",13,0,1,14,"dummy"
"243025",0,4,0,4,"dummy"
"243026",2,2,0,4,"dummy"
"243027",5,0,0,5,"dummy"
"243028",0,4,0,4,"dummy"
"243029",0,1,0,1,"dummy"
"243030",2,8,2,12,"dummy"
"243031",0,3,0,3,"dummy"
"243032",0,1,0,1,"dummy"
"243033",0,1,0,1,"dummy"
"243034",0,17,0,17,"dummy"
"243035",0,2,0,2,"dummy"
"243036",1,1,0,2,"dummy"
"243037",1,3,0,4,"dummy"
"243038",1,1,0,2,"dummy"
"243039",0,1,0,1,"dummy"
"243040",3,8,4,15,"dummy"
"243041",14,9,2,25,"dummy"
"243042",11,0,1,12,"dummy"
"243043",0,0,0,0,"dummy"
"243044",0,1,0,1,"dummy"
"243045",0,2,1,3,"dummy"
"243046",0,1,0,1,"dummy"
"243047",0,0,1,1,"dummy"
"243048",2,1,0,3,"dummy"
"243049",0,0,1,1,"dummy"
"243050",9,5,1,15,"dummy"
"243051",0,1,0,1,"dummy"
"243052",0,2,0,2,"dummy"
"243053",1,0,0,1,"dummy"
"243054",1,1,0,2,"dummy"
"243055",0,4,0,4,"dummy"
"243056",16,15,6,37,"dummy"
"243057",6,0,0,6,"dummy"
"243058",3,3,0,6,"dummy"
"243059",0,0,0,0,"dummy"
"243060",0,1,0,1,"dummy"
"243061",16,1,2,19,"dummy"
"243062",1,12,2,15,"dummy"
"243063",15,15,1,31,"dummy"
"243064",0,3,0,3,"dummy"
"243065",0,6,0,6,"dummy"
"243066",2,2,0,4,"dummy"
"243067",0,0,2,2,"dummy"
"243068",3,1,2,6,"dummy"
"243069",2,4,0,6,"dummy"
"243070",0,1,0,1,"dummy"
"243071",0,1,0,1,"dummy"
"243072",4,0,2,6,"dummy"
"243073",0,1,0,1,"dummy"
"243074",45,26,2,73,"dummy"
"243075",2,2,0,4,"dummy"
"243076",0,8,0,8,"dummy"
"243077",12,2,0,14,"dummy"
"243078",2,2,0,4,"dummy"
"243079",2,1,0,3,"dummy"
"243080",1,0,1,2,"dummy"
"243081",0,0,1,1,"dummy"
"243082",2,2,0,4,"dummy"
"243083",5,2,1,8,"dummy"
"243084",1,0,0,1,"dummy"
"243085",0,0,1,1,"dummy"
"243086",0,0,1,1,"dummy"
"243087",1,0,0,1,"dummy"
"243088",12,6,2,20,"dummy"
"243089",0,0,1,1,"dummy"
"243090",1,0,1,2,"dummy"
"243097",1,2,1,4,"dummy"
"243098",0,1,0,1,"dummy"
"243115",0,1,0,1,"dummy"
"243116",0,1,1,2,"dummy"
"243119",3,21,3,27,"dummy"
"243120",18,17,9,44,"dummy"
"243121",0,2,0,2,"dummy"
"243122",0,0,2,2,"dummy"
"243123",0,8,0,8,"dummy"
"243124",12,0,0,12,"dummy"
"243125",8,2,2,12,"dummy"
"243126",5,19,3,27,"dummy"
"243127",0,2,0,2,"dummy"
"243128",2,2,0,4,"dummy"
"243129",0,1,0,1,"dummy"
"243130",0,2,0,2,"dummy"
"243142",1,2,0,3,"dummy"
"243143",1,0,1,2,"dummy"
"243144",0,1,1,2,"dummy"
"243145",4,2,0,6,"dummy"
"243154",0,2,0,2,"dummy"
"243157",2,5,2,9,"dummy"
"243165",5,1,1,7,"dummy"
"243166",14,0,2,16,"dummy"
"243167",0,1,0,1,"dummy"
"243168",0,0,1,1,"dummy"
"243173",0,7,0,7,"dummy"
"243174",0,2,0,2,"dummy"
"243175",0,0,2,2,"dummy"
"243183",0,0,1,1,"dummy"
"243184",0,1,0,1,"dummy"
"243185",0,0,0,0,"dummy"
"243199",0,4,2,6,"dummy"
"243237",0,0,0,0,"dummy"
"243238",0,0,2,2,"dummy"
"243239",0,1,1,2,"dummy"
"243242",0,0,0,0,"dummy"
"243243",0,0,0,0,"dummy"
"243254",0,4,0,4,"dummy"
"243255",7,3,3,13,"dummy"
"243256",1,2,1,4,"dummy"
"243257",0,5,0,5,"dummy"
"243258",0,0,1,1,"dummy"
"243259",0,0,1,1,"dummy"
"243260",0,0,1,1,"dummy"
"243261",10,0,2,12,"dummy"
"243295",2,2,0,4,"dummy"
"243296",11,22,3,36,"dummy"
"243297",17,3,3,23,"dummy"
"243298",2,15,2,19,"dummy"
"243299",0,2,1,3,"dummy"
"243300",1,0,0,1,"dummy"
"243305",2,3,0,5,"dummy"
"243306",3,2,0,5,"dummy"
"243307",2,3,0,5,"dummy"
"243308",3,1,1,5,"dummy"
"243311",1,0,0,1,"dummy"
"243312",0,1,0,1,"dummy"
"243313",0,1,0,1,"dummy"
"243091",0,0,1,1,"dummy"
"243092",10,0,3,13,"dummy"
"243093",0,0,1,1,"dummy"
"243094",0,0,1,1,"dummy"
"243095",1,1,1,3,"dummy"
"243100",0,1,0,1,"dummy"
"243101",1,0,0,1,"dummy"
"243104",0,0,1,1,"dummy"
"243107",0,0,1,1,"dummy"
"243110",0,3,0,3,"dummy"
"243111",0,0,2,2,"dummy"
"243112",0,0,1,1,"dummy"
"243113",0,0,1,1,"dummy"
"243140",0,0,0,0,"dummy"
"243147",0,0,1,1,"dummy"
"243148",0,0,1,1,"dummy"
"243149",0,0,1,1,"dummy"
"243150",0,0,2,2,"dummy"
"243151",0,0,1,1,"dummy"
"243152",0,2,0,2,"dummy"
"243159",0,0,1,1,"dummy"
"243160",0,2,1,3,"dummy"
"243161",0,1,0,1,"dummy"
"243177",0,1,0,1,"dummy"
"243178",0,4,1,5,"dummy"
"243179",0,1,0,1,"dummy"
"243187",6,0,0,6,"dummy"
"243188",2,5,2,9,"dummy"
"243195",2,2,1,5,"dummy"
"243196",3,16,0,19,"dummy"
"243197",0,0,2,2,"dummy"
"243201",0,1,0,1,"dummy"
"243202",2,2,0,4,"dummy"
"243207",0,0,1,1,"dummy"
"243217",0,0,0,0,"dummy"
"243218",0,0,0,0,"dummy"
"243219",0,0,1,1,"dummy"
"243220",0,0,0,0,"dummy"
"243221",0,0,0,0,"dummy"
"243222",1,0,1,2,"dummy"
"243230",0,0,0,0,"dummy"
"243233",0,0,0,0,"dummy"
"243234",0,1,0,1,"dummy"
"243235",1,1,0,2,"dummy"
"243251",0,1,0,1,"dummy"
"243252",8,5,3,16,"dummy"
"243271",0,2,0,2,"dummy"
"243272",0,2,0,2,"dummy"
"243273",0,1,0,1,"dummy"
"243274",0,2,0,2,"dummy"
"243275",0,1,0,1,"dummy"
"243276",1,0,0,1,"dummy"
"243277",0,0,0,0,"dummy"
"243278",0,2,0,2,"dummy"
"243279",0,1,0,1,"dummy"
"243285",4,8,1,13,"dummy"
"243286",13,7,2,22,"dummy"
"243287",4,3,0,7,"dummy"
"243288",3,3,0,6,"dummy"
"243289",0,0,1,1,"dummy"
"243290",0,0,1,1,"dummy"
"243291",0,0,1,1,"dummy"
"243292",0,0,2,2,"dummy"
"243293",0,0,1,1,"dummy"
"243336",1,0,1,2,"dummy"
"243337",0,1,2,3,"dummy"
"243338",1,0,1,2,"dummy"
"243339",0,0,1,1,"dummy"
"243316",0,0,0,0,"dummy"
"243317",0,0,0,0,"dummy"
"243322",0,0,2,2,"dummy"
"243323",0,0,1,1,"dummy"
"243334",0,2,1,3,"dummy"
"243364",0,0,0,0,"dummy"
"243365",0,0,3,3,"dummy"
"243366",0,0,3,3,"dummy"
"243367",0,0,0,0,"dummy"
"243370",1,4,0,5,"dummy"
"243382",2,3,0,5,"dummy"
"243383",5,11,1,17,"dummy"
"243384",8,2,2,12,"dummy"
"243385",0,1,0,1,"dummy"
"243388",0,0,1,1,"dummy"
"243397",0,0,1,1,"dummy"
"243398",0,2,1,3,"dummy"
"243399",0,1,0,1,"dummy"
"243402",4,5,1,10,"dummy"
"243403",1,3,1,5,"dummy"
"243404",6,1,1,8,"dummy"
"243405",0,6,1,7,"dummy"
"243412",4,0,4,8,"dummy"
"243413",0,0,3,3,"dummy"
"243414",0,0,2,2,"dummy"
"243415",0,0,1,1,"dummy"
"243416",0,1,1,2,"dummy"
"243417",0,0,1,1,"dummy"
"243418",0,1,0,1,"dummy"
"243419",1,0,1,2,"dummy"
"243422",0,1,0,1,"dummy"
"243423",1,1,0,2,"dummy"
"243424",2,0,0,2,"dummy"
"243439",1,0,0,1,"dummy"
"243442",1,6,1,8,"dummy"
"243443",0,1,0,1,"dummy"
"243444",0,0,1,1,"dummy"
"243445",0,1,0,1,"dummy"
"243453",28,6,0,34,"dummy"
"243468",4,6,1,11,"dummy"
"243469",3,3,0,6,"dummy"
"243475",0,1,0,1,"dummy"
"243480",3,3,2,8,"dummy"
"243481",3,3,0,6,"dummy"
"243482",0,7,0,7,"dummy"
"243492",0,0,0,0,"dummy"
"243493",0,0,0,0,"dummy"
"243494",0,0,0,0,"dummy"
"243495",0,0,0,0,"dummy"
"243500",6,0,0,6,"dummy"
"243506",0,2,0,2,"dummy"
"243507",0,2,0,2,"dummy"
"243508",0,1,0,1,"dummy"
"243509",1,11,0,12,"dummy"
"243510",2,0,0,2,"dummy"
"243511",0,1,1,2,"dummy"
"243523",2,2,4,8,"dummy"
"243526",0,0,1,1,"dummy"
"243527",0,0,1,1,"dummy"
"243530",0,2,1,3,"dummy"
"243531",22,17,4,43,"dummy"
"243532",4,3,1,8,"dummy"
"243535",0,0,1,1,"dummy"
"243536",0,0,1,1,"dummy"
"243541",0,0,1,1,"dummy"
"243542",1,0,0,1,"dummy"
"243543",0,1,0,1,"dummy"
"243544",0,1,0,1,"dummy"
"243545",0,1,0,1,"dummy"
"243340",0,0,2,2,"dummy"
"243341",0,0,1,1,"dummy"
"243342",0,0,0,0,"dummy"
"243343",2,0,1,3,"dummy"
"243344",0,0,1,1,"dummy"
"243345",0,1,0,1,"dummy"
"243346",0,2,0,2,"dummy"
"243347",0,0,1,1,"dummy"
"243348",0,0,1,1,"dummy"
"243349",0,1,0,1,"dummy"
"243350",0,1,0,1,"dummy"
"243351",0,0,1,1,"dummy"
"243352",0,1,0,1,"dummy"
"243353",5,0,0,5,"dummy"
"243354",0,2,0,2,"dummy"
"243355",0,1,0,1,"dummy"
"243356",0,1,0,1,"dummy"
"243357",0,0,0,0,"dummy"
"243358",4,0,0,4,"dummy"
"243359",0,0,0,0,"dummy"
"243360",4,11,0,15,"dummy"
"243361",0,0,0,0,"dummy"
"243362",4,0,0,4,"dummy"
"243372",2,4,0,6,"dummy"
"243373",0,2,0,2,"dummy"
"243374",0,2,0,2,"dummy"
"243375",10,2,0,12,"dummy"
"243376",0,2,0,2,"dummy"
"243377",0,0,0,0,"dummy"
"243378",0,0,3,3,"dummy"
"243379",0,5,0,5,"dummy"
"243380",1,0,1,2,"dummy"
"243392",0,1,0,1,"dummy"
"243393",0,0,1,1,"dummy"
"243394",0,0,1,1,"dummy"
"243395",0,0,1,1,"dummy"
"243435",0,1,0,1,"dummy"
"243436",0,1,0,1,"dummy"
"243437",0,0,0,0,"dummy"
"243449",0,1,0,1,"dummy"
"243450",0,4,0,4,"dummy"
"243451",0,1,1,2,"dummy"
"243473",0,1,0,1,"dummy"
"243484",3,0,3,6,"dummy"
"243487",0,0,0,0,"dummy"
"243488",0,0,0,0,"dummy"
"243504",0,0,2,2,"dummy"
"243513",2,5,0,7,"dummy"
"243520",4,42,3,49,"dummy"
"243538",0,1,2,3,"dummy"
"243539",1,0,0,1,"dummy"
"243559",3,1,0,4,"dummy"
"243560",0,0,1,1,"dummy"
"243561",0,0,1,1,"dummy"
"243562",0,1,0,1,"dummy"
"243563",4,6,1,11,"dummy"
"243564",0,0,1,1,"dummy"
"243565",2,1,0,3,"dummy"
"243566",0,0,1,1,"dummy"
"243567",2,2,5,9,"dummy"
"243568",0,0,2,2,"dummy"
"243571",3,1,1,5,"dummy"
"243572",1,0,1,2,"dummy"
"243575",1,1,1,3,"dummy"
"243576",0,0,1,1,"dummy"
"243577",0,2,0,2,"dummy"
"243546",1,2,0,3,"dummy"
"243547",1,1,0,2,"dummy"
"243548",2,2,0,4,"dummy"
"243549",0,1,0,1,"dummy"
"243550",1,1,0,2,"dummy"
"243551",1,0,0,1,"dummy"
"243552",0,0,1,1,"dummy"
"243553",0,0,1,1,"dummy"
"243554",0,0,1,1,"dummy"
"243557",0,0,2,2,"dummy"
"243582",0,1,0,1,"dummy"
"243585",4,1,1,6,"dummy"
"243586",0,2,0,2,"dummy"
"243587",0,0,1,1,"dummy"
"243588",0,4,0,4,"dummy"
"243589",0,8,2,10,"dummy"
"243590",8,0,2,10,"dummy"
"243591",3,2,0,5,"dummy"
"243592",0,1,0,1,"dummy"
"243593",0,0,0,0,"dummy"
"243594",1,1,0,2,"dummy"
"243595",1,1,0,2,"dummy"
"243598",0,0,1,1,"dummy"
"243606",0,2,1,3,"dummy"
"243607",0,0,0,0,"dummy"
"243611",2,15,1,18,"dummy"
"243612",4,4,1,9,"dummy"
"243578",2,5,0,7,"dummy"
"243579",1,7,1,9,"dummy"
"243580",0,0,0,0,"dummy"
"243600",1,8,3,12,"dummy"
"243601",0,0,1,1,"dummy"
"243602",2,1,4,7,"dummy"
"243609",14,2,1,17,"dummy"
"243619",0,3,0,3,"dummy"
"243621",0,0,3,3,"dummy"
"243623",3,0,0,3,"dummy"
"243625",0,0,1,1,"dummy"
"243626",0,2,0,2,"dummy"
"243627",0,1,0,1,"dummy"
"243629",2,7,17,26,"dummy"
"243630",0,0,0,0,"dummy"
"243647",0,4,1,5,"dummy"
"243649",1,3,0,4,"dummy"
"243659",0,0,4,4,"dummy"
"243660",0,0,1,1,"dummy"
"243661",1,2,1,4,"dummy"
"243662",0,3,0,3,"dummy"
"243664",0,0,0,0,"dummy"
"243665",0,2,0,2,"dummy"
"243666",0,5,1,6,"dummy"
"243667",9,1,1,11,"dummy"
"243668",0,4,1,5,"dummy"
"243689",0,8,0,8,"dummy"
"243690",0,2,0,2,"dummy"
"243691",0,2,0,2,"dummy"
"243692",0,0,0,0,"dummy"
"243695",1,2,1,4,"dummy"
"243697",1,0,0,1,"dummy"
"243705",0,0,1,1,"dummy"
"243706",0,1,0,1,"dummy"
"243710",0,3,0,3,"dummy"
"243711",1,3,1,5,"dummy"
"243712",0,0,1,1,"dummy"
"243716",0,12,0,12,"dummy"
"243717",0,1,1,2,"dummy"
"243718",2,1,2,5,"dummy"
"243719",1,1,0,2,"dummy"
"243720",0,0,1,1,"dummy"
"243721",0,0,1,1,"dummy"
"243722",2,1,1,4,"dummy"
"243724",1,1,1,3,"dummy"
"243725",0,1,0,1,"dummy"
"243730",0,1,1,2,"dummy"
"243734",0,0,1,1,"dummy"
"243736",0,2,0,2,"dummy"
"243738",0,1,0,1,"dummy"
"243741",5,9,2,16,"dummy"
"243742",5,21,1,27,"dummy"
"243743",0,0,0,0,"dummy"
"243744",1,6,0,7,"dummy"
"243745",4,0,0,4,"dummy"
"243746",5,8,0,13,"dummy"
"243747",3,1,0,4,"dummy"
"243752",0,0,0,0,"dummy"
"243779",1,6,1,8,"dummy"
"243780",11,20,5,36,"dummy"
"243781",0,0,1,1,"dummy"
"243782",1,0,1,2,"dummy"
"243783",19,9,1,29,"dummy"
"243784",0,5,0,5,"dummy"
"243785",0,5,0,5,"dummy"
"243786",2,1,1,4,"dummy"
"243787",1,0,2,3,"dummy"
"243788",0,1,0,1,"dummy"
"243789",0,1,2,3,"dummy"
"243790",2,0,0,2,"dummy"
"243791",0,1,0,1,"dummy"
"243792",1,1,0,2,"dummy"
"243793",1,1,0,2,"dummy"
"243794",16,25,7,48,"dummy"
"243796",0,0,1,1,"dummy"
"243798",0,0,1,1,"dummy"
"243806",0,0,0,0,"dummy"
"243808",0,0,1,1,"dummy"
"243809",0,0,0,0,"dummy"
"243811",2,1,1,4,"dummy"
"243812",0,0,1,1,"dummy"
"243813",0,4,0,4,"dummy"
"243814",7,0,3,10,"dummy"
"243815",0,0,1,1,"dummy"
"243816",3,1,0,4,"dummy"
"243871",0,1,0,1,"dummy"
"243872",0,9,3,12,"dummy"
"243873",0,0,2,2,"dummy"
"243874",0,0,3,3,"dummy"
"243878",0,0,2,2,"dummy"
"243881",0,1,0,1,"dummy"
"243882",0,2,0,2,"dummy"
"243883",0,0,2,2,"dummy"
"243884",2,0,0,2,"dummy"
"243885",1,2,0,3,"dummy"
"243886",1,0,0,1,"dummy"
"243887",0,0,1,1,"dummy"
"243888",0,2,0,2,"dummy"
"243889",0,5,3,8,"dummy"
"243891",0,0,1,1,"dummy"
"243892",0,0,1,1,"dummy"
"243894",0,2,0,2,"dummy"
"243895",0,1,0,1,"dummy"
"243910",0,1,0,1,"dummy"
"243916",0,1,0,1,"dummy"
"243917",2,9,0,11,"dummy"
"243918",0,0,0,0,"dummy"
"243935",0,6,2,8,"dummy"
"243936",0,0,1,1,"dummy"
"243937",0,0,0,0,"dummy"
"243938",1,1,1,3,"dummy"
"243939",0,0,2,2,"dummy"
"243940",1,0,0,1,"dummy"
"243941",0,2,1,3,"dummy"
"243942",0,0,1,1,"dummy"
"243943",2,2,0,4,"dummy"
"243944",0,1,1,2,"dummy"
"243945",3,5,3,11,"dummy"
"243946",1,2,2,5,"dummy"
"243947",0,1,1,2,"dummy"
"243948",0,3,0,3,"dummy"
"243949",2,0,0,2,"dummy"
"243950",0,2,0,2,"dummy"
"243951",1,1,0,2,"dummy"
"243952",3,0,0,3,"dummy"
"243953",2,2,0,4,"dummy"
"243955",3,0,6,9,"dummy"
"243956",3,4,1,8,"dummy"
"243957",2,2,0,4,"dummy"
"243958",1,0,0,1,"dummy"
"243959",2,2,0,4,"dummy"
"243960",0,0,2,2,"dummy"
"243961",2,2,0,4,"dummy"
"243963",3,0,0,3,"dummy"
"243965",0,1,2,3,"dummy"
"243966",0,0,0,0,"dummy"
"243967",0,1,0,1,"dummy"
"243968",4,0,2,6,"dummy"
"243969",1,0,0,1,"dummy"
"243970",0,0,0,0,"dummy"
"243973",14,19,8,41,"dummy"
"243974",2,1,0,3,"dummy"
"243975",0,0,0,0,"dummy"
"243976",5,5,1,11,"dummy"
"243977",0,1,0,1,"dummy"
"243978",0,0,2,2,"dummy"
"243979",0,2,0,2,"dummy"
"243980",0,0,2,2,"dummy"
"243981",6,6,0,12,"dummy"
"243982",1,0,0,1,"dummy"
"243983",0,4,0,4,"dummy"
"243984",6,0,0,6,"dummy"
"243985",0,4,0,4,"dummy"
"243986",0,2,0,2,"dummy"
"243987",0,0,2,2,"dummy"
"243988",5,5,0,10,"dummy"
"243989",0,1,0,1,"dummy"
"243990",1,1,0,2,"dummy"
"243994",0,2,0,2,"dummy"
"243995",4,5,2,11,"dummy"
"243997",2,3,4,9,"dummy"
"243998",0,1,1,2,"dummy"
"244010",1,0,0,1,"dummy"
"244013",0,1,0,1,"dummy"
"244014",0,0,0,0,"dummy"
"244015",1,0,0,1,"dummy"
"244016",1,4,1,6,"dummy"
"244017",0,0,2,2,"dummy"
"244018",0,2,0,2,"dummy"
"244019",0,0,1,1,"dummy"
"244020",0,1,0,1,"dummy"
"244021",0,0,3,3,"dummy"
"244023",1,1,0,2,"dummy"
"244024",0,3,0,3,"dummy"
"244025",6,4,4,14,"dummy"
"244026",2,0,0,2,"dummy"
"244046",0,1,0,1,"dummy"
"244047",1,7,0,8,"dummy"
"244048",3,2,0,5,"dummy"
"244050",0,0,1,1,"dummy"
"244051",0,0,2,2,"dummy"
"244052",0,0,1,1,"dummy"
"244053",0,0,2,2,"dummy"
"244054",0,0,4,4,"dummy"
"244087",18,32,1,51,"dummy"
"244088",9,4,0,13,"dummy"
"244109",1,0,0,1,"dummy"
"244110",0,0,1,1,"dummy"
"244111",0,0,0,0,"dummy"
"244112",8,4,0,12,"dummy"
"244114",6,6,0,12,"dummy"
"244115",0,0,3,3,"dummy"
"244149",0,0,1,1,"dummy"
"244150",8,2,0,10,"dummy"
"244151",2,4,0,6,"dummy"
"244152",0,1,0,1,"dummy"
"244153",4,6,0,10,"dummy"
"244154",0,0,0,0,"dummy"
"244155",0,1,0,1,"dummy"
"244156",2,0,0,2,"dummy"
"244157",0,0,2,2,"dummy"
"244160",0,2,0,2,"dummy"
"244161",18,23,5,46,"dummy"
"244166",0,2,0,2,"dummy"
"244167",0,3,0,3,"dummy"
"244168",0,1,0,1,"dummy"
"244169",0,1,0,1,"dummy"
"244170",0,3,0,3,"dummy"
"244171",0,2,0,2,"dummy"
"244174",4,2,0,6,"dummy"
"244176",0,0,0,0,"dummy"
"244177",0,2,0,2,"dummy"
"244180",0,2,0,2,"dummy"
"244184",7,8,0,15,"dummy"
"244185",0,0,1,1,"dummy"
"244186",0,0,1,1,"dummy"
"244187",0,0,1,1,"dummy"
"244188",0,0,1,1,"dummy"
"244189",0,0,1,1,"dummy"
"244190",0,0,1,1,"dummy"
"244191",0,0,1,1,"dummy"
"244192",0,0,1,1,"dummy"
"244193",0,0,1,1,"dummy"
"244194",0,0,1,1,"dummy"
"244195",0,0,2,2,"dummy"
"244196",0,0,1,1,"dummy"
"244197",0,0,1,1,"dummy"
"244198",0,0,2,2,"dummy"
"244199",0,0,1,1,"dummy"
"244200",0,0,1,1,"dummy"
"244201",0,0,1,1,"dummy"
"244202",0,0,1,1,"dummy"
"244203",0,0,2,2,"dummy"
"244204",0,0,1,1,"dummy"
"244205",0,0,1,1,"dummy"
"244206",0,0,1,1,"dummy"
"244207",0,0,1,1,"dummy"
"244208",0,0,1,1,"dummy"
"244231",2,4,2,8,"dummy"
"244232",1,0,0,1,"dummy"
"244233",1,5,0,6,"dummy"
"244234",3,1,0,4,"dummy"
"244235",2,5,1,8,"dummy"
"244237",0,5,0,5,"dummy"
"244243",0,0,1,1,"dummy"
"244244",0,3,0,3,"dummy"
"244246",1,2,1,4,"dummy"
"244247",0,2,0,2,"dummy"
"244252",0,0,1,1,"dummy"
"244253",0,0,1,1,"dummy"
"244254",0,0,1,1,"dummy"
"244256",0,1,0,1,"dummy"
"244257",0,10,2,12,"dummy"
"244258",0,3,0,3,"dummy"
"244259",0,0,0,0,"dummy"
"244262",1,0,3,4,"dummy"
"244263",0,0,6,6,"dummy"
"244264",0,0,1,1,"dummy"
"244265",0,2,0,2,"dummy"
"244266",2,0,1,3,"dummy"
"244267",0,2,0,2,"dummy"
"244268",0,0,0,0,"dummy"
"244269",0,0,1,1,"dummy"
"244274",1,2,0,3,"dummy"
"244275",0,3,0,3,"dummy"
"244276",0,1,0,1,"dummy"
"244277",0,2,0,2,"dummy"
"244278",2,6,2,10,"dummy"
"244279",1,4,1,6,"dummy"
"244281",7,4,2,13,"dummy"
"244282",2,0,0,2,"dummy"
"244290",0,1,0,1,"dummy"
"244291",0,0,4,4,"dummy"
"244315",0,1,0,1,"dummy"
"244316",1,0,0,1,"dummy"
"244317",0,1,1,2,"dummy"
"244318",1,0,0,1,"dummy"
"244319",0,1,0,1,"dummy"
"244320",1,0,0,1,"dummy"
"244321",1,0,1,2,"dummy"
"244322",0,1,0,1,"dummy"
"244325",0,1,0,1,"dummy"
"244326",0,3,0,3,"dummy"
"244328",0,0,1,1,"dummy"
"244329",0,0,1,1,"dummy"
"244330",8,5,2,15,"dummy"
"244331",0,0,1,1,"dummy"
"244332",0,0,1,1,"dummy"
"244335",0,0,2,2,"dummy"
"244336",0,0,2,2,"dummy"
"244337",0,0,1,1,"dummy"
"244339",0,1,0,1,"dummy"
"244340",0,0,0,0,"dummy"
"244363",0,0,1,1,"dummy"
"244364",0,0,1,1,"dummy"
"244366",0,0,1,1,"dummy"
"244367",1,2,0,3,"dummy"
"244368",10,17,0,27,"dummy"
"244369",0,1,1,2,"dummy"
"244370",0,0,2,2,"dummy"
"244371",0,0,1,1,"dummy"
"244372",2,1,0,3,"dummy"
"244373",0,0,2,2,"dummy"
"244374",0,1,0,1,"dummy"
"244375",0,1,1,2,"dummy"
"244376",0,0,1,1,"dummy"
"244377",22,5,3,30,"dummy"
"244380",0,0,0,0,"dummy"
"244382",0,2,0,2,"dummy"
"244383",8,7,1,16,"dummy"
"244384",0,1,0,1,"dummy"
"244385",0,0,2,2,"dummy"
"244387",0,9,0,9,"dummy"
"244388",0,0,2,2,"dummy"
"244389",0,2,0,2,"dummy"
"244390",2,1,0,3,"dummy"
"244391",11,0,0,11,"dummy"
"244393",0,0,1,1,"dummy"
"244394",2,0,4,6,"dummy"
"244395",0,0,1,1,"dummy"
"244410",0,1,0,1,"dummy"
"244411",0,0,1,1,"dummy"
"244417",0,0,1,1,"dummy"
"244446",0,0,0,0,"dummy"
"244447",0,0,0,0,"dummy"
"244450",1,4,0,5,"dummy"
"244456",2,15,7,24,"dummy"
"244457",0,3,0,3,"dummy"
"244464",0,1,0,1,"dummy"
"244465",0,0,1,1,"dummy"
"244484",0,1,0,1,"dummy"
"244485",3,3,0,6,"dummy"
"244486",0,4,0,4,"dummy"
"244487",0,1,0,1,"dummy"
"244492",0,1,0,1,"dummy"
"244498",0,0,1,1,"dummy"
"244514",2,4,0,6,"dummy"
"244515",0,2,0,2,"dummy"
"244516",0,2,0,2,"dummy"
"244517",10,2,0,12,"dummy"
"244518",0,2,0,2,"dummy"
"244524",0,0,1,1,"dummy"
"244525",0,1,0,1,"dummy"
"244526",0,0,1,1,"dummy"
"244540",2,0,0,2,"dummy"
"244544",5,7,4,16,"dummy"
"244556",8,0,0,8,"dummy"
"244557",0,0,1,1,"dummy"
"244558",0,1,0,1,"dummy"
"244559",0,1,0,1,"dummy"
"244560",1,0,0,1,"dummy"
"244561",4,5,0,9,"dummy"
"244562",0,2,5,7,"dummy"
"244563",6,6,0,12,"dummy"
"244564",1,1,0,2,"dummy"
"244565",0,1,0,1,"dummy"
"244566",2,1,0,3,"dummy"
"244567",0,1,0,1,"dummy"
"244568",0,1,0,1,"dummy"
"244569",0,6,0,6,"dummy"
"244570",0,2,0,2,"dummy"
"244571",7,5,3,15,"dummy"
"244572",3,3,2,8,"dummy"
"244573",1,0,0,1,"dummy"
"244574",0,0,1,1,"dummy"
"244575",0,3,0,3,"dummy"
"244576",5,3,4,12,"dummy"
"244577",0,0,1,1,"dummy"
"244578",0,0,1,1,"dummy"
"244579",1,3,0,4,"dummy"
"244580",1,5,1,7,"dummy"
"244581",4,12,2,18,"dummy"
"244582",4,0,1,5,"dummy"
"244583",5,0,0,5,"dummy"
"244584",4,0,0,4,"dummy"
"244607",3,4,2,9,"dummy"
"244608",6,15,2,23,"dummy"
"244609",7,3,2,12,"dummy"
"244610",0,0,3,3,"dummy"
"244611",0,0,4,4,"dummy"
"244612",0,7,0,7,"dummy"
"244613",6,0,0,6,"dummy"
"244614",1,0,2,3,"dummy"
"244415",0,1,0,1,"dummy"
"244419",1,0,0,1,"dummy"
"244434",0,1,0,1,"dummy"
"244437",0,0,0,0,"dummy"
"244438",5,5,1,11,"dummy"
"244439",2,1,0,3,"dummy"
"244440",1,0,0,1,"dummy"
"244441",0,1,0,1,"dummy"
"244442",0,1,1,2,"dummy"
"244443",1,2,4,7,"dummy"
"244444",0,1,0,1,"dummy"
"244452",0,0,1,1,"dummy"
"244453",0,0,1,1,"dummy"
"244454",0,0,1,1,"dummy"
"244459",0,1,0,1,"dummy"
"244460",2,0,2,4,"dummy"
"244480",9,7,4,20,"dummy"
"244481",0,3,0,3,"dummy"
"244482",0,1,0,1,"dummy"
"244494",9,12,0,21,"dummy"
"244500",1,1,0,2,"dummy"
"244501",1,2,1,4,"dummy"
"244502",3,0,0,3,"dummy"
"244503",3,2,2,7,"dummy"
"244504",3,0,0,3,"dummy"
"244505",0,0,1,1,"dummy"
"244520",4,1,1,6,"dummy"
"244521",0,0,1,1,"dummy"
"244522",0,0,3,3,"dummy"
"244528",0,3,0,3,"dummy"
"244535",9,1,2,12,"dummy"
"244536",0,0,0,0,"dummy"
"244542",1,2,0,3,"dummy"
"244550",0,3,0,3,"dummy"
"244551",0,7,0,7,"dummy"
"244552",0,2,0,2,"dummy"
"244553",0,1,0,1,"dummy"
"244554",0,0,2,2,"dummy"
"244586",0,0,1,1,"dummy"
"244587",0,0,3,3,"dummy"
"244588",6,8,2,16,"dummy"
"244589",3,3,2,8,"dummy"
"244590",4,1,1,6,"dummy"
"244591",0,4,0,4,"dummy"
"244592",0,0,0,0,"dummy"
"244593",0,1,0,1,"dummy"
"244594",0,0,1,1,"dummy"
"244595",0,1,0,1,"dummy"
"244600",2,4,0,6,"dummy"
"244601",0,2,0,2,"dummy"
"244602",0,2,0,2,"dummy"
"244603",10,2,0,12,"dummy"
"244604",0,2,0,2,"dummy"
"244605",0,0,0,0,"dummy"
"244616",2,2,3,7,"dummy"
"244644",0,1,2,3,"dummy"
"244651",0,2,0,2,"dummy"
"244652",1,0,1,2,"dummy"
"244662",0,0,1,1,"dummy"
"244663",0,2,0,2,"dummy"
"244618",2,1,0,3,"dummy"
"244621",0,0,0,0,"dummy"
"244635",0,1,1,2,"dummy"
"244636",15,10,2,27,"dummy"
"244637",1,1,0,2,"dummy"
"244638",3,7,1,11,"dummy"
"244639",0,1,1,2,"dummy"
"244640",1,0,1,2,"dummy"
"244646",0,0,0,0,"dummy"
"244647",0,1,0,1,"dummy"
"244648",0,0,2,2,"dummy"
"244649",0,1,0,1,"dummy"
"244654",0,0,3,3,"dummy"
"244655",0,4,0,4,"dummy"
"244658",1,3,0,4,"dummy"
"244666",0,0,0,0,"dummy"
"244697",0,0,2,2,"dummy"
"244698",0,0,2,2,"dummy"
"244699",0,0,2,2,"dummy"
"244700",0,0,2,2,"dummy"
"244701",0,0,2,2,"dummy"
"244702",0,2,0,2,"dummy"
"244703",0,0,2,2,"dummy"
"244704",0,3,0,3,"dummy"
"244705",0,2,0,2,"dummy"
"244706",3,3,0,6,"dummy"
"244707",0,0,2,2,"dummy"
"244708",0,0,2,2,"dummy"
"244709",0,0,2,2,"dummy"
"244710",0,0,2,2,"dummy"
"244711",0,0,2,2,"dummy"
"244712",0,0,2,2,"dummy"
"244713",0,0,2,2,"dummy"
"244714",0,0,2,2,"dummy"
"244715",0,0,2,2,"dummy"
"244716",0,0,2,2,"dummy"
"244717",0,0,2,2,"dummy"
"244718",1,2,2,5,"dummy"
"244719",0,0,2,2,"dummy"
"244720",0,0,2,2,"dummy"
"244731",8,0,0,8,"dummy"
"244732",0,1,0,1,"dummy"
"244733",0,1,0,1,"dummy"
"244734",0,3,0,3,"dummy"
"244735",3,3,0,6,"dummy"
"244736",3,3,0,6,"dummy"
"244737",0,0,1,1,"dummy"
"244738",0,0,1,1,"dummy"
"244739",0,1,0,1,"dummy"
"244740",1,0,0,1,"dummy"
"244741",1,1,0,2,"dummy"
"244742",0,1,0,1,"dummy"
"244743",0,0,1,1,"dummy"
"244744",0,0,1,1,"dummy"
"244758",2,8,2,12,"dummy"
"244759",0,2,0,2,"dummy"
"244760",4,4,0,8,"dummy"
"244761",0,0,2,2,"dummy"
"244762",0,1,0,1,"dummy"
"244763",1,1,0,2,"dummy"
"244764",0,0,0,0,"dummy"
"244792",0,0,1,1,"dummy"
"244793",0,0,1,1,"dummy"
"244794",0,0,1,1,"dummy"
"244795",0,0,1,1,"dummy"
"244796",0,0,1,1,"dummy"
"244797",0,0,1,1,"dummy"
"244798",0,0,1,1,"dummy"
"244804",1,0,0,1,"dummy"
"244805",0,0,1,1,"dummy"
"244814",6,6,0,12,"dummy"
"244815",0,0,1,1,"dummy"
"244816",1,0,1,2,"dummy"
"244817",4,3,1,8,"dummy"
"244818",0,1,0,1,"dummy"
"244819",0,0,0,0,"dummy"
"244826",0,0,1,1,"dummy"
"244827",3,3,0,6,"dummy"
"244828",0,3,0,3,"dummy"
"244829",0,0,1,1,"dummy"
"244830",0,2,0,2,"dummy"
"244831",2,2,0,4,"dummy"
"244832",0,1,0,1,"dummy"
"244664",0,2,0,2,"dummy"
"244668",3,0,0,3,"dummy"
"244673",0,1,1,2,"dummy"
"244674",1,6,1,8,"dummy"
"244675",0,1,0,1,"dummy"
"244676",4,4,0,8,"dummy"
"244677",4,6,0,10,"dummy"
"244678",0,2,1,3,"dummy"
"244679",1,0,6,7,"dummy"
"244680",3,4,0,7,"dummy"
"244681",3,0,0,3,"dummy"
"244682",3,3,0,6,"dummy"
"244683",3,3,0,6,"dummy"
"244684",0,0,2,2,"dummy"
"244685",2,4,1,7,"dummy"
"244686",0,4,0,4,"dummy"
"244687",4,4,0,8,"dummy"
"244688",7,7,1,15,"dummy"
"244689",1,7,0,8,"dummy"
"244690",6,7,0,13,"dummy"
"244691",6,1,1,8,"dummy"
"244692",0,2,0,2,"dummy"
"244693",0,0,1,1,"dummy"
"244694",0,1,0,1,"dummy"
"244695",0,3,0,3,"dummy"
"244724",0,0,1,1,"dummy"
"244725",0,0,1,1,"dummy"
"244726",0,1,0,1,"dummy"
"244727",0,0,1,1,"dummy"
"244748",3,16,1,20,"dummy"
"244751",0,5,0,5,"dummy"
"244752",1,14,2,17,"dummy"
"244753",0,2,4,6,"dummy"
"244754",5,2,0,7,"dummy"
"244800",0,4,0,4,"dummy"
"244821",11,6,2,19,"dummy"
"244822",0,3,2,5,"dummy"
"244823",1,1,3,5,"dummy"
"244824",0,0,0,0,"dummy"
"244834",0,2,1,3,"dummy"
"244835",0,0,1,1,"dummy"
"244845",0,2,0,2,"dummy"
"244846",1,1,0,2,"dummy"
"244847",0,0,0,0,"dummy"
"244852",1,3,1,5,"dummy"
"244858",0,1,3,4,"dummy"
"244864",0,0,6,6,"dummy"
"244865",0,0,6,6,"dummy"
"244866",0,1,6,7,"dummy"
"244837",0,0,0,0,"dummy"
"244838",0,4,0,4,"dummy"
"244839",0,2,0,2,"dummy"
"244840",1,0,0,1,"dummy"
"244841",0,0,0,0,"dummy"
"244849",0,6,0,6,"dummy"
"244850",0,2,0,2,"dummy"
"244854",0,1,0,1,"dummy"
"244855",1,0,0,1,"dummy"
"244856",1,1,0,2,"dummy"
"244860",0,0,1,1,"dummy"
"244861",2,0,1,3,"dummy"
"244862",1,2,0,3,"dummy"
"244872",5,0,2,7,"dummy"
"244873",0,1,0,1,"dummy"
"244874",0,0,1,1,"dummy"
"244875",2,6,0,8,"dummy"
"244876",0,0,1,1,"dummy"
"244877",0,0,1,1,"dummy"
"244878",0,0,1,1,"dummy"
"244882",27,4,3,34,"dummy"
"244885",0,0,0,0,"dummy"
"244886",0,0,0,0,"dummy"
"244888",2,1,1,4,"dummy"
"244889",0,0,1,1,"dummy"
"244892",1,0,0,1,"dummy"
"244894",3,4,0,7,"dummy"
"244895",6,1,2,9,"dummy"
"244905",0,0,1,1,"dummy"
"244907",8,14,4,26,"dummy"
"244908",0,1,0,1,"dummy"
"244909",1,0,1,2,"dummy"
"244910",0,1,1,2,"dummy"
"244912",0,0,1,1,"dummy"
"244914",0,0,0,0,"dummy"
"244916",0,2,0,2,"dummy"
"244919",3,6,1,10,"dummy"
"244922",11,9,1,21,"dummy"
"244928",0,1,2,3,"dummy"
"244929",0,2,1,3,"dummy"
"244933",0,1,0,1,"dummy"
"244935",0,0,0,0,"dummy"
"244937",2,3,0,5,"dummy"
"244939",0,1,0,1,"dummy"
"244940",0,2,0,2,"dummy"
"244941",0,0,1,1,"dummy"
"244942",4,0,0,4,"dummy"
"244943",0,4,1,5,"dummy"
"244956",0,0,0,0,"dummy"
"244957",0,11,0,11,"dummy"
"244959",0,1,1,2,"dummy"
"244966",0,0,2,2,"dummy"
"244967",0,0,1,1,"dummy"
"244968",1,1,0,2,"dummy"
"244969",0,0,1,1,"dummy"
"244970",0,0,1,1,"dummy"
"244971",0,0,1,1,"dummy"
"244973",0,0,0,0,"dummy"
"244974",0,0,0,0,"dummy"
"244975",0,0,1,1,"dummy"
"244976",0,0,0,0,"dummy"
"244978",0,4,0,4,"dummy"
"244983",0,7,0,7,"dummy"
"244984",2,0,0,2,"dummy"
"244985",0,0,1,1,"dummy"
"244988",0,1,0,1,"dummy"
"244989",0,2,0,2,"dummy"
"244991",6,0,0,6,"dummy"
"244992",2,5,2,9,"dummy"
"245002",0,1,0,1,"dummy"
"245003",0,0,1,1,"dummy"
"245004",1,0,0,1,"dummy"
"245007",0,1,0,1,"dummy"
"245008",1,0,0,1,"dummy"
"245010",0,0,1,1,"dummy"
"245011",0,0,1,1,"dummy"
"245012",0,3,0,3,"dummy"
"245013",0,0,1,1,"dummy"
"245014",0,0,1,1,"dummy"
"245016",0,0,1,1,"dummy"
"245019",3,0,0,3,"dummy"
"245020",0,1,0,1,"dummy"
"245021",0,2,0,2,"dummy"
"245022",2,0,0,2,"dummy"
"245023",0,2,0,2,"dummy"
"245026",1,3,0,4,"dummy"
"245027",1,0,1,2,"dummy"
"245028",3,0,3,6,"dummy"
"245029",1,0,0,1,"dummy"
"245031",4,2,0,6,"dummy"
"245032",1,1,0,2,"dummy"
"245033",0,1,0,1,"dummy"
"245034",0,1,0,1,"dummy"
"245035",7,0,1,8,"dummy"
"245036",0,1,0,1,"dummy"
"245037",0,4,0,4,"dummy"
"245038",0,0,1,1,"dummy"
"245039",2,5,0,7,"dummy"
"245040",5,5,0,10,"dummy"
"245041",0,0,0,0,"dummy"
"245042",3,5,0,8,"dummy"
"245043",0,1,0,1,"dummy"
"245044",0,3,0,3,"dummy"
"245045",5,0,0,5,"dummy"
"245047",0,0,1,1,"dummy"
"245048",0,0,2,2,"dummy"
"245049",0,0,1,1,"dummy"
"245050",2,0,2,4,"dummy"
"245053",1,2,0,3,"dummy"
"245055",0,0,1,1,"dummy"
"245061",0,1,0,1,"dummy"
"245062",0,2,0,2,"dummy"
"245063",0,1,0,1,"dummy"
"245064",0,5,0,5,"dummy"
"245065",9,2,0,11,"dummy"
"245066",2,2,0,4,"dummy"
"245070",1,0,1,2,"dummy"
"245072",1,0,0,1,"dummy"
"245073",0,1,0,1,"dummy"
"245074",2,2,2,6,"dummy"
"245075",0,0,1,1,"dummy"
"245076",3,0,1,4,"dummy"
"245077",0,1,0,1,"dummy"
"245079",11,13,4,28,"dummy"
"245080",16,15,12,43,"dummy"
"245081",0,0,0,0,"dummy"
"245082",0,0,0,0,"dummy"
"245085",2,4,1,7,"dummy"
"245087",0,0,0,0,"dummy"
"245089",2,3,2,7,"dummy"
"245090",1,2,0,3,"dummy"
"245091",0,0,0,0,"dummy"
"245092",0,0,0,0,"dummy"
"245093",0,0,0,0,"dummy"
"245094",0,0,0,0,"dummy"
"245095",3,0,0,3,"dummy"
"245096",0,0,0,0,"dummy"
"245158",0,0,1,1,"dummy"
"245159",0,0,1,1,"dummy"
"245160",0,0,1,1,"dummy"
"245161",0,0,1,1,"dummy"
"245162",0,1,0,1,"dummy"
"245163",10,11,0,21,"dummy"
"245164",3,1,0,4,"dummy"
"245165",0,0,1,1,"dummy"
"245178",2,7,2,11,"dummy"
"245179",0,0,1,1,"dummy"
"245214",1,0,6,7,"dummy"
"245215",0,0,1,1,"dummy"
"245216",0,0,1,1,"dummy"
"245336",2,1,1,4,"dummy"
"245337",0,2,0,2,"dummy"
"245353",1,5,0,6,"dummy"
"245354",0,1,0,1,"dummy"
"245355",1,0,0,1,"dummy"
"245356",1,2,0,3,"dummy"
"245361",17,0,1,18,"dummy"
"245362",0,1,0,1,"dummy"
"245363",1,2,1,4,"dummy"
"245364",0,9,0,9,"dummy"
"245365",0,24,3,27,"dummy"
"245366",0,0,0,0,"dummy"
"245367",24,0,0,24,"dummy"
"245368",0,0,3,3,"dummy"
"245376",0,0,0,0,"dummy"
"245377",5,0,2,7,"dummy"
"245378",0,0,0,0,"dummy"
"245381",1,0,0,1,"dummy"
"245098",0,3,0,3,"dummy"
"245099",2,5,1,8,"dummy"
"245100",1,5,1,7,"dummy"
"245103",0,0,1,1,"dummy"
"245104",0,0,0,0,"dummy"
"245105",0,0,0,0,"dummy"
"245167",0,0,4,4,"dummy"
"245181",2,1,1,4,"dummy"
"245182",1,1,0,2,"dummy"
"245183",0,3,1,4,"dummy"
"245184",1,0,0,1,"dummy"
"245185",0,1,0,1,"dummy"
"245186",1,0,0,1,"dummy"
"245187",1,1,0,2,"dummy"
"245188",1,0,0,1,"dummy"
"245189",10,28,2,40,"dummy"
"245190",22,12,8,42,"dummy"
"245191",1,3,0,4,"dummy"
"245192",3,3,0,6,"dummy"
"245193",3,2,0,5,"dummy"
"245194",1,2,1,4,"dummy"
"245195",0,0,3,3,"dummy"
"245196",14,25,6,45,"dummy"
"245197",1,0,0,1,"dummy"
"245200",0,1,4,5,"dummy"
"245203",0,0,1,1,"dummy"
"245204",0,0,1,1,"dummy"
"245205",0,0,2,2,"dummy"
"245206",26,3,7,36,"dummy"
"245220",1,2,0,3,"dummy"
"245234",0,0,2,2,"dummy"
"245243",0,1,0,1,"dummy"
"245246",3,3,1,7,"dummy"
"245247",0,0,1,1,"dummy"
"245250",1,4,0,5,"dummy"
"245255",0,0,1,1,"dummy"
"245329",0,6,0,6,"dummy"
"245332",0,0,2,2,"dummy"
"245346",0,0,1,1,"dummy"
"245347",0,0,1,1,"dummy"
"245348",0,0,1,1,"dummy"
"245349",0,0,0,0,"dummy"
"245350",0,0,1,1,"dummy"
"245351",0,0,1,1,"dummy"
"245358",8,8,4,20,"dummy"
"245359",0,2,0,2,"dummy"
"245374",0,0,0,0,"dummy"
"245385",8,1,4,13,"dummy"
"245386",0,2,0,2,"dummy"
"245387",0,0,1,1,"dummy"
"245388",0,0,1,1,"dummy"
"245389",0,0,1,1,"dummy"
"245390",0,0,1,1,"dummy"
"245391",0,0,2,2,"dummy"
"245392",0,0,1,1,"dummy"
"245393",0,0,3,3,"dummy"
"245394",0,2,0,2,"dummy"
"245407",0,1,0,1,"dummy"
"245418",0,3,0,3,"dummy"
"245419",1,0,0,1,"dummy"
"245424",0,2,0,2,"dummy"
"245425",0,2,0,2,"dummy"
"245426",0,2,0,2,"dummy"
"245427",0,0,3,3,"dummy"
"245382",0,1,0,1,"dummy"
"245383",0,1,0,1,"dummy"
"245396",6,4,2,12,"dummy"
"245397",2,3,2,7,"dummy"
"245398",6,0,3,9,"dummy"
"245399",1,11,1,13,"dummy"
"245400",5,0,1,6,"dummy"
"245401",0,0,0,0,"dummy"
"245402",1,0,0,1,"dummy"
"245403",0,0,0,0,"dummy"
"245404",0,2,0,2,"dummy"
"245405",1,0,0,1,"dummy"
"245409",0,1,0,1,"dummy"
"245410",0,1,0,1,"dummy"
"245411",0,1,0,1,"dummy"
"245416",0,1,0,1,"dummy"
"245431",3,3,2,8,"dummy"
"245432",3,1,0,4,"dummy"
"245433",0,0,1,1,"dummy"
"245453",5,18,2,25,"dummy"
"245475",0,0,0,0,"dummy"
"245490",0,0,0,0,"dummy"
"245491",0,0,0,0,"dummy"
"245496",0,3,0,3,"dummy"
"245497",0,1,0,1,"dummy"
"245498",0,1,0,1,"dummy"
"245499",1,2,0,3,"dummy"
"245500",0,1,0,1,"dummy"
"245501",0,0,1,1,"dummy"
"245504",0,0,1,1,"dummy"
"245507",0,5,1,6,"dummy"
"245508",10,23,4,37,"dummy"
"245509",2,1,0,3,"dummy"
"245542",0,1,0,1,"dummy"
"245543",0,0,1,1,"dummy"
"245544",0,2,0,2,"dummy"
"245545",0,0,1,1,"dummy"
"245546",0,1,0,1,"dummy"
"245547",0,0,0,0,"dummy"
"245548",0,3,0,3,"dummy"
"245549",3,0,1,4,"dummy"
"245550",0,3,0,3,"dummy"
"245557",0,3,0,3,"dummy"
"245577",0,0,0,0,"dummy"
"245578",11,3,4,18,"dummy"
"245589",0,6,0,6,"dummy"
"245590",6,0,2,8,"dummy"
"245600",0,0,1,1,"dummy"
"245601",0,1,0,1,"dummy"
"245604",0,0,1,1,"dummy"
"245605",4,2,1,7,"dummy"
"245606",0,0,1,1,"dummy"
"245611",16,3,2,21,"dummy"
"245612",0,0,1,1,"dummy"
"245613",1,0,1,2,"dummy"
"245614",1,0,1,2,"dummy"
"245615",0,0,1,1,"dummy"
"245633",0,0,1,1,"dummy"
"245634",10,0,0,10,"dummy"
"245635",0,10,0,10,"dummy"
"245636",0,0,1,1,"dummy"
"245639",2,2,0,4,"dummy"
"245640",0,0,1,1,"dummy"
"245645",0,0,4,4,"dummy"
"245646",0,1,0,1,"dummy"
"245647",6,6,2,14,"dummy"
"245648",1,6,0,7,"dummy"
"245649",5,7,0,12,"dummy"
"245650",6,2,2,10,"dummy"
"245651",0,1,0,1,"dummy"
"245652",0,1,0,1,"dummy"
"245670",0,0,2,2,"dummy"
"245671",1,0,0,1,"dummy"
"245462",2,11,1,14,"dummy"
"245463",0,0,2,2,"dummy"
"245464",20,2,1,23,"dummy"
"245465",2,0,0,2,"dummy"
"245466",0,2,1,3,"dummy"
"245467",0,0,1,1,"dummy"
"245468",0,1,0,1,"dummy"
"245469",0,0,1,1,"dummy"
"245470",0,3,0,3,"dummy"
"245471",3,1,0,4,"dummy"
"245472",2,0,0,2,"dummy"
"245473",1,0,0,1,"dummy"
"245477",0,0,1,1,"dummy"
"245478",0,2,0,2,"dummy"
"245481",0,0,0,0,"dummy"
"245484",0,0,1,1,"dummy"
"245485",27,23,1,51,"dummy"
"245486",4,0,0,4,"dummy"
"245487",6,9,5,20,"dummy"
"245488",2,6,1,9,"dummy"
"245513",0,0,1,1,"dummy"
"245514",0,0,1,1,"dummy"
"245515",0,0,2,2,"dummy"
"245516",0,0,1,1,"dummy"
"245517",0,0,1,1,"dummy"
"245518",0,2,0,2,"dummy"
"245519",0,1,0,1,"dummy"
"245520",1,0,1,2,"dummy"
"245521",0,1,0,1,"dummy"
"245522",0,0,1,1,"dummy"
"245523",0,1,0,1,"dummy"
"245524",0,1,0,1,"dummy"
"245525",2,2,0,4,"dummy"
"245526",0,0,0,0,"dummy"
"245527",0,0,0,0,"dummy"
"245528",0,2,0,2,"dummy"
"245529",6,1,0,7,"dummy"
"245530",1,0,0,1,"dummy"
"245531",0,0,0,0,"dummy"
"245532",3,21,1,25,"dummy"
"245533",0,0,0,0,"dummy"
"245534",7,0,0,7,"dummy"
"245535",5,4,0,9,"dummy"
"245536",0,0,0,0,"dummy"
"245537",0,0,0,0,"dummy"
"245538",0,0,0,0,"dummy"
"245539",1,0,0,1,"dummy"
"245540",2,0,0,2,"dummy"
"245617",0,0,1,1,"dummy"
"245618",0,0,0,0,"dummy"
"245619",0,1,0,1,"dummy"
"245620",0,0,2,2,"dummy"
"245621",3,3,1,7,"dummy"
"245622",0,0,0,0,"dummy"
"245623",0,0,0,0,"dummy"
"245624",0,0,1,1,"dummy"
"245625",0,0,1,1,"dummy"
"245654",0,6,0,6,"dummy"
"245655",1,11,0,12,"dummy"
"245656",0,1,0,1,"dummy"
"245657",1,5,0,6,"dummy"
"245658",0,1,0,1,"dummy"
"245659",0,3,0,3,"dummy"
"245660",21,2,2,25,"dummy"
"245661",1,0,0,1,"dummy"
"245662",1,16,0,17,"dummy"
"245663",0,3,0,3,"dummy"
"245664",1,3,0,4,"dummy"
"245665",2,0,0,2,"dummy"
"245666",0,1,0,1,"dummy"
"245667",0,2,0,2,"dummy"
"245668",0,1,0,1,"dummy"
"245688",2,2,1,5,"dummy"
"245689",1,2,0,3,"dummy"
"245690",6,0,1,7,"dummy"
"245691",3,1,0,4,"dummy"
"245692",0,1,1,2,"dummy"
"245693",1,0,0,1,"dummy"
"245698",0,1,0,1,"dummy"
"245699",1,1,0,2,"dummy"
"245700",0,0,1,1,"dummy"
"245706",0,0,1,1,"dummy"
"245709",0,1,1,2,"dummy"
"245714",2,7,3,12,"dummy"
"245715",5,1,0,6,"dummy"
"245732",0,0,0,0,"dummy"
"245735",0,0,1,1,"dummy"
"245745",0,0,1,1,"dummy"
"245746",0,1,0,1,"dummy"
"245760",10,3,3,16,"dummy"
"245761",1,2,2,5,"dummy"
"245762",0,0,1,1,"dummy"
"245763",0,0,1,1,"dummy"
"245764",3,2,0,5,"dummy"
"245765",0,1,0,1,"dummy"
"245766",0,2,0,2,"dummy"
"245767",2,4,1,7,"dummy"
"245768",4,3,0,7,"dummy"
"245769",3,0,2,5,"dummy"
"245770",0,0,1,1,"dummy"
"245771",0,2,3,5,"dummy"
"245772",2,0,3,5,"dummy"
"245803",0,0,0,0,"dummy"
"245811",1,4,0,5,"dummy"
"245812",4,5,1,10,"dummy"
"245813",0,1,0,1,"dummy"
"245814",0,0,1,1,"dummy"
"245815",0,0,1,1,"dummy"
"245816",10,11,5,26,"dummy"
"245817",0,1,0,1,"dummy"
"245818",0,0,1,1,"dummy"
"245819",0,0,1,1,"dummy"
"245820",0,0,1,1,"dummy"
"245821",14,3,2,19,"dummy"
"245822",0,2,1,3,"dummy"
"245823",0,1,0,1,"dummy"
"245824",0,1,0,1,"dummy"
"245825",0,1,1,2,"dummy"
"245826",0,0,3,3,"dummy"
"245827",0,0,1,1,"dummy"
"245828",0,1,0,1,"dummy"
"245829",0,1,0,1,"dummy"
"245830",0,0,1,1,"dummy"
"245831",0,0,1,1,"dummy"
"245832",0,0,2,2,"dummy"
"245833",0,0,2,2,"dummy"
"245834",0,0,1,1,"dummy"
"245835",0,0,1,1,"dummy"
"245836",0,0,1,1,"dummy"
"245837",0,0,1,1,"dummy"
"245838",0,0,1,1,"dummy"
"245839",0,0,3,3,"dummy"
"245840",0,0,2,2,"dummy"
"245841",3,1,0,4,"dummy"
"245842",0,0,1,1,"dummy"
"245843",0,0,1,1,"dummy"
"245844",0,6,0,6,"dummy"
"245845",0,0,0,0,"dummy"
"245846",0,0,1,1,"dummy"
"245847",0,0,0,0,"dummy"
"245848",0,0,1,1,"dummy"
"245849",0,0,1,1,"dummy"
"245672",0,0,0,0,"dummy"
"245677",7,3,0,10,"dummy"
"245678",2,3,0,5,"dummy"
"245679",0,1,0,1,"dummy"
"245684",23,3,15,41,"dummy"
"245685",0,0,2,2,"dummy"
"245686",2,0,0,2,"dummy"
"245711",0,0,1,1,"dummy"
"245712",0,0,1,1,"dummy"
"245725",0,2,0,2,"dummy"
"245728",1,1,2,4,"dummy"
"245729",1,1,2,4,"dummy"
"245730",0,0,1,1,"dummy"
"245737",1,0,1,2,"dummy"
"245738",0,0,1,1,"dummy"
"245739",2,4,0,6,"dummy"
"245748",0,9,0,9,"dummy"
"245749",0,2,5,7,"dummy"
"245750",0,0,3,3,"dummy"
"245751",8,0,0,8,"dummy"
"245752",0,7,0,7,"dummy"
"245753",4,0,1,5,"dummy"
"245756",4,4,0,8,"dummy"
"245757",1,19,0,20,"dummy"
"245758",1,0,0,1,"dummy"
"245774",0,21,0,21,"dummy"
"245775",0,1,6,7,"dummy"
"245776",0,0,7,7,"dummy"
"245777",0,1,0,1,"dummy"
"245778",0,1,0,1,"dummy"
"245779",0,0,1,1,"dummy"
"245799",1,0,0,1,"dummy"
"245800",0,1,0,1,"dummy"
"245801",0,0,1,1,"dummy"
"245805",2,2,0,4,"dummy"
"245806",0,0,1,1,"dummy"
"245807",10,3,2,15,"dummy"
"245851",0,0,0,0,"dummy"
"245852",0,1,0,1,"dummy"
"245853",2,0,2,4,"dummy"
"245857",0,6,0,6,"dummy"
"245858",6,0,0,6,"dummy"
"245859",0,5,0,5,"dummy"
"245860",5,0,0,5,"dummy"
"245861",0,5,0,5,"dummy"
"245862",5,0,0,5,"dummy"
"245863",0,5,0,5,"dummy"
"245864",2,0,0,2,"dummy"
"245865",0,2,0,2,"dummy"
"245866",0,1,0,1,"dummy"
"245867",0,8,0,8,"dummy"
"245868",8,0,0,8,"dummy"
"245902",0,0,1,1,"dummy"
"245977",0,1,0,1,"dummy"
"245978",2,0,2,4,"dummy"
"245979",0,5,0,5,"dummy"
"245984",0,0,0,0,"dummy"
"245985",0,0,0,0,"dummy"
"245988",0,0,2,2,"dummy"
"245989",4,3,2,9,"dummy"
"245990",0,0,1,1,"dummy"
"245991",2,2,0,4,"dummy"
"245992",1,1,0,2,"dummy"
"245993",0,0,0,0,"dummy"
"245999",1,1,2,4,"dummy"
"246025",0,9,0,9,"dummy"
"246026",0,2,0,2,"dummy"
"246027",0,0,1,1,"dummy"
"246028",6,0,0,6,"dummy"
"245870",0,0,0,0,"dummy"
"245871",0,8,1,9,"dummy"
"245872",0,1,1,2,"dummy"
"245873",0,0,0,0,"dummy"
"245874",0,0,1,1,"dummy"
"245875",0,0,0,0,"dummy"
"245876",5,4,1,10,"dummy"
"245877",3,8,0,11,"dummy"
"245878",0,0,1,1,"dummy"
"245879",0,4,0,4,"dummy"
"245880",0,0,0,0,"dummy"
"245881",0,1,0,1,"dummy"
"245882",0,0,0,0,"dummy"
"245885",0,1,0,1,"dummy"
"245886",0,0,1,1,"dummy"
"245887",1,2,0,3,"dummy"
"245888",0,0,2,2,"dummy"
"245889",0,0,7,7,"dummy"
"245890",0,0,7,7,"dummy"
"245891",0,0,7,7,"dummy"
"245892",0,0,7,7,"dummy"
"245893",0,5,7,12,"dummy"
"245894",0,0,2,2,"dummy"
"245895",0,0,2,2,"dummy"
"245896",0,0,2,2,"dummy"
"245897",0,0,2,2,"dummy"
"245898",0,0,2,2,"dummy"
"245899",0,0,2,2,"dummy"
"245900",0,1,3,4,"dummy"
"245971",0,0,1,1,"dummy"
"245995",0,1,0,1,"dummy"
"245996",0,0,1,1,"dummy"
"245997",0,0,1,1,"dummy"
"246001",1,1,0,2,"dummy"
"246002",0,2,0,2,"dummy"
"246003",0,1,0,1,"dummy"
"246004",3,0,0,3,"dummy"
"246005",0,1,1,2,"dummy"
"246006",1,1,1,3,"dummy"
"246007",0,0,0,0,"dummy"
"246008",0,0,2,2,"dummy"
"246009",0,0,0,0,"dummy"
"246029",0,0,0,0,"dummy"
"246030",0,0,0,0,"dummy"
"246031",0,0,0,0,"dummy"
"246032",0,0,0,0,"dummy"
"246033",0,0,0,0,"dummy"
"246034",0,0,0,0,"dummy"
"246035",0,0,0,0,"dummy"
"246036",0,0,0,0,"dummy"
"246037",0,0,0,0,"dummy"
"246038",0,0,0,0,"dummy"
"246039",0,7,0,7,"dummy"
"246040",1,0,0,1,"dummy"
"246041",0,0,0,0,"dummy"
"246042",0,0,0,0,"dummy"
"246047",2,0,0,2,"dummy"
"246048",3,5,0,8,"dummy"
"246049",0,10,0,10,"dummy"
"246050",0,1,0,1,"dummy"
"246051",2,2,3,7,"dummy"
"246052",0,5,1,6,"dummy"
"246053",0,2,0,2,"dummy"
"246072",6,3,2,11,"dummy"
"246073",0,0,2,2,"dummy"
"246074",0,0,1,1,"dummy"
"246079",0,1,0,1,"dummy"
"246084",0,1,0,1,"dummy"
"246094",0,1,0,1,"dummy"
"246095",1,1,0,2,"dummy"
"246096",0,0,1,1,"dummy"
"246097",0,0,0,0,"dummy"
"246098",0,1,0,1,"dummy"
"246099",1,0,0,1,"dummy"
"246100",1,1,0,2,"dummy"
"246101",0,0,1,1,"dummy"
"246104",1,7,2,10,"dummy"
"246105",0,0,2,2,"dummy"
"246106",5,6,0,11,"dummy"
"246107",0,1,1,2,"dummy"
"246108",4,3,1,8,"dummy"
"246109",11,10,0,21,"dummy"
"246110",0,0,1,1,"dummy"
"246111",1,1,0,2,"dummy"
"246112",9,2,1,12,"dummy"
"246113",2,1,0,3,"dummy"
"246126",3,0,0,3,"dummy"
"246127",0,1,0,1,"dummy"
"246128",0,4,1,5,"dummy"
"246129",0,0,1,1,"dummy"
"246132",0,1,0,1,"dummy"
"246133",0,1,0,1,"dummy"
"246134",0,2,1,3,"dummy"
"246135",0,1,0,1,"dummy"
"246144",0,0,1,1,"dummy"
"246145",2,2,0,4,"dummy"
"246146",2,2,0,4,"dummy"
"246147",0,1,0,1,"dummy"
"246148",0,2,0,2,"dummy"
"246149",0,0,1,1,"dummy"
"246166",3,1,0,4,"dummy"
"246167",0,0,0,0,"dummy"
"246168",0,5,0,5,"dummy"
"246169",0,2,0,2,"dummy"
"246178",2,3,5,10,"dummy"
"246184",0,0,2,2,"dummy"
"246185",0,0,3,3,"dummy"
"246253",2,3,0,5,"dummy"
"246264",0,1,1,2,"dummy"
"246265",0,0,3,3,"dummy"
"246266",0,0,1,1,"dummy"
"246267",1,1,0,2,"dummy"
"246268",1,1,0,2,"dummy"
"246269",0,0,1,1,"dummy"
"246276",0,1,0,1,"dummy"
"246081",6,0,0,6,"dummy"
"246082",2,5,2,9,"dummy"
"246086",0,0,2,2,"dummy"
"246087",0,0,0,0,"dummy"
"246088",0,1,4,5,"dummy"
"246089",0,2,0,2,"dummy"
"246090",0,1,0,1,"dummy"
"246115",0,4,1,5,"dummy"
"246116",0,0,1,1,"dummy"
"246117",1,0,0,1,"dummy"
"246120",0,1,0,1,"dummy"
"246121",0,0,1,1,"dummy"
"246122",0,0,1,1,"dummy"
"246123",0,0,1,1,"dummy"
"246124",0,0,1,1,"dummy"
"246151",1,2,1,4,"dummy"
"246152",2,2,0,4,"dummy"
"246153",3,2,2,7,"dummy"
"246159",0,1,1,2,"dummy"
"246162",0,1,0,1,"dummy"
"246171",0,0,2,2,"dummy"
"246172",1,1,1,3,"dummy"
"246173",3,1,0,4,"dummy"
"246176",6,3,2,11,"dummy"
"246180",0,1,0,1,"dummy"
"246181",0,2,2,4,"dummy"
"246182",0,1,0,1,"dummy"
"246197",1,10,1,12,"dummy"
"246198",0,1,0,1,"dummy"
"246199",0,0,1,1,"dummy"
"246200",0,0,2,2,"dummy"
"246201",0,0,1,1,"dummy"
"246255",0,6,2,8,"dummy"
"246256",7,9,1,17,"dummy"
"246257",1,0,1,2,"dummy"
"246258",1,1,0,2,"dummy"
"246261",0,1,1,2,"dummy"
"246262",0,0,0,0,"dummy"
"246287",0,0,1,1,"dummy"
"246289",0,3,0,3,"dummy"
"246290",0,0,2,2,"dummy"
"246294",3,3,0,6,"dummy"
"246303",0,0,1,1,"dummy"
"246304",0,1,0,1,"dummy"
"246305",0,4,0,4,"dummy"
"246306",5,5,1,11,"dummy"
"246308",0,1,0,1,"dummy"
"246309",1,0,0,1,"dummy"
"246310",0,2,0,2,"dummy"
"246311",1,4,0,5,"dummy"
"246312",0,1,0,1,"dummy"
"246313",5,3,3,11,"dummy"
"246315",2,4,1,7,"dummy"
"246317",6,0,0,6,"dummy"
"246318",0,0,1,1,"dummy"
"246319",0,0,1,1,"dummy"
"246321",0,1,0,1,"dummy"
"246324",0,0,1,1,"dummy"
"246325",1,2,0,3,"dummy"
"246328",0,0,0,0,"dummy"
"246329",1,2,0,3,"dummy"
"246330",0,1,0,1,"dummy"
"246331",4,0,1,5,"dummy"
"246332",0,0,1,1,"dummy"
"246333",1,0,0,1,"dummy"
"246334",2,0,0,2,"dummy"
"246338",1,5,0,6,"dummy"
"246339",0,0,1,1,"dummy"
"246340",6,6,0,12,"dummy"
"246341",1,1,2,4,"dummy"
"246342",2,10,0,12,"dummy"
"246343",4,5,0,9,"dummy"
"246344",0,2,0,2,"dummy"
"246345",0,0,1,1,"dummy"
"246346",0,0,2,2,"dummy"
"246347",0,0,1,1,"dummy"
"246348",0,0,1,1,"dummy"
"246349",2,4,1,7,"dummy"
"246350",0,0,1,1,"dummy"
"246351",0,0,1,1,"dummy"
"246352",0,1,0,1,"dummy"
"246353",1,0,1,2,"dummy"
"246354",0,0,1,1,"dummy"
"246355",4,2,0,6,"dummy"
"246358",2,0,0,2,"dummy"
"246359",0,0,1,1,"dummy"
"246360",0,0,0,0,"dummy"
"246361",0,0,0,0,"dummy"
"246362",0,0,1,1,"dummy"
"246363",0,0,1,1,"dummy"
"246364",0,3,1,4,"dummy"
"246365",3,0,1,4,"dummy"
"246366",0,0,1,1,"dummy"
"246367",0,1,0,1,"dummy"
"246368",0,0,1,1,"dummy"
"246369",0,0,1,1,"dummy"
"246370",6,5,0,11,"dummy"
"246371",0,6,0,6,"dummy"
"246372",2,1,2,5,"dummy"
"246373",0,0,1,1,"dummy"
"246381",0,1,0,1,"dummy"
"246382",1,2,0,3,"dummy"
"246383",0,2,0,2,"dummy"
"246384",0,1,0,1,"dummy"
"246386",0,0,3,3,"dummy"
"246389",0,0,1,1,"dummy"
"246390",0,0,1,1,"dummy"
"246391",0,0,2,2,"dummy"
"246392",26,3,7,36,"dummy"
"246395",0,0,1,1,"dummy"
"246396",2,2,2,6,"dummy"
"246400",0,5,1,6,"dummy"
"246401",0,0,0,0,"dummy"
"246402",6,3,0,9,"dummy"
"246405",0,3,0,3,"dummy"
"246406",0,4,0,4,"dummy"
"246408",0,2,1,3,"dummy"
"246409",0,0,1,1,"dummy"
"246413",0,0,1,1,"dummy"
"246415",0,1,0,1,"dummy"
"246416",0,2,0,2,"dummy"
"246417",4,5,0,9,"dummy"
"246418",0,1,0,1,"dummy"
"246419",1,0,3,4,"dummy"
"246420",0,2,0,2,"dummy"
"246421",0,0,1,1,"dummy"
"246426",1,4,1,6,"dummy"
"246427",7,15,1,23,"dummy"
"246428",0,1,0,1,"dummy"
"246429",2,2,0,4,"dummy"
"246430",0,0,0,0,"dummy"
"246433",0,2,0,2,"dummy"
"246436",4,1,1,6,"dummy"
"246437",0,0,0,0,"dummy"
"246438",0,0,1,1,"dummy"
"246439",0,0,1,1,"dummy"
"246440",0,1,0,1,"dummy"
"246442",0,0,0,0,"dummy"
"246454",0,1,0,1,"dummy"
"246455",1,2,0,3,"dummy"
"246456",3,3,0,6,"dummy"
"246457",1,2,0,3,"dummy"
"246459",7,10,2,19,"dummy"
"246461",0,0,1,1,"dummy"
"246462",0,0,1,1,"dummy"
"246463",0,8,0,8,"dummy"
"246464",0,0,2,2,"dummy"
"246466",0,0,1,1,"dummy"
"246467",0,0,1,1,"dummy"
"246469",0,0,1,1,"dummy"
"246470",0,0,1,1,"dummy"
"246471",0,0,2,2,"dummy"
"246472",26,3,7,36,"dummy"
"246474",1,2,0,3,"dummy"
"246475",0,1,0,1,"dummy"
"246476",0,1,0,1,"dummy"
"246484",3,0,3,6,"dummy"
"246485",0,0,1,1,"dummy"
"246486",1,0,0,1,"dummy"
"246487",0,0,1,1,"dummy"
"246488",0,0,1,1,"dummy"
"246493",4,4,0,8,"dummy"
"246495",0,0,2,2,"dummy"
"246496",0,1,0,1,"dummy"
"246511",2,4,0,6,"dummy"
"246512",0,2,0,2,"dummy"
"246513",0,2,0,2,"dummy"
"246514",10,2,0,12,"dummy"
"246515",0,2,0,2,"dummy"
"246517",0,1,0,1,"dummy"
"246518",0,1,0,1,"dummy"
"246520",0,0,2,2,"dummy"
"246521",0,0,1,1,"dummy"
"246522",0,0,1,1,"dummy"
"246523",0,0,1,1,"dummy"
"246524",0,0,1,1,"dummy"
"246525",1,0,1,2,"dummy"
"246526",0,0,1,1,"dummy"
"246527",0,0,2,2,"dummy"
"246528",0,0,1,1,"dummy"
"246529",0,1,3,4,"dummy"
"246530",0,0,1,1,"dummy"
"246531",0,0,1,1,"dummy"
"246532",0,0,1,1,"dummy"
"246533",0,0,1,1,"dummy"
"246534",0,0,1,1,"dummy"
"246535",0,0,1,1,"dummy"
"246536",0,0,1,1,"dummy"
"246537",0,0,1,1,"dummy"
"246538",0,0,1,1,"dummy"
"246539",0,0,1,1,"dummy"
"246540",0,0,1,1,"dummy"
"246541",0,0,1,1,"dummy"
"246542",0,0,1,1,"dummy"
"246543",0,0,1,1,"dummy"
"246544",0,0,1,1,"dummy"
"246545",0,0,1,1,"dummy"
"246546",0,0,1,1,"dummy"
"246547",0,0,1,1,"dummy"
"246548",0,0,1,1,"dummy"
"246549",0,0,1,1,"dummy"
"246550",0,0,1,1,"dummy"
"246551",0,0,1,1,"dummy"
"246552",0,0,1,1,"dummy"
"246553",0,0,1,1,"dummy"
"246554",0,0,1,1,"dummy"
"246555",0,0,1,1,"dummy"
"246556",0,0,1,1,"dummy"
"246557",0,0,1,1,"dummy"
"246558",0,0,1,1,"dummy"
"246559",0,0,1,1,"dummy"
"246560",0,0,1,1,"dummy"
"246561",0,0,1,1,"dummy"
"246562",0,0,1,1,"dummy"
"246563",0,0,1,1,"dummy"
"246564",0,0,1,1,"dummy"
"246565",0,0,1,1,"dummy"
"246566",0,0,1,1,"dummy"
"246567",0,0,1,1,"dummy"
"246568",0,0,1,1,"dummy"
"246569",0,0,1,1,"dummy"
"246570",0,0,1,1,"dummy"
"246572",0,0,1,1,"dummy"
"246574",0,2,0,2,"dummy"
"246575",0,2,0,2,"dummy"
"246576",0,3,0,3,"dummy"
"246577",1,5,0,6,"dummy"
"246578",0,1,0,1,"dummy"
"246582",0,0,1,1,"dummy"
"246586",0,0,0,0,"dummy"
"246589",1,0,0,1,"dummy"
"246591",0,0,1,1,"dummy"
"246592",0,0,1,1,"dummy"
"246593",0,2,0,2,"dummy"
"246595",0,1,0,1,"dummy"
"246596",0,1,0,1,"dummy"
"246602",3,9,2,14,"dummy"
"246603",0,0,0,0,"dummy"
"246604",0,0,3,3,"dummy"
"246605",0,1,0,1,"dummy"
"246606",1,1,0,2,"dummy"
"246607",0,1,0,1,"dummy"
"246608",1,0,2,3,"dummy"
"246609",1,7,2,10,"dummy"
"246610",7,1,2,10,"dummy"
"246611",11,2,0,13,"dummy"
"246612",2,11,0,13,"dummy"
"246614",0,5,1,6,"dummy"
"246615",0,0,1,1,"dummy"
"246616",0,2,0,2,"dummy"
"246621",0,0,1,1,"dummy"
"246627",0,1,0,1,"dummy"
"246628",2,1,0,3,"dummy"
"246629",0,0,1,1,"dummy"
"246630",0,2,0,2,"dummy"
"246631",0,1,0,1,"dummy"
"246632",3,3,1,7,"dummy"
"246633",2,0,0,2,"dummy"
"246634",1,4,1,6,"dummy"
"246635",1,4,0,5,"dummy"
"246636",0,1,0,1,"dummy"
"246637",1,0,0,1,"dummy"
"246638",0,1,0,1,"dummy"
"246646",0,0,0,0,"dummy"
"246650",1,4,2,7,"dummy"
"246651",0,0,1,1,"dummy"
"246652",6,0,4,10,"dummy"
"246653",0,0,1,1,"dummy"
"246654",1,0,1,2,"dummy"
"246655",0,0,0,0,"dummy"
"246656",0,0,0,0,"dummy"
"246657",7,11,4,22,"dummy"
"246658",5,0,5,10,"dummy"
"246659",0,5,7,12,"dummy"
"246660",5,0,5,10,"dummy"
"246661",0,2,1,3,"dummy"
"246670",0,0,1,1,"dummy"
"246672",17,14,1,32,"dummy"
"246673",0,0,0,0,"dummy"
"246675",0,1,0,1,"dummy"
"246678",0,0,0,0,"dummy"
"246679",0,0,0,0,"dummy"
"246680",0,0,1,1,"dummy"
"246681",0,0,0,0,"dummy"
"246682",1,0,0,1,"dummy"
"246684",0,1,0,1,"dummy"
"246685",4,2,0,6,"dummy"
"246686",1,1,0,2,"dummy"
"246687",0,0,0,0,"dummy"
"246703",3,48,1,52,"dummy"
"246704",4,0,0,4,"dummy"
"246705",2,0,1,3,"dummy"
"246706",0,2,0,2,"dummy"
"246707",0,1,0,1,"dummy"
"246709",0,3,0,3,"dummy"
"246710",0,0,1,1,"dummy"
"246712",1,1,1,3,"dummy"
"246713",1,3,0,4,"dummy"
"246714",0,0,1,1,"dummy"
"246715",0,1,0,1,"dummy"
"246716",1,1,1,3,"dummy"
"246721",8,9,1,18,"dummy"
"246722",9,8,1,18,"dummy"
"246724",0,2,0,2,"dummy"
"246725",0,5,0,5,"dummy"
"246728",6,2,3,11,"dummy"
"246729",1,1,1,3,"dummy"
"246730",0,3,1,4,"dummy"
"246731",0,0,2,2,"dummy"
"246732",1,1,0,2,"dummy"
"246733",1,0,0,1,"dummy"
"246735",0,5,0,5,"dummy"
"246736",0,1,0,1,"dummy"
"246737",0,1,0,1,"dummy"
"246738",0,1,0,1,"dummy"
"246739",0,0,1,1,"dummy"
"246740",0,1,0,1,"dummy"
"246741",5,8,3,16,"dummy"
"246742",0,5,2,7,"dummy"
"246743",0,0,1,1,"dummy"
"246744",0,1,0,1,"dummy"
"246745",0,0,1,1,"dummy"
"246746",0,1,0,1,"dummy"
"246748",0,0,1,1,"dummy"
"246752",0,1,0,1,"dummy"
"246753",5,5,0,10,"dummy"
"246756",1,1,0,2,"dummy"
"246757",0,4,4,8,"dummy"
"246758",0,1,0,1,"dummy"
"246759",1,4,1,6,"dummy"
"246761",0,0,1,1,"dummy"
"246762",1,0,2,3,"dummy"
"246763",1,4,3,8,"dummy"
"246764",0,1,0,1,"dummy"
"246779",0,0,1,1,"dummy"
"246780",0,0,1,1,"dummy"
"246781",0,0,2,2,"dummy"
"246782",26,3,7,36,"dummy"
"246784",0,1,0,1,"dummy"
"246785",0,0,2,2,"dummy"
"246786",0,1,0,1,"dummy"
"246788",0,3,1,4,"dummy"
"246789",2,8,2,12,"dummy"
"246790",1,1,0,2,"dummy"
"246802",0,0,0,0,"dummy"
"246803",0,1,0,1,"dummy"
"246804",0,0,0,0,"dummy"
"246806",0,0,0,0,"dummy"
"246832",1,1,0,2,"dummy"
"246833",5,2,0,7,"dummy"
"246835",6,1,0,7,"dummy"
"246836",1,2,0,3,"dummy"
"246837",1,1,0,2,"dummy"
"246838",1,1,0,2,"dummy"
"246839",0,1,0,1,"dummy"
"246840",0,1,0,1,"dummy"
"246841",0,1,0,1,"dummy"
"246842",0,3,0,3,"dummy"
"246849",0,0,0,0,"dummy"
"246850",0,0,0,0,"dummy"
"246852",3,10,0,13,"dummy"
"246858",0,1,0,1,"dummy"
"246860",0,0,1,1,"dummy"
"246861",0,0,1,1,"dummy"
"246873",1,0,0,1,"dummy"
"246875",0,3,1,4,"dummy"
"246876",0,0,2,2,"dummy"
"246877",0,2,1,3,"dummy"
"246878",0,1,0,1,"dummy"
"246879",1,1,2,4,"dummy"
"246880",0,0,1,1,"dummy"
"246882",0,1,0,1,"dummy"
"246883",6,3,1,10,"dummy"
"246884",0,0,0,0,"dummy"
"246885",0,0,0,0,"dummy"
"246886",0,0,0,0,"dummy"
"246887",0,2,1,3,"dummy"
"246888",2,1,1,4,"dummy"
"246889",1,0,0,1,"dummy"
"246890",1,0,3,4,"dummy"
"246891",1,0,1,2,"dummy"
"246892",0,0,1,1,"dummy"
"246893",0,0,1,1,"dummy"
"246895",0,0,1,1,"dummy"
"246897",0,0,1,1,"dummy"
"246898",0,0,0,0,"dummy"
"246900",0,2,0,2,"dummy"
"246901",0,0,1,1,"dummy"
"246902",0,0,1,1,"dummy"
"246903",0,0,1,1,"dummy"
"246904",10,2,0,12,"dummy"
"246905",2,10,0,12,"dummy"
"246906",0,1,1,2,"dummy"
"246907",0,1,0,1,"dummy"
"246909",0,1,0,1,"dummy"
"246911",0,2,1,3,"dummy"
"246912",0,0,1,1,"dummy"
"246915",0,24,2,26,"dummy"
"246916",2,2,0,4,"dummy"
"246917",2,2,0,4,"dummy"
"246919",0,0,1,1,"dummy"
"246923",0,2,1,3,"dummy"
"246924",0,8,0,8,"dummy"
"246925",0,1,0,1,"dummy"
"246926",0,9,0,9,"dummy"
"246927",0,0,1,1,"dummy"
"246928",4,1,1,6,"dummy"
"246929",0,3,0,3,"dummy"
"246930",4,3,1,8,"dummy"
"246935",3,1,0,4,"dummy"
"246936",0,1,0,1,"dummy"
"246937",0,2,0,2,"dummy"
"246938",0,2,0,2,"dummy"
"246939",0,1,0,1,"dummy"
"246940",0,1,0,1,"dummy"
"246941",0,0,1,1,"dummy"
"246943",0,2,1,3,"dummy"
"246944",1,0,1,2,"dummy"
"246947",0,1,0,1,"dummy"
"246948",0,4,0,4,"dummy"
"246949",0,1,0,1,"dummy"
"246953",0,1,0,1,"dummy"
"246954",1,0,0,1,"dummy"
"246955",0,5,0,5,"dummy"
"246956",0,3,0,3,"dummy"
"246957",0,0,1,1,"dummy"
"246958",0,3,0,3,"dummy"
"246960",0,4,0,4,"dummy"
"246983",0,0,1,1,"dummy"
"246984",0,1,0,1,"dummy"
"246985",0,0,1,1,"dummy"
"246986",0,3,0,3,"dummy"
"246987",0,0,1,1,"dummy"
"246988",0,0,1,1,"dummy"
"246989",0,0,1,1,"dummy"
"246990",0,8,0,8,"dummy"
"246991",8,0,0,8,"dummy"
"246992",1,11,8,20,"dummy"
"246993",0,4,0,4,"dummy"
"246995",2,1,1,4,"dummy"
"246996",16,0,3,19,"dummy"
"246997",0,0,1,1,"dummy"
"246999",0,0,2,2,"dummy"
"247000",3,10,2,15,"dummy"
"247001",3,2,1,6,"dummy"
"247002",1,0,1,2,"dummy"
"247003",0,2,1,3,"dummy"
"247004",0,0,1,1,"dummy"
"247005",0,0,1,1,"dummy"
"247006",0,0,1,1,"dummy"
"247009",0,1,0,1,"dummy"
"247018",0,0,1,1,"dummy"
"247019",1,1,0,2,"dummy"
"247022",0,1,0,1,"dummy"
"247024",12,17,1,30,"dummy"
"247028",0,1,0,1,"dummy"
"247057",2,5,2,9,"dummy"
"247059",0,4,0,4,"dummy"
"247060",2,6,0,8,"dummy"
"247061",0,4,0,4,"dummy"
"247068",0,0,2,2,"dummy"
"247071",0,0,2,2,"dummy"
"247072",4,1,4,9,"dummy"
"247073",0,1,0,1,"dummy"
"247074",0,0,2,2,"dummy"
"247075",0,0,1,1,"dummy"
"247077",0,0,1,1,"dummy"
"247079",0,1,0,1,"dummy"
"247080",7,17,2,26,"dummy"
"247081",0,1,1,2,"dummy"
"247082",0,3,0,3,"dummy"
"247083",0,1,0,1,"dummy"
"247084",1,1,3,5,"dummy"
"247085",0,0,2,2,"dummy"
"247086",0,0,1,1,"dummy"
"247087",2,0,0,2,"dummy"
"247088",0,0,1,1,"dummy"
"247089",1,1,2,4,"dummy"
"247090",0,1,0,1,"dummy"
"247091",0,0,1,1,"dummy"
"247092",0,3,0,3,"dummy"
"247093",4,4,0,8,"dummy"
"247094",2,0,0,2,"dummy"
"247095",0,0,1,1,"dummy"
"247096",0,0,2,2,"dummy"
"247097",0,0,1,1,"dummy"
"247098",1,0,0,1,"dummy"
"247099",0,1,1,2,"dummy"
"247100",0,1,0,1,"dummy"
"247101",0,0,1,1,"dummy"
"247102",6,6,7,19,"dummy"
"247103",0,0,1,1,"dummy"
"247104",0,1,0,1,"dummy"
"247106",2,0,2,4,"dummy"
"247114",0,8,0,8,"dummy"
"247115",0,0,0,0,"dummy"
"247118",1,2,0,3,"dummy"
"247120",3,4,0,7,"dummy"
"247122",15,5,0,20,"dummy"
"247123",0,0,1,1,"dummy"
"247124",0,0,0,0,"dummy"
"247126",6,7,2,15,"dummy"
"247127",8,1,0,9,"dummy"
"247130",1,2,0,3,"dummy"
"247132",0,0,1,1,"dummy"
"247145",6,0,1,7,"dummy"
"247146",0,1,0,1,"dummy"
"247147",0,1,0,1,"dummy"
"247148",1,0,0,1,"dummy"
"247149",0,0,1,1,"dummy"
"247150",2,4,0,6,"dummy"
"247151",0,0,0,0,"dummy"
"247152",0,0,4,4,"dummy"
"247154",3,0,1,4,"dummy"
"247155",3,3,2,8,"dummy"
"247156",0,0,0,0,"dummy"
"247157",3,3,0,6,"dummy"
"247158",2,2,0,4,"dummy"
"247159",4,2,0,6,"dummy"
"247160",0,0,3,3,"dummy"
"247209",0,3,0,3,"dummy"
"247211",4,7,12,23,"dummy"
"247213",2,10,1,13,"dummy"
"247214",0,1,0,1,"dummy"
"247215",0,1,0,1,"dummy"
"247218",0,12,5,17,"dummy"
"247219",0,14,0,14,"dummy"
"247221",0,0,0,0,"dummy"
"247222",0,0,0,0,"dummy"
"247223",0,0,0,0,"dummy"
"247224",0,0,0,0,"dummy"
"247228",0,6,0,6,"dummy"
"247229",3,4,0,7,"dummy"
"247230",1,1,0,2,"dummy"
"247231",0,0,3,3,"dummy"
"247240",6,3,1,10,"dummy"
"247242",1,2,0,3,"dummy"
"247243",0,1,0,1,"dummy"
"247244",0,1,1,2,"dummy"
"247245",0,1,0,1,"dummy"
"247246",0,0,1,1,"dummy"
"247247",0,0,1,1,"dummy"
"247248",0,0,1,1,"dummy"
"247250",0,0,1,1,"dummy"
"247251",0,2,0,2,"dummy"
"247252",2,9,0,11,"dummy"
"247254",2,4,0,6,"dummy"
"247255",1,6,0,7,"dummy"
"247256",1,3,1,5,"dummy"
"247257",0,1,0,1,"dummy"
"247258",0,0,1,1,"dummy"
"247259",19,10,2,31,"dummy"
"247260",3,0,1,4,"dummy"
"247261",0,4,0,4,"dummy"
"247262",0,0,0,0,"dummy"
"247263",2,2,1,5,"dummy"
"247264",0,3,0,3,"dummy"
"247265",0,1,0,1,"dummy"
"247267",0,1,2,3,"dummy"
"247268",0,0,0,0,"dummy"
"247269",0,2,0,2,"dummy"
"247270",5,0,2,7,"dummy"
"247271",1,0,0,1,"dummy"
"247272",0,0,0,0,"dummy"
"247275",0,1,0,1,"dummy"
"247276",0,1,0,1,"dummy"
"247277",0,0,1,1,"dummy"
"247278",0,2,1,3,"dummy"
"247279",0,0,2,2,"dummy"
"247280",0,8,2,10,"dummy"
"247281",0,0,0,0,"dummy"
"247282",8,7,0,15,"dummy"
"247284",14,16,5,35,"dummy"
"247285",2,2,0,4,"dummy"
"247290",0,0,0,0,"dummy"
"247291",0,0,0,0,"dummy"
"247294",2,3,0,5,"dummy"
"247296",0,1,0,1,"dummy"
"247299",13,0,2,15,"dummy"
"247300",1,10,1,12,"dummy"
"247301",1,0,0,1,"dummy"
"247302",2,4,0,6,"dummy"
"247303",2,2,0,4,"dummy"
"247304",1,0,0,1,"dummy"
"247310",0,0,0,0,"dummy"
"247311",0,0,0,0,"dummy"
"247313",0,0,1,1,"dummy"
"247314",0,1,0,1,"dummy"
"247315",0,4,0,4,"dummy"
"247316",5,5,1,11,"dummy"
"247318",5,18,2,25,"dummy"
"247320",0,4,1,5,"dummy"
"247321",7,12,0,19,"dummy"
"247322",0,0,1,1,"dummy"
"247323",2,5,0,7,"dummy"
"247324",0,1,0,1,"dummy"
"247325",1,2,0,3,"dummy"
"247340",0,1,0,1,"dummy"
"247341",1,0,0,1,"dummy"
"247344",0,0,1,1,"dummy"
"247345",0,1,0,1,"dummy"
"247347",0,0,1,1,"dummy"
"247348",0,2,0,2,"dummy"
"247349",0,4,0,4,"dummy"
"247350",0,0,0,0,"dummy"
"247352",0,0,0,0,"dummy"
"247354",0,0,1,1,"dummy"
"247355",1,0,0,1,"dummy"
"247357",0,1,0,1,"dummy"
"247359",0,1,0,1,"dummy"
"247360",4,1,0,5,"dummy"
"247362",0,0,1,1,"dummy"
"247363",0,7,1,8,"dummy"
"247368",0,6,0,6,"dummy"
"247369",0,2,0,2,"dummy"
"247375",2,2,0,4,"dummy"
"247376",4,0,1,5,"dummy"
"247377",0,0,2,2,"dummy"
"247379",0,0,0,0,"dummy"
"247383",0,0,1,1,"dummy"
"247384",0,7,0,7,"dummy"
"247385",0,0,1,1,"dummy"
"247389",0,1,0,1,"dummy"
"247405",3,3,0,6,"dummy"
"247407",0,1,0,1,"dummy"
"247415",0,2,0,2,"dummy"
"247416",0,0,0,0,"dummy"
"247417",0,0,0,0,"dummy"
"247418",0,1,0,1,"dummy"
"247419",1,0,0,1,"dummy"
"247420",0,0,0,0,"dummy"
"247421",0,0,0,0,"dummy"
"247422",0,1,0,1,"dummy"
"247423",0,0,0,0,"dummy"
"247424",0,0,1,1,"dummy"
"247425",0,0,1,1,"dummy"
"247430",0,1,1,2,"dummy"
"247432",0,19,0,19,"dummy"
"247433",0,1,0,1,"dummy"
"247434",1,0,0,1,"dummy"
"247436",0,1,0,1,"dummy"
"247437",0,0,1,1,"dummy"
"247438",0,0,1,1,"dummy"
"247439",0,0,1,1,"dummy"
"247440",0,0,1,1,"dummy"
"247441",0,0,1,1,"dummy"
"247442",0,0,1,1,"dummy"
"247443",0,0,1,1,"dummy"
"247444",0,0,1,1,"dummy"
"247445",0,0,1,1,"dummy"
"247446",0,0,0,0,"dummy"
"247447",0,0,1,1,"dummy"
"247448",0,0,1,1,"dummy"
"247449",0,0,1,1,"dummy"
"247450",0,0,1,1,"dummy"
"247451",0,0,1,1,"dummy"
"247452",0,0,1,1,"dummy"
"247453",0,0,1,1,"dummy"
"247454",0,0,1,1,"dummy"
"247455",0,0,1,1,"dummy"
"247456",0,0,1,1,"dummy"
"247457",0,0,1,1,"dummy"
"247458",0,0,1,1,"dummy"
"247459",0,0,1,1,"dummy"
"247460",0,0,1,1,"dummy"
"247461",0,0,1,1,"dummy"
"247462",0,0,1,1,"dummy"
"247463",0,0,1,1,"dummy"
"247464",0,0,1,1,"dummy"
"247465",0,0,1,1,"dummy"
"247466",0,0,1,1,"dummy"
"247467",0,0,2,2,"dummy"
"247468",0,0,1,1,"dummy"
"247469",0,0,1,1,"dummy"
"247470",0,0,1,1,"dummy"
"247471",0,0,1,1,"dummy"
"247472",0,0,1,1,"dummy"
"247473",0,0,1,1,"dummy"
"247474",0,0,1,1,"dummy"
"247475",0,0,1,1,"dummy"
"247476",0,0,1,1,"dummy"
"247477",0,0,1,1,"dummy"
"247478",0,0,1,1,"dummy"
"247479",0,0,1,1,"dummy"
"247480",0,0,1,1,"dummy"
"247481",0,0,1,1,"dummy"
"247546",0,0,0,0,"dummy"
"247547",0,0,0,0,"dummy"
"247550",1,0,1,2,"dummy"
"247552",9,12,1,22,"dummy"
"247553",0,0,1,1,"dummy"
"247554",0,1,1,2,"dummy"
"247555",0,0,1,1,"dummy"
"247566",7,4,1,12,"dummy"
"247567",0,1,0,1,"dummy"
"247568",0,1,0,1,"dummy"
"247571",0,1,0,1,"dummy"
"247575",0,5,0,5,"dummy"
"247577",0,0,1,1,"dummy"
"247579",0,1,2,3,"dummy"
"247580",0,0,0,0,"dummy"
"247581",0,2,0,2,"dummy"
"247582",5,0,2,7,"dummy"
"247583",1,0,0,1,"dummy"
"247585",0,0,0,0,"dummy"
"247586",1,0,0,1,"dummy"
"247587",0,0,1,1,"dummy"
"247588",1,1,0,2,"dummy"
"247589",0,0,1,1,"dummy"
"247590",0,0,1,1,"dummy"
"247591",2,0,0,2,"dummy"
"247592",0,2,0,2,"dummy"
"247593",0,1,0,1,"dummy"
"247594",1,0,0,1,"dummy"
"247595",0,1,0,1,"dummy"
"247596",0,0,0,0,"dummy"
"247597",4,1,0,5,"dummy"
"247598",1,0,0,1,"dummy"
"247599",0,0,0,0,"dummy"
"247600",0,0,0,0,"dummy"
"247639",0,2,0,2,"dummy"
"247642",2,0,0,2,"dummy"
"247643",0,0,1,1,"dummy"
"247645",0,1,0,1,"dummy"
"247646",0,1,0,1,"dummy"
"247647",0,4,0,4,"dummy"
"247648",0,2,0,2,"dummy"
"247649",5,5,0,10,"dummy"
"247651",9,0,2,11,"dummy"
"247652",0,9,2,11,"dummy"
"247653",1,2,0,3,"dummy"
"247654",3,1,1,5,"dummy"
"247658",3,5,1,9,"dummy"
"247660",0,0,8,8,"dummy"
"247666",1,5,1,7,"dummy"
"247667",5,1,1,7,"dummy"
"247668",0,1,0,1,"dummy"
"247669",0,0,2,2,"dummy"
"247670",1,3,2,6,"dummy"
"247671",0,1,0,1,"dummy"
"247672",0,1,0,1,"dummy"
"247673",0,0,1,1,"dummy"
"247674",3,2,1,6,"dummy"
"247676",0,0,0,0,"dummy"
"247677",0,4,2,6,"dummy"
"247678",0,0,0,0,"dummy"
"247679",0,0,0,0,"dummy"
"247680",1,1,0,2,"dummy"
"247681",0,0,3,3,"dummy"
"247682",1,1,0,2,"dummy"
"247683",4,0,0,4,"dummy"
"247686",0,0,1,1,"dummy"
"247689",0,0,0,0,"dummy"
"247691",0,1,0,1,"dummy"
"247692",0,0,0,0,"dummy"
"247694",0,1,0,1,"dummy"
"247697",0,1,0,1,"dummy"
"247698",3,1,0,4,"dummy"
"247699",4,2,0,6,"dummy"
"247701",1,1,1,3,"dummy"
"247705",0,0,3,3,"dummy"
"247715",0,0,1,1,"dummy"
"247718",12,2,2,16,"dummy"
"247726",0,0,0,0,"dummy"
"247730",14,15,4,33,"dummy"
"247731",13,12,4,29,"dummy"
"247732",1,0,0,1,"dummy"
"247733",11,5,0,16,"dummy"
"247734",0,0,0,0,"dummy"
"247735",0,4,0,4,"dummy"
"247736",0,1,0,1,"dummy"
"247737",0,0,4,4,"dummy"
"247738",0,2,0,2,"dummy"
"247739",4,0,0,4,"dummy"
"247740",2,0,0,2,"dummy"
"247741",0,1,0,1,"dummy"
"247742",3,6,0,9,"dummy"
"247743",0,1,0,1,"dummy"
"247744",0,2,0,2,"dummy"
"247745",0,0,2,2,"dummy"
"247747",0,1,1,2,"dummy"
"247749",1,2,0,3,"dummy"
"247750",5,0,1,6,"dummy"
"247751",0,0,2,2,"dummy"
"247752",5,5,0,10,"dummy"
"247758",0,0,1,1,"dummy"
"247768",1,0,1,2,"dummy"
"247769",0,0,1,1,"dummy"
"247770",0,0,0,0,"dummy"
"247771",1,0,0,1,"dummy"
"247772",8,5,1,14,"dummy"
"247773",2,2,0,4,"dummy"
"247774",1,0,0,1,"dummy"
"247775",0,1,0,1,"dummy"
"247776",0,0,1,1,"dummy"
"247777",0,1,0,1,"dummy"
"247802",0,1,0,1,"dummy"
"247804",0,0,1,1,"dummy"
"247805",0,5,0,5,"dummy"
"247830",0,1,0,1,"dummy"
"247834",7,8,1,16,"dummy"
"247835",0,2,0,2,"dummy"
"247836",0,0,1,1,"dummy"
"247837",1,2,1,4,"dummy"
"247838",6,4,4,14,"dummy"
"247839",0,0,0,0,"dummy"
"247840",0,0,0,0,"dummy"
"247841",0,0,0,0,"dummy"
"247842",0,0,0,0,"dummy"
"247843",0,0,0,0,"dummy"
"247844",0,0,0,0,"dummy"
"247845",0,0,0,0,"dummy"
"247846",0,0,0,0,"dummy"
"247847",0,0,0,0,"dummy"
"247848",0,0,0,0,"dummy"
"247849",0,0,0,0,"dummy"
"247850",3,2,2,7,"dummy"
"247851",0,4,0,4,"dummy"
"247852",3,3,0,6,"dummy"
"247853",0,1,0,1,"dummy"
"247854",0,1,0,1,"dummy"
"247855",0,0,0,0,"dummy"
"247856",5,0,0,5,"dummy"
"247857",0,0,0,0,"dummy"
"247858",2,36,1,39,"dummy"
"247859",1,5,1,7,"dummy"
"247860",34,0,0,34,"dummy"
"247861",0,0,0,0,"dummy"
"247862",0,0,0,0,"dummy"
"247863",0,0,0,0,"dummy"
"247864",0,0,0,0,"dummy"
"247865",0,0,0,0,"dummy"
"247866",2,0,2,4,"dummy"
"247867",0,0,0,0,"dummy"
"247868",0,0,0,0,"dummy"
"247869",0,0,0,0,"dummy"
"247870",1,0,0,1,"dummy"
"247871",0,1,0,1,"dummy"
"247872",0,0,0,0,"dummy"
"247873",1,8,0,9,"dummy"
"247874",8,0,0,8,"dummy"
"247876",0,0,1,1,"dummy"
"247877",2,1,0,3,"dummy"
"247878",0,2,0,2,"dummy"
"247879",2,3,0,5,"dummy"
"247880",3,0,0,3,"dummy"
"247934",0,0,1,1,"dummy"
"247936",3,3,1,7,"dummy"
"247937",0,1,0,1,"dummy"
"247938",0,2,1,3,"dummy"
"247939",1,2,4,7,"dummy"
"247941",16,5,0,21,"dummy"
"247942",0,0,1,1,"dummy"
"247946",0,4,0,4,"dummy"
"247947",7,3,3,13,"dummy"
"247948",1,2,1,4,"dummy"
"247949",0,5,0,5,"dummy"
"247950",0,0,1,1,"dummy"
"247951",0,0,1,1,"dummy"
"247952",0,0,1,1,"dummy"
"247953",10,0,2,12,"dummy"
"247954",0,0,1,1,"dummy"
"247955",0,0,0,0,"dummy"
"247956",5,5,1,11,"dummy"
"247958",0,3,0,3,"dummy"
"247959",0,6,0,6,"dummy"
"247960",3,0,0,3,"dummy"
"247978",0,0,1,1,"dummy"
"247981",7,1,3,11,"dummy"
"247982",0,5,0,5,"dummy"
"247983",0,0,3,3,"dummy"
"247984",1,0,0,1,"dummy"
"247988",0,0,0,0,"dummy"
"247989",0,0,0,0,"dummy"
"247990",0,0,0,0,"dummy"
"247993",1,0,0,1,"dummy"
"247996",0,0,0,0,"dummy"
"247997",0,1,0,1,"dummy"
"247998",0,0,1,1,"dummy"
"247999",0,0,0,0,"dummy"
"248001",0,2,0,2,"dummy"
"248002",0,3,0,3,"dummy"
"248003",0,10,2,12,"dummy"
"248004",2,0,1,3,"dummy"
"248005",1,1,0,2,"dummy"
"248006",4,9,0,13,"dummy"
"248007",10,1,0,11,"dummy"
"248012",0,0,1,1,"dummy"
"248013",0,2,1,3,"dummy"
"248014",2,0,0,2,"dummy"
"248015",0,1,2,3,"dummy"
"248016",0,2,0,2,"dummy"
"248017",1,0,3,4,"dummy"
"248018",6,0,1,7,"dummy"
"248019",1,3,1,5,"dummy"
"248020",2,4,2,8,"dummy"
"248021",0,0,1,1,"dummy"
"248022",4,1,0,5,"dummy"
"248023",0,1,0,1,"dummy"
"248025",0,0,0,0,"dummy"
"248026",0,3,0,3,"dummy"
"248029",0,1,0,1,"dummy"
"248030",1,0,0,1,"dummy"
"248031",0,1,0,1,"dummy"
"248032",0,1,0,1,"dummy"
"248034",2,0,3,5,"dummy"
"248036",3,4,1,8,"dummy"
"248038",0,0,1,1,"dummy"
"248039",0,1,0,1,"dummy"
"248040",4,3,2,9,"dummy"
"248041",4,4,0,8,"dummy"
"248042",0,2,0,2,"dummy"
"248055",0,0,0,0,"dummy"
"248056",0,3,1,4,"dummy"
"248057",0,1,0,1,"dummy"
"248059",1,2,0,3,"dummy"
"248060",0,1,0,1,"dummy"
"248081",0,1,0,1,"dummy"
"248082",0,0,1,1,"dummy"
"248083",9,42,2,53,"dummy"
"248086",0,3,0,3,"dummy"
"248087",0,1,0,1,"dummy"
"248089",0,1,0,1,"dummy"
"248090",0,0,1,1,"dummy"
"248095",1,0,0,1,"dummy"
"248096",0,0,1,1,"dummy"
"248099",0,0,1,1,"dummy"
"248100",0,2,0,2,"dummy"
"248101",16,2,3,21,"dummy"
"248104",2,0,0,2,"dummy"
"248105",0,1,0,1,"dummy"
"248106",0,0,1,1,"dummy"
"248109",0,2,0,2,"dummy"
"248113",0,0,0,0,"dummy"
"248114",0,0,0,0,"dummy"
"248116",0,0,0,0,"dummy"
"248117",0,0,0,0,"dummy"
"248121",2,6,1,9,"dummy"
"248122",0,1,1,2,"dummy"
"248123",1,0,0,1,"dummy"
"248124",1,0,0,1,"dummy"
"248127",8,6,4,18,"dummy"
"248128",0,0,0,0,"dummy"
"248129",0,0,0,0,"dummy"
"248130",3,1,0,4,"dummy"
"248131",9,0,0,9,"dummy"
"248132",0,0,3,3,"dummy"
"248133",0,0,0,0,"dummy"
"248134",0,0,0,0,"dummy"
"248136",0,1,1,2,"dummy"
"248137",0,1,0,1,"dummy"
"248139",5,2,4,11,"dummy"
"248141",0,4,1,5,"dummy"
"248142",0,0,1,1,"dummy"
"248143",0,0,1,1,"dummy"
"248144",0,1,0,1,"dummy"
"248146",1,1,2,4,"dummy"
"248147",0,0,0,0,"dummy"
"248150",0,0,3,3,"dummy"
"248151",0,0,1,1,"dummy"
"248154",0,8,1,9,"dummy"
"248156",0,6,1,7,"dummy"
"248157",0,2,0,2,"dummy"
"248158",4,2,0,6,"dummy"
"248159",0,2,0,2,"dummy"
"248160",3,4,0,7,"dummy"
"248161",1,0,3,4,"dummy"
"248162",3,3,2,8,"dummy"
"248163",3,1,1,5,"dummy"
"248164",0,1,0,1,"dummy"
"248165",0,2,0,2,"dummy"
"248176",1,21,2,24,"dummy"
"248177",22,3,3,28,"dummy"
"248180",0,0,1,1,"dummy"
"248181",0,0,2,2,"dummy"
"248182",1,1,1,3,"dummy"
"248183",0,0,1,1,"dummy"
"248184",0,0,1,1,"dummy"
"248185",0,0,1,1,"dummy"
"248189",0,0,0,0,"dummy"
"248190",0,0,0,0,"dummy"
"248191",0,0,0,0,"dummy"
"248192",0,11,0,11,"dummy"
"248194",0,0,0,0,"dummy"
"248198",0,0,0,0,"dummy"
"248201",0,0,2,2,"dummy"
"248202",15,0,0,15,"dummy"
"248203",0,0,2,2,"dummy"
"248273",2,9,1,12,"dummy"
"248274",0,0,2,2,"dummy"
"248275",0,2,0,2,"dummy"
"248281",0,1,0,1,"dummy"
"248282",0,0,1,1,"dummy"
"248283",0,0,1,1,"dummy"
"248284",0,3,0,3,"dummy"
"248285",0,3,0,3,"dummy"
"248286",1,1,1,3,"dummy"
"248287",2,4,0,6,"dummy"
"248292",0,0,1,1,"dummy"
"248296",0,1,0,1,"dummy"
"248297",0,1,0,1,"dummy"
"248298",0,2,0,2,"dummy"
"248299",0,1,0,1,"dummy"
"248300",0,2,0,2,"dummy"
"248301",1,0,0,1,"dummy"
"248302",0,1,0,1,"dummy"
"248303",1,0,1,2,"dummy"
"248304",3,2,2,7,"dummy"
"248305",12,3,2,17,"dummy"
"248306",3,5,0,8,"dummy"
"248313",0,1,0,1,"dummy"
"248314",1,0,0,1,"dummy"
"248318",0,2,0,2,"dummy"
"248319",0,0,0,0,"dummy"
"248322",0,0,1,1,"dummy"
"248323",0,0,1,1,"dummy"
"248324",0,0,1,1,"dummy"
"248325",0,1,2,3,"dummy"
"248326",0,0,1,1,"dummy"
"248327",0,3,0,3,"dummy"
"248328",2,1,0,3,"dummy"
"248329",0,1,0,1,"dummy"
"248330",2,0,1,3,"dummy"
"248331",0,0,2,2,"dummy"
"248332",0,0,1,1,"dummy"
"248333",3,0,0,3,"dummy"
"248334",0,0,0,0,"dummy"
"248336",2,3,3,8,"dummy"
"248340",0,0,1,1,"dummy"
"248342",0,1,0,1,"dummy"
"248343",0,0,1,1,"dummy"
"248344",0,4,0,4,"dummy"
"248346",1,10,7,18,"dummy"
"248347",0,0,1,1,"dummy"
"248348",0,0,1,1,"dummy"
"248349",0,2,1,3,"dummy"
"248352",0,2,0,2,"dummy"
"248353",0,1,0,1,"dummy"
"248354",0,0,0,0,"dummy"
"248355",0,1,0,1,"dummy"
"248356",0,5,0,5,"dummy"
"248357",0,0,0,0,"dummy"
"248360",1,0,3,4,"dummy"
"248361",0,1,0,1,"dummy"
"248363",0,1,1,2,"dummy"
"248364",0,1,0,1,"dummy"
"248365",0,6,0,6,"dummy"
"248366",6,0,2,8,"dummy"
"248367",0,0,1,1,"dummy"
"248368",4,1,1,6,"dummy"
"248369",3,2,0,5,"dummy"
"248370",4,3,1,8,"dummy"
"248371",4,13,3,20,"dummy"
"248374",10,11,5,26,"dummy"
"248375",3,1,1,5,"dummy"
"248376",0,0,1,1,"dummy"
"248377",0,0,1,1,"dummy"
"248378",0,0,1,1,"dummy"
"248379",0,0,1,1,"dummy"
"248380",0,0,1,1,"dummy"
"248381",0,0,1,1,"dummy"
"248382",0,0,1,1,"dummy"
"248383",0,0,1,1,"dummy"
"248384",0,0,1,1,"dummy"
"248385",0,0,1,1,"dummy"
"248386",1,3,1,5,"dummy"
"248390",3,1,0,4,"dummy"
"248392",0,1,0,1,"dummy"
"248393",22,15,8,45,"dummy"
"248394",18,9,6,33,"dummy"
"248397",2,0,0,2,"dummy"
"248398",0,1,0,1,"dummy"
"248399",0,0,1,1,"dummy"
"248400",0,0,3,3,"dummy"
"248401",2,0,0,2,"dummy"
"248402",0,0,1,1,"dummy"
"248404",13,5,1,19,"dummy"
"248405",0,1,0,1,"dummy"
"248408",0,4,1,5,"dummy"
"248409",2,2,1,5,"dummy"
"248410",3,0,0,3,"dummy"
"248420",1,2,2,5,"dummy"
"248421",2,3,1,6,"dummy"
"248423",0,0,1,1,"dummy"
"248425",0,0,1,1,"dummy"
"248428",0,13,0,13,"dummy"
"248429",0,2,0,2,"dummy"
"248430",0,4,0,4,"dummy"
"248431",1,0,5,6,"dummy"
"248432",0,0,1,1,"dummy"
"248433",3,0,0,3,"dummy"
"248434",4,4,1,9,"dummy"
"248435",0,0,1,1,"dummy"
"248436",0,1,0,1,"dummy"
"248437",2,2,1,5,"dummy"
"248438",0,0,1,1,"dummy"
"248439",2,2,2,6,"dummy"
"248441",2,2,3,7,"dummy"
"248443",0,5,0,5,"dummy"
"248444",0,1,0,1,"dummy"
"248447",0,0,3,3,"dummy"
"248448",0,1,0,1,"dummy"
"248449",0,0,1,1,"dummy"
"248450",1,0,0,1,"dummy"
"248451",2,0,0,2,"dummy"
"248452",0,0,1,1,"dummy"
"248457",0,1,0,1,"dummy"
"248458",0,0,1,1,"dummy"
"248459",0,1,0,1,"dummy"
"248460",0,1,2,3,"dummy"
"248461",12,23,11,46,"dummy"
"248462",1,2,1,4,"dummy"
"248463",0,0,1,1,"dummy"
"248464",0,1,0,1,"dummy"
"248465",0,0,1,1,"dummy"
"248466",0,2,0,2,"dummy"
"248467",1,0,1,2,"dummy"
"248468",1,3,0,4,"dummy"
"248469",0,0,1,1,"dummy"
"248470",0,1,1,2,"dummy"
"248471",14,9,4,27,"dummy"
"248472",0,0,1,1,"dummy"
"248473",2,0,1,3,"dummy"
"248474",7,1,0,8,"dummy"
"248492",0,0,0,0,"dummy"
"248493",0,1,0,1,"dummy"
"248494",0,2,0,2,"dummy"
"248495",0,0,0,0,"dummy"
"248496",2,2,0,4,"dummy"
"248498",1,2,0,3,"dummy"
"248499",23,1,1,25,"dummy"
"248500",0,0,2,2,"dummy"
"248502",0,1,0,1,"dummy"
"248506",0,2,0,2,"dummy"
"248508",1,2,0,3,"dummy"
"248511",0,0,3,3,"dummy"
"248512",0,0,0,0,"dummy"
"248513",0,1,0,1,"dummy"
"248514",0,2,0,2,"dummy"
"248515",0,0,1,1,"dummy"
"248518",1,3,0,4,"dummy"
"248519",0,3,0,3,"dummy"
"248520",0,0,0,0,"dummy"
"248521",0,1,0,1,"dummy"
"248523",3,15,0,18,"dummy"
"248524",1,12,0,13,"dummy"
"248525",0,0,1,1,"dummy"
"248526",1,0,0,1,"dummy"
"248527",5,1,0,6,"dummy"
"248528",0,5,0,5,"dummy"
"248529",4,4,2,10,"dummy"
"248530",1,4,0,5,"dummy"
"248531",1,10,0,11,"dummy"
"248532",0,6,0,6,"dummy"
"248533",2,2,2,6,"dummy"
"248534",1,3,3,7,"dummy"
"248535",0,0,0,0,"dummy"
"248536",0,0,0,0,"dummy"
"248537",0,0,0,0,"dummy"
"248544",0,0,0,0,"dummy"
"248545",0,0,1,1,"dummy"
"248546",0,0,1,1,"dummy"
"248547",0,0,1,1,"dummy"
"248548",0,7,0,7,"dummy"
"248549",0,0,1,1,"dummy"
"248550",2,2,0,4,"dummy"
"248551",0,0,2,2,"dummy"
"248552",0,2,0,2,"dummy"
"248553",0,2,0,2,"dummy"
"248554",0,0,2,2,"dummy"
"248555",0,0,1,1,"dummy"
"248556",1,1,1,3,"dummy"
"248557",0,0,1,1,"dummy"
"248558",0,5,1,6,"dummy"
"248559",0,1,2,3,"dummy"
"248560",5,1,1,7,"dummy"
"248562",0,0,1,1,"dummy"
"248563",1,0,0,1,"dummy"
"248565",0,1,0,1,"dummy"
"248566",0,6,1,7,"dummy"
"248567",0,0,0,0,"dummy"
"248569",13,12,4,29,"dummy"
"248570",4,3,1,8,"dummy"
"248574",0,1,1,2,"dummy"
"248575",0,0,1,1,"dummy"
"248576",0,1,2,3,"dummy"
"248577",1,0,2,3,"dummy"
"248578",1,5,2,8,"dummy"
"248582",0,0,0,0,"dummy"
"248583",0,0,0,0,"dummy"
"248588",1,0,1,2,"dummy"
"248589",0,1,0,1,"dummy"
"248595",2,2,0,4,"dummy"
"248596",0,1,0,1,"dummy"
"248597",1,0,0,1,"dummy"
"248600",0,2,1,3,"dummy"
"248602",0,2,0,2,"dummy"
"248609",0,1,0,1,"dummy"
"248610",0,0,1,1,"dummy"
"248611",2,0,1,3,"dummy"
"248612",0,0,1,1,"dummy"
"248613",0,0,1,1,"dummy"
"248616",0,1,0,1,"dummy"
"248619",0,0,0,0,"dummy"
"248621",0,0,0,0,"dummy"
"248622",0,0,0,0,"dummy"
"248624",5,4,1,10,"dummy"
"248625",0,0,0,0,"dummy"
"248626",0,0,1,1,"dummy"
"248628",2,5,0,7,"dummy"
"248629",5,3,0,8,"dummy"
"248630",0,1,1,2,"dummy"
"248631",1,2,0,3,"dummy"
"248632",0,1,0,1,"dummy"
"248633",0,0,1,1,"dummy"
"248634",1,0,0,1,"dummy"
"248635",0,1,0,1,"dummy"
"248636",0,1,0,1,"dummy"
"248637",5,7,0,12,"dummy"
"248638",7,5,0,12,"dummy"
"248639",0,1,0,1,"dummy"
"248641",3,1,2,6,"dummy"
"248652",0,6,0,6,"dummy"
"248653",0,0,0,0,"dummy"
"248655",0,0,2,2,"dummy"
"248660",7,8,1,16,"dummy"
"248661",0,1,0,1,"dummy"
"248662",1,0,0,1,"dummy"
"248663",0,1,0,1,"dummy"
"248664",1,1,0,2,"dummy"
"248665",7,16,1,24,"dummy"
"248666",0,0,0,0,"dummy"
"248667",0,0,1,1,"dummy"
"248668",0,0,1,1,"dummy"
"248669",1,1,0,2,"dummy"
"248670",7,7,1,15,"dummy"
"248671",0,0,0,0,"dummy"
"248672",0,0,1,1,"dummy"
"248674",6,21,3,30,"dummy"
"248677",0,4,0,4,"dummy"
"248678",0,0,1,1,"dummy"
"248680",0,0,0,0,"dummy"
"248681",0,0,0,0,"dummy"
"248684",0,16,0,16,"dummy"
"248686",0,2,0,2,"dummy"
"248691",0,0,1,1,"dummy"
"248693",2,1,0,3,"dummy"
"248694",7,3,0,10,"dummy"
"248695",0,2,0,2,"dummy"
"248696",1,0,0,1,"dummy"
"248698",3,5,2,10,"dummy"
"248700",3,2,0,5,"dummy"
"248701",2,3,0,5,"dummy"
"248702",3,2,0,5,"dummy"
"248704",0,1,0,1,"dummy"
"248706",4,9,5,18,"dummy"
"248707",0,3,3,6,"dummy"
"248708",0,1,0,1,"dummy"
"248709",3,3,2,8,"dummy"
"248710",0,1,0,1,"dummy"
"248711",0,0,1,1,"dummy"
"248714",0,1,0,1,"dummy"
"248716",0,33,0,33,"dummy"
"248717",23,35,1,59,"dummy"
"248718",0,1,0,1,"dummy"
"248719",0,4,0,4,"dummy"
"248721",0,1,0,1,"dummy"
"248732",21,96,2,119,"dummy"
"248733",0,1,0,1,"dummy"
"248734",0,1,0,1,"dummy"
"248735",0,2,0,2,"dummy"
"248736",61,10,0,71,"dummy"
"248737",0,3,0,3,"dummy"
"248740",1,0,0,1,"dummy"
"248742",0,1,0,1,"dummy"
"248743",1,1,0,2,"dummy"
"248744",2,2,0,4,"dummy"
"248745",0,0,2,2,"dummy"
"248749",0,0,0,0,"dummy"
"248750",0,0,0,0,"dummy"
"248751",0,0,0,0,"dummy"
"248752",0,0,0,0,"dummy"
"248753",0,0,0,0,"dummy"
"248754",0,0,0,0,"dummy"
"248758",0,0,1,1,"dummy"
"248759",0,0,1,1,"dummy"
"248761",1,4,0,5,"dummy"
"248762",5,2,1,8,"dummy"
"248763",0,1,0,1,"dummy"
"248765",9,12,4,25,"dummy"
"248766",0,1,0,1,"dummy"
"248767",10,10,0,20,"dummy"
"248768",0,0,1,1,"dummy"
"248769",1,1,0,2,"dummy"
"248770",9,8,2,19,"dummy"
"248774",0,0,0,0,"dummy"
"248775",2,0,0,2,"dummy"
"248777",2,7,0,9,"dummy"
"248778",3,0,1,4,"dummy"
"248783",8,2,1,11,"dummy"
"248790",1,3,0,4,"dummy"
"248795",0,2,1,3,"dummy"
"248796",2,2,2,6,"dummy"
"248798",0,0,0,0,"dummy"
"248800",1,1,0,2,"dummy"
"248801",1,1,0,2,"dummy"
"248802",0,0,1,1,"dummy"
"248803",0,0,3,3,"dummy"
"248805",0,0,1,1,"dummy"
"248809",0,1,1,2,"dummy"
"248810",1,1,1,3,"dummy"
"248811",0,1,0,1,"dummy"
"248812",0,0,3,3,"dummy"
"248813",0,0,3,3,"dummy"
"248814",0,1,3,4,"dummy"
"248815",0,0,0,0,"dummy"
"248817",0,16,0,16,"dummy"
"248818",2,1,0,3,"dummy"
"248819",0,3,0,3,"dummy"
"248820",0,7,1,8,"dummy"
"248822",0,2,0,2,"dummy"
"248823",0,0,0,0,"dummy"
"248824",0,2,0,2,"dummy"
"248825",1,0,0,1,"dummy"
"248834",0,0,0,0,"dummy"
"248835",0,0,0,0,"dummy"
"248836",0,0,0,0,"dummy"
"248837",0,0,0,0,"dummy"
"248841",0,3,0,3,"dummy"
"248843",0,1,0,1,"dummy"
"248844",0,2,0,2,"dummy"
"248846",0,2,0,2,"dummy"
"248847",0,6,0,6,"dummy"
"248848",0,2,0,2,"dummy"
"248850",0,0,0,0,"dummy"
"248851",0,0,0,0,"dummy"
"248856",0,1,0,1,"dummy"
"248858",0,18,0,18,"dummy"
"248859",17,0,0,17,"dummy"
"248861",7,1,0,8,"dummy"
"248862",0,0,0,0,"dummy"
"248863",0,5,2,7,"dummy"
"248864",1,1,0,2,"dummy"
"248865",0,0,0,0,"dummy"
"248866",5,0,4,9,"dummy"
"248867",0,0,1,1,"dummy"
"248872",1,0,0,1,"dummy"
"248873",4,2,2,8,"dummy"
"248892",0,2,1,3,"dummy"
"248893",0,0,1,1,"dummy"
"248895",0,1,0,1,"dummy"
"248896",2,4,3,9,"dummy"
"248907",0,1,0,1,"dummy"
"248908",0,2,1,3,"dummy"
"248909",0,2,0,2,"dummy"
"248910",1,1,0,2,"dummy"
"248911",0,5,2,7,"dummy"
"248914",1,1,0,2,"dummy"
"248915",0,0,1,1,"dummy"
"248916",0,0,1,1,"dummy"
"248921",0,0,0,0,"dummy"
"248922",1,4,1,6,"dummy"
"248923",8,5,3,16,"dummy"
"248924",2,5,2,9,"dummy"
"248925",0,1,0,1,"dummy"
"248926",3,9,3,15,"dummy"
"248927",1,0,0,1,"dummy"
"248929",19,0,0,19,"dummy"
"248930",4,0,2,6,"dummy"
"248931",0,0,1,1,"dummy"
"248932",0,0,0,0,"dummy"
"248933",0,0,0,0,"dummy"
"248934",0,0,0,0,"dummy"
"248935",0,0,0,0,"dummy"
"248936",0,23,2,25,"dummy"
"248937",23,0,2,25,"dummy"
"248938",0,23,2,25,"dummy"
"248939",23,0,2,25,"dummy"
"248940",0,0,1,1,"dummy"
"248943",0,0,0,0,"dummy"
"248944",0,0,0,0,"dummy"
"248945",0,0,0,0,"dummy"
"248948",0,0,1,1,"dummy"
"248949",0,0,1,1,"dummy"
"248950",0,0,1,1,"dummy"
"248951",0,0,1,1,"dummy"
"248952",0,0,1,1,"dummy"
"248953",0,0,1,1,"dummy"
"248954",0,0,1,1,"dummy"
"248955",0,0,1,1,"dummy"
"248956",0,0,1,1,"dummy"
"248957",0,0,1,1,"dummy"
"248958",0,0,1,1,"dummy"
"248959",0,0,1,1,"dummy"
"248960",0,0,1,1,"dummy"
"248961",0,0,1,1,"dummy"
"248962",0,0,1,1,"dummy"
"248963",0,0,1,1,"dummy"
"248964",0,0,1,1,"dummy"
"248972",6,0,0,6,"dummy"
"248975",0,2,0,2,"dummy"
"248976",0,3,0,3,"dummy"
"248977",1,4,1,6,"dummy"
"248978",0,1,0,1,"dummy"
"248979",0,1,0,1,"dummy"
"248980",1,0,0,1,"dummy"
"248981",5,1,1,7,"dummy"
"248982",0,0,1,1,"dummy"
"248987",0,1,0,1,"dummy"
"248991",0,3,0,3,"dummy"
"248992",0,0,1,1,"dummy"
"248993",21,4,1,26,"dummy"
"248994",0,9,0,9,"dummy"
"248995",5,2,2,9,"dummy"
"248996",0,1,0,1,"dummy"
"248997",0,1,0,1,"dummy"
"248998",0,0,0,0,"dummy"
"248999",0,1,0,1,"dummy"
"249000",0,0,1,1,"dummy"
"249001",1,2,1,4,"dummy"
"249002",0,0,1,1,"dummy"
"249003",2,2,0,4,"dummy"
"249004",4,16,0,20,"dummy"
"249005",0,0,0,0,"dummy"
"249006",2,1,0,3,"dummy"
"249007",0,0,1,1,"dummy"
"249008",3,0,0,3,"dummy"
"249009",0,0,0,0,"dummy"
"249010",0,0,0,0,"dummy"
"249011",0,0,1,1,"dummy"
"249012",1,2,0,3,"dummy"
"249013",0,4,0,4,"dummy"
"249014",3,2,0,5,"dummy"
"249017",7,0,1,8,"dummy"
"249018",1,3,0,4,"dummy"
"249019",5,9,1,15,"dummy"
"249020",0,0,0,0,"dummy"
"249031",1,0,2,3,"dummy"
"249032",1,8,0,9,"dummy"
"249033",0,0,2,2,"dummy"
"249034",0,0,1,1,"dummy"
"249035",0,0,2,2,"dummy"
"249036",1,4,2,7,"dummy"
"249040",0,0,1,1,"dummy"
"249041",0,0,1,1,"dummy"
"249042",0,0,1,1,"dummy"
"249043",0,0,1,1,"dummy"
"249044",0,0,1,1,"dummy"
"249046",0,0,4,4,"dummy"
"249047",0,0,0,0,"dummy"
"249049",1,2,1,4,"dummy"
"249050",0,0,0,0,"dummy"
"249051",0,0,0,0,"dummy"
"249052",0,0,0,0,"dummy"
"249053",0,0,0,0,"dummy"
"249054",1,0,0,1,"dummy"
"249055",0,0,0,0,"dummy"
"249056",0,0,0,0,"dummy"
"249057",0,0,0,0,"dummy"
"249058",0,0,0,0,"dummy"
"249059",0,0,0,0,"dummy"
"249060",0,0,0,0,"dummy"
"249061",0,0,0,0,"dummy"
"249062",0,0,0,0,"dummy"
"249063",0,0,0,0,"dummy"
"249064",0,0,0,0,"dummy"
"249065",0,0,0,0,"dummy"
"249066",0,0,0,0,"dummy"
"249067",0,0,0,0,"dummy"
"249070",0,0,1,1,"dummy"
"249071",0,3,0,3,"dummy"
"249073",0,0,0,0,"dummy"
"249074",0,0,0,0,"dummy"
"249076",11,13,2,26,"dummy"
"249078",6,1,3,10,"dummy"
"249097",6,0,0,6,"dummy"
"249098",2,5,2,9,"dummy"
"249101",0,1,0,1,"dummy"
"249107",2,0,0,2,"dummy"
"249109",2,4,1,7,"dummy"
"249123",0,0,1,1,"dummy"
"249126",4,1,4,9,"dummy"
"249129",3,0,2,5,"dummy"
"249130",0,0,1,1,"dummy"
"249132",0,8,0,8,"dummy"
"249133",1,2,3,6,"dummy"
"249134",4,4,2,10,"dummy"
"249135",3,1,0,4,"dummy"
"249136",8,0,0,8,"dummy"
"249137",0,0,1,1,"dummy"
"249139",0,0,1,1,"dummy"
"249140",0,0,1,1,"dummy"
"249141",0,0,1,1,"dummy"
"249142",0,0,3,3,"dummy"
"249143",0,0,1,1,"dummy"
"249144",2,6,0,8,"dummy"
"249145",1,3,0,4,"dummy"
"249146",2,2,0,4,"dummy"
"249147",5,1,0,6,"dummy"
"249148",0,0,2,2,"dummy"
"249149",0,0,1,1,"dummy"
"249150",0,0,0,0,"dummy"
"249151",0,0,0,0,"dummy"
"249152",0,0,1,1,"dummy"
"249153",0,0,0,0,"dummy"
"249154",0,0,0,0,"dummy"
"249155",0,0,0,0,"dummy"
"249156",0,3,1,4,"dummy"
"249163",0,0,0,0,"dummy"
"249164",1,1,0,2,"dummy"
"249165",0,1,1,2,"dummy"
"249167",1,12,1,14,"dummy"
"249168",2,2,0,4,"dummy"
"249169",0,2,0,2,"dummy"
"249170",1,6,0,7,"dummy"
"249174",0,2,1,3,"dummy"
"249175",0,1,0,1,"dummy"
"249177",0,1,0,1,"dummy"
"249179",12,1,0,13,"dummy"
"249180",0,0,1,1,"dummy"
"249183",0,0,1,1,"dummy"
"249184",7,22,1,30,"dummy"
"249188",0,0,2,2,"dummy"
"249189",1,1,1,3,"dummy"
"249190",0,0,1,1,"dummy"
"249198",3,2,1,6,"dummy"
"249217",1,1,0,2,"dummy"
"249218",2,4,1,7,"dummy"
"249219",0,3,0,3,"dummy"
"249221",5,0,2,7,"dummy"
"249223",1,0,1,2,"dummy"
"249224",1,9,1,11,"dummy"
"249225",0,2,0,2,"dummy"
"249226",0,0,2,2,"dummy"
"249227",0,1,0,1,"dummy"
"249228",0,0,1,1,"dummy"
"249229",1,0,1,2,"dummy"
"249236",2,3,0,5,"dummy"
"249238",2,19,1,22,"dummy"
"249239",3,4,5,12,"dummy"
"249240",0,4,1,5,"dummy"
"249241",0,0,1,1,"dummy"
"249242",0,0,1,1,"dummy"
"249243",0,0,1,1,"dummy"
"249244",0,2,0,2,"dummy"
"249246",0,1,0,1,"dummy"
"249249",2,2,1,5,"dummy"
"249250",0,0,1,1,"dummy"
"249251",0,0,0,0,"dummy"
"249252",0,0,1,1,"dummy"
"249254",2,2,0,4,"dummy"
"249257",1,1,0,2,"dummy"
"249258",0,1,0,1,"dummy"
"249259",2,0,0,2,"dummy"
"249262",13,72,1,86,"dummy"
"249263",27,42,5,74,"dummy"
"249264",0,2,0,2,"dummy"
"249265",2,2,0,4,"dummy"
"249266",61,10,0,71,"dummy"
"249267",4,4,1,9,"dummy"
"249268",0,3,0,3,"dummy"
"249269",2,2,0,4,"dummy"
"249272",0,1,1,2,"dummy"
"249276",0,0,1,1,"dummy"
"249277",0,5,5,10,"dummy"
"249278",0,0,0,0,"dummy"
"249280",0,0,1,1,"dummy"
"249284",4,11,0,15,"dummy"
"249285",0,0,1,1,"dummy"
"249287",2,0,1,3,"dummy"
"249288",0,1,0,1,"dummy"
"249291",2,0,0,2,"dummy"
"249292",2,10,0,12,"dummy"
"249293",4,4,5,13,"dummy"
"249294",5,4,7,16,"dummy"
"249295",0,2,1,3,"dummy"
"249296",1,2,1,4,"dummy"
"249297",2,2,0,4,"dummy"
"249298",13,0,1,14,"dummy"
"249299",0,0,0,0,"dummy"
"249300",0,0,0,0,"dummy"
"249301",0,1,0,1,"dummy"
"249302",1,0,1,2,"dummy"
"249303",0,18,0,18,"dummy"
"249304",0,1,0,1,"dummy"
"249305",1,0,0,1,"dummy"
"249306",0,1,0,1,"dummy"
"249307",0,1,0,1,"dummy"
"249308",1,0,0,1,"dummy"
"249309",22,0,2,24,"dummy"
"249330",0,5,0,5,"dummy"
"249331",1,3,1,5,"dummy"
"249339",8,6,0,14,"dummy"
"249340",0,1,0,1,"dummy"
"249341",0,0,2,2,"dummy"
"249342",0,0,2,2,"dummy"
"249343",0,0,1,1,"dummy"
"249380",0,3,0,3,"dummy"
"249381",0,2,0,2,"dummy"
"249382",0,1,0,1,"dummy"
"249383",0,1,0,1,"dummy"
"249384",7,8,1,16,"dummy"
"249385",5,7,3,15,"dummy"
"249386",1,1,0,2,"dummy"
"249387",0,1,0,1,"dummy"
"249388",0,7,0,7,"dummy"
"249424",0,1,0,1,"dummy"
"249425",1,12,0,13,"dummy"
"249426",7,4,1,12,"dummy"
"249427",0,1,0,1,"dummy"
"249428",9,5,2,16,"dummy"
"249438",0,5,0,5,"dummy"
"249439",1,0,1,2,"dummy"
"249441",0,0,1,1,"dummy"
"249443",0,1,0,1,"dummy"
"249444",0,0,1,1,"dummy"
"249445",1,8,0,9,"dummy"
"249446",6,0,0,6,"dummy"
"249447",0,0,0,0,"dummy"
"249450",33,53,2,88,"dummy"
"249451",0,0,4,4,"dummy"
"249452",0,4,0,4,"dummy"
"249453",0,5,1,6,"dummy"
"249454",0,1,0,1,"dummy"
"249455",4,4,0,8,"dummy"
"249456",22,1,0,23,"dummy"
"249457",1,0,1,2,"dummy"
"249458",27,6,0,33,"dummy"
"249459",9,1,0,10,"dummy"
"249468",35,16,4,55,"dummy"
"249469",0,4,0,4,"dummy"
"249511",0,1,1,2,"dummy"
"249514",23,3,1,27,"dummy"
"249517",3,0,0,3,"dummy"
"249529",0,0,1,1,"dummy"
"249531",3,4,2,9,"dummy"
"249532",3,0,0,3,"dummy"
"249533",4,14,0,18,"dummy"
"249534",5,0,2,7,"dummy"
"249535",5,7,3,15,"dummy"
"249536",6,6,1,13,"dummy"
"249537",1,0,0,1,"dummy"
"249538",0,0,2,2,"dummy"
"249540",0,1,0,1,"dummy"
"249542",1,1,0,2,"dummy"
"249544",0,0,1,1,"dummy"
"249562",1,1,1,3,"dummy"
"249563",7,3,1,11,"dummy"
"249564",0,0,1,1,"dummy"
"249573",1,0,0,1,"dummy"
"249577",6,1,1,8,"dummy"
"249579",0,3,0,3,"dummy"
"249580",0,7,0,7,"dummy"
"249585",6,0,0,6,"dummy"
"249586",2,5,2,9,"dummy"
"249591",1,0,0,1,"dummy"
"249592",0,1,0,1,"dummy"
"249593",0,1,0,1,"dummy"
"249594",0,0,1,1,"dummy"
"249595",1,14,0,15,"dummy"
"249609",0,0,1,1,"dummy"
"249610",0,0,1,1,"dummy"
"249611",0,0,1,1,"dummy"
"249612",0,0,1,1,"dummy"
"249614",0,0,1,1,"dummy"
"249616",0,0,1,1,"dummy"
"249618",0,0,1,1,"dummy"
"249621",0,0,0,0,"dummy"
"249622",2,0,0,2,"dummy"
"249624",0,1,0,1,"dummy"
"249626",2,2,1,5,"dummy"
"249627",0,0,1,1,"dummy"
"249628",3,3,2,8,"dummy"
"249630",0,3,0,3,"dummy"
"249632",3,4,2,9,"dummy"
"249633",0,1,0,1,"dummy"
"249634",0,0,1,1,"dummy"
"249637",0,0,1,1,"dummy"
"249638",0,0,3,3,"dummy"
"249643",0,0,2,2,"dummy"
"249649",0,10,0,10,"dummy"
"249654",0,2,0,2,"dummy"
"249664",0,2,3,5,"dummy"
"249667",0,5,0,5,"dummy"
"249669",0,0,1,1,"dummy"
"249670",0,1,0,1,"dummy"
"249671",0,0,1,1,"dummy"
"249672",0,0,1,1,"dummy"
"249674",1,5,1,7,"dummy"
"249677",0,2,1,3,"dummy"
"249679",0,0,0,0,"dummy"
"249680",0,1,1,2,"dummy"
"249683",0,0,2,2,"dummy"
"249685",7,16,0,23,"dummy"
"249686",2,2,0,4,"dummy"
"249687",1,8,3,12,"dummy"
"249688",0,2,0,2,"dummy"
"249690",5,1,1,7,"dummy"
"249691",0,3,0,3,"dummy"
"249692",0,0,1,1,"dummy"
"249693",0,3,0,3,"dummy"
"249694",0,0,0,0,"dummy"
"249695",1,2,1,4,"dummy"
"249696",1,3,1,5,"dummy"
"249697",0,1,1,2,"dummy"
"249700",2,4,0,6,"dummy"
"249701",0,2,0,2,"dummy"
"249702",0,2,0,2,"dummy"
"249703",10,2,0,12,"dummy"
"249704",0,2,0,2,"dummy"
"249711",2,0,3,5,"dummy"
"249712",0,0,0,0,"dummy"
"249715",0,0,1,1,"dummy"
"249716",1,8,0,9,"dummy"
"249717",0,5,2,7,"dummy"
"249718",0,3,3,6,"dummy"
"249719",0,0,0,0,"dummy"
"249720",0,0,2,2,"dummy"
"249725",0,2,0,2,"dummy"
"249726",0,0,2,2,"dummy"
"249729",9,1,1,11,"dummy"
"249730",0,0,2,2,"dummy"
"249731",0,0,2,2,"dummy"
"249750",0,0,0,0,"dummy"
"249751",0,1,0,1,"dummy"
"249755",0,13,0,13,"dummy"
"249756",0,2,0,2,"dummy"
"249757",0,1,0,1,"dummy"
"249758",0,0,1,1,"dummy"
"249759",0,3,0,3,"dummy"
"249760",0,1,0,1,"dummy"
"249761",0,1,0,1,"dummy"
"249762",0,1,0,1,"dummy"
"249763",0,0,1,1,"dummy"
"249764",0,0,1,1,"dummy"
"249765",0,0,0,0,"dummy"
"249766",0,2,0,2,"dummy"
"249767",0,3,0,3,"dummy"
"249768",3,7,0,10,"dummy"
"249769",0,1,0,1,"dummy"
"249770",3,0,0,3,"dummy"
"249771",0,1,0,1,"dummy"
"249772",0,1,0,1,"dummy"
"249836",0,1,1,2,"dummy"
"249858",2,5,1,8,"dummy"
"249859",0,0,1,1,"dummy"
"249860",0,0,2,2,"dummy"
"249861",7,8,5,20,"dummy"
"249862",0,0,1,1,"dummy"
"249863",12,1,1,14,"dummy"
"249864",1,19,0,20,"dummy"
"249878",0,13,1,14,"dummy"
"249883",0,1,0,1,"dummy"
"249884",0,0,0,0,"dummy"
"249887",0,0,1,1,"dummy"
"249888",1,0,1,2,"dummy"
"249889",0,3,3,6,"dummy"
"249890",0,1,1,2,"dummy"
"249902",0,1,0,1,"dummy"
"249903",9,18,2,29,"dummy"
"249904",2,7,0,9,"dummy"
"249905",2,4,0,6,"dummy"
"249906",8,8,0,16,"dummy"
"249911",0,8,0,8,"dummy"
"249912",0,0,1,1,"dummy"
"249913",6,6,0,12,"dummy"
"249914",6,6,0,12,"dummy"
"249940",0,1,0,1,"dummy"
"249941",8,16,0,24,"dummy"
"249942",1,0,0,1,"dummy"
"249943",1,2,0,3,"dummy"
"249944",3,2,1,6,"dummy"
"249945",0,0,2,2,"dummy"
"249946",0,1,2,3,"dummy"
"249947",0,1,1,2,"dummy"
"249948",1,0,0,1,"dummy"
"249949",0,0,1,1,"dummy"
"249722",0,1,0,1,"dummy"
"249723",1,2,0,3,"dummy"
"249733",16,15,0,31,"dummy"
"249734",0,0,1,1,"dummy"
"249735",15,16,1,32,"dummy"
"249736",16,0,1,17,"dummy"
"249737",1,35,3,39,"dummy"
"249738",35,1,3,39,"dummy"
"249739",0,0,0,0,"dummy"
"249740",1,34,3,38,"dummy"
"249741",35,2,3,40,"dummy"
"249742",1,1,1,3,"dummy"
"249743",0,0,1,1,"dummy"
"249744",0,23,0,23,"dummy"
"249753",1,2,0,3,"dummy"
"249774",2,0,0,2,"dummy"
"249775",0,0,1,1,"dummy"
"249776",0,0,1,1,"dummy"
"249777",1,0,0,1,"dummy"
"249778",1,1,0,2,"dummy"
"249779",2,0,0,2,"dummy"
"249829",2,0,1,3,"dummy"
"249830",4,2,1,7,"dummy"
"249834",0,0,2,2,"dummy"
"249838",1,0,0,1,"dummy"
"249839",0,3,0,3,"dummy"
"249840",1,3,0,4,"dummy"
"249841",0,0,1,1,"dummy"
"249842",0,0,1,1,"dummy"
"249843",0,1,0,1,"dummy"
"249844",0,2,0,2,"dummy"
"249849",0,1,0,1,"dummy"
"249850",0,1,0,1,"dummy"
"249851",0,1,0,1,"dummy"
"249852",0,0,0,0,"dummy"
"249853",0,1,0,1,"dummy"
"249854",0,2,0,2,"dummy"
"249866",0,0,0,0,"dummy"
"249867",0,0,1,1,"dummy"
"249870",0,0,2,2,"dummy"
"249871",6,9,2,17,"dummy"
"249872",0,1,0,1,"dummy"
"249873",0,4,0,4,"dummy"
"249874",0,1,1,2,"dummy"
"249875",0,0,1,1,"dummy"
"249876",1,1,1,3,"dummy"
"249892",1,1,0,2,"dummy"
"249900",0,0,1,1,"dummy"
"249916",0,0,2,2,"dummy"
"249917",3,6,2,11,"dummy"
"249920",0,0,0,0,"dummy"
"249921",0,2,0,2,"dummy"
"249922",2,0,0,2,"dummy"
"249923",0,0,1,1,"dummy"
"249924",0,1,0,1,"dummy"
"249951",0,1,0,1,"dummy"
"249952",3,5,0,8,"dummy"
"249953",6,10,0,16,"dummy"
"249954",2,0,0,2,"dummy"
"249955",2,0,0,2,"dummy"
"249958",0,0,0,0,"dummy"
"249959",14,7,5,26,"dummy"
"249960",5,5,2,12,"dummy"
"249961",2,7,3,12,"dummy"
"249962",12,4,0,16,"dummy"
"249971",0,2,2,4,"dummy"
"249972",6,5,1,12,"dummy"
"249973",0,0,1,1,"dummy"
"249983",0,0,1,1,"dummy"
"249984",0,0,1,1,"dummy"
"249966",7,12,0,19,"dummy"
"249967",0,1,0,1,"dummy"
"249968",20,1,1,22,"dummy"
"249969",3,1,0,4,"dummy"
"249994",0,0,1,1,"dummy"
"249995",0,2,0,2,"dummy"
"250000",0,0,0,0,"dummy"
"250006",0,2,0,2,"dummy"
"250007",0,1,0,1,"dummy"
"249997",0,0,2,2,"dummy"
"249998",1,0,0,1,"dummy"
"250002",0,1,0,1,"dummy"
"250003",0,2,1,3,"dummy"
"250004",0,1,0,1,"dummy"
"250020",0,1,2,3,"dummy"
"250022",0,1,0,1,"dummy"
"250024",0,2,0,2,"dummy"
"250029",4,0,0,4,"dummy"
"250030",8,11,2,21,"dummy"
"250031",1,0,0,1,"dummy"
"250034",4,3,1,8,"dummy"
"250035",1,0,2,3,"dummy"
"250036",0,1,2,3,"dummy"
"250038",0,0,1,1,"dummy"
"250039",2,1,2,5,"dummy"
"250040",0,1,0,1,"dummy"
"250043",0,1,0,1,"dummy"
"250044",0,1,0,1,"dummy"
"250047",1,0,0,1,"dummy"
"250048",5,1,0,6,"dummy"
"250050",15,5,1,21,"dummy"
"250065",2,2,0,4,"dummy"
"250066",4,35,0,39,"dummy"
"250069",1,0,0,1,"dummy"
"250070",1,1,1,3,"dummy"
"250071",0,0,1,1,"dummy"
"250072",1,0,1,2,"dummy"
"250075",0,7,2,9,"dummy"
"250076",6,3,1,10,"dummy"
"250077",0,5,2,7,"dummy"
"250078",0,0,1,1,"dummy"
"250079",0,0,1,1,"dummy"
"250080",0,2,1,3,"dummy"
"250083",1,0,1,2,"dummy"
"250093",3,6,3,12,"dummy"
"250095",0,0,1,1,"dummy"
"250098",0,0,1,1,"dummy"
"250128",0,0,0,0,"dummy"
"250130",0,0,2,2,"dummy"
"250134",2,4,0,6,"dummy"
"250136",0,0,2,2,"dummy"
"250137",3,0,0,3,"dummy"
"250141",10,10,0,20,"dummy"
"250142",0,0,1,1,"dummy"
"250143",0,0,1,1,"dummy"
"250147",0,1,0,1,"dummy"
"250148",0,0,1,1,"dummy"
"250149",6,7,2,15,"dummy"
"250150",15,0,0,15,"dummy"
"250151",0,2,1,3,"dummy"
"250152",1,7,1,9,"dummy"
"250153",2,3,0,5,"dummy"
"250154",3,3,0,6,"dummy"
"250155",8,0,0,8,"dummy"
"250156",0,0,1,1,"dummy"
"250161",0,0,0,0,"dummy"
"250162",0,0,0,0,"dummy"
"250163",0,0,0,0,"dummy"
"250164",2,0,0,2,"dummy"
"250166",0,0,1,1,"dummy"
"250167",2,7,0,9,"dummy"
"250170",0,2,0,2,"dummy"
"250174",2,0,0,2,"dummy"
"250176",0,0,1,1,"dummy"
"250181",1,0,3,4,"dummy"
"250183",0,0,1,1,"dummy"
"250184",0,2,0,2,"dummy"
"250185",1,2,1,4,"dummy"
"250186",0,5,0,5,"dummy"
"250187",0,2,0,2,"dummy"
"250188",2,0,0,2,"dummy"
"250189",0,6,0,6,"dummy"
"250190",0,2,1,3,"dummy"
"250191",0,1,1,2,"dummy"
"250192",0,0,1,1,"dummy"
"250193",0,0,1,1,"dummy"
"250194",0,0,2,2,"dummy"
"250195",0,2,0,2,"dummy"
"250196",0,1,0,1,"dummy"
"250197",14,20,1,35,"dummy"
"250198",2,3,1,6,"dummy"
"250203",0,0,0,0,"dummy"
"250204",0,0,0,0,"dummy"
"250205",1,0,0,1,"dummy"
"250206",3,5,0,8,"dummy"
"250208",0,2,0,2,"dummy"
"250209",0,6,0,6,"dummy"
"250210",0,1,1,2,"dummy"
"250211",0,3,0,3,"dummy"
"250212",4,5,0,9,"dummy"
"250213",0,1,0,1,"dummy"
"250214",1,3,0,4,"dummy"
"250215",17,1,3,21,"dummy"
"250217",0,1,0,1,"dummy"
"250219",4,5,1,10,"dummy"
"250220",0,2,0,2,"dummy"
"250248",5,0,2,7,"dummy"
"250250",0,0,3,3,"dummy"
"250251",0,0,1,1,"dummy"
"250254",0,0,1,1,"dummy"
"250258",2,4,0,6,"dummy"
"250259",0,2,0,2,"dummy"
"250260",0,2,0,2,"dummy"
"250261",10,2,0,12,"dummy"
"250262",0,2,0,2,"dummy"
"250263",0,0,0,0,"dummy"
"250264",0,0,3,3,"dummy"
"250265",0,5,0,5,"dummy"
"250266",1,0,1,2,"dummy"
"250269",0,8,0,8,"dummy"
"250270",2,12,1,15,"dummy"
"250271",0,1,0,1,"dummy"
"250274",0,0,2,2,"dummy"
"250275",0,0,2,2,"dummy"
"250276",0,0,1,1,"dummy"
"250278",0,0,1,1,"dummy"
"250280",0,0,1,1,"dummy"
"250286",0,1,0,1,"dummy"
"250289",1,0,0,1,"dummy"
"250290",0,1,0,1,"dummy"
"250291",2,12,0,14,"dummy"
"250292",1,2,1,4,"dummy"
"250293",0,2,0,2,"dummy"
"250294",0,0,2,2,"dummy"
"250295",0,1,0,1,"dummy"
"250298",1,1,0,2,"dummy"
"250299",1,2,0,3,"dummy"
"250302",1,2,0,3,"dummy"
"250307",0,0,1,1,"dummy"
"250317",1,0,0,1,"dummy"
"250320",2,2,0,4,"dummy"
"250322",3,4,1,8,"dummy"
"250323",0,3,0,3,"dummy"
"250324",4,3,2,9,"dummy"
"250325",6,5,2,13,"dummy"
"250327",11,23,4,38,"dummy"
"250328",1,0,0,1,"dummy"
"250335",3,4,0,7,"dummy"
"250336",0,1,0,1,"dummy"
"250337",0,1,0,1,"dummy"
"250338",0,10,0,10,"dummy"
"250341",0,0,0,0,"dummy"
"250342",0,0,1,1,"dummy"
"250345",0,1,0,1,"dummy"
"250346",0,1,0,1,"dummy"
"250347",0,1,0,1,"dummy"
"250348",1,2,0,3,"dummy"
"250349",0,1,0,1,"dummy"
"250355",1,20,1,22,"dummy"
"250356",0,8,0,8,"dummy"
"250357",6,1,0,7,"dummy"
"250360",0,0,0,0,"dummy"
"250361",0,0,1,1,"dummy"
"250362",0,0,0,0,"dummy"
"250364",0,1,0,1,"dummy"
"250365",0,2,0,2,"dummy"
"250366",4,7,1,12,"dummy"
"250367",2,9,0,11,"dummy"
"250368",1,0,0,1,"dummy"
"250369",0,1,0,1,"dummy"
"250370",0,0,1,1,"dummy"
"250373",0,0,1,1,"dummy"
"250374",1,6,0,7,"dummy"
"250375",2,2,0,4,"dummy"
"250376",0,1,0,1,"dummy"
"250378",0,1,0,1,"dummy"
"250379",0,1,0,1,"dummy"
"250380",5,13,3,21,"dummy"
"250381",2,10,0,12,"dummy"
"250382",0,0,1,1,"dummy"
"250384",1,2,2,5,"dummy"
"250394",0,2,0,2,"dummy"
"250396",0,8,0,8,"dummy"
"250399",0,0,1,1,"dummy"
"250403",0,1,1,2,"dummy"
"250404",0,1,0,1,"dummy"
"250405",6,15,1,22,"dummy"
"250406",9,3,0,12,"dummy"
"250407",0,2,0,2,"dummy"
"250416",0,2,1,3,"dummy"
"250417",3,6,6,15,"dummy"
"250449",1,0,0,1,"dummy"
"250455",7,0,0,7,"dummy"
"250456",0,0,1,1,"dummy"
"250457",7,2,0,9,"dummy"
"250458",0,2,0,2,"dummy"
"250459",0,0,1,1,"dummy"
"250460",0,0,1,1,"dummy"
"250463",0,0,0,0,"dummy"
"250464",0,1,0,1,"dummy"
"250465",5,0,0,5,"dummy"
"250488",0,4,2,6,"dummy"
"250491",5,7,6,18,"dummy"
"250492",9,6,2,17,"dummy"
"250514",2,2,1,5,"dummy"
"250522",1,0,0,1,"dummy"
"250527",4,7,2,13,"dummy"
"250528",1,3,2,6,"dummy"
"250529",0,1,0,1,"dummy"
"250530",0,0,0,0,"dummy"
"250531",6,1,0,7,"dummy"
"250532",0,1,1,2,"dummy"
"250533",0,2,0,2,"dummy"
"250534",1,2,0,3,"dummy"
"250535",0,3,0,3,"dummy"
"250536",0,1,0,1,"dummy"
"250537",0,1,0,1,"dummy"
"250538",0,2,0,2,"dummy"
"250539",2,5,0,7,"dummy"
"250540",0,1,0,1,"dummy"
"250541",3,13,2,18,"dummy"
"250542",2,3,0,5,"dummy"
"250543",0,4,0,4,"dummy"
"250544",56,0,2,58,"dummy"
"250545",0,0,1,1,"dummy"
"250546",0,0,1,1,"dummy"
"250547",0,0,1,1,"dummy"
"250548",0,0,1,1,"dummy"
"250549",0,0,1,1,"dummy"
"250550",0,0,1,1,"dummy"
"250551",0,0,1,1,"dummy"
"250554",0,0,1,1,"dummy"
"250555",0,0,1,1,"dummy"
"250579",0,2,0,2,"dummy"
"250580",2,1,0,3,"dummy"
"250581",0,4,0,4,"dummy"
"250585",0,1,0,1,"dummy"
"250586",1,2,1,4,"dummy"
"250587",0,4,1,5,"dummy"
"250590",0,1,0,1,"dummy"
"250591",6,1,1,8,"dummy"
"250592",0,2,1,3,"dummy"
"250593",2,6,1,9,"dummy"
"250642",2,2,1,5,"dummy"
"250659",0,0,1,1,"dummy"
"250662",1,1,1,3,"dummy"
"250669",2,1,4,7,"dummy"
"250677",2,51,3,56,"dummy"
"250678",8,9,1,18,"dummy"
"250679",14,8,3,25,"dummy"
"250680",0,0,1,1,"dummy"
"250409",0,0,0,0,"dummy"
"250410",0,0,0,0,"dummy"
"250411",0,0,0,0,"dummy"
"250412",0,0,0,0,"dummy"
"250419",3,1,1,5,"dummy"
"250422",1,1,0,2,"dummy"
"250423",0,1,0,1,"dummy"
"250424",2,3,1,6,"dummy"
"250437",0,2,0,2,"dummy"
"250440",0,0,0,0,"dummy"
"250441",0,0,0,0,"dummy"
"250442",0,0,0,0,"dummy"
"250443",2,1,1,4,"dummy"
"250446",0,7,2,9,"dummy"
"250447",0,0,1,1,"dummy"
"250451",0,0,0,0,"dummy"
"250452",0,0,4,4,"dummy"
"250453",0,0,3,3,"dummy"
"250467",4,13,4,21,"dummy"
"250468",0,0,8,8,"dummy"
"250469",3,15,0,18,"dummy"
"250470",2,0,0,2,"dummy"
"250471",0,1,0,1,"dummy"
"250472",4,3,1,8,"dummy"
"250473",0,0,1,1,"dummy"
"250474",0,0,2,2,"dummy"
"250475",0,2,2,4,"dummy"
"250476",0,1,0,1,"dummy"
"250477",1,2,0,3,"dummy"
"250478",2,2,0,4,"dummy"
"250483",1,2,0,3,"dummy"
"250484",0,1,0,1,"dummy"
"250485",0,0,0,0,"dummy"
"250486",7,1,2,10,"dummy"
"250494",2,8,1,11,"dummy"
"250495",0,1,0,1,"dummy"
"250498",2,9,0,11,"dummy"
"250499",0,0,1,1,"dummy"
"250500",1,5,1,7,"dummy"
"250503",0,3,0,3,"dummy"
"250504",7,2,2,11,"dummy"
"250505",19,18,0,37,"dummy"
"250516",0,1,2,3,"dummy"
"250517",0,0,0,0,"dummy"
"250518",0,2,0,2,"dummy"
"250519",5,0,2,7,"dummy"
"250520",1,0,0,1,"dummy"
"250524",0,1,0,1,"dummy"
"250525",0,0,1,1,"dummy"
"250557",9,1,0,10,"dummy"
"250558",4,4,5,13,"dummy"
"250559",0,0,1,1,"dummy"
"250560",0,4,0,4,"dummy"
"250561",0,8,0,8,"dummy"
"250568",0,0,1,1,"dummy"
"250583",0,1,3,4,"dummy"
"250595",1,0,1,2,"dummy"
"250596",3,8,6,17,"dummy"
"250597",0,6,0,6,"dummy"
"250598",0,2,2,4,"dummy"
"250599",8,2,2,12,"dummy"
"250600",0,8,2,10,"dummy"
"250601",0,13,1,14,"dummy"
"250602",0,1,0,1,"dummy"
"250603",0,1,0,1,"dummy"
"250606",3,4,1,8,"dummy"
"250607",0,8,2,10,"dummy"
"250610",0,1,0,1,"dummy"
"250611",0,1,0,1,"dummy"
"250612",0,0,1,1,"dummy"
"250613",0,0,1,1,"dummy"
"250614",0,0,1,1,"dummy"
"250615",0,0,1,1,"dummy"
"250616",0,0,1,1,"dummy"
"250617",0,0,1,1,"dummy"
"250618",0,6,2,8,"dummy"
"250619",0,0,1,1,"dummy"
"250620",0,0,1,1,"dummy"
"250621",0,1,0,1,"dummy"
"250622",0,4,0,4,"dummy"
"250623",0,0,1,1,"dummy"
"250624",0,0,1,1,"dummy"
"250625",0,0,1,1,"dummy"
"250626",0,0,1,1,"dummy"
"250627",0,0,1,1,"dummy"
"250628",0,0,1,1,"dummy"
"250629",0,0,1,1,"dummy"
"250630",0,0,1,1,"dummy"
"250631",0,0,1,1,"dummy"
"250632",0,0,1,1,"dummy"
"250633",0,0,1,1,"dummy"
"250634",0,0,1,1,"dummy"
"250635",0,0,1,1,"dummy"
"250636",0,1,0,1,"dummy"
"250637",0,0,1,1,"dummy"
"250638",0,0,1,1,"dummy"
"250639",0,0,1,1,"dummy"
"250640",1,2,1,4,"dummy"
"250664",1,1,2,4,"dummy"
"250665",0,1,0,1,"dummy"
"250666",2,0,3,5,"dummy"
"250667",3,0,1,4,"dummy"
"250673",2,4,1,7,"dummy"
"250687",0,1,0,1,"dummy"
"250688",1,0,0,1,"dummy"
"250689",0,0,1,1,"dummy"
"250690",0,1,0,1,"dummy"
"250691",1,0,4,5,"dummy"
"250692",0,0,2,2,"dummy"
"250693",2,3,2,7,"dummy"
"250694",0,1,0,1,"dummy"
"250695",1,3,1,5,"dummy"
"250696",4,12,0,16,"dummy"
"250697",0,0,0,0,"dummy"
"250698",0,0,2,2,"dummy"
"250699",5,2,1,8,"dummy"
"250700",0,0,2,2,"dummy"
"250701",0,0,1,1,"dummy"
"250702",1,7,0,8,"dummy"
"250703",2,2,0,4,"dummy"
"250704",0,0,1,1,"dummy"
"250707",1,2,0,3,"dummy"
"250708",0,0,1,1,"dummy"
"250709",0,2,0,2,"dummy"
"250712",0,0,1,1,"dummy"
"250713",0,0,0,0,"dummy"
"250716",1,1,1,3,"dummy"
"250717",0,1,0,1,"dummy"
"250718",1,0,0,1,"dummy"
"250725",0,0,1,1,"dummy"
"250726",0,1,0,1,"dummy"
"250727",0,1,0,1,"dummy"
"250728",0,0,0,0,"dummy"
"250730",0,0,1,1,"dummy"
"250731",0,1,1,2,"dummy"
"250732",3,1,2,6,"dummy"
"250733",0,1,0,1,"dummy"
"250735",0,0,0,0,"dummy"
"250736",0,7,3,10,"dummy"
"250737",0,0,1,1,"dummy"
"250739",0,0,1,1,"dummy"
"250740",0,0,1,1,"dummy"
"250744",0,2,0,2,"dummy"
"250745",2,0,0,2,"dummy"
"250746",0,4,0,4,"dummy"
"250747",3,0,0,3,"dummy"
"250748",0,0,1,1,"dummy"
"250750",0,2,0,2,"dummy"
"250754",0,0,0,0,"dummy"
"250755",0,2,0,2,"dummy"
"250756",5,18,0,23,"dummy"
"250757",1,1,0,2,"dummy"
"250758",1,1,0,2,"dummy"
"250767",0,0,1,1,"dummy"
"250772",0,3,1,4,"dummy"
"250789",5,4,1,10,"dummy"
"250790",2,3,0,5,"dummy"
"250791",0,1,0,1,"dummy"
"250792",0,3,2,5,"dummy"
"250793",0,1,0,1,"dummy"
"250796",2,4,0,6,"dummy"
"250797",0,2,0,2,"dummy"
"250798",0,2,0,2,"dummy"
"250799",10,2,0,12,"dummy"
"250800",0,2,0,2,"dummy"
"250801",0,0,0,0,"dummy"
"250802",0,0,3,3,"dummy"
"250803",0,5,0,5,"dummy"
"250808",0,1,0,1,"dummy"
"250809",0,0,1,1,"dummy"
"250810",0,2,1,3,"dummy"
"250811",0,2,0,2,"dummy"
"250812",0,0,0,0,"dummy"
"250813",0,0,0,0,"dummy"
"250814",0,0,0,0,"dummy"
"250815",0,0,0,0,"dummy"
"250816",13,5,0,18,"dummy"
"250817",0,0,0,0,"dummy"
"250818",0,0,0,0,"dummy"
"250819",0,0,0,0,"dummy"
"250820",1,3,0,4,"dummy"
"250821",0,0,0,0,"dummy"
"250822",0,0,1,1,"dummy"
"250823",0,1,0,1,"dummy"
"250830",0,1,1,2,"dummy"
"250831",0,0,2,2,"dummy"
"250832",0,3,2,5,"dummy"
"250833",0,0,0,0,"dummy"
"250836",0,1,0,1,"dummy"
"250837",0,0,0,0,"dummy"
"250838",0,4,0,4,"dummy"
"250844",2,6,1,9,"dummy"
"250845",0,0,1,1,"dummy"
"250846",1,1,3,5,"dummy"
"250849",0,0,0,0,"dummy"
"250850",5,0,2,7,"dummy"
"250851",0,0,0,0,"dummy"
"250858",0,1,0,1,"dummy"
"250859",0,0,1,1,"dummy"
"250860",0,0,1,1,"dummy"
"250861",0,0,1,1,"dummy"
"250867",0,1,0,1,"dummy"
"250880",0,0,1,1,"dummy"
"250881",0,1,0,1,"dummy"
"250882",0,0,2,2,"dummy"
"250883",0,5,0,5,"dummy"
"250884",4,5,0,9,"dummy"
"250889",0,0,1,1,"dummy"
"250890",0,0,1,1,"dummy"
"250891",4,2,2,8,"dummy"
"250892",2,6,2,10,"dummy"
"250898",6,0,0,6,"dummy"
"250899",0,0,1,1,"dummy"
"250900",0,0,0,0,"dummy"
"250901",2,2,1,5,"dummy"
"250902",1,2,1,4,"dummy"
"250903",0,0,0,0,"dummy"
"250904",0,0,0,0,"dummy"
"250910",1,1,1,3,"dummy"
"250913",6,8,5,19,"dummy"
"250916",0,2,0,2,"dummy"
"250917",0,1,0,1,"dummy"
"250918",1,6,0,7,"dummy"
"250919",2,3,0,5,"dummy"
"250920",0,2,0,2,"dummy"
"250921",1,0,1,2,"dummy"
"250922",3,0,0,3,"dummy"
"250923",9,7,0,16,"dummy"
"250924",2,0,0,2,"dummy"
"250925",0,0,1,1,"dummy"
"250926",0,1,0,1,"dummy"
"250927",1,0,0,1,"dummy"
"250928",1,1,0,2,"dummy"
"250929",0,1,0,1,"dummy"
"250930",1,1,0,2,"dummy"
"250933",0,2,0,2,"dummy"
"250762",3,0,0,3,"dummy"
"250763",0,0,1,1,"dummy"
"250764",0,1,0,1,"dummy"
"250765",0,0,2,2,"dummy"
"250769",0,0,0,0,"dummy"
"250770",0,0,2,2,"dummy"
"250774",0,1,0,1,"dummy"
"250775",0,1,0,1,"dummy"
"250776",0,4,0,4,"dummy"
"250777",0,1,0,1,"dummy"
"250778",2,7,1,10,"dummy"
"250779",0,1,1,2,"dummy"
"250780",0,0,1,1,"dummy"
"250781",0,1,1,2,"dummy"
"250782",0,1,1,2,"dummy"
"250783",0,0,1,1,"dummy"
"250784",0,1,1,2,"dummy"
"250785",0,1,1,2,"dummy"
"250786",0,1,1,2,"dummy"
"250787",0,1,1,2,"dummy"
"250805",0,0,0,0,"dummy"
"250806",0,0,0,0,"dummy"
"250825",5,4,3,12,"dummy"
"250826",2,0,2,4,"dummy"
"250827",0,0,0,0,"dummy"
"250828",1,0,2,3,"dummy"
"250863",0,0,0,0,"dummy"
"250869",10,4,3,17,"dummy"
"250870",0,2,0,2,"dummy"
"250871",0,0,1,1,"dummy"
"250872",0,0,1,1,"dummy"
"250873",0,0,1,1,"dummy"
"250874",3,0,1,4,"dummy"
"250875",4,2,1,7,"dummy"
"250876",0,2,0,2,"dummy"
"250877",2,0,0,2,"dummy"
"250878",0,0,1,1,"dummy"
"250894",0,1,0,1,"dummy"
"250895",1,0,0,1,"dummy"
"250896",0,1,0,1,"dummy"
"250906",0,0,1,1,"dummy"
"250937",1,0,0,1,"dummy"
"250938",0,1,0,1,"dummy"
"250939",0,0,1,1,"dummy"
"250940",7,11,0,18,"dummy"
"250941",1,0,0,1,"dummy"
"250942",9,6,1,16,"dummy"
"250951",0,39,0,39,"dummy"
"250952",0,1,0,1,"dummy"
"250953",0,1,0,1,"dummy"
"250954",0,10,0,10,"dummy"
"250955",0,0,1,1,"dummy"
"250956",1,0,0,1,"dummy"
"250994",0,0,1,1,"dummy"
"250995",9,2,3,14,"dummy"
"250996",0,0,1,1,"dummy"
"251013",16,5,2,23,"dummy"
"251014",4,0,0,4,"dummy"
"251025",0,1,0,1,"dummy"
"251026",0,0,1,1,"dummy"
"251027",0,0,1,1,"dummy"
"251028",0,0,1,1,"dummy"
"251029",0,0,1,1,"dummy"
"251030",0,0,1,1,"dummy"
"251031",8,8,1,17,"dummy"
"251034",2,1,0,3,"dummy"
"251035",0,1,0,1,"dummy"
"251038",0,4,0,4,"dummy"
"251041",1,1,0,2,"dummy"
"251042",2,10,0,12,"dummy"
"250944",0,0,1,1,"dummy"
"250945",7,7,0,14,"dummy"
"250946",0,1,0,1,"dummy"
"250947",3,0,0,3,"dummy"
"250958",0,0,0,0,"dummy"
"250961",0,2,0,2,"dummy"
"250962",0,0,1,1,"dummy"
"250963",1,1,0,2,"dummy"
"250964",0,0,1,1,"dummy"
"250965",0,2,0,2,"dummy"
"250966",0,0,3,3,"dummy"
"250967",0,0,1,1,"dummy"
"250968",0,2,1,3,"dummy"
"250969",11,13,2,26,"dummy"
"250970",0,2,1,3,"dummy"
"250971",1,0,0,1,"dummy"
"250972",0,3,0,3,"dummy"
"250973",10,1,0,11,"dummy"
"250974",0,0,3,3,"dummy"
"250975",2,1,0,3,"dummy"
"250976",11,4,1,16,"dummy"
"250977",2,2,0,4,"dummy"
"250978",0,0,1,1,"dummy"
"250979",0,0,1,1,"dummy"
"250980",0,0,1,1,"dummy"
"250981",0,0,1,1,"dummy"
"250982",0,0,1,1,"dummy"
"250983",0,0,1,1,"dummy"
"250984",0,0,1,1,"dummy"
"250985",7,5,2,14,"dummy"
"250986",0,0,1,1,"dummy"
"250987",0,2,0,2,"dummy"
"250988",4,2,0,6,"dummy"
"250989",0,0,1,1,"dummy"
"250990",0,0,1,1,"dummy"
"250991",0,0,1,1,"dummy"
"250992",0,0,1,1,"dummy"
"250998",7,10,3,20,"dummy"
"250999",0,2,1,3,"dummy"
"251005",0,1,0,1,"dummy"
"251010",3,1,0,4,"dummy"
"251011",1,9,0,10,"dummy"
"251016",3,9,0,12,"dummy"
"251017",0,0,0,0,"dummy"
"251018",5,0,0,5,"dummy"
"251019",2,5,0,7,"dummy"
"251020",0,3,0,3,"dummy"
"251021",0,0,0,0,"dummy"
"251022",0,0,0,0,"dummy"
"251023",0,0,0,0,"dummy"
"251044",2,4,0,6,"dummy"
"251045",0,2,0,2,"dummy"
"251046",0,2,0,2,"dummy"
"251047",10,2,0,12,"dummy"
"251048",0,2,0,2,"dummy"
"251049",0,0,0,0,"dummy"
"251050",0,0,3,3,"dummy"
"251055",0,1,0,1,"dummy"
"251056",3,2,0,5,"dummy"
"251057",2,0,0,2,"dummy"
"251058",0,2,0,2,"dummy"
"251059",0,2,0,2,"dummy"
"251060",0,3,0,3,"dummy"
"251061",0,0,0,0,"dummy"
"251062",0,0,1,1,"dummy"
"251063",1,0,1,2,"dummy"
"251064",0,1,0,1,"dummy"
"251081",0,5,0,5,"dummy"
"251082",7,3,2,12,"dummy"
"251066",5,0,0,5,"dummy"
"251067",0,10,0,10,"dummy"
"251068",0,2,0,2,"dummy"
"251069",1,1,0,2,"dummy"
"251070",0,3,1,4,"dummy"
"251078",3,7,0,10,"dummy"
"251079",0,0,1,1,"dummy"
"251117",0,2,0,2,"dummy"
"251118",1,2,0,3,"dummy"
"251119",1,1,0,2,"dummy"
"251120",0,1,0,1,"dummy"
"251121",0,0,1,1,"dummy"
"251124",0,0,0,0,"dummy"
"251127",0,0,0,0,"dummy"
"251129",0,1,0,1,"dummy"
"251130",0,1,1,2,"dummy"
"251131",1,2,0,3,"dummy"
"251132",2,1,0,3,"dummy"
"251134",1,5,1,7,"dummy"
"251135",5,1,1,7,"dummy"
"251137",0,2,0,2,"dummy"
"251138",1,0,1,2,"dummy"
"251140",3,1,0,4,"dummy"
"251142",0,3,0,3,"dummy"
"251143",3,0,0,3,"dummy"
"251144",0,2,0,2,"dummy"
"251147",0,0,1,1,"dummy"
"251149",0,1,1,2,"dummy"
"251150",2,1,0,3,"dummy"
"251152",0,0,1,1,"dummy"
"251155",1,3,0,4,"dummy"
"251156",0,0,1,1,"dummy"
"251157",1,4,0,5,"dummy"
"251160",0,1,0,1,"dummy"
"251161",1,3,0,4,"dummy"
"251164",1,1,1,3,"dummy"
"251165",0,0,1,1,"dummy"
"251166",0,1,0,1,"dummy"
"251167",0,0,0,0,"dummy"
"251168",1,0,0,1,"dummy"
"251169",0,12,0,12,"dummy"
"251170",0,4,0,4,"dummy"
"251171",0,1,0,1,"dummy"
"251172",6,2,3,11,"dummy"
"251173",0,1,0,1,"dummy"
"251174",0,0,1,1,"dummy"
"251175",0,2,0,2,"dummy"
"251186",0,2,0,2,"dummy"
"251187",0,1,0,1,"dummy"
"251189",4,4,2,10,"dummy"
"251190",0,0,1,1,"dummy"
"251191",0,0,1,1,"dummy"
"251192",0,0,1,1,"dummy"
"251193",1,0,0,1,"dummy"
"251195",0,4,1,5,"dummy"
"251196",0,5,2,7,"dummy"
"251197",0,2,0,2,"dummy"
"251198",0,1,0,1,"dummy"
"251199",0,0,1,1,"dummy"
"251200",2,2,0,4,"dummy"
"251201",0,1,0,1,"dummy"
"251202",0,0,2,2,"dummy"
"251203",0,0,2,2,"dummy"
"251204",0,2,0,2,"dummy"
"251205",0,2,0,2,"dummy"
"251206",1,0,0,1,"dummy"
"251207",0,1,0,1,"dummy"
"251208",0,1,1,2,"dummy"
"251209",5,0,0,5,"dummy"
"251210",7,3,0,10,"dummy"
"251211",0,0,0,0,"dummy"
"251212",8,3,3,14,"dummy"
"251213",0,0,1,1,"dummy"
"251218",3,2,0,5,"dummy"
"251272",2,1,0,3,"dummy"
"251274",4,2,2,8,"dummy"
"251279",0,1,0,1,"dummy"
"251282",3,0,1,4,"dummy"
"251283",1,2,1,4,"dummy"
"251308",0,0,2,2,"dummy"
"251309",8,8,2,18,"dummy"
"251310",0,0,6,6,"dummy"
"251311",0,0,1,1,"dummy"
"251306",0,0,0,0,"dummy"
"251305",16,2,1,19,"dummy"
"251316",0,1,0,1,"dummy"
"251317",0,1,0,1,"dummy"
"251318",4,0,0,4,"dummy"
"251319",0,2,0,2,"dummy"
"251320",0,1,1,2,"dummy"
"251321",1,0,1,2,"dummy"
"251323",0,5,0,5,"dummy"
"251324",2,7,1,10,"dummy"
"251325",0,1,0,1,"dummy"
"251328",0,0,1,1,"dummy"
"251331",0,0,0,0,"dummy"
"251332",0,0,0,0,"dummy"
"251333",0,0,0,0,"dummy"
"251335",0,0,1,1,"dummy"
"251336",0,0,1,1,"dummy"
"251337",0,1,0,1,"dummy"
"251338",2,2,0,4,"dummy"
"251339",0,0,1,1,"dummy"
"251340",2,2,0,4,"dummy"
"251341",0,1,0,1,"dummy"
"251342",0,1,0,1,"dummy"
"251343",0,0,1,1,"dummy"
"251344",1,0,0,1,"dummy"
"251345",1,1,2,4,"dummy"
"251346",0,0,1,1,"dummy"
"251347",2,0,0,2,"dummy"
"251348",0,0,1,1,"dummy"
"251349",0,0,1,1,"dummy"
"251350",0,0,1,1,"dummy"
"251351",0,0,1,1,"dummy"
"251352",0,0,1,1,"dummy"
"251353",0,0,1,1,"dummy"
"251354",0,0,1,1,"dummy"
"251355",0,1,1,2,"dummy"
"251356",0,0,1,1,"dummy"
"251357",0,2,1,3,"dummy"
"251358",1,2,0,3,"dummy"
"251359",4,1,0,5,"dummy"
"251360",0,1,0,1,"dummy"
"251361",1,2,0,3,"dummy"
"251362",0,0,1,1,"dummy"
"251363",0,1,1,2,"dummy"
"251364",0,0,1,1,"dummy"
"251365",0,0,2,2,"dummy"
"251366",0,0,1,1,"dummy"
"251367",3,1,1,5,"dummy"
"251368",0,0,1,1,"dummy"
"251369",0,0,1,1,"dummy"
"251370",0,0,1,1,"dummy"
"251371",3,2,2,7,"dummy"
"251372",0,0,1,1,"dummy"
"251373",0,0,2,2,"dummy"
"251374",0,0,1,1,"dummy"
"251375",1,0,0,1,"dummy"
"251376",1,1,0,2,"dummy"
"251377",0,0,1,1,"dummy"
"251378",0,0,1,1,"dummy"
"251379",0,0,1,1,"dummy"
"251380",0,0,1,1,"dummy"
"251381",0,0,1,1,"dummy"
"251382",0,0,1,1,"dummy"
"251383",0,0,1,1,"dummy"
"251384",0,0,1,1,"dummy"
"251385",1,2,0,3,"dummy"
"251386",0,0,1,1,"dummy"
"251387",0,0,1,1,"dummy"
"251388",0,1,1,2,"dummy"
"251389",0,0,1,1,"dummy"
"251391",9,4,3,16,"dummy"
"251392",0,0,1,1,"dummy"
"251393",0,0,0,0,"dummy"
"251395",0,0,2,2,"dummy"
"251398",0,0,1,1,"dummy"
"251399",0,0,0,0,"dummy"
"251401",9,2,0,11,"dummy"
"251402",0,0,0,0,"dummy"
"251405",18,26,1,45,"dummy"
"251408",2,0,0,2,"dummy"
"251410",0,1,2,3,"dummy"
"251411",0,0,1,1,"dummy"
"251416",0,1,0,1,"dummy"
"251417",0,1,0,1,"dummy"
"251419",0,0,1,1,"dummy"
"251420",5,2,2,9,"dummy"
"251441",0,2,0,2,"dummy"
"251442",3,3,5,11,"dummy"
"251443",1,7,1,9,"dummy"
"251444",0,2,0,2,"dummy"
"251445",0,2,0,2,"dummy"
"251446",2,5,1,8,"dummy"
"251447",0,2,0,2,"dummy"
"251448",0,9,0,9,"dummy"
"251449",0,1,0,1,"dummy"
"251450",0,2,1,3,"dummy"
"251470",0,4,2,6,"dummy"
"251471",15,0,2,17,"dummy"
"251472",0,1,0,1,"dummy"
"251473",0,1,1,2,"dummy"
"251474",0,1,0,1,"dummy"
"251485",0,3,1,4,"dummy"
"251489",1,5,0,6,"dummy"
"251490",0,0,1,1,"dummy"
"251493",0,1,0,1,"dummy"
"251497",6,0,3,9,"dummy"
"251498",0,0,1,1,"dummy"
"251504",0,1,2,3,"dummy"
"251505",0,0,0,0,"dummy"
"251506",0,1,0,1,"dummy"
"251507",4,0,2,6,"dummy"
"251508",1,0,0,1,"dummy"
"251509",0,0,0,0,"dummy"
"251511",0,0,0,0,"dummy"
"251514",0,9,0,9,"dummy"
"251516",0,1,0,1,"dummy"
"251517",1,0,0,1,"dummy"
"251524",4,1,0,5,"dummy"
"251525",0,0,1,1,"dummy"
"251526",0,0,0,0,"dummy"
"251528",0,1,0,1,"dummy"
"251531",3,6,0,9,"dummy"
"251532",4,8,1,13,"dummy"
"251533",0,0,0,0,"dummy"
"251534",0,0,0,0,"dummy"
"251535",1,0,0,1,"dummy"
"251537",1,0,0,1,"dummy"
"251538",0,0,0,0,"dummy"
"251539",0,0,0,0,"dummy"
"251540",0,0,0,0,"dummy"
"251541",0,1,0,1,"dummy"
"251542",0,0,0,0,"dummy"
"251544",0,0,4,4,"dummy"
"251545",0,0,0,0,"dummy"
"251546",0,0,1,1,"dummy"
"251547",0,4,0,4,"dummy"
"251548",0,0,0,0,"dummy"
"251549",0,0,1,1,"dummy"
"251550",2,2,1,5,"dummy"
"251551",5,0,3,8,"dummy"
"251608",0,0,0,0,"dummy"
"251610",0,0,0,0,"dummy"
"251615",2,11,0,13,"dummy"
"251616",1,1,0,2,"dummy"
"251617",0,0,1,1,"dummy"
"251618",0,0,0,0,"dummy"
"251619",0,3,0,3,"dummy"
"251620",0,0,1,1,"dummy"
"251621",0,0,1,1,"dummy"
"251622",0,1,0,1,"dummy"
"251623",2,3,0,5,"dummy"
"251624",0,1,0,1,"dummy"
"251626",2,16,1,19,"dummy"
"251627",0,0,3,3,"dummy"
"251628",13,6,0,19,"dummy"
"251629",0,0,5,5,"dummy"
"251638",0,0,2,2,"dummy"
"251639",0,0,2,2,"dummy"
"251640",0,0,1,1,"dummy"
"251642",4,18,0,22,"dummy"
"251643",0,3,0,3,"dummy"
"251644",7,7,1,15,"dummy"
"251650",0,0,0,0,"dummy"
"251651",0,0,0,0,"dummy"
"251652",0,0,0,0,"dummy"
"251653",0,0,0,0,"dummy"
"251654",0,0,0,0,"dummy"
"251655",0,0,0,0,"dummy"
"251656",0,0,0,0,"dummy"
"251659",0,0,1,1,"dummy"
"251661",0,2,0,2,"dummy"
"251662",7,1,5,13,"dummy"
"251664",0,0,1,1,"dummy"
"251665",5,0,0,5,"dummy"
"251667",12,14,1,27,"dummy"
"251670",0,2,0,2,"dummy"
"251671",2,0,1,3,"dummy"
"251672",0,0,6,6,"dummy"
"251673",0,3,0,3,"dummy"
"251674",13,10,0,23,"dummy"
"251675",0,0,5,5,"dummy"
"251676",10,2,0,12,"dummy"
"251677",2,0,0,2,"dummy"
"251678",0,1,0,1,"dummy"
"251679",1,1,0,2,"dummy"
"251680",0,1,0,1,"dummy"
"251683",0,1,0,1,"dummy"
"251684",3,2,0,5,"dummy"
"251685",6,10,0,16,"dummy"
"251686",4,0,0,4,"dummy"
"251687",0,1,1,2,"dummy"
"251688",2,3,0,5,"dummy"
"251689",0,1,0,1,"dummy"
"251690",15,2,0,17,"dummy"
"251692",1,4,1,6,"dummy"
"251693",3,1,0,4,"dummy"
"251694",6,11,0,17,"dummy"
"251695",2,2,0,4,"dummy"
"251696",7,3,0,10,"dummy"
"251697",0,0,1,1,"dummy"
"251698",4,4,1,9,"dummy"
"251699",0,7,1,8,"dummy"
"251701",2,4,0,6,"dummy"
"251702",0,2,0,2,"dummy"
"251703",0,2,0,2,"dummy"
"251704",10,2,0,12,"dummy"
"251705",0,2,0,2,"dummy"
"251710",2,0,3,5,"dummy"
"251711",1,0,0,1,"dummy"
"251712",0,1,0,1,"dummy"
"251713",0,1,1,2,"dummy"
"251715",0,1,0,1,"dummy"
"251717",0,0,1,1,"dummy"
"251718",2,0,0,2,"dummy"
"251721",0,2,0,2,"dummy"
"251723",0,0,1,1,"dummy"
"251724",1,0,0,1,"dummy"
"251727",2,1,0,3,"dummy"
"251728",3,9,0,12,"dummy"
"251733",2,0,1,3,"dummy"
"251734",0,3,1,4,"dummy"
"251735",0,0,1,1,"dummy"
"251736",1,0,0,1,"dummy"
"251737",0,1,0,1,"dummy"
"251738",0,0,1,1,"dummy"
"251739",1,3,0,4,"dummy"
"251740",6,2,2,10,"dummy"
"251741",0,0,1,1,"dummy"
"251742",0,0,1,1,"dummy"
"251743",1,2,0,3,"dummy"
"251744",2,0,0,2,"dummy"
"251745",0,1,0,1,"dummy"
"251746",0,1,0,1,"dummy"
"251747",1,0,0,1,"dummy"
"251748",0,1,0,1,"dummy"
"251749",1,0,0,1,"dummy"
"251750",0,1,0,1,"dummy"
"251751",0,1,0,1,"dummy"
"251752",0,1,0,1,"dummy"
"251753",0,0,0,0,"dummy"
"251754",0,0,0,0,"dummy"
"251755",0,0,1,1,"dummy"
"251756",0,2,0,2,"dummy"
"251757",0,0,1,1,"dummy"
"251760",0,0,0,0,"dummy"
"251762",0,0,1,1,"dummy"
"251763",0,0,1,1,"dummy"
"251764",0,0,1,1,"dummy"
"251766",14,11,0,25,"dummy"
"251767",14,24,2,40,"dummy"
"251768",0,0,1,1,"dummy"
"251769",3,0,1,4,"dummy"
"251770",0,2,0,2,"dummy"
"251771",0,0,1,1,"dummy"
"251772",0,2,0,2,"dummy"
"251773",0,0,1,1,"dummy"
"251774",1,0,0,1,"dummy"
"251775",22,15,2,39,"dummy"
"251776",0,2,0,2,"dummy"
"251785",0,1,0,1,"dummy"
"251786",0,1,0,1,"dummy"
"251787",0,1,0,1,"dummy"
"251789",0,1,0,1,"dummy"
"251790",0,0,2,2,"dummy"
"251791",0,0,1,1,"dummy"
"251793",0,0,1,1,"dummy"
"251795",0,1,2,3,"dummy"
"251797",0,1,2,3,"dummy"
"251798",1,2,2,5,"dummy"
"251801",0,4,0,4,"dummy"
"251802",0,3,0,3,"dummy"
"251803",0,4,0,4,"dummy"
"251804",8,1,0,9,"dummy"
"251805",0,1,1,2,"dummy"
"251806",1,0,0,1,"dummy"
"251807",0,2,0,2,"dummy"
"251808",2,1,0,3,"dummy"
"251809",0,1,0,1,"dummy"
"251811",0,2,0,2,"dummy"
"251814",0,0,0,0,"dummy"
"251816",0,0,0,0,"dummy"
"251819",0,0,0,0,"dummy"
"251820",2,0,0,2,"dummy"
"251823",1,5,0,6,"dummy"
"251824",1,1,1,3,"dummy"
"251828",0,0,1,1,"dummy"
"251829",0,0,2,2,"dummy"
"251830",0,0,1,1,"dummy"
"251831",2,1,0,3,"dummy"
"251833",2,0,0,2,"dummy"
"251834",0,0,1,1,"dummy"
"251835",0,0,1,1,"dummy"
"251836",0,10,0,10,"dummy"
"251837",0,0,1,1,"dummy"
"251838",2,2,0,4,"dummy"
"251839",0,0,1,1,"dummy"
"251840",0,0,1,1,"dummy"
"251841",0,2,0,2,"dummy"
"251842",0,0,1,1,"dummy"
"251843",0,0,1,1,"dummy"
"251844",0,0,1,1,"dummy"
"251845",0,0,1,1,"dummy"
"251846",1,5,0,6,"dummy"
"251847",0,4,0,4,"dummy"
"251848",0,0,1,1,"dummy"
"251849",2,1,0,3,"dummy"
"251851",0,4,1,5,"dummy"
"251852",0,0,1,1,"dummy"
"251853",0,0,0,0,"dummy"
"251857",0,2,0,2,"dummy"
"251858",0,0,0,0,"dummy"
"251864",0,0,0,0,"dummy"
"251865",5,2,1,8,"dummy"
"251866",0,0,1,1,"dummy"
"251867",3,4,3,10,"dummy"
"251882",0,1,0,1,"dummy"
"251889",0,1,0,1,"dummy"
"251891",0,0,0,0,"dummy"
"251894",0,1,0,1,"dummy"
"251896",0,3,0,3,"dummy"
"251898",2,3,1,6,"dummy"
"251901",0,0,2,2,"dummy"
"251903",1,0,0,1,"dummy"
"251905",11,14,6,31,"dummy"
"251908",0,11,3,14,"dummy"
"251909",0,0,0,0,"dummy"
"251910",0,1,1,2,"dummy"
"251911",0,1,0,1,"dummy"
"251912",1,2,0,3,"dummy"
"251913",0,0,1,1,"dummy"
"251914",0,0,2,2,"dummy"
"251915",10,6,0,16,"dummy"
"251916",0,2,1,3,"dummy"
"251917",3,5,0,8,"dummy"
"251918",1,2,0,3,"dummy"
"251919",7,21,3,31,"dummy"
"251920",1,1,0,2,"dummy"
"251921",0,2,9,11,"dummy"
"251925",0,3,1,4,"dummy"
"251926",0,3,0,3,"dummy"
"251927",2,0,0,2,"dummy"
"251928",1,0,1,2,"dummy"
"251929",0,2,9,11,"dummy"
"251931",3,0,0,3,"dummy"
"251932",0,1,0,1,"dummy"
"251933",0,1,0,1,"dummy"
"251934",1,3,1,5,"dummy"
"251936",0,2,0,2,"dummy"
"251937",3,5,3,11,"dummy"
"251938",0,1,0,1,"dummy"
"251939",0,0,1,1,"dummy"
"251942",0,1,0,1,"dummy"
"251944",1,6,2,9,"dummy"
"251945",0,1,0,1,"dummy"
"251946",0,1,1,2,"dummy"
"251948",0,9,0,9,"dummy"
"251951",0,1,0,1,"dummy"
"251955",3,0,0,3,"dummy"
"251956",1,4,0,5,"dummy"
"251957",0,0,0,0,"dummy"
"251959",1,0,0,1,"dummy"
"251960",0,3,0,3,"dummy"
"251964",6,4,1,11,"dummy"
"251965",1,0,0,1,"dummy"
"251967",2,1,0,3,"dummy"
"251972",0,0,1,1,"dummy"
"251973",0,1,0,1,"dummy"
"251974",2,5,1,8,"dummy"
"251976",14,7,1,22,"dummy"
"251977",0,0,1,1,"dummy"
"251978",0,1,0,1,"dummy"
"251979",0,0,0,0,"dummy"
"251981",0,1,0,1,"dummy"
"251982",0,13,0,13,"dummy"
"251983",6,6,0,12,"dummy"
"251984",0,0,0,0,"dummy"
"251985",1,3,0,4,"dummy"
"251986",2,4,1,7,"dummy"
"251987",0,1,0,1,"dummy"
"251988",2,1,0,3,"dummy"
"251989",2,5,0,7,"dummy"
"251990",2,3,0,5,"dummy"
"251993",1,3,1,5,"dummy"
"251994",5,0,0,5,"dummy"
"251995",0,5,0,5,"dummy"
"251996",1,0,2,3,"dummy"
"251997",5,0,0,5,"dummy"
"251998",0,5,0,5,"dummy"
"251999",0,1,0,1,"dummy"
"252000",0,1,0,1,"dummy"
"252003",0,0,0,0,"dummy"
"252005",1,3,0,4,"dummy"
"252006",0,0,1,1,"dummy"
"252007",0,1,0,1,"dummy"
"252040",0,1,0,1,"dummy"
"252044",0,1,1,2,"dummy"
"252045",0,0,1,1,"dummy"
"252051",3,1,0,4,"dummy"
"252053",0,5,0,5,"dummy"
"252054",0,0,1,1,"dummy"
"252055",0,1,1,2,"dummy"
"252056",0,1,0,1,"dummy"
"252057",0,0,1,1,"dummy"
"252058",3,8,0,11,"dummy"
"252059",0,2,0,2,"dummy"
"252060",9,1,3,13,"dummy"
"252081",0,3,0,3,"dummy"
"252082",0,1,0,1,"dummy"
"252085",0,1,1,2,"dummy"
"252086",6,0,1,7,"dummy"
"252087",0,1,0,1,"dummy"
"252089",0,1,0,1,"dummy"
"252090",0,2,0,2,"dummy"
"252091",1,0,1,2,"dummy"
"252093",0,0,1,1,"dummy"
"252094",0,0,1,1,"dummy"
"252095",0,0,1,1,"dummy"
"252096",0,1,0,1,"dummy"
"252097",0,0,1,1,"dummy"
"252098",1,0,0,1,"dummy"
"252104",2,5,0,7,"dummy"
"252106",0,0,1,1,"dummy"
"252108",0,1,1,2,"dummy"
"252110",0,1,0,1,"dummy"
"252111",0,4,0,4,"dummy"
"252112",0,1,0,1,"dummy"
"252116",0,1,1,2,"dummy"
"252117",3,1,0,4,"dummy"
"252151",0,0,1,1,"dummy"
"252152",0,0,0,0,"dummy"
"252154",0,1,0,1,"dummy"
"252158",2,0,0,2,"dummy"
"252159",0,0,3,3,"dummy"
"252160",2,1,0,3,"dummy"
"252163",2,0,1,3,"dummy"
"252165",4,0,0,4,"dummy"
"252166",0,0,0,0,"dummy"
"252167",2,0,0,2,"dummy"
"252168",0,0,1,1,"dummy"
"252178",1,8,1,10,"dummy"
"252179",3,2,0,5,"dummy"
"252180",12,20,0,32,"dummy"
"252181",1,0,0,1,"dummy"
"252182",4,2,0,6,"dummy"
"252183",1,0,0,1,"dummy"
"252184",8,0,1,9,"dummy"
"252186",0,0,1,1,"dummy"
"252187",3,3,1,7,"dummy"
"252189",1,1,0,2,"dummy"
"252190",0,1,1,2,"dummy"
"252191",0,2,1,3,"dummy"
"252192",1,4,1,6,"dummy"
"252195",0,27,0,27,"dummy"
"252196",0,0,0,0,"dummy"
"252197",5,6,0,11,"dummy"
"252198",13,12,2,27,"dummy"
"252199",4,16,2,22,"dummy"
"252200",4,0,1,5,"dummy"
"252201",0,3,0,3,"dummy"
"252205",0,1,0,1,"dummy"
"252206",0,1,0,1,"dummy"
"252208",1,0,0,1,"dummy"
"252213",6,13,2,21,"dummy"
"252215",0,2,0,2,"dummy"
"252216",0,1,0,1,"dummy"
"252236",3,9,0,12,"dummy"
"252237",0,1,0,1,"dummy"
"252238",1,0,0,1,"dummy"
"252265",0,0,1,1,"dummy"
"252266",1,0,0,1,"dummy"
"252267",1,17,0,18,"dummy"
"252268",12,15,5,32,"dummy"
"252269",0,0,0,0,"dummy"
"252270",0,1,0,1,"dummy"
"252271",0,1,0,1,"dummy"
"252276",0,1,1,2,"dummy"
"252277",0,12,0,12,"dummy"
"252278",1,5,0,6,"dummy"
"252279",0,8,0,8,"dummy"
"252280",0,0,1,1,"dummy"
"252281",4,14,1,19,"dummy"
"252282",6,32,3,41,"dummy"
"252283",0,4,1,5,"dummy"
"252284",0,0,1,1,"dummy"
"252285",0,3,0,3,"dummy"
"252286",0,5,0,5,"dummy"
"252287",4,1,0,5,"dummy"
"252288",66,6,5,77,"dummy"
"252289",0,1,0,1,"dummy"
"252290",1,0,0,1,"dummy"
"252291",0,0,1,1,"dummy"
"252304",1,0,0,1,"dummy"
"252305",0,0,1,1,"dummy"
"252306",2,0,0,2,"dummy"
"252307",0,0,1,1,"dummy"
"252308",0,1,0,1,"dummy"
"252309",0,2,0,2,"dummy"
"252310",0,0,0,0,"dummy"
"252311",2,1,0,3,"dummy"
"252312",1,0,0,1,"dummy"
"252313",0,0,0,0,"dummy"
"252314",0,0,0,0,"dummy"
"252315",0,0,0,0,"dummy"
"252327",0,2,0,2,"dummy"
"252328",1,2,2,5,"dummy"
"252329",0,0,3,3,"dummy"
"252330",0,2,0,2,"dummy"
"252331",0,0,1,1,"dummy"
"252334",14,3,2,19,"dummy"
"252242",0,0,0,0,"dummy"
"252243",0,2,0,2,"dummy"
"252244",0,1,1,2,"dummy"
"252245",0,0,1,1,"dummy"
"252246",0,1,1,2,"dummy"
"252247",0,0,1,1,"dummy"
"252248",0,0,0,0,"dummy"
"252249",0,6,0,6,"dummy"
"252250",0,0,1,1,"dummy"
"252251",0,1,0,1,"dummy"
"252252",1,0,1,2,"dummy"
"252253",0,1,1,2,"dummy"
"252254",0,0,1,1,"dummy"
"252259",0,2,0,2,"dummy"
"252260",2,0,0,2,"dummy"
"252263",20,13,6,39,"dummy"
"252273",0,0,1,1,"dummy"
"252274",0,0,1,1,"dummy"
"252336",0,6,0,6,"dummy"
"252337",0,0,2,2,"dummy"
"252338",0,0,1,1,"dummy"
"252339",0,0,1,1,"dummy"
"252340",3,0,0,3,"dummy"
"252350",0,0,1,1,"dummy"
"252351",0,0,1,1,"dummy"
"252352",0,0,1,1,"dummy"
"252353",0,0,1,1,"dummy"
"252354",0,0,1,1,"dummy"
"252357",0,0,1,1,"dummy"
"252393",2,2,0,4,"dummy"
"252395",12,13,2,27,"dummy"
"252401",0,0,1,1,"dummy"
"252409",5,7,0,12,"dummy"
"252410",0,0,0,0,"dummy"
"252411",0,3,0,3,"dummy"
"252412",0,0,1,1,"dummy"
"252413",0,0,0,0,"dummy"
"252415",1,2,0,3,"dummy"
"252416",0,1,0,1,"dummy"
"252418",0,2,0,2,"dummy"
"252419",0,0,2,2,"dummy"
"252421",0,0,1,1,"dummy"
"252422",0,1,0,1,"dummy"
"252423",0,0,1,1,"dummy"
"252424",0,0,1,1,"dummy"
"252426",2,3,1,6,"dummy"
"252427",1,3,0,4,"dummy"
"252436",0,0,0,0,"dummy"
"252437",0,4,0,4,"dummy"
"252438",17,4,2,23,"dummy"
"252439",0,0,1,1,"dummy"
"252440",0,2,0,2,"dummy"
"252441",0,0,0,0,"dummy"
"252442",1,0,0,1,"dummy"
"252443",3,4,3,10,"dummy"
"252444",0,0,1,1,"dummy"
"252445",0,0,0,0,"dummy"
"252446",0,0,0,0,"dummy"
"252447",0,0,0,0,"dummy"
"252449",0,8,0,8,"dummy"
"252453",0,1,2,3,"dummy"
"252454",0,1,0,1,"dummy"
"252455",0,2,0,2,"dummy"
"252456",4,1,1,6,"dummy"
"252458",1,0,0,1,"dummy"
"252461",0,0,1,1,"dummy"
"252462",0,2,1,3,"dummy"
"252464",0,2,2,4,"dummy"
"252465",3,7,0,10,"dummy"
"252466",10,41,3,54,"dummy"
"252467",13,18,0,31,"dummy"
"252468",0,4,0,4,"dummy"
"252475",9,0,2,11,"dummy"
"252476",0,3,3,6,"dummy"
"252478",1,1,0,2,"dummy"
"252481",0,3,0,3,"dummy"
"252482",2,5,3,10,"dummy"
"252483",3,5,1,9,"dummy"
"252484",1,0,0,1,"dummy"
"252485",0,3,0,3,"dummy"
"252486",0,1,0,1,"dummy"
"252488",0,4,0,4,"dummy"
"252491",7,4,1,12,"dummy"
"252492",1,1,0,2,"dummy"
"252493",6,1,2,9,"dummy"
"252494",0,1,1,2,"dummy"
"252495",0,0,1,1,"dummy"
"252497",0,2,0,2,"dummy"
"252498",0,2,0,2,"dummy"
"252499",0,0,1,1,"dummy"
"252500",0,0,1,1,"dummy"
"252501",2,1,3,6,"dummy"
"252502",2,0,0,2,"dummy"
"252503",1,1,0,2,"dummy"
"252504",2,0,0,2,"dummy"
"252505",2,3,0,5,"dummy"
"252507",0,0,1,1,"dummy"
"252509",0,2,0,2,"dummy"
"252510",0,3,0,3,"dummy"
"252511",10,1,0,11,"dummy"
"252518",0,2,0,2,"dummy"
"252519",0,1,1,2,"dummy"
"252520",0,0,0,0,"dummy"
"252521",2,1,0,3,"dummy"
"252530",0,1,0,1,"dummy"
"252531",0,1,1,2,"dummy"
"252532",1,0,2,3,"dummy"
"252533",0,1,0,1,"dummy"
"252534",0,2,0,2,"dummy"
"252535",0,2,0,2,"dummy"
"252536",0,2,0,2,"dummy"
"252537",2,3,0,5,"dummy"
"252538",0,11,1,12,"dummy"
"252539",0,1,1,2,"dummy"
"252543",0,0,1,1,"dummy"
"252546",0,0,1,1,"dummy"
"252548",5,9,0,14,"dummy"
"252549",0,0,1,1,"dummy"
"252550",2,3,0,5,"dummy"
"252551",0,1,0,1,"dummy"
"252552",0,0,1,1,"dummy"
"252553",1,2,0,3,"dummy"
"252554",10,6,1,17,"dummy"
"252556",16,13,3,32,"dummy"
"252557",13,16,2,31,"dummy"
"252558",1,5,0,6,"dummy"
"252559",0,1,0,1,"dummy"
"252560",0,0,0,0,"dummy"
"252561",1,0,0,1,"dummy"
"252562",0,0,0,0,"dummy"
"252563",0,4,0,4,"dummy"
"252564",2,0,0,2,"dummy"
"252565",0,2,0,2,"dummy"
"252566",2,3,0,5,"dummy"
"252567",3,1,0,4,"dummy"
"252568",3,0,1,4,"dummy"
"252569",2,4,0,6,"dummy"
"252570",19,9,3,31,"dummy"
"252571",0,0,1,1,"dummy"
"252574",3,0,2,5,"dummy"
"252575",0,1,0,1,"dummy"
"252576",0,1,0,1,"dummy"
"252577",0,0,2,2,"dummy"
"252583",1,1,0,2,"dummy"
"252584",0,1,1,2,"dummy"
"252585",0,1,0,1,"dummy"
"252586",0,1,0,1,"dummy"
"252587",13,3,0,16,"dummy"
"252588",0,1,0,1,"dummy"
"252589",0,1,0,1,"dummy"
"252590",0,0,1,1,"dummy"
"252610",0,0,0,0,"dummy"
"252611",0,1,0,1,"dummy"
"252612",3,0,0,3,"dummy"
"252614",0,0,1,1,"dummy"
"252625",0,2,0,2,"dummy"
"252626",1,1,0,2,"dummy"
"252627",0,3,0,3,"dummy"
"252628",1,4,1,6,"dummy"
"252629",2,1,0,3,"dummy"
"252630",4,0,1,5,"dummy"
"252631",0,0,0,0,"dummy"
"252632",0,0,0,0,"dummy"
"252633",1,0,0,1,"dummy"
"252636",1,0,0,1,"dummy"
"252637",1,1,0,2,"dummy"
"252643",0,0,0,0,"dummy"
"252644",0,0,1,1,"dummy"
"252645",1,4,2,7,"dummy"
"252646",0,1,0,1,"dummy"
"252647",3,1,0,4,"dummy"
"252650",0,33,0,33,"dummy"
"252652",2,9,1,12,"dummy"
"252653",9,2,0,11,"dummy"
"252654",0,0,1,1,"dummy"
"252656",17,12,0,29,"dummy"
"252657",0,8,0,8,"dummy"
"252660",11,0,0,11,"dummy"
"252661",4,0,0,4,"dummy"
"252662",0,5,0,5,"dummy"
"252663",10,3,0,13,"dummy"
"252664",1,5,0,6,"dummy"
"252665",3,12,0,15,"dummy"
"252669",0,0,1,1,"dummy"
"252672",0,1,0,1,"dummy"
"252673",0,1,0,1,"dummy"
"252674",5,2,0,7,"dummy"
"252698",0,0,0,0,"dummy"
"252700",1,9,0,10,"dummy"
"252701",1,2,0,3,"dummy"
"252702",1,0,0,1,"dummy"
"252703",0,2,0,2,"dummy"
"252704",2,1,0,3,"dummy"
"252705",0,0,1,1,"dummy"
"252706",0,1,0,1,"dummy"
"252707",0,1,0,1,"dummy"
"252709",0,0,0,0,"dummy"
"252711",3,3,2,8,"dummy"
"252712",1,0,0,1,"dummy"
"252713",0,1,0,1,"dummy"
"252714",1,9,1,11,"dummy"
"252715",3,6,4,13,"dummy"
"252716",1,1,0,2,"dummy"
"252717",0,1,0,1,"dummy"
"252718",5,1,0,6,"dummy"
"252719",1,4,0,5,"dummy"
"252720",0,2,0,2,"dummy"
"252721",3,0,0,3,"dummy"
"252722",2,0,0,2,"dummy"
"252724",0,0,0,0,"dummy"
"252725",0,0,1,1,"dummy"
"252727",6,0,0,6,"dummy"
"252728",2,5,2,9,"dummy"
"252730",0,0,1,1,"dummy"
"252735",1,8,0,9,"dummy"
"252736",1,1,1,3,"dummy"
"252737",0,0,1,1,"dummy"
"252738",1,5,3,9,"dummy"
"252739",0,0,1,1,"dummy"
"252740",0,0,1,1,"dummy"
"252741",0,0,1,1,"dummy"
"252742",0,0,1,1,"dummy"
"252743",0,0,1,1,"dummy"
"252744",0,0,1,1,"dummy"
"252745",0,0,0,0,"dummy"
"252746",0,0,1,1,"dummy"
"252747",0,0,1,1,"dummy"
"252748",0,0,4,4,"dummy"
"252749",0,0,3,3,"dummy"
"252750",0,0,1,1,"dummy"
"252751",0,0,1,1,"dummy"
"252752",6,1,3,10,"dummy"
"252753",0,0,1,1,"dummy"
"252755",11,7,1,19,"dummy"
"252759",1,0,1,2,"dummy"
"252760",0,1,0,1,"dummy"
"252764",0,1,1,2,"dummy"
"252766",0,0,1,1,"dummy"
"252767",0,0,1,1,"dummy"
"252768",2,0,0,2,"dummy"
"252769",0,2,0,2,"dummy"
"252772",4,2,1,7,"dummy"
"252788",27,4,3,34,"dummy"
"252791",0,0,0,0,"dummy"
"252792",0,0,0,0,"dummy"
"252794",0,0,0,0,"dummy"
"252796",0,0,1,1,"dummy"
"252800",0,4,0,4,"dummy"
"252803",0,2,1,3,"dummy"
"252804",1,0,0,1,"dummy"
"252805",0,0,1,1,"dummy"
"252806",1,0,1,2,"dummy"
"252807",1,1,1,3,"dummy"
"252808",1,0,0,1,"dummy"
"252809",0,0,1,1,"dummy"
"252810",0,4,0,4,"dummy"
"252812",0,0,1,1,"dummy"
"252814",0,2,0,2,"dummy"
"252815",0,0,1,1,"dummy"
"252816",0,0,1,1,"dummy"
"252819",0,0,0,0,"dummy"
"252821",1,3,2,6,"dummy"
"252822",0,0,1,1,"dummy"
"252823",8,8,6,22,"dummy"
"252824",0,2,0,2,"dummy"
"252825",0,1,0,1,"dummy"
"252827",1,1,0,2,"dummy"
"252828",0,0,1,1,"dummy"
"252829",0,0,1,1,"dummy"
"252830",0,0,1,1,"dummy"
"252831",0,0,1,1,"dummy"
"252832",0,0,1,1,"dummy"
"252833",0,0,1,1,"dummy"
"252834",0,0,1,1,"dummy"
"252835",0,0,1,1,"dummy"
"252837",2,0,0,2,"dummy"
"252838",2,8,0,10,"dummy"
"252839",0,5,1,6,"dummy"
"252841",1,0,0,1,"dummy"
"252846",0,3,0,3,"dummy"
"252847",1,4,1,6,"dummy"
"252849",1,1,0,2,"dummy"
"252850",0,2,2,4,"dummy"
"252851",4,5,5,14,"dummy"
"252852",0,5,0,5,"dummy"
"252853",2,2,0,4,"dummy"
"252854",2,2,0,4,"dummy"
"252857",1,10,0,11,"dummy"
"252858",0,7,2,9,"dummy"
"252859",0,1,1,2,"dummy"
"252860",1,0,0,1,"dummy"
"252861",10,8,5,23,"dummy"
"252862",1,1,0,2,"dummy"
"252863",0,2,0,2,"dummy"
"252866",1,0,0,1,"dummy"
"252867",0,2,2,4,"dummy"
"252868",0,0,1,1,"dummy"
"252870",0,1,0,1,"dummy"
"252871",0,1,0,1,"dummy"
"252883",0,23,0,23,"dummy"
"252884",0,0,0,0,"dummy"
"252885",0,0,1,1,"dummy"
"252888",1,1,0,2,"dummy"
"252889",10,7,0,17,"dummy"
"252890",2,5,0,7,"dummy"
"252892",0,0,1,1,"dummy"
"252898",0,5,0,5,"dummy"
"252899",0,0,1,1,"dummy"
"252900",0,1,0,1,"dummy"
"252901",0,1,0,1,"dummy"
"252902",1,0,2,3,"dummy"
"252903",0,2,1,3,"dummy"
"252904",0,1,0,1,"dummy"
"252905",0,5,1,6,"dummy"
"252906",0,1,1,2,"dummy"
"252907",0,4,0,4,"dummy"
"252908",0,5,0,5,"dummy"
"252909",3,0,0,3,"dummy"
"252910",0,8,0,8,"dummy"
"252911",3,3,0,6,"dummy"
"252912",5,4,0,9,"dummy"
"252913",4,4,0,8,"dummy"
"252914",5,6,0,11,"dummy"
"252915",2,2,0,4,"dummy"
"252916",3,3,0,6,"dummy"
"252917",5,5,0,10,"dummy"
"252918",0,1,0,1,"dummy"
"252919",4,4,0,8,"dummy"
"252920",8,5,0,13,"dummy"
"252921",2,0,0,2,"dummy"
"252922",0,0,1,1,"dummy"
"252923",28,18,3,49,"dummy"
"252924",0,0,1,1,"dummy"
"252925",1,1,1,3,"dummy"
"252926",0,1,1,2,"dummy"
"252927",0,0,1,1,"dummy"
"252928",0,1,0,1,"dummy"
"252929",0,1,0,1,"dummy"
"252930",2,0,1,3,"dummy"
"252931",1,0,0,1,"dummy"
"252932",0,1,0,1,"dummy"
"252933",0,0,1,1,"dummy"
"252934",0,0,0,0,"dummy"
"252935",0,0,0,0,"dummy"
"252936",0,0,0,0,"dummy"
"252937",0,0,0,0,"dummy"
"252939",0,17,0,17,"dummy"
"252940",0,1,0,1,"dummy"
"252941",0,1,0,1,"dummy"
"252942",0,1,0,1,"dummy"
"252943",0,0,1,1,"dummy"
"252946",0,0,1,1,"dummy"
"252947",0,0,1,1,"dummy"
"252948",0,0,1,1,"dummy"
"252952",0,0,0,0,"dummy"
"252954",2,5,2,9,"dummy"
"252961",2,0,2,4,"dummy"
"252991",1,3,2,6,"dummy"
"252992",0,1,0,1,"dummy"
"252993",0,1,0,1,"dummy"
"252994",0,1,0,1,"dummy"
"252995",0,2,1,3,"dummy"
"252996",2,5,0,7,"dummy"
"253003",0,0,1,1,"dummy"
"253004",0,0,1,1,"dummy"
"253005",0,1,0,1,"dummy"
"253006",8,0,2,10,"dummy"
"253007",0,0,1,1,"dummy"
"253008",0,0,1,1,"dummy"
"253009",0,0,1,1,"dummy"
"253010",0,0,1,1,"dummy"
"253011",0,0,1,1,"dummy"
"253019",0,0,1,1,"dummy"
"253018",0,0,1,1,"dummy"
"253017",0,0,1,1,"dummy"
"253016",0,0,1,1,"dummy"
"253015",0,0,1,1,"dummy"
"253025",5,14,0,19,"dummy"
"253026",0,2,0,2,"dummy"
"253027",0,1,0,1,"dummy"
"253028",8,23,1,32,"dummy"
"253029",0,3,0,3,"dummy"
"253030",0,0,0,0,"dummy"
"253032",0,0,1,1,"dummy"
"253040",0,0,1,1,"dummy"
"253041",0,0,1,1,"dummy"
"253042",0,0,1,1,"dummy"
"253055",2,3,2,7,"dummy"
"253056",2,3,0,5,"dummy"
"253057",0,1,1,2,"dummy"
"253058",8,6,1,15,"dummy"
"253059",8,0,0,8,"dummy"
"253060",0,9,0,9,"dummy"
"253062",0,1,0,1,"dummy"
"253063",0,0,2,2,"dummy"
"253064",0,0,1,1,"dummy"
"253065",0,2,0,2,"dummy"
"253066",0,0,2,2,"dummy"
"253067",0,0,1,1,"dummy"
"253068",0,0,1,1,"dummy"
"253072",1,0,0,1,"dummy"
"253073",0,1,0,1,"dummy"
"253074",0,5,0,5,"dummy"
"253077",0,0,2,2,"dummy"
"253079",0,0,4,4,"dummy"
"253080",0,1,2,3,"dummy"
"253081",0,2,1,3,"dummy"
"253082",2,1,1,4,"dummy"
"253083",0,2,1,3,"dummy"
"253084",0,2,0,2,"dummy"
"253085",12,4,4,20,"dummy"
"253086",8,0,2,10,"dummy"
"253087",0,3,0,3,"dummy"
"253088",2,2,0,4,"dummy"
"253089",0,3,0,3,"dummy"
"253092",0,0,1,1,"dummy"
"253093",0,0,1,1,"dummy"
"253095",0,1,0,1,"dummy"
"253096",0,1,1,2,"dummy"
"253099",0,3,0,3,"dummy"
"253102",0,1,0,1,"dummy"
"253103",3,17,0,20,"dummy"
"253105",2,1,1,4,"dummy"
"253106",0,1,3,4,"dummy"
"253107",1,0,3,4,"dummy"
"253112",3,10,1,14,"dummy"
"253114",2,16,1,19,"dummy"
"253116",2,4,2,8,"dummy"
"253117",4,5,2,11,"dummy"
"253120",0,1,0,1,"dummy"
"253124",0,1,0,1,"dummy"
"253128",3,4,1,8,"dummy"
"253130",0,1,0,1,"dummy"
"253134",0,1,0,1,"dummy"
"253135",1,3,0,4,"dummy"
"253136",3,1,0,4,"dummy"
"253137",0,0,1,1,"dummy"
"253138",0,1,0,1,"dummy"
"253139",0,0,2,2,"dummy"
"253141",0,0,1,1,"dummy"
"253142",0,0,1,1,"dummy"
"253145",0,0,1,1,"dummy"
"253146",2,3,0,5,"dummy"
"253147",0,0,1,1,"dummy"
"253148",2,8,1,11,"dummy"
"253149",0,1,0,1,"dummy"
"253151",0,0,1,1,"dummy"
"253152",0,0,1,1,"dummy"
"253153",0,0,1,1,"dummy"
"253155",0,1,0,1,"dummy"
"253156",24,5,2,31,"dummy"
"253157",0,4,0,4,"dummy"
"253161",0,0,1,1,"dummy"
"253162",1,2,6,9,"dummy"
"253167",0,2,0,2,"dummy"
"253173",0,0,0,0,"dummy"
"253177",0,2,0,2,"dummy"
"253178",0,0,1,1,"dummy"
"253179",1,1,1,3,"dummy"
"253180",0,0,1,1,"dummy"
"253181",0,0,1,1,"dummy"
"253183",0,0,0,0,"dummy"
"253184",0,0,0,0,"dummy"
"253187",0,0,0,0,"dummy"
"253188",3,3,0,6,"dummy"
"253190",0,2,0,2,"dummy"
"253191",0,2,0,2,"dummy"
"253192",0,2,0,2,"dummy"
"253194",0,0,0,0,"dummy"
"253195",0,3,0,3,"dummy"
"253196",0,0,1,1,"dummy"
"253197",0,1,0,1,"dummy"
"253198",1,2,0,3,"dummy"
"253199",2,2,3,7,"dummy"
"253201",0,2,3,5,"dummy"
"253203",1,3,0,4,"dummy"
"253204",0,0,1,1,"dummy"
"253205",0,0,0,0,"dummy"
"253207",0,0,1,1,"dummy"
"253208",0,0,1,1,"dummy"
"253209",1,1,0,2,"dummy"
"253210",0,1,0,1,"dummy"
"253213",0,0,0,0,"dummy"
"253214",0,2,0,2,"dummy"
"253215",1,5,0,6,"dummy"
"253216",1,0,0,1,"dummy"
"253217",3,4,2,9,"dummy"
"253218",0,1,0,1,"dummy"
"253219",1,2,0,3,"dummy"
"253222",0,0,0,0,"dummy"
"253223",0,3,2,5,"dummy"
"253224",0,2,0,2,"dummy"
"253225",0,4,0,4,"dummy"
"253226",0,0,1,1,"dummy"
"253229",0,2,0,2,"dummy"
"253231",0,0,0,0,"dummy"
"253232",0,0,0,0,"dummy"
"253233",0,0,0,0,"dummy"
"253234",0,0,0,0,"dummy"
"253235",0,0,0,0,"dummy"
"253236",0,0,0,0,"dummy"
"253239",0,0,2,2,"dummy"
"253240",0,0,2,2,"dummy"
"253241",2,2,0,4,"dummy"
"253242",0,0,2,2,"dummy"
"253243",0,1,0,1,"dummy"
"253244",0,0,2,2,"dummy"
"253245",0,0,2,2,"dummy"
"253246",0,0,2,2,"dummy"
"253248",0,0,0,0,"dummy"
"253249",0,0,1,1,"dummy"
"253250",0,1,0,1,"dummy"
"253251",2,2,5,9,"dummy"
"253252",3,5,1,9,"dummy"
"253253",0,0,1,1,"dummy"
"253254",0,0,2,2,"dummy"
"253255",0,0,0,0,"dummy"
"253256",0,0,2,2,"dummy"
"253257",0,0,2,2,"dummy"
"253259",1,0,1,2,"dummy"
"253260",0,0,0,0,"dummy"
"253261",1,0,0,1,"dummy"
"253262",0,0,0,0,"dummy"
"253266",0,0,3,3,"dummy"
"253267",0,0,1,1,"dummy"
"253268",2,9,3,14,"dummy"
"253269",0,0,1,1,"dummy"
"253270",0,0,1,1,"dummy"
"253271",0,4,0,4,"dummy"
"253272",1,4,0,5,"dummy"
"253273",7,0,0,7,"dummy"
"253274",0,0,0,0,"dummy"
"253275",0,0,1,1,"dummy"
"253276",0,0,1,1,"dummy"
"253277",22,11,2,35,"dummy"
"253278",0,0,1,1,"dummy"
"253279",0,0,0,0,"dummy"
"253280",0,0,1,1,"dummy"
"253281",0,0,0,0,"dummy"
"253282",0,0,1,1,"dummy"
"253283",0,0,0,0,"dummy"
"253284",0,2,0,2,"dummy"
"253285",0,0,1,1,"dummy"
"253286",0,0,1,1,"dummy"
"253287",0,0,1,1,"dummy"
"253289",0,1,1,2,"dummy"
"253290",2,1,2,5,"dummy"
"253291",0,0,1,1,"dummy"
"253292",0,0,1,1,"dummy"
"253293",1,0,1,2,"dummy"
"253295",1,5,0,6,"dummy"
"253296",0,3,0,3,"dummy"
"253298",1,2,1,4,"dummy"
"253299",0,1,0,1,"dummy"
"253300",0,8,0,8,"dummy"
"253301",7,6,0,13,"dummy"
"253302",2,3,0,5,"dummy"
"253311",6,2,4,12,"dummy"
"253314",0,4,0,4,"dummy"
"253315",0,1,0,1,"dummy"
"253316",0,0,1,1,"dummy"
"253317",0,0,1,1,"dummy"
"253322",0,0,0,0,"dummy"
"253323",0,1,0,1,"dummy"
"253325",10,9,0,19,"dummy"
"253326",0,1,0,1,"dummy"
"253327",10,3,0,13,"dummy"
"253328",2,6,5,13,"dummy"
"253329",2,0,0,2,"dummy"
"253334",6,0,0,6,"dummy"
"253335",2,5,2,9,"dummy"
"253343",0,1,0,1,"dummy"
"253344",0,1,0,1,"dummy"
"253347",0,1,0,1,"dummy"
"253348",11,4,3,18,"dummy"
"253349",1,0,0,1,"dummy"
"253350",0,0,1,1,"dummy"
"253351",0,0,0,0,"dummy"
"253352",0,0,1,1,"dummy"
"253354",0,2,1,3,"dummy"
"253355",0,3,0,3,"dummy"
"253356",0,2,0,2,"dummy"
"253357",0,0,0,0,"dummy"
"253358",0,0,0,0,"dummy"
"253359",2,0,0,2,"dummy"
"253360",2,4,1,7,"dummy"
"253364",0,0,1,1,"dummy"
"253365",0,4,0,4,"dummy"
"253366",1,0,1,2,"dummy"
"253367",0,7,0,7,"dummy"
"253369",0,0,2,2,"dummy"
"253370",0,2,0,2,"dummy"
"253371",0,1,0,1,"dummy"
"253372",0,2,0,2,"dummy"
"253374",0,1,0,1,"dummy"
"253375",0,1,0,1,"dummy"
"253376",0,1,0,1,"dummy"
"253380",0,1,3,4,"dummy"
"253381",0,0,1,1,"dummy"
"253382",0,0,0,0,"dummy"
"253383",0,1,3,4,"dummy"
"253384",0,0,3,3,"dummy"
"253385",0,1,0,1,"dummy"
"253388",2,1,1,4,"dummy"
"253389",1,0,0,1,"dummy"
"253390",0,1,3,4,"dummy"
"253391",0,0,1,1,"dummy"
"253392",0,1,0,1,"dummy"
"253393",0,1,0,1,"dummy"
"253394",0,0,1,1,"dummy"
"253395",0,1,0,1,"dummy"
"253396",0,5,0,5,"dummy"
"253397",0,0,1,1,"dummy"
"253398",0,4,0,4,"dummy"
"253399",0,1,0,1,"dummy"
"253400",0,0,1,1,"dummy"
"253401",0,0,1,1,"dummy"
"253402",0,1,0,1,"dummy"
"253403",0,9,0,9,"dummy"
"253404",0,1,0,1,"dummy"
"253405",0,0,1,1,"dummy"
"253406",0,0,1,1,"dummy"
"253407",0,2,0,2,"dummy"
"253408",0,4,0,4,"dummy"
"253412",0,1,0,1,"dummy"
"253413",0,0,1,1,"dummy"
"253414",0,0,1,1,"dummy"
"253421",0,0,1,1,"dummy"
"253422",6,0,0,6,"dummy"
"253423",0,2,0,2,"dummy"
"253424",1,4,0,5,"dummy"
"253429",6,7,2,15,"dummy"
"253430",1,5,0,6,"dummy"
"253431",2,13,4,19,"dummy"
"253432",11,0,1,12,"dummy"
"253433",0,3,2,5,"dummy"
"253434",0,0,2,2,"dummy"
"253437",0,1,0,1,"dummy"
"253438",0,1,0,1,"dummy"
"253439",0,1,0,1,"dummy"
"253440",0,1,0,1,"dummy"
"253443",0,0,1,1,"dummy"
"253444",0,0,0,0,"dummy"
"253455",2,0,1,3,"dummy"
"253456",8,1,2,11,"dummy"
"253457",0,1,0,1,"dummy"
"253458",0,2,0,2,"dummy"
"253459",0,3,0,3,"dummy"
"253468",10,1,2,13,"dummy"
"253469",5,5,0,10,"dummy"
"253470",1,0,0,1,"dummy"
"253471",0,0,1,1,"dummy"
"253472",1,0,0,1,"dummy"
"253473",0,0,1,1,"dummy"
"253484",0,8,0,8,"dummy"
"253485",5,0,0,5,"dummy"
"253498",3,3,0,6,"dummy"
"253499",10,0,4,14,"dummy"
"253500",6,0,0,6,"dummy"
"253501",0,1,0,1,"dummy"
"253502",0,7,0,7,"dummy"
"253503",2,1,0,3,"dummy"
"253504",1,3,1,5,"dummy"
"253505",1,2,0,3,"dummy"
"253506",5,1,0,6,"dummy"
"253507",2,15,3,20,"dummy"
"253481",0,0,1,1,"dummy"
"253482",0,0,1,1,"dummy"
"253487",1,5,1,7,"dummy"
"253490",0,1,0,1,"dummy"
"253491",0,0,1,1,"dummy"
"253492",0,4,0,4,"dummy"
"253493",1,1,0,2,"dummy"
"253494",2,2,2,6,"dummy"
"253509",7,0,0,7,"dummy"
"253510",1,0,0,1,"dummy"
"253511",4,0,2,6,"dummy"
"253512",0,0,2,2,"dummy"
"253513",0,2,0,2,"dummy"
"253514",0,0,1,1,"dummy"
"253599",1,1,0,2,"dummy"
"253577",1,9,3,13,"dummy"
"253582",1,5,0,6,"dummy"
"253583",4,2,1,7,"dummy"
"253585",1,0,0,1,"dummy"
"253586",0,1,2,3,"dummy"
"253587",0,4,1,5,"dummy"
"253588",0,2,0,2,"dummy"
"253591",0,4,0,4,"dummy"
"253592",0,8,1,9,"dummy"
"253593",0,0,0,0,"dummy"
"253594",1,0,0,1,"dummy"
"253596",0,1,0,1,"dummy"
"253600",2,3,1,6,"dummy"
"253601",4,1,2,7,"dummy"
"253602",0,0,1,1,"dummy"
"253603",0,0,0,0,"dummy"
"253604",0,0,1,1,"dummy"
"253605",0,0,1,1,"dummy"
"253606",0,0,1,1,"dummy"
"253607",3,4,3,10,"dummy"
"253608",6,13,1,20,"dummy"
"253613",0,1,2,3,"dummy"
"253614",0,10,1,11,"dummy"
"253617",3,2,0,5,"dummy"
"253633",1,2,0,3,"dummy"
"253639",1,1,0,2,"dummy"
"253640",0,0,0,0,"dummy"
"253641",0,1,0,1,"dummy"
"253642",1,1,0,2,"dummy"
"253644",0,0,2,2,"dummy"
"253646",0,6,0,6,"dummy"
"253647",0,9,0,9,"dummy"
"253648",0,4,0,4,"dummy"
"253649",1,18,0,19,"dummy"
"253650",17,1,0,18,"dummy"
"253651",2,13,2,17,"dummy"
"253652",0,1,0,1,"dummy"
"253653",0,1,0,1,"dummy"
"253656",2,5,1,8,"dummy"
"253657",0,0,1,1,"dummy"
"253658",6,6,0,12,"dummy"
"253660",4,0,0,4,"dummy"
"253662",0,1,0,1,"dummy"
"253663",0,1,0,1,"dummy"
"253664",0,6,0,6,"dummy"
"253665",0,1,0,1,"dummy"
"253666",2,0,0,2,"dummy"
"253671",0,0,1,1,"dummy"
"253672",0,0,1,1,"dummy"
"253675",5,4,0,9,"dummy"
"253676",0,0,1,1,"dummy"
"253677",2,2,1,5,"dummy"
"253678",2,2,4,8,"dummy"
"253679",2,2,1,5,"dummy"
"253680",1,1,0,2,"dummy"
"253681",0,0,2,2,"dummy"
"253683",0,1,1,2,"dummy"
"253685",0,2,0,2,"dummy"
"253686",0,1,0,1,"dummy"
"253693",0,0,1,1,"dummy"
"253694",0,6,0,6,"dummy"
"253695",0,1,0,1,"dummy"
"253698",0,2,4,6,"dummy"
"253699",2,2,3,7,"dummy"
"253700",0,2,1,3,"dummy"
"253701",0,0,1,1,"dummy"
"253702",0,0,1,1,"dummy"
"253708",0,0,2,2,"dummy"
"253709",0,0,6,6,"dummy"
"253710",0,0,3,3,"dummy"
"253711",3,2,3,8,"dummy"
"253712",10,5,4,19,"dummy"
"253714",0,1,2,3,"dummy"
"253715",0,0,1,1,"dummy"
"253716",0,0,1,1,"dummy"
"253717",0,1,1,2,"dummy"
"253719",0,1,0,1,"dummy"
"253720",5,5,0,10,"dummy"
"253721",4,3,1,8,"dummy"
"253722",2,20,3,25,"dummy"
"253723",0,0,1,1,"dummy"
"253724",0,0,2,2,"dummy"
"253725",0,0,1,1,"dummy"
"253726",0,0,1,1,"dummy"
"253727",0,2,2,4,"dummy"
"253728",0,1,0,1,"dummy"
"253729",2,2,2,6,"dummy"
"253730",2,2,0,4,"dummy"
"253731",0,0,1,1,"dummy"
"253732",0,2,0,2,"dummy"
"253733",4,3,3,10,"dummy"
"253734",2,2,0,4,"dummy"
"253735",2,2,0,4,"dummy"
"253736",2,2,0,4,"dummy"
"253737",2,2,0,4,"dummy"
"253738",2,2,0,4,"dummy"
"253739",0,0,1,1,"dummy"
"253740",4,1,1,6,"dummy"
"253741",3,6,3,12,"dummy"
"253743",0,1,0,1,"dummy"
"253744",0,0,1,1,"dummy"
"253748",0,0,1,1,"dummy"
"253749",2,4,2,8,"dummy"
"253750",3,2,1,6,"dummy"
"253751",0,0,1,1,"dummy"
"253756",0,0,0,0,"dummy"
"253757",0,0,0,0,"dummy"
"253760",0,0,0,0,"dummy"
"253761",0,0,1,1,"dummy"
"253763",5,7,0,12,"dummy"
"253764",0,0,1,1,"dummy"
"253765",17,0,0,17,"dummy"
"253767",0,3,0,3,"dummy"
"253768",0,1,0,1,"dummy"
"253769",0,1,0,1,"dummy"
"253770",3,5,1,9,"dummy"
"253772",2,8,2,12,"dummy"
"253773",4,1,1,6,"dummy"
"253774",0,0,1,1,"dummy"
"253775",0,1,0,1,"dummy"
"253777",0,12,0,12,"dummy"
"253778",12,0,0,12,"dummy"
"253779",0,0,3,3,"dummy"
"253781",1,0,1,2,"dummy"
"253783",1,1,0,2,"dummy"
"253784",10,11,1,22,"dummy"
"253785",1,1,0,2,"dummy"
"253786",1,5,1,7,"dummy"
"253796",3,3,0,6,"dummy"
"253797",3,3,0,6,"dummy"
"253798",0,1,0,1,"dummy"
"253799",0,0,0,0,"dummy"
"253800",0,1,1,2,"dummy"
"253801",0,1,0,1,"dummy"
"253802",0,0,1,1,"dummy"
"253803",0,0,0,0,"dummy"
"253804",0,0,1,1,"dummy"
"253805",1,9,0,10,"dummy"
"253807",2,0,0,2,"dummy"
"253808",0,1,0,1,"dummy"
"253809",2,0,1,3,"dummy"
"253810",0,2,2,4,"dummy"
"253811",0,1,0,1,"dummy"
"253812",1,2,0,3,"dummy"
"253815",0,0,1,1,"dummy"
"253816",2,5,2,9,"dummy"
"253817",0,2,0,2,"dummy"
"253818",1,1,4,6,"dummy"
"253819",5,0,0,5,"dummy"
"253820",0,3,1,4,"dummy"
"253821",0,0,2,2,"dummy"
"253822",0,0,1,1,"dummy"
"253823",0,0,0,0,"dummy"
"253824",19,0,1,20,"dummy"
"253825",0,0,1,1,"dummy"
"253826",0,2,1,3,"dummy"
"253827",1,0,0,1,"dummy"
"253829",0,0,2,2,"dummy"
"253830",2,0,0,2,"dummy"
"253831",4,2,1,7,"dummy"
"253847",0,0,1,1,"dummy"
"253852",0,11,0,11,"dummy"
"253853",11,9,0,20,"dummy"
"253854",9,7,0,16,"dummy"
"253855",0,18,0,18,"dummy"
"253856",0,0,2,2,"dummy"
"253858",3,3,0,6,"dummy"
"253859",4,0,0,4,"dummy"
"253860",1,3,2,6,"dummy"
"253861",3,1,2,6,"dummy"
"253864",1,1,0,2,"dummy"
"253865",1,1,0,2,"dummy"
"253866",0,1,0,1,"dummy"
"253867",0,0,1,1,"dummy"
"253871",0,1,0,1,"dummy"
"253872",2,0,0,2,"dummy"
"253881",0,0,2,2,"dummy"
"253883",1,0,1,2,"dummy"
"253884",0,1,0,1,"dummy"
"253885",74,1,3,78,"dummy"
"253886",0,2,0,2,"dummy"
"253887",0,2,0,2,"dummy"
"253888",0,2,0,2,"dummy"
"253889",2,1,0,3,"dummy"
"253890",1,2,0,3,"dummy"
"253891",0,1,0,1,"dummy"
"253892",0,3,0,3,"dummy"
"253893",6,2,2,10,"dummy"
"253894",0,1,0,1,"dummy"
"253899",0,1,0,1,"dummy"
"253902",0,0,4,4,"dummy"
"253903",1,0,2,3,"dummy"
"253904",1,9,1,11,"dummy"
"253905",0,5,5,10,"dummy"
"253906",0,1,0,1,"dummy"
"253908",2,0,3,5,"dummy"
"253910",0,1,0,1,"dummy"
"253911",0,0,1,1,"dummy"
"253913",0,2,0,2,"dummy"
"253914",0,2,0,2,"dummy"
"253915",4,1,0,5,"dummy"
"253916",1,0,0,1,"dummy"
"253917",0,0,0,0,"dummy"
"253918",0,0,0,0,"dummy"
"253919",0,0,0,0,"dummy"
"253921",0,0,2,2,"dummy"
"253922",1,0,0,1,"dummy"
"253923",0,1,0,1,"dummy"
"253925",0,9,0,9,"dummy"
"253926",0,3,1,4,"dummy"
"253927",10,1,3,14,"dummy"
"253929",0,0,1,1,"dummy"
"253937",2,1,2,5,"dummy"
"253940",1,23,0,24,"dummy"
"253941",0,11,0,11,"dummy"
"253943",1,1,0,2,"dummy"
"253944",0,0,0,0,"dummy"
"253945",0,0,3,3,"dummy"
"253946",0,1,1,2,"dummy"
"253947",0,0,2,2,"dummy"
"253948",0,0,3,3,"dummy"
"253951",5,8,2,15,"dummy"
"253952",0,0,2,2,"dummy"
"253953",3,0,0,3,"dummy"
"253955",0,1,0,1,"dummy"
"253957",0,0,1,1,"dummy"
"253958",12,3,1,16,"dummy"
"253959",3,22,2,27,"dummy"
"253960",2,0,0,2,"dummy"
"253963",1,2,0,3,"dummy"
"253964",0,1,2,3,"dummy"
"253965",4,6,5,15,"dummy"
"253966",0,0,1,1,"dummy"
"253970",0,0,0,0,"dummy"
"253973",0,0,2,2,"dummy"
"253974",0,0,1,1,"dummy"
"253976",1,0,0,1,"dummy"
"253977",0,4,0,4,"dummy"
"253978",0,0,1,1,"dummy"
"253979",0,1,0,1,"dummy"
"253980",0,0,0,0,"dummy"
"253981",2,2,0,4,"dummy"
"253983",0,2,0,2,"dummy"
"253984",2,2,0,4,"dummy"
"253985",0,0,1,1,"dummy"
"253994",0,0,0,0,"dummy"
"253995",0,0,0,0,"dummy"
"253997",2,4,0,6,"dummy"
"253998",0,2,0,2,"dummy"
"253999",0,2,0,2,"dummy"
"254000",10,2,0,12,"dummy"
"254001",0,2,0,2,"dummy"
"254002",0,0,0,0,"dummy"
"254003",0,0,3,3,"dummy"
"254004",0,5,0,5,"dummy"
"254005",1,0,1,2,"dummy"
"254007",0,10,0,10,"dummy"
"254008",0,0,1,1,"dummy"
"254010",0,0,1,1,"dummy"
"254011",8,5,1,14,"dummy"
"254012",0,1,0,1,"dummy"
"254013",4,1,0,5,"dummy"
"254014",4,4,2,10,"dummy"
"254015",0,0,1,1,"dummy"
"254020",0,0,0,0,"dummy"
"254021",0,13,0,13,"dummy"
"254022",3,0,0,3,"dummy"
"254029",0,0,1,1,"dummy"
"254030",0,0,0,0,"dummy"
"254031",0,1,0,1,"dummy"
"254032",1,2,0,3,"dummy"
"254033",0,1,0,1,"dummy"
"254034",1,10,1,12,"dummy"
"254035",1,1,0,2,"dummy"
"254036",0,0,1,1,"dummy"
"254037",0,0,1,1,"dummy"
"254038",0,1,0,1,"dummy"
"254039",7,2,0,9,"dummy"
"254040",0,1,0,1,"dummy"
"254041",0,0,1,1,"dummy"
"254042",0,0,1,1,"dummy"
"254043",0,0,1,1,"dummy"
"254044",0,0,2,2,"dummy"
"254045",0,0,1,1,"dummy"
"254046",0,0,1,1,"dummy"
"254047",0,0,1,1,"dummy"
"254048",0,0,1,1,"dummy"
"254049",0,0,1,1,"dummy"
"254050",0,0,4,4,"dummy"
"254051",0,0,0,0,"dummy"
"254052",0,2,1,3,"dummy"
"254053",2,0,2,4,"dummy"
"254054",0,2,1,3,"dummy"
"254055",0,0,1,1,"dummy"
"254056",0,0,1,1,"dummy"
"254057",0,0,1,1,"dummy"
"254058",0,2,0,2,"dummy"
"254059",4,2,0,6,"dummy"
"254060",0,2,0,2,"dummy"
"254061",0,0,1,1,"dummy"
"254062",0,0,1,1,"dummy"
"254063",0,0,1,1,"dummy"
"254064",0,0,1,1,"dummy"
"254065",5,2,1,8,"dummy"
"254066",0,4,1,5,"dummy"
"254067",3,1,0,4,"dummy"
"254073",2,2,1,5,"dummy"
"254099",0,0,1,1,"dummy"
"254101",0,1,0,1,"dummy"
"254102",0,0,1,1,"dummy"
"254120",0,4,0,4,"dummy"
"254121",0,2,2,4,"dummy"
"254123",0,9,1,10,"dummy"
"254124",0,0,0,0,"dummy"
"254125",0,1,0,1,"dummy"
"254126",2,2,0,4,"dummy"
"254127",0,0,2,2,"dummy"
"254128",0,0,1,1,"dummy"
"254130",1,1,0,2,"dummy"
"254131",0,0,1,1,"dummy"
"254132",0,1,1,2,"dummy"
"254133",1,0,1,2,"dummy"
"254134",4,2,1,7,"dummy"
"254135",0,2,1,3,"dummy"
"254136",0,0,4,4,"dummy"
"254137",7,8,0,15,"dummy"
"254138",0,0,1,1,"dummy"
"254140",0,0,2,2,"dummy"
"254141",4,1,3,8,"dummy"
"254143",1,1,2,4,"dummy"
"254144",0,0,0,0,"dummy"
"254146",0,1,0,1,"dummy"
"254147",0,0,1,1,"dummy"
"254153",0,3,0,3,"dummy"
"254154",1,3,0,4,"dummy"
"254155",15,3,0,18,"dummy"
"254156",13,13,2,28,"dummy"
"254157",0,0,2,2,"dummy"
"254158",4,0,0,4,"dummy"
"254162",0,2,0,2,"dummy"
"254163",1,1,1,3,"dummy"
"254164",0,2,0,2,"dummy"
"254165",0,2,0,2,"dummy"
"254166",0,1,1,2,"dummy"
"254167",0,1,0,1,"dummy"
"254168",0,0,1,1,"dummy"
"254169",2,1,4,7,"dummy"
"254176",0,0,1,1,"dummy"
"254179",2,1,0,3,"dummy"
"254180",6,1,2,9,"dummy"
"254181",0,1,0,1,"dummy"
"254182",2,5,0,7,"dummy"
"254183",0,0,1,1,"dummy"
"254184",0,0,1,1,"dummy"
"254195",0,0,0,0,"dummy"
"254196",6,8,0,14,"dummy"
"254206",13,6,0,19,"dummy"
"254207",0,0,1,1,"dummy"
"254208",0,1,0,1,"dummy"
"254209",1,1,0,2,"dummy"
"254210",0,1,1,2,"dummy"
"254211",1,0,1,2,"dummy"
"254212",2,8,4,14,"dummy"
"254213",0,1,0,1,"dummy"
"254214",4,2,1,7,"dummy"
"254215",1,1,1,3,"dummy"
"254216",1,1,0,2,"dummy"
"254217",3,5,3,11,"dummy"
"254218",0,0,1,1,"dummy"
"254219",1,1,1,3,"dummy"
"254220",1,1,0,2,"dummy"
"254221",2,2,0,4,"dummy"
"254222",1,2,1,4,"dummy"
"254223",2,4,3,9,"dummy"
"254224",5,5,7,17,"dummy"
"254225",5,5,7,17,"dummy"
"254226",1,0,0,1,"dummy"
"254227",2,0,0,2,"dummy"
"254228",12,0,0,12,"dummy"
"254229",0,1,0,1,"dummy"
"254230",0,5,0,5,"dummy"
"254231",1,0,0,1,"dummy"
"254232",8,6,2,16,"dummy"
"254235",1,10,0,11,"dummy"
"254236",1,0,0,1,"dummy"
"254239",0,2,0,2,"dummy"
"254240",0,0,0,0,"dummy"
"254259",2,2,0,4,"dummy"
"254263",0,1,1,2,"dummy"
"254271",0,0,0,0,"dummy"
"254272",0,0,0,0,"dummy"
"254273",0,0,0,0,"dummy"
"254274",0,0,0,0,"dummy"
"254275",0,0,0,0,"dummy"
"254276",3,17,1,21,"dummy"
"254277",0,0,1,1,"dummy"
"254278",0,4,3,7,"dummy"
"254279",0,1,0,1,"dummy"
"254280",2,4,1,7,"dummy"
"254281",0,2,0,2,"dummy"
"254282",0,1,0,1,"dummy"
"254283",1,0,0,1,"dummy"
"254284",16,5,6,27,"dummy"
"254285",0,0,3,3,"dummy"
"254286",0,0,0,0,"dummy"
"254351",2,2,1,5,"dummy"
"254352",13,9,2,24,"dummy"
"254353",1,0,4,5,"dummy"
"254362",0,0,1,1,"dummy"
"254363",0,1,0,1,"dummy"
"254369",6,19,0,25,"dummy"
"254370",5,1,0,6,"dummy"
"254371",0,0,0,0,"dummy"
"254372",0,1,0,1,"dummy"
"254373",1,1,0,2,"dummy"
"254374",5,1,2,8,"dummy"
"254375",1,2,0,3,"dummy"
"254376",2,2,3,7,"dummy"
"254377",0,1,1,2,"dummy"
"254378",0,2,0,2,"dummy"
"254379",0,1,0,1,"dummy"
"254380",5,2,0,7,"dummy"
"254381",0,3,0,3,"dummy"
"254382",0,0,1,1,"dummy"
"254383",2,2,1,5,"dummy"
"254384",2,9,0,11,"dummy"
"254385",0,1,0,1,"dummy"
"254386",21,6,1,28,"dummy"
"254387",1,0,0,1,"dummy"
"254388",0,3,0,3,"dummy"
"254389",0,3,0,3,"dummy"
"254186",0,0,1,1,"dummy"
"254187",0,1,0,1,"dummy"
"254190",0,1,0,1,"dummy"
"254191",3,4,4,11,"dummy"
"254192",0,0,0,0,"dummy"
"254193",1,9,0,10,"dummy"
"254198",0,0,1,1,"dummy"
"254199",0,0,1,1,"dummy"
"254200",0,0,1,1,"dummy"
"254203",0,2,0,2,"dummy"
"254204",2,4,0,6,"dummy"
"254242",0,0,1,1,"dummy"
"254243",4,0,3,7,"dummy"
"254244",0,10,2,12,"dummy"
"254245",10,0,2,12,"dummy"
"254246",14,1,5,20,"dummy"
"254249",5,0,0,5,"dummy"
"254250",0,2,1,3,"dummy"
"254251",0,0,2,2,"dummy"
"254252",0,0,1,1,"dummy"
"254253",0,0,0,0,"dummy"
"254254",19,0,1,20,"dummy"
"254255",0,0,1,1,"dummy"
"254256",0,2,1,3,"dummy"
"254257",1,0,0,1,"dummy"
"254261",0,1,0,1,"dummy"
"254290",0,2,0,2,"dummy"
"254291",0,1,0,1,"dummy"
"254294",0,0,0,0,"dummy"
"254295",0,0,1,1,"dummy"
"254296",0,0,0,0,"dummy"
"254297",0,0,0,0,"dummy"
"254298",0,0,1,1,"dummy"
"254299",0,0,0,0,"dummy"
"254329",0,2,0,2,"dummy"
"254330",1,2,0,3,"dummy"
"254331",1,2,0,3,"dummy"
"254332",7,8,1,16,"dummy"
"254333",0,5,0,5,"dummy"
"254334",1,11,1,13,"dummy"
"254335",0,0,0,0,"dummy"
"254336",0,0,1,1,"dummy"
"254337",1,8,3,12,"dummy"
"254338",0,3,0,3,"dummy"
"254339",5,8,1,14,"dummy"
"254340",4,8,0,12,"dummy"
"254341",26,23,0,49,"dummy"
"254342",9,5,2,16,"dummy"
"254343",1,8,5,14,"dummy"
"254348",6,0,0,6,"dummy"
"254349",2,5,2,9,"dummy"
"254355",0,0,1,1,"dummy"
"254356",0,0,1,1,"dummy"
"254357",0,0,1,1,"dummy"
"254358",0,0,0,0,"dummy"
"254359",0,0,1,1,"dummy"
"254360",0,0,1,1,"dummy"
"254413",0,1,0,1,"dummy"
"254414",1,1,0,2,"dummy"
"254427",1,2,0,3,"dummy"
"254428",2,4,2,8,"dummy"
"254429",0,3,0,3,"dummy"
"254430",2,3,1,6,"dummy"
"254431",0,7,1,8,"dummy"
"254432",0,0,1,1,"dummy"
"254433",2,4,0,6,"dummy"
"254434",0,0,0,0,"dummy"
"254435",0,1,0,1,"dummy"
"254436",2,8,1,11,"dummy"
"254437",0,0,1,1,"dummy"
"254438",2,0,0,2,"dummy"
"254439",2,0,0,2,"dummy"
"254440",2,0,0,2,"dummy"
"254443",1,0,1,2,"dummy"
"254444",0,0,1,1,"dummy"
"254449",0,0,1,1,"dummy"
"254450",0,1,2,3,"dummy"
"254451",5,10,12,27,"dummy"
"254454",6,11,2,19,"dummy"
"254390",6,3,0,9,"dummy"
"254391",0,0,1,1,"dummy"
"254392",1,3,0,4,"dummy"
"254393",0,1,0,1,"dummy"
"254394",0,1,0,1,"dummy"
"254395",0,0,1,1,"dummy"
"254396",0,1,1,2,"dummy"
"254397",0,0,0,0,"dummy"
"254398",0,2,0,2,"dummy"
"254399",3,5,0,8,"dummy"
"254400",5,4,0,9,"dummy"
"254401",0,1,0,1,"dummy"
"254402",0,1,0,1,"dummy"
"254403",1,3,0,4,"dummy"
"254404",0,1,0,1,"dummy"
"254405",8,2,0,10,"dummy"
"254406",5,0,1,6,"dummy"
"254407",0,0,2,2,"dummy"
"254408",0,1,0,1,"dummy"
"254409",0,4,0,4,"dummy"
"254410",1,0,0,1,"dummy"
"254411",7,9,0,16,"dummy"
"254416",0,0,1,1,"dummy"
"254421",3,4,0,7,"dummy"
"254446",0,0,3,3,"dummy"
"254447",0,0,1,1,"dummy"
"254489",0,1,1,2,"dummy"
"254490",0,6,0,6,"dummy"
"254491",0,2,0,2,"dummy"
"254512",1,5,0,6,"dummy"
"254513",0,0,2,2,"dummy"
"254514",4,7,1,12,"dummy"
"254515",0,3,0,3,"dummy"
"254516",0,2,0,2,"dummy"
"254517",0,4,0,4,"dummy"
"254518",0,8,0,8,"dummy"
"254519",3,0,1,4,"dummy"
"254520",11,7,0,18,"dummy"
"254521",11,10,3,24,"dummy"
"254522",9,3,0,12,"dummy"
"254523",2,6,2,10,"dummy"
"254524",11,10,0,21,"dummy"
"254525",0,1,0,1,"dummy"
"254526",0,0,8,8,"dummy"
"254527",11,4,0,15,"dummy"
"254528",4,11,0,15,"dummy"
"254529",0,1,0,1,"dummy"
"254530",0,0,1,1,"dummy"
"254531",11,4,0,15,"dummy"
"254532",1,3,0,4,"dummy"
"254533",3,8,1,12,"dummy"
"254534",20,13,0,33,"dummy"
"254535",13,20,0,33,"dummy"
"254536",11,4,0,15,"dummy"
"254541",1,1,1,3,"dummy"
"254542",3,0,0,3,"dummy"
"254546",0,0,1,1,"dummy"
"254547",0,0,1,1,"dummy"
"254548",0,1,0,1,"dummy"
"254549",0,1,1,2,"dummy"
"254550",0,0,1,1,"dummy"
"254551",11,5,4,20,"dummy"
"254552",4,9,5,18,"dummy"
"254553",0,0,1,1,"dummy"
"254554",0,0,1,1,"dummy"
"254555",0,1,0,1,"dummy"
"254556",1,3,2,6,"dummy"
"254557",0,0,1,1,"dummy"
"254558",0,0,1,1,"dummy"
"254559",0,0,1,1,"dummy"
"254560",0,2,0,2,"dummy"
"254561",0,0,1,1,"dummy"
"254562",0,0,1,1,"dummy"
"254563",3,0,0,3,"dummy"
"254564",0,0,1,1,"dummy"
"254565",0,0,1,1,"dummy"
"254566",0,0,1,1,"dummy"
"254567",0,0,1,1,"dummy"
"254568",0,0,1,1,"dummy"
"254569",0,2,0,2,"dummy"
"254570",0,0,1,1,"dummy"
"254571",0,0,1,1,"dummy"
"254572",0,0,1,1,"dummy"
"254573",0,0,1,1,"dummy"
"254574",0,0,1,1,"dummy"
"254575",0,0,1,1,"dummy"
"254576",0,0,1,1,"dummy"
"254577",0,0,1,1,"dummy"
"254578",0,0,1,1,"dummy"
"254455",3,5,3,11,"dummy"
"254456",0,0,1,1,"dummy"
"254457",0,0,2,2,"dummy"
"254462",0,1,0,1,"dummy"
"254463",2,0,1,3,"dummy"
"254468",2,3,0,5,"dummy"
"254469",3,0,0,3,"dummy"
"254470",0,3,0,3,"dummy"
"254493",1,9,5,15,"dummy"
"254494",0,0,1,1,"dummy"
"254495",0,0,1,1,"dummy"
"254500",1,6,0,7,"dummy"
"254501",1,2,0,3,"dummy"
"254502",0,3,0,3,"dummy"
"254503",8,6,0,14,"dummy"
"254538",0,8,0,8,"dummy"
"254539",7,3,0,10,"dummy"
"254544",2,0,4,6,"dummy"
"254684",4,5,3,12,"dummy"
"254685",1,0,0,1,"dummy"
"254686",0,0,0,0,"dummy"
"254695",0,1,0,1,"dummy"
"254696",0,2,0,2,"dummy"
"254697",2,4,1,7,"dummy"
"254713",0,6,0,6,"dummy"
"254714",1,0,0,1,"dummy"
"254715",0,2,0,2,"dummy"
"254718",7,4,1,12,"dummy"
"254719",0,4,0,4,"dummy"
"254720",4,24,1,29,"dummy"
"254721",0,0,0,0,"dummy"
"254722",8,0,0,8,"dummy"
"254723",1,0,0,1,"dummy"
"254724",1,4,1,6,"dummy"
"254725",21,3,2,26,"dummy"
"254726",0,3,0,3,"dummy"
"254727",6,0,0,6,"dummy"
"254746",0,2,1,3,"dummy"
"254747",0,1,0,1,"dummy"
"254750",4,6,0,10,"dummy"
"254751",0,0,1,1,"dummy"
"254752",5,2,0,7,"dummy"
"254753",2,0,0,2,"dummy"
"254754",0,1,0,1,"dummy"
"254771",0,1,0,1,"dummy"
"254772",1,1,0,2,"dummy"
"254785",1,1,1,3,"dummy"
"254786",0,1,2,3,"dummy"
"254787",0,1,1,2,"dummy"
"254788",1,0,2,3,"dummy"
"254789",0,0,0,0,"dummy"
"254790",2,1,2,5,"dummy"
"254791",0,3,2,5,"dummy"
"254792",1,0,0,1,"dummy"
"254793",2,1,1,4,"dummy"
"254796",0,0,1,1,"dummy"
"254874",0,0,0,0,"dummy"
"254875",0,0,3,3,"dummy"
"254876",0,0,3,3,"dummy"
"254877",0,0,0,0,"dummy"
"254885",1,0,0,1,"dummy"
"254891",0,0,1,1,"dummy"
"254908",9,3,2,14,"dummy"
"254909",0,5,0,5,"dummy"
"254913",0,0,0,0,"dummy"
"254914",3,4,1,8,"dummy"
"254579",0,0,1,1,"dummy"
"254580",0,0,1,1,"dummy"
"254581",0,0,1,1,"dummy"
"254582",0,0,1,1,"dummy"
"254583",0,0,1,1,"dummy"
"254584",0,0,1,1,"dummy"
"254585",0,0,1,1,"dummy"
"254586",0,0,1,1,"dummy"
"254587",0,0,1,1,"dummy"
"254588",0,0,1,1,"dummy"
"254589",0,0,1,1,"dummy"
"254590",0,0,1,1,"dummy"
"254591",0,0,1,1,"dummy"
"254592",0,0,1,1,"dummy"
"254593",0,0,1,1,"dummy"
"254594",0,0,1,1,"dummy"
"254595",0,0,1,1,"dummy"
"254596",0,0,1,1,"dummy"
"254597",0,0,1,1,"dummy"
"254598",0,0,1,1,"dummy"
"254599",0,0,1,1,"dummy"
"254600",0,0,1,1,"dummy"
"254601",0,0,1,1,"dummy"
"254602",0,0,1,1,"dummy"
"254603",0,0,1,1,"dummy"
"254604",0,0,1,1,"dummy"
"254605",2,4,2,8,"dummy"
"254606",0,0,1,1,"dummy"
"254607",0,0,1,1,"dummy"
"254608",0,0,1,1,"dummy"
"254609",0,0,1,1,"dummy"
"254610",0,0,1,1,"dummy"
"254611",0,0,1,1,"dummy"
"254612",0,0,1,1,"dummy"
"254613",0,0,1,1,"dummy"
"254614",0,0,1,1,"dummy"
"254615",0,0,1,1,"dummy"
"254616",0,0,1,1,"dummy"
"254617",0,0,1,1,"dummy"
"254618",0,0,1,1,"dummy"
"254619",0,0,1,1,"dummy"
"254620",0,0,1,1,"dummy"
"254621",0,0,1,1,"dummy"
"254622",0,0,1,1,"dummy"
"254623",0,0,1,1,"dummy"
"254624",0,0,1,1,"dummy"
"254625",0,0,1,1,"dummy"
"254626",1,2,2,5,"dummy"
"254627",0,0,1,1,"dummy"
"254628",0,0,1,1,"dummy"
"254629",0,0,1,1,"dummy"
"254630",0,0,1,1,"dummy"
"254631",0,0,1,1,"dummy"
"254632",0,0,1,1,"dummy"
"254633",0,0,1,1,"dummy"
"254634",0,0,1,1,"dummy"
"254635",0,0,1,1,"dummy"
"254636",0,0,1,1,"dummy"
"254637",0,0,1,1,"dummy"
"254638",0,0,1,1,"dummy"
"254639",0,0,1,1,"dummy"
"254640",0,0,1,1,"dummy"
"254641",0,0,1,1,"dummy"
"254642",0,0,1,1,"dummy"
"254643",0,0,1,1,"dummy"
"254644",0,0,1,1,"dummy"
"254645",0,0,1,1,"dummy"
"254646",0,0,1,1,"dummy"
"254647",0,0,1,1,"dummy"
"254648",0,0,1,1,"dummy"
"254649",0,0,1,1,"dummy"
"254650",0,0,1,1,"dummy"
"254651",10,1,4,15,"dummy"
"254652",0,0,0,0,"dummy"
"254653",0,0,0,0,"dummy"
"254654",0,0,0,0,"dummy"
"254655",0,0,0,0,"dummy"
"254656",0,0,0,0,"dummy"
"254657",0,0,0,0,"dummy"
"254658",0,0,0,0,"dummy"
"254659",0,0,0,0,"dummy"
"254660",0,0,0,0,"dummy"
"254661",0,0,0,0,"dummy"
"254662",0,0,0,0,"dummy"
"254663",0,0,0,0,"dummy"
"254664",0,0,0,0,"dummy"
"254665",0,0,0,0,"dummy"
"254666",0,0,0,0,"dummy"
"254667",0,0,0,0,"dummy"
"254668",0,0,0,0,"dummy"
"254669",0,0,0,0,"dummy"
"254670",0,0,0,0,"dummy"
"254671",0,0,0,0,"dummy"
"254672",0,0,0,0,"dummy"
"254673",0,0,0,0,"dummy"
"254674",0,0,0,0,"dummy"
"254675",0,0,0,0,"dummy"
"254676",0,0,0,0,"dummy"
"254677",0,0,0,0,"dummy"
"254678",0,0,0,0,"dummy"
"254679",0,0,0,0,"dummy"
"254682",0,1,0,1,"dummy"
"254692",0,0,1,1,"dummy"
"254693",0,0,1,1,"dummy"
"254699",1,1,0,2,"dummy"
"254729",0,1,0,1,"dummy"
"254730",0,1,0,1,"dummy"
"254731",0,0,0,0,"dummy"
"254732",8,0,2,10,"dummy"
"254733",0,26,1,27,"dummy"
"254758",2,3,2,7,"dummy"
"254759",5,0,0,5,"dummy"
"254760",0,1,0,1,"dummy"
"254761",0,4,1,5,"dummy"
"254762",0,0,1,1,"dummy"
"254763",4,4,0,8,"dummy"
"254764",0,4,1,5,"dummy"
"254765",0,0,0,0,"dummy"
"254766",0,1,0,1,"dummy"
"254767",7,1,0,8,"dummy"
"254768",0,0,1,1,"dummy"
"254769",4,0,1,5,"dummy"
"254776",0,2,0,2,"dummy"
"254800",0,16,0,16,"dummy"
"254801",2,1,0,3,"dummy"
"254802",0,5,1,6,"dummy"
"254803",0,3,0,3,"dummy"
"254861",5,15,0,20,"dummy"
"254862",8,10,0,18,"dummy"
"254863",0,1,0,1,"dummy"
"254864",0,1,0,1,"dummy"
"254865",0,2,1,3,"dummy"
"254866",17,7,1,25,"dummy"
"254867",0,0,1,1,"dummy"
"254868",0,1,0,1,"dummy"
"254869",1,0,0,1,"dummy"
"254870",7,1,0,8,"dummy"
"254871",0,2,0,2,"dummy"
"254872",0,1,0,1,"dummy"
"254879",1,0,0,1,"dummy"
"254880",0,0,2,2,"dummy"
"254881",4,5,0,9,"dummy"
"254882",2,3,2,7,"dummy"
"254883",1,2,0,3,"dummy"
"254900",0,0,1,1,"dummy"
"254901",2,0,0,2,"dummy"
"254902",0,2,0,2,"dummy"
"254903",0,3,0,3,"dummy"
"254904",2,1,0,3,"dummy"
"254935",0,6,0,6,"dummy"
"254936",1,3,0,4,"dummy"
"254946",12,2,4,18,"dummy"
"254949",1,0,0,1,"dummy"
"254950",10,3,1,14,"dummy"
"254951",0,1,0,1,"dummy"
"254958",0,0,1,1,"dummy"
"254959",1,1,0,2,"dummy"
"254960",10,0,0,10,"dummy"
"254961",0,1,0,1,"dummy"
"254962",0,1,0,1,"dummy"
"254963",0,1,0,1,"dummy"
"254964",0,1,0,1,"dummy"
"254965",0,1,0,1,"dummy"
"254966",0,0,1,1,"dummy"
"254967",0,3,0,3,"dummy"
"254968",0,0,0,0,"dummy"
"254969",0,2,0,2,"dummy"
"254977",0,1,0,1,"dummy"
"254978",0,1,0,1,"dummy"
"254979",1,7,0,8,"dummy"
"254980",0,0,1,1,"dummy"
"254981",1,0,1,2,"dummy"
"254982",0,3,0,3,"dummy"
"254983",0,1,1,2,"dummy"
"254984",1,3,0,4,"dummy"
"254985",0,0,2,2,"dummy"
"254915",0,1,0,1,"dummy"
"254916",0,3,0,3,"dummy"
"254917",0,1,0,1,"dummy"
"254918",0,6,1,7,"dummy"
"254919",18,8,0,26,"dummy"
"254920",0,0,2,2,"dummy"
"254921",0,0,0,0,"dummy"
"254922",1,2,0,3,"dummy"
"254923",4,1,1,6,"dummy"
"254924",0,0,0,0,"dummy"
"254925",0,2,2,4,"dummy"
"254926",0,0,1,1,"dummy"
"254927",4,1,1,6,"dummy"
"254928",0,3,0,3,"dummy"
"254929",0,0,0,0,"dummy"
"254930",0,2,0,2,"dummy"
"254931",39,3,4,46,"dummy"
"254938",0,2,0,2,"dummy"
"254953",1,0,0,1,"dummy"
"254954",1,1,0,2,"dummy"
"254971",1,1,1,3,"dummy"
"254972",0,3,0,3,"dummy"
"254975",0,0,0,0,"dummy"
"255007",1,0,0,1,"dummy"
"255018",0,0,0,0,"dummy"
"255019",10,9,2,21,"dummy"
"255022",0,3,0,3,"dummy"
"255023",3,0,0,3,"dummy"
"255024",0,1,0,1,"dummy"
"255025",0,1,0,1,"dummy"
"255026",1,3,1,5,"dummy"
"255027",0,1,0,1,"dummy"
"255031",1,2,0,3,"dummy"
"255032",0,4,0,4,"dummy"
"255033",0,2,0,2,"dummy"
"255034",5,1,1,7,"dummy"
"255035",1,2,1,4,"dummy"
"255036",0,0,0,0,"dummy"
"255037",2,1,1,4,"dummy"
"255038",0,0,1,1,"dummy"
"255040",0,2,0,2,"dummy"
"255041",0,1,0,1,"dummy"
"255042",1,0,1,2,"dummy"
"255048",1,0,0,1,"dummy"
"255049",0,1,2,3,"dummy"
"255050",1,0,2,3,"dummy"
"255051",0,1,1,2,"dummy"
"255052",0,0,0,0,"dummy"
"255053",0,1,0,1,"dummy"
"255055",0,0,2,2,"dummy"
"255056",0,1,0,1,"dummy"
"255057",3,6,1,10,"dummy"
"255059",3,2,1,6,"dummy"
"255063",1,4,4,9,"dummy"
"255064",0,0,1,1,"dummy"
"255065",0,1,1,2,"dummy"
"255069",0,0,1,1,"dummy"
"255070",0,0,1,1,"dummy"
"255071",0,0,1,1,"dummy"
"255072",0,0,1,1,"dummy"
"255073",0,0,1,1,"dummy"
"255074",0,0,1,1,"dummy"
"255075",0,0,1,1,"dummy"
"255076",1,2,0,3,"dummy"
"255078",0,7,0,7,"dummy"
"255080",4,8,1,13,"dummy"
"255081",6,4,3,13,"dummy"
"255082",2,0,1,3,"dummy"
"255083",0,0,2,2,"dummy"
"255089",2,2,0,4,"dummy"
"255090",7,4,3,14,"dummy"
"255091",0,0,1,1,"dummy"
"255092",1,0,1,2,"dummy"
"255093",1,2,3,6,"dummy"
"255094",0,0,1,1,"dummy"
"255096",0,0,0,0,"dummy"
"255097",0,1,0,1,"dummy"
"255098",0,0,2,2,"dummy"
"255101",0,19,0,19,"dummy"
"255102",0,2,0,2,"dummy"
"255103",0,3,0,3,"dummy"
"255104",0,0,1,1,"dummy"
"255105",2,0,1,3,"dummy"
"255106",2,9,2,13,"dummy"
"255107",0,0,0,0,"dummy"
"255112",0,0,0,0,"dummy"
"255113",1,0,3,4,"dummy"
"255116",0,0,1,1,"dummy"
"255121",0,8,0,8,"dummy"
"255125",1,12,0,13,"dummy"
"255126",0,5,0,5,"dummy"
"255127",0,1,0,1,"dummy"
"255128",0,1,1,2,"dummy"
"255131",1,1,0,2,"dummy"
"255132",0,0,2,2,"dummy"
"255133",0,0,2,2,"dummy"
"255134",0,0,2,2,"dummy"
"255135",0,0,2,2,"dummy"
"255137",0,0,4,4,"dummy"
"255144",7,3,0,10,"dummy"
"255145",0,1,0,1,"dummy"
"255146",0,0,1,1,"dummy"
"255147",4,4,0,8,"dummy"
"255151",0,1,0,1,"dummy"
"255152",0,0,1,1,"dummy"
"255156",0,0,1,1,"dummy"
"255157",1,4,0,5,"dummy"
"255158",0,8,0,8,"dummy"
"255159",6,0,0,6,"dummy"
"255161",0,0,1,1,"dummy"
"255163",0,3,0,3,"dummy"
"255166",2,0,0,2,"dummy"
"255168",3,3,0,6,"dummy"
"255169",0,0,0,0,"dummy"
"255170",0,1,0,1,"dummy"
"255171",0,0,1,1,"dummy"
"255177",0,0,1,1,"dummy"
"255180",1,0,0,1,"dummy"
"255181",0,1,0,1,"dummy"
"255187",1,0,0,1,"dummy"
"255188",0,1,0,1,"dummy"
"255189",1,2,0,3,"dummy"
"255190",0,1,0,1,"dummy"
"255191",0,1,0,1,"dummy"
"255192",0,1,0,1,"dummy"
"255193",1,0,0,1,"dummy"
"255194",0,1,0,1,"dummy"
"255195",2,0,0,2,"dummy"
"255196",0,2,0,2,"dummy"
"255197",0,0,2,2,"dummy"
"255198",0,2,0,2,"dummy"
"255199",0,2,1,3,"dummy"
"255200",0,0,1,1,"dummy"
"255201",0,1,0,1,"dummy"
"255202",1,1,0,2,"dummy"
"255203",1,2,0,3,"dummy"
"255204",0,1,1,2,"dummy"
"255205",0,0,1,1,"dummy"
"255206",0,1,0,1,"dummy"
"255207",0,0,1,1,"dummy"
"255210",5,15,3,23,"dummy"
"255211",0,6,0,6,"dummy"
"255212",5,0,0,5,"dummy"
"255213",0,1,0,1,"dummy"
"255214",0,0,1,1,"dummy"
"255215",0,0,1,1,"dummy"
"255217",0,2,0,2,"dummy"
"255218",0,0,1,1,"dummy"
"255219",4,14,5,23,"dummy"
"255220",0,1,0,1,"dummy"
"255221",0,0,1,1,"dummy"
"255222",0,0,5,5,"dummy"
"255226",2,1,2,5,"dummy"
"255227",0,0,4,4,"dummy"
"255228",0,1,1,2,"dummy"
"255229",0,0,0,0,"dummy"
"255231",0,1,0,1,"dummy"
"255234",0,1,0,1,"dummy"
"255238",1,2,0,3,"dummy"
"255257",2,2,0,4,"dummy"
"255260",0,0,1,1,"dummy"
"255261",0,0,1,1,"dummy"
"255263",1,0,0,1,"dummy"
"255264",0,1,0,1,"dummy"
"255266",0,6,0,6,"dummy"
"255267",2,4,0,6,"dummy"
"255268",0,15,3,18,"dummy"
"255269",7,12,0,19,"dummy"
"255270",7,5,4,16,"dummy"
"255271",0,0,0,0,"dummy"
"255272",0,2,0,2,"dummy"
"255273",1,1,0,2,"dummy"
"255274",23,2,3,28,"dummy"
"255275",0,0,1,1,"dummy"
"255276",0,0,1,1,"dummy"
"255282",0,3,1,4,"dummy"
"255283",0,0,0,0,"dummy"
"255284",9,8,1,18,"dummy"
"255286",11,5,0,16,"dummy"
"255288",3,4,1,8,"dummy"
"255289",1,1,0,2,"dummy"
"255290",1,1,3,5,"dummy"
"255293",0,0,1,1,"dummy"
"255294",0,2,0,2,"dummy"
"255295",2,2,0,4,"dummy"
"255296",0,1,0,1,"dummy"
"255297",0,2,0,2,"dummy"
"255298",0,2,0,2,"dummy"
"255299",0,1,0,1,"dummy"
"255302",0,0,1,1,"dummy"
"255303",0,1,3,4,"dummy"
"255304",1,0,3,4,"dummy"
"255305",0,0,1,1,"dummy"
"255306",0,0,0,0,"dummy"
"255307",0,1,2,3,"dummy"
"255312",0,0,2,2,"dummy"
"255313",0,1,0,1,"dummy"
"255315",0,0,0,0,"dummy"
"255323",0,3,2,5,"dummy"
"255324",9,1,2,12,"dummy"
"255325",0,0,2,2,"dummy"
"255326",1,3,0,4,"dummy"
"255327",2,0,0,2,"dummy"
"255328",0,1,2,3,"dummy"
"255329",0,1,4,5,"dummy"
"255330",0,4,0,4,"dummy"
"255331",0,1,0,1,"dummy"
"255332",4,0,0,4,"dummy"
"255333",2,8,5,15,"dummy"
"255334",0,0,0,0,"dummy"
"255335",0,0,1,1,"dummy"
"255336",0,0,1,1,"dummy"
"255337",0,0,1,1,"dummy"
"255339",0,0,1,1,"dummy"
"255340",0,0,1,1,"dummy"
"255341",0,0,1,1,"dummy"
"255342",0,0,1,1,"dummy"
"255343",0,0,1,1,"dummy"
"255344",0,2,0,2,"dummy"
"255345",0,0,1,1,"dummy"
"255346",0,0,1,1,"dummy"
"255347",0,0,1,1,"dummy"
"255348",0,0,1,1,"dummy"
"255349",0,0,1,1,"dummy"
"255350",0,0,1,1,"dummy"
"255352",6,6,1,13,"dummy"
"255359",0,2,0,2,"dummy"
"255361",2,7,3,12,"dummy"
"255362",0,0,1,1,"dummy"
"255365",2,0,0,2,"dummy"
"255366",0,3,1,4,"dummy"
"255367",2,0,0,2,"dummy"
"255368",0,1,0,1,"dummy"
"255369",0,1,2,3,"dummy"
"255380",0,0,1,1,"dummy"
"255381",1,4,0,5,"dummy"
"255382",0,0,1,1,"dummy"
"255383",1,0,0,1,"dummy"
"255384",10,5,2,17,"dummy"
"255385",2,0,0,2,"dummy"
"255386",0,0,1,1,"dummy"
"255387",3,6,0,9,"dummy"
"255391",0,2,0,2,"dummy"
"255392",2,0,0,2,"dummy"
"255396",0,0,1,1,"dummy"
"255397",0,0,1,1,"dummy"
"255398",0,1,1,2,"dummy"
"255400",2,1,1,4,"dummy"
"255401",0,2,1,3,"dummy"
"255404",0,1,2,3,"dummy"
"255405",2,3,1,6,"dummy"
"255406",3,1,1,5,"dummy"
"255407",0,1,0,1,"dummy"
"255410",2,0,0,2,"dummy"
"255413",0,8,4,12,"dummy"
"255414",0,2,2,4,"dummy"
"255415",10,0,4,14,"dummy"
"255417",0,5,0,5,"dummy"
"255419",0,0,0,0,"dummy"
"255420",0,0,0,0,"dummy"
"255421",0,0,0,0,"dummy"
"255422",0,0,0,0,"dummy"
"255423",0,0,0,0,"dummy"
"255424",1,10,2,13,"dummy"
"255425",0,1,0,1,"dummy"
"255426",1,0,0,1,"dummy"
"255427",0,0,0,0,"dummy"
"255430",2,1,1,4,"dummy"
"255431",0,2,1,3,"dummy"
"255432",0,1,0,1,"dummy"
"255433",1,2,0,3,"dummy"
"255446",0,0,2,2,"dummy"
"255447",4,1,1,6,"dummy"
"255448",0,2,0,2,"dummy"
"255449",0,0,0,0,"dummy"
"255452",0,0,0,0,"dummy"
"255453",5,0,2,7,"dummy"
"255454",0,0,0,0,"dummy"
"255458",0,0,1,1,"dummy"
"255464",0,0,3,3,"dummy"
"255467",2,0,1,3,"dummy"
"255468",5,6,0,11,"dummy"
"255471",0,0,1,1,"dummy"
"255472",0,0,1,1,"dummy"
"255473",6,0,2,8,"dummy"
"255474",0,0,1,1,"dummy"
"255487",0,5,0,5,"dummy"
"255488",3,2,2,7,"dummy"
"255489",1,2,1,4,"dummy"
"255490",27,18,2,47,"dummy"
"255491",0,1,0,1,"dummy"
"255492",0,1,0,1,"dummy"
"255493",1,0,1,2,"dummy"
"255503",2,3,2,7,"dummy"
"255558",2,1,0,3,"dummy"
"255559",0,0,1,1,"dummy"
"255563",0,0,1,1,"dummy"
"255571",0,0,1,1,"dummy"
"255572",10,8,5,23,"dummy"
"255573",2,15,1,18,"dummy"
"255578",2,2,1,5,"dummy"
"255579",0,1,0,1,"dummy"
"255589",12,2,0,14,"dummy"
"255590",3,3,0,6,"dummy"
"255644",1,4,1,6,"dummy"
"255645",4,4,0,8,"dummy"
"255646",13,10,5,28,"dummy"
"255647",5,5,0,10,"dummy"
"255648",9,2,1,12,"dummy"
"255649",0,1,0,1,"dummy"
"255650",5,1,2,8,"dummy"
"255651",0,0,1,1,"dummy"
"255652",0,0,1,1,"dummy"
"255653",3,2,2,7,"dummy"
"255654",0,1,2,3,"dummy"
"255655",2,9,0,11,"dummy"
"255656",0,1,0,1,"dummy"
"255665",5,3,0,8,"dummy"
"255666",3,8,0,11,"dummy"
"255667",0,0,2,2,"dummy"
"255668",0,0,1,1,"dummy"
"255671",0,0,0,0,"dummy"
"255675",0,0,1,1,"dummy"
"255695",0,0,1,1,"dummy"
"255696",0,1,0,1,"dummy"
"255697",0,0,0,0,"dummy"
"255698",0,1,0,1,"dummy"
"255699",6,0,0,6,"dummy"
"255707",0,1,0,1,"dummy"
"255714",5,4,2,11,"dummy"
"255715",0,0,1,1,"dummy"
"255725",1,2,0,3,"dummy"
"255731",0,0,1,1,"dummy"
"255734",20,2,4,26,"dummy"
"255735",0,0,2,2,"dummy"
"255739",0,0,1,1,"dummy"
"255740",0,0,1,1,"dummy"
"255746",0,0,2,2,"dummy"
"255747",1,1,5,7,"dummy"
"255748",0,0,1,1,"dummy"
"255749",0,0,1,1,"dummy"
"255750",1,0,2,3,"dummy"
"255751",1,1,0,2,"dummy"
"255752",1,1,0,2,"dummy"
"255755",0,0,1,1,"dummy"
"255460",7,2,3,12,"dummy"
"255461",0,2,0,2,"dummy"
"255462",0,0,1,1,"dummy"
"255476",0,0,2,2,"dummy"
"255477",2,0,0,2,"dummy"
"255478",0,1,0,1,"dummy"
"255479",0,1,0,1,"dummy"
"255480",6,0,0,6,"dummy"
"255481",0,0,0,0,"dummy"
"255482",0,0,0,0,"dummy"
"255483",0,0,0,0,"dummy"
"255484",0,0,0,0,"dummy"
"255485",0,0,0,0,"dummy"
"255497",0,1,2,3,"dummy"
"255498",0,0,3,3,"dummy"
"255499",0,1,0,1,"dummy"
"255561",0,1,0,1,"dummy"
"255575",0,0,1,1,"dummy"
"255576",0,0,0,0,"dummy"
"255594",5,22,2,29,"dummy"
"255595",1,1,2,4,"dummy"
"255596",0,0,0,0,"dummy"
"255597",0,0,1,1,"dummy"
"255598",0,0,0,0,"dummy"
"255599",17,33,0,50,"dummy"
"255600",33,17,0,50,"dummy"
"255601",0,1,1,2,"dummy"
"255602",15,26,0,41,"dummy"
"255603",0,0,6,6,"dummy"
"255604",1,4,0,5,"dummy"
"255605",0,0,0,0,"dummy"
"255606",0,0,0,0,"dummy"
"255607",0,0,6,6,"dummy"
"255608",0,3,4,7,"dummy"
"255609",17,18,4,39,"dummy"
"255610",6,6,6,18,"dummy"
"255611",8,4,0,12,"dummy"
"255612",3,2,0,5,"dummy"
"255632",0,0,1,1,"dummy"
"255635",2,4,0,6,"dummy"
"255636",0,2,0,2,"dummy"
"255637",0,2,0,2,"dummy"
"255638",10,2,0,12,"dummy"
"255639",0,2,0,2,"dummy"
"255640",0,0,0,0,"dummy"
"255641",0,0,3,3,"dummy"
"255642",0,5,0,5,"dummy"
"255660",0,0,0,0,"dummy"
"255661",5,5,0,10,"dummy"
"255662",0,1,0,1,"dummy"
"255663",0,1,0,1,"dummy"
"255673",3,1,0,4,"dummy"
"255677",0,0,1,1,"dummy"
"255678",0,0,1,1,"dummy"
"255679",0,0,1,1,"dummy"
"255680",0,0,2,2,"dummy"
"255681",0,0,1,1,"dummy"
"255682",3,0,0,3,"dummy"
"255683",0,0,1,1,"dummy"
"255684",0,0,1,1,"dummy"
"255685",0,0,1,1,"dummy"
"255686",0,0,1,1,"dummy"
"255687",0,0,1,1,"dummy"
"255688",0,0,1,1,"dummy"
"255691",3,0,2,5,"dummy"
"255701",3,7,6,16,"dummy"
"255702",4,9,0,13,"dummy"
"255703",0,2,1,3,"dummy"
"255711",0,0,1,1,"dummy"
"255712",0,0,1,1,"dummy"
"255717",0,2,0,2,"dummy"
"255718",0,5,0,5,"dummy"
"255719",0,1,0,1,"dummy"
"255720",0,1,0,1,"dummy"
"255721",0,0,1,1,"dummy"
"255727",2,4,1,7,"dummy"
"255728",0,1,0,1,"dummy"
"255729",0,0,3,3,"dummy"
"255737",4,1,0,5,"dummy"
"255742",1,0,0,1,"dummy"
"255743",0,0,1,1,"dummy"
"255744",1,0,0,1,"dummy"
"255764",13,1,2,16,"dummy"
"255765",0,0,1,1,"dummy"
"255785",0,0,1,1,"dummy"
"255786",0,0,1,1,"dummy"
"255787",0,0,1,1,"dummy"
"255788",0,0,1,1,"dummy"
"255816",0,0,6,6,"dummy"
"255817",0,0,2,2,"dummy"
"255818",0,0,1,1,"dummy"
"255819",8,5,1,14,"dummy"
"255820",0,1,0,1,"dummy"
"255830",0,0,1,1,"dummy"
"255831",7,3,1,11,"dummy"
"255832",7,5,6,18,"dummy"
"255833",0,0,1,1,"dummy"
"255836",0,1,0,1,"dummy"
"255837",0,1,0,1,"dummy"
"255838",0,2,0,2,"dummy"
"255839",0,6,0,6,"dummy"
"255840",2,0,0,2,"dummy"
"255841",0,0,6,6,"dummy"
"255842",0,0,2,2,"dummy"
"255843",0,2,0,2,"dummy"
"255844",2,0,0,2,"dummy"
"255845",0,2,0,2,"dummy"
"255846",0,2,0,2,"dummy"
"255847",0,0,1,1,"dummy"
"255848",0,1,5,6,"dummy"
"255849",31,5,3,39,"dummy"
"255852",0,1,0,1,"dummy"
"255853",1,0,0,1,"dummy"
"255854",0,1,0,1,"dummy"
"255861",0,5,0,5,"dummy"
"255862",1,0,0,1,"dummy"
"255882",0,1,0,1,"dummy"
"255883",0,3,0,3,"dummy"
"255884",9,9,0,18,"dummy"
"255885",2,2,0,4,"dummy"
"255886",9,9,0,18,"dummy"
"255887",0,5,0,5,"dummy"
"255888",0,0,1,1,"dummy"
"255889",4,1,5,10,"dummy"
"255890",0,2,1,3,"dummy"
"255891",0,0,1,1,"dummy"
"255892",0,4,0,4,"dummy"
"255893",1,0,1,2,"dummy"
"255894",0,1,0,1,"dummy"
"255895",7,7,0,14,"dummy"
"255896",2,0,0,2,"dummy"
"255897",0,3,0,3,"dummy"
"255898",8,2,0,10,"dummy"
"255899",0,1,0,1,"dummy"
"255900",2,3,0,5,"dummy"
"255901",0,0,1,1,"dummy"
"255902",0,7,3,10,"dummy"
"255903",0,0,3,3,"dummy"
"255911",0,1,0,1,"dummy"
"255912",0,1,0,1,"dummy"
"255913",2,5,1,8,"dummy"
"255914",0,4,0,4,"dummy"
"255915",12,6,5,23,"dummy"
"255934",0,0,0,0,"dummy"
"255935",0,1,0,1,"dummy"
"255939",4,4,1,9,"dummy"
"255940",0,0,0,0,"dummy"
"255941",1,4,0,5,"dummy"
"255942",3,3,0,6,"dummy"
"255943",0,0,1,1,"dummy"
"255944",0,0,1,1,"dummy"
"255953",0,1,0,1,"dummy"
"255954",0,2,0,2,"dummy"
"255955",2,2,0,4,"dummy"
"255756",0,0,1,1,"dummy"
"255757",0,0,1,1,"dummy"
"255758",0,0,1,1,"dummy"
"255759",0,0,1,1,"dummy"
"255762",0,0,1,1,"dummy"
"255767",0,2,1,3,"dummy"
"255780",0,1,0,1,"dummy"
"255781",0,0,0,0,"dummy"
"255782",1,0,0,1,"dummy"
"255783",0,1,0,1,"dummy"
"255792",0,0,1,1,"dummy"
"255807",0,0,1,1,"dummy"
"255808",3,0,0,3,"dummy"
"255809",24,1,1,26,"dummy"
"255810",1,6,1,8,"dummy"
"255811",4,3,1,8,"dummy"
"255812",2,1,1,4,"dummy"
"255813",0,0,1,1,"dummy"
"255814",5,4,0,9,"dummy"
"255822",0,0,0,0,"dummy"
"255823",2,5,0,7,"dummy"
"255826",0,3,0,3,"dummy"
"255827",2,1,0,3,"dummy"
"255828",5,13,1,19,"dummy"
"255856",1,0,0,1,"dummy"
"255857",0,1,0,1,"dummy"
"255864",19,5,0,24,"dummy"
"255865",38,3,0,41,"dummy"
"255866",5,0,0,5,"dummy"
"255867",2,5,0,7,"dummy"
"255868",6,7,0,13,"dummy"
"255869",4,5,0,9,"dummy"
"255870",1,1,0,2,"dummy"
"255871",1,0,0,1,"dummy"
"255872",0,1,0,1,"dummy"
"255873",0,1,0,1,"dummy"
"255874",1,0,0,1,"dummy"
"255875",2,2,0,4,"dummy"
"255876",5,6,1,12,"dummy"
"255877",0,0,0,0,"dummy"
"255878",7,1,0,8,"dummy"
"255879",0,1,0,1,"dummy"
"255880",0,2,0,2,"dummy"
"255905",0,0,2,2,"dummy"
"255906",4,5,3,12,"dummy"
"255907",1,2,0,3,"dummy"
"255908",3,0,3,6,"dummy"
"255909",3,0,0,3,"dummy"
"255919",1,0,0,1,"dummy"
"255920",0,1,0,1,"dummy"
"255925",0,1,0,1,"dummy"
"255946",0,0,1,1,"dummy"
"255947",0,0,1,1,"dummy"
"255948",0,1,4,5,"dummy"
"255949",0,0,1,1,"dummy"
"255950",0,0,1,1,"dummy"
"255951",0,0,2,2,"dummy"
"255969",6,0,1,7,"dummy"
"255972",0,0,1,1,"dummy"
"255975",1,2,0,3,"dummy"
"255981",7,12,1,20,"dummy"
"255986",0,3,1,4,"dummy"
"255987",0,2,0,2,"dummy"
"255988",0,0,3,3,"dummy"
"255989",1,0,0,1,"dummy"
"255990",0,0,2,2,"dummy"
"255991",0,0,1,1,"dummy"
"255992",0,1,0,1,"dummy"
"255993",0,6,1,7,"dummy"
"255994",0,0,1,1,"dummy"
"255997",0,0,1,1,"dummy"
"256001",3,8,2,13,"dummy"
"256002",5,0,0,5,"dummy"
"255956",2,10,0,12,"dummy"
"255957",0,1,1,2,"dummy"
"255958",2,15,0,17,"dummy"
"255959",3,6,0,9,"dummy"
"255960",4,7,0,11,"dummy"
"255961",0,0,1,1,"dummy"
"255966",0,2,0,2,"dummy"
"255967",1,4,0,5,"dummy"
"255977",0,0,0,0,"dummy"
"255999",1,1,1,3,"dummy"
"256004",0,2,1,3,"dummy"
"256007",0,0,0,0,"dummy"
"256010",2,0,0,2,"dummy"
"256011",0,1,0,1,"dummy"
"256012",2,5,1,8,"dummy"
"256013",0,1,0,1,"dummy"
"256014",1,0,1,2,"dummy"
"256015",6,9,0,15,"dummy"
"256016",0,0,0,0,"dummy"
"256017",1,0,0,1,"dummy"
"256018",0,1,0,1,"dummy"
"256019",1,0,0,1,"dummy"
"256020",0,0,0,0,"dummy"
"256021",0,1,0,1,"dummy"
"256022",6,0,0,6,"dummy"
"256023",0,0,2,2,"dummy"
"256024",0,0,0,0,"dummy"
"256059",0,1,0,1,"dummy"
"256060",0,0,0,0,"dummy"
"256061",1,2,0,3,"dummy"
"256062",2,2,0,4,"dummy"
"256063",2,8,0,10,"dummy"
"256064",1,2,0,3,"dummy"
"256065",0,1,3,4,"dummy"
"256066",1,1,0,2,"dummy"
"256067",1,0,3,4,"dummy"
"256068",0,1,3,4,"dummy"
"256069",0,1,0,1,"dummy"
"256070",10,6,2,18,"dummy"
"256071",2,0,0,2,"dummy"
"256072",0,0,1,1,"dummy"
"256073",2,2,0,4,"dummy"
"256074",1,4,0,5,"dummy"
"256075",11,3,0,14,"dummy"
"256076",1,1,0,2,"dummy"
"256077",0,1,0,1,"dummy"
"256078",5,2,1,8,"dummy"
"256079",2,0,0,2,"dummy"
"256080",1,2,0,3,"dummy"
"256081",2,0,1,3,"dummy"
"256082",2,1,0,3,"dummy"
"256083",1,2,0,3,"dummy"
"256084",2,1,0,3,"dummy"
"256085",2,0,0,2,"dummy"
"256086",0,2,0,2,"dummy"
"256087",0,0,1,1,"dummy"
"256088",7,1,0,8,"dummy"
"256089",2,0,0,2,"dummy"
"256090",1,0,1,2,"dummy"
"256091",1,3,3,7,"dummy"
"256092",0,0,3,3,"dummy"
"256093",0,0,1,1,"dummy"
"256094",0,12,0,12,"dummy"
"256095",0,0,0,0,"dummy"
"256096",0,1,0,1,"dummy"
"256097",5,1,0,6,"dummy"
"256102",4,9,3,16,"dummy"
"256103",5,9,2,16,"dummy"
"256104",1,1,1,3,"dummy"
"256105",7,2,1,10,"dummy"
"256117",0,0,1,1,"dummy"
"256118",0,0,1,1,"dummy"
"256119",0,0,0,0,"dummy"
"256120",0,0,1,1,"dummy"
"256121",0,0,1,1,"dummy"
"256124",0,0,1,1,"dummy"
"256125",2,1,0,3,"dummy"
"256126",1,2,0,3,"dummy"
"256127",0,0,1,1,"dummy"
"256128",0,0,1,1,"dummy"
"256028",0,0,3,3,"dummy"
"256029",0,5,0,5,"dummy"
"256030",0,0,4,4,"dummy"
"256031",0,15,0,15,"dummy"
"256032",0,1,0,1,"dummy"
"256033",1,0,0,1,"dummy"
"256034",0,0,2,2,"dummy"
"256037",2,2,2,6,"dummy"
"256038",0,4,0,4,"dummy"
"256107",1,0,0,1,"dummy"
"256108",0,1,0,1,"dummy"
"256109",0,1,0,1,"dummy"
"256110",7,7,1,15,"dummy"
"256111",0,0,1,1,"dummy"
"256112",0,1,0,1,"dummy"
"256113",13,5,2,20,"dummy"
"256114",1,0,0,1,"dummy"
"256115",0,1,0,1,"dummy"
"256132",0,7,0,7,"dummy"
"256135",0,1,0,1,"dummy"
"256136",0,1,0,1,"dummy"
"256137",2,5,0,7,"dummy"
"256138",1,5,3,9,"dummy"
"256139",0,1,0,1,"dummy"
"256158",0,0,1,1,"dummy"
"256159",0,0,1,1,"dummy"
"256160",0,0,2,2,"dummy"
"256161",0,0,1,1,"dummy"
"256166",0,4,0,4,"dummy"
"256167",0,1,0,1,"dummy"
"256168",0,0,1,1,"dummy"
"256176",0,3,2,5,"dummy"
"256129",1,0,0,1,"dummy"
"256130",0,0,0,0,"dummy"
"256141",17,18,8,43,"dummy"
"256144",0,0,0,0,"dummy"
"256145",0,0,0,0,"dummy"
"256163",0,0,0,0,"dummy"
"256164",0,6,0,6,"dummy"
"256172",0,0,0,0,"dummy"
"256173",5,0,2,7,"dummy"
"256174",0,0,0,0,"dummy"
"256184",0,1,0,1,"dummy"
"256185",4,0,0,4,"dummy"
"256193",0,0,1,1,"dummy"
"256194",0,0,0,0,"dummy"
"256196",0,0,0,0,"dummy"
"256198",0,2,0,2,"dummy"
"256199",6,3,0,9,"dummy"
"256200",3,3,0,6,"dummy"
"256218",0,1,0,1,"dummy"
"256219",0,0,1,1,"dummy"
"256223",0,0,0,0,"dummy"
"256224",0,0,0,0,"dummy"
"256225",0,2,0,2,"dummy"
"256226",0,1,0,1,"dummy"
"256227",0,0,0,0,"dummy"
"256228",1,0,0,1,"dummy"
"256231",1,2,2,5,"dummy"
"256232",1,0,0,1,"dummy"
"256233",3,0,2,5,"dummy"
"256245",0,1,0,1,"dummy"
"256246",0,2,0,2,"dummy"
"256247",3,0,0,3,"dummy"
"256248",0,0,2,2,"dummy"
"256249",1,3,0,4,"dummy"
"256250",0,1,0,1,"dummy"
"256257",1,1,0,2,"dummy"
"256258",0,0,1,1,"dummy"
"256259",0,1,0,1,"dummy"
"256269",2,3,0,5,"dummy"
"256274",0,0,1,1,"dummy"
"256276",2,3,0,5,"dummy"
"256277",2,13,0,15,"dummy"
"256278",20,0,2,22,"dummy"
"256280",0,0,0,0,"dummy"
"256281",0,0,0,0,"dummy"
"256284",0,0,2,2,"dummy"
"256285",0,0,2,2,"dummy"
"256286",0,0,2,2,"dummy"
"256287",0,1,0,1,"dummy"
"256288",0,4,0,4,"dummy"
"256289",0,0,2,2,"dummy"
"256291",50,44,4,98,"dummy"
"256292",1,1,0,2,"dummy"
"256293",42,47,6,95,"dummy"
"256294",0,1,0,1,"dummy"
"256295",2,1,0,3,"dummy"
"256296",9,7,17,33,"dummy"
"256297",0,1,0,1,"dummy"
"256298",0,0,0,0,"dummy"
"256299",8,15,0,23,"dummy"
"256300",4,2,0,6,"dummy"
"256301",0,6,7,13,"dummy"
"256302",1,0,0,1,"dummy"
"256303",0,0,0,0,"dummy"
"256304",0,1,0,1,"dummy"
"256305",7,2,0,9,"dummy"
"256306",1,14,0,15,"dummy"
"256307",0,0,1,1,"dummy"
"256310",3,13,1,17,"dummy"
"256311",0,1,0,1,"dummy"
"256312",0,0,1,1,"dummy"
"256315",2,0,3,5,"dummy"
"256316",3,0,0,3,"dummy"
"256317",0,3,0,3,"dummy"
"256318",0,5,1,6,"dummy"
"256321",0,1,0,1,"dummy"
"256322",0,2,0,2,"dummy"
"256323",0,5,0,5,"dummy"
"256324",6,2,0,8,"dummy"
"256325",1,0,0,1,"dummy"
"256326",0,2,0,2,"dummy"
"256327",0,0,1,1,"dummy"
"256329",2,2,3,7,"dummy"
"256330",0,0,0,0,"dummy"
"256332",0,0,1,1,"dummy"
"256333",0,0,1,1,"dummy"
"256334",0,0,2,2,"dummy"
"256335",26,3,7,36,"dummy"
"256387",0,5,0,5,"dummy"
"256388",2,0,0,2,"dummy"
"256389",1,0,0,1,"dummy"
"256390",0,0,1,1,"dummy"
"256392",13,1,1,15,"dummy"
"256394",0,0,0,0,"dummy"
"256395",0,0,0,0,"dummy"
"256396",0,0,0,0,"dummy"
"256397",4,4,0,8,"dummy"
"256398",0,1,1,2,"dummy"
"256399",1,1,0,2,"dummy"
"256401",2,3,0,5,"dummy"
"256402",0,0,1,1,"dummy"
"256403",0,0,1,1,"dummy"
"256429",0,1,0,1,"dummy"
"256431",9,2,3,14,"dummy"
"256434",0,0,0,0,"dummy"
"256435",1,2,0,3,"dummy"
"256474",0,0,0,0,"dummy"
"256475",0,0,0,0,"dummy"
"256478",0,1,2,3,"dummy"
"256480",0,0,0,0,"dummy"
"256481",7,3,2,12,"dummy"
"256483",5,2,1,8,"dummy"
"256484",2,5,1,8,"dummy"
"256487",0,1,0,1,"dummy"
"256488",0,0,2,2,"dummy"
"256497",1,0,0,1,"dummy"
"256498",0,2,0,2,"dummy"
"256499",9,9,0,18,"dummy"
"256500",2,1,0,3,"dummy"
"256501",0,2,0,2,"dummy"
"256502",0,0,0,0,"dummy"
"256503",0,0,0,0,"dummy"
"256504",0,3,0,3,"dummy"
"256505",0,0,2,2,"dummy"
"256506",0,0,2,2,"dummy"
"256507",0,1,0,1,"dummy"
"256508",4,5,4,13,"dummy"
"256510",0,7,0,7,"dummy"
"256511",2,2,0,4,"dummy"
"256512",0,0,5,5,"dummy"
"256513",0,0,0,0,"dummy"
"256514",0,0,0,0,"dummy"
"256515",0,0,0,0,"dummy"
"256516",0,0,0,0,"dummy"
"256517",0,1,0,1,"dummy"
"256519",0,0,3,3,"dummy"
"256524",0,0,1,1,"dummy"
"256525",0,0,0,0,"dummy"
"256526",0,0,1,1,"dummy"
"256527",0,0,1,1,"dummy"
"256528",0,0,1,1,"dummy"
"256529",0,0,1,1,"dummy"
"256530",0,0,1,1,"dummy"
"256531",0,0,1,1,"dummy"
"256532",0,0,1,1,"dummy"
"256533",0,0,1,1,"dummy"
"256534",0,0,1,1,"dummy"
"256535",0,0,1,1,"dummy"
"256536",0,0,1,1,"dummy"
"256537",0,0,1,1,"dummy"
"256538",0,0,1,1,"dummy"
"256539",0,0,1,1,"dummy"
"256540",0,0,1,1,"dummy"
"256541",0,0,1,1,"dummy"
"256543",0,4,0,4,"dummy"
"256544",1,0,0,1,"dummy"
"256545",0,0,0,0,"dummy"
"256546",0,0,0,0,"dummy"
"256547",0,0,1,1,"dummy"
"256548",0,0,0,0,"dummy"
"256549",3,2,0,5,"dummy"
"256550",1,0,0,1,"dummy"
"256551",2,3,0,5,"dummy"
"256552",0,0,1,1,"dummy"
"256555",2,14,3,19,"dummy"
"256556",7,3,0,10,"dummy"
"256560",0,0,1,1,"dummy"
"256561",0,0,1,1,"dummy"
"256562",0,0,1,1,"dummy"
"256563",0,0,1,1,"dummy"
"256566",0,2,3,5,"dummy"
"256567",0,1,0,1,"dummy"
"256568",0,1,5,6,"dummy"
"256569",0,0,1,1,"dummy"
"256570",0,0,1,1,"dummy"
"256581",10,26,3,39,"dummy"
"256582",20,30,6,56,"dummy"
"256583",1,3,1,5,"dummy"
"256584",0,2,0,2,"dummy"
"256585",1,0,0,1,"dummy"
"256586",0,1,0,1,"dummy"
"256587",0,0,1,1,"dummy"
"256588",1,3,1,5,"dummy"
"256589",10,1,1,12,"dummy"
"256590",5,8,2,15,"dummy"
"256591",2,2,5,9,"dummy"
"256592",2,2,7,11,"dummy"
"256593",2,6,2,10,"dummy"
"256594",8,7,4,19,"dummy"
"256595",0,0,2,2,"dummy"
"256596",0,0,0,0,"dummy"
"256597",0,2,0,2,"dummy"
"256598",2,2,0,4,"dummy"
"256599",0,0,2,2,"dummy"
"256600",0,0,1,1,"dummy"
"256601",0,0,1,1,"dummy"
"256602",0,0,0,0,"dummy"
"256603",0,0,0,0,"dummy"
"256604",16,27,4,47,"dummy"
"256605",10,0,5,15,"dummy"
"256606",1,1,1,3,"dummy"
"256607",0,0,1,1,"dummy"
"256608",0,0,1,1,"dummy"
"256609",5,3,5,13,"dummy"
"256610",17,13,0,30,"dummy"
"256611",2,0,0,2,"dummy"
"256612",7,9,2,18,"dummy"
"256613",0,0,1,1,"dummy"
"256614",1,1,1,3,"dummy"
"256615",15,8,4,27,"dummy"
"256616",0,0,1,1,"dummy"
"256617",2,1,3,6,"dummy"
"256618",0,1,0,1,"dummy"
"256619",1,0,0,1,"dummy"
"256620",0,1,2,3,"dummy"
"256625",0,43,1,44,"dummy"
"256626",15,33,10,58,"dummy"
"256627",7,10,14,31,"dummy"
"256628",0,1,0,1,"dummy"
"256629",3,0,0,3,"dummy"
"256630",0,1,0,1,"dummy"
"256631",0,0,54,54,"dummy"
"256632",2,2,0,4,"dummy"
"256633",0,0,0,0,"dummy"
"256634",0,2,0,2,"dummy"
"256635",0,9,0,9,"dummy"
"256636",3,3,0,6,"dummy"
"256639",0,2,0,2,"dummy"
"256640",0,0,1,1,"dummy"
"256652",2,0,2,4,"dummy"
"256653",1,3,0,4,"dummy"
"256654",3,1,0,4,"dummy"
"256655",3,0,0,3,"dummy"
"256659",0,0,1,1,"dummy"
"256663",0,0,2,2,"dummy"
"256664",0,9,2,11,"dummy"
"256665",0,0,2,2,"dummy"
"256669",2,6,2,10,"dummy"
"256671",0,0,0,0,"dummy"
"256672",2,1,0,3,"dummy"
"256673",1,1,0,2,"dummy"
"256674",7,0,0,7,"dummy"
"256675",1,0,0,1,"dummy"
"256677",0,0,1,1,"dummy"
"256678",0,0,1,1,"dummy"
"256679",2,2,2,6,"dummy"
"256680",0,0,0,0,"dummy"
"256681",0,0,0,0,"dummy"
"256682",0,0,0,0,"dummy"
"256683",0,0,0,0,"dummy"
"256684",0,0,0,0,"dummy"
"256685",3,1,0,4,"dummy"
"256686",0,0,0,0,"dummy"
"256687",1,12,4,17,"dummy"
"256688",0,0,0,0,"dummy"
"256689",0,1,5,6,"dummy"
"256690",0,1,0,1,"dummy"
"256695",0,0,1,1,"dummy"
"256697",9,0,4,13,"dummy"
"256698",0,0,0,0,"dummy"
"256699",0,0,0,0,"dummy"
"256700",0,1,1,2,"dummy"
"256701",0,4,1,5,"dummy"
"256702",0,1,1,2,"dummy"
"256703",4,2,1,7,"dummy"
"256705",0,6,0,6,"dummy"
"256706",1,0,0,1,"dummy"
"256707",0,1,0,1,"dummy"
"256708",0,0,0,0,"dummy"
"256709",1,1,0,2,"dummy"
"256710",1,1,0,2,"dummy"
"256712",0,0,1,1,"dummy"
"256719",1,0,0,1,"dummy"
"256720",2,12,2,16,"dummy"
"256723",0,0,3,3,"dummy"
"256724",0,0,1,1,"dummy"
"256725",0,0,1,1,"dummy"
"256727",2,1,1,4,"dummy"
"256728",0,0,1,1,"dummy"
"256730",16,15,2,33,"dummy"
"256732",0,2,1,3,"dummy"
"256733",0,0,2,2,"dummy"
"256738",5,0,0,5,"dummy"
"256741",6,3,0,9,"dummy"
"256744",0,1,1,2,"dummy"
"256745",2,3,1,6,"dummy"
"256748",0,0,1,1,"dummy"
"256750",0,1,0,1,"dummy"
"256763",10,7,5,22,"dummy"
"256764",0,2,0,2,"dummy"
"256765",9,16,2,27,"dummy"
"256766",13,15,1,29,"dummy"
"256768",0,2,0,2,"dummy"
"256770",2,0,0,2,"dummy"
"256771",0,0,0,0,"dummy"
"256772",2,0,0,2,"dummy"
"256773",2,0,0,2,"dummy"
"256774",3,0,0,3,"dummy"
"256775",0,0,0,0,"dummy"
"256776",0,1,0,1,"dummy"
"256777",1,6,0,7,"dummy"
"256778",12,7,1,20,"dummy"
"256779",4,0,1,5,"dummy"
"256781",0,0,1,1,"dummy"
"256782",3,9,2,14,"dummy"
"256833",0,1,0,1,"dummy"
"256834",0,3,0,3,"dummy"
"256838",3,1,4,8,"dummy"
"256839",0,3,2,5,"dummy"
"256841",0,2,2,4,"dummy"
"256843",0,0,1,1,"dummy"
"256845",1,0,0,1,"dummy"
"256846",0,0,2,2,"dummy"
"256856",1,1,0,2,"dummy"
"256857",1,1,0,2,"dummy"
"256858",0,3,0,3,"dummy"
"256859",13,8,8,29,"dummy"
"256860",0,0,1,1,"dummy"
"256861",0,0,1,1,"dummy"
"256862",0,1,0,1,"dummy"
"256869",1,0,0,1,"dummy"
"256871",0,0,1,1,"dummy"
"256872",0,0,1,1,"dummy"
"256873",0,1,0,1,"dummy"
"256874",0,1,0,1,"dummy"
"256875",0,0,1,1,"dummy"
"256876",0,2,0,2,"dummy"
"256878",0,0,0,0,"dummy"
"256879",0,0,0,0,"dummy"
"256880",0,0,1,1,"dummy"
"256881",0,0,0,0,"dummy"
"256882",0,0,0,0,"dummy"
"256883",0,0,0,0,"dummy"
"256884",0,0,0,0,"dummy"
"256885",0,0,0,0,"dummy"
"256887",0,1,0,1,"dummy"
"256888",3,0,0,3,"dummy"
"256889",0,4,0,4,"dummy"
"256890",1,0,1,2,"dummy"
"256891",0,2,0,2,"dummy"
"256892",0,0,1,1,"dummy"
"256893",0,2,0,2,"dummy"
"256894",0,0,1,1,"dummy"
"256895",0,2,0,2,"dummy"
"256896",1,2,1,4,"dummy"
"256898",0,1,1,2,"dummy"
"256901",0,1,0,1,"dummy"
"256980",0,0,1,1,"dummy"
"256987",0,1,0,1,"dummy"
"256988",0,6,0,6,"dummy"
"256989",0,1,0,1,"dummy"
"256990",0,1,0,1,"dummy"
"256991",0,3,0,3,"dummy"
"256994",1,0,0,1,"dummy"
"256996",5,2,0,7,"dummy"
"257000",0,0,1,1,"dummy"
"257001",0,0,1,1,"dummy"
"257002",0,0,1,1,"dummy"
"257004",0,1,1,2,"dummy"
"257020",0,2,0,2,"dummy"
"257021",0,2,0,2,"dummy"
"257022",2,1,0,3,"dummy"
"257023",1,2,0,3,"dummy"
"257024",10,2,0,12,"dummy"
"257025",0,0,2,2,"dummy"
"257027",0,0,1,1,"dummy"
"257028",0,0,1,1,"dummy"
"257029",0,0,1,1,"dummy"
"257030",0,0,1,1,"dummy"
"257031",0,0,1,1,"dummy"
"257032",0,0,1,1,"dummy"
"257033",0,0,1,1,"dummy"
"257034",0,0,1,1,"dummy"
"257035",0,0,1,1,"dummy"
"257036",0,0,1,1,"dummy"
"257037",0,0,1,1,"dummy"
"257038",0,0,1,1,"dummy"
"257039",0,0,1,1,"dummy"
"257040",0,0,0,0,"dummy"
"257043",0,1,0,1,"dummy"
"257044",0,1,0,1,"dummy"
"257090",2,0,0,2,"dummy"
"257094",0,0,0,0,"dummy"
"257097",0,0,2,2,"dummy"
"257098",2,0,0,2,"dummy"
"257099",0,4,0,4,"dummy"
"257110",5,13,1,19,"dummy"
"257111",0,0,4,4,"dummy"
"257112",3,4,3,10,"dummy"
"257113",0,1,2,3,"dummy"
"257114",0,5,0,5,"dummy"
"257115",0,1,0,1,"dummy"
"257116",0,0,1,1,"dummy"
"257117",2,0,0,2,"dummy"
"257118",1,1,2,4,"dummy"
"257122",0,2,0,2,"dummy"
"257124",5,7,0,12,"dummy"
"257125",3,1,0,4,"dummy"
"257131",1,1,0,2,"dummy"
"257133",0,16,0,16,"dummy"
"257134",2,1,0,3,"dummy"
"257135",0,3,1,4,"dummy"
"257136",0,10,0,10,"dummy"
"257137",0,3,0,3,"dummy"
"257143",0,1,0,1,"dummy"
"257146",7,0,0,7,"dummy"
"257148",1,1,0,2,"dummy"
"257149",5,0,0,5,"dummy"
"257150",0,0,0,0,"dummy"
"257151",0,0,1,1,"dummy"
"257153",0,0,2,2,"dummy"
"257156",1,0,0,1,"dummy"
"257157",0,0,1,1,"dummy"
"257158",0,2,3,5,"dummy"
"257162",0,0,0,0,"dummy"
"257165",0,0,1,1,"dummy"
"257166",5,0,1,6,"dummy"
"257167",0,0,0,0,"dummy"
"257169",0,1,1,2,"dummy"
"257171",0,2,0,2,"dummy"
"257174",1,0,0,1,"dummy"
"257175",13,11,1,25,"dummy"
"257176",10,1,0,11,"dummy"
"257177",0,0,1,1,"dummy"
"257178",0,0,1,1,"dummy"
"257181",0,3,0,3,"dummy"
"257184",0,0,2,2,"dummy"
"257185",1,1,0,2,"dummy"
"257189",0,13,0,13,"dummy"
"257190",0,1,0,1,"dummy"
"257191",3,3,1,7,"dummy"
"257192",7,1,2,10,"dummy"
"257193",1,2,2,5,"dummy"
"257194",0,1,0,1,"dummy"
"257195",0,2,0,2,"dummy"
"257198",0,1,0,1,"dummy"
"257200",0,1,0,1,"dummy"
"257202",0,15,0,15,"dummy"
"257203",0,0,1,1,"dummy"
"257204",8,0,1,9,"dummy"
"257205",0,0,0,0,"dummy"
"257206",0,4,0,4,"dummy"
"257207",0,5,0,5,"dummy"
"257208",0,0,0,0,"dummy"
"257209",1,2,1,4,"dummy"
"257210",0,0,1,1,"dummy"
"257211",0,1,0,1,"dummy"
"257212",0,0,0,0,"dummy"
"257213",3,5,0,8,"dummy"
"257214",0,0,0,0,"dummy"
"257215",0,0,0,0,"dummy"
"257216",0,0,0,0,"dummy"
"257217",1,1,0,2,"dummy"
"257218",2,0,0,2,"dummy"
"257223",0,1,0,1,"dummy"
"257230",1,0,0,1,"dummy"
"257231",0,1,0,1,"dummy"
"257232",1,0,0,1,"dummy"
"257233",0,0,0,0,"dummy"
"257236",0,0,1,1,"dummy"
"257238",0,17,2,19,"dummy"
"257239",14,1,0,15,"dummy"
"257241",4,13,3,20,"dummy"
"257245",0,0,1,1,"dummy"
"257250",0,0,1,1,"dummy"
"257252",0,0,0,0,"dummy"
"257266",0,0,1,1,"dummy"
"257267",0,0,1,1,"dummy"
"257270",0,1,0,1,"dummy"
"257271",1,2,0,3,"dummy"
"257272",1,1,0,2,"dummy"
"257274",0,2,0,2,"dummy"
"257275",0,3,1,4,"dummy"
"257277",0,2,0,2,"dummy"
"257278",0,0,0,0,"dummy"
"257279",0,0,0,0,"dummy"
"257280",0,11,0,11,"dummy"
"257281",0,0,2,2,"dummy"
"257282",0,0,2,2,"dummy"
"257283",9,24,3,36,"dummy"
"257284",1,1,0,2,"dummy"
"257285",0,1,0,1,"dummy"
"257286",7,0,0,7,"dummy"
"257287",0,0,1,1,"dummy"
"257288",0,0,2,2,"dummy"
"257289",0,0,0,0,"dummy"
"257290",0,0,0,0,"dummy"
"257291",0,2,0,2,"dummy"
"257292",0,0,0,0,"dummy"
"257293",0,0,2,2,"dummy"
"257294",0,0,1,1,"dummy"
"257295",1,4,0,5,"dummy"
"257321",0,2,1,3,"dummy"
"257322",1,0,0,1,"dummy"
"257324",2,4,0,6,"dummy"
"257325",0,2,0,2,"dummy"
"257326",0,2,0,2,"dummy"
"257327",10,2,0,12,"dummy"
"257328",0,2,0,2,"dummy"
"257329",0,0,0,0,"dummy"
"257330",0,0,3,3,"dummy"
"257331",0,5,0,5,"dummy"
"257332",1,0,1,2,"dummy"
"257334",0,3,0,3,"dummy"
"257338",2,8,1,11,"dummy"
"257339",0,1,0,1,"dummy"
"257352",0,3,0,3,"dummy"
"257353",0,2,0,2,"dummy"
"257354",0,1,0,1,"dummy"
"257355",0,5,0,5,"dummy"
"257356",0,0,1,1,"dummy"
"257357",0,1,0,1,"dummy"
"257358",0,1,0,1,"dummy"
"257359",0,1,0,1,"dummy"
"257360",0,0,1,1,"dummy"
"257361",0,0,1,1,"dummy"
"257362",0,0,1,1,"dummy"
"257363",0,0,1,1,"dummy"
"257364",0,1,2,3,"dummy"
"257365",0,1,0,1,"dummy"
"257366",0,1,0,1,"dummy"
"257367",0,1,0,1,"dummy"
"257368",0,0,1,1,"dummy"
"257369",0,1,0,1,"dummy"
"257370",0,1,0,1,"dummy"
"257371",0,1,0,1,"dummy"
"257372",0,1,0,1,"dummy"
"257373",0,1,0,1,"dummy"
"257374",0,1,0,1,"dummy"
"257375",16,21,2,39,"dummy"
"257385",0,0,1,1,"dummy"
"257386",0,2,0,2,"dummy"
"257387",2,0,0,2,"dummy"
"257388",0,3,0,3,"dummy"
"257389",0,0,1,1,"dummy"
"257390",1,0,0,1,"dummy"
"257391",0,0,1,1,"dummy"
"257392",0,1,0,1,"dummy"
"257393",0,1,0,1,"dummy"
"257394",2,2,0,4,"dummy"
"257395",1,2,0,3,"dummy"
"257396",0,0,1,1,"dummy"
"257397",0,0,0,0,"dummy"
"257399",6,10,2,18,"dummy"
"257400",1,2,4,7,"dummy"
"257401",2,2,0,4,"dummy"
"257402",1,2,1,4,"dummy"
"257403",0,0,2,2,"dummy"
"257404",0,0,0,0,"dummy"
"257405",0,0,1,1,"dummy"
"257406",0,4,0,4,"dummy"
"257407",0,3,1,4,"dummy"
"257409",0,0,0,0,"dummy"
"257410",0,1,0,1,"dummy"
"257411",2,1,0,3,"dummy"
"257412",5,10,0,15,"dummy"
"257413",0,2,0,2,"dummy"
"257414",0,0,1,1,"dummy"
"257416",0,0,1,1,"dummy"
"257418",1,0,0,1,"dummy"
"257420",0,0,1,1,"dummy"
"257425",1,0,1,2,"dummy"
"257426",1,0,0,1,"dummy"
"257427",4,1,0,5,"dummy"
"257428",1,4,0,5,"dummy"
"257429",0,0,1,1,"dummy"
"257430",0,1,0,1,"dummy"
"257432",0,1,0,1,"dummy"
"257433",1,2,0,3,"dummy"
"257439",0,1,0,1,"dummy"
"257440",1,1,0,2,"dummy"
"257442",0,2,0,2,"dummy"
"257444",0,0,1,1,"dummy"
"257448",3,2,0,5,"dummy"
"257452",0,2,0,2,"dummy"
"257453",0,1,4,5,"dummy"
"257454",1,0,0,1,"dummy"
"257455",0,0,1,1,"dummy"
"257522",0,0,1,1,"dummy"
"257523",0,7,0,7,"dummy"
"257524",5,0,0,5,"dummy"
"257525",1,13,0,14,"dummy"
"257526",13,6,0,19,"dummy"
"257527",1,13,0,14,"dummy"
"257528",0,0,1,1,"dummy"
"257529",0,5,0,5,"dummy"
"257530",5,0,1,6,"dummy"
"257531",0,0,1,1,"dummy"
"257532",0,0,1,1,"dummy"
"257533",0,5,0,5,"dummy"
"257534",1,1,1,3,"dummy"
"257535",0,0,3,3,"dummy"
"257536",4,5,3,12,"dummy"
"257537",0,0,3,3,"dummy"
"257538",17,16,1,34,"dummy"
"257539",0,0,2,2,"dummy"
"257540",0,0,1,1,"dummy"
"257541",0,0,1,1,"dummy"
"257542",1,0,0,1,"dummy"
"257543",0,0,1,1,"dummy"
"257544",0,0,3,3,"dummy"
"257545",7,4,0,11,"dummy"
"257546",1,3,0,4,"dummy"
"257547",0,0,1,1,"dummy"
"257548",7,1,0,8,"dummy"
"257549",0,0,0,0,"dummy"
"257550",6,8,2,16,"dummy"
"257551",0,0,0,0,"dummy"
"257552",0,0,1,1,"dummy"
"257553",0,0,0,0,"dummy"
"257554",8,6,0,14,"dummy"
"257555",12,12,0,24,"dummy"
"257556",0,0,0,0,"dummy"
"257557",0,1,0,1,"dummy"
"257558",17,17,0,34,"dummy"
"257559",0,0,0,0,"dummy"
"257560",0,0,0,0,"dummy"
"257561",0,0,0,0,"dummy"
"257562",0,3,1,4,"dummy"
"257566",9,12,3,24,"dummy"
"257567",2,3,0,5,"dummy"
"257568",2,2,0,4,"dummy"
"257569",2,2,0,4,"dummy"
"257570",2,2,0,4,"dummy"
"257571",2,2,0,4,"dummy"
"257572",2,2,0,4,"dummy"
"257573",2,2,0,4,"dummy"
"257574",2,4,0,6,"dummy"
"257575",4,2,0,6,"dummy"
"257576",0,3,0,3,"dummy"
"257577",5,12,1,18,"dummy"
"257578",2,2,0,4,"dummy"
"257579",2,2,0,4,"dummy"
"257580",2,0,0,2,"dummy"
"257581",0,3,0,3,"dummy"
"257582",21,0,1,22,"dummy"
"257583",0,3,0,3,"dummy"
"257584",0,1,0,1,"dummy"
"257585",0,18,1,19,"dummy"
"257586",2,0,0,2,"dummy"
"257587",0,0,1,1,"dummy"
"257588",0,0,1,1,"dummy"
"257589",3,0,0,3,"dummy"
"257590",3,3,0,6,"dummy"
"257591",3,3,0,6,"dummy"
"257592",0,1,0,1,"dummy"
"257564",0,0,0,0,"dummy"
"257644",0,2,0,2,"dummy"
"257645",2,0,0,2,"dummy"
"257648",0,0,1,1,"dummy"
"257651",0,0,1,1,"dummy"
"257653",0,1,0,1,"dummy"
"257654",0,3,0,3,"dummy"
"257655",3,1,0,4,"dummy"
"257657",19,1,4,24,"dummy"
"257659",0,3,2,5,"dummy"
"257660",0,0,1,1,"dummy"
"257661",0,4,0,4,"dummy"
"257662",4,9,2,15,"dummy"
"257663",2,0,0,2,"dummy"
"257664",0,2,1,3,"dummy"
"257665",0,0,1,1,"dummy"
"257667",0,0,1,1,"dummy"
"257668",0,1,1,2,"dummy"
"257683",0,0,1,1,"dummy"
"257685",0,0,1,1,"dummy"
"257686",0,0,1,1,"dummy"
"257687",0,0,0,0,"dummy"
"257691",0,0,0,0,"dummy"
"257698",1,1,3,5,"dummy"
"257701",0,0,3,3,"dummy"
"257703",1,0,0,1,"dummy"
"257705",0,6,0,6,"dummy"
"257709",1,0,0,1,"dummy"
"257710",0,0,0,0,"dummy"
"257711",0,1,0,1,"dummy"
"257712",0,0,0,0,"dummy"
"257715",0,0,1,1,"dummy"
"257717",0,0,1,1,"dummy"
"257720",0,4,0,4,"dummy"
"257721",0,7,1,8,"dummy"
"257724",1,0,1,2,"dummy"
"257725",2,3,4,9,"dummy"
"257726",0,1,0,1,"dummy"
"257727",0,2,0,2,"dummy"
"257728",3,6,2,11,"dummy"
"257729",0,1,0,1,"dummy"
"257730",1,4,1,6,"dummy"
"257731",5,4,3,12,"dummy"
"257732",0,1,0,1,"dummy"
"257733",0,1,0,1,"dummy"
"257734",2,0,3,5,"dummy"
"257735",0,1,0,1,"dummy"
"257736",0,2,0,2,"dummy"
"257737",0,1,0,1,"dummy"
"257738",3,0,0,3,"dummy"
"257739",0,3,2,5,"dummy"
"257740",0,0,1,1,"dummy"
"257741",1,3,3,7,"dummy"
"257742",0,1,0,1,"dummy"
"257743",0,2,0,2,"dummy"
"257744",1,4,1,6,"dummy"
"257745",0,0,2,2,"dummy"
"257747",0,1,0,1,"dummy"
"257748",0,0,1,1,"dummy"
"257749",10,6,3,19,"dummy"
"257750",0,2,0,2,"dummy"
"257755",0,0,1,1,"dummy"
"257769",2,16,1,19,"dummy"
"257771",4,15,2,21,"dummy"
"257776",0,0,2,2,"dummy"
"257800",3,10,0,13,"dummy"
"257801",0,1,0,1,"dummy"
"257803",11,1,0,12,"dummy"
"257804",0,2,0,2,"dummy"
"257814",0,0,0,0,"dummy"
"257815",0,0,1,1,"dummy"
"257816",4,2,0,6,"dummy"
"257818",0,0,1,1,"dummy"
"257822",0,2,0,2,"dummy"
"257838",3,1,0,4,"dummy"
"257839",0,0,0,0,"dummy"
"257840",0,4,0,4,"dummy"
"257841",0,1,0,1,"dummy"
"257842",0,2,2,4,"dummy"
"257844",0,3,0,3,"dummy"
"257845",0,5,3,8,"dummy"
"257846",1,6,0,7,"dummy"
"257847",5,1,0,6,"dummy"
"257849",0,0,0,0,"dummy"
"257850",0,1,0,1,"dummy"
"257851",3,1,1,5,"dummy"
"257852",1,3,1,5,"dummy"
"257853",0,0,1,1,"dummy"
"257854",1,0,1,2,"dummy"
"257858",0,1,0,1,"dummy"
"257859",3,1,0,4,"dummy"
"257860",0,1,0,1,"dummy"
"257861",2,0,0,2,"dummy"
"257862",0,0,0,0,"dummy"
"257863",1,0,1,2,"dummy"
"257864",0,1,0,1,"dummy"
"257865",1,0,0,1,"dummy"
"257867",0,2,0,2,"dummy"
"257868",2,2,0,4,"dummy"
"257869",0,0,2,2,"dummy"
"257870",0,0,1,1,"dummy"
"257871",0,0,1,1,"dummy"
"257872",8,8,1,17,"dummy"
"257876",1,0,1,2,"dummy"
"257877",0,0,1,1,"dummy"
"257878",0,1,1,2,"dummy"
"257879",6,6,4,16,"dummy"
"257880",0,0,2,2,"dummy"
"257882",0,0,0,0,"dummy"
"257883",0,0,1,1,"dummy"
"257884",0,2,0,2,"dummy"
"257885",0,0,1,1,"dummy"
"257886",0,0,0,0,"dummy"
"257889",1,3,0,4,"dummy"
"257891",0,0,1,1,"dummy"
"257892",1,0,0,1,"dummy"
"257895",0,1,0,1,"dummy"
"257896",0,5,1,6,"dummy"
"257897",7,9,1,17,"dummy"
"257898",17,5,3,25,"dummy"
"257899",1,2,1,4,"dummy"
"257900",0,0,1,1,"dummy"
"257902",0,1,0,1,"dummy"
"257903",0,3,0,3,"dummy"
"257904",0,1,0,1,"dummy"
"257905",0,1,0,1,"dummy"
"257906",0,3,0,3,"dummy"
"257907",1,0,0,1,"dummy"
"257908",0,2,0,2,"dummy"
"257909",0,0,1,1,"dummy"
"257916",0,0,1,1,"dummy"
"257917",0,0,1,1,"dummy"
"257922",4,0,0,4,"dummy"
"257923",0,0,0,0,"dummy"
"257924",3,0,0,3,"dummy"
"257925",0,1,4,5,"dummy"
"257926",1,0,4,5,"dummy"
"257927",1,0,0,1,"dummy"
"257975",0,0,0,0,"dummy"
"257976",0,2,0,2,"dummy"
"258005",2,2,0,4,"dummy"
"258006",0,1,0,1,"dummy"
"258007",1,0,0,1,"dummy"
"258008",0,7,2,9,"dummy"
"258009",0,1,0,1,"dummy"
"258010",0,0,3,3,"dummy"
"258011",12,1,2,15,"dummy"
"258023",1,0,0,1,"dummy"
"258024",0,1,0,1,"dummy"
"258025",1,0,1,2,"dummy"
"258026",0,1,0,1,"dummy"
"258027",0,1,0,1,"dummy"
"258028",0,0,3,3,"dummy"
"258029",0,1,0,1,"dummy"
"258030",0,0,1,1,"dummy"
"258031",0,1,0,1,"dummy"
"258032",1,1,0,2,"dummy"
"258033",1,2,0,3,"dummy"
"258034",14,12,1,27,"dummy"
"258035",8,8,0,16,"dummy"
"258036",0,2,0,2,"dummy"
"258037",1,4,0,5,"dummy"
"258038",0,1,0,1,"dummy"
"258075",0,1,0,1,"dummy"
"258076",0,1,0,1,"dummy"
"258079",0,1,0,1,"dummy"
"258150",2,7,1,10,"dummy"
"258151",0,0,0,0,"dummy"
"258152",1,1,2,4,"dummy"
"258153",0,1,0,1,"dummy"
"258156",0,4,0,4,"dummy"
"258157",4,0,0,4,"dummy"
"258158",0,4,0,4,"dummy"
"258159",0,0,2,2,"dummy"
"258160",2,3,0,5,"dummy"
"258161",2,0,0,2,"dummy"
"258162",3,2,2,7,"dummy"
"258163",0,2,0,2,"dummy"
"258164",0,0,2,2,"dummy"
"258165",0,1,0,1,"dummy"
"258166",4,8,2,14,"dummy"
"258167",0,1,0,1,"dummy"
"258168",0,2,0,2,"dummy"
"258169",0,1,0,1,"dummy"
"258170",22,54,3,79,"dummy"
"258171",0,4,0,4,"dummy"
"258172",0,0,1,1,"dummy"
"258173",5,5,0,10,"dummy"
"258174",0,3,0,3,"dummy"
"258175",7,8,0,15,"dummy"
"258176",3,3,0,6,"dummy"
"258177",3,3,0,6,"dummy"
"258178",4,4,0,8,"dummy"
"258179",3,3,0,6,"dummy"
"258180",7,7,0,14,"dummy"
"258181",8,8,0,16,"dummy"
"258182",6,0,3,9,"dummy"
"258183",20,3,0,23,"dummy"
"258184",1,2,0,3,"dummy"
"258185",0,5,0,5,"dummy"
"258186",0,0,1,1,"dummy"
"258187",0,1,0,1,"dummy"
"258191",0,1,0,1,"dummy"
"257919",4,4,0,8,"dummy"
"257920",0,0,0,0,"dummy"
"257964",0,17,0,17,"dummy"
"257967",4,19,0,23,"dummy"
"257968",9,10,0,19,"dummy"
"257969",0,0,3,3,"dummy"
"257970",0,0,1,1,"dummy"
"257971",0,0,1,1,"dummy"
"257972",0,0,1,1,"dummy"
"257973",0,0,1,1,"dummy"
"257993",0,1,0,1,"dummy"
"258000",0,3,0,3,"dummy"
"258001",2,4,0,6,"dummy"
"258019",0,0,1,1,"dummy"
"258020",0,0,1,1,"dummy"
"258021",0,0,1,1,"dummy"
"258040",0,3,1,4,"dummy"
"258041",0,0,1,1,"dummy"
"258042",0,0,1,1,"dummy"
"258043",8,5,0,13,"dummy"
"258044",0,0,1,1,"dummy"
"258045",2,6,0,8,"dummy"
"258046",8,1,1,10,"dummy"
"258047",3,32,0,35,"dummy"
"258048",5,5,0,10,"dummy"
"258049",1,0,0,1,"dummy"
"258050",0,0,2,2,"dummy"
"258051",1,19,1,21,"dummy"
"258052",0,2,1,3,"dummy"
"258053",0,2,12,14,"dummy"
"258054",26,7,0,33,"dummy"
"258055",5,7,3,15,"dummy"
"258056",2,0,0,2,"dummy"
"258057",0,3,0,3,"dummy"
"258058",0,0,0,0,"dummy"
"258059",0,0,0,0,"dummy"
"258060",2,0,0,2,"dummy"
"258061",0,0,0,0,"dummy"
"258062",0,3,0,3,"dummy"
"258063",0,1,0,1,"dummy"
"258064",0,0,0,0,"dummy"
"258065",0,0,0,0,"dummy"
"258066",0,3,0,3,"dummy"
"258067",0,0,0,0,"dummy"
"258068",0,0,1,1,"dummy"
"258069",0,0,0,0,"dummy"
"258070",0,0,1,1,"dummy"
"258071",0,3,0,3,"dummy"
"258072",14,4,0,18,"dummy"
"258073",0,0,1,1,"dummy"
"258103",0,0,1,1,"dummy"
"258106",5,4,1,10,"dummy"
"258107",0,0,1,1,"dummy"
"258108",0,1,0,1,"dummy"
"258109",0,0,1,1,"dummy"
"258110",0,0,1,1,"dummy"
"258113",0,1,0,1,"dummy"
"258114",1,0,0,1,"dummy"
"258115",0,3,0,3,"dummy"
"258116",0,2,0,2,"dummy"
"258117",3,1,0,4,"dummy"
"258118",0,1,0,1,"dummy"
"258119",0,2,0,2,"dummy"
"258120",6,2,0,8,"dummy"
"258121",0,2,0,2,"dummy"
"258122",0,0,2,2,"dummy"
"258123",0,0,2,2,"dummy"
"258129",1,3,0,4,"dummy"
"258130",3,8,6,17,"dummy"
"258131",15,0,3,18,"dummy"
"258132",0,0,0,0,"dummy"
"258133",0,2,0,2,"dummy"
"258134",0,1,0,1,"dummy"
"258135",0,1,0,1,"dummy"
"258136",3,1,0,4,"dummy"
"258137",0,0,1,1,"dummy"
"258138",0,1,0,1,"dummy"
"258139",20,25,3,48,"dummy"
"258140",9,6,2,17,"dummy"
"258141",12,5,0,17,"dummy"
"258142",2,0,1,3,"dummy"
"258143",5,0,0,5,"dummy"
"258144",0,0,5,5,"dummy"
"258145",0,0,1,1,"dummy"
"258146",0,0,1,1,"dummy"
"258189",2,2,2,6,"dummy"
"258193",0,0,0,0,"dummy"
"258194",1,3,2,6,"dummy"
"258195",0,21,0,21,"dummy"
"258196",0,2,0,2,"dummy"
"258197",2,3,0,5,"dummy"
"258198",0,2,0,2,"dummy"
"258199",5,7,0,12,"dummy"
"258200",0,14,0,14,"dummy"
"258201",2,1,0,3,"dummy"
"258202",0,2,0,2,"dummy"
"258203",2,3,1,6,"dummy"
"258204",3,3,0,6,"dummy"
"258205",1,2,0,3,"dummy"
"258206",0,0,3,3,"dummy"
"258207",7,7,1,15,"dummy"
"258208",2,12,0,14,"dummy"
"258209",8,0,2,10,"dummy"
"258210",0,0,0,0,"dummy"
"258211",2,0,0,2,"dummy"
"258212",0,0,0,0,"dummy"
"258213",3,0,0,3,"dummy"
"258214",0,0,0,0,"dummy"
"258215",13,0,0,13,"dummy"
"258216",1,10,2,13,"dummy"
"258217",5,5,0,10,"dummy"
"258218",14,23,4,41,"dummy"
"258219",2,0,0,2,"dummy"
"258220",1,6,0,7,"dummy"
"258221",0,1,0,1,"dummy"
"258224",1,11,0,12,"dummy"
"258225",0,1,0,1,"dummy"
"258226",0,13,0,13,"dummy"
"258227",4,8,2,14,"dummy"
"258228",0,5,0,5,"dummy"
"258229",0,1,0,1,"dummy"
"258230",0,3,0,3,"dummy"
"258231",0,1,0,1,"dummy"
"258232",1,4,0,5,"dummy"
"258233",0,3,1,4,"dummy"
"258237",1,2,0,3,"dummy"
"258245",0,2,0,2,"dummy"
"258246",0,5,0,5,"dummy"
"258247",4,0,0,4,"dummy"
"258248",0,0,0,0,"dummy"
"258251",2,0,2,4,"dummy"
"258252",0,0,0,0,"dummy"
"258253",0,2,0,2,"dummy"
"258259",0,1,0,1,"dummy"
"258305",0,0,2,2,"dummy"
"258306",0,4,0,4,"dummy"
"258307",0,1,0,1,"dummy"
"258308",0,0,0,0,"dummy"
"258329",0,0,4,4,"dummy"
"258330",0,1,2,3,"dummy"
"258331",0,2,1,3,"dummy"
"258332",2,1,1,4,"dummy"
"258333",0,2,1,3,"dummy"
"258334",0,2,0,2,"dummy"
"258335",12,4,4,20,"dummy"
"258235",0,2,0,2,"dummy"
"258241",2,0,0,2,"dummy"
"258255",1,2,0,3,"dummy"
"258256",0,2,2,4,"dummy"
"258257",0,1,0,1,"dummy"
"258284",12,10,4,26,"dummy"
"258285",7,0,0,7,"dummy"
"258286",0,0,1,1,"dummy"
"258287",0,0,0,0,"dummy"
"258288",0,0,0,0,"dummy"
"258296",0,6,2,8,"dummy"
"258297",0,1,0,1,"dummy"
"258298",0,0,4,4,"dummy"
"258299",0,1,0,1,"dummy"
"258300",0,0,1,1,"dummy"
"258301",0,0,1,1,"dummy"
"258302",0,0,1,1,"dummy"
"258303",0,0,1,1,"dummy"
"258317",41,4,0,45,"dummy"
"258318",3,5,0,8,"dummy"
"258319",0,2,1,3,"dummy"
"258322",0,0,0,0,"dummy"
"258323",2,0,0,2,"dummy"
"258324",0,0,0,0,"dummy"
"258325",0,0,0,0,"dummy"
"258341",1,9,1,11,"dummy"
"258342",0,5,0,5,"dummy"
"258343",8,1,1,10,"dummy"
"258346",2,6,0,8,"dummy"
"258347",1,1,2,4,"dummy"
"258348",0,5,0,5,"dummy"
"258349",1,7,3,11,"dummy"
"258350",0,0,1,1,"dummy"
"258381",2,0,1,3,"dummy"
"258382",0,3,1,4,"dummy"
"258383",0,0,1,1,"dummy"
"258384",1,0,0,1,"dummy"
"258385",0,1,0,1,"dummy"
"258386",0,0,1,1,"dummy"
"258387",1,3,0,4,"dummy"
"258388",0,0,0,0,"dummy"
"258389",0,0,0,0,"dummy"
"258390",0,0,0,0,"dummy"
"258391",0,0,0,0,"dummy"
"258394",0,0,0,0,"dummy"
"258395",0,0,0,0,"dummy"
"258398",0,0,1,1,"dummy"
"258399",1,1,1,3,"dummy"
"258400",2,0,0,2,"dummy"
"258401",7,2,3,12,"dummy"
"258402",2,4,0,6,"dummy"
"258403",1,0,3,4,"dummy"
"258404",0,0,4,4,"dummy"
"258405",0,3,0,3,"dummy"
"258406",0,0,3,3,"dummy"
"258409",0,1,0,1,"dummy"
"258410",0,0,1,1,"dummy"
"258414",0,1,0,1,"dummy"
"258415",2,2,0,4,"dummy"
"258416",0,0,1,1,"dummy"
"258424",0,0,1,1,"dummy"
"258425",0,1,0,1,"dummy"
"258426",0,2,0,2,"dummy"
"258427",2,1,0,3,"dummy"
"258428",0,2,0,2,"dummy"
"258431",0,13,0,13,"dummy"
"258432",0,11,1,12,"dummy"
"258464",0,2,0,2,"dummy"
"258465",2,5,0,7,"dummy"
"258466",4,19,1,24,"dummy"
"258467",2,0,0,2,"dummy"
"258468",3,9,1,13,"dummy"
"258469",18,2,1,21,"dummy"
"258470",0,0,7,7,"dummy"
"258471",0,1,0,1,"dummy"
"258472",0,0,0,0,"dummy"
"258336",8,0,2,10,"dummy"
"258337",0,3,0,3,"dummy"
"258338",2,2,0,4,"dummy"
"258339",0,3,0,3,"dummy"
"258412",0,0,0,0,"dummy"
"258418",0,2,0,2,"dummy"
"258419",0,17,1,18,"dummy"
"258420",19,19,2,40,"dummy"
"258421",1,3,0,4,"dummy"
"258422",0,1,0,1,"dummy"
"258434",4,0,0,4,"dummy"
"258449",18,32,1,51,"dummy"
"258450",9,4,0,13,"dummy"
"258451",3,12,0,15,"dummy"
"258452",41,25,5,71,"dummy"
"258519",0,2,2,4,"dummy"
"258520",0,0,1,1,"dummy"
"258523",0,0,1,1,"dummy"
"258524",0,0,1,1,"dummy"
"258525",0,0,1,1,"dummy"
"258526",0,0,1,1,"dummy"
"258527",0,0,1,1,"dummy"
"258532",1,1,0,2,"dummy"
"258533",0,1,0,1,"dummy"
"258566",0,10,0,10,"dummy"
"258569",2,3,2,7,"dummy"
"258570",1,2,0,3,"dummy"
"258571",0,0,0,0,"dummy"
"258572",0,0,0,0,"dummy"
"258573",0,0,0,0,"dummy"
"258574",0,0,0,0,"dummy"
"258575",3,0,0,3,"dummy"
"258576",0,0,0,0,"dummy"
"258579",0,1,0,1,"dummy"
"258580",0,1,0,1,"dummy"
"258581",2,0,0,2,"dummy"
"258582",0,0,1,1,"dummy"
"258583",0,0,1,1,"dummy"
"258584",1,0,0,1,"dummy"
"258585",0,0,1,1,"dummy"
"258586",0,0,1,1,"dummy"
"258587",0,0,1,1,"dummy"
"258599",3,2,1,6,"dummy"
"258609",0,2,0,2,"dummy"
"258610",1,2,1,4,"dummy"
"258611",0,1,1,2,"dummy"
"258622",0,0,0,0,"dummy"
"258623",0,0,0,0,"dummy"
"258624",2,0,1,3,"dummy"
"258627",10,18,5,33,"dummy"
"258628",18,10,5,33,"dummy"
"258629",10,18,5,33,"dummy"
"258630",19,15,5,39,"dummy"
"258631",3,3,1,7,"dummy"
"258632",13,17,6,36,"dummy"
"258633",18,10,5,33,"dummy"
"258634",10,18,5,33,"dummy"
"258635",18,10,5,33,"dummy"
"258636",14,50,5,69,"dummy"
"258637",45,12,5,62,"dummy"
"258638",0,0,2,2,"dummy"
"258639",0,1,0,1,"dummy"
"258640",12,17,6,35,"dummy"
"258641",18,11,6,35,"dummy"
"258642",1,0,3,4,"dummy"
"258643",0,0,1,1,"dummy"
"258644",0,0,1,1,"dummy"
"258473",2,0,1,3,"dummy"
"258474",0,7,0,7,"dummy"
"258475",0,1,0,1,"dummy"
"258476",0,0,2,2,"dummy"
"258479",0,0,0,0,"dummy"
"258480",0,0,0,0,"dummy"
"258481",0,0,0,0,"dummy"
"258482",0,0,0,0,"dummy"
"258483",0,0,0,0,"dummy"
"258513",0,0,0,0,"dummy"
"258514",0,0,0,0,"dummy"
"258515",0,0,0,0,"dummy"
"258516",0,0,0,0,"dummy"
"258517",0,0,0,0,"dummy"
"258529",0,1,0,1,"dummy"
"258530",27,3,3,33,"dummy"
"258535",0,2,1,3,"dummy"
"258538",1,11,0,12,"dummy"
"258539",0,2,1,3,"dummy"
"258540",0,0,3,3,"dummy"
"258541",0,2,0,2,"dummy"
"258542",1,0,0,1,"dummy"
"258543",4,1,0,5,"dummy"
"258544",0,0,1,1,"dummy"
"258545",0,1,0,1,"dummy"
"258546",0,0,0,0,"dummy"
"258547",0,0,1,1,"dummy"
"258591",0,0,1,1,"dummy"
"258597",0,0,2,2,"dummy"
"258605",0,1,0,1,"dummy"
"258613",2,0,0,2,"dummy"
"258616",0,0,0,0,"dummy"
"258619",0,1,0,1,"dummy"
"258620",0,0,2,2,"dummy"
"258665",1,0,1,2,"dummy"
"258666",3,1,1,5,"dummy"
"258667",0,4,2,6,"dummy"
"258668",0,1,0,1,"dummy"
"258669",2,10,0,12,"dummy"
"258672",0,0,1,1,"dummy"
"258673",0,5,1,6,"dummy"
"258674",1,0,0,1,"dummy"
"258678",0,1,0,1,"dummy"
"258700",1,0,1,2,"dummy"
"258701",0,0,2,2,"dummy"
"258702",0,1,0,1,"dummy"
"258703",0,0,0,0,"dummy"
"258704",1,0,0,1,"dummy"
"258705",0,0,2,2,"dummy"
"258706",0,0,3,3,"dummy"
"258707",0,1,0,1,"dummy"
"258708",0,1,2,3,"dummy"
"258722",2,0,0,2,"dummy"
"258734",0,1,0,1,"dummy"
"258735",0,1,0,1,"dummy"
"258736",1,0,0,1,"dummy"
"258740",3,7,6,16,"dummy"
"258743",0,0,1,1,"dummy"
"258764",0,1,0,1,"dummy"
"258645",0,1,1,2,"dummy"
"258646",1,0,1,2,"dummy"
"258647",0,0,1,1,"dummy"
"258648",0,0,1,1,"dummy"
"258649",10,7,2,19,"dummy"
"258650",7,10,5,22,"dummy"
"258651",0,0,0,0,"dummy"
"258652",0,0,0,0,"dummy"
"258657",1,3,0,4,"dummy"
"258658",0,2,1,3,"dummy"
"258659",0,1,0,1,"dummy"
"258660",19,9,1,29,"dummy"
"258661",0,1,0,1,"dummy"
"258662",1,3,0,4,"dummy"
"258663",0,0,0,0,"dummy"
"258676",0,0,1,1,"dummy"
"258684",2,2,0,4,"dummy"
"258697",0,1,0,1,"dummy"
"258698",0,1,0,1,"dummy"
"258710",0,0,1,1,"dummy"
"258711",6,5,4,15,"dummy"
"258712",0,0,0,0,"dummy"
"258713",0,0,0,0,"dummy"
"258720",0,0,2,2,"dummy"
"258724",0,0,0,0,"dummy"
"258725",0,0,1,1,"dummy"
"258726",3,0,0,3,"dummy"
"258727",0,1,1,2,"dummy"
"258728",0,0,1,1,"dummy"
"258729",0,1,0,1,"dummy"
"258730",0,0,0,0,"dummy"
"258731",0,0,1,1,"dummy"
"258732",0,2,0,2,"dummy"
"258738",0,0,0,0,"dummy"
"258745",0,0,1,1,"dummy"
"258762",0,2,0,2,"dummy"
"258787",1,0,0,1,"dummy"
"258796",0,0,1,1,"dummy"
"258805",0,3,0,3,"dummy"
"258806",0,8,1,9,"dummy"
"258807",0,0,1,1,"dummy"
"258808",3,0,0,3,"dummy"
"258809",0,0,0,0,"dummy"
"258810",0,3,0,3,"dummy"
"258811",0,0,0,0,"dummy"
"258812",0,1,2,3,"dummy"
"258813",9,3,1,13,"dummy"
"258814",8,20,4,32,"dummy"
"258817",0,1,0,1,"dummy"
"258818",0,4,0,4,"dummy"
"258819",4,5,0,9,"dummy"
"258828",0,2,0,2,"dummy"
"258829",0,1,0,1,"dummy"
"258830",0,1,0,1,"dummy"
"258831",0,0,1,1,"dummy"
"258832",0,0,1,1,"dummy"
"258833",0,0,1,1,"dummy"
"258834",0,0,1,1,"dummy"
"258837",0,0,1,1,"dummy"
"258849",23,23,0,46,"dummy"
"258850",2,0,0,2,"dummy"
"258853",5,15,3,23,"dummy"
"258879",6,15,1,22,"dummy"
"258880",3,2,1,6,"dummy"
"258881",0,0,1,1,"dummy"
"258885",4,8,0,12,"dummy"
"258886",2,2,1,5,"dummy"
"258887",2,0,0,2,"dummy"
"258888",0,3,0,3,"dummy"
"258769",0,0,0,0,"dummy"
"258770",0,5,0,5,"dummy"
"258771",0,0,0,0,"dummy"
"258772",0,1,0,1,"dummy"
"258785",3,0,1,4,"dummy"
"258789",0,6,0,6,"dummy"
"258790",0,0,1,1,"dummy"
"258791",0,0,2,2,"dummy"
"258794",0,0,1,1,"dummy"
"258798",1,0,0,1,"dummy"
"258799",0,1,1,2,"dummy"
"258821",0,2,0,2,"dummy"
"258822",0,1,3,4,"dummy"
"258823",0,0,0,0,"dummy"
"258824",3,0,2,5,"dummy"
"258839",0,1,0,1,"dummy"
"258840",1,0,0,1,"dummy"
"258841",0,1,0,1,"dummy"
"258842",1,0,0,1,"dummy"
"258843",0,1,0,1,"dummy"
"258844",1,0,0,1,"dummy"
"258847",0,1,0,1,"dummy"
"258855",0,1,0,1,"dummy"
"258856",0,1,0,1,"dummy"
"258857",0,1,0,1,"dummy"
"258858",0,2,2,4,"dummy"
"258859",2,0,2,4,"dummy"
"258860",0,0,1,1,"dummy"
"258861",0,1,0,1,"dummy"
"258862",0,2,0,2,"dummy"
"258863",0,2,1,3,"dummy"
"258864",2,2,0,4,"dummy"
"258865",0,0,1,1,"dummy"
"258866",0,0,0,0,"dummy"
"258867",2,2,0,4,"dummy"
"258868",0,0,0,0,"dummy"
"258871",1,0,0,1,"dummy"
"258872",0,0,1,1,"dummy"
"258873",0,0,1,1,"dummy"
"258874",0,0,1,1,"dummy"
"258875",0,0,1,1,"dummy"
"258883",0,0,0,0,"dummy"
"258898",0,1,0,1,"dummy"
"258899",9,1,0,10,"dummy"
"258900",14,1,1,16,"dummy"
"258907",1,1,2,4,"dummy"
"258910",0,1,0,1,"dummy"
"258911",0,21,0,21,"dummy"
"258912",1,3,0,4,"dummy"
"258913",2,8,2,12,"dummy"
"258914",3,2,1,6,"dummy"
"258915",10,7,0,17,"dummy"
"258916",10,0,0,10,"dummy"
"258917",2,0,1,3,"dummy"
"258946",1,1,1,3,"dummy"
"258958",1,0,0,1,"dummy"
"258959",0,1,0,1,"dummy"
"258960",0,0,1,1,"dummy"
"258889",1,4,3,8,"dummy"
"258890",0,0,1,1,"dummy"
"258891",1,1,0,2,"dummy"
"258892",5,1,1,7,"dummy"
"258893",0,2,0,2,"dummy"
"258894",0,13,1,14,"dummy"
"258895",1,2,2,5,"dummy"
"258896",0,2,0,2,"dummy"
"258902",0,0,1,1,"dummy"
"258903",0,0,1,1,"dummy"
"258904",0,0,1,1,"dummy"
"258905",0,0,1,1,"dummy"
"258919",0,1,0,1,"dummy"
"258920",0,2,3,5,"dummy"
"258921",0,5,0,5,"dummy"
"258922",0,1,0,1,"dummy"
"258923",8,8,0,16,"dummy"
"258924",1,0,0,1,"dummy"
"258925",0,1,0,1,"dummy"
"258926",0,1,0,1,"dummy"
"258927",3,3,0,6,"dummy"
"258928",1,0,0,1,"dummy"
"258929",0,2,0,2,"dummy"
"258930",5,0,3,8,"dummy"
"258931",0,1,0,1,"dummy"
"258950",0,1,0,1,"dummy"
"258951",0,2,0,2,"dummy"
"258952",0,3,0,3,"dummy"
"258953",0,0,1,1,"dummy"
"258954",2,2,0,4,"dummy"
"258955",0,0,1,1,"dummy"
"258956",0,0,1,1,"dummy"
"258964",0,0,1,1,"dummy"
"258965",0,0,0,0,"dummy"
"258966",0,3,0,3,"dummy"
"258967",4,4,0,8,"dummy"
"258968",4,2,0,6,"dummy"
"258969",0,3,0,3,"dummy"
"258971",0,2,0,2,"dummy"
"258972",0,1,0,1,"dummy"
"258974",0,0,0,0,"dummy"
"258976",0,1,0,1,"dummy"
"258977",0,1,0,1,"dummy"
"258978",0,1,0,1,"dummy"
"258981",0,0,0,0,"dummy"
"258982",0,0,0,0,"dummy"
"258983",0,1,0,1,"dummy"
"258984",0,0,0,0,"dummy"
"258985",2,2,0,4,"dummy"
"258988",0,0,0,0,"dummy"
"258990",0,6,2,8,"dummy"
"258991",2,5,0,7,"dummy"
"259003",0,1,1,2,"dummy"
"259004",0,0,1,1,"dummy"
"259005",0,0,1,1,"dummy"
"259006",0,0,0,0,"dummy"
"259008",0,1,0,1,"dummy"
"259009",0,1,0,1,"dummy"
"259010",0,1,0,1,"dummy"
"259011",0,1,0,1,"dummy"
"259012",6,3,0,9,"dummy"
"259013",0,1,0,1,"dummy"
"259014",0,1,0,1,"dummy"
"259016",0,0,1,1,"dummy"
"259017",0,5,0,5,"dummy"
"259018",0,3,0,3,"dummy"
"259019",0,1,0,1,"dummy"
"259020",0,1,0,1,"dummy"
"259021",1,0,0,1,"dummy"
"259022",0,0,1,1,"dummy"
"259023",1,0,1,2,"dummy"
"259026",1,3,0,4,"dummy"
"259027",0,1,1,2,"dummy"
"259028",0,2,0,2,"dummy"
"259031",1,8,0,9,"dummy"
"259032",3,10,1,14,"dummy"
"259033",2,0,1,3,"dummy"
"259035",1,6,0,7,"dummy"
"259036",0,1,0,1,"dummy"
"259037",0,2,0,2,"dummy"
"259044",0,0,1,1,"dummy"
"259045",0,2,0,2,"dummy"
"259046",1,0,0,1,"dummy"
"259047",1,1,0,2,"dummy"
"259052",0,0,0,0,"dummy"
"259079",2,2,1,5,"dummy"
"259080",3,12,1,16,"dummy"
"259081",1,1,0,2,"dummy"
"259082",0,0,3,3,"dummy"
"259083",0,1,0,1,"dummy"
"259086",0,7,1,8,"dummy"
"259087",0,5,0,5,"dummy"
"259088",0,0,0,0,"dummy"
"259089",0,1,0,1,"dummy"
"259091",5,3,0,8,"dummy"
"259092",2,4,1,7,"dummy"
"259094",2,2,1,5,"dummy"
"259095",2,4,2,8,"dummy"
"259096",6,4,1,11,"dummy"
"259099",2,0,3,5,"dummy"
"259103",1,1,1,3,"dummy"
"259104",1,1,4,6,"dummy"
"259112",0,4,0,4,"dummy"
"259113",0,2,0,2,"dummy"
"259117",0,0,0,0,"dummy"
"259118",0,0,1,1,"dummy"
"259121",0,3,0,3,"dummy"
"259125",2,0,0,2,"dummy"
"259126",0,6,2,8,"dummy"
"259127",1,10,0,11,"dummy"
"259128",0,10,1,11,"dummy"
"259131",0,0,1,1,"dummy"
"259132",1,0,0,1,"dummy"
"259133",0,1,0,1,"dummy"
"259134",0,0,2,2,"dummy"
"259139",0,2,0,2,"dummy"
"259140",1,1,1,3,"dummy"
"259141",0,2,0,2,"dummy"
"259142",0,2,0,2,"dummy"
"259143",0,1,1,2,"dummy"
"259144",0,1,0,1,"dummy"
"259145",0,0,1,1,"dummy"
"259146",2,1,4,7,"dummy"
"259148",0,1,0,1,"dummy"
"259149",0,1,0,1,"dummy"
"259152",0,6,0,6,"dummy"
"259153",7,2,0,9,"dummy"
"259155",2,3,1,6,"dummy"
"259156",0,0,1,1,"dummy"
"259157",2,2,2,6,"dummy"
"259158",0,0,1,1,"dummy"
"259159",0,0,1,1,"dummy"
"259163",0,1,0,1,"dummy"
"259168",0,0,1,1,"dummy"
"259169",0,0,1,1,"dummy"
"259170",0,0,1,1,"dummy"
"259171",0,0,3,3,"dummy"
"259172",0,0,1,1,"dummy"
"259173",2,6,0,8,"dummy"
"259174",1,3,0,4,"dummy"
"259175",2,2,0,4,"dummy"
"259176",5,1,0,6,"dummy"
"259177",0,0,2,2,"dummy"
"259178",0,0,1,1,"dummy"
"259179",0,0,0,0,"dummy"
"259180",0,0,0,0,"dummy"
"259181",0,0,1,1,"dummy"
"259182",0,0,0,0,"dummy"
"259183",0,0,0,0,"dummy"
"259184",0,0,0,0,"dummy"
"259185",0,3,1,4,"dummy"
"259187",1,0,2,3,"dummy"
"259188",0,1,2,3,"dummy"
"259189",0,1,0,1,"dummy"
"259190",0,0,0,0,"dummy"
"259191",0,0,1,1,"dummy"
"259192",0,0,3,3,"dummy"
"259193",0,0,3,3,"dummy"
"259194",0,0,4,4,"dummy"
"259195",2,3,1,6,"dummy"
"259199",0,11,2,13,"dummy"
"259200",4,7,0,11,"dummy"
"259201",5,0,0,5,"dummy"
"259202",0,0,0,0,"dummy"
"259203",0,0,0,0,"dummy"
"259204",1,0,0,1,"dummy"
"259205",1,1,2,4,"dummy"
"259206",6,16,0,22,"dummy"
"259207",0,0,1,1,"dummy"
"259208",4,1,0,5,"dummy"
"259209",12,17,0,29,"dummy"
"259210",0,3,1,4,"dummy"
"259212",0,1,0,1,"dummy"
"259213",0,0,1,1,"dummy"
"259217",1,0,0,1,"dummy"
"259221",2,10,0,12,"dummy"
"259222",9,11,0,20,"dummy"
"259223",0,1,0,1,"dummy"
"259224",0,1,1,2,"dummy"
"259225",0,1,3,4,"dummy"
"259227",0,2,0,2,"dummy"
"259228",1,0,0,1,"dummy"
"259229",0,5,0,5,"dummy"
"259230",0,0,1,1,"dummy"
"259231",0,1,0,1,"dummy"
"259232",2,0,1,3,"dummy"
"259233",1,3,0,4,"dummy"
"259235",0,0,0,0,"dummy"
"259236",0,21,0,21,"dummy"
"259237",2,1,2,5,"dummy"
"259238",0,2,1,3,"dummy"
"259239",0,0,0,0,"dummy"
"259240",0,1,0,1,"dummy"
"259241",3,0,0,3,"dummy"
"259242",0,1,0,1,"dummy"
"259243",5,1,2,8,"dummy"
"259244",0,1,0,1,"dummy"
"259245",0,1,0,1,"dummy"
"259246",1,4,2,7,"dummy"
"259247",0,0,0,0,"dummy"
"259248",3,1,0,4,"dummy"
"259249",1,0,0,1,"dummy"
"259250",0,1,0,1,"dummy"
"259251",0,0,0,0,"dummy"
"259252",1,0,0,1,"dummy"
"259253",0,2,0,2,"dummy"
"259254",0,2,0,2,"dummy"
"259255",0,1,0,1,"dummy"
"259256",2,4,1,7,"dummy"
"259257",0,3,0,3,"dummy"
"259258",0,2,0,2,"dummy"
"259259",2,1,0,3,"dummy"
"259260",0,2,0,2,"dummy"
"259261",0,0,2,2,"dummy"
"259262",4,5,2,11,"dummy"
"259263",0,0,2,2,"dummy"
"259264",0,3,0,3,"dummy"
"259265",4,1,2,7,"dummy"
"259266",1,3,0,4,"dummy"
"259267",4,2,3,9,"dummy"
"259268",0,3,0,3,"dummy"
"259269",0,1,0,1,"dummy"
"259270",1,0,0,1,"dummy"
"259271",1,3,2,6,"dummy"
"259272",0,0,1,1,"dummy"
"259273",3,5,0,8,"dummy"
"259274",0,0,2,2,"dummy"
"259275",5,5,0,10,"dummy"
"259276",27,3,0,30,"dummy"
"259277",0,1,0,1,"dummy"
"259278",0,1,1,2,"dummy"
"259279",0,2,0,2,"dummy"
"259280",0,0,0,0,"dummy"
"259281",5,5,0,10,"dummy"
"259282",23,12,2,37,"dummy"
"259283",0,1,0,1,"dummy"
"259284",0,1,0,1,"dummy"
"259285",0,0,2,2,"dummy"
"259287",0,5,2,7,"dummy"
"259290",0,1,0,1,"dummy"
"259291",1,0,2,3,"dummy"
"259292",1,0,1,2,"dummy"
"259293",0,1,2,3,"dummy"
"259294",0,1,1,2,"dummy"
"259295",1,0,0,1,"dummy"
"259296",0,9,2,11,"dummy"
"259297",1,2,0,3,"dummy"
"259298",0,3,0,3,"dummy"
"259299",0,2,0,2,"dummy"
"259300",1,0,0,1,"dummy"
"259301",15,1,1,17,"dummy"
"259302",0,1,0,1,"dummy"
"259303",1,0,0,1,"dummy"
"259304",1,5,2,8,"dummy"
"259305",0,0,3,3,"dummy"
"259306",0,1,2,3,"dummy"
"259307",0,1,0,1,"dummy"
"259308",3,1,0,4,"dummy"
"259309",5,1,3,9,"dummy"
"259310",0,0,1,1,"dummy"
"259311",0,1,0,1,"dummy"
"259312",3,0,0,3,"dummy"
"259313",0,7,0,7,"dummy"
"259314",2,2,0,4,"dummy"
"259315",3,7,2,12,"dummy"
"259316",0,0,1,1,"dummy"
"259317",5,1,2,8,"dummy"
"259318",0,0,1,1,"dummy"
"259319",0,1,0,1,"dummy"
"259320",0,0,1,1,"dummy"
"259321",0,0,1,1,"dummy"
"259322",0,0,1,1,"dummy"
"259323",1,0,0,1,"dummy"
"259324",0,1,1,2,"dummy"
"259325",0,0,2,2,"dummy"
"259326",0,0,1,1,"dummy"
"259327",0,0,0,0,"dummy"
"259328",0,0,1,1,"dummy"
"259329",1,0,1,2,"dummy"
"259330",1,9,3,13,"dummy"
"259331",0,0,1,1,"dummy"
"259332",0,0,1,1,"dummy"
"259333",0,0,0,0,"dummy"
"259334",0,1,2,3,"dummy"
"259335",0,2,0,2,"dummy"
"259336",4,0,1,5,"dummy"
"259337",0,3,0,3,"dummy"
"259338",1,13,3,17,"dummy"
"259339",0,1,0,1,"dummy"
"259340",0,0,1,1,"dummy"
"259344",0,0,1,1,"dummy"
"259345",0,0,1,1,"dummy"
"259346",0,0,1,1,"dummy"
"259347",0,0,1,1,"dummy"
"259352",10,9,4,23,"dummy"
"259353",6,6,3,15,"dummy"
"259354",6,0,2,8,"dummy"
"259355",0,1,1,2,"dummy"
"259356",0,6,0,6,"dummy"
"259357",0,0,2,2,"dummy"
"259358",0,0,2,2,"dummy"
"259360",0,2,0,2,"dummy"
"259361",0,1,0,1,"dummy"
"259362",1,1,0,2,"dummy"
"259363",1,2,0,3,"dummy"
"259364",0,1,0,1,"dummy"
"259365",4,4,0,8,"dummy"
"259367",0,0,1,1,"dummy"
"259382",0,1,0,1,"dummy"
"259383",0,0,1,1,"dummy"
"259384",1,1,0,2,"dummy"
"259385",4,1,0,5,"dummy"
"259386",1,2,1,4,"dummy"
"259387",1,2,0,3,"dummy"
"259388",0,0,1,1,"dummy"
"259389",0,0,2,2,"dummy"
"259390",0,0,0,0,"dummy"
"259391",0,0,1,1,"dummy"
"259392",0,0,0,0,"dummy"
"259393",0,0,0,0,"dummy"
"259394",0,0,1,1,"dummy"
"259395",0,0,2,2,"dummy"
"259396",0,0,0,0,"dummy"
"259397",0,0,0,0,"dummy"
"259398",0,0,0,0,"dummy"
"259399",0,0,0,0,"dummy"
"259400",0,1,1,2,"dummy"
"259401",0,0,1,1,"dummy"
"259402",0,0,2,2,"dummy"
"259403",0,0,1,1,"dummy"
"259404",0,0,1,1,"dummy"
"259405",1,0,0,1,"dummy"
"259406",0,0,0,0,"dummy"
"259407",0,1,0,1,"dummy"
"259408",0,0,0,0,"dummy"
"259409",0,0,0,0,"dummy"
"259410",1,4,2,7,"dummy"
"259411",0,0,0,0,"dummy"
"259412",1,1,0,2,"dummy"
"259413",0,0,1,1,"dummy"
"259414",1,2,0,3,"dummy"
"259415",1,1,2,4,"dummy"
"259416",0,1,0,1,"dummy"
"259417",1,1,0,2,"dummy"
"259418",2,3,0,5,"dummy"
"259429",1,0,0,1,"dummy"
"259431",2,3,0,5,"dummy"
"259433",0,4,0,4,"dummy"
"259434",0,1,1,2,"dummy"
"259435",0,0,1,1,"dummy"
"259436",0,7,0,7,"dummy"
"259437",0,2,1,3,"dummy"
"259440",7,4,0,11,"dummy"
"259443",1,0,0,1,"dummy"
"259444",0,1,0,1,"dummy"
"259445",0,11,0,11,"dummy"
"259446",0,1,0,1,"dummy"
"259447",2,2,1,5,"dummy"
"259448",2,2,1,5,"dummy"
"259449",1,2,1,4,"dummy"
"259450",0,0,3,3,"dummy"
"259451",0,0,1,1,"dummy"
"259452",0,3,0,3,"dummy"
"259453",0,1,0,1,"dummy"
"259454",0,3,0,3,"dummy"
"259455",0,2,0,2,"dummy"
"259457",0,1,0,1,"dummy"
"259461",1,0,0,1,"dummy"
"259464",0,0,1,1,"dummy"
"259466",0,0,0,0,"dummy"
"259470",0,0,1,1,"dummy"
"259471",0,0,0,0,"dummy"
"259476",0,1,1,2,"dummy"
"259479",0,0,1,1,"dummy"
"259480",0,0,0,0,"dummy"
"259481",0,0,0,0,"dummy"
"259482",0,0,1,1,"dummy"
"259484",0,10,0,10,"dummy"
"259487",0,0,1,1,"dummy"
"259503",0,0,0,0,"dummy"
"259575",0,0,1,1,"dummy"
"259576",0,0,4,4,"dummy"
"259590",0,2,0,2,"dummy"
"259592",0,2,0,2,"dummy"
"259593",1,8,0,9,"dummy"
"259595",3,3,0,6,"dummy"
"259596",0,0,1,1,"dummy"
"259597",0,0,0,0,"dummy"
"259599",0,1,0,1,"dummy"
"259601",0,0,1,1,"dummy"
"259602",0,4,0,4,"dummy"
"259603",2,1,1,4,"dummy"
"259604",0,0,0,0,"dummy"
"259605",0,0,2,2,"dummy"
"259606",0,2,0,2,"dummy"
"259609",0,3,0,3,"dummy"
"259611",0,3,0,3,"dummy"
"259612",0,1,0,1,"dummy"
"259613",0,0,1,1,"dummy"
"259614",0,0,1,1,"dummy"
"259618",2,6,0,8,"dummy"
"259619",3,2,1,6,"dummy"
"259629",0,0,1,1,"dummy"
"259630",0,0,1,1,"dummy"
"259632",0,0,1,1,"dummy"
"259633",0,0,1,1,"dummy"
"259640",0,4,2,6,"dummy"
"259644",0,0,0,0,"dummy"
"259646",2,15,1,18,"dummy"
"259647",4,4,1,9,"dummy"
"259648",0,1,0,1,"dummy"
"259649",0,0,2,2,"dummy"
"259650",2,0,2,4,"dummy"
"259651",0,0,1,1,"dummy"
"259652",0,0,1,1,"dummy"
"259654",0,0,0,0,"dummy"
"259655",0,0,1,1,"dummy"
"259656",3,13,0,16,"dummy"
"259657",13,3,0,16,"dummy"
"259659",0,1,0,1,"dummy"
"259661",1,0,0,1,"dummy"
"259662",10,11,1,22,"dummy"
"259664",0,6,2,8,"dummy"
"259665",2,2,1,5,"dummy"
"259667",0,0,1,1,"dummy"
"259669",0,7,0,7,"dummy"
"259671",2,4,4,10,"dummy"
"259672",0,0,2,2,"dummy"
"259673",0,1,0,1,"dummy"
"259678",0,0,1,1,"dummy"
"259679",0,0,1,1,"dummy"
"259686",0,0,0,0,"dummy"
"259687",0,1,0,1,"dummy"
"259688",0,1,0,1,"dummy"
"259689",1,4,0,5,"dummy"
"259690",0,1,0,1,"dummy"
"259691",0,0,0,0,"dummy"
"259693",0,2,0,2,"dummy"
"259694",0,4,0,4,"dummy"
"259695",4,2,4,10,"dummy"
"259696",1,1,4,6,"dummy"
"259698",0,0,1,1,"dummy"
"259699",0,0,1,1,"dummy"
"259700",0,0,2,2,"dummy"
"259701",0,0,1,1,"dummy"
"259702",0,0,0,0,"dummy"
"259703",2,0,0,2,"dummy"
"259704",0,0,1,1,"dummy"
"259705",0,1,1,2,"dummy"
"259706",0,0,1,1,"dummy"
"259707",0,0,1,1,"dummy"
"259708",0,0,1,1,"dummy"
"259709",0,2,0,2,"dummy"
"259710",0,1,0,1,"dummy"
"259711",0,4,0,4,"dummy"
"259712",1,0,0,1,"dummy"
"259713",0,1,0,1,"dummy"
"259714",1,2,0,3,"dummy"
"259715",0,1,0,1,"dummy"
"259716",0,10,0,10,"dummy"
"259717",10,2,0,12,"dummy"
"259718",2,0,0,2,"dummy"
"259719",0,2,0,2,"dummy"
"259720",0,10,0,10,"dummy"
"259721",0,0,0,0,"dummy"
"259722",0,0,0,0,"dummy"
"259723",0,0,2,2,"dummy"
"259724",8,2,0,10,"dummy"
"259725",2,0,0,2,"dummy"
"259726",0,0,0,0,"dummy"
"259727",0,0,0,0,"dummy"
"259728",1,0,0,1,"dummy"
"259729",0,0,0,0,"dummy"
"259730",4,0,0,4,"dummy"
"259739",1,3,0,4,"dummy"
"259740",0,1,0,1,"dummy"
"259741",1,1,0,2,"dummy"
"259742",0,1,0,1,"dummy"
"259743",0,0,0,0,"dummy"
"259744",0,3,0,3,"dummy"
"259745",0,1,0,1,"dummy"
"259749",0,0,0,0,"dummy"
"259750",10,5,2,17,"dummy"
"259751",0,0,1,1,"dummy"
"259762",0,0,1,1,"dummy"
"259783",4,8,0,12,"dummy"
"259784",2,1,0,3,"dummy"
"259785",0,2,0,2,"dummy"
"259786",0,1,1,2,"dummy"
"259788",1,5,0,6,"dummy"
"259789",0,0,2,2,"dummy"
"259792",0,2,2,4,"dummy"
"259793",0,1,0,1,"dummy"
"259794",0,3,0,3,"dummy"
"259796",0,0,2,2,"dummy"
"259799",2,2,2,6,"dummy"
"259800",1,1,0,2,"dummy"
"259801",10,12,2,24,"dummy"
"259807",0,0,2,2,"dummy"
"259808",0,0,1,1,"dummy"
"259809",0,0,2,2,"dummy"
"259810",0,0,1,1,"dummy"
"259811",0,0,0,0,"dummy"
"259812",0,0,1,1,"dummy"
"259813",0,0,1,1,"dummy"
"259814",0,0,1,1,"dummy"
"259815",0,0,1,1,"dummy"
"259817",0,1,0,1,"dummy"
"259820",0,0,1,1,"dummy"
"259823",0,0,1,1,"dummy"
"259824",0,1,1,2,"dummy"
"259825",8,0,3,11,"dummy"
"259829",4,7,0,11,"dummy"
"259830",0,10,0,10,"dummy"
"259834",0,5,0,5,"dummy"
"259835",0,1,0,1,"dummy"
"259836",0,4,0,4,"dummy"
"259837",0,5,0,5,"dummy"
"259838",2,5,0,7,"dummy"
"259839",0,1,0,1,"dummy"
"259840",0,1,0,1,"dummy"
"259841",0,3,0,3,"dummy"
"259842",3,2,0,5,"dummy"
"259843",6,2,0,8,"dummy"
"259844",0,1,0,1,"dummy"
"259845",0,3,0,3,"dummy"
"259846",0,1,0,1,"dummy"
"259847",0,1,0,1,"dummy"
"259848",0,1,0,1,"dummy"
"259849",4,4,0,8,"dummy"
"259851",6,6,2,14,"dummy"
"259852",0,0,0,0,"dummy"
"259853",0,2,0,2,"dummy"
"259861",3,0,0,3,"dummy"
"259863",0,3,1,4,"dummy"
"259864",0,1,0,1,"dummy"
"259865",3,2,0,5,"dummy"
"259866",1,4,1,6,"dummy"
"259867",0,0,2,2,"dummy"
"259868",0,1,0,1,"dummy"
"259869",0,1,0,1,"dummy"
"259870",0,2,0,2,"dummy"
"259871",0,1,0,1,"dummy"
"259872",0,2,0,2,"dummy"
"259873",0,4,0,4,"dummy"
"259875",0,1,0,1,"dummy"
"259876",0,8,0,8,"dummy"
"259877",0,2,0,2,"dummy"
"259878",0,2,0,2,"dummy"
"259879",8,12,1,21,"dummy"
"259882",0,1,0,1,"dummy"
"259884",12,7,1,20,"dummy"
"259885",1,0,0,1,"dummy"
"259887",0,1,2,3,"dummy"
"259888",0,0,0,0,"dummy"
"259889",0,1,0,1,"dummy"
"259890",4,0,2,6,"dummy"
"259891",1,0,0,1,"dummy"
"259892",0,0,0,0,"dummy"
"259893",0,0,0,0,"dummy"
"259895",0,4,0,4,"dummy"
"259898",0,1,0,1,"dummy"
"259902",0,0,3,3,"dummy"
"259903",0,0,0,0,"dummy"
"259904",0,0,3,3,"dummy"
"259905",0,0,3,3,"dummy"
"259906",1,2,0,3,"dummy"
"259907",0,0,0,0,"dummy"
"259908",0,0,0,0,"dummy"
"259909",0,0,0,0,"dummy"
"259910",0,0,0,0,"dummy"
"259911",0,1,0,1,"dummy"
"259912",8,2,0,10,"dummy"
"259913",0,0,0,0,"dummy"
"259914",2,8,0,10,"dummy"
"259915",0,0,0,0,"dummy"
"259916",0,0,3,3,"dummy"
"259917",0,0,3,3,"dummy"
"259918",0,0,3,3,"dummy"
"259919",22,19,1,42,"dummy"
"259920",55,24,1,80,"dummy"
"259921",0,0,1,1,"dummy"
"259922",0,0,1,1,"dummy"
"259924",0,0,1,1,"dummy"
"259925",0,0,1,1,"dummy"
"259926",0,0,1,1,"dummy"
"259927",1,3,0,4,"dummy"
"259928",0,0,1,1,"dummy"
"259929",0,2,0,2,"dummy"
"259930",0,2,1,3,"dummy"
"259931",0,1,1,2,"dummy"
"259932",0,1,0,1,"dummy"
"259933",1,1,1,3,"dummy"
"259934",0,0,1,1,"dummy"
"259935",0,1,0,1,"dummy"
"259936",0,0,1,1,"dummy"
"259937",0,0,1,1,"dummy"
"259938",0,0,1,1,"dummy"
"259939",2,0,0,2,"dummy"
"259940",4,1,0,5,"dummy"
"259941",9,0,0,9,"dummy"
"259942",0,0,1,1,"dummy"
"259944",0,4,0,4,"dummy"
"259945",0,0,2,2,"dummy"
"259946",1,2,0,3,"dummy"
"259947",0,1,0,1,"dummy"
"259948",3,5,0,8,"dummy"
"259949",7,5,0,12,"dummy"
"259950",0,1,0,1,"dummy"
"259951",3,4,0,7,"dummy"
"259952",2,0,0,2,"dummy"
"259953",4,2,0,6,"dummy"
"259955",3,4,0,7,"dummy"
"259956",0,0,1,1,"dummy"
"259957",2,2,1,5,"dummy"
"259958",0,0,1,1,"dummy"
"259959",1,0,0,1,"dummy"
"259960",0,0,1,1,"dummy"
"259961",0,0,1,1,"dummy"
"259962",0,15,0,15,"dummy"
"259963",0,0,1,1,"dummy"
"259964",3,3,0,6,"dummy"
"259965",0,0,1,1,"dummy"
"259967",0,0,1,1,"dummy"
"259968",0,0,1,1,"dummy"
"259969",0,1,0,1,"dummy"
"259970",0,0,1,1,"dummy"
"259971",0,0,1,1,"dummy"
"259972",2,3,3,8,"dummy"
"259973",0,0,2,2,"dummy"
"259975",0,6,0,6,"dummy"
"259976",0,3,0,3,"dummy"
"259978",0,1,0,1,"dummy"
"259980",8,8,2,18,"dummy"
"259983",0,6,0,6,"dummy"
"259986",0,0,1,1,"dummy"
"259988",1,3,2,6,"dummy"
"259990",7,0,0,7,"dummy"
"259991",0,0,2,2,"dummy"
"260008",0,3,1,4,"dummy"
"260009",3,2,0,5,"dummy"
"260010",8,0,0,8,"dummy"
"260011",2,3,1,6,"dummy"
"260012",1,0,0,1,"dummy"
"260013",1,0,0,1,"dummy"
"260014",0,4,1,5,"dummy"
"260015",2,2,0,4,"dummy"
"260016",0,1,0,1,"dummy"
"260017",0,1,0,1,"dummy"
"260018",0,3,1,4,"dummy"
"260019",0,3,1,4,"dummy"
"260020",3,3,1,7,"dummy"
"260021",7,0,0,7,"dummy"
"260022",1,0,0,1,"dummy"
"260024",1,0,0,1,"dummy"
"260026",10,6,0,16,"dummy"
"260027",28,19,4,51,"dummy"
"260028",1,5,5,11,"dummy"
"260029",0,0,7,7,"dummy"
"260031",0,2,0,2,"dummy"
"260034",0,1,0,1,"dummy"
"260039",0,2,3,5,"dummy"
"260041",1,0,1,2,"dummy"
"260047",0,0,0,0,"dummy"
"260057",0,0,1,1,"dummy"
"260058",4,12,1,17,"dummy"
"260062",0,0,1,1,"dummy"
"260063",4,5,5,14,"dummy"
"260066",0,0,1,1,"dummy"
"260067",5,3,2,10,"dummy"
"260072",0,2,1,3,"dummy"
"260075",0,0,1,1,"dummy"
"260076",0,0,2,2,"dummy"
"260077",0,0,1,1,"dummy"
"260078",0,0,2,2,"dummy"
"260079",0,0,1,1,"dummy"
"260080",0,0,1,1,"dummy"
"260081",0,2,2,4,"dummy"
"260084",0,0,0,0,"dummy"
"260086",5,32,0,37,"dummy"
"260087",8,2,4,14,"dummy"
"260088",0,1,2,3,"dummy"
"260092",7,2,2,11,"dummy"
"260093",0,0,0,0,"dummy"
"260094",0,0,0,0,"dummy"
"260096",0,5,0,5,"dummy"
"260097",0,1,0,1,"dummy"
"260098",5,0,0,5,"dummy"
"260099",1,0,1,2,"dummy"
"260100",0,1,0,1,"dummy"
"260102",0,0,7,7,"dummy"
"260104",1,1,0,2,"dummy"
"260107",0,1,0,1,"dummy"
"260109",0,1,2,3,"dummy"
"260110",0,1,0,1,"dummy"
"260112",0,1,0,1,"dummy"
"260113",0,1,0,1,"dummy"
"260114",0,1,0,1,"dummy"
"260117",3,8,3,14,"dummy"
"260118",0,2,0,2,"dummy"
"260119",0,1,0,1,"dummy"
"260120",6,0,0,6,"dummy"
"260121",0,8,0,8,"dummy"
"260122",1,5,4,10,"dummy"
"260123",0,3,0,3,"dummy"
"260124",0,0,1,1,"dummy"
"260125",0,0,1,1,"dummy"
"260126",0,0,1,1,"dummy"
"260127",0,0,1,1,"dummy"
"260128",2,2,0,4,"dummy"
"260129",6,16,2,24,"dummy"
"260130",2,4,0,6,"dummy"
"260131",1,0,0,1,"dummy"
"260132",2,4,0,6,"dummy"
"260133",1,0,0,1,"dummy"
"260134",0,1,0,1,"dummy"
"260135",1,0,0,1,"dummy"
"260136",0,0,1,1,"dummy"
"260137",0,2,0,2,"dummy"
"260138",0,2,0,2,"dummy"
"260139",0,0,1,1,"dummy"
"260140",34,3,2,39,"dummy"
"260141",0,14,0,14,"dummy"
"260142",2,2,2,6,"dummy"
"260143",14,0,0,14,"dummy"
"260144",4,5,4,13,"dummy"
"260145",4,3,3,10,"dummy"
"260146",0,1,0,1,"dummy"
"260147",0,2,0,2,"dummy"
"260148",5,4,3,12,"dummy"
"260149",0,3,0,3,"dummy"
"260150",6,0,0,6,"dummy"
"260151",0,0,1,1,"dummy"
"260152",0,0,1,1,"dummy"
"260153",1,1,0,2,"dummy"
"260154",0,0,1,1,"dummy"
"260155",0,3,0,3,"dummy"
"260156",0,1,0,1,"dummy"
"260157",0,2,0,2,"dummy"
"260158",7,5,2,14,"dummy"
"260159",0,1,0,1,"dummy"
"260175",0,0,1,1,"dummy"
"260177",0,0,3,3,"dummy"
"260179",1,6,3,10,"dummy"
"260180",0,0,1,1,"dummy"
"260187",0,0,1,1,"dummy"
"260189",0,0,1,1,"dummy"
"260225",2,2,2,6,"dummy"
"260227",1,5,0,6,"dummy"
"260228",2,3,0,5,"dummy"
"260230",0,1,0,1,"dummy"
"260231",1,2,0,3,"dummy"
"260232",0,1,0,1,"dummy"
"260233",0,0,1,1,"dummy"
"260234",0,1,0,1,"dummy"
"260237",1,0,0,1,"dummy"
"260238",0,0,0,0,"dummy"
"260239",1,0,0,1,"dummy"
"260240",0,0,1,1,"dummy"
"260241",1,4,0,5,"dummy"
"260242",0,1,0,1,"dummy"
"260243",0,0,0,0,"dummy"
"260245",0,0,0,0,"dummy"
"260246",0,0,0,0,"dummy"
"260247",0,0,0,0,"dummy"
"260248",0,0,0,0,"dummy"
"260269",0,0,1,1,"dummy"
"260271",0,2,0,2,"dummy"
"260272",0,0,2,2,"dummy"
"260273",1,0,0,1,"dummy"
"260274",0,1,0,1,"dummy"
"260275",7,1,1,9,"dummy"
"260279",0,0,0,0,"dummy"
"260280",0,0,1,1,"dummy"
"260281",0,1,0,1,"dummy"
"260282",0,2,0,2,"dummy"
"260283",0,2,0,2,"dummy"
"260284",0,0,1,1,"dummy"
"260285",1,2,1,4,"dummy"
"260286",0,3,0,3,"dummy"
"260287",0,1,0,1,"dummy"
"260288",0,1,0,1,"dummy"
"260289",0,1,0,1,"dummy"
"260290",0,2,0,2,"dummy"
"260291",0,2,0,2,"dummy"
"260292",0,1,0,1,"dummy"
"260293",1,0,0,1,"dummy"
"260294",0,0,2,2,"dummy"
"260295",0,0,2,2,"dummy"
"260296",0,1,0,1,"dummy"
"260297",0,1,0,1,"dummy"
"260300",0,1,2,3,"dummy"
"260301",0,0,0,0,"dummy"
"260302",0,1,0,1,"dummy"
"260303",4,0,2,6,"dummy"
"260304",1,0,0,1,"dummy"
"260305",0,0,0,0,"dummy"
"260307",0,0,1,1,"dummy"
"260315",0,3,0,3,"dummy"
"260316",0,4,0,4,"dummy"
"260317",2,0,1,3,"dummy"
"260318",0,2,0,2,"dummy"
"260319",0,0,0,0,"dummy"
"260320",7,16,5,28,"dummy"
"260321",0,2,0,2,"dummy"
"260322",1,2,0,3,"dummy"
"260323",0,1,0,1,"dummy"
"260324",1,2,1,4,"dummy"
"260325",0,0,1,1,"dummy"
"260326",1,3,2,6,"dummy"
"260327",0,0,1,1,"dummy"
"260328",0,1,0,1,"dummy"
"260331",1,4,0,5,"dummy"
"260335",0,0,0,0,"dummy"
"260336",0,0,0,0,"dummy"
"260337",0,0,0,0,"dummy"
"260338",0,22,0,22,"dummy"
"260340",2,12,0,14,"dummy"
"260341",0,5,0,5,"dummy"
"260342",1,6,0,7,"dummy"
"260343",8,7,0,15,"dummy"
"260347",0,0,1,1,"dummy"
"260348",0,2,1,3,"dummy"
"260349",2,2,0,4,"dummy"
"260350",0,2,1,3,"dummy"
"260351",0,2,3,5,"dummy"
"260352",1,2,0,3,"dummy"
"260353",2,2,0,4,"dummy"
"260354",2,0,1,3,"dummy"
"260355",0,1,0,1,"dummy"
"260356",0,0,1,1,"dummy"
"260357",0,2,0,2,"dummy"
"260360",3,2,0,5,"dummy"
"260361",2,3,1,6,"dummy"
"260364",0,1,0,1,"dummy"
"260365",0,0,0,0,"dummy"
"260366",0,1,3,4,"dummy"
"260367",2,1,0,3,"dummy"
"260368",10,4,2,16,"dummy"
"260369",1,2,0,3,"dummy"
"260370",0,0,0,0,"dummy"
"260371",1,5,1,7,"dummy"
"260372",0,2,0,2,"dummy"
"260373",0,2,0,2,"dummy"
"260374",1,2,1,4,"dummy"
"260375",0,0,0,0,"dummy"
"260376",0,0,0,0,"dummy"
"260377",0,0,0,0,"dummy"
"260378",0,0,0,0,"dummy"
"260379",1,0,1,2,"dummy"
"260380",1,3,1,5,"dummy"
"260383",0,1,0,1,"dummy"
"260384",1,0,0,1,"dummy"
"260385",0,1,0,1,"dummy"
"260386",0,4,0,4,"dummy"
"260387",1,2,0,3,"dummy"
"260388",0,0,0,0,"dummy"
"260389",0,2,2,4,"dummy"
"260390",2,4,6,12,"dummy"
"260395",0,0,1,1,"dummy"
"260396",0,0,1,1,"dummy"
"260392",1,3,2,6,"dummy"
"260393",0,0,0,0,"dummy"
"260404",0,0,3,3,"dummy"
"260406",0,0,1,1,"dummy"
"260412",1,2,0,3,"dummy"
"260414",0,0,1,1,"dummy"
"260417",0,0,2,2,"dummy"
"260418",0,0,1,1,"dummy"
"260419",0,0,1,1,"dummy"
"260420",0,17,0,17,"dummy"
"260424",0,0,1,1,"dummy"
"260443",3,2,1,6,"dummy"
"260462",0,7,0,7,"dummy"
"260463",0,0,2,2,"dummy"
"260464",1,0,1,2,"dummy"
"260466",0,2,0,2,"dummy"
"260467",0,3,0,3,"dummy"
"260469",3,2,4,9,"dummy"
"260470",1,4,0,5,"dummy"
"260473",0,0,1,1,"dummy"
"260475",12,5,1,18,"dummy"
"260477",0,0,3,3,"dummy"
"260478",0,2,0,2,"dummy"
"260479",6,19,3,28,"dummy"
"260480",27,3,0,30,"dummy"
"260482",0,0,1,1,"dummy"
"260484",7,7,1,15,"dummy"
"260486",6,2,0,8,"dummy"
"260487",0,1,1,2,"dummy"
"260488",1,0,1,2,"dummy"
"260489",0,0,0,0,"dummy"
"260490",0,1,0,1,"dummy"
"260491",0,1,2,3,"dummy"
"260492",0,4,0,4,"dummy"
"260493",3,8,0,11,"dummy"
"260494",0,1,0,1,"dummy"
"260495",1,0,0,1,"dummy"
"260500",0,0,1,1,"dummy"
"260503",0,0,1,1,"dummy"
"260504",0,0,1,1,"dummy"
"260505",0,4,0,4,"dummy"
"260506",0,0,1,1,"dummy"
"260509",23,18,0,41,"dummy"
"260510",1,1,2,4,"dummy"
"260511",0,1,2,3,"dummy"
"260515",2,16,1,19,"dummy"
"260517",2,0,0,2,"dummy"
"260521",0,0,1,1,"dummy"
"260522",0,0,1,1,"dummy"
"260523",0,0,2,2,"dummy"
"260524",0,0,1,1,"dummy"
"260525",0,3,1,4,"dummy"
"260526",0,0,1,1,"dummy"
"260528",1,3,1,5,"dummy"
"260529",0,2,0,2,"dummy"
"260530",2,0,0,2,"dummy"
"260533",1,3,0,4,"dummy"
"260534",0,0,0,0,"dummy"
"260536",3,0,2,5,"dummy"
"260537",0,7,0,7,"dummy"
"260540",1,5,1,7,"dummy"
"260543",0,0,1,1,"dummy"
"260545",5,2,2,9,"dummy"
"260546",0,7,2,9,"dummy"
"260547",5,6,2,13,"dummy"
"260548",2,2,0,4,"dummy"
"260549",0,0,1,1,"dummy"
"260550",0,0,1,1,"dummy"
"260551",1,2,1,4,"dummy"
"260552",1,8,0,9,"dummy"
"260553",0,1,0,1,"dummy"
"260554",0,2,0,2,"dummy"
"260555",0,1,1,2,"dummy"
"260556",2,0,0,2,"dummy"
"260558",0,0,3,3,"dummy"
"260563",5,4,4,13,"dummy"
"260564",1,0,0,1,"dummy"
"260565",0,0,1,1,"dummy"
"260566",0,0,0,0,"dummy"
"260567",2,3,5,10,"dummy"
"260568",0,1,0,1,"dummy"
"260570",0,1,1,2,"dummy"
"260572",0,0,1,1,"dummy"
"260573",0,0,1,1,"dummy"
"260574",5,2,4,11,"dummy"
"260575",2,7,3,12,"dummy"
"260576",0,0,0,0,"dummy"
"260579",2,1,1,4,"dummy"
"260602",6,15,0,21,"dummy"
"260604",5,8,3,16,"dummy"
"260605",0,5,0,5,"dummy"
"260606",9,22,5,36,"dummy"
"260607",22,9,5,36,"dummy"
"260608",8,3,1,12,"dummy"
"260609",6,12,1,19,"dummy"
"260610",4,8,1,13,"dummy"
"260611",1,2,0,3,"dummy"
"260612",2,7,8,17,"dummy"
"260613",0,0,1,1,"dummy"
"260614",0,6,0,6,"dummy"
"260615",1,3,0,4,"dummy"
"260616",6,1,0,7,"dummy"
"260617",0,1,0,1,"dummy"
"260618",4,3,0,7,"dummy"
"260619",1,0,0,1,"dummy"
"260621",2,8,0,10,"dummy"
"260622",4,10,1,15,"dummy"
"260623",3,14,2,19,"dummy"
"260625",0,1,0,1,"dummy"
"260626",0,0,1,1,"dummy"
"260629",0,1,0,1,"dummy"
"260633",1,8,0,9,"dummy"
"260634",0,20,0,20,"dummy"
"260636",0,0,0,0,"dummy"
"260637",0,1,0,1,"dummy"
"260638",0,1,0,1,"dummy"
"260639",0,0,1,1,"dummy"
"260644",0,0,0,0,"dummy"
"260645",0,0,0,0,"dummy"
"260646",2,0,0,2,"dummy"
"260648",0,1,0,1,"dummy"
"260654",0,0,1,1,"dummy"
"260656",0,0,1,1,"dummy"
"260658",0,0,1,1,"dummy"
"260659",4,6,0,10,"dummy"
"260666",7,12,1,20,"dummy"
"260672",0,0,3,3,"dummy"
"260675",1,0,0,1,"dummy"
"260679",0,4,0,4,"dummy"
"260681",0,0,1,1,"dummy"
"260686",0,6,1,7,"dummy"
"260687",10,10,0,20,"dummy"
"260688",0,0,2,2,"dummy"
"260689",0,0,2,2,"dummy"
"260690",5,5,0,10,"dummy"
"260691",2,0,0,2,"dummy"
"260692",0,1,0,1,"dummy"
"260694",1,1,0,2,"dummy"
"260695",2,0,0,2,"dummy"
"260696",1,0,1,2,"dummy"
"260697",0,1,0,1,"dummy"
"260698",3,1,1,5,"dummy"
"260702",0,3,0,3,"dummy"
"260703",0,2,0,2,"dummy"
"260704",0,1,0,1,"dummy"
"260705",0,2,3,5,"dummy"
"260708",1,0,0,1,"dummy"
"260709",0,0,1,1,"dummy"
"260710",0,1,0,1,"dummy"
"260712",1,0,0,1,"dummy"
"260714",0,0,0,0,"dummy"
"260715",0,0,0,0,"dummy"
"260725",3,0,0,3,"dummy"
"260726",3,2,2,7,"dummy"
"260728",1,0,3,4,"dummy"
"260731",1,12,0,13,"dummy"
"260732",3,3,0,6,"dummy"
"260733",1,1,3,5,"dummy"
"260734",0,1,0,1,"dummy"
"260735",0,0,1,1,"dummy"
"260736",0,0,1,1,"dummy"
"260737",0,0,1,1,"dummy"
"260738",0,0,1,1,"dummy"
"260739",0,0,1,1,"dummy"
"260740",1,4,0,5,"dummy"
"260741",0,0,1,1,"dummy"
"260742",0,0,1,1,"dummy"
"260743",0,0,1,1,"dummy"
"260744",0,0,1,1,"dummy"
"260745",0,0,1,1,"dummy"
"260746",0,0,1,1,"dummy"
"260747",0,0,1,1,"dummy"
"260748",0,0,1,1,"dummy"
"260749",0,0,1,1,"dummy"
"260750",0,0,1,1,"dummy"
"260751",0,0,1,1,"dummy"
"260752",0,0,1,1,"dummy"
"260753",0,0,1,1,"dummy"
"260754",0,0,1,1,"dummy"
"260755",0,0,1,1,"dummy"
"260756",0,0,1,1,"dummy"
"260757",0,0,1,1,"dummy"
"260758",0,0,1,1,"dummy"
"260759",0,0,1,1,"dummy"
"260760",0,0,1,1,"dummy"
"260761",0,0,1,1,"dummy"
"260762",0,0,1,1,"dummy"
"260763",0,0,1,1,"dummy"
"260764",0,0,1,1,"dummy"
"260765",0,0,1,1,"dummy"
"260766",0,0,1,1,"dummy"
"260767",0,0,1,1,"dummy"
"260768",0,0,1,1,"dummy"
"260769",0,0,1,1,"dummy"
"260770",0,0,1,1,"dummy"
"260771",0,0,1,1,"dummy"
"260772",0,0,1,1,"dummy"
"260773",0,0,1,1,"dummy"
"260774",0,0,1,1,"dummy"
"260775",0,0,1,1,"dummy"
"260776",0,0,1,1,"dummy"
"260777",0,0,1,1,"dummy"
"260778",0,0,1,1,"dummy"
"260779",0,0,1,1,"dummy"
"260780",0,0,1,1,"dummy"
"260781",0,0,1,1,"dummy"
"260782",0,0,1,1,"dummy"
"260783",0,0,1,1,"dummy"
"260784",0,0,1,1,"dummy"
"260785",0,0,1,1,"dummy"
"260786",0,0,1,1,"dummy"
"260787",0,0,1,1,"dummy"
"260788",0,0,1,1,"dummy"
"260789",0,0,1,1,"dummy"
"260790",0,0,1,1,"dummy"
"260791",0,0,1,1,"dummy"
"260792",0,0,1,1,"dummy"
"260793",0,0,1,1,"dummy"
"260794",0,0,1,1,"dummy"
"260795",0,0,1,1,"dummy"
"260796",0,0,1,1,"dummy"
"260797",0,0,1,1,"dummy"
"260798",0,0,1,1,"dummy"
"260799",0,0,1,1,"dummy"
"260800",0,0,1,1,"dummy"
"260801",0,0,1,1,"dummy"
"260802",0,0,1,1,"dummy"
"260803",0,0,1,1,"dummy"
"260804",0,0,1,1,"dummy"
"260805",0,0,1,1,"dummy"
"260806",0,0,1,1,"dummy"
"260807",0,0,1,1,"dummy"
"260808",0,0,1,1,"dummy"
"260809",0,0,1,1,"dummy"
"260811",1,1,1,3,"dummy"
"260812",0,0,1,1,"dummy"
"260813",0,0,1,1,"dummy"
"260814",0,0,2,2,"dummy"
"260828",1,8,2,11,"dummy"
"260829",1,1,0,2,"dummy"
"260830",0,0,1,1,"dummy"
"260831",0,1,0,1,"dummy"
"260832",0,1,0,1,"dummy"
"260833",0,5,0,5,"dummy"
"260834",0,0,1,1,"dummy"
"260835",7,9,0,16,"dummy"
"260837",0,0,0,0,"dummy"
"260839",0,0,1,1,"dummy"
"260840",2,10,1,13,"dummy"
"260841",2,0,0,2,"dummy"
"260842",0,2,0,2,"dummy"
"260846",0,1,0,1,"dummy"
"260847",1,2,0,3,"dummy"
"260848",0,1,0,1,"dummy"
"260849",3,0,0,3,"dummy"
"260850",5,6,1,12,"dummy"
"260851",6,3,0,9,"dummy"
"260852",0,1,0,1,"dummy"
"260853",0,0,0,0,"dummy"
"260854",0,0,1,1,"dummy"
"260855",0,0,0,0,"dummy"
"260857",0,0,1,1,"dummy"
"260858",0,0,0,0,"dummy"
"260868",2,0,2,4,"dummy"
"260871",2,0,0,2,"dummy"
"260872",0,0,1,1,"dummy"
"260873",0,0,0,0,"dummy"
"260874",0,0,1,1,"dummy"
"260875",0,0,1,1,"dummy"
"260876",0,3,1,4,"dummy"
"260877",3,0,1,4,"dummy"
"260878",0,0,1,1,"dummy"
"260879",0,1,0,1,"dummy"
"260880",0,0,1,1,"dummy"
"260881",0,0,1,1,"dummy"
"260882",6,5,0,11,"dummy"
"260883",0,6,0,6,"dummy"
"260884",2,1,2,5,"dummy"
"260885",0,0,1,1,"dummy"
"260887",0,0,0,0,"dummy"
"260889",0,6,0,6,"dummy"
"260890",5,6,2,13,"dummy"
"260891",4,0,0,4,"dummy"
"260892",4,2,1,7,"dummy"
"260893",0,5,2,7,"dummy"
"260899",1,8,1,10,"dummy"
"260900",6,12,2,20,"dummy"
"260901",0,2,0,2,"dummy"
"260931",10,8,4,22,"dummy"
"260932",8,1,0,9,"dummy"
"260933",0,0,1,1,"dummy"
"260934",11,22,5,38,"dummy"
"260935",0,0,1,1,"dummy"
"260952",0,1,0,1,"dummy"
"260955",1,3,1,5,"dummy"
"260956",0,0,2,2,"dummy"
"260980",0,1,0,1,"dummy"
"260996",0,0,0,0,"dummy"
"260997",0,0,1,1,"dummy"
"260998",0,0,0,0,"dummy"
"260999",0,1,0,1,"dummy"
"261000",0,0,0,0,"dummy"
"261001",0,0,0,0,"dummy"
"261002",0,0,0,0,"dummy"
"261003",0,0,0,0,"dummy"
"261004",0,0,0,0,"dummy"
"261005",0,0,0,0,"dummy"
"261006",0,0,0,0,"dummy"
"261007",0,1,0,1,"dummy"
"261052",0,0,1,1,"dummy"
"261160",0,1,0,1,"dummy"
"261161",0,0,1,1,"dummy"
"261184",0,1,0,1,"dummy"
"261187",2,5,3,10,"dummy"
"261210",0,2,0,2,"dummy"
"261217",2,4,0,6,"dummy"
"261218",0,2,0,2,"dummy"
"261219",0,2,0,2,"dummy"
"260895",5,5,4,14,"dummy"
"260896",0,3,0,3,"dummy"
"260897",1,0,0,1,"dummy"
"260905",2,2,3,7,"dummy"
"260918",4,3,4,11,"dummy"
"260919",0,1,0,1,"dummy"
"260920",1,0,0,1,"dummy"
"260923",0,2,2,4,"dummy"
"260969",0,1,0,1,"dummy"
"260970",0,0,1,1,"dummy"
"260971",1,0,1,2,"dummy"
"260972",0,1,0,1,"dummy"
"260973",1,3,0,4,"dummy"
"260974",16,8,3,27,"dummy"
"260975",8,14,3,25,"dummy"
"260976",0,0,0,0,"dummy"
"260977",0,0,2,2,"dummy"
"260978",0,0,1,1,"dummy"
"260984",4,3,0,7,"dummy"
"260985",3,2,6,11,"dummy"
"260986",7,3,0,10,"dummy"
"260987",1,1,0,2,"dummy"
"260988",0,8,1,9,"dummy"
"260989",3,3,1,7,"dummy"
"260990",3,3,1,7,"dummy"
"261009",25,2,0,27,"dummy"
"261010",2,3,0,5,"dummy"
"261011",0,1,0,1,"dummy"
"261012",0,0,1,1,"dummy"
"261013",0,0,2,2,"dummy"
"261014",1,0,1,2,"dummy"
"261015",0,0,1,1,"dummy"
"261016",0,1,1,2,"dummy"
"261048",8,15,3,26,"dummy"
"261074",0,1,1,2,"dummy"
"261147",2,12,1,15,"dummy"
"261148",0,0,5,5,"dummy"
"261149",7,1,0,8,"dummy"
"261150",0,0,1,1,"dummy"
"261151",0,0,0,0,"dummy"
"261152",0,2,0,2,"dummy"
"261153",0,0,1,1,"dummy"
"261154",2,2,0,4,"dummy"
"261155",0,0,1,1,"dummy"
"261156",0,0,1,1,"dummy"
"261157",1,9,1,11,"dummy"
"261158",0,0,1,1,"dummy"
"261189",0,0,0,0,"dummy"
"261190",1,0,0,1,"dummy"
"261191",0,0,1,1,"dummy"
"261192",2,0,0,2,"dummy"
"261193",0,0,1,1,"dummy"
"261194",0,1,0,1,"dummy"
"261195",0,2,0,2,"dummy"
"261196",1,7,1,9,"dummy"
"261197",0,0,0,0,"dummy"
"261198",0,0,0,0,"dummy"
"261199",0,2,0,2,"dummy"
"261200",6,3,0,9,"dummy"
"261201",3,0,0,3,"dummy"
"261202",0,0,0,0,"dummy"
"261203",0,0,0,0,"dummy"
"261204",0,0,2,2,"dummy"
"261205",0,0,2,2,"dummy"
"261206",0,0,2,2,"dummy"
"261207",0,0,2,2,"dummy"
"261208",0,0,0,0,"dummy"
"261212",0,1,0,1,"dummy"
"261213",0,0,2,2,"dummy"
"261229",0,1,0,1,"dummy"
"261230",0,0,0,0,"dummy"
"261231",0,0,1,1,"dummy"
"261232",5,8,4,17,"dummy"
"261233",7,0,0,7,"dummy"
"261240",0,0,0,0,"dummy"
"261241",0,0,0,0,"dummy"
"261242",0,1,0,1,"dummy"
"261243",0,0,1,1,"dummy"
"261246",1,4,0,5,"dummy"
"261249",0,0,1,1,"dummy"
"261250",0,0,4,4,"dummy"
"261251",0,0,1,1,"dummy"
"261258",0,0,3,3,"dummy"
"261259",0,1,0,1,"dummy"
"261262",5,7,0,12,"dummy"
"261263",0,0,0,0,"dummy"
"261264",0,0,0,0,"dummy"
"261295",0,0,2,2,"dummy"
"261296",0,2,0,2,"dummy"
"261297",2,1,0,3,"dummy"
"261319",1,0,0,1,"dummy"
"261320",0,1,0,1,"dummy"
"261321",1,2,0,3,"dummy"
"261348",0,0,1,1,"dummy"
"261349",0,0,1,1,"dummy"
"261365",0,0,0,0,"dummy"
"261366",2,0,0,2,"dummy"
"261367",0,0,0,0,"dummy"
"261368",10,6,0,16,"dummy"
"261369",0,0,0,0,"dummy"
"261377",0,0,0,0,"dummy"
"261378",1,4,1,6,"dummy"
"261379",8,5,3,16,"dummy"
"261380",2,5,2,9,"dummy"
"261381",0,1,0,1,"dummy"
"261382",3,9,3,15,"dummy"
"261383",1,0,0,1,"dummy"
"261393",0,6,0,6,"dummy"
"261396",0,1,0,1,"dummy"
"261397",0,8,0,8,"dummy"
"261400",0,0,1,1,"dummy"
"261403",15,13,0,28,"dummy"
"261404",0,0,1,1,"dummy"
"261405",1,8,0,9,"dummy"
"261406",1,1,0,2,"dummy"
"261409",0,0,1,1,"dummy"
"261410",0,0,1,1,"dummy"
"261417",2,5,0,7,"dummy"
"261418",9,5,0,14,"dummy"
"261419",0,3,0,3,"dummy"
"261425",0,0,1,1,"dummy"
"261426",3,3,2,8,"dummy"
"261427",0,0,1,1,"dummy"
"261428",2,22,0,24,"dummy"
"261220",10,2,0,12,"dummy"
"261221",0,2,0,2,"dummy"
"261222",0,0,0,0,"dummy"
"261223",0,0,3,3,"dummy"
"261224",0,5,0,5,"dummy"
"261225",1,0,1,2,"dummy"
"261235",0,3,0,3,"dummy"
"261236",0,0,1,1,"dummy"
"261237",0,0,1,1,"dummy"
"261238",2,3,1,6,"dummy"
"261253",0,1,2,3,"dummy"
"261254",6,0,2,8,"dummy"
"261266",3,10,2,15,"dummy"
"261269",8,3,1,12,"dummy"
"261270",0,2,0,2,"dummy"
"261273",1,2,5,8,"dummy"
"261291",0,1,0,1,"dummy"
"261292",1,1,0,2,"dummy"
"261293",0,1,0,1,"dummy"
"261301",7,8,0,15,"dummy"
"261302",2,4,0,6,"dummy"
"261303",0,0,0,0,"dummy"
"261308",0,0,1,1,"dummy"
"261311",1,2,0,3,"dummy"
"261314",0,0,1,1,"dummy"
"261315",0,0,1,1,"dummy"
"261316",1,0,0,1,"dummy"
"261317",0,0,3,3,"dummy"
"261351",0,2,0,2,"dummy"
"261352",0,2,0,2,"dummy"
"261353",1,6,0,7,"dummy"
"261354",3,4,0,7,"dummy"
"261355",0,0,0,0,"dummy"
"261356",0,2,0,2,"dummy"
"261357",0,0,1,1,"dummy"
"261358",0,4,0,4,"dummy"
"261359",0,0,2,2,"dummy"
"261360",2,1,1,4,"dummy"
"261361",0,2,0,2,"dummy"
"261362",0,0,1,1,"dummy"
"261363",0,0,1,1,"dummy"
"261385",7,11,1,19,"dummy"
"261386",4,6,0,10,"dummy"
"261387",0,3,0,3,"dummy"
"261388",0,0,1,1,"dummy"
"261389",4,4,1,9,"dummy"
"261390",0,2,0,2,"dummy"
"261391",0,0,1,1,"dummy"
"261430",0,2,0,2,"dummy"
"261431",1,2,1,4,"dummy"
"261432",2,0,0,2,"dummy"
"261435",0,3,0,3,"dummy"
"261445",0,6,0,6,"dummy"
"261453",0,0,1,1,"dummy"
"261470",1,1,0,2,"dummy"
"261471",1,1,0,2,"dummy"
"261472",0,0,1,1,"dummy"
"261473",4,6,1,11,"dummy"
"261474",0,0,1,1,"dummy"
"261475",2,0,0,2,"dummy"
"261437",3,3,0,6,"dummy"
"261438",0,0,1,1,"dummy"
"261441",0,1,0,1,"dummy"
"261447",0,1,1,2,"dummy"
"261448",0,1,0,1,"dummy"
"261449",2,2,2,6,"dummy"
"261450",6,5,1,12,"dummy"
"261451",0,3,2,5,"dummy"
"261457",1,2,3,6,"dummy"
"261479",0,1,1,2,"dummy"
"261480",0,7,0,7,"dummy"
"261481",0,1,0,1,"dummy"
"261539",10,0,3,13,"dummy"
"261540",4,2,0,6,"dummy"
"261541",1,3,0,4,"dummy"
"261559",0,1,2,3,"dummy"
"261560",0,0,0,0,"dummy"
"261561",0,1,0,1,"dummy"
"261562",4,0,2,6,"dummy"
"261563",1,0,0,1,"dummy"
"261564",0,0,0,0,"dummy"
"261584",0,1,0,1,"dummy"
"261585",0,0,1,1,"dummy"
"261592",6,0,0,6,"dummy"
"261593",0,1,3,4,"dummy"
"261594",0,0,4,4,"dummy"
"261595",0,0,3,3,"dummy"
"261599",0,1,0,1,"dummy"
"261604",0,1,0,1,"dummy"
"261609",1,2,0,3,"dummy"
"261628",0,3,0,3,"dummy"
"261629",1,0,0,1,"dummy"
"261630",0,1,0,1,"dummy"
"261631",0,0,0,0,"dummy"
"261632",4,104,0,108,"dummy"
"261633",90,6,4,100,"dummy"
"261634",4,22,2,28,"dummy"
"261635",0,8,0,8,"dummy"
"261636",3,2,2,7,"dummy"
"261637",6,8,0,14,"dummy"
"261638",4,11,0,15,"dummy"
"261639",3,1,1,5,"dummy"
"261640",0,1,0,1,"dummy"
"261641",0,0,1,1,"dummy"
"261642",0,9,0,9,"dummy"
"261643",0,1,0,1,"dummy"
"261644",0,2,0,2,"dummy"
"261645",0,1,0,1,"dummy"
"261646",0,1,0,1,"dummy"
"261647",0,2,0,2,"dummy"
"261648",0,1,0,1,"dummy"
"261649",0,2,0,2,"dummy"
"261650",0,3,0,3,"dummy"
"261651",0,1,0,1,"dummy"
"261652",0,1,0,1,"dummy"
"261653",0,2,0,2,"dummy"
"261654",0,2,0,2,"dummy"
"261655",0,8,0,8,"dummy"
"261656",2,5,0,7,"dummy"
"261657",0,0,2,2,"dummy"
"261658",0,1,1,2,"dummy"
"261659",1,0,0,1,"dummy"
"261660",1,4,1,6,"dummy"
"261661",2,2,0,4,"dummy"
"261662",2,2,0,4,"dummy"
"261663",1,4,1,6,"dummy"
"261664",2,2,0,4,"dummy"
"261665",0,1,0,1,"dummy"
"261666",0,2,0,2,"dummy"
"261667",0,0,1,1,"dummy"
"261668",0,1,0,1,"dummy"
"261669",1,6,0,7,"dummy"
"261670",6,10,0,16,"dummy"
"261671",1,1,1,3,"dummy"
"261672",0,0,1,1,"dummy"
"261673",5,4,0,9,"dummy"
"261674",0,1,0,1,"dummy"
"261675",0,1,0,1,"dummy"
"261676",0,1,0,1,"dummy"
"261677",0,2,0,2,"dummy"
"261476",0,0,1,1,"dummy"
"261477",0,0,1,1,"dummy"
"261537",3,3,0,6,"dummy"
"261543",1,0,0,1,"dummy"
"261544",2,0,1,3,"dummy"
"261545",0,0,0,0,"dummy"
"261546",0,1,0,1,"dummy"
"261547",8,1,0,9,"dummy"
"261548",0,0,0,0,"dummy"
"261549",0,0,0,0,"dummy"
"261550",1,10,0,11,"dummy"
"261551",7,1,0,8,"dummy"
"261552",2,0,3,5,"dummy"
"261555",0,0,1,1,"dummy"
"261556",0,3,0,3,"dummy"
"261557",1,1,1,3,"dummy"
"261566",0,0,1,1,"dummy"
"261567",1,1,0,2,"dummy"
"261568",8,0,0,8,"dummy"
"261569",0,3,0,3,"dummy"
"261570",3,0,0,3,"dummy"
"261571",0,3,0,3,"dummy"
"261574",0,2,0,2,"dummy"
"261575",0,2,2,4,"dummy"
"261576",1,0,0,1,"dummy"
"261577",0,1,1,2,"dummy"
"261578",0,0,1,1,"dummy"
"261579",0,0,1,1,"dummy"
"261580",0,2,0,2,"dummy"
"261581",2,1,0,3,"dummy"
"261582",0,1,0,1,"dummy"
"261587",1,0,0,1,"dummy"
"261588",0,0,1,1,"dummy"
"261589",0,1,0,1,"dummy"
"261590",2,0,1,3,"dummy"
"261597",1,3,1,5,"dummy"
"261606",0,1,0,1,"dummy"
"261607",0,0,1,1,"dummy"
"261618",0,0,1,1,"dummy"
"261619",0,0,1,1,"dummy"
"261622",0,0,2,2,"dummy"
"261679",6,0,0,6,"dummy"
"261686",0,2,0,2,"dummy"
"261698",2,3,4,9,"dummy"
"261699",3,1,0,4,"dummy"
"261704",0,1,0,1,"dummy"
"261705",2,2,0,4,"dummy"
"261706",0,0,1,1,"dummy"
"261716",0,0,0,0,"dummy"
"261719",28,7,0,35,"dummy"
"261720",6,8,1,15,"dummy"
"261721",0,1,0,1,"dummy"
"261722",1,0,0,1,"dummy"
"261723",4,3,0,7,"dummy"
"261724",0,1,0,1,"dummy"
"261725",0,1,0,1,"dummy"
"261726",0,2,0,2,"dummy"
"261681",0,1,0,1,"dummy"
"261682",1,1,0,2,"dummy"
"261688",1,4,1,6,"dummy"
"261691",0,1,1,2,"dummy"
"261696",12,8,8,28,"dummy"
"261728",0,0,1,1,"dummy"
"261729",0,0,1,1,"dummy"
"261730",0,0,1,1,"dummy"
"261731",0,0,1,1,"dummy"
"261742",0,1,0,1,"dummy"
"261744",0,0,1,1,"dummy"
"261745",0,1,0,1,"dummy"
"261748",11,0,3,14,"dummy"
"261749",0,1,0,1,"dummy"
"261750",0,1,0,1,"dummy"
"261757",0,8,0,8,"dummy"
"261758",0,0,0,0,"dummy"
"261759",1,2,1,4,"dummy"
"261760",9,0,0,9,"dummy"
"261762",2,11,0,13,"dummy"
"261763",0,1,0,1,"dummy"
"261764",0,1,0,1,"dummy"
"261765",0,0,1,1,"dummy"
"261766",16,0,1,17,"dummy"
"261767",0,0,0,0,"dummy"
"261768",1,6,0,7,"dummy"
"261776",2,4,0,6,"dummy"
"261777",1,3,1,5,"dummy"
"261779",1,7,1,9,"dummy"
"261780",5,14,0,19,"dummy"
"261781",0,7,0,7,"dummy"
"261782",1,15,1,17,"dummy"
"261783",0,0,2,2,"dummy"
"261787",0,2,0,2,"dummy"
"261788",1,0,0,1,"dummy"
"261799",0,0,1,1,"dummy"
"261801",0,2,0,2,"dummy"
"261803",0,3,0,3,"dummy"
"261804",0,0,0,0,"dummy"
"261806",0,2,0,2,"dummy"
"261807",1,0,1,2,"dummy"
"261809",0,0,0,0,"dummy"
"261810",0,0,0,0,"dummy"
"261813",2,0,1,3,"dummy"
"261814",0,0,3,3,"dummy"
"261815",0,0,3,3,"dummy"
"261816",0,2,3,5,"dummy"
"261819",0,2,0,2,"dummy"
"261821",13,11,2,26,"dummy"
"261824",0,0,0,0,"dummy"
"261825",0,0,0,0,"dummy"
"261827",2,2,3,7,"dummy"
"261829",1,0,0,1,"dummy"
"261832",0,0,1,1,"dummy"
"261833",0,0,1,1,"dummy"
"261834",0,0,1,1,"dummy"
"261835",0,0,1,1,"dummy"
"261836",1,1,2,4,"dummy"
"261837",0,0,1,1,"dummy"
"261838",0,0,1,1,"dummy"
"261839",0,2,1,3,"dummy"
"261840",0,1,0,1,"dummy"
"261841",4,1,0,5,"dummy"
"261842",0,0,1,1,"dummy"
"261843",0,1,1,2,"dummy"
"261844",0,0,1,1,"dummy"
"261845",0,0,2,2,"dummy"
"261846",0,0,1,1,"dummy"
"261847",0,0,1,1,"dummy"
"261848",0,0,1,1,"dummy"
"261849",3,2,2,7,"dummy"
"261850",0,0,1,1,"dummy"
"261851",0,0,2,2,"dummy"
"261852",0,0,1,1,"dummy"
"261853",1,0,0,1,"dummy"
"261854",1,1,0,2,"dummy"
"261855",0,0,1,1,"dummy"
"261856",0,0,1,1,"dummy"
"261863",0,0,1,1,"dummy"
"261865",1,5,0,6,"dummy"
"261866",5,1,0,6,"dummy"
"261867",0,1,0,1,"dummy"
"261868",0,2,0,2,"dummy"
"261869",0,0,1,1,"dummy"
"261870",0,1,0,1,"dummy"
"261871",1,1,0,2,"dummy"
"261872",1,0,0,1,"dummy"
"261873",1,1,0,2,"dummy"
"261874",0,1,0,1,"dummy"
"261875",0,0,1,1,"dummy"
"261877",0,1,0,1,"dummy"
"261878",0,0,1,1,"dummy"
"261879",0,1,0,1,"dummy"
"261881",0,6,0,6,"dummy"
"261882",0,5,0,5,"dummy"
"261883",0,3,1,4,"dummy"
"261884",0,6,9,15,"dummy"
"261885",0,1,1,2,"dummy"
"261886",1,2,0,3,"dummy"
"261887",0,2,0,2,"dummy"
"261888",16,0,0,16,"dummy"
"261889",0,1,1,2,"dummy"
"261890",0,2,0,2,"dummy"
"261894",0,1,1,2,"dummy"
"261896",1,2,0,3,"dummy"
"261898",0,0,1,1,"dummy"
"261899",0,0,1,1,"dummy"
"261902",1,0,0,1,"dummy"
"261903",0,1,0,1,"dummy"
"261912",0,0,1,1,"dummy"
"261914",2,4,0,6,"dummy"
"261915",0,3,0,3,"dummy"
"261916",0,1,0,1,"dummy"
"261917",2,1,0,3,"dummy"
"261921",4,2,2,8,"dummy"
"261922",2,4,2,8,"dummy"
"261923",4,2,2,8,"dummy"
"261924",0,1,0,1,"dummy"
"261925",2,2,0,4,"dummy"
"261926",1,2,0,3,"dummy"
"261927",1,1,0,2,"dummy"
"261928",1,1,0,2,"dummy"
"261931",0,1,0,1,"dummy"
"261935",13,11,3,27,"dummy"
"261937",0,0,1,1,"dummy"
"261938",0,0,1,1,"dummy"
"261939",0,0,1,1,"dummy"
"261940",0,0,0,0,"dummy"
"261941",2,4,0,6,"dummy"
"261942",0,0,1,1,"dummy"
"261943",0,0,1,1,"dummy"
"261944",0,1,0,1,"dummy"
"261945",0,3,0,3,"dummy"
"261946",0,0,1,1,"dummy"
"261947",0,0,0,0,"dummy"
"261948",0,0,0,0,"dummy"
"261949",0,0,0,0,"dummy"
"261950",0,0,1,1,"dummy"
"261951",0,2,0,2,"dummy"
"261952",0,0,1,1,"dummy"
"261953",0,0,0,0,"dummy"
"261954",2,2,1,5,"dummy"
"261955",11,8,0,19,"dummy"
"261957",0,0,1,1,"dummy"
"261958",5,11,1,17,"dummy"
"261959",0,1,0,1,"dummy"
"261960",4,0,2,6,"dummy"
"261961",0,0,1,1,"dummy"
"261962",0,1,0,1,"dummy"
"261963",0,0,0,0,"dummy"
"261966",0,0,0,0,"dummy"
"261969",1,5,0,6,"dummy"
"261970",0,0,1,1,"dummy"
"261971",1,2,0,3,"dummy"
"261977",0,0,1,1,"dummy"
"261979",0,0,1,1,"dummy"
"261980",0,0,1,1,"dummy"
"261981",0,0,1,1,"dummy"
"261984",0,0,0,0,"dummy"
"261985",0,0,0,0,"dummy"
"261988",1,5,0,6,"dummy"
"261989",0,1,0,1,"dummy"
"261990",0,1,0,1,"dummy"
"261993",0,1,0,1,"dummy"
"261994",0,1,0,1,"dummy"
"261995",0,1,0,1,"dummy"
"261996",0,9,0,9,"dummy"
"261998",2,13,0,15,"dummy"
"261999",5,1,1,7,"dummy"
"262000",16,19,2,37,"dummy"
"262001",0,0,3,3,"dummy"
"262003",0,2,0,2,"dummy"
"262006",0,0,1,1,"dummy"
"262007",0,1,1,2,"dummy"
"262008",0,0,1,1,"dummy"
"262010",0,0,1,1,"dummy"
"262011",0,0,1,1,"dummy"
"262012",0,0,1,1,"dummy"
"262013",0,1,0,1,"dummy"
"262057",0,5,0,5,"dummy"
"262058",0,0,0,0,"dummy"
"262059",0,0,1,1,"dummy"
"262060",0,2,0,2,"dummy"
"262061",0,29,0,29,"dummy"
"262063",1,1,1,3,"dummy"
"262064",0,3,0,3,"dummy"
"262065",9,6,1,16,"dummy"
"262067",0,6,0,6,"dummy"
"262068",0,1,0,1,"dummy"
"262069",0,1,1,2,"dummy"
"262070",1,0,0,1,"dummy"
"262071",0,1,0,1,"dummy"
"262072",7,3,1,11,"dummy"
"262074",0,1,0,1,"dummy"
"262077",0,0,0,0,"dummy"
"262147",0,3,0,3,"dummy"
"262148",0,1,0,1,"dummy"
"262149",3,0,0,3,"dummy"
"262150",0,0,1,1,"dummy"
"262151",0,1,0,1,"dummy"
"262152",0,0,1,1,"dummy"
"262153",2,22,0,24,"dummy"
"262154",0,0,0,0,"dummy"
"262155",0,0,0,0,"dummy"
"262156",0,0,1,1,"dummy"
"262157",0,1,2,3,"dummy"
"262158",0,0,1,1,"dummy"
"262159",0,0,1,1,"dummy"
"262160",0,0,1,1,"dummy"
"262161",0,0,1,1,"dummy"
"262162",0,0,1,1,"dummy"
"262163",0,0,1,1,"dummy"
"262164",0,0,1,1,"dummy"
"262165",0,0,1,1,"dummy"
"262167",2,0,1,3,"dummy"
"262172",13,20,1,34,"dummy"
"262174",0,0,0,0,"dummy"
"262177",0,1,0,1,"dummy"
"262179",0,1,2,3,"dummy"
"262180",0,0,0,0,"dummy"
"262181",0,1,0,1,"dummy"
"262182",4,0,2,6,"dummy"
"262183",1,0,0,1,"dummy"
"262184",0,0,0,0,"dummy"
"262185",0,0,0,0,"dummy"
"262189",0,0,1,1,"dummy"
"262191",0,5,0,5,"dummy"
"262193",1,1,1,3,"dummy"
"262195",0,0,1,1,"dummy"
"262196",0,0,1,1,"dummy"
"262197",0,1,0,1,"dummy"
"262198",0,0,1,1,"dummy"
"262199",0,0,2,2,"dummy"
"262202",0,0,0,0,"dummy"
"262203",0,0,0,0,"dummy"
"262204",0,1,0,1,"dummy"
"262205",1,1,0,2,"dummy"
"262206",1,1,0,2,"dummy"
"262210",0,0,1,1,"dummy"
"262211",0,0,1,1,"dummy"
"262212",0,2,0,2,"dummy"
"262213",2,2,0,4,"dummy"
"262214",0,0,1,1,"dummy"
"262218",0,2,0,2,"dummy"
"262226",1,1,0,2,"dummy"
"262227",0,2,0,2,"dummy"
"262228",2,1,0,3,"dummy"
"262229",0,2,1,3,"dummy"
"262230",0,1,0,1,"dummy"
"262231",0,1,0,1,"dummy"
"262232",2,2,0,4,"dummy"
"262233",2,2,0,4,"dummy"
"262234",0,1,1,2,"dummy"
"262235",2,1,1,4,"dummy"
"262236",0,0,1,1,"dummy"
"262237",3,2,0,5,"dummy"
"262238",1,0,0,1,"dummy"
"262239",5,8,0,13,"dummy"
"262240",1,0,0,1,"dummy"
"262241",5,8,2,15,"dummy"
"262242",1,0,0,1,"dummy"
"262243",8,2,3,13,"dummy"
"262244",0,1,0,1,"dummy"
"262245",1,0,0,1,"dummy"
"262246",0,3,0,3,"dummy"
"262247",5,1,0,6,"dummy"
"262248",0,1,0,1,"dummy"
"262250",3,4,0,7,"dummy"
"262251",0,1,0,1,"dummy"
"262252",0,0,1,1,"dummy"
"262253",0,2,2,4,"dummy"
"262259",1,0,0,1,"dummy"
"262260",1,0,0,1,"dummy"
"262262",0,0,0,0,"dummy"
"262263",0,2,0,2,"dummy"
"262264",0,0,0,0,"dummy"
"262265",5,4,0,9,"dummy"
"262266",0,0,0,0,"dummy"
"262269",0,1,0,1,"dummy"
"262270",0,1,0,1,"dummy"
"262271",3,13,2,18,"dummy"
"262311",0,1,1,2,"dummy"
"262313",0,1,0,1,"dummy"
"262314",0,1,0,1,"dummy"
"262324",0,17,0,17,"dummy"
"262325",0,0,0,0,"dummy"
"262326",0,0,1,1,"dummy"
"262327",0,0,2,2,"dummy"
"262328",1,1,0,2,"dummy"
"262329",0,0,4,4,"dummy"
"262330",0,0,1,1,"dummy"
"262331",0,0,3,3,"dummy"
"262332",0,0,0,0,"dummy"
"262333",0,0,1,1,"dummy"
"262337",0,1,1,2,"dummy"
"262338",0,7,0,7,"dummy"
"262339",0,1,0,1,"dummy"
"262343",0,1,0,1,"dummy"
"262344",0,0,2,2,"dummy"
"262345",0,1,0,1,"dummy"
"262346",0,0,1,1,"dummy"
"262347",0,1,0,1,"dummy"
"262348",0,2,0,2,"dummy"
"262351",0,0,1,1,"dummy"
"262353",0,4,0,4,"dummy"
"262354",0,2,0,2,"dummy"
"262357",2,15,2,19,"dummy"
"262358",2,3,0,5,"dummy"
"262359",5,4,0,9,"dummy"
"262363",0,0,0,0,"dummy"
"262364",0,0,0,0,"dummy"
"262365",3,0,0,3,"dummy"
"262368",1,1,0,2,"dummy"
"262369",0,10,2,12,"dummy"
"262370",0,0,1,1,"dummy"
"262371",0,1,0,1,"dummy"
"262374",0,0,0,0,"dummy"
"262375",0,0,0,0,"dummy"
"262376",2,0,0,2,"dummy"
"262377",0,2,0,2,"dummy"
"262378",2,0,0,2,"dummy"
"262379",5,0,0,5,"dummy"
"262382",2,2,0,4,"dummy"
"262383",0,0,1,1,"dummy"
"262384",1,0,0,1,"dummy"
"262387",1,0,1,2,"dummy"
"262389",1,0,0,1,"dummy"
"262392",0,0,1,1,"dummy"
"262393",2,0,0,2,"dummy"
"262394",0,2,0,2,"dummy"
"262395",0,0,0,0,"dummy"
"262396",3,20,0,23,"dummy"
"262397",0,1,0,1,"dummy"
"262398",0,0,5,5,"dummy"
"262399",1,0,0,1,"dummy"
"262400",1,9,1,11,"dummy"
"262401",5,0,0,5,"dummy"
"262402",3,2,0,5,"dummy"
"262403",0,3,0,3,"dummy"
"262404",3,0,0,3,"dummy"
"262405",0,7,0,7,"dummy"
"262406",3,3,0,6,"dummy"
"262407",0,3,0,3,"dummy"
"262408",0,1,0,1,"dummy"
"262409",0,0,1,1,"dummy"
"262410",12,6,0,18,"dummy"
"262411",0,3,0,3,"dummy"
"262412",0,1,0,1,"dummy"
"262413",0,0,1,1,"dummy"
"262414",0,1,0,1,"dummy"
"262415",2,0,0,2,"dummy"
"262416",0,2,1,3,"dummy"
"262417",4,0,0,4,"dummy"
"262418",1,0,0,1,"dummy"
"262419",0,1,0,1,"dummy"
"262420",8,20,20,48,"dummy"
"262421",0,1,0,1,"dummy"
"262422",2,2,0,4,"dummy"
"262423",14,1,0,15,"dummy"
"262424",0,0,8,8,"dummy"
"262425",0,0,1,1,"dummy"
"262426",0,0,1,1,"dummy"
"262427",11,2,4,17,"dummy"
"262428",19,1,2,22,"dummy"
"262429",1,2,0,3,"dummy"
"262430",0,0,0,0,"dummy"
"262431",0,0,1,1,"dummy"
"262439",0,5,0,5,"dummy"
"262458",0,0,1,1,"dummy"
"262461",0,3,0,3,"dummy"
"262462",0,5,4,9,"dummy"
"262463",2,0,0,2,"dummy"
"262466",2,15,2,19,"dummy"
"262467",2,3,0,5,"dummy"
"262468",5,4,0,9,"dummy"
"262479",4,4,1,9,"dummy"
"262480",0,1,0,1,"dummy"
"262489",0,2,4,6,"dummy"
"262492",3,0,0,3,"dummy"
"262493",1,2,0,3,"dummy"
"262494",4,7,2,13,"dummy"
"262495",0,1,0,1,"dummy"
"262496",0,0,1,1,"dummy"
"262497",1,3,1,5,"dummy"
"262498",0,0,2,2,"dummy"
"262499",1,0,1,2,"dummy"
"262500",0,2,0,2,"dummy"
"262512",0,1,1,2,"dummy"
"262522",0,0,1,1,"dummy"
"262532",31,0,0,31,"dummy"
"262548",0,0,1,1,"dummy"
"262549",0,1,2,3,"dummy"
"262552",0,3,1,4,"dummy"
"262553",0,1,3,4,"dummy"
"262554",0,0,1,1,"dummy"
"262561",9,9,3,21,"dummy"
"262562",2,7,5,14,"dummy"
"262576",6,0,0,6,"dummy"
"262577",2,0,0,2,"dummy"
"262578",0,0,0,0,"dummy"
"262581",0,1,1,2,"dummy"
"262584",3,2,3,8,"dummy"
"262585",0,0,1,1,"dummy"
"262586",0,0,0,0,"dummy"
"262587",0,0,5,5,"dummy"
"262588",0,0,1,1,"dummy"
"262589",2,1,2,5,"dummy"
"262590",0,1,0,1,"dummy"
"262591",0,0,1,1,"dummy"
"262437",0,1,0,1,"dummy"
"262441",0,0,1,1,"dummy"
"262442",0,1,0,1,"dummy"
"262443",0,2,0,2,"dummy"
"262444",3,3,0,6,"dummy"
"262445",0,1,0,1,"dummy"
"262446",2,1,0,3,"dummy"
"262447",0,0,2,2,"dummy"
"262448",2,0,0,2,"dummy"
"262449",0,1,1,2,"dummy"
"262450",1,1,0,2,"dummy"
"262451",1,0,0,1,"dummy"
"262452",0,0,1,1,"dummy"
"262455",7,7,10,24,"dummy"
"262456",1,3,0,4,"dummy"
"262474",0,0,6,6,"dummy"
"262475",0,6,0,6,"dummy"
"262484",0,0,1,1,"dummy"
"262485",0,0,1,1,"dummy"
"262486",0,1,1,2,"dummy"
"262487",4,3,0,7,"dummy"
"262504",0,9,1,10,"dummy"
"262505",1,0,0,1,"dummy"
"262506",0,1,0,1,"dummy"
"262507",3,2,0,5,"dummy"
"262508",1,0,0,1,"dummy"
"262520",0,2,0,2,"dummy"
"262524",2,2,1,5,"dummy"
"262525",12,1,3,16,"dummy"
"262528",0,0,1,1,"dummy"
"262536",0,0,1,1,"dummy"
"262537",6,6,0,12,"dummy"
"262538",20,3,0,23,"dummy"
"262539",0,0,1,1,"dummy"
"262540",3,20,0,23,"dummy"
"262541",5,29,3,37,"dummy"
"262542",0,2,0,2,"dummy"
"262543",0,0,0,0,"dummy"
"262544",1,0,2,3,"dummy"
"262545",0,0,0,0,"dummy"
"262546",8,2,1,11,"dummy"
"262558",0,0,1,1,"dummy"
"262559",0,0,0,0,"dummy"
"262568",0,0,0,0,"dummy"
"262569",0,1,0,1,"dummy"
"262570",0,0,0,0,"dummy"
"262571",0,0,0,0,"dummy"
"262574",0,1,0,1,"dummy"
"262597",0,0,0,0,"dummy"
"262598",0,0,0,0,"dummy"
"262608",0,2,3,5,"dummy"
"262609",0,4,0,4,"dummy"
"262610",0,0,1,1,"dummy"
"262611",2,1,1,4,"dummy"
"262612",1,4,0,5,"dummy"
"262613",2,0,0,2,"dummy"
"262618",0,0,1,1,"dummy"
"262619",2,0,0,2,"dummy"
"262636",0,1,0,1,"dummy"
"262637",1,1,0,2,"dummy"
"262638",0,1,0,1,"dummy"
"262642",0,0,1,1,"dummy"
"262643",0,0,1,1,"dummy"
"262652",0,22,0,22,"dummy"
"262653",4,4,0,8,"dummy"
"262654",0,1,0,1,"dummy"
"262655",1,31,2,34,"dummy"
"262592",0,0,2,2,"dummy"
"262593",1,2,0,3,"dummy"
"262594",0,0,1,1,"dummy"
"262595",2,1,1,4,"dummy"
"262600",0,1,0,1,"dummy"
"262601",8,6,2,16,"dummy"
"262602",0,0,1,1,"dummy"
"262603",2,18,3,23,"dummy"
"262604",3,0,1,4,"dummy"
"262605",0,0,1,1,"dummy"
"262606",0,3,0,3,"dummy"
"262615",1,6,0,7,"dummy"
"262616",1,0,0,1,"dummy"
"262623",6,15,3,24,"dummy"
"262624",0,5,0,5,"dummy"
"262625",3,2,0,5,"dummy"
"262626",0,2,0,2,"dummy"
"262627",2,0,0,2,"dummy"
"262628",22,0,0,22,"dummy"
"262629",0,1,0,1,"dummy"
"262630",0,15,4,19,"dummy"
"262631",15,0,3,18,"dummy"
"262632",0,0,1,1,"dummy"
"262633",0,0,1,1,"dummy"
"262634",0,13,3,16,"dummy"
"262640",0,0,1,1,"dummy"
"262647",0,1,1,2,"dummy"
"262662",1,3,5,9,"dummy"
"262663",2,0,0,2,"dummy"
"262669",0,0,1,1,"dummy"
"262698",3,6,1,10,"dummy"
"262701",1,0,0,1,"dummy"
"262702",41,8,3,52,"dummy"
"262703",4,4,3,11,"dummy"
"262704",8,41,3,52,"dummy"
"262705",25,0,0,25,"dummy"
"262706",0,7,0,7,"dummy"
"262707",1,4,0,5,"dummy"
"262708",1,2,1,4,"dummy"
"262709",0,8,0,8,"dummy"
"262710",0,1,2,3,"dummy"
"262711",9,15,5,29,"dummy"
"262712",0,0,1,1,"dummy"
"262713",1,0,0,1,"dummy"
"262714",5,5,1,11,"dummy"
"262715",0,0,0,0,"dummy"
"262716",4,3,5,12,"dummy"
"262717",0,0,0,0,"dummy"
"262718",0,1,0,1,"dummy"
"262719",0,1,0,1,"dummy"
"262720",7,9,0,16,"dummy"
"262721",2,0,1,3,"dummy"
"262722",0,1,0,1,"dummy"
"262723",0,1,0,1,"dummy"
"262724",0,3,0,3,"dummy"
"262725",19,4,0,23,"dummy"
"262726",3,2,0,5,"dummy"
"262741",0,0,2,2,"dummy"
"262750",0,0,1,1,"dummy"
"262751",1,1,0,2,"dummy"
"262752",5,0,0,5,"dummy"
"262753",2,0,0,2,"dummy"
"262754",2,6,0,8,"dummy"
"262755",5,0,0,5,"dummy"
"262756",10,4,3,17,"dummy"
"262757",4,10,3,17,"dummy"
"262758",8,4,2,14,"dummy"
"262759",1,0,0,1,"dummy"
"262760",1,0,1,2,"dummy"
"262770",2,1,0,3,"dummy"
"262771",0,4,0,4,"dummy"
"262772",1,2,0,3,"dummy"
"262773",0,0,1,1,"dummy"
"262774",0,1,0,1,"dummy"
"262775",0,1,0,1,"dummy"
"262776",0,1,0,1,"dummy"
"262777",0,0,0,0,"dummy"
"262778",0,1,1,2,"dummy"
"262660",8,8,0,16,"dummy"
"262665",2,1,2,5,"dummy"
"262666",1,3,3,7,"dummy"
"262667",0,0,0,0,"dummy"
"262728",0,3,0,3,"dummy"
"262729",2,0,0,2,"dummy"
"262732",1,0,2,3,"dummy"
"262733",0,0,1,1,"dummy"
"262734",0,0,1,1,"dummy"
"262735",0,0,1,1,"dummy"
"262736",0,0,1,1,"dummy"
"262737",0,0,1,1,"dummy"
"262738",0,0,1,1,"dummy"
"262739",0,0,1,1,"dummy"
"262745",0,0,0,0,"dummy"
"262746",4,7,0,11,"dummy"
"262747",0,0,0,0,"dummy"
"262748",0,0,1,1,"dummy"
"262762",0,1,0,1,"dummy"
"262763",0,0,3,3,"dummy"
"262764",0,0,3,3,"dummy"
"262765",0,4,0,4,"dummy"
"262766",4,0,0,4,"dummy"
"262767",0,0,3,3,"dummy"
"262768",0,0,3,3,"dummy"
"262791",3,9,0,12,"dummy"
"262794",0,3,4,7,"dummy"
"262795",3,0,2,5,"dummy"
"262796",1,0,1,2,"dummy"
"262869",2,1,0,3,"dummy"
"262870",3,1,1,5,"dummy"
"262881",0,0,1,1,"dummy"
"262885",0,2,2,4,"dummy"
"262886",0,1,0,1,"dummy"
"262887",0,0,2,2,"dummy"
"262918",4,6,1,11,"dummy"
"262972",0,3,3,6,"dummy"
"262973",1,0,0,1,"dummy"
"262974",0,1,2,3,"dummy"
"262986",0,0,2,2,"dummy"
"262987",8,3,1,12,"dummy"
"262988",1,3,2,6,"dummy"
"262989",7,7,0,14,"dummy"
"262990",0,0,0,0,"dummy"
"262991",6,5,0,11,"dummy"
"262992",0,0,2,2,"dummy"
"262993",0,1,1,2,"dummy"
"262994",2,2,0,4,"dummy"
"262995",15,0,2,17,"dummy"
"262996",0,0,1,1,"dummy"
"262997",1,0,0,1,"dummy"
"262998",0,2,1,3,"dummy"
"262999",0,1,0,1,"dummy"
"263000",0,0,0,0,"dummy"
"262779",0,1,0,1,"dummy"
"262780",0,0,1,1,"dummy"
"262781",0,0,1,1,"dummy"
"262782",0,0,1,1,"dummy"
"262783",0,0,5,5,"dummy"
"262784",2,6,5,13,"dummy"
"262785",0,1,0,1,"dummy"
"262786",0,1,0,1,"dummy"
"262787",6,0,0,6,"dummy"
"262798",0,2,0,2,"dummy"
"262799",0,0,1,1,"dummy"
"262872",0,0,1,1,"dummy"
"262873",0,0,1,1,"dummy"
"262874",0,0,0,0,"dummy"
"262875",6,10,0,16,"dummy"
"262876",3,4,0,7,"dummy"
"262877",7,13,6,26,"dummy"
"262878",0,0,5,5,"dummy"
"262879",0,0,2,2,"dummy"
"262883",0,1,0,1,"dummy"
"262889",1,0,1,2,"dummy"
"262890",0,0,0,0,"dummy"
"262895",0,5,0,5,"dummy"
"262896",1,2,3,6,"dummy"
"262897",1,7,1,9,"dummy"
"262898",0,1,0,1,"dummy"
"262899",2,7,0,9,"dummy"
"262900",0,0,1,1,"dummy"
"262901",0,0,3,3,"dummy"
"262902",0,0,1,1,"dummy"
"262903",0,0,1,1,"dummy"
"262904",0,0,1,1,"dummy"
"262905",0,0,1,1,"dummy"
"262906",1,0,0,1,"dummy"
"262907",0,0,1,1,"dummy"
"262908",0,0,2,2,"dummy"
"262909",0,0,1,1,"dummy"
"262910",0,0,1,1,"dummy"
"262911",0,0,1,1,"dummy"
"262912",0,0,1,1,"dummy"
"262913",0,0,2,2,"dummy"
"262914",0,0,2,2,"dummy"
"262915",0,0,1,1,"dummy"
"262916",0,0,1,1,"dummy"
"262980",0,0,3,3,"dummy"
"262983",0,1,2,3,"dummy"
"262984",0,0,1,1,"dummy"
"263009",1,2,4,7,"dummy"
"263010",0,1,0,1,"dummy"
"263011",2,5,0,7,"dummy"
"263012",0,2,0,2,"dummy"
"263015",0,2,1,3,"dummy"
"263016",4,8,0,12,"dummy"
"263017",0,4,1,5,"dummy"
"263018",0,5,0,5,"dummy"
"263019",2,2,0,4,"dummy"
"263020",0,0,1,1,"dummy"
"263029",4,10,1,15,"dummy"
"263030",4,10,1,15,"dummy"
"263034",0,0,1,1,"dummy"
"263041",1,0,0,1,"dummy"
"263063",8,37,1,46,"dummy"
"263067",6,0,4,10,"dummy"
"263068",0,6,4,10,"dummy"
"263069",1,0,1,2,"dummy"
"263085",0,3,0,3,"dummy"
"263086",4,4,0,8,"dummy"
"263087",0,5,0,5,"dummy"
"263088",0,0,1,1,"dummy"
"263001",0,0,0,0,"dummy"
"263022",0,3,0,3,"dummy"
"263032",0,0,1,1,"dummy"
"263038",0,0,1,1,"dummy"
"263039",0,0,1,1,"dummy"
"263043",0,1,0,1,"dummy"
"263044",0,0,1,1,"dummy"
"263045",0,2,0,2,"dummy"
"263046",8,1,5,14,"dummy"
"263047",1,1,0,2,"dummy"
"263048",0,0,1,1,"dummy"
"263054",0,0,1,1,"dummy"
"263055",0,2,0,2,"dummy"
"263056",0,0,1,1,"dummy"
"263057",1,1,0,2,"dummy"
"263065",0,2,0,2,"dummy"
"263075",2,5,3,10,"dummy"
"263078",0,10,0,10,"dummy"
"263081",0,1,0,1,"dummy"
"263092",2,26,4,32,"dummy"
"263093",26,2,4,32,"dummy"
"263094",0,2,0,2,"dummy"
"263095",3,21,2,26,"dummy"
"263096",2,0,0,2,"dummy"
"263097",1,1,0,2,"dummy"
"263098",8,7,2,17,"dummy"
"263099",0,3,0,3,"dummy"
"263100",5,5,0,10,"dummy"
"263101",0,2,0,2,"dummy"
"263102",6,3,0,9,"dummy"
"263103",0,2,0,2,"dummy"
"263104",0,2,0,2,"dummy"
"263105",0,1,0,1,"dummy"
"263106",2,2,2,6,"dummy"
"263107",1,0,1,2,"dummy"
"263108",1,0,0,1,"dummy"
"263109",1,1,0,2,"dummy"
"263110",1,1,0,2,"dummy"
"263111",2,1,0,3,"dummy"
"263112",1,3,0,4,"dummy"
"263113",5,5,0,10,"dummy"
"263114",6,1,0,7,"dummy"
"263115",1,0,0,1,"dummy"
"263116",0,1,0,1,"dummy"
"263117",2,4,0,6,"dummy"
"263118",0,0,1,1,"dummy"
"263119",0,1,0,1,"dummy"
"263120",0,1,0,1,"dummy"
"263121",0,1,0,1,"dummy"
"263122",0,2,0,2,"dummy"
"263135",0,0,1,1,"dummy"
"263136",0,1,2,3,"dummy"
"263124",39,1,0,40,"dummy"
"263125",3,0,0,3,"dummy"
"263126",13,9,5,27,"dummy"
"263127",4,1,0,5,"dummy"
"263128",1,1,0,2,"dummy"
"263190",0,1,0,1,"dummy"
"263191",1,2,0,3,"dummy"
"263192",0,0,2,2,"dummy"
"263193",2,1,0,3,"dummy"
"263194",0,0,1,1,"dummy"
"263195",1,1,0,2,"dummy"
"263196",3,5,2,10,"dummy"
"263197",0,0,1,1,"dummy"
"263198",0,1,0,1,"dummy"
"263199",0,0,1,1,"dummy"
"263200",0,1,0,1,"dummy"
"263202",2,1,0,3,"dummy"
"263203",0,2,0,2,"dummy"
"263204",1,0,0,1,"dummy"
"263205",0,0,0,0,"dummy"
"263206",0,0,0,0,"dummy"
"263209",1,2,2,5,"dummy"
"263211",0,1,0,1,"dummy"
"263212",1,1,0,2,"dummy"
"263218",0,2,0,2,"dummy"
"263219",0,8,0,8,"dummy"
"263221",0,2,0,2,"dummy"
"263222",2,3,1,6,"dummy"
"263224",0,0,1,1,"dummy"
"263225",0,1,0,1,"dummy"
"263228",0,0,1,1,"dummy"
"263229",1,0,0,1,"dummy"
"263230",0,3,0,3,"dummy"
"263231",0,4,1,5,"dummy"
"263233",2,0,1,3,"dummy"
"263234",4,3,1,8,"dummy"
"263235",0,0,1,1,"dummy"
"263238",1,0,0,1,"dummy"
"263239",0,1,0,1,"dummy"
"263240",0,4,0,4,"dummy"
"263241",0,0,0,0,"dummy"
"263249",0,2,0,2,"dummy"
"263250",0,2,0,2,"dummy"
"263253",0,1,0,1,"dummy"
"263254",0,0,0,0,"dummy"
"263255",0,1,0,1,"dummy"
"263257",0,1,0,1,"dummy"
"263258",1,0,1,2,"dummy"
"263261",2,0,3,5,"dummy"
"263262",1,0,0,1,"dummy"
"263263",0,1,0,1,"dummy"
"263264",0,1,1,2,"dummy"
"263267",0,0,1,1,"dummy"
"263269",0,1,3,4,"dummy"
"263271",0,2,3,5,"dummy"
"263272",1,1,0,2,"dummy"
"263273",0,0,1,1,"dummy"
"263275",0,0,5,5,"dummy"
"263276",1,0,1,2,"dummy"
"263281",0,1,2,3,"dummy"
"263282",0,0,0,0,"dummy"
"263283",0,2,0,2,"dummy"
"263284",5,0,2,7,"dummy"
"263285",1,0,0,1,"dummy"
"263288",0,2,0,2,"dummy"
"263289",2,2,3,7,"dummy"
"263291",2,0,3,5,"dummy"
"263297",0,1,0,1,"dummy"
"263298",0,1,0,1,"dummy"
"263299",2,0,0,2,"dummy"
"263300",0,0,1,1,"dummy"
"263301",0,0,1,1,"dummy"
"263302",1,0,0,1,"dummy"
"263303",0,0,1,1,"dummy"
"263304",0,0,1,1,"dummy"
"263305",0,0,1,1,"dummy"
"263308",0,0,0,0,"dummy"
"263310",0,1,0,1,"dummy"
"263313",2,0,0,2,"dummy"
"263318",5,0,1,6,"dummy"
"263319",1,0,0,1,"dummy"
"263323",2,0,0,2,"dummy"
"263325",0,1,0,1,"dummy"
"263326",0,0,0,0,"dummy"
"263329",3,4,1,8,"dummy"
"263330",3,1,1,5,"dummy"
"263332",0,0,3,3,"dummy"
"263335",0,0,2,2,"dummy"
"263338",0,0,0,0,"dummy"
"263339",0,0,0,0,"dummy"
"263340",0,0,0,0,"dummy"
"263341",0,0,0,0,"dummy"
"263350",3,1,2,6,"dummy"
"263352",2,3,3,8,"dummy"
"263354",0,0,2,2,"dummy"
"263356",0,0,1,1,"dummy"
"263365",1,16,0,17,"dummy"
"263366",0,0,1,1,"dummy"
"263368",0,2,0,2,"dummy"
"263369",0,1,0,1,"dummy"
"263370",0,0,1,1,"dummy"
"263371",5,0,0,5,"dummy"
"263374",0,1,2,3,"dummy"
"263375",0,0,1,1,"dummy"
"263376",0,1,2,3,"dummy"
"263377",1,0,2,3,"dummy"
"263378",0,0,1,1,"dummy"
"263379",1,0,2,3,"dummy"
"263392",0,2,0,2,"dummy"
"263395",2,3,0,5,"dummy"
"263396",2,2,0,4,"dummy"
"263397",0,7,0,7,"dummy"
"263398",9,4,0,13,"dummy"
"263399",0,0,0,0,"dummy"
"263400",4,8,0,12,"dummy"
"263401",2,12,1,15,"dummy"
"263402",2,3,0,5,"dummy"
"263403",0,5,0,5,"dummy"
"263404",0,1,1,2,"dummy"
"263405",0,1,0,1,"dummy"
"263406",1,2,0,3,"dummy"
"263407",2,2,0,4,"dummy"
"263408",5,9,0,14,"dummy"
"263409",0,2,0,2,"dummy"
"263410",3,1,0,4,"dummy"
"263411",0,0,1,1,"dummy"
"263412",0,3,0,3,"dummy"
"263413",3,1,0,4,"dummy"
"263414",0,1,0,1,"dummy"
"263415",0,2,0,2,"dummy"
"263416",3,4,0,7,"dummy"
"263417",2,3,0,5,"dummy"
"263418",4,0,2,6,"dummy"
"263419",1,0,1,2,"dummy"
"263420",2,0,0,2,"dummy"
"263421",10,0,0,10,"dummy"
"263422",0,5,0,5,"dummy"
"263423",1,0,0,1,"dummy"
"263424",0,0,0,0,"dummy"
"263425",3,2,0,5,"dummy"
"263426",0,1,1,2,"dummy"
"263427",0,4,1,5,"dummy"
"263428",0,2,0,2,"dummy"
"263429",0,2,0,2,"dummy"
"263430",3,0,0,3,"dummy"
"263431",0,1,0,1,"dummy"
"263432",3,1,0,4,"dummy"
"263433",0,2,0,2,"dummy"
"263434",0,2,0,2,"dummy"
"263435",0,6,0,6,"dummy"
"263436",0,1,0,1,"dummy"
"263437",0,2,0,2,"dummy"
"263438",0,0,0,0,"dummy"
"263439",0,2,0,2,"dummy"
"263440",1,2,0,3,"dummy"
"263441",0,2,2,4,"dummy"
"263445",0,0,1,1,"dummy"
"263446",0,0,1,1,"dummy"
"263447",0,0,1,1,"dummy"
"263448",0,0,1,1,"dummy"
"263449",0,0,1,1,"dummy"
"263450",0,0,4,4,"dummy"
"263451",0,0,1,1,"dummy"
"263452",0,0,1,1,"dummy"
"263453",0,0,1,1,"dummy"
"263454",0,0,1,1,"dummy"
"263457",0,19,0,19,"dummy"
"263458",15,9,3,27,"dummy"
"263459",9,15,3,27,"dummy"
"263460",0,0,0,0,"dummy"
"263461",0,2,1,3,"dummy"
"263476",0,1,0,1,"dummy"
"263485",2,0,2,4,"dummy"
"263492",0,0,1,1,"dummy"
"263493",1,4,0,5,"dummy"
"263506",0,0,1,1,"dummy"
"263507",1,0,0,1,"dummy"
"263510",0,1,0,1,"dummy"
"263511",0,0,0,0,"dummy"
"263514",5,3,0,8,"dummy"
"263515",0,1,0,1,"dummy"
"263516",0,5,0,5,"dummy"
"263517",3,0,0,3,"dummy"
"263547",0,2,0,2,"dummy"
"263548",0,2,0,2,"dummy"
"263549",19,0,3,22,"dummy"
"263559",0,1,0,1,"dummy"
"263571",0,2,0,2,"dummy"
"263575",0,0,0,0,"dummy"
"263576",0,16,0,16,"dummy"
"263577",0,5,0,5,"dummy"
"263620",0,1,0,1,"dummy"
"263621",0,1,0,1,"dummy"
"263672",2,3,1,6,"dummy"
"263673",16,11,4,31,"dummy"
"263674",0,4,0,4,"dummy"
"263675",0,1,0,1,"dummy"
"263676",0,2,1,3,"dummy"
"263684",1,0,0,1,"dummy"
"263687",2,5,2,9,"dummy"
"263694",0,1,0,1,"dummy"
"263695",0,1,0,1,"dummy"
"263443",0,0,1,1,"dummy"
"263478",1,0,0,1,"dummy"
"263479",0,1,0,1,"dummy"
"263480",3,2,0,5,"dummy"
"263481",1,0,0,1,"dummy"
"263495",0,2,1,3,"dummy"
"263496",0,0,0,0,"dummy"
"263497",0,2,0,2,"dummy"
"263498",3,0,3,6,"dummy"
"263499",0,2,0,2,"dummy"
"263500",1,0,1,2,"dummy"
"263501",0,0,1,1,"dummy"
"263504",2,0,2,4,"dummy"
"263544",2,0,0,2,"dummy"
"263545",2,0,0,2,"dummy"
"263553",0,0,1,1,"dummy"
"263554",0,0,2,2,"dummy"
"263555",1,1,0,2,"dummy"
"263556",0,0,3,3,"dummy"
"263557",0,0,2,2,"dummy"
"263561",1,4,0,5,"dummy"
"263562",0,1,0,1,"dummy"
"263563",0,4,0,4,"dummy"
"263564",0,2,0,2,"dummy"
"263565",0,1,0,1,"dummy"
"263566",3,6,0,9,"dummy"
"263567",1,1,4,6,"dummy"
"263568",10,0,0,10,"dummy"
"263569",2,0,0,2,"dummy"
"263573",0,0,1,1,"dummy"
"263586",0,0,3,3,"dummy"
"263608",2,0,1,3,"dummy"
"263609",0,0,1,1,"dummy"
"263610",3,6,1,10,"dummy"
"263611",0,1,0,1,"dummy"
"263612",0,0,1,1,"dummy"
"263615",0,0,1,1,"dummy"
"263616",0,0,2,2,"dummy"
"263617",2,5,0,7,"dummy"
"263618",9,3,6,18,"dummy"
"263625",0,0,1,1,"dummy"
"263626",0,0,1,1,"dummy"
"263627",1,0,1,2,"dummy"
"263669",3,5,1,9,"dummy"
"263670",7,9,0,16,"dummy"
"263680",0,0,1,1,"dummy"
"263689",2,0,0,2,"dummy"
"263690",0,0,1,1,"dummy"
"263691",0,2,0,2,"dummy"
"263692",13,5,5,23,"dummy"
"263756",0,1,0,1,"dummy"
"263757",2,0,2,4,"dummy"
"263763",2,8,3,13,"dummy"
"263696",2,2,0,4,"dummy"
"263697",0,0,1,1,"dummy"
"263698",0,0,1,1,"dummy"
"263699",2,2,1,5,"dummy"
"263700",1,1,1,3,"dummy"
"263701",1,3,0,4,"dummy"
"263702",1,1,1,3,"dummy"
"263703",1,0,0,1,"dummy"
"263704",0,2,0,2,"dummy"
"263705",2,2,0,4,"dummy"
"263706",0,1,0,1,"dummy"
"263707",0,1,0,1,"dummy"
"263708",4,0,2,6,"dummy"
"263709",10,1,2,13,"dummy"
"263710",2,5,1,8,"dummy"
"263711",0,2,0,2,"dummy"
"263712",0,0,1,1,"dummy"
"263713",0,1,0,1,"dummy"
"263714",1,0,1,2,"dummy"
"263715",0,1,0,1,"dummy"
"263716",0,0,1,1,"dummy"
"263717",0,0,0,0,"dummy"
"263718",0,0,1,1,"dummy"
"263719",0,2,0,2,"dummy"
"263720",0,0,1,1,"dummy"
"263721",0,0,1,1,"dummy"
"263722",0,0,1,1,"dummy"
"263723",0,0,1,1,"dummy"
"263724",0,0,1,1,"dummy"
"263725",0,0,1,1,"dummy"
"263761",0,1,0,1,"dummy"
"263785",2,2,2,6,"dummy"
"263786",0,1,2,3,"dummy"
"263787",1,2,2,5,"dummy"
"263788",5,4,1,10,"dummy"
"263789",0,0,1,1,"dummy"
"263793",6,1,2,9,"dummy"
"263794",2,3,0,5,"dummy"
"263799",1,0,0,1,"dummy"
"263800",1,0,0,1,"dummy"
"263801",1,0,0,1,"dummy"
"263802",0,1,0,1,"dummy"
"263803",1,0,0,1,"dummy"
"263809",1,1,2,4,"dummy"
"263810",1,0,0,1,"dummy"
"263813",0,0,1,1,"dummy"
"263818",0,0,1,1,"dummy"
"263819",0,27,0,27,"dummy"
"263820",5,3,1,9,"dummy"
"263821",6,0,0,6,"dummy"
"263822",1,5,0,6,"dummy"
"263823",0,2,0,2,"dummy"
"263824",0,36,0,36,"dummy"
"263825",1,4,0,5,"dummy"
"263826",1,0,0,1,"dummy"
"263827",19,0,0,19,"dummy"
"263828",4,9,0,13,"dummy"
"263829",9,4,0,13,"dummy"
"263830",7,11,0,18,"dummy"
"263831",5,0,0,5,"dummy"
"263832",0,5,0,5,"dummy"
"263833",0,0,1,1,"dummy"
"263834",1,0,1,2,"dummy"
"263835",0,2,0,2,"dummy"
"263836",0,1,1,2,"dummy"
"263837",0,0,2,2,"dummy"
"263838",0,0,1,1,"dummy"
"263839",0,0,1,1,"dummy"
"263840",0,0,2,2,"dummy"
"263844",0,1,0,1,"dummy"
"263847",0,1,0,1,"dummy"
"263850",0,0,2,2,"dummy"
"263855",0,3,0,3,"dummy"
"263871",0,1,0,1,"dummy"
"263872",9,2,0,11,"dummy"
"263873",1,2,0,3,"dummy"
"263874",0,1,0,1,"dummy"
"263875",1,0,0,1,"dummy"
"263887",0,0,0,0,"dummy"
"263888",0,0,0,0,"dummy"
"263891",1,0,0,1,"dummy"
"263894",0,2,2,4,"dummy"
"263895",4,4,1,9,"dummy"
"263896",1,2,0,3,"dummy"
"263897",0,1,0,1,"dummy"
"263898",1,0,0,1,"dummy"
"263899",0,1,0,1,"dummy"
"263900",0,0,2,2,"dummy"
"263764",0,4,0,4,"dummy"
"263765",0,1,0,1,"dummy"
"263766",1,4,0,5,"dummy"
"263769",3,2,1,6,"dummy"
"263772",0,0,0,0,"dummy"
"263773",9,10,0,19,"dummy"
"263774",2,3,1,6,"dummy"
"263775",0,2,0,2,"dummy"
"263776",0,1,1,2,"dummy"
"263777",0,8,0,8,"dummy"
"263778",0,5,0,5,"dummy"
"263779",1,5,0,6,"dummy"
"263780",0,2,0,2,"dummy"
"263781",1,0,0,1,"dummy"
"263782",0,0,0,0,"dummy"
"263783",0,1,0,1,"dummy"
"263791",0,2,0,2,"dummy"
"263796",0,2,0,2,"dummy"
"263797",0,1,0,1,"dummy"
"263807",11,13,5,29,"dummy"
"263815",0,1,0,1,"dummy"
"263816",2,1,0,3,"dummy"
"263842",33,0,2,35,"dummy"
"263852",2,0,0,2,"dummy"
"263853",0,0,0,0,"dummy"
"263884",0,2,0,2,"dummy"
"263885",8,8,0,16,"dummy"
"263905",4,5,2,11,"dummy"
"263908",0,2,0,2,"dummy"
"263909",1,1,0,2,"dummy"
"263910",1,21,3,25,"dummy"
"263911",0,1,0,1,"dummy"
"263912",22,1,3,26,"dummy"
"263913",1,24,4,29,"dummy"
"263914",0,3,0,3,"dummy"
"263915",0,1,0,1,"dummy"
"263918",0,0,2,2,"dummy"
"263919",0,0,1,1,"dummy"
"263920",1,0,0,1,"dummy"
"263921",6,6,0,12,"dummy"
"263922",0,0,2,2,"dummy"
"263923",0,0,1,1,"dummy"
"263924",0,0,1,1,"dummy"
"263925",0,0,1,1,"dummy"
"263926",0,0,0,0,"dummy"
"263927",5,0,0,5,"dummy"
"263937",0,3,1,4,"dummy"
"263938",1,0,0,1,"dummy"
"263939",0,1,0,1,"dummy"
"263947",0,0,0,0,"dummy"
"263952",0,0,1,1,"dummy"
"263953",1,9,6,16,"dummy"
"263954",0,2,0,2,"dummy"
"263955",0,0,0,0,"dummy"
"263962",1,0,0,1,"dummy"
"263963",0,0,1,1,"dummy"
"263986",0,0,1,1,"dummy"
"263987",0,8,0,8,"dummy"
"263988",4,0,3,7,"dummy"
"264015",0,2,0,2,"dummy"
"264016",0,0,2,2,"dummy"
"264017",0,0,0,0,"dummy"
"264021",2,2,11,15,"dummy"
"264022",0,0,1,1,"dummy"
"264023",0,1,4,5,"dummy"
"264028",0,1,0,1,"dummy"
"263901",0,2,3,5,"dummy"
"263929",2,1,1,4,"dummy"
"263930",0,0,2,2,"dummy"
"263931",0,0,1,1,"dummy"
"263932",0,0,2,2,"dummy"
"263933",0,0,1,1,"dummy"
"263941",0,7,4,11,"dummy"
"263942",1,0,0,1,"dummy"
"263943",2,5,2,9,"dummy"
"263944",0,0,1,1,"dummy"
"263945",6,7,4,17,"dummy"
"263949",0,1,0,1,"dummy"
"263950",1,1,0,2,"dummy"
"263960",2,1,1,4,"dummy"
"263965",0,0,0,0,"dummy"
"263966",0,1,0,1,"dummy"
"263983",1,1,0,2,"dummy"
"263984",0,1,0,1,"dummy"
"263990",1,3,1,5,"dummy"
"263991",0,0,1,1,"dummy"
"263992",0,12,1,13,"dummy"
"264019",0,0,0,0,"dummy"
"264048",0,3,0,3,"dummy"
"264049",0,2,0,2,"dummy"
"264050",0,1,1,2,"dummy"
"264051",0,3,1,4,"dummy"
"264052",0,2,0,2,"dummy"
"264053",11,0,3,14,"dummy"
"264054",0,1,0,1,"dummy"
"264055",0,2,0,2,"dummy"
"264056",0,0,1,1,"dummy"
"264059",0,0,1,1,"dummy"
"264060",0,0,1,1,"dummy"
"264061",0,2,0,2,"dummy"
"264062",3,8,1,12,"dummy"
"264063",0,1,0,1,"dummy"
"264064",0,0,1,1,"dummy"
"264070",0,1,0,1,"dummy"
"264077",0,0,2,2,"dummy"
"264078",3,0,0,3,"dummy"
"264085",0,2,0,2,"dummy"
"264086",0,1,0,1,"dummy"
"264087",0,1,0,1,"dummy"
"264088",0,0,1,1,"dummy"
"264089",0,3,0,3,"dummy"
"264090",0,1,0,1,"dummy"
"264091",0,0,0,0,"dummy"
"264092",0,1,0,1,"dummy"
"264093",0,2,0,2,"dummy"
"264094",0,0,2,2,"dummy"
"264095",0,6,0,6,"dummy"
"264096",4,3,0,7,"dummy"
"264097",3,3,1,7,"dummy"
"264098",0,0,0,0,"dummy"
"264099",0,0,0,0,"dummy"
"264100",0,2,0,2,"dummy"
"264101",1,0,0,1,"dummy"
"264102",0,1,0,1,"dummy"
"264103",0,1,0,1,"dummy"
"264104",0,1,0,1,"dummy"
"264105",1,0,0,1,"dummy"
"264106",0,1,2,3,"dummy"
"264107",4,4,0,8,"dummy"
"264108",0,0,1,1,"dummy"
"264109",0,1,0,1,"dummy"
"264110",1,0,0,1,"dummy"
"264111",0,2,0,2,"dummy"
"264112",0,0,0,0,"dummy"
"264113",0,1,0,1,"dummy"
"264114",4,0,0,4,"dummy"
"264115",0,1,0,1,"dummy"
"264116",2,0,0,2,"dummy"
"264117",0,1,0,1,"dummy"
"264118",0,0,3,3,"dummy"
"264119",2,0,0,2,"dummy"
"264120",3,0,0,3,"dummy"
"264121",1,0,0,1,"dummy"
"264122",0,0,1,1,"dummy"
"264123",1,0,0,1,"dummy"
"264124",1,0,0,1,"dummy"
"264125",0,2,1,3,"dummy"
"264068",0,1,0,1,"dummy"
"264143",0,1,0,1,"dummy"
"264144",0,10,0,10,"dummy"
"264145",2,0,0,2,"dummy"
"264148",10,15,1,26,"dummy"
"264149",2,1,1,4,"dummy"
"264150",0,0,1,1,"dummy"
"264151",0,8,0,8,"dummy"
"264152",4,4,0,8,"dummy"
"264153",0,6,3,9,"dummy"
"264154",10,1,3,14,"dummy"
"264155",14,10,3,27,"dummy"
"264156",5,18,1,24,"dummy"
"264157",18,5,5,28,"dummy"
"264158",6,17,6,29,"dummy"
"264159",17,5,5,27,"dummy"
"264160",5,19,5,29,"dummy"
"264161",2,3,1,6,"dummy"
"264162",6,1,0,7,"dummy"
"264163",1,0,1,2,"dummy"
"264164",0,3,0,3,"dummy"
"264165",0,1,0,1,"dummy"
"264166",18,8,2,28,"dummy"
"264167",0,2,0,2,"dummy"
"264168",1,1,1,3,"dummy"
"264169",5,6,5,16,"dummy"
"264170",3,1,1,5,"dummy"
"264171",0,0,0,0,"dummy"
"264172",0,0,1,1,"dummy"
"264173",1,0,1,2,"dummy"
"264174",0,1,0,1,"dummy"
"264175",1,0,0,1,"dummy"
"264184",0,0,1,1,"dummy"
"264196",0,2,0,2,"dummy"
"264197",0,2,2,4,"dummy"
"264198",0,1,0,1,"dummy"
"264199",0,2,2,4,"dummy"
"264200",3,2,1,6,"dummy"
"264201",2,5,0,7,"dummy"
"264202",2,1,0,3,"dummy"
"264203",0,3,0,3,"dummy"
"264204",3,0,0,3,"dummy"
"264205",0,1,0,1,"dummy"
"264206",0,1,0,1,"dummy"
"264207",1,0,0,1,"dummy"
"264208",0,1,0,1,"dummy"
"264222",1,12,2,15,"dummy"
"264228",0,0,0,0,"dummy"
"264254",2,1,2,5,"dummy"
"264261",5,0,2,7,"dummy"
"264265",0,2,0,2,"dummy"
"264268",1,1,0,2,"dummy"
"264272",6,0,0,6,"dummy"
"264273",2,5,2,9,"dummy"
"264292",0,4,0,4,"dummy"
"264126",0,0,1,1,"dummy"
"264127",0,0,0,0,"dummy"
"264128",0,2,0,2,"dummy"
"264141",0,1,0,1,"dummy"
"264186",0,1,0,1,"dummy"
"264187",0,7,0,7,"dummy"
"264188",5,5,1,11,"dummy"
"264189",1,0,2,3,"dummy"
"264190",0,1,0,1,"dummy"
"264193",0,3,3,6,"dummy"
"264194",0,2,0,2,"dummy"
"264220",1,0,0,1,"dummy"
"264224",0,0,0,0,"dummy"
"264225",0,4,1,5,"dummy"
"264226",3,9,1,13,"dummy"
"264234",1,6,2,9,"dummy"
"264235",0,11,1,12,"dummy"
"264236",1,1,0,2,"dummy"
"264237",1,0,0,1,"dummy"
"264238",0,2,0,2,"dummy"
"264239",13,10,0,23,"dummy"
"264240",0,2,0,2,"dummy"
"264241",8,5,0,13,"dummy"
"264249",0,0,0,0,"dummy"
"264250",6,4,2,12,"dummy"
"264251",3,2,0,5,"dummy"
"264252",0,4,0,4,"dummy"
"264257",3,9,0,12,"dummy"
"264263",0,0,1,1,"dummy"
"264270",0,0,0,0,"dummy"
"264275",0,8,1,9,"dummy"
"264276",0,2,0,2,"dummy"
"264287",7,5,1,13,"dummy"
"264288",0,3,1,4,"dummy"
"264294",0,2,1,3,"dummy"
"264298",0,0,1,1,"dummy"
"264299",0,0,1,1,"dummy"
"264300",0,4,1,5,"dummy"
"264301",4,7,0,11,"dummy"
"264302",0,1,0,1,"dummy"
"264316",1,0,0,1,"dummy"
"264317",0,2,0,2,"dummy"
"264318",1,0,0,1,"dummy"
"264319",1,2,3,6,"dummy"
"264320",1,0,0,1,"dummy"
"264321",5,0,0,5,"dummy"
"264340",9,7,3,19,"dummy"
"264341",0,0,0,0,"dummy"
"264342",0,1,0,1,"dummy"
"264343",0,0,0,0,"dummy"
"264344",2,5,0,7,"dummy"
"264345",0,2,0,2,"dummy"
"264346",0,3,0,3,"dummy"
"264347",1,1,0,2,"dummy"
"264348",0,0,2,2,"dummy"
"264349",5,0,0,5,"dummy"
"264360",1,1,0,2,"dummy"
"264361",0,0,2,2,"dummy"
"264362",1,0,0,1,"dummy"
"264383",1,0,2,3,"dummy"
"264408",0,1,0,1,"dummy"
"264430",0,0,3,3,"dummy"
"264296",0,2,0,2,"dummy"
"264304",0,1,0,1,"dummy"
"264307",0,1,0,1,"dummy"
"264308",0,5,0,5,"dummy"
"264309",0,0,1,1,"dummy"
"264310",1,0,0,1,"dummy"
"264323",1,0,2,3,"dummy"
"264324",0,1,1,2,"dummy"
"264325",0,2,0,2,"dummy"
"264326",1,0,1,2,"dummy"
"264327",2,3,1,6,"dummy"
"264328",5,3,0,8,"dummy"
"264329",4,4,0,8,"dummy"
"264330",0,3,0,3,"dummy"
"264331",2,3,1,6,"dummy"
"264332",12,19,10,41,"dummy"
"264333",2,9,2,13,"dummy"
"264334",0,0,1,1,"dummy"
"264335",1,1,0,2,"dummy"
"264336",0,0,0,0,"dummy"
"264337",0,0,2,2,"dummy"
"264338",1,0,0,1,"dummy"
"264351",2,4,0,6,"dummy"
"264352",0,2,0,2,"dummy"
"264353",0,2,0,2,"dummy"
"264354",10,2,0,12,"dummy"
"264355",0,2,0,2,"dummy"
"264356",0,0,0,0,"dummy"
"264357",0,0,3,3,"dummy"
"264358",0,5,0,5,"dummy"
"264370",0,0,2,2,"dummy"
"264371",0,6,1,7,"dummy"
"264372",0,0,0,0,"dummy"
"264373",2,10,1,13,"dummy"
"264374",0,5,0,5,"dummy"
"264375",0,2,0,2,"dummy"
"264376",0,0,1,1,"dummy"
"264377",0,1,0,1,"dummy"
"264378",1,0,4,5,"dummy"
"264379",0,3,0,3,"dummy"
"264380",1,0,0,1,"dummy"
"264381",0,0,0,0,"dummy"
"264385",1,0,0,1,"dummy"
"264386",8,8,0,16,"dummy"
"264387",0,1,0,1,"dummy"
"264388",0,1,0,1,"dummy"
"264453",0,4,0,4,"dummy"
"264466",0,0,1,1,"dummy"
"264467",0,0,1,1,"dummy"
"264470",0,5,2,7,"dummy"
"264471",0,5,0,5,"dummy"
"264472",0,1,2,3,"dummy"
"264473",0,2,0,2,"dummy"
"264474",0,1,0,1,"dummy"
"264475",0,1,0,1,"dummy"
"264435",0,0,1,1,"dummy"
"264436",0,1,1,2,"dummy"
"264437",0,0,1,1,"dummy"
"264438",0,3,0,3,"dummy"
"264439",0,1,0,1,"dummy"
"264440",10,4,0,14,"dummy"
"264441",0,8,0,8,"dummy"
"264442",0,0,0,0,"dummy"
"264443",0,0,0,0,"dummy"
"264444",2,4,1,7,"dummy"
"264445",0,0,0,0,"dummy"
"264446",0,1,0,1,"dummy"
"264447",0,0,0,0,"dummy"
"264448",0,0,0,0,"dummy"
"264449",0,0,1,1,"dummy"
"264450",0,0,0,0,"dummy"
"264451",0,0,0,0,"dummy"
"264455",0,0,1,1,"dummy"
"264458",0,0,1,1,"dummy"
"264461",0,0,1,1,"dummy"
"264485",2,2,0,4,"dummy"
"264486",1,2,1,4,"dummy"
"264487",5,2,0,7,"dummy"
"264488",0,0,1,1,"dummy"
"264489",0,1,1,2,"dummy"
"264490",0,4,0,4,"dummy"
"264491",3,0,1,4,"dummy"
"264492",0,0,1,1,"dummy"
"264493",0,0,5,5,"dummy"
"264494",2,2,0,4,"dummy"
"264495",4,12,2,18,"dummy"
"264496",16,1,2,19,"dummy"
"264497",0,0,0,0,"dummy"
"264498",0,1,0,1,"dummy"
"264499",0,1,0,1,"dummy"
"264500",0,1,0,1,"dummy"
"264501",0,0,1,1,"dummy"
"264502",1,0,1,2,"dummy"
"264503",0,15,1,16,"dummy"
"264504",2,0,0,2,"dummy"
"264505",9,4,0,13,"dummy"
"264506",0,0,0,0,"dummy"
"264507",0,0,0,0,"dummy"
"264508",1,6,0,7,"dummy"
"264509",0,1,0,1,"dummy"
"264510",0,0,0,0,"dummy"
"264511",0,1,0,1,"dummy"
"264512",0,0,0,0,"dummy"
"264513",0,0,1,1,"dummy"
"264514",0,0,0,0,"dummy"
"264515",0,0,1,1,"dummy"
"264516",0,1,0,1,"dummy"
"264517",5,0,0,5,"dummy"
"264520",0,1,0,1,"dummy"
"264521",0,0,0,0,"dummy"
"264522",2,2,2,6,"dummy"
"264527",3,3,0,6,"dummy"
"264532",0,3,0,3,"dummy"
"264533",0,0,1,1,"dummy"
"264535",0,0,1,1,"dummy"
"264536",0,1,0,1,"dummy"
"264537",0,1,0,1,"dummy"
"264538",1,0,0,1,"dummy"
"264540",0,0,1,1,"dummy"
"264543",2,3,0,5,"dummy"
"264544",0,6,0,6,"dummy"
"264545",0,2,1,3,"dummy"
"264547",0,1,0,1,"dummy"
"264548",1,0,0,1,"dummy"
"264549",3,5,3,11,"dummy"
"264550",2,0,0,2,"dummy"
"264552",1,2,0,3,"dummy"
"264553",0,0,1,1,"dummy"
"264554",0,1,0,1,"dummy"
"264555",2,3,0,5,"dummy"
"264556",0,0,0,0,"dummy"
"264557",0,0,1,1,"dummy"
"264559",0,1,0,1,"dummy"
"264560",5,9,0,14,"dummy"
"264561",0,0,4,4,"dummy"
"264563",1,0,0,1,"dummy"
"264564",18,0,0,18,"dummy"
"264565",0,14,0,14,"dummy"
"264566",2,2,1,5,"dummy"
"264568",0,10,0,10,"dummy"
"264569",10,10,0,20,"dummy"
"264570",1,2,2,5,"dummy"
"264572",0,4,0,4,"dummy"
"264573",0,25,0,25,"dummy"
"264574",0,1,0,1,"dummy"
"264575",0,4,0,4,"dummy"
"264576",0,2,0,2,"dummy"
"264577",1,0,1,2,"dummy"
"264589",0,0,1,1,"dummy"
"264590",3,2,0,5,"dummy"
"264591",0,0,2,2,"dummy"
"264592",0,0,1,1,"dummy"
"264596",0,4,0,4,"dummy"
"264620",0,31,0,31,"dummy"
"264621",0,2,0,2,"dummy"
"264622",0,2,0,2,"dummy"
"264623",2,1,1,4,"dummy"
"264627",0,0,1,1,"dummy"
"264628",0,0,1,1,"dummy"
"264629",0,2,1,3,"dummy"
"264631",0,0,1,1,"dummy"
"264641",0,0,1,1,"dummy"
"264642",1,0,0,1,"dummy"
"264650",2,1,1,4,"dummy"
"264652",0,2,4,6,"dummy"
"264654",0,0,1,1,"dummy"
"264655",0,0,1,1,"dummy"
"264656",0,0,1,1,"dummy"
"264657",0,0,0,0,"dummy"
"264658",0,1,0,1,"dummy"
"264659",0,0,1,1,"dummy"
"264660",0,1,1,2,"dummy"
"264661",0,0,1,1,"dummy"
"264662",0,0,1,1,"dummy"
"264663",0,0,1,1,"dummy"
"264668",1,2,0,3,"dummy"
"264669",0,0,0,0,"dummy"
"264670",0,0,0,0,"dummy"
"264671",0,0,0,0,"dummy"
"264672",0,0,3,3,"dummy"
"264673",2,2,1,5,"dummy"
"264675",29,37,3,69,"dummy"
"264676",0,7,1,8,"dummy"
"264677",2,15,1,18,"dummy"
"264680",1,3,0,4,"dummy"
"264681",0,5,0,5,"dummy"
"264684",4,3,0,7,"dummy"
"264688",1,2,1,4,"dummy"
"264691",0,3,0,3,"dummy"
"264692",2,10,0,12,"dummy"
"264693",0,0,0,0,"dummy"
"264699",0,0,0,0,"dummy"
"264714",1,0,0,1,"dummy"
"264715",0,1,0,1,"dummy"
"264720",0,0,1,1,"dummy"
"264721",0,0,1,1,"dummy"
"264722",0,0,1,1,"dummy"
"264723",0,0,1,1,"dummy"
"264724",0,0,1,1,"dummy"
"264725",0,0,1,1,"dummy"
"264726",0,0,1,1,"dummy"
"264728",0,0,1,1,"dummy"
"264729",29,2,1,32,"dummy"
"264730",1,0,0,1,"dummy"
"264732",0,0,1,1,"dummy"
"264733",0,0,1,1,"dummy"
"264734",0,0,1,1,"dummy"
"264735",2,1,0,3,"dummy"
"264739",0,2,0,2,"dummy"
"264740",0,1,0,1,"dummy"
"264741",0,1,0,1,"dummy"
"264742",0,1,0,1,"dummy"
"264743",1,0,0,1,"dummy"
"264744",0,1,0,1,"dummy"
"264745",0,0,1,1,"dummy"
"264763",0,1,0,1,"dummy"
"264764",0,1,0,1,"dummy"
"264768",0,1,1,2,"dummy"
"264769",0,2,0,2,"dummy"
"264770",9,2,0,11,"dummy"
"264773",0,1,0,1,"dummy"
"264774",0,1,0,1,"dummy"
"264775",0,0,0,0,"dummy"
"264779",0,3,0,3,"dummy"
"264780",0,0,2,2,"dummy"
"264782",0,1,0,1,"dummy"
"264783",0,3,3,6,"dummy"
"264784",3,0,0,3,"dummy"
"264785",5,6,2,13,"dummy"
"264786",0,17,5,22,"dummy"
"264787",1,0,3,4,"dummy"
"264788",0,1,0,1,"dummy"
"264789",0,2,8,10,"dummy"
"264790",0,9,4,13,"dummy"
"264792",2,4,0,6,"dummy"
"264793",1,3,0,4,"dummy"
"264794",0,4,0,4,"dummy"
"264795",0,0,1,1,"dummy"
"264799",6,0,0,6,"dummy"
"264800",2,5,2,9,"dummy"
"264802",0,9,2,11,"dummy"
"264803",14,1,1,16,"dummy"
"264806",22,30,0,52,"dummy"
"264807",0,10,0,10,"dummy"
"264808",0,0,0,0,"dummy"
"264809",0,1,1,2,"dummy"
"264810",1,4,1,6,"dummy"
"264812",0,0,1,1,"dummy"
"264813",0,0,1,1,"dummy"
"264872",0,0,0,0,"dummy"
"264873",0,0,0,0,"dummy"
"264874",0,0,0,0,"dummy"
"264880",0,1,0,1,"dummy"
"264883",3,4,0,7,"dummy"
"264884",0,3,0,3,"dummy"
"264885",4,12,3,19,"dummy"
"264886",0,6,0,6,"dummy"
"264892",0,6,0,6,"dummy"
"264897",0,0,2,2,"dummy"
"264898",0,0,1,1,"dummy"
"264899",1,27,2,30,"dummy"
"264900",6,11,0,17,"dummy"
"264901",0,1,0,1,"dummy"
"264902",0,3,0,3,"dummy"
"264903",7,25,0,32,"dummy"
"264904",3,6,0,9,"dummy"
"264905",28,5,1,34,"dummy"
"264906",1,1,0,2,"dummy"
"264907",0,1,0,1,"dummy"
"264908",0,0,1,1,"dummy"
"264909",1,1,0,2,"dummy"
"264910",0,0,0,0,"dummy"
"264916",4,9,0,13,"dummy"
"264933",0,0,1,1,"dummy"
"264934",0,0,1,1,"dummy"
"264935",1,0,0,1,"dummy"
"264936",0,0,1,1,"dummy"
"264941",0,1,0,1,"dummy"
"264942",0,0,1,1,"dummy"
"264945",0,0,1,1,"dummy"
"264950",2,0,3,5,"dummy"
"264956",0,1,0,1,"dummy"
"264973",1,0,1,2,"dummy"
"264974",1,0,0,1,"dummy"
"264975",3,0,0,3,"dummy"
"264976",1,0,0,1,"dummy"
"264977",0,0,1,1,"dummy"
"264978",0,0,0,0,"dummy"
"264979",0,2,0,2,"dummy"
"264980",0,1,3,4,"dummy"
"265003",7,5,0,12,"dummy"
"265011",4,5,1,10,"dummy"
"264858",1,3,1,5,"dummy"
"264859",15,21,8,44,"dummy"
"264860",15,3,5,23,"dummy"
"264861",3,15,5,23,"dummy"
"264862",7,21,5,33,"dummy"
"264863",8,9,1,18,"dummy"
"264864",5,0,3,8,"dummy"
"264865",0,2,0,2,"dummy"
"264866",19,6,6,31,"dummy"
"264888",0,25,1,26,"dummy"
"264894",0,1,0,1,"dummy"
"264895",0,0,1,1,"dummy"
"264912",2,1,0,3,"dummy"
"264913",0,2,1,3,"dummy"
"264914",0,0,0,0,"dummy"
"264920",1,2,0,3,"dummy"
"264921",2,4,1,7,"dummy"
"264922",0,0,0,0,"dummy"
"264923",4,0,0,4,"dummy"
"264924",0,0,0,0,"dummy"
"264925",0,0,0,0,"dummy"
"264926",0,0,1,1,"dummy"
"264927",0,0,3,3,"dummy"
"264928",0,0,1,1,"dummy"
"264929",2,0,0,2,"dummy"
"264930",1,5,3,9,"dummy"
"264931",2,1,0,3,"dummy"
"264954",0,0,1,1,"dummy"
"264958",0,0,0,0,"dummy"
"264982",0,1,0,1,"dummy"
"264983",0,0,1,1,"dummy"
"264984",1,1,0,2,"dummy"
"264985",0,0,1,1,"dummy"
"264986",0,0,0,0,"dummy"
"264987",1,0,0,1,"dummy"
"264988",13,2,1,16,"dummy"
"264989",0,2,0,2,"dummy"
"264990",2,0,0,2,"dummy"
"264991",0,2,1,3,"dummy"
"264992",1,0,0,1,"dummy"
"264993",0,0,2,2,"dummy"
"264994",2,8,0,10,"dummy"
"264995",0,4,0,4,"dummy"
"264996",2,1,0,3,"dummy"
"264997",5,6,0,11,"dummy"
"264998",2,2,2,6,"dummy"
"264999",0,1,0,1,"dummy"
"265000",5,1,2,8,"dummy"
"265001",0,0,1,1,"dummy"
"265009",3,3,0,6,"dummy"
"265030",5,15,0,20,"dummy"
"265031",0,0,1,1,"dummy"
"265044",0,5,0,5,"dummy"
"265047",0,2,2,4,"dummy"
"265048",33,13,0,46,"dummy"
"265049",0,0,1,1,"dummy"
"265050",0,0,1,1,"dummy"
"265079",0,8,0,8,"dummy"
"265080",0,0,1,1,"dummy"
"265090",1,0,0,1,"dummy"
"265091",2,3,2,7,"dummy"
"265102",0,0,1,1,"dummy"
"265103",0,0,2,2,"dummy"
"265104",2,0,0,2,"dummy"
"265105",0,1,0,1,"dummy"
"265012",0,0,1,1,"dummy"
"265013",3,4,0,7,"dummy"
"265014",6,12,0,18,"dummy"
"265022",0,1,0,1,"dummy"
"265023",6,9,4,19,"dummy"
"265026",0,0,1,1,"dummy"
"265027",0,0,1,1,"dummy"
"265028",0,0,1,1,"dummy"
"265033",7,17,6,30,"dummy"
"265034",0,0,1,1,"dummy"
"265035",4,1,1,6,"dummy"
"265036",0,0,0,0,"dummy"
"265037",0,1,2,3,"dummy"
"265052",3,1,3,7,"dummy"
"265053",0,0,1,1,"dummy"
"265056",0,1,0,1,"dummy"
"265057",8,8,1,17,"dummy"
"265060",0,1,0,1,"dummy"
"265061",0,1,0,1,"dummy"
"265062",0,0,1,1,"dummy"
"265063",0,0,2,2,"dummy"
"265064",0,1,0,1,"dummy"
"265065",0,0,1,1,"dummy"
"265066",0,0,1,1,"dummy"
"265067",1,0,0,1,"dummy"
"265068",0,1,0,1,"dummy"
"265069",1,0,0,1,"dummy"
"265072",0,7,0,7,"dummy"
"265073",0,1,2,3,"dummy"
"265076",0,0,1,1,"dummy"
"265077",6,10,7,23,"dummy"
"265084",0,0,1,1,"dummy"
"265085",0,0,1,1,"dummy"
"265086",0,0,1,1,"dummy"
"265087",0,0,1,1,"dummy"
"265088",0,0,1,1,"dummy"
"265096",0,0,3,3,"dummy"
"265097",0,2,0,2,"dummy"
"265098",0,2,2,4,"dummy"
"265099",6,1,1,8,"dummy"
"265100",0,0,0,0,"dummy"
"265107",0,2,0,2,"dummy"
"265108",0,1,0,1,"dummy"
"265109",1,0,2,3,"dummy"
"265110",0,0,1,1,"dummy"
"265111",0,2,0,2,"dummy"
"265112",0,1,0,1,"dummy"
"265113",0,0,0,0,"dummy"
"265122",0,1,0,1,"dummy"
"265134",2,2,0,4,"dummy"
"265139",0,1,0,1,"dummy"
"265167",1,0,0,1,"dummy"
"265178",0,1,1,2,"dummy"
"265179",0,0,1,1,"dummy"
"265182",0,0,1,1,"dummy"
"265187",1,11,1,13,"dummy"
"265192",0,0,1,1,"dummy"
"265193",0,0,1,1,"dummy"
"265194",0,1,0,1,"dummy"
"265195",0,1,0,1,"dummy"
"265196",0,2,0,2,"dummy"
"265197",2,0,0,2,"dummy"
"265198",1,1,2,4,"dummy"
"265199",1,0,1,2,"dummy"
"265208",0,1,0,1,"dummy"
"265209",1,4,0,5,"dummy"
"265210",12,5,3,20,"dummy"
"265211",0,8,2,10,"dummy"
"265212",0,1,0,1,"dummy"
"265213",0,1,0,1,"dummy"
"265214",0,1,0,1,"dummy"
"265215",0,1,1,2,"dummy"
"265216",3,2,2,7,"dummy"
"265217",0,1,0,1,"dummy"
"265218",0,1,0,1,"dummy"
"265219",0,1,0,1,"dummy"
"265220",2,2,0,4,"dummy"
"265115",0,0,1,1,"dummy"
"265116",0,0,1,1,"dummy"
"265131",2,1,2,5,"dummy"
"265132",6,5,1,12,"dummy"
"265136",0,0,1,1,"dummy"
"265137",0,0,3,3,"dummy"
"265165",4,2,0,6,"dummy"
"265171",0,1,2,3,"dummy"
"265172",0,1,0,1,"dummy"
"265173",0,0,1,1,"dummy"
"265174",0,1,0,1,"dummy"
"265175",0,3,0,3,"dummy"
"265176",0,0,0,0,"dummy"
"265189",0,0,2,2,"dummy"
"265190",0,0,2,2,"dummy"
"265201",1,4,2,7,"dummy"
"265232",0,1,0,1,"dummy"
"265233",1,10,0,11,"dummy"
"265234",0,0,1,1,"dummy"
"265235",0,0,1,1,"dummy"
"265236",0,0,1,1,"dummy"
"265237",0,0,1,1,"dummy"
"265238",2,0,0,2,"dummy"
"265248",0,4,0,4,"dummy"
"265249",7,11,1,19,"dummy"
"265255",0,0,1,1,"dummy"
"265256",0,11,1,12,"dummy"
"265257",2,1,1,4,"dummy"
"265258",1,2,1,4,"dummy"
"265259",0,0,1,1,"dummy"
"265260",0,1,1,2,"dummy"
"265261",1,1,0,2,"dummy"
"265262",0,1,0,1,"dummy"
"265263",0,2,0,2,"dummy"
"265264",0,2,0,2,"dummy"
"265265",2,1,0,3,"dummy"
"265266",1,1,1,3,"dummy"
"265267",1,0,0,1,"dummy"
"265268",0,1,0,1,"dummy"
"265269",0,0,1,1,"dummy"
"265272",0,0,0,0,"dummy"
"265273",0,25,0,25,"dummy"
"265274",0,1,0,1,"dummy"
"265275",0,4,0,4,"dummy"
"265276",0,2,0,2,"dummy"
"265277",1,0,1,2,"dummy"
"265326",0,0,3,3,"dummy"
"265327",0,0,1,1,"dummy"
"265328",1,3,0,4,"dummy"
"265329",0,0,1,1,"dummy"
"265330",0,0,1,1,"dummy"
"265331",0,1,0,1,"dummy"
"265332",0,0,1,1,"dummy"
"265333",0,2,0,2,"dummy"
"265334",0,0,1,1,"dummy"
"265335",0,2,1,3,"dummy"
"265336",0,0,1,1,"dummy"
"265337",1,0,1,2,"dummy"
"265338",0,0,1,1,"dummy"
"265339",0,1,1,2,"dummy"
"265340",0,0,1,1,"dummy"
"265341",0,0,1,1,"dummy"
"265358",0,0,1,1,"dummy"
"265407",0,1,0,1,"dummy"
"265412",0,0,2,2,"dummy"
"265424",0,8,2,10,"dummy"
"265425",0,2,0,2,"dummy"
"265428",1,0,0,1,"dummy"
"265431",2,2,2,6,"dummy"
"265221",3,1,2,6,"dummy"
"265222",0,1,0,1,"dummy"
"265223",6,6,0,12,"dummy"
"265224",0,0,1,1,"dummy"
"265225",0,1,0,1,"dummy"
"265226",5,4,3,12,"dummy"
"265227",0,4,3,7,"dummy"
"265228",0,0,1,1,"dummy"
"265229",1,1,0,2,"dummy"
"265230",0,1,0,1,"dummy"
"265240",2,0,0,2,"dummy"
"265243",1,0,1,2,"dummy"
"265244",1,1,0,2,"dummy"
"265245",0,0,2,2,"dummy"
"265246",0,1,0,1,"dummy"
"265253",0,4,0,4,"dummy"
"265279",5,9,0,14,"dummy"
"265280",0,1,0,1,"dummy"
"265281",0,0,1,1,"dummy"
"265282",0,1,0,1,"dummy"
"265283",0,0,2,2,"dummy"
"265284",0,1,0,1,"dummy"
"265285",0,2,0,2,"dummy"
"265286",0,1,0,1,"dummy"
"265287",1,1,0,2,"dummy"
"265288",0,0,1,1,"dummy"
"265289",3,0,0,3,"dummy"
"265290",0,4,0,4,"dummy"
"265291",0,1,0,1,"dummy"
"265292",19,9,4,32,"dummy"
"265293",0,1,0,1,"dummy"
"265294",0,1,1,2,"dummy"
"265295",0,1,0,1,"dummy"
"265296",1,1,0,2,"dummy"
"265318",0,0,1,1,"dummy"
"265324",0,1,0,1,"dummy"
"265345",2,2,0,4,"dummy"
"265346",0,1,0,1,"dummy"
"265347",1,0,0,1,"dummy"
"265348",0,1,0,1,"dummy"
"265349",0,0,1,1,"dummy"
"265350",0,2,0,2,"dummy"
"265351",0,0,1,1,"dummy"
"265352",0,1,0,1,"dummy"
"265353",0,0,0,0,"dummy"
"265354",0,3,0,3,"dummy"
"265355",3,0,1,4,"dummy"
"265356",0,3,0,3,"dummy"
"265360",0,0,1,1,"dummy"
"265361",0,0,1,1,"dummy"
"265362",0,0,1,1,"dummy"
"265363",0,0,1,1,"dummy"
"265364",0,0,1,1,"dummy"
"265365",0,0,0,0,"dummy"
"265366",0,1,0,1,"dummy"
"265367",0,0,1,1,"dummy"
"265368",0,0,0,0,"dummy"
"265369",0,0,0,0,"dummy"
"265370",0,2,0,2,"dummy"
"265371",0,0,0,0,"dummy"
"265372",0,3,0,3,"dummy"
"265373",0,0,1,1,"dummy"
"265374",1,3,0,4,"dummy"
"265375",0,0,1,1,"dummy"
"265376",0,1,0,1,"dummy"
"265377",0,0,1,1,"dummy"
"265378",0,0,0,0,"dummy"
"265379",0,0,1,1,"dummy"
"265380",0,0,1,1,"dummy"
"265381",0,0,1,1,"dummy"
"265382",0,0,1,1,"dummy"
"265390",0,4,3,7,"dummy"
"265391",2,4,1,7,"dummy"
"265392",3,2,0,5,"dummy"
"265393",0,4,0,4,"dummy"
"265394",0,1,1,2,"dummy"
"265395",0,1,1,2,"dummy"
"265396",0,1,0,1,"dummy"
"265397",2,3,2,7,"dummy"
"265398",0,2,0,2,"dummy"
"265399",0,0,1,1,"dummy"
"265414",0,1,2,3,"dummy"
"265415",3,5,2,10,"dummy"
"265416",1,14,4,19,"dummy"
"265417",10,1,0,11,"dummy"
"265418",0,0,0,0,"dummy"
"265419",0,0,0,0,"dummy"
"265420",0,4,0,4,"dummy"
"265421",4,1,0,5,"dummy"
"265422",0,1,0,1,"dummy"
"265470",0,0,2,2,"dummy"
"265471",2,1,1,4,"dummy"
"265472",0,2,0,2,"dummy"
"265475",0,0,0,0,"dummy"
"265476",0,0,0,0,"dummy"
"265481",0,0,3,3,"dummy"
"265482",0,1,0,1,"dummy"
"265486",0,1,1,2,"dummy"
"265491",0,0,0,0,"dummy"
"265492",0,1,0,1,"dummy"
"265493",0,0,2,2,"dummy"
"265494",0,0,1,1,"dummy"
"265495",0,2,0,2,"dummy"
"265508",0,1,0,1,"dummy"
"265509",1,0,0,1,"dummy"
"265510",0,0,1,1,"dummy"
"265511",0,0,1,1,"dummy"
"265512",4,6,4,14,"dummy"
"265513",0,2,0,2,"dummy"
"265514",0,0,1,1,"dummy"
"265515",0,7,1,8,"dummy"
"265516",0,0,1,1,"dummy"
"265517",1,0,0,1,"dummy"
"265520",0,0,0,0,"dummy"
"265521",0,1,0,1,"dummy"
"265522",0,0,0,0,"dummy"
"265523",0,0,0,0,"dummy"
"265524",0,13,0,13,"dummy"
"265525",15,16,3,34,"dummy"
"265526",5,2,7,14,"dummy"
"265548",0,0,1,1,"dummy"
"265549",0,0,1,1,"dummy"
"265563",0,2,0,2,"dummy"
"265564",1,1,1,3,"dummy"
"265565",0,2,0,2,"dummy"
"265566",0,2,0,2,"dummy"
"265567",0,1,1,2,"dummy"
"265568",0,1,0,1,"dummy"
"265569",0,0,1,1,"dummy"
"265570",2,1,4,7,"dummy"
"265577",7,0,4,11,"dummy"
"265586",1,0,0,1,"dummy"
"265598",1,0,0,1,"dummy"
"265599",0,3,0,3,"dummy"
"265600",3,1,0,4,"dummy"
"265601",0,0,3,3,"dummy"
"265602",0,0,0,0,"dummy"
"265603",0,0,1,1,"dummy"
"265604",0,8,1,9,"dummy"
"265605",0,0,1,1,"dummy"
"265646",3,6,0,9,"dummy"
"265657",1,0,0,1,"dummy"
"265658",0,0,1,1,"dummy"
"265659",0,0,2,2,"dummy"
"265660",0,0,1,1,"dummy"
"265661",0,0,1,1,"dummy"
"265662",0,2,1,3,"dummy"
"265663",0,0,1,1,"dummy"
"265664",0,0,1,1,"dummy"
"265665",1,0,2,3,"dummy"
"265666",0,0,1,1,"dummy"
"265667",1,2,0,3,"dummy"
"265668",0,0,0,0,"dummy"
"265669",0,0,0,0,"dummy"
"265670",0,0,0,0,"dummy"
"265685",12,3,2,17,"dummy"
"265706",1,4,1,6,"dummy"
"265707",0,2,2,4,"dummy"
"265710",0,0,1,1,"dummy"
"265711",3,0,0,3,"dummy"
"265432",0,0,1,1,"dummy"
"265437",2,16,3,21,"dummy"
"265438",2,0,3,5,"dummy"
"265439",1,1,1,3,"dummy"
"265440",0,5,0,5,"dummy"
"265441",0,0,0,0,"dummy"
"265442",2,4,1,7,"dummy"
"265443",0,0,0,0,"dummy"
"265444",0,1,0,1,"dummy"
"265445",2,2,2,6,"dummy"
"265446",0,1,0,1,"dummy"
"265447",2,2,2,6,"dummy"
"265448",2,2,2,6,"dummy"
"265449",2,2,2,6,"dummy"
"265450",0,0,1,1,"dummy"
"265451",2,2,2,6,"dummy"
"265452",2,2,2,6,"dummy"
"265453",2,2,2,6,"dummy"
"265454",2,2,2,6,"dummy"
"265455",0,0,1,1,"dummy"
"265456",0,0,2,2,"dummy"
"265457",2,2,3,7,"dummy"
"265458",2,2,3,7,"dummy"
"265459",2,2,2,6,"dummy"
"265460",2,2,3,7,"dummy"
"265461",2,2,2,6,"dummy"
"265462",2,2,3,7,"dummy"
"265463",2,2,2,6,"dummy"
"265464",2,2,3,7,"dummy"
"265465",2,2,2,6,"dummy"
"265466",2,2,3,7,"dummy"
"265467",2,2,2,6,"dummy"
"265468",2,2,2,6,"dummy"
"265484",5,11,1,17,"dummy"
"265488",0,0,0,0,"dummy"
"265489",0,0,0,0,"dummy"
"265497",0,0,1,1,"dummy"
"265498",0,0,0,0,"dummy"
"265501",0,0,1,1,"dummy"
"265502",0,0,1,1,"dummy"
"265503",1,0,0,1,"dummy"
"265504",0,0,1,1,"dummy"
"265532",0,0,1,1,"dummy"
"265533",0,0,1,1,"dummy"
"265534",0,0,1,1,"dummy"
"265535",0,0,1,1,"dummy"
"265536",0,0,1,1,"dummy"
"265553",0,1,2,3,"dummy"
"265554",1,3,1,5,"dummy"
"265555",4,12,5,21,"dummy"
"265556",8,15,5,28,"dummy"
"265557",2,2,0,4,"dummy"
"265558",11,7,4,22,"dummy"
"265559",0,3,1,4,"dummy"
"265560",0,2,0,2,"dummy"
"265561",5,0,1,6,"dummy"
"265572",0,0,1,1,"dummy"
"265573",0,0,1,1,"dummy"
"265574",0,0,2,2,"dummy"
"265575",26,3,7,36,"dummy"
"265579",0,2,4,6,"dummy"
"265580",6,2,1,9,"dummy"
"265581",0,1,0,1,"dummy"
"265582",0,2,0,2,"dummy"
"265583",1,4,0,5,"dummy"
"265584",0,3,0,3,"dummy"
"265588",0,1,0,1,"dummy"
"265589",1,0,2,3,"dummy"
"265593",2,0,0,2,"dummy"
"265594",0,0,1,1,"dummy"
"265607",1,0,0,1,"dummy"
"265612",13,2,2,17,"dummy"
"265644",0,0,1,1,"dummy"
"265672",0,0,1,1,"dummy"
"265673",0,0,1,1,"dummy"
"265674",1,0,0,1,"dummy"
"265675",0,1,0,1,"dummy"
"265676",0,0,1,1,"dummy"
"265677",0,0,0,0,"dummy"
"265678",0,2,1,3,"dummy"
"265679",1,3,1,5,"dummy"
"265680",2,0,1,3,"dummy"
"265681",0,2,0,2,"dummy"
"265682",2,0,0,2,"dummy"
"265683",0,2,0,2,"dummy"
"265720",0,1,0,1,"dummy"
"265721",0,0,1,1,"dummy"
"265722",0,0,1,1,"dummy"
"265723",0,0,1,1,"dummy"
"265724",0,0,1,1,"dummy"
"265725",0,0,1,1,"dummy"
"265726",0,0,1,1,"dummy"
"265727",0,0,1,1,"dummy"
"265728",0,0,1,1,"dummy"
"265729",0,0,1,1,"dummy"
"265730",0,0,1,1,"dummy"
"265731",3,45,0,48,"dummy"
"265732",2,0,0,2,"dummy"
"265733",0,1,0,1,"dummy"
"265766",0,1,0,1,"dummy"
"265769",0,0,0,0,"dummy"
"265770",0,0,0,0,"dummy"
"265771",0,0,0,0,"dummy"
"265772",0,0,0,0,"dummy"
"265775",0,1,0,1,"dummy"
"265776",0,1,0,1,"dummy"
"265779",0,3,0,3,"dummy"
"265780",1,0,0,1,"dummy"
"265781",0,1,0,1,"dummy"
"265782",0,0,0,0,"dummy"
"265783",4,99,0,103,"dummy"
"265784",84,5,5,94,"dummy"
"265785",4,22,2,28,"dummy"
"265786",0,8,0,8,"dummy"
"265787",3,2,2,7,"dummy"
"265788",6,8,0,14,"dummy"
"265789",4,11,0,15,"dummy"
"265790",3,1,1,5,"dummy"
"265791",0,1,0,1,"dummy"
"265792",0,0,1,1,"dummy"
"265793",0,9,0,9,"dummy"
"265794",0,1,0,1,"dummy"
"265795",0,2,0,2,"dummy"
"265796",0,1,0,1,"dummy"
"265797",0,1,0,1,"dummy"
"265798",0,2,0,2,"dummy"
"265799",0,1,0,1,"dummy"
"265800",0,2,0,2,"dummy"
"265801",0,3,0,3,"dummy"
"265802",0,1,0,1,"dummy"
"265803",0,1,0,1,"dummy"
"265804",0,2,0,2,"dummy"
"265805",0,2,0,2,"dummy"
"265806",0,8,0,8,"dummy"
"265807",2,5,0,7,"dummy"
"265808",0,0,2,2,"dummy"
"265809",0,1,1,2,"dummy"
"265810",1,0,0,1,"dummy"
"265811",1,4,1,6,"dummy"
"265812",2,2,0,4,"dummy"
"265813",2,2,0,4,"dummy"
"265814",1,4,1,6,"dummy"
"265815",2,2,0,4,"dummy"
"265816",0,1,0,1,"dummy"
"265817",0,2,0,2,"dummy"
"265818",0,0,1,1,"dummy"
"265819",0,1,0,1,"dummy"
"265820",1,6,0,7,"dummy"
"265821",6,10,0,16,"dummy"
"265822",1,1,1,3,"dummy"
"265823",0,0,1,1,"dummy"
"265824",5,4,0,9,"dummy"
"265825",0,1,0,1,"dummy"
"265826",0,1,0,1,"dummy"
"265827",0,1,0,1,"dummy"
"265828",0,2,0,2,"dummy"
"265829",6,12,2,20,"dummy"
"265830",0,0,2,2,"dummy"
"265831",0,0,1,1,"dummy"
"265832",19,6,3,28,"dummy"
"265833",0,0,1,1,"dummy"
"265834",0,0,1,1,"dummy"
"265835",2,2,0,4,"dummy"
"265836",2,2,0,4,"dummy"
"265712",0,0,3,3,"dummy"
"265713",0,3,0,3,"dummy"
"265714",0,2,4,6,"dummy"
"265715",9,11,0,20,"dummy"
"265716",1,0,0,1,"dummy"
"265717",0,1,0,1,"dummy"
"265718",1,3,0,4,"dummy"
"265735",1,7,0,8,"dummy"
"265736",0,0,0,0,"dummy"
"265737",0,1,0,1,"dummy"
"265738",0,3,1,4,"dummy"
"265739",0,0,3,3,"dummy"
"265740",0,1,0,1,"dummy"
"265741",16,0,4,20,"dummy"
"265744",9,6,1,16,"dummy"
"265745",1,2,0,3,"dummy"
"265746",2,2,0,4,"dummy"
"265747",3,1,0,4,"dummy"
"265748",1,0,1,2,"dummy"
"265749",0,1,0,1,"dummy"
"265752",0,5,1,6,"dummy"
"265760",1,0,1,2,"dummy"
"265761",0,1,0,1,"dummy"
"265762",0,0,1,1,"dummy"
"265763",0,0,0,0,"dummy"
"265764",0,0,0,0,"dummy"
"265842",0,0,2,2,"dummy"
"265847",1,0,0,1,"dummy"
"265848",0,0,3,3,"dummy"
"265849",0,0,2,2,"dummy"
"265850",0,0,3,3,"dummy"
"265853",0,1,0,1,"dummy"
"265854",1,1,1,3,"dummy"
"265855",20,2,1,23,"dummy"
"265856",0,2,0,2,"dummy"
"265857",0,0,2,2,"dummy"
"265858",0,0,2,2,"dummy"
"265859",0,0,2,2,"dummy"
"265860",0,0,1,1,"dummy"
"265864",0,2,1,3,"dummy"
"265865",0,0,0,0,"dummy"
"265866",1,0,1,2,"dummy"
"265868",1,6,0,7,"dummy"
"265869",0,1,1,2,"dummy"
"265870",0,2,0,2,"dummy"
"265871",3,5,0,8,"dummy"
"265872",4,0,3,7,"dummy"
"265873",1,3,1,5,"dummy"
"265874",2,5,3,10,"dummy"
"265877",0,1,2,3,"dummy"
"265878",0,0,1,1,"dummy"
"265880",0,1,0,1,"dummy"
"265881",0,1,0,1,"dummy"
"265889",0,0,0,0,"dummy"
"265890",0,0,0,0,"dummy"
"265894",1,2,1,4,"dummy"
"265897",0,11,0,11,"dummy"
"265899",0,2,0,2,"dummy"
"265900",0,0,1,1,"dummy"
"265901",0,7,0,7,"dummy"
"265902",1,13,0,14,"dummy"
"265903",4,0,0,4,"dummy"
"265905",3,3,0,6,"dummy"
"265906",0,1,0,1,"dummy"
"265914",12,3,0,15,"dummy"
"265915",0,0,1,1,"dummy"
"265916",4,14,0,18,"dummy"
"265917",2,0,2,4,"dummy"
"265918",0,2,0,2,"dummy"
"265919",7,6,1,14,"dummy"
"265920",13,0,0,13,"dummy"
"265921",0,0,0,0,"dummy"
"265922",0,0,1,1,"dummy"
"265923",0,0,1,1,"dummy"
"265927",2,3,0,5,"dummy"
"265932",2,0,3,5,"dummy"
"265934",0,0,3,3,"dummy"
"265935",0,1,0,1,"dummy"
"265937",0,2,0,2,"dummy"
"265939",2,2,1,5,"dummy"
"265940",0,0,1,1,"dummy"
"265942",0,1,0,1,"dummy"
"265943",0,1,0,1,"dummy"
"265946",6,0,0,6,"dummy"
"265947",2,5,2,9,"dummy"
"265950",2,2,0,4,"dummy"
"265951",2,4,3,9,"dummy"
"265952",3,0,0,3,"dummy"
"265953",4,2,0,6,"dummy"
"265954",1,3,0,4,"dummy"
"265957",0,0,2,2,"dummy"
"265964",0,5,1,6,"dummy"
"265968",0,1,0,1,"dummy"
"265969",1,0,0,1,"dummy"
"265971",0,1,1,2,"dummy"
"265972",1,0,0,1,"dummy"
"265974",0,0,3,3,"dummy"
"265978",2,2,0,4,"dummy"
"265989",0,2,0,2,"dummy"
"265990",0,0,6,6,"dummy"
"266012",0,0,0,0,"dummy"
"266014",0,0,1,1,"dummy"
"266015",0,0,1,1,"dummy"
"266016",0,0,1,1,"dummy"
"266017",0,0,1,1,"dummy"
"266020",0,1,0,1,"dummy"
"266021",7,2,2,11,"dummy"
"266022",0,0,1,1,"dummy"
"266023",0,1,1,2,"dummy"
"266024",0,1,4,5,"dummy"
"266025",6,2,3,11,"dummy"
"266028",0,0,0,0,"dummy"
"266029",1,8,0,9,"dummy"
"266030",0,0,3,3,"dummy"
"266031",0,9,0,9,"dummy"
"266032",2,1,0,3,"dummy"
"266033",6,6,0,12,"dummy"
"266034",1,0,0,1,"dummy"
"266035",3,4,2,9,"dummy"
"266036",0,0,1,1,"dummy"
"266037",0,0,1,1,"dummy"
"266038",4,4,0,8,"dummy"
"266039",4,5,0,9,"dummy"
"266040",0,1,0,1,"dummy"
"266042",0,0,2,2,"dummy"
"266055",2,4,0,6,"dummy"
"266056",0,2,0,2,"dummy"
"266057",0,2,0,2,"dummy"
"266058",10,2,0,12,"dummy"
"266059",0,2,0,2,"dummy"
"266060",0,0,0,0,"dummy"
"266061",0,0,3,3,"dummy"
"266062",0,5,0,5,"dummy"
"266063",1,0,1,2,"dummy"
"266065",0,1,0,1,"dummy"
"266066",0,1,0,1,"dummy"
"266070",6,0,2,8,"dummy"
"266073",0,0,1,1,"dummy"
"266074",0,0,1,1,"dummy"
"266076",0,0,0,0,"dummy"
"266079",2,1,0,3,"dummy"
"266080",0,4,0,4,"dummy"
"266081",0,0,0,0,"dummy"
"266083",0,0,0,0,"dummy"
"266084",5,0,2,7,"dummy"
"266085",0,0,0,0,"dummy"
"266087",0,0,0,0,"dummy"
"266088",3,2,1,6,"dummy"
"266089",0,1,0,1,"dummy"
"266090",0,1,0,1,"dummy"
"266092",3,0,3,6,"dummy"
"266098",8,4,2,14,"dummy"
"266099",0,4,0,4,"dummy"
"266111",2,2,0,4,"dummy"
"266112",0,1,0,1,"dummy"
"266113",0,0,3,3,"dummy"
"266114",3,1,1,5,"dummy"
"266170",2,2,1,5,"dummy"
"266171",0,0,1,1,"dummy"
"266173",12,4,1,17,"dummy"
"266174",0,1,0,1,"dummy"
"266176",0,0,0,0,"dummy"
"266177",0,0,0,0,"dummy"
"266178",0,0,0,0,"dummy"
"266179",0,0,0,0,"dummy"
"266180",0,0,0,0,"dummy"
"266181",1,1,2,4,"dummy"
"266182",0,0,1,1,"dummy"
"266183",0,0,0,0,"dummy"
"266184",0,0,0,0,"dummy"
"266186",0,0,1,1,"dummy"
"266187",0,0,1,1,"dummy"
"266188",0,0,1,1,"dummy"
"266189",0,0,0,0,"dummy"
"266190",0,0,1,1,"dummy"
"266191",0,0,1,1,"dummy"
"266193",0,0,1,1,"dummy"
"266195",0,3,0,3,"dummy"
"266196",1,0,0,1,"dummy"
"266197",0,8,0,8,"dummy"
"266198",0,1,3,4,"dummy"
"266200",0,0,1,1,"dummy"
"266201",0,0,1,1,"dummy"
"266203",2,0,3,5,"dummy"
"266205",0,1,0,1,"dummy"
"266207",0,1,0,1,"dummy"
"266209",0,0,1,1,"dummy"
"266219",0,1,0,1,"dummy"
"266220",0,0,1,1,"dummy"
"266221",0,0,1,1,"dummy"
"266223",0,1,0,1,"dummy"
"266224",0,0,0,0,"dummy"
"266226",5,14,3,22,"dummy"
"266227",0,0,1,1,"dummy"
"266228",1,0,0,1,"dummy"
"266231",1,0,2,3,"dummy"
"266232",0,0,0,0,"dummy"
"266233",0,0,4,4,"dummy"
"266234",0,7,0,7,"dummy"
"266235",4,4,1,9,"dummy"
"266236",0,0,1,1,"dummy"
"266237",4,4,0,8,"dummy"
"266238",0,0,1,1,"dummy"
"266239",0,3,2,5,"dummy"
"266240",9,4,2,15,"dummy"
"266243",0,2,0,2,"dummy"
"266244",0,0,4,4,"dummy"
"266245",3,2,0,5,"dummy"
"266246",2,2,2,6,"dummy"
"266249",2,1,1,4,"dummy"
"266252",0,0,1,1,"dummy"
"266253",0,2,0,2,"dummy"
"266254",0,0,1,1,"dummy"
"266259",0,0,1,1,"dummy"
"266260",0,4,0,4,"dummy"
"266265",0,0,1,1,"dummy"
"266276",0,0,0,0,"dummy"
"266277",0,0,1,1,"dummy"
"266290",0,0,1,1,"dummy"
"266291",0,0,2,2,"dummy"
"266292",0,0,1,1,"dummy"
"266293",0,0,1,1,"dummy"
"266294",0,0,1,1,"dummy"
"266303",7,1,2,10,"dummy"
"266304",0,2,0,2,"dummy"
"266315",0,1,0,1,"dummy"
"266316",0,0,4,4,"dummy"
"266317",1,0,0,1,"dummy"
"266318",2,4,4,10,"dummy"
"266321",1,0,0,1,"dummy"
"266322",0,0,0,0,"dummy"
"266323",0,0,1,1,"dummy"
"266326",2,2,1,5,"dummy"
"266327",2,0,0,2,"dummy"
"266328",0,6,0,6,"dummy"
"266349",1,1,0,2,"dummy"
"266350",0,1,0,1,"dummy"
"266359",0,0,0,0,"dummy"
"266360",0,0,0,0,"dummy"
"266361",1,0,0,1,"dummy"
"266364",32,2,0,34,"dummy"
"266365",0,0,0,0,"dummy"
"266366",0,4,0,4,"dummy"
"266369",7,2,4,13,"dummy"
"266370",0,0,1,1,"dummy"
"266381",0,0,0,0,"dummy"
"266382",0,0,1,1,"dummy"
"266383",0,0,0,0,"dummy"
"266384",0,0,0,0,"dummy"
"266385",0,0,1,1,"dummy"
"266386",0,0,0,0,"dummy"
"266393",0,1,0,1,"dummy"
"266394",0,0,1,1,"dummy"
"266395",3,3,3,9,"dummy"
"266398",5,0,0,5,"dummy"
"266399",0,1,0,1,"dummy"
"266400",10,9,7,26,"dummy"
"266404",0,0,3,3,"dummy"
"266405",0,2,0,2,"dummy"
"266406",0,0,1,1,"dummy"
"266407",0,1,0,1,"dummy"
"266416",0,2,0,2,"dummy"
"266417",4,2,0,6,"dummy"
"266418",0,4,0,4,"dummy"
"266256",0,1,1,2,"dummy"
"266257",6,3,3,12,"dummy"
"266262",0,0,0,0,"dummy"
"266263",0,0,0,0,"dummy"
"266274",3,2,1,6,"dummy"
"266281",3,2,0,5,"dummy"
"266282",0,1,0,1,"dummy"
"266283",0,0,2,2,"dummy"
"266284",0,2,0,2,"dummy"
"266285",1,0,1,2,"dummy"
"266286",0,0,1,1,"dummy"
"266287",0,0,1,1,"dummy"
"266288",0,0,1,1,"dummy"
"266298",0,0,0,0,"dummy"
"266308",0,0,1,1,"dummy"
"266309",0,2,0,2,"dummy"
"266310",0,0,4,4,"dummy"
"266334",0,11,0,11,"dummy"
"266335",0,7,3,10,"dummy"
"266336",2,6,1,9,"dummy"
"266337",0,6,0,6,"dummy"
"266338",6,0,0,6,"dummy"
"266339",0,2,0,2,"dummy"
"266340",0,1,0,1,"dummy"
"266341",0,1,0,1,"dummy"
"266342",3,3,1,7,"dummy"
"266343",0,0,2,2,"dummy"
"266344",25,11,5,41,"dummy"
"266345",0,1,0,1,"dummy"
"266346",0,0,0,0,"dummy"
"266347",0,0,1,1,"dummy"
"266354",0,1,0,1,"dummy"
"266355",0,0,1,1,"dummy"
"266372",5,3,0,8,"dummy"
"266373",0,1,0,1,"dummy"
"266374",0,2,1,3,"dummy"
"266375",0,1,0,1,"dummy"
"266391",2,10,1,13,"dummy"
"266402",1,0,1,2,"dummy"
"266411",0,2,0,2,"dummy"
"266412",0,0,1,1,"dummy"
"266427",6,0,1,7,"dummy"
"266428",3,1,0,4,"dummy"
"266434",0,6,0,6,"dummy"
"266435",0,0,2,2,"dummy"
"266436",0,2,0,2,"dummy"
"266437",0,0,0,0,"dummy"
"266438",3,0,4,7,"dummy"
"266450",0,1,0,1,"dummy"
"266451",0,3,0,3,"dummy"
"266452",0,3,1,4,"dummy"
"266453",0,2,0,2,"dummy"
"266465",5,0,3,8,"dummy"
"266466",0,11,0,11,"dummy"
"266467",12,1,1,14,"dummy"
"266468",0,2,0,2,"dummy"
"266491",0,0,0,0,"dummy"
"266492",0,1,2,3,"dummy"
"266493",1,0,0,1,"dummy"
"266494",0,2,0,2,"dummy"
"266419",4,0,0,4,"dummy"
"266422",0,0,1,1,"dummy"
"266423",0,1,0,1,"dummy"
"266424",0,3,0,3,"dummy"
"266425",0,0,1,1,"dummy"
"266432",0,6,0,6,"dummy"
"266445",0,0,0,0,"dummy"
"266446",0,0,0,0,"dummy"
"266455",0,0,1,1,"dummy"
"266456",1,0,1,2,"dummy"
"266457",0,0,1,1,"dummy"
"266458",0,0,1,1,"dummy"
"266459",0,0,1,1,"dummy"
"266460",7,3,1,11,"dummy"
"266463",1,0,0,1,"dummy"
"266470",1,7,5,13,"dummy"
"266496",1,9,0,10,"dummy"
"266497",0,1,0,1,"dummy"
"266498",0,1,0,1,"dummy"
"266499",0,1,4,5,"dummy"
"266512",0,1,3,4,"dummy"
"266513",0,0,1,1,"dummy"
"266520",0,0,2,2,"dummy"
"266521",0,0,1,1,"dummy"
"266526",0,0,1,1,"dummy"
"266550",0,2,0,2,"dummy"
"266556",0,0,1,1,"dummy"
"266557",11,0,0,11,"dummy"
"266566",0,0,1,1,"dummy"
"266608",9,9,3,21,"dummy"
"266611",0,3,1,4,"dummy"
"266612",7,1,2,10,"dummy"
"266613",0,0,1,1,"dummy"
"266614",0,1,0,1,"dummy"
"266615",0,1,0,1,"dummy"
"266621",0,0,0,0,"dummy"
"266622",1,0,0,1,"dummy"
"266515",0,0,1,1,"dummy"
"266516",0,0,2,2,"dummy"
"266517",0,2,4,6,"dummy"
"266518",0,0,1,1,"dummy"
"266523",15,17,2,34,"dummy"
"266524",0,1,0,1,"dummy"
"266530",5,8,1,14,"dummy"
"266531",0,0,1,1,"dummy"
"266532",0,0,1,1,"dummy"
"266533",0,2,3,5,"dummy"
"266534",8,4,1,13,"dummy"
"266535",0,1,0,1,"dummy"
"266536",0,0,0,0,"dummy"
"266537",2,2,0,4,"dummy"
"266538",0,0,1,1,"dummy"
"266539",0,0,1,1,"dummy"
"266540",0,0,0,0,"dummy"
"266541",0,0,2,2,"dummy"
"266542",1,0,0,1,"dummy"
"266543",0,0,1,1,"dummy"
"266544",1,1,0,2,"dummy"
"266545",0,0,1,1,"dummy"
"266546",8,8,2,18,"dummy"
"266552",3,2,0,5,"dummy"
"266562",1,0,0,1,"dummy"
"266593",8,4,0,12,"dummy"
"266594",0,2,0,2,"dummy"
"266595",5,4,2,11,"dummy"
"266596",0,1,0,1,"dummy"
"266597",1,1,2,4,"dummy"
"266598",0,1,0,1,"dummy"
"266599",1,3,3,7,"dummy"
"266600",0,0,1,1,"dummy"
"266601",4,2,3,9,"dummy"
"266602",1,0,3,4,"dummy"
"266603",0,2,3,5,"dummy"
"266604",0,0,0,0,"dummy"
"266617",2,6,0,8,"dummy"
"266618",1,6,0,7,"dummy"
"266619",0,1,0,1,"dummy"
"266624",0,0,0,0,"dummy"
"266625",0,0,0,0,"dummy"
"266678",0,1,0,1,"dummy"
"266679",0,0,0,0,"dummy"
"266682",2,2,1,5,"dummy"
"266683",0,2,0,2,"dummy"
"266686",0,0,1,1,"dummy"
"266691",0,0,1,1,"dummy"
"266692",0,2,0,2,"dummy"
"266693",2,2,2,6,"dummy"
"266694",0,2,0,2,"dummy"
"266695",0,2,0,2,"dummy"
"266696",0,0,1,1,"dummy"
"266697",0,15,0,15,"dummy"
"266698",0,1,0,1,"dummy"
"266699",0,0,0,0,"dummy"
"266700",26,4,3,33,"dummy"
"266703",0,1,0,1,"dummy"
"266704",0,1,2,3,"dummy"
"266705",0,1,0,1,"dummy"
"266706",1,5,1,7,"dummy"
"266707",0,1,0,1,"dummy"
"266708",0,1,0,1,"dummy"
"266709",0,0,0,0,"dummy"
"266749",0,1,0,1,"dummy"
"266750",0,1,0,1,"dummy"
"266751",0,0,2,2,"dummy"
"266756",0,2,0,2,"dummy"
"266774",0,2,0,2,"dummy"
"266775",2,0,0,2,"dummy"
"266758",5,5,0,10,"dummy"
"266759",5,5,0,10,"dummy"
"266760",0,1,0,1,"dummy"
"266761",0,0,1,1,"dummy"
"266762",1,1,0,2,"dummy"
"266777",0,1,0,1,"dummy"
"266778",0,0,1,1,"dummy"
"266779",0,0,3,3,"dummy"
"266780",3,3,0,6,"dummy"
"266781",2,8,1,11,"dummy"
"266782",0,0,1,1,"dummy"
"266783",0,0,1,1,"dummy"
"266784",13,0,3,16,"dummy"
"266788",2,4,0,6,"dummy"
"266789",0,2,0,2,"dummy"
"266790",0,2,0,2,"dummy"
"266791",10,2,0,12,"dummy"
"266792",0,2,0,2,"dummy"
"266793",0,0,0,0,"dummy"
"266798",2,0,3,5,"dummy"
"266805",0,2,1,3,"dummy"
"266806",1,0,0,1,"dummy"
"266809",0,0,0,0,"dummy"
"266810",0,2,0,2,"dummy"
"266811",0,0,1,1,"dummy"
"266812",0,0,1,1,"dummy"
"266813",0,1,0,1,"dummy"
"266814",0,0,1,1,"dummy"
"266815",0,0,0,0,"dummy"
"266816",0,3,1,4,"dummy"
"266817",3,0,2,5,"dummy"
"266818",0,3,1,4,"dummy"
"266786",0,0,1,1,"dummy"
"266795",2,0,0,2,"dummy"
"266796",0,0,0,0,"dummy"
"266800",4,0,0,4,"dummy"
"266803",1,0,0,1,"dummy"
"266822",0,0,0,0,"dummy"
"266823",0,0,0,0,"dummy"
"267091",0,0,1,1,"dummy"
"267092",3,8,0,11,"dummy"
"267093",0,1,0,1,"dummy"
"267096",2,0,0,2,"dummy"
"267097",0,1,0,1,"dummy"
"267098",0,0,1,1,"dummy"
"267099",0,0,1,1,"dummy"
"267100",0,0,1,1,"dummy"
"267150",0,0,0,0,"dummy"
"267157",1,1,3,5,"dummy"
"267158",1,0,1,2,"dummy"
"267166",0,3,0,3,"dummy"
"267172",0,1,0,1,"dummy"
"267173",0,1,0,1,"dummy"
"267185",1,0,2,3,"dummy"
"267186",1,0,1,2,"dummy"
"267187",0,2,1,3,"dummy"
"267188",2,0,1,3,"dummy"
"267189",0,1,1,2,"dummy"
"267190",0,2,0,2,"dummy"
"267191",2,0,0,2,"dummy"
"267060",1,0,0,1,"dummy"
"267061",0,0,1,1,"dummy"
"267062",0,0,1,1,"dummy"
"267063",0,0,1,1,"dummy"
"267064",0,0,1,1,"dummy"
"267065",0,1,0,1,"dummy"
"267068",0,1,0,1,"dummy"
"267069",0,3,1,4,"dummy"
"267070",5,12,2,19,"dummy"
"267071",0,4,0,4,"dummy"
"267072",0,0,1,1,"dummy"
"267073",0,0,2,2,"dummy"
"267074",0,0,3,3,"dummy"
"267075",0,1,0,1,"dummy"
"267076",5,13,5,23,"dummy"
"267077",0,6,0,6,"dummy"
"267080",1,0,0,1,"dummy"
"267081",0,1,0,1,"dummy"
"267084",3,4,0,7,"dummy"
"267085",0,0,1,1,"dummy"
"267086",4,4,0,8,"dummy"
"267089",2,1,1,4,"dummy"
"267106",0,0,1,1,"dummy"
"267107",0,0,1,1,"dummy"
"267108",1,4,1,6,"dummy"
"267109",2,3,0,5,"dummy"
"267110",0,0,1,1,"dummy"
"267111",0,0,1,1,"dummy"
"267140",0,1,0,1,"dummy"
"267141",0,1,0,1,"dummy"
"267142",4,2,2,8,"dummy"
"267143",0,1,0,1,"dummy"
"267144",0,2,0,2,"dummy"
"267145",0,1,0,1,"dummy"
"267146",0,1,0,1,"dummy"
"267147",0,2,0,2,"dummy"
"267148",0,1,0,1,"dummy"
"267154",0,0,1,1,"dummy"
"267155",1,0,0,1,"dummy"
"267164",0,0,1,1,"dummy"
"267199",0,0,1,1,"dummy"
"267200",1,0,0,1,"dummy"
"267202",8,7,0,15,"dummy"
"267204",0,0,1,1,"dummy"
"267205",2,0,1,3,"dummy"
"267206",0,0,1,1,"dummy"
"267210",1,1,0,2,"dummy"
"267211",0,0,0,0,"dummy"
"267213",0,0,0,0,"dummy"
"267216",0,3,0,3,"dummy"
"267217",1,1,0,2,"dummy"
"267219",0,0,0,0,"dummy"
"267220",0,0,0,0,"dummy"
"267221",0,0,0,0,"dummy"
"267222",0,0,0,0,"dummy"
"267223",0,0,0,0,"dummy"
"267224",0,0,0,0,"dummy"
"267225",0,0,0,0,"dummy"
"267226",0,0,0,0,"dummy"
"267227",0,0,0,0,"dummy"
"267228",0,0,0,0,"dummy"
"267230",0,1,0,1,"dummy"
"267231",0,1,0,1,"dummy"
"267232",0,0,1,1,"dummy"
"267233",4,4,0,8,"dummy"
"267236",0,1,0,1,"dummy"
"267238",0,2,0,2,"dummy"
"267239",3,2,1,6,"dummy"
"267240",0,0,1,1,"dummy"
"267241",0,0,1,1,"dummy"
"267242",0,0,1,1,"dummy"
"267243",0,0,1,1,"dummy"
"267244",1,1,1,3,"dummy"
"267245",0,0,1,1,"dummy"
"267246",0,0,0,0,"dummy"
"267250",0,2,0,2,"dummy"
"267251",0,1,0,1,"dummy"
"267252",0,0,1,1,"dummy"
"267253",3,3,0,6,"dummy"
"267254",4,3,0,7,"dummy"
"267259",1,1,2,4,"dummy"
"267260",1,2,0,3,"dummy"
"267261",4,3,1,8,"dummy"
"267265",4,6,2,12,"dummy"
"267266",0,0,1,1,"dummy"
"267274",1,10,1,12,"dummy"
"267276",1,0,0,1,"dummy"
"267277",0,0,0,0,"dummy"
"267278",0,0,0,0,"dummy"
"267279",0,0,0,0,"dummy"
"267280",3,0,0,3,"dummy"
"267283",0,0,0,0,"dummy"
"267293",0,2,0,2,"dummy"
"267307",1,2,0,3,"dummy"
"267309",13,3,6,22,"dummy"
"267310",0,0,0,0,"dummy"
"267313",2,16,0,18,"dummy"
"267314",0,1,0,1,"dummy"
"267315",4,0,1,5,"dummy"
"267317",3,3,1,7,"dummy"
"267318",3,3,1,7,"dummy"
"267319",0,1,0,1,"dummy"
"267320",11,9,2,22,"dummy"
"267321",0,0,2,2,"dummy"
"267322",0,0,2,2,"dummy"
"267323",0,0,4,4,"dummy"
"267329",1,0,0,1,"dummy"
"267330",1,1,0,2,"dummy"
"267332",0,1,0,1,"dummy"
"267333",0,0,1,1,"dummy"
"267334",0,2,0,2,"dummy"
"267335",0,0,1,1,"dummy"
"267336",0,0,0,0,"dummy"
"267338",0,1,1,2,"dummy"
"267339",0,1,0,1,"dummy"
"267340",6,13,4,23,"dummy"
"267342",0,0,1,1,"dummy"
"267344",0,0,1,1,"dummy"
"267346",3,0,1,4,"dummy"
"267350",0,0,1,1,"dummy"
"267351",0,0,1,1,"dummy"
"267352",0,0,1,1,"dummy"
"267353",0,0,1,1,"dummy"
"267354",0,0,1,1,"dummy"
"267355",0,0,1,1,"dummy"
"267356",0,0,1,1,"dummy"
"267357",0,0,1,1,"dummy"
"267358",0,0,1,1,"dummy"
"267359",0,0,1,1,"dummy"
"267360",0,0,1,1,"dummy"
"267361",0,0,1,1,"dummy"
"267362",1,3,0,4,"dummy"
"267363",0,0,1,1,"dummy"
"267364",0,0,1,1,"dummy"
"267379",0,1,0,1,"dummy"
"267380",0,1,0,1,"dummy"
"267382",2,2,0,4,"dummy"
"267383",1,2,0,3,"dummy"
"267385",0,3,0,3,"dummy"
"267386",1,7,0,8,"dummy"
"267387",2,2,0,4,"dummy"
"267388",0,1,0,1,"dummy"
"267389",0,1,0,1,"dummy"
"267390",6,8,1,15,"dummy"
"267391",8,7,1,16,"dummy"
"267392",6,8,1,15,"dummy"
"267393",1,2,1,4,"dummy"
"267394",20,0,1,21,"dummy"
"267418",2,0,0,2,"dummy"
"267419",1,0,0,1,"dummy"
"267420",0,1,0,1,"dummy"
"267421",1,0,0,1,"dummy"
"267429",0,1,1,2,"dummy"
"267432",3,1,0,4,"dummy"
"267433",20,0,2,22,"dummy"
"267434",0,2,0,2,"dummy"
"267435",0,1,0,1,"dummy"
"267437",0,0,1,1,"dummy"
"267438",0,0,1,1,"dummy"
"267439",0,1,0,1,"dummy"
"267441",4,4,0,8,"dummy"
"267443",0,3,0,3,"dummy"
"267444",0,4,0,4,"dummy"
"267445",0,2,0,2,"dummy"
"267446",0,4,1,5,"dummy"
"267455",0,0,2,2,"dummy"
"267458",0,3,1,4,"dummy"
"267459",0,0,1,1,"dummy"
"267460",0,0,1,1,"dummy"
"267471",0,10,0,10,"dummy"
"267472",0,2,0,2,"dummy"
"267473",0,0,0,0,"dummy"
"267474",0,7,0,7,"dummy"
"267476",0,1,0,1,"dummy"
"267477",0,0,1,1,"dummy"
"267478",3,2,0,5,"dummy"
"267479",2,0,0,2,"dummy"
"267480",1,1,0,2,"dummy"
"267481",0,1,1,2,"dummy"
"267484",4,21,3,28,"dummy"
"267486",2,7,0,9,"dummy"
"267487",4,3,1,8,"dummy"
"267489",1,2,0,3,"dummy"
"267490",1,2,0,3,"dummy"
"267492",4,1,0,5,"dummy"
"267493",1,1,0,2,"dummy"
"267494",0,1,0,1,"dummy"
"267495",0,0,0,0,"dummy"
"267496",0,0,1,1,"dummy"
"267497",0,0,1,1,"dummy"
"267500",0,7,0,7,"dummy"
"267501",0,0,0,0,"dummy"
"267502",6,0,0,6,"dummy"
"267503",0,2,0,2,"dummy"
"267504",2,0,0,2,"dummy"
"267505",0,0,1,1,"dummy"
"267506",13,18,4,35,"dummy"
"267507",0,0,1,1,"dummy"
"267509",1,3,0,4,"dummy"
"267510",0,1,1,2,"dummy"
"267511",0,2,0,2,"dummy"
"267514",2,1,1,4,"dummy"
"267516",0,2,2,4,"dummy"
"267517",0,1,2,3,"dummy"
"267520",0,4,0,4,"dummy"
"267521",2,0,0,2,"dummy"
"267526",2,2,0,4,"dummy"
"267528",1,3,0,4,"dummy"
"267530",0,12,0,12,"dummy"
"267531",0,3,1,4,"dummy"
"267532",2,0,3,5,"dummy"
"267533",2,2,0,4,"dummy"
"267534",1,1,0,2,"dummy"
"267535",2,1,0,3,"dummy"
"267536",0,1,0,1,"dummy"
"267538",0,0,1,1,"dummy"
"267540",2,1,2,5,"dummy"
"267541",0,1,0,1,"dummy"
"267542",0,1,0,1,"dummy"
"267543",0,3,0,3,"dummy"
"267544",3,1,0,4,"dummy"
"267554",0,6,1,7,"dummy"
"267555",2,0,1,3,"dummy"
"267557",2,2,0,4,"dummy"
"267558",0,0,0,0,"dummy"
"267559",1,4,1,6,"dummy"
"267560",0,0,0,0,"dummy"
"267561",3,3,1,7,"dummy"
"267562",0,3,1,4,"dummy"
"267563",0,1,0,1,"dummy"
"267564",7,3,0,10,"dummy"
"267565",4,2,0,6,"dummy"
"267566",6,3,0,9,"dummy"
"267567",0,3,0,3,"dummy"
"267568",0,2,0,2,"dummy"
"267569",3,7,2,12,"dummy"
"267570",2,3,0,5,"dummy"
"267571",3,2,0,5,"dummy"
"267572",5,6,1,12,"dummy"
"267573",2,3,0,5,"dummy"
"267574",0,2,0,2,"dummy"
"267575",0,3,0,3,"dummy"
"267576",4,0,0,4,"dummy"
"267577",0,3,0,3,"dummy"
"267578",13,8,2,23,"dummy"
"267579",0,1,0,1,"dummy"
"267580",0,1,0,1,"dummy"
"267581",0,0,2,2,"dummy"
"267582",0,2,0,2,"dummy"
"267583",0,0,2,2,"dummy"
"267586",1,1,0,2,"dummy"
"267592",1,2,0,3,"dummy"
"267593",0,1,5,6,"dummy"
"267594",1,0,0,1,"dummy"
"267596",0,1,0,1,"dummy"
"267597",0,1,0,1,"dummy"
"267598",0,0,3,3,"dummy"
"267599",0,0,3,3,"dummy"
"267600",0,0,3,3,"dummy"
"267601",0,1,3,4,"dummy"
"267602",0,0,3,3,"dummy"
"267603",0,0,1,1,"dummy"
"267604",0,0,4,4,"dummy"
"267615",3,3,1,7,"dummy"
"267616",0,2,0,2,"dummy"
"267618",0,0,0,0,"dummy"
"267619",0,0,0,0,"dummy"
"267620",0,2,0,2,"dummy"
"267621",0,0,0,0,"dummy"
"267622",0,0,0,0,"dummy"
"267623",1,0,0,1,"dummy"
"267624",0,1,0,1,"dummy"
"267625",0,1,0,1,"dummy"
"267626",0,2,0,2,"dummy"
"267627",0,0,0,0,"dummy"
"267630",0,0,0,0,"dummy"
"267641",0,0,1,1,"dummy"
"267642",0,3,1,4,"dummy"
"267643",1,0,0,1,"dummy"
"267644",0,0,1,1,"dummy"
"267647",1,0,1,2,"dummy"
"267648",0,0,1,1,"dummy"
"267649",0,0,1,1,"dummy"
"267651",2,17,4,23,"dummy"
"267652",0,6,0,6,"dummy"
"267653",0,1,0,1,"dummy"
"267654",1,1,1,3,"dummy"
"267655",1,2,0,3,"dummy"
"267656",5,1,2,8,"dummy"
"267657",0,1,0,1,"dummy"
"267658",0,0,2,2,"dummy"
"267659",1,0,0,1,"dummy"
"267660",0,0,1,1,"dummy"
"267661",9,10,2,21,"dummy"
"267662",0,0,1,1,"dummy"
"267663",0,0,1,1,"dummy"
"267664",0,1,0,1,"dummy"
"267665",0,1,4,5,"dummy"
"267666",0,1,4,5,"dummy"
"267667",0,0,1,1,"dummy"
"267668",0,0,4,4,"dummy"
"267669",0,0,2,2,"dummy"
"267670",0,0,1,1,"dummy"
"267674",0,3,0,3,"dummy"
"267675",1,0,0,1,"dummy"
"267676",0,1,0,1,"dummy"
"267677",0,1,0,1,"dummy"
"267678",1,0,0,1,"dummy"
"267679",0,0,0,0,"dummy"
"267680",1,3,2,6,"dummy"
"267681",0,2,0,2,"dummy"
"267682",5,1,2,8,"dummy"
"267683",0,0,0,0,"dummy"
"267684",0,0,0,0,"dummy"
"267686",0,3,0,3,"dummy"
"267727",0,0,2,2,"dummy"
"267728",0,0,1,1,"dummy"
"267731",0,1,1,2,"dummy"
"267732",2,1,0,3,"dummy"
"267734",0,1,0,1,"dummy"
"267736",0,1,1,2,"dummy"
"267737",0,0,2,2,"dummy"
"267738",3,1,0,4,"dummy"
"267743",2,3,0,5,"dummy"
"267744",1,0,0,1,"dummy"
"267746",0,0,1,1,"dummy"
"267748",1,0,0,1,"dummy"
"267749",0,1,0,1,"dummy"
"267753",3,2,5,10,"dummy"
"267754",1,0,1,2,"dummy"
"267755",0,1,1,2,"dummy"
"267758",0,3,5,8,"dummy"
"267762",1,0,0,1,"dummy"
"267763",0,0,0,0,"dummy"
"267764",1,1,0,2,"dummy"
"267771",2,0,1,3,"dummy"
"267772",1,1,0,2,"dummy"
"267773",2,0,0,2,"dummy"
"267774",0,0,0,0,"dummy"
"267775",0,0,0,0,"dummy"
"267776",2,2,0,4,"dummy"
"267777",0,2,0,2,"dummy"
"267788",0,0,0,0,"dummy"
"267798",0,2,0,2,"dummy"
"267799",2,0,0,2,"dummy"
"267800",12,6,1,19,"dummy"
"267801",2,0,0,2,"dummy"
"267804",3,1,0,4,"dummy"
"267805",1,2,0,3,"dummy"
"267807",0,1,1,2,"dummy"
"267815",4,7,4,15,"dummy"
"267816",1,4,0,5,"dummy"
"267817",0,0,1,1,"dummy"
"267818",0,0,1,1,"dummy"
"267819",0,0,1,1,"dummy"
"267820",0,0,2,2,"dummy"
"267821",0,0,1,1,"dummy"
"267822",0,0,1,1,"dummy"
"267823",0,0,1,1,"dummy"
"267824",0,0,1,1,"dummy"
"267828",2,0,2,4,"dummy"
"267830",1,6,0,7,"dummy"
"267831",5,0,0,5,"dummy"
"267832",5,2,0,7,"dummy"
"267833",2,4,0,6,"dummy"
"267834",0,1,0,1,"dummy"
"267835",0,0,2,2,"dummy"
"267836",0,11,5,16,"dummy"
"267837",0,0,9,9,"dummy"
"267838",0,2,0,2,"dummy"
"267839",2,1,2,5,"dummy"
"267840",0,0,3,3,"dummy"
"267841",6,7,2,15,"dummy"
"267842",2,0,0,2,"dummy"
"267843",2,1,0,3,"dummy"
"267844",0,2,0,2,"dummy"
"267845",1,1,0,2,"dummy"
"267847",8,11,0,19,"dummy"
"267848",0,8,0,8,"dummy"
"267849",0,0,3,3,"dummy"
"267850",1,5,0,6,"dummy"
"267851",0,2,0,2,"dummy"
"267852",6,0,0,6,"dummy"
"267856",0,0,0,0,"dummy"
"267857",4,2,0,6,"dummy"
"267858",2,8,0,10,"dummy"
"267860",3,0,0,3,"dummy"
"267861",0,6,0,6,"dummy"
"267862",0,5,0,5,"dummy"
"267863",14,4,0,18,"dummy"
"267864",0,0,1,1,"dummy"
"267865",2,6,2,10,"dummy"
"267887",0,2,0,2,"dummy"
"267889",2,1,3,6,"dummy"
"267896",0,7,0,7,"dummy"
"267897",0,0,0,0,"dummy"
"267898",0,0,0,0,"dummy"
"267902",0,4,0,4,"dummy"
"267903",0,1,0,1,"dummy"
"267904",0,2,0,2,"dummy"
"267905",0,3,0,3,"dummy"
"267906",0,2,0,2,"dummy"
"267907",0,1,2,3,"dummy"
"267908",0,12,0,12,"dummy"
"267909",0,1,0,1,"dummy"
"267911",0,0,1,1,"dummy"
"267912",3,16,4,23,"dummy"
"267922",0,2,0,2,"dummy"
"267923",2,1,0,3,"dummy"
"267924",0,1,0,1,"dummy"
"267925",1,0,0,1,"dummy"
"267926",1,0,0,1,"dummy"
"267927",1,2,0,3,"dummy"
"267928",4,2,2,8,"dummy"
"267929",2,0,0,2,"dummy"
"267932",0,0,0,0,"dummy"
"267935",0,1,0,1,"dummy"
"267936",2,2,0,4,"dummy"
"267937",2,2,0,4,"dummy"
"267938",3,2,0,5,"dummy"
"267939",1,2,2,5,"dummy"
"267940",2,0,2,4,"dummy"
"267941",3,4,3,10,"dummy"
"267943",1,2,1,4,"dummy"
"267944",1,1,1,3,"dummy"
"267945",0,1,2,3,"dummy"
"267946",1,0,0,1,"dummy"
"267947",2,1,0,3,"dummy"
"267948",0,0,1,1,"dummy"
"267949",8,0,3,11,"dummy"
"267950",3,2,1,6,"dummy"
"267951",2,3,1,6,"dummy"
"267952",0,1,0,1,"dummy"
"267953",0,0,0,0,"dummy"
"267954",0,4,0,4,"dummy"
"267955",0,2,1,3,"dummy"
"267956",2,4,0,6,"dummy"
"267959",0,1,0,1,"dummy"
"267960",0,0,2,2,"dummy"
"267964",0,2,1,3,"dummy"
"267965",10,0,2,12,"dummy"
"267967",3,8,1,12,"dummy"
"267968",0,0,1,1,"dummy"
"267969",0,1,0,1,"dummy"
"267970",17,7,5,29,"dummy"
"267971",3,0,3,6,"dummy"
"267974",1,1,0,2,"dummy"
"267975",1,2,0,3,"dummy"
"267976",0,0,1,1,"dummy"
"267977",0,0,1,1,"dummy"
"267981",2,5,0,7,"dummy"
"267983",0,1,0,1,"dummy"
"267984",0,8,3,11,"dummy"
"267985",0,0,1,1,"dummy"
"267986",0,1,0,1,"dummy"
"267987",0,3,0,3,"dummy"
"267989",2,4,0,6,"dummy"
"267993",0,2,0,2,"dummy"
"267998",0,0,1,1,"dummy"
"267999",0,0,1,1,"dummy"
"268000",0,0,1,1,"dummy"
"268003",0,8,1,9,"dummy"
"268004",0,0,0,0,"dummy"
"268005",0,0,0,0,"dummy"
"268018",3,2,2,7,"dummy"
"268019",1,3,5,9,"dummy"
"268020",0,0,0,0,"dummy"
"268022",2,2,1,5,"dummy"
"268023",0,0,1,1,"dummy"
"268024",0,0,1,1,"dummy"
"268025",0,1,1,2,"dummy"
"268026",0,0,1,1,"dummy"
"268027",0,0,1,1,"dummy"
"268028",2,2,4,8,"dummy"
"268029",0,0,4,4,"dummy"
"268030",0,1,0,1,"dummy"
"268031",2,3,2,7,"dummy"
"268032",0,1,0,1,"dummy"
"268033",0,0,1,1,"dummy"
"268034",0,1,0,1,"dummy"
"268035",0,0,1,1,"dummy"
"268037",0,0,0,0,"dummy"
"268040",0,1,0,1,"dummy"
"268041",0,4,0,4,"dummy"
"268042",0,0,2,2,"dummy"
"268043",0,2,0,2,"dummy"
"268044",6,0,1,7,"dummy"
"268045",0,1,0,1,"dummy"
"268046",0,1,0,1,"dummy"
"268048",0,0,1,1,"dummy"
"268051",10,1,0,11,"dummy"
"268052",0,0,0,0,"dummy"
"268053",1,1,0,2,"dummy"
"268054",0,2,0,2,"dummy"
"268055",0,1,0,1,"dummy"
"268060",0,3,0,3,"dummy"
"268061",0,1,0,1,"dummy"
"268062",0,0,1,1,"dummy"
"268063",0,1,0,1,"dummy"
"268064",0,4,1,5,"dummy"
"268065",1,0,0,1,"dummy"
"268066",4,0,1,5,"dummy"
"268067",3,1,2,6,"dummy"
"268068",0,3,0,3,"dummy"
"268069",3,0,0,3,"dummy"
"268071",0,3,0,3,"dummy"
"268072",0,1,0,1,"dummy"
"268073",1,2,0,3,"dummy"
"268074",0,3,2,5,"dummy"
"268075",0,1,0,1,"dummy"
"268076",2,4,0,6,"dummy"
"268077",0,1,0,1,"dummy"
"268078",1,0,0,1,"dummy"
"268079",1,2,0,3,"dummy"
"268080",1,0,0,1,"dummy"
"268081",2,2,0,4,"dummy"
"268082",2,0,0,2,"dummy"
"268083",1,2,0,3,"dummy"
"268084",0,1,0,1,"dummy"
"268085",0,0,1,1,"dummy"
"268086",0,1,0,1,"dummy"
"268087",0,0,1,1,"dummy"
"268088",2,1,0,3,"dummy"
"268089",0,0,1,1,"dummy"
"268090",0,0,1,1,"dummy"
"268091",0,0,1,1,"dummy"
"268092",0,0,1,1,"dummy"
"268093",4,2,1,7,"dummy"
"268094",0,1,0,1,"dummy"
"268095",0,4,0,4,"dummy"
"268096",0,0,3,3,"dummy"
"268097",0,0,1,1,"dummy"
"268098",3,0,0,3,"dummy"
"268099",0,1,0,1,"dummy"
"268100",0,2,0,2,"dummy"
"268101",0,1,0,1,"dummy"
"268105",0,0,1,1,"dummy"
"268106",2,2,1,5,"dummy"
"268107",0,0,1,1,"dummy"
"268108",0,0,1,1,"dummy"
"268109",0,0,1,1,"dummy"
"268110",0,4,0,4,"dummy"
"268111",0,1,0,1,"dummy"
"268112",6,4,1,11,"dummy"
"268113",1,1,0,2,"dummy"
"268114",0,0,0,0,"dummy"
"268115",7,0,0,7,"dummy"
"268116",1,0,0,1,"dummy"
"268117",0,1,0,1,"dummy"
"268118",1,1,0,2,"dummy"
"268119",0,0,1,1,"dummy"
"268120",0,1,0,1,"dummy"
"268121",0,4,0,4,"dummy"
"268122",0,0,1,1,"dummy"
"268124",1,2,0,3,"dummy"
"268125",0,1,0,1,"dummy"
"268131",1,0,0,1,"dummy"
"268132",1,0,0,1,"dummy"
"268133",0,1,0,1,"dummy"
"268134",11,0,0,11,"dummy"
"268135",5,1,0,6,"dummy"
"268136",0,1,0,1,"dummy"
"268138",0,0,1,1,"dummy"
"268139",0,0,1,1,"dummy"
"268140",1,3,1,5,"dummy"
"268141",0,0,1,1,"dummy"
"268142",0,0,1,1,"dummy"
"268143",0,0,1,1,"dummy"
"268144",0,2,0,2,"dummy"
"268145",0,0,1,1,"dummy"
"268146",0,0,1,1,"dummy"
"268147",3,0,0,3,"dummy"
"268148",0,0,1,1,"dummy"
"268149",0,0,1,1,"dummy"
"268150",0,0,1,1,"dummy"
"268151",0,0,1,1,"dummy"
"268152",0,0,1,1,"dummy"
"268153",0,1,0,1,"dummy"
"268154",0,0,1,1,"dummy"
"268155",0,0,1,1,"dummy"
"268156",0,0,1,1,"dummy"
"268157",0,0,1,1,"dummy"
"268158",0,0,1,1,"dummy"
"268159",0,0,1,1,"dummy"
"268160",0,0,1,1,"dummy"
"268161",0,0,1,1,"dummy"
"268162",0,0,1,1,"dummy"
"268163",0,0,1,1,"dummy"
"268164",0,0,1,1,"dummy"
"268165",0,0,1,1,"dummy"
"268166",0,0,1,1,"dummy"
"268167",0,0,1,1,"dummy"
"268168",0,0,1,1,"dummy"
"268169",0,0,1,1,"dummy"
"268170",0,0,1,1,"dummy"
"268171",0,0,1,1,"dummy"
"268172",0,0,1,1,"dummy"
"268173",0,0,1,1,"dummy"
"268174",0,0,1,1,"dummy"
"268175",0,0,1,1,"dummy"
"268176",0,0,1,1,"dummy"
"268177",0,0,1,1,"dummy"
"268178",0,0,1,1,"dummy"
"268179",0,0,1,1,"dummy"
"268180",0,0,1,1,"dummy"
"268181",0,0,1,1,"dummy"
"268182",0,0,1,1,"dummy"
"268183",0,0,1,1,"dummy"
"268184",0,0,1,1,"dummy"
"268185",0,0,1,1,"dummy"
"268186",0,0,1,1,"dummy"
"268187",0,0,1,1,"dummy"
"268188",0,0,1,1,"dummy"
"268189",3,5,0,8,"dummy"
"268190",0,0,1,1,"dummy"
"268191",0,0,1,1,"dummy"
"268192",0,0,1,1,"dummy"
"268193",0,0,1,1,"dummy"
"268194",0,0,1,1,"dummy"
"268195",0,0,1,1,"dummy"
"268196",0,0,1,1,"dummy"
"268197",0,0,1,1,"dummy"
"268198",0,0,1,1,"dummy"
"268199",0,0,1,1,"dummy"
"268200",0,0,1,1,"dummy"
"268201",0,0,1,1,"dummy"
"268202",0,0,1,1,"dummy"
"268203",0,0,1,1,"dummy"
"268204",0,0,1,1,"dummy"
"268205",0,0,1,1,"dummy"
"268206",0,0,1,1,"dummy"
"268207",0,0,1,1,"dummy"
"268208",0,0,1,1,"dummy"
"268209",0,0,1,1,"dummy"
"268210",0,2,2,4,"dummy"
"268211",0,0,1,1,"dummy"
"268212",0,0,1,1,"dummy"
"268213",0,0,1,1,"dummy"
"268214",0,0,1,1,"dummy"
"268215",0,0,1,1,"dummy"
"268216",0,0,1,1,"dummy"
"268217",0,0,1,1,"dummy"
"268218",0,0,1,1,"dummy"
"268219",0,0,1,1,"dummy"
"268220",0,0,1,1,"dummy"
"268221",0,0,1,1,"dummy"
"268222",0,0,1,1,"dummy"
"268223",0,0,1,1,"dummy"
"268224",0,0,1,1,"dummy"
"268225",0,0,1,1,"dummy"
"268226",0,0,1,1,"dummy"
"268227",0,0,1,1,"dummy"
"268228",0,0,1,1,"dummy"
"268229",0,0,1,1,"dummy"
"268230",0,0,1,1,"dummy"
"268231",0,0,1,1,"dummy"
"268232",0,0,1,1,"dummy"
"268233",0,0,1,1,"dummy"
"268234",0,0,1,1,"dummy"
"268235",9,1,5,15,"dummy"
"268236",0,0,1,1,"dummy"
"268237",0,0,0,0,"dummy"
"268238",0,0,0,0,"dummy"
"268239",0,0,0,0,"dummy"
"268240",0,0,0,0,"dummy"
"268241",0,0,0,0,"dummy"
"268242",0,0,0,0,"dummy"
"268243",0,0,0,0,"dummy"
"268244",0,0,0,0,"dummy"
"268245",0,0,0,0,"dummy"
"268246",0,0,0,0,"dummy"
"268247",0,0,0,0,"dummy"
"268248",0,0,0,0,"dummy"
"268249",0,0,0,0,"dummy"
"268250",0,0,0,0,"dummy"
"268251",0,0,0,0,"dummy"
"268252",0,0,0,0,"dummy"
"268253",0,0,0,0,"dummy"
"268254",0,0,0,0,"dummy"
"268255",0,0,0,0,"dummy"
"268256",0,0,0,0,"dummy"
"268257",0,0,0,0,"dummy"
"268258",0,0,0,0,"dummy"
"268259",0,0,0,0,"dummy"
"268260",0,0,0,0,"dummy"
"268261",0,0,0,0,"dummy"
"268262",0,0,0,0,"dummy"
"268263",0,0,0,0,"dummy"
"268264",0,0,0,0,"dummy"
"268266",1,4,0,5,"dummy"
"268267",0,1,0,1,"dummy"
"268268",0,1,0,1,"dummy"
"268289",1,8,3,12,"dummy"
"268290",0,2,0,2,"dummy"
"268291",2,2,0,4,"dummy"
"268299",0,0,1,1,"dummy"
"268300",0,0,1,1,"dummy"
"268301",0,0,2,2,"dummy"
"268302",26,3,7,36,"dummy"
"268304",0,0,1,1,"dummy"
"268305",0,0,1,1,"dummy"
"268306",0,3,0,3,"dummy"
"268307",2,1,1,4,"dummy"
"268308",0,1,0,1,"dummy"
"268309",1,0,0,1,"dummy"
"268320",0,3,1,4,"dummy"
"268321",10,11,0,21,"dummy"
"268322",0,0,1,1,"dummy"
"268323",2,2,0,4,"dummy"
"268324",1,2,0,3,"dummy"
"268337",0,0,2,2,"dummy"
"268338",2,0,4,6,"dummy"
"268339",0,0,4,4,"dummy"
"268340",0,0,1,1,"dummy"
"268342",0,0,1,1,"dummy"
"268345",0,0,1,1,"dummy"
"268347",0,0,0,0,"dummy"
"268350",0,1,0,1,"dummy"
"268351",0,0,0,0,"dummy"
"268354",0,1,0,1,"dummy"
"268363",2,6,2,10,"dummy"
"268364",3,3,0,6,"dummy"
"268365",1,10,2,13,"dummy"
"268366",0,1,0,1,"dummy"
"268367",0,2,1,3,"dummy"
"268368",0,1,1,2,"dummy"
"268370",6,0,0,6,"dummy"
"268371",2,5,2,9,"dummy"
"268396",1,0,0,1,"dummy"
"268397",2,0,0,2,"dummy"
"268399",0,0,1,1,"dummy"
"268400",0,0,1,1,"dummy"
"268401",1,0,0,1,"dummy"
"268403",0,1,0,1,"dummy"
"268404",0,2,1,3,"dummy"
"268405",0,1,0,1,"dummy"
"268407",5,0,0,5,"dummy"
"268408",0,10,0,10,"dummy"
"268409",0,1,0,1,"dummy"
"268410",4,6,5,15,"dummy"
"268411",0,1,0,1,"dummy"
"268412",0,2,0,2,"dummy"
"268413",9,11,0,20,"dummy"
"268414",0,3,0,3,"dummy"
"268415",8,7,0,15,"dummy"
"268416",3,0,0,3,"dummy"
"268418",1,4,1,6,"dummy"
"268419",8,5,3,16,"dummy"
"268420",2,5,2,9,"dummy"
"268421",0,1,0,1,"dummy"
"268422",3,9,3,15,"dummy"
"268423",1,0,0,1,"dummy"
"268425",0,0,1,1,"dummy"
"268427",1,2,0,3,"dummy"
"268434",0,0,1,1,"dummy"
"268435",0,0,1,1,"dummy"
"268436",0,0,1,1,"dummy"
"268437",0,0,1,1,"dummy"
"268438",0,0,1,1,"dummy"
"268439",0,0,1,1,"dummy"
"268440",0,0,1,1,"dummy"
"268441",0,0,1,1,"dummy"
"268442",0,0,1,1,"dummy"
"268443",0,1,0,1,"dummy"
"268444",0,0,2,2,"dummy"
"268445",0,13,0,13,"dummy"
"268454",0,7,1,8,"dummy"
"268455",0,2,0,2,"dummy"
"268456",2,0,0,2,"dummy"
"268458",0,1,0,1,"dummy"
"268459",9,4,3,16,"dummy"
"268460",0,3,0,3,"dummy"
"268464",0,1,0,1,"dummy"
"268474",0,1,0,1,"dummy"
"268475",1,0,0,1,"dummy"
"268479",0,2,0,2,"dummy"
"268501",0,1,0,1,"dummy"
"268502",0,1,0,1,"dummy"
"268504",5,1,3,9,"dummy"
"268509",0,1,0,1,"dummy"
"268510",0,1,0,1,"dummy"
"268511",0,1,0,1,"dummy"
"268512",4,4,0,8,"dummy"
"268513",0,1,0,1,"dummy"
"268514",1,2,0,3,"dummy"
"268515",0,0,1,1,"dummy"
"268516",0,4,0,4,"dummy"
"268517",0,1,1,2,"dummy"
"268518",0,1,0,1,"dummy"
"268519",0,1,0,1,"dummy"
"268520",3,4,1,8,"dummy"
"268522",1,0,4,5,"dummy"
"268523",0,0,2,2,"dummy"
"268525",0,0,1,1,"dummy"
"268528",0,0,2,2,"dummy"
"268529",0,11,2,13,"dummy"
"268530",0,0,0,0,"dummy"
"268531",0,11,0,11,"dummy"
"268534",0,0,3,3,"dummy"
"268535",0,0,1,1,"dummy"
"268536",0,3,1,4,"dummy"
"268537",2,2,0,4,"dummy"
"268538",2,3,0,5,"dummy"
"268539",2,2,0,4,"dummy"
"268540",2,0,1,3,"dummy"
"268541",21,0,0,21,"dummy"
"268544",0,0,4,4,"dummy"
"268545",2,0,0,2,"dummy"
"268546",0,2,0,2,"dummy"
"268547",0,0,2,2,"dummy"
"268548",0,0,1,1,"dummy"
"268549",5,6,3,14,"dummy"
"268550",0,0,1,1,"dummy"
"268551",0,1,0,1,"dummy"
"268552",2,0,0,2,"dummy"
"268553",0,2,0,2,"dummy"
"268554",1,2,2,5,"dummy"
"268555",0,0,1,1,"dummy"
"268563",0,1,0,1,"dummy"
"268564",0,0,1,1,"dummy"
"268565",0,0,1,1,"dummy"
"268567",2,0,3,5,"dummy"
"268568",1,0,0,1,"dummy"
"268569",0,1,0,1,"dummy"
"268570",0,1,1,2,"dummy"
"268572",0,0,1,1,"dummy"
"268574",0,0,0,0,"dummy"
"268575",3,4,0,7,"dummy"
"268578",0,2,0,2,"dummy"
"268582",0,0,1,1,"dummy"
"268583",0,4,1,5,"dummy"
"268584",0,0,1,1,"dummy"
"268587",1,5,1,7,"dummy"
"268588",1,2,0,3,"dummy"
"268589",1,1,0,2,"dummy"
"268590",0,1,0,1,"dummy"
"268593",8,0,3,11,"dummy"
"268594",3,10,5,18,"dummy"
"268595",0,2,0,2,"dummy"
"268596",0,2,0,2,"dummy"
"268597",1,0,0,1,"dummy"
"268598",0,0,1,1,"dummy"
"268599",0,5,0,5,"dummy"
"268600",0,1,0,1,"dummy"
"268601",0,2,0,2,"dummy"
"268602",0,1,2,3,"dummy"
"268603",14,1,1,16,"dummy"
"268606",0,2,0,2,"dummy"
"268608",0,6,1,7,"dummy"
"268609",0,0,0,0,"dummy"
"268610",4,0,0,4,"dummy"
"268612",0,0,2,2,"dummy"
"268613",0,1,0,1,"dummy"
"268614",1,0,1,2,"dummy"
"268615",0,0,1,1,"dummy"
"268620",1,1,0,2,"dummy"
"268621",1,6,0,7,"dummy"
"268622",0,2,0,2,"dummy"
"268623",0,4,0,4,"dummy"
"268624",0,1,0,1,"dummy"
"268625",0,4,0,4,"dummy"
"268626",0,7,0,7,"dummy"
"268627",0,2,0,2,"dummy"
"268630",0,2,0,2,"dummy"
"268632",0,3,0,3,"dummy"
"268633",6,27,4,37,"dummy"
"268635",0,0,0,0,"dummy"
"268637",0,0,1,1,"dummy"
"268644",4,3,0,7,"dummy"
"268645",0,1,1,2,"dummy"
"268646",2,2,0,4,"dummy"
"268647",0,0,2,2,"dummy"
"268648",5,1,0,6,"dummy"
"268649",1,4,2,7,"dummy"
"268650",0,1,2,3,"dummy"
"268651",0,0,0,0,"dummy"
"268653",0,6,0,6,"dummy"
"268654",0,2,0,2,"dummy"
"268655",0,1,2,3,"dummy"
"268656",0,0,0,0,"dummy"
"268657",0,4,0,4,"dummy"
"268658",0,2,0,2,"dummy"
"268659",0,2,0,2,"dummy"
"268660",4,3,1,8,"dummy"
"268661",3,3,0,6,"dummy"
"268662",0,1,1,2,"dummy"
"268663",1,1,4,6,"dummy"
"268664",4,2,1,7,"dummy"
"268665",0,1,0,1,"dummy"
"268668",0,5,0,5,"dummy"
"268669",7,5,0,12,"dummy"
"268670",0,5,0,5,"dummy"
"268671",0,1,2,3,"dummy"
"268672",1,2,3,6,"dummy"
"268673",1,1,2,4,"dummy"
"268674",0,0,1,1,"dummy"
"268675",0,0,1,1,"dummy"
"268676",0,1,0,1,"dummy"
"268679",0,1,1,2,"dummy"
"268680",0,0,1,1,"dummy"
"268681",1,1,0,2,"dummy"
"268682",0,1,0,1,"dummy"
"268683",0,2,2,4,"dummy"
"268684",0,0,1,1,"dummy"
"268685",0,1,0,1,"dummy"
"268686",1,0,0,1,"dummy"
"268695",0,11,4,15,"dummy"
"268696",0,0,0,0,"dummy"
"268697",11,9,3,23,"dummy"
"268698",0,0,3,3,"dummy"
"268699",0,2,1,3,"dummy"
"268701",2,2,0,4,"dummy"
"268702",2,0,0,2,"dummy"
"268703",5,4,1,10,"dummy"
"268704",1,1,0,2,"dummy"
"268708",38,13,3,54,"dummy"
"268709",0,1,0,1,"dummy"
"268710",0,2,0,2,"dummy"
"268711",1,3,0,4,"dummy"
"268712",3,1,0,4,"dummy"
"268713",0,1,0,1,"dummy"
"268716",1,11,4,16,"dummy"
"268717",0,1,0,1,"dummy"
"268720",0,1,0,1,"dummy"
"268721",0,2,0,2,"dummy"
"268722",0,0,0,0,"dummy"
"268723",4,1,0,5,"dummy"
"268724",1,0,0,1,"dummy"
"268725",2,21,1,24,"dummy"
"268726",0,0,0,0,"dummy"
"268727",0,0,0,0,"dummy"
"268728",5,0,0,5,"dummy"
"268729",2,0,0,2,"dummy"
"268731",0,0,0,0,"dummy"
"268732",0,0,0,0,"dummy"
"268733",0,0,0,0,"dummy"
"268734",0,0,0,0,"dummy"
"268735",0,0,0,0,"dummy"
"268736",0,0,0,0,"dummy"
"268737",0,0,0,0,"dummy"
"268738",0,0,0,0,"dummy"
"268740",0,0,1,1,"dummy"
"268741",1,2,0,3,"dummy"
"268743",1,2,0,3,"dummy"
"268744",1,1,0,2,"dummy"
"268745",0,1,0,1,"dummy"
"268747",0,0,0,0,"dummy"
"268748",0,0,1,1,"dummy"
"268749",1,7,0,8,"dummy"
"268758",0,2,0,2,"dummy"
"268759",2,0,0,2,"dummy"
"268760",0,7,0,7,"dummy"
"268761",0,1,0,1,"dummy"
"268762",0,1,0,1,"dummy"
"268763",0,1,0,1,"dummy"
"268764",1,0,0,1,"dummy"
"268765",0,1,0,1,"dummy"
"268766",1,0,0,1,"dummy"
"268767",0,1,0,1,"dummy"
"268768",1,0,0,1,"dummy"
"268769",0,1,0,1,"dummy"
"268770",1,0,0,1,"dummy"
"268771",1,3,0,4,"dummy"
"268772",7,1,0,8,"dummy"
"268773",0,0,3,3,"dummy"
"268774",0,1,0,1,"dummy"
"268775",1,2,0,3,"dummy"
"268776",1,0,0,1,"dummy"
"268777",0,0,0,0,"dummy"
"268778",2,2,1,5,"dummy"
"268779",0,0,2,2,"dummy"
"268780",0,0,1,1,"dummy"
"268784",1,0,0,1,"dummy"
"268791",0,1,0,1,"dummy"
"268792",3,3,0,6,"dummy"
"268793",2,1,1,4,"dummy"
"268794",0,0,1,1,"dummy"
"268795",2,0,0,2,"dummy"
"268798",0,0,0,0,"dummy"
"268803",0,0,1,1,"dummy"
"268804",0,0,1,1,"dummy"
"268805",1,5,1,7,"dummy"
"268806",5,1,2,8,"dummy"
"268807",4,2,2,8,"dummy"
"268808",2,2,0,4,"dummy"
"268809",0,1,1,2,"dummy"
"268810",0,0,2,2,"dummy"
"268811",0,0,1,1,"dummy"
"268812",0,0,1,1,"dummy"
"268813",1,2,1,4,"dummy"
"268814",0,0,0,0,"dummy"
"268815",5,5,0,10,"dummy"
"268816",0,0,1,1,"dummy"
"268817",1,1,2,4,"dummy"
"268827",3,0,1,4,"dummy"
"268828",4,4,0,8,"dummy"
"268829",1,2,0,3,"dummy"
"268864",0,0,1,1,"dummy"
"268865",0,0,2,2,"dummy"
"268866",0,0,2,2,"dummy"
"268867",0,0,5,5,"dummy"
"268868",4,3,1,8,"dummy"
"268869",0,0,3,3,"dummy"
"268870",1,2,0,3,"dummy"
"268871",0,0,1,1,"dummy"
"268872",0,0,1,1,"dummy"
"268873",0,2,0,2,"dummy"
"268874",0,0,1,1,"dummy"
"268875",2,3,0,5,"dummy"
"268876",0,0,0,0,"dummy"
"268877",0,0,1,1,"dummy"
"268878",8,6,1,15,"dummy"
"268879",2,3,0,5,"dummy"
"268880",0,1,0,1,"dummy"
"268881",4,1,4,9,"dummy"
"268882",13,0,0,13,"dummy"
"268883",0,0,3,3,"dummy"
"268884",1,0,0,1,"dummy"
"268885",1,0,0,1,"dummy"
"268886",0,1,1,2,"dummy"
"268887",0,4,0,4,"dummy"
"268888",1,1,0,2,"dummy"
"268889",0,0,2,2,"dummy"
"268890",0,7,3,10,"dummy"
"268891",0,0,2,2,"dummy"
"268901",0,0,0,0,"dummy"
"268902",0,2,0,2,"dummy"
"268903",2,2,0,4,"dummy"
"268904",0,0,1,1,"dummy"
"268905",2,1,0,3,"dummy"
"268906",1,21,0,22,"dummy"
"268907",6,11,1,18,"dummy"
"268755",3,20,1,24,"dummy"
"268756",17,11,0,28,"dummy"
"268782",0,1,0,1,"dummy"
"268788",3,3,0,6,"dummy"
"268789",0,1,0,1,"dummy"
"268823",0,0,1,1,"dummy"
"268824",0,1,1,2,"dummy"
"268825",0,0,3,3,"dummy"
"268835",0,0,2,2,"dummy"
"268840",0,2,0,2,"dummy"
"268841",1,1,2,4,"dummy"
"268853",0,1,0,1,"dummy"
"268854",3,0,0,3,"dummy"
"268855",7,0,2,9,"dummy"
"268856",16,7,3,26,"dummy"
"268857",0,0,1,1,"dummy"
"268858",0,0,1,1,"dummy"
"268899",0,0,0,0,"dummy"
"268909",0,1,0,1,"dummy"
"268924",1,0,0,1,"dummy"
"268925",0,0,1,1,"dummy"
"268930",2,0,0,2,"dummy"
"268933",2,1,1,4,"dummy"
"268948",0,1,1,2,"dummy"
"268959",0,0,1,1,"dummy"
"268966",0,0,1,1,"dummy"
"268972",0,2,0,2,"dummy"
"268973",0,1,0,1,"dummy"
"268974",0,1,1,2,"dummy"
"268975",3,10,4,17,"dummy"
"268989",0,1,0,1,"dummy"
"268990",0,0,2,2,"dummy"
"268991",0,0,1,1,"dummy"
"268996",0,0,1,1,"dummy"
"269038",0,1,0,1,"dummy"
"269039",1,1,0,2,"dummy"
"269123",2,12,3,17,"dummy"
"269124",1,14,2,17,"dummy"
"269125",3,1,2,6,"dummy"
"269126",5,1,0,6,"dummy"
"269127",0,2,0,2,"dummy"
"269128",1,4,0,5,"dummy"
"269129",0,1,0,1,"dummy"
"269130",1,2,1,4,"dummy"
"269131",21,0,0,21,"dummy"
"269139",0,3,0,3,"dummy"
"269142",0,1,0,1,"dummy"
"269143",3,4,2,9,"dummy"
"269152",0,0,0,0,"dummy"
"269153",0,2,0,2,"dummy"
"269154",0,0,0,0,"dummy"
"269155",0,0,1,1,"dummy"
"268935",0,0,1,1,"dummy"
"268936",0,0,2,2,"dummy"
"268937",0,0,2,2,"dummy"
"268938",0,0,2,2,"dummy"
"268941",0,0,1,1,"dummy"
"268942",0,0,1,1,"dummy"
"268943",6,6,2,14,"dummy"
"268944",0,0,1,1,"dummy"
"268945",0,0,1,1,"dummy"
"268946",0,0,1,1,"dummy"
"268968",0,0,0,0,"dummy"
"268977",0,1,0,1,"dummy"
"268978",0,1,0,1,"dummy"
"268979",0,1,0,1,"dummy"
"268980",1,1,0,2,"dummy"
"268981",0,1,0,1,"dummy"
"268982",1,1,0,2,"dummy"
"268985",0,4,0,4,"dummy"
"268986",1,3,4,8,"dummy"
"268987",0,4,0,4,"dummy"
"268998",0,0,8,8,"dummy"
"269041",0,0,1,1,"dummy"
"269042",0,0,1,1,"dummy"
"269043",0,0,1,1,"dummy"
"269044",0,0,1,1,"dummy"
"269045",0,0,1,1,"dummy"
"269046",0,0,1,1,"dummy"
"269047",0,0,1,1,"dummy"
"269048",0,0,1,1,"dummy"
"269049",0,0,1,1,"dummy"
"269050",0,0,1,1,"dummy"
"269051",0,0,1,1,"dummy"
"269052",0,0,1,1,"dummy"
"269053",0,0,1,1,"dummy"
"269054",0,0,1,1,"dummy"
"269055",0,0,1,1,"dummy"
"269056",0,0,1,1,"dummy"
"269057",0,0,1,1,"dummy"
"269058",0,0,1,1,"dummy"
"269059",0,0,1,1,"dummy"
"269060",0,0,1,1,"dummy"
"269061",0,0,1,1,"dummy"
"269062",0,0,1,1,"dummy"
"269065",0,2,0,2,"dummy"
"269066",0,5,0,5,"dummy"
"269067",0,1,1,2,"dummy"
"269068",8,4,0,12,"dummy"
"269069",2,4,0,6,"dummy"
"269070",3,1,1,5,"dummy"
"269071",1,4,0,5,"dummy"
"269072",4,4,0,8,"dummy"
"269073",0,0,0,0,"dummy"
"269074",1,0,0,1,"dummy"
"269075",0,3,0,3,"dummy"
"269076",0,1,0,1,"dummy"
"269077",0,1,0,1,"dummy"
"269078",0,0,0,0,"dummy"
"269079",0,0,4,4,"dummy"
"269080",6,0,0,6,"dummy"
"269085",0,2,0,2,"dummy"
"269088",0,0,1,1,"dummy"
"269089",0,2,0,2,"dummy"
"269090",2,0,0,2,"dummy"
"269091",1,4,0,5,"dummy"
"269092",0,1,1,2,"dummy"
"269093",4,0,0,4,"dummy"
"269094",13,6,3,22,"dummy"
"269095",0,0,1,1,"dummy"
"269096",3,6,0,9,"dummy"
"269101",0,0,1,1,"dummy"
"269102",0,0,1,1,"dummy"
"269103",0,0,1,1,"dummy"
"269104",0,0,1,1,"dummy"
"269105",0,0,1,1,"dummy"
"269106",0,0,1,1,"dummy"
"269107",0,0,1,1,"dummy"
"269108",0,0,1,1,"dummy"
"269109",0,0,1,1,"dummy"
"269110",0,0,1,1,"dummy"
"269111",0,0,1,1,"dummy"
"269112",0,0,1,1,"dummy"
"269113",0,0,1,1,"dummy"
"269114",0,0,1,1,"dummy"
"269115",0,0,1,1,"dummy"
"269116",0,0,1,1,"dummy"
"269117",0,0,1,1,"dummy"
"269118",0,0,1,1,"dummy"
"269119",0,0,1,1,"dummy"
"269120",0,0,1,1,"dummy"
"269121",0,0,1,1,"dummy"
"269133",0,0,0,0,"dummy"
"269134",0,0,0,0,"dummy"
"269135",0,0,0,0,"dummy"
"269136",2,2,0,4,"dummy"
"269137",2,2,0,4,"dummy"
"269145",0,2,1,3,"dummy"
"269146",1,1,0,2,"dummy"
"269147",1,9,0,10,"dummy"
"269148",1,1,0,2,"dummy"
"269149",2,10,0,12,"dummy"
"269150",0,0,4,4,"dummy"
"269161",0,1,0,1,"dummy"
"269165",0,3,0,3,"dummy"
"269166",3,0,0,3,"dummy"
"269167",0,0,1,1,"dummy"
"269179",1,7,0,8,"dummy"
"269182",0,1,0,1,"dummy"
"269185",2,0,2,4,"dummy"
"269188",0,2,0,2,"dummy"
"269189",0,0,1,1,"dummy"
"269190",0,0,1,1,"dummy"
"269191",0,0,1,1,"dummy"
"269194",8,1,1,10,"dummy"
"269195",0,0,1,1,"dummy"
"269196",0,1,0,1,"dummy"
"269197",0,0,1,1,"dummy"
"269200",4,4,3,11,"dummy"
"269201",0,2,0,2,"dummy"
"269202",0,0,0,0,"dummy"
"269203",4,0,5,9,"dummy"
"269204",0,0,2,2,"dummy"
"269209",0,4,1,5,"dummy"
"269216",0,0,1,1,"dummy"
"269217",1,1,3,5,"dummy"
"269218",0,6,4,10,"dummy"
"269219",0,8,9,17,"dummy"
"269227",0,0,1,1,"dummy"
"269228",0,0,1,1,"dummy"
"269229",0,0,1,1,"dummy"
"269230",0,0,2,2,"dummy"
"269240",1,4,0,5,"dummy"
"269241",2,2,2,6,"dummy"
"269265",0,0,1,1,"dummy"
"269266",4,5,2,11,"dummy"
"269267",5,4,2,11,"dummy"
"269268",0,0,1,1,"dummy"
"269269",5,7,1,13,"dummy"
"269270",2,1,1,4,"dummy"
"269271",0,0,1,1,"dummy"
"269272",0,0,1,1,"dummy"
"269278",1,0,0,1,"dummy"
"269279",2,0,0,2,"dummy"
"269319",3,0,0,3,"dummy"
"269320",1,0,2,3,"dummy"
"269321",0,2,0,2,"dummy"
"269322",0,0,0,0,"dummy"
"269156",0,0,2,2,"dummy"
"269157",0,0,2,2,"dummy"
"269158",0,0,1,1,"dummy"
"269159",0,0,0,0,"dummy"
"269163",0,1,0,1,"dummy"
"269169",0,0,1,1,"dummy"
"269174",0,2,0,2,"dummy"
"269175",0,1,0,1,"dummy"
"269176",3,4,1,8,"dummy"
"269177",0,1,1,2,"dummy"
"269221",0,1,0,1,"dummy"
"269222",0,2,0,2,"dummy"
"269223",0,4,0,4,"dummy"
"269224",0,2,4,6,"dummy"
"269225",0,0,1,1,"dummy"
"269249",1,2,0,3,"dummy"
"269250",0,0,1,1,"dummy"
"269251",0,0,1,1,"dummy"
"269252",0,0,3,3,"dummy"
"269253",0,0,1,1,"dummy"
"269254",0,1,3,4,"dummy"
"269255",0,6,0,6,"dummy"
"269256",0,0,1,1,"dummy"
"269257",0,0,1,1,"dummy"
"269258",0,0,1,1,"dummy"
"269259",0,0,1,1,"dummy"
"269260",0,0,1,1,"dummy"
"269261",0,0,1,1,"dummy"
"269262",0,0,1,1,"dummy"
"269263",0,0,1,1,"dummy"
"269274",0,0,2,2,"dummy"
"269275",6,8,2,16,"dummy"
"269276",0,1,0,1,"dummy"
"269281",1,0,0,1,"dummy"
"269284",0,7,0,7,"dummy"
"269307",0,0,1,1,"dummy"
"269308",0,1,0,1,"dummy"
"269309",0,0,0,0,"dummy"
"269324",0,16,3,19,"dummy"
"269335",0,1,0,1,"dummy"
"269336",0,3,0,3,"dummy"
"269337",0,5,0,5,"dummy"
"269338",6,2,0,8,"dummy"
"269339",0,1,1,2,"dummy"
"269340",0,1,0,1,"dummy"
"269341",2,0,0,2,"dummy"
"269342",0,0,1,1,"dummy"
"269343",0,3,0,3,"dummy"
"269344",0,2,0,2,"dummy"
"269345",10,4,0,14,"dummy"
"269346",0,9,0,9,"dummy"
"269347",1,0,0,1,"dummy"
"269348",2,2,0,4,"dummy"
"269349",0,1,2,3,"dummy"
"269350",1,0,0,1,"dummy"
"269351",0,1,0,1,"dummy"
"269352",0,0,2,2,"dummy"
"269353",14,7,0,21,"dummy"
"269354",2,3,1,6,"dummy"
"269358",2,6,1,9,"dummy"
"269374",2,4,0,6,"dummy"
"269375",0,2,0,2,"dummy"
"269376",0,2,0,2,"dummy"
"269377",10,2,0,12,"dummy"
"269378",0,2,0,2,"dummy"
"269379",0,0,0,0,"dummy"
"269380",0,0,3,3,"dummy"
"269381",0,5,0,5,"dummy"
"269382",1,0,1,2,"dummy"
"269391",1,5,0,6,"dummy"
"269356",0,8,0,8,"dummy"
"269367",1,1,0,2,"dummy"
"269370",0,0,1,1,"dummy"
"269371",1,1,0,2,"dummy"
"269372",0,0,1,1,"dummy"
"269384",0,0,1,1,"dummy"
"269385",0,1,0,1,"dummy"
"269386",1,15,1,17,"dummy"
"269387",1,1,1,3,"dummy"
"269388",0,0,2,2,"dummy"
"269389",0,1,0,1,"dummy"
"269396",0,1,0,1,"dummy"
"269397",0,0,1,1,"dummy"
"269410",0,1,0,1,"dummy"
"269411",0,0,1,1,"dummy"
"269412",0,1,1,2,"dummy"
"269437",0,1,0,1,"dummy"
"269438",0,2,0,2,"dummy"
"269439",0,0,2,2,"dummy"
"269440",0,0,2,2,"dummy"
"269441",0,0,2,2,"dummy"
"269446",0,0,1,1,"dummy"
"269451",0,4,0,4,"dummy"
"269478",0,0,1,1,"dummy"
"269479",0,0,1,1,"dummy"
"269480",0,1,2,3,"dummy"
"269481",0,0,0,0,"dummy"
"269488",2,0,3,5,"dummy"
"269493",0,0,0,0,"dummy"
"269494",1,0,0,1,"dummy"
"269495",0,0,0,0,"dummy"
"269496",0,0,0,0,"dummy"
"269497",0,0,0,0,"dummy"
"269498",0,0,0,0,"dummy"
"269499",2,0,0,2,"dummy"
"269500",0,2,0,2,"dummy"
"269501",2,0,0,2,"dummy"
"269502",0,0,0,0,"dummy"
"269503",0,0,0,0,"dummy"
"269504",0,0,0,0,"dummy"
"269505",0,0,0,0,"dummy"
"269506",0,0,0,0,"dummy"
"269509",3,0,1,4,"dummy"
"269510",0,3,1,4,"dummy"
"269511",0,2,2,4,"dummy"
"269512",2,5,1,8,"dummy"
"269513",4,0,3,7,"dummy"
"269528",0,0,1,1,"dummy"
"269529",0,1,0,1,"dummy"
"269532",0,0,0,0,"dummy"
"269550",17,3,0,20,"dummy"
"269551",4,1,0,5,"dummy"
"269552",1,0,1,2,"dummy"
"269553",18,5,8,31,"dummy"
"269554",0,0,0,0,"dummy"
"269563",0,6,0,6,"dummy"
"269564",1,4,1,6,"dummy"
"269565",2,1,2,5,"dummy"
"269566",0,1,0,1,"dummy"
"269567",0,4,0,4,"dummy"
"269568",4,0,0,4,"dummy"
"269571",0,3,0,3,"dummy"
"269572",0,1,0,1,"dummy"
"269573",0,1,0,1,"dummy"
"269574",1,0,0,1,"dummy"
"269575",1,7,2,10,"dummy"
"269604",0,0,1,1,"dummy"
"269621",0,3,1,4,"dummy"
"269622",0,1,0,1,"dummy"
"269623",0,0,1,1,"dummy"
"269624",0,0,1,1,"dummy"
"269631",0,0,1,1,"dummy"
"269392",2,3,1,6,"dummy"
"269393",6,6,8,20,"dummy"
"269394",14,2,2,18,"dummy"
"269399",4,3,4,11,"dummy"
"269400",0,0,2,2,"dummy"
"269401",0,0,1,1,"dummy"
"269402",0,3,0,3,"dummy"
"269403",9,2,1,12,"dummy"
"269404",0,0,1,1,"dummy"
"269455",0,14,1,15,"dummy"
"269456",0,0,0,0,"dummy"
"269457",16,18,2,36,"dummy"
"269458",0,3,0,3,"dummy"
"269459",6,0,0,6,"dummy"
"269460",0,4,0,4,"dummy"
"269461",0,0,1,1,"dummy"
"269462",1,3,0,4,"dummy"
"269463",0,3,1,4,"dummy"
"269464",0,10,0,10,"dummy"
"269465",0,10,1,11,"dummy"
"269466",6,5,3,14,"dummy"
"269467",0,1,3,4,"dummy"
"269468",0,0,1,1,"dummy"
"269469",0,0,1,1,"dummy"
"269470",0,0,1,1,"dummy"
"269471",0,2,2,4,"dummy"
"269472",1,2,0,3,"dummy"
"269473",1,0,1,2,"dummy"
"269474",3,13,1,17,"dummy"
"269475",4,0,0,4,"dummy"
"269476",0,0,0,0,"dummy"
"269490",9,1,2,12,"dummy"
"269491",0,1,0,1,"dummy"
"269515",0,0,0,0,"dummy"
"269516",0,0,1,1,"dummy"
"269517",0,1,0,1,"dummy"
"269525",4,3,0,7,"dummy"
"269526",7,0,0,7,"dummy"
"269534",0,0,1,1,"dummy"
"269535",0,1,4,5,"dummy"
"269536",0,0,0,0,"dummy"
"269537",0,2,1,3,"dummy"
"269538",0,0,1,1,"dummy"
"269539",0,1,1,2,"dummy"
"269540",0,0,1,1,"dummy"
"269541",0,0,1,1,"dummy"
"269542",0,0,1,1,"dummy"
"269543",0,0,2,2,"dummy"
"269544",0,0,1,1,"dummy"
"269545",0,0,0,0,"dummy"
"269546",0,0,1,1,"dummy"
"269547",11,10,5,26,"dummy"
"269548",0,1,1,2,"dummy"
"269577",0,1,0,1,"dummy"
"269578",0,0,1,1,"dummy"
"269579",0,1,0,1,"dummy"
"269626",7,8,0,15,"dummy"
"269627",8,7,0,15,"dummy"
"269628",0,4,1,5,"dummy"
"269629",8,5,1,14,"dummy"
"269639",3,0,0,3,"dummy"
"269640",0,0,1,1,"dummy"
"269641",0,0,1,1,"dummy"
"269642",0,0,1,1,"dummy"
"269643",0,0,1,1,"dummy"
"269648",0,2,0,2,"dummy"
"269649",6,1,3,10,"dummy"
"269650",1,4,3,8,"dummy"
"269659",1,0,1,2,"dummy"
"269634",0,0,5,5,"dummy"
"269635",0,0,5,5,"dummy"
"269636",0,0,0,0,"dummy"
"269637",3,1,4,8,"dummy"
"269675",0,0,1,1,"dummy"
"269678",0,0,1,1,"dummy"
"269679",0,1,0,1,"dummy"
"269680",0,0,1,1,"dummy"
"269681",0,0,1,1,"dummy"
"269686",0,11,0,11,"dummy"
"269692",0,1,0,1,"dummy"
"269693",7,0,0,7,"dummy"
"269694",2,7,0,9,"dummy"
"269697",0,4,0,4,"dummy"
"269698",0,0,0,0,"dummy"
"269699",1,0,0,1,"dummy"
"269700",0,0,0,0,"dummy"
"269701",0,1,0,1,"dummy"
"269702",0,9,2,11,"dummy"
"269705",0,0,1,1,"dummy"
"269713",0,0,3,3,"dummy"
"269717",0,0,2,2,"dummy"
"269718",0,2,0,2,"dummy"
"269688",4,4,0,8,"dummy"
"269689",4,4,0,8,"dummy"
"269690",4,4,0,8,"dummy"
"269709",0,0,0,0,"dummy"
"269710",1,0,0,1,"dummy"
"269711",3,0,0,3,"dummy"
"269715",10,1,0,11,"dummy"
"269722",0,3,0,3,"dummy"
"269723",3,1,1,5,"dummy"
"269746",8,0,2,10,"dummy"
"269778",0,0,1,1,"dummy"
"269779",0,0,0,0,"dummy"
"269783",0,0,1,1,"dummy"
"269784",1,1,1,3,"dummy"
"269786",0,1,1,2,"dummy"
"269789",3,7,1,11,"dummy"
"269792",0,0,0,0,"dummy"
"269794",0,1,0,1,"dummy"
"269795",0,2,0,2,"dummy"
"269799",10,2,0,12,"dummy"
"269800",1,10,0,11,"dummy"
"269801",2,2,0,4,"dummy"
"269802",0,1,0,1,"dummy"
"269803",6,2,0,8,"dummy"
"269804",1,9,1,11,"dummy"
"269805",0,0,1,1,"dummy"
"269806",0,5,0,5,"dummy"
"269807",0,1,0,1,"dummy"
"269808",11,0,2,13,"dummy"
"269809",0,0,2,2,"dummy"
"269811",0,1,0,1,"dummy"
"269814",1,0,1,2,"dummy"
"269815",0,0,1,1,"dummy"
"269816",1,1,0,2,"dummy"
"269817",2,11,0,13,"dummy"
"269823",0,1,1,2,"dummy"
"269824",0,0,1,1,"dummy"
"269825",0,1,0,1,"dummy"
"269826",0,1,0,1,"dummy"
"269827",0,0,1,1,"dummy"
"269828",0,1,0,1,"dummy"
"269829",0,1,0,1,"dummy"
"269830",3,0,0,3,"dummy"
"269834",0,0,1,1,"dummy"
"269835",3,11,0,14,"dummy"
"269837",2,2,1,5,"dummy"
"269838",2,0,0,2,"dummy"
"269839",3,0,3,6,"dummy"
"269840",0,1,0,1,"dummy"
"269841",1,2,0,3,"dummy"
"269842",0,0,0,0,"dummy"
"269843",3,3,2,8,"dummy"
"269844",0,2,1,3,"dummy"
"269845",0,3,0,3,"dummy"
"269846",2,3,2,7,"dummy"
"269847",0,0,1,1,"dummy"
"269848",0,0,1,1,"dummy"
"269851",1,2,0,3,"dummy"
"269854",9,8,2,19,"dummy"
"269855",6,4,2,12,"dummy"
"269856",1,4,4,9,"dummy"
"269858",3,2,1,6,"dummy"
"269859",0,0,3,3,"dummy"
"269865",0,1,2,3,"dummy"
"269866",2,7,0,9,"dummy"
"269867",0,0,0,0,"dummy"
"269868",0,0,0,0,"dummy"
"269869",7,0,0,7,"dummy"
"269870",3,0,0,3,"dummy"
"269871",0,0,2,2,"dummy"
"269872",4,1,1,6,"dummy"
"269874",0,1,0,1,"dummy"
"269876",0,2,0,2,"dummy"
"269878",7,2,2,11,"dummy"
"269880",0,0,1,1,"dummy"
"269881",0,0,1,1,"dummy"
"269882",0,4,0,4,"dummy"
"269884",0,3,0,3,"dummy"
"269885",0,0,1,1,"dummy"
"269886",0,2,0,2,"dummy"
"269887",1,0,3,4,"dummy"
"269888",0,6,0,6,"dummy"
"269890",0,2,0,2,"dummy"
"269891",0,0,1,1,"dummy"
"269892",2,1,2,5,"dummy"
"269893",1,4,0,5,"dummy"
"269894",0,7,2,9,"dummy"
"269895",2,1,1,4,"dummy"
"269897",1,0,1,2,"dummy"
"269899",4,9,1,14,"dummy"
"269900",0,1,0,1,"dummy"
"269901",0,1,4,5,"dummy"
"269902",0,1,0,1,"dummy"
"269903",0,0,0,0,"dummy"
"269904",2,5,0,7,"dummy"
"269905",1,1,0,2,"dummy"
"269906",1,6,0,7,"dummy"
"269907",2,2,1,5,"dummy"
"269908",1,6,0,7,"dummy"
"269909",1,0,0,1,"dummy"
"269910",6,0,0,6,"dummy"
"269913",1,3,0,4,"dummy"
"269914",2,3,2,7,"dummy"
"269915",0,0,1,1,"dummy"
"269916",0,0,1,1,"dummy"
"269917",0,1,0,1,"dummy"
"269918",0,0,1,1,"dummy"
"269919",7,8,3,18,"dummy"
"269920",0,1,3,4,"dummy"
"269921",1,1,0,2,"dummy"
"269922",1,0,4,5,"dummy"
"269923",0,1,0,1,"dummy"
"269930",0,0,2,2,"dummy"
"269941",2,0,0,2,"dummy"
"269942",0,1,0,1,"dummy"
"269944",0,2,0,2,"dummy"
"269945",2,2,2,6,"dummy"
"269946",0,0,1,1,"dummy"
"269948",0,6,0,6,"dummy"
"269957",2,1,1,4,"dummy"
"269959",0,0,1,1,"dummy"
"269960",0,0,1,1,"dummy"
"269962",0,1,0,1,"dummy"
"269965",0,0,0,0,"dummy"
"269966",0,0,0,0,"dummy"
"269967",0,0,1,1,"dummy"
"269968",0,0,0,0,"dummy"
"269969",0,0,0,0,"dummy"
"269974",3,8,1,12,"dummy"
"269975",0,0,1,1,"dummy"
"269976",0,1,0,1,"dummy"
"269977",17,7,5,29,"dummy"
"269978",3,0,3,6,"dummy"
"269985",0,7,0,7,"dummy"
"269986",2,3,0,5,"dummy"
"269987",0,1,0,1,"dummy"
"269988",0,0,1,1,"dummy"
"269996",0,0,3,3,"dummy"
"270030",0,1,0,1,"dummy"
"270031",0,3,0,3,"dummy"
"270032",20,20,0,40,"dummy"
"270033",0,3,0,3,"dummy"
"270034",0,10,1,11,"dummy"
"270035",0,0,1,1,"dummy"
"270036",0,6,0,6,"dummy"
"270037",0,2,0,2,"dummy"
"270038",1,1,0,2,"dummy"
"270039",7,0,1,8,"dummy"
"270040",0,0,1,1,"dummy"
"270041",0,0,1,1,"dummy"
"270042",1,2,0,3,"dummy"
"270043",0,1,0,1,"dummy"
"270053",0,0,1,1,"dummy"
"270056",0,2,0,2,"dummy"
"270092",0,0,2,2,"dummy"
"270093",0,0,1,1,"dummy"
"270094",0,2,0,2,"dummy"
"270100",1,11,1,13,"dummy"
"270101",1,0,1,2,"dummy"
"270110",0,3,1,4,"dummy"
"270121",6,0,0,6,"dummy"
"270137",0,4,0,4,"dummy"
"270138",0,1,0,1,"dummy"
"270139",1,3,0,4,"dummy"
"270140",0,8,0,8,"dummy"
"270141",3,5,1,9,"dummy"
"270142",0,0,1,1,"dummy"
"270143",0,3,0,3,"dummy"
"270144",0,0,1,1,"dummy"
"270145",0,0,1,1,"dummy"
"270146",0,0,1,1,"dummy"
"270147",0,1,0,1,"dummy"
"270148",0,0,2,2,"dummy"
"270149",0,0,1,1,"dummy"
"270150",1,1,1,3,"dummy"
"270151",0,0,1,1,"dummy"
"270152",0,0,1,1,"dummy"
"270153",0,2,0,2,"dummy"
"270154",1,1,0,2,"dummy"
"270155",0,0,1,1,"dummy"
"270156",0,0,2,2,"dummy"
"270157",0,0,1,1,"dummy"
"270158",0,0,1,1,"dummy"
"270159",0,0,0,0,"dummy"
"270160",0,0,1,1,"dummy"
"270161",0,0,1,1,"dummy"
"270162",0,0,3,3,"dummy"
"270163",0,0,2,2,"dummy"
"270164",0,0,3,3,"dummy"
"270165",0,0,2,2,"dummy"
"270166",0,0,1,1,"dummy"
"270167",0,0,2,2,"dummy"
"270168",0,0,1,1,"dummy"
"270169",0,0,1,1,"dummy"
"270170",0,0,2,2,"dummy"
"270171",0,0,2,2,"dummy"
"270172",0,0,1,1,"dummy"
"270173",0,0,1,1,"dummy"
"270174",0,0,2,2,"dummy"
"270175",0,0,2,2,"dummy"
"270176",0,0,2,2,"dummy"
"270177",0,0,3,3,"dummy"
"270178",0,0,2,2,"dummy"
"270182",0,0,0,0,"dummy"
"269990",2,4,0,6,"dummy"
"269991",3,3,2,8,"dummy"
"269992",2,2,0,4,"dummy"
"269998",0,0,1,1,"dummy"
"269999",2,2,1,5,"dummy"
"270002",0,2,0,2,"dummy"
"270003",0,4,0,4,"dummy"
"270004",0,1,0,1,"dummy"
"270007",0,0,2,2,"dummy"
"270008",0,0,2,2,"dummy"
"270017",1,0,1,2,"dummy"
"270020",0,0,0,0,"dummy"
"270021",0,0,0,0,"dummy"
"270022",0,0,0,0,"dummy"
"270023",0,0,1,1,"dummy"
"270024",0,0,0,0,"dummy"
"270025",0,0,0,0,"dummy"
"270026",0,0,0,0,"dummy"
"270027",0,0,1,1,"dummy"
"270028",0,0,0,0,"dummy"
"270045",0,0,1,1,"dummy"
"270046",0,0,1,1,"dummy"
"270047",1,0,0,1,"dummy"
"270058",1,1,0,2,"dummy"
"270059",1,0,1,2,"dummy"
"270060",0,1,0,1,"dummy"
"270061",0,0,1,1,"dummy"
"270062",0,2,0,2,"dummy"
"270063",2,0,0,2,"dummy"
"270064",0,0,0,0,"dummy"
"270073",0,0,1,1,"dummy"
"270074",2,2,0,4,"dummy"
"270075",0,0,1,1,"dummy"
"270076",0,0,1,1,"dummy"
"270077",0,0,1,1,"dummy"
"270078",0,0,1,1,"dummy"
"270079",0,0,1,1,"dummy"
"270080",0,0,1,1,"dummy"
"270081",0,0,1,1,"dummy"
"270082",0,0,1,1,"dummy"
"270083",2,2,0,4,"dummy"
"270084",0,0,1,1,"dummy"
"270085",1,1,0,2,"dummy"
"270086",0,0,1,1,"dummy"
"270089",0,0,0,0,"dummy"
"270090",0,0,0,0,"dummy"
"270096",1,0,0,1,"dummy"
"270103",0,1,0,1,"dummy"
"270108",0,0,2,2,"dummy"
"270116",7,0,0,7,"dummy"
"270117",0,0,1,1,"dummy"
"270125",0,0,3,3,"dummy"
"270126",0,6,1,7,"dummy"
"270127",0,2,0,2,"dummy"
"270128",2,2,0,4,"dummy"
"270129",1,1,0,2,"dummy"
"270130",0,0,2,2,"dummy"
"270131",1,1,0,2,"dummy"
"270132",0,3,0,3,"dummy"
"270133",1,0,3,4,"dummy"
"270134",0,0,3,3,"dummy"
"270135",1,1,0,2,"dummy"
"270180",0,0,0,0,"dummy"
"270192",0,1,0,1,"dummy"
"270193",3,2,0,5,"dummy"
"270194",1,3,0,4,"dummy"
"270195",0,0,0,0,"dummy"
"270196",3,1,0,4,"dummy"
"270197",0,0,1,1,"dummy"
"270198",1,0,0,1,"dummy"
"270199",0,0,1,1,"dummy"
"270200",0,0,0,0,"dummy"
"270201",0,0,1,1,"dummy"
"270202",0,0,1,1,"dummy"
"270203",0,0,0,0,"dummy"
"270185",0,0,1,1,"dummy"
"270186",0,0,1,1,"dummy"
"270187",0,2,0,2,"dummy"
"270188",0,0,2,2,"dummy"
"270189",0,2,0,2,"dummy"
"270190",2,3,1,6,"dummy"
"270211",0,1,0,1,"dummy"
"270212",0,1,0,1,"dummy"
"270257",0,2,0,2,"dummy"
"270258",0,1,0,1,"dummy"
"270259",1,3,0,4,"dummy"
"270260",3,5,0,8,"dummy"
"270261",0,1,0,1,"dummy"
"270262",0,1,0,1,"dummy"
"270263",0,1,0,1,"dummy"
"270264",0,1,0,1,"dummy"
"270265",0,3,0,3,"dummy"
"270266",0,0,1,1,"dummy"
"270267",0,1,0,1,"dummy"
"270268",0,3,0,3,"dummy"
"270269",0,1,0,1,"dummy"
"270277",0,8,0,8,"dummy"
"270287",1,2,0,3,"dummy"
"270288",1,0,0,1,"dummy"
"270289",2,2,0,4,"dummy"
"270329",0,0,1,1,"dummy"
"270330",0,2,3,5,"dummy"
"270331",0,0,1,1,"dummy"
"270332",0,0,4,4,"dummy"
"270337",1,5,0,6,"dummy"
"270349",0,0,0,0,"dummy"
"270350",0,0,0,0,"dummy"
"270372",0,0,0,0,"dummy"
"270373",3,4,4,11,"dummy"
"270374",0,1,2,3,"dummy"
"270375",5,8,1,14,"dummy"
"270376",2,0,0,2,"dummy"
"270377",0,0,0,0,"dummy"
"270378",0,0,0,0,"dummy"
"270390",2,4,3,9,"dummy"
"270391",5,1,0,6,"dummy"
"270392",0,1,2,3,"dummy"
"270393",0,2,2,4,"dummy"
"270394",0,1,1,2,"dummy"
"270401",0,0,1,1,"dummy"
"270415",0,1,0,1,"dummy"
"270420",0,0,0,0,"dummy"
"270421",0,6,0,6,"dummy"
"270422",6,2,0,8,"dummy"
"270423",2,6,0,8,"dummy"
"270424",0,0,0,0,"dummy"
"270425",7,2,0,9,"dummy"
"270426",1,0,0,1,"dummy"
"270427",2,0,0,2,"dummy"
"270428",1,2,0,3,"dummy"
"270438",0,1,0,1,"dummy"
"270439",0,3,0,3,"dummy"
"270440",1,0,0,1,"dummy"
"270441",2,3,0,5,"dummy"
"270442",0,0,2,2,"dummy"
"270468",21,98,2,121,"dummy"
"270469",0,2,0,2,"dummy"
"270470",2,4,0,6,"dummy"
"270471",2,3,0,5,"dummy"
"270472",59,4,0,63,"dummy"
"270473",0,3,0,3,"dummy"
"270478",5,11,1,17,"dummy"
"270479",0,3,0,3,"dummy"
"270502",0,0,1,1,"dummy"
"270208",6,0,0,6,"dummy"
"270209",2,5,2,9,"dummy"
"270214",1,0,1,2,"dummy"
"270215",3,3,0,6,"dummy"
"270216",3,3,0,6,"dummy"
"270217",0,20,6,26,"dummy"
"270218",0,1,5,6,"dummy"
"270219",0,4,0,4,"dummy"
"270220",8,2,2,12,"dummy"
"270221",0,0,0,0,"dummy"
"270222",0,0,1,1,"dummy"
"270223",0,0,1,1,"dummy"
"270271",0,0,0,0,"dummy"
"270274",0,4,1,5,"dummy"
"270275",0,3,0,3,"dummy"
"270339",1,3,2,6,"dummy"
"270340",1,10,4,15,"dummy"
"270341",2,5,2,9,"dummy"
"270342",20,3,0,23,"dummy"
"270345",5,6,0,11,"dummy"
"270352",7,1,1,9,"dummy"
"270353",0,0,0,0,"dummy"
"270354",0,0,1,1,"dummy"
"270355",0,4,0,4,"dummy"
"270356",0,1,0,1,"dummy"
"270357",6,3,1,10,"dummy"
"270358",1,0,1,2,"dummy"
"270359",0,0,1,1,"dummy"
"270360",7,3,2,12,"dummy"
"270361",1,0,2,3,"dummy"
"270362",1,0,1,2,"dummy"
"270363",4,0,0,4,"dummy"
"270364",0,1,0,1,"dummy"
"270365",0,1,0,1,"dummy"
"270370",2,1,0,3,"dummy"
"270380",0,4,0,4,"dummy"
"270381",0,0,1,1,"dummy"
"270382",7,5,2,14,"dummy"
"270383",0,0,1,1,"dummy"
"270384",0,0,1,1,"dummy"
"270398",11,0,0,11,"dummy"
"270399",0,1,0,1,"dummy"
"270403",29,1,0,30,"dummy"
"270404",0,0,0,0,"dummy"
"270405",0,0,0,0,"dummy"
"270406",0,1,1,2,"dummy"
"270407",0,0,0,0,"dummy"
"270410",1,0,0,1,"dummy"
"270411",2,0,0,2,"dummy"
"270412",0,2,0,2,"dummy"
"270413",2,0,0,2,"dummy"
"270417",0,2,1,3,"dummy"
"270418",0,0,1,1,"dummy"
"270430",2,5,2,9,"dummy"
"270433",0,0,0,0,"dummy"
"270434",0,2,0,2,"dummy"
"270435",0,0,1,1,"dummy"
"270436",0,0,2,2,"dummy"
"270444",0,0,1,1,"dummy"
"270445",0,0,0,0,"dummy"
"270446",0,1,0,1,"dummy"
"270447",0,0,0,0,"dummy"
"270448",0,0,1,1,"dummy"
"270451",0,0,0,0,"dummy"
"270454",1,2,0,3,"dummy"
"270481",0,1,0,1,"dummy"
"270482",0,0,1,1,"dummy"
"270483",1,7,2,10,"dummy"
"270484",0,1,0,1,"dummy"
"270485",0,2,0,2,"dummy"
"270486",10,1,2,13,"dummy"
"270487",0,1,0,1,"dummy"
"270488",0,0,1,1,"dummy"
"270489",0,1,0,1,"dummy"
"270490",0,0,1,1,"dummy"
"270491",0,0,1,1,"dummy"
"270492",0,0,1,1,"dummy"
"270493",0,0,1,1,"dummy"
"270494",0,0,1,1,"dummy"
"270495",0,0,1,1,"dummy"
"270498",0,0,0,0,"dummy"
"270499",0,0,0,0,"dummy"
"270500",0,0,0,0,"dummy"
"270509",0,1,0,1,"dummy"
"270510",9,27,1,37,"dummy"
"270511",0,6,0,6,"dummy"
"270541",4,1,0,5,"dummy"
"270542",0,1,0,1,"dummy"
"270543",1,2,0,3,"dummy"
"270544",1,0,0,1,"dummy"
"270545",0,1,0,1,"dummy"
"270546",0,1,0,1,"dummy"
"270547",1,5,0,6,"dummy"
"270548",0,5,0,5,"dummy"
"270549",0,0,2,2,"dummy"
"270565",6,0,0,6,"dummy"
"270566",2,5,2,9,"dummy"
"270576",9,10,2,21,"dummy"
"270583",0,12,0,12,"dummy"
"270591",0,0,0,0,"dummy"
"270592",0,0,1,1,"dummy"
"270595",0,1,0,1,"dummy"
"270625",7,2,2,11,"dummy"
"270626",0,0,1,1,"dummy"
"270627",0,0,1,1,"dummy"
"270628",0,0,0,0,"dummy"
"270658",0,0,2,2,"dummy"
"270659",1,1,0,2,"dummy"
"270660",0,2,0,2,"dummy"
"270663",0,0,1,1,"dummy"
"270699",5,0,1,6,"dummy"
"270790",0,0,0,0,"dummy"
"270791",0,0,0,0,"dummy"
"270792",0,0,0,0,"dummy"
"270793",0,0,0,0,"dummy"
"270794",2,0,2,4,"dummy"
"270795",0,0,0,0,"dummy"
"270796",0,0,0,0,"dummy"
"270804",0,0,0,0,"dummy"
"270805",1,1,0,2,"dummy"
"270806",1,1,0,2,"dummy"
"270807",3,5,2,10,"dummy"
"270818",0,2,0,2,"dummy"
"270819",1,0,0,1,"dummy"
"270820",0,1,0,1,"dummy"
"270821",0,1,0,1,"dummy"
"270507",1,0,0,1,"dummy"
"270531",0,6,0,6,"dummy"
"270532",1,5,1,7,"dummy"
"270533",5,7,5,17,"dummy"
"270534",0,0,2,2,"dummy"
"270535",0,2,0,2,"dummy"
"270536",0,0,1,1,"dummy"
"270551",2,3,2,7,"dummy"
"270552",0,1,0,1,"dummy"
"270553",0,0,1,1,"dummy"
"270554",0,0,1,1,"dummy"
"270557",1,23,1,25,"dummy"
"270558",3,8,3,14,"dummy"
"270559",0,4,0,4,"dummy"
"270560",0,2,0,2,"dummy"
"270561",1,9,1,11,"dummy"
"270562",3,6,2,11,"dummy"
"270563",1,0,0,1,"dummy"
"270578",0,1,0,1,"dummy"
"270579",0,1,0,1,"dummy"
"270580",0,0,1,1,"dummy"
"270581",1,0,1,2,"dummy"
"270585",0,3,0,3,"dummy"
"270597",0,0,1,1,"dummy"
"270598",0,0,0,0,"dummy"
"270601",2,0,0,2,"dummy"
"270602",0,1,0,1,"dummy"
"270603",1,23,0,24,"dummy"
"270606",0,0,3,3,"dummy"
"270619",1,0,0,1,"dummy"
"270622",0,2,0,2,"dummy"
"270623",1,0,0,1,"dummy"
"270644",0,0,1,1,"dummy"
"270649",21,3,1,25,"dummy"
"270650",0,0,1,1,"dummy"
"270651",0,0,1,1,"dummy"
"270652",10,0,2,12,"dummy"
"270653",0,2,0,2,"dummy"
"270654",1,4,0,5,"dummy"
"270655",0,0,2,2,"dummy"
"270656",0,0,1,1,"dummy"
"270665",0,2,0,2,"dummy"
"270666",0,1,0,1,"dummy"
"270667",0,1,0,1,"dummy"
"270668",0,1,0,1,"dummy"
"270669",1,4,1,6,"dummy"
"270670",4,2,1,7,"dummy"
"270671",0,0,1,1,"dummy"
"270672",4,0,6,10,"dummy"
"270677",0,1,2,3,"dummy"
"270701",0,2,1,3,"dummy"
"270702",0,1,0,1,"dummy"
"270703",0,0,1,1,"dummy"
"270704",3,2,0,5,"dummy"
"270705",0,0,1,1,"dummy"
"270706",3,3,2,8,"dummy"
"270707",0,1,0,1,"dummy"
"270708",0,2,0,2,"dummy"
"270709",1,6,0,7,"dummy"
"270710",0,0,1,1,"dummy"
"270711",0,1,0,1,"dummy"
"270712",1,1,1,3,"dummy"
"270713",17,0,3,20,"dummy"
"270714",0,0,0,0,"dummy"
"270715",0,0,0,0,"dummy"
"270716",0,0,1,1,"dummy"
"270717",0,1,0,1,"dummy"
"270718",0,6,0,6,"dummy"
"270719",1,0,0,1,"dummy"
"270720",1,0,1,2,"dummy"
"270721",0,0,1,1,"dummy"
"270722",0,1,0,1,"dummy"
"270723",2,0,0,2,"dummy"
"270724",0,0,1,1,"dummy"
"270725",0,0,1,1,"dummy"
"270726",0,0,0,0,"dummy"
"270727",0,1,0,1,"dummy"
"270728",0,0,2,2,"dummy"
"270729",0,0,1,1,"dummy"
"270730",0,0,1,1,"dummy"
"270731",0,1,0,1,"dummy"
"270732",1,0,0,1,"dummy"
"270733",0,5,0,5,"dummy"
"270734",0,0,1,1,"dummy"
"270735",0,0,2,2,"dummy"
"270736",0,0,0,0,"dummy"
"270737",0,0,1,1,"dummy"
"270738",0,0,1,1,"dummy"
"270739",0,0,1,1,"dummy"
"270740",0,0,1,1,"dummy"
"270741",0,0,1,1,"dummy"
"270742",0,0,2,2,"dummy"
"270743",0,0,2,2,"dummy"
"270744",0,0,2,2,"dummy"
"270745",0,0,2,2,"dummy"
"270746",0,0,2,2,"dummy"
"270747",0,0,2,2,"dummy"
"270748",0,0,2,2,"dummy"
"270749",2,0,0,2,"dummy"
"270750",1,1,0,2,"dummy"
"270751",0,0,0,0,"dummy"
"270752",1,1,0,2,"dummy"
"270753",0,0,2,2,"dummy"
"270754",0,0,0,0,"dummy"
"270755",1,0,1,2,"dummy"
"270756",0,0,0,0,"dummy"
"270757",0,0,0,0,"dummy"
"270758",0,0,0,0,"dummy"
"270759",0,0,1,1,"dummy"
"270760",0,1,0,1,"dummy"
"270761",0,0,1,1,"dummy"
"270762",0,0,1,1,"dummy"
"270763",0,0,1,1,"dummy"
"270764",0,1,1,2,"dummy"
"270765",0,0,1,1,"dummy"
"270766",0,0,1,1,"dummy"
"270767",0,0,1,1,"dummy"
"270768",0,0,1,1,"dummy"
"270769",0,0,1,1,"dummy"
"270770",0,0,0,0,"dummy"
"270771",0,0,1,1,"dummy"
"270772",0,0,1,1,"dummy"
"270773",0,0,1,1,"dummy"
"270774",0,0,1,1,"dummy"
"270775",0,0,1,1,"dummy"
"270776",0,0,1,1,"dummy"
"270777",0,0,1,1,"dummy"
"270778",0,0,1,1,"dummy"
"270779",0,0,1,1,"dummy"
"270780",0,0,1,1,"dummy"
"270781",0,0,1,1,"dummy"
"270782",0,0,1,1,"dummy"
"270783",0,0,1,1,"dummy"
"270784",0,0,1,1,"dummy"
"270785",0,0,1,1,"dummy"
"270786",0,0,1,1,"dummy"
"270787",0,0,1,1,"dummy"
"270788",0,0,1,1,"dummy"
"270809",1,3,0,4,"dummy"
"270810",6,21,2,29,"dummy"
"270811",0,1,1,2,"dummy"
"270826",0,1,0,1,"dummy"
"270829",0,0,1,1,"dummy"
"270843",0,0,1,1,"dummy"
"270844",3,5,0,8,"dummy"
"270845",1,0,1,2,"dummy"
"270846",0,0,1,1,"dummy"
"270847",2,0,2,4,"dummy"
"270850",0,14,0,14,"dummy"
"270851",3,1,2,6,"dummy"
"270852",0,0,1,1,"dummy"
"270853",0,2,3,5,"dummy"
"270854",0,0,2,2,"dummy"
"270871",2,4,0,6,"dummy"
"270872",0,2,0,2,"dummy"
"270873",0,2,0,2,"dummy"
"270874",10,2,0,12,"dummy"
"270875",0,2,0,2,"dummy"
"270876",0,0,0,0,"dummy"
"270877",0,0,3,3,"dummy"
"270878",0,5,0,5,"dummy"
"270893",0,1,0,1,"dummy"
"270899",4,1,1,6,"dummy"
"270900",0,6,2,8,"dummy"
"270903",10,1,2,13,"dummy"
"270904",0,1,1,2,"dummy"
"270822",0,2,0,2,"dummy"
"270823",0,1,0,1,"dummy"
"270824",0,2,0,2,"dummy"
"270856",0,0,1,1,"dummy"
"270857",0,0,0,0,"dummy"
"270858",0,1,1,2,"dummy"
"270859",0,2,0,2,"dummy"
"270860",0,6,0,6,"dummy"
"270861",0,2,0,2,"dummy"
"270862",0,1,0,1,"dummy"
"270863",0,1,0,1,"dummy"
"270864",0,0,3,3,"dummy"
"270865",0,3,4,7,"dummy"
"270866",0,0,1,1,"dummy"
"270867",0,2,0,2,"dummy"
"270880",9,7,2,18,"dummy"
"270881",3,0,0,3,"dummy"
"270882",2,5,0,7,"dummy"
"270895",0,1,0,1,"dummy"
"270896",0,0,1,1,"dummy"
"270897",0,1,1,2,"dummy"
"270909",1,2,0,3,"dummy"
"270912",0,2,0,2,"dummy"
"270913",0,3,0,3,"dummy"
"270914",0,1,0,1,"dummy"
"270917",1,3,0,4,"dummy"
"270918",0,1,0,1,"dummy"
"270919",0,3,0,3,"dummy"
"270920",5,5,1,11,"dummy"
"270921",0,0,1,1,"dummy"
"270922",3,8,2,13,"dummy"
"270923",0,1,0,1,"dummy"
"270924",3,1,0,4,"dummy"
"270925",1,3,1,5,"dummy"
"270926",0,0,5,5,"dummy"
"270927",1,1,0,2,"dummy"
"270928",0,0,1,1,"dummy"
"270929",0,7,0,7,"dummy"
"270930",1,0,3,4,"dummy"
"270931",0,1,3,4,"dummy"
"270932",1,1,0,2,"dummy"
"270933",0,0,1,1,"dummy"
"270940",1,1,0,2,"dummy"
"270941",1,1,3,5,"dummy"
"270942",0,0,1,1,"dummy"
"270943",0,1,0,1,"dummy"
"270944",0,0,1,1,"dummy"
"270945",0,1,1,2,"dummy"
"270946",0,0,1,1,"dummy"
"270947",0,0,1,1,"dummy"
"270948",1,2,4,7,"dummy"
"270949",0,0,1,1,"dummy"
"270950",0,0,1,1,"dummy"
"270960",23,1,0,24,"dummy"
"270961",0,0,1,1,"dummy"
"270962",0,0,1,1,"dummy"
"270963",0,0,18,18,"dummy"
"270984",0,6,0,6,"dummy"
"270985",0,7,0,7,"dummy"
"270986",0,0,1,1,"dummy"
"270987",1,0,2,3,"dummy"
"270988",0,0,1,1,"dummy"
"270989",0,0,1,1,"dummy"
"270990",0,0,1,1,"dummy"
"270991",0,18,0,18,"dummy"
"270992",18,19,0,37,"dummy"
"270993",20,1,0,21,"dummy"
"270994",0,0,1,1,"dummy"
"270995",0,0,1,1,"dummy"
"270996",0,0,1,1,"dummy"
"270997",0,0,1,1,"dummy"
"270998",0,0,1,1,"dummy"
"270999",0,0,1,1,"dummy"
"271000",0,0,1,1,"dummy"
"271001",0,0,1,1,"dummy"
"271002",0,1,1,2,"dummy"
"271003",0,0,1,1,"dummy"
"271004",0,0,1,1,"dummy"
"271005",0,0,1,1,"dummy"
"271006",3,1,0,4,"dummy"
"271007",1,3,0,4,"dummy"
"271008",0,0,1,1,"dummy"
"271009",0,0,1,1,"dummy"
"271010",0,0,1,1,"dummy"
"271011",0,0,1,1,"dummy"
"271028",5,2,1,8,"dummy"
"270905",1,0,1,2,"dummy"
"270906",0,0,1,1,"dummy"
"270907",0,0,1,1,"dummy"
"270958",0,0,1,1,"dummy"
"270965",2,12,1,15,"dummy"
"270966",0,1,0,1,"dummy"
"270969",0,0,2,2,"dummy"
"270970",0,0,1,1,"dummy"
"270971",4,1,2,7,"dummy"
"270972",0,2,1,3,"dummy"
"270973",1,1,2,4,"dummy"
"270974",4,7,1,12,"dummy"
"270975",2,0,2,4,"dummy"
"270976",0,0,1,1,"dummy"
"270977",0,0,2,2,"dummy"
"270980",0,2,1,3,"dummy"
"270981",0,2,0,2,"dummy"
"270982",3,2,0,5,"dummy"
"271017",1,0,0,1,"dummy"
"271018",2,0,1,3,"dummy"
"271019",0,0,0,0,"dummy"
"271020",0,1,0,1,"dummy"
"271021",8,1,0,9,"dummy"
"271022",0,0,0,0,"dummy"
"271023",0,0,0,0,"dummy"
"271024",1,10,0,11,"dummy"
"271025",7,1,0,8,"dummy"
"271026",2,0,3,5,"dummy"
"271033",0,0,1,1,"dummy"
"271034",0,0,2,2,"dummy"
"271038",2,1,0,3,"dummy"
"271039",0,0,2,2,"dummy"
"271040",0,0,2,2,"dummy"
"271041",1,1,0,2,"dummy"
"271045",0,2,0,2,"dummy"
"271046",0,2,2,4,"dummy"
"271056",2,4,0,6,"dummy"
"271057",0,2,0,2,"dummy"
"271058",0,2,0,2,"dummy"
"271059",10,2,0,12,"dummy"
"271060",0,2,0,2,"dummy"
"271061",0,0,0,0,"dummy"
"271062",0,0,3,3,"dummy"
"271063",0,5,0,5,"dummy"
"271064",1,0,1,2,"dummy"
"271070",2,2,0,4,"dummy"
"271071",2,0,0,2,"dummy"
"271072",0,0,1,1,"dummy"
"271073",0,0,1,1,"dummy"
"271074",3,5,1,9,"dummy"
"271098",4,7,0,11,"dummy"
"271099",0,1,0,1,"dummy"
"271100",0,1,0,1,"dummy"
"271129",0,0,1,1,"dummy"
"271130",1,0,1,2,"dummy"
"271131",0,0,1,1,"dummy"
"271132",0,2,0,2,"dummy"
"271133",0,3,0,3,"dummy"
"271134",0,1,0,1,"dummy"
"271135",0,0,1,1,"dummy"
"271136",0,1,1,2,"dummy"
"271137",0,1,1,2,"dummy"
"271138",0,0,5,5,"dummy"
"271139",0,1,0,1,"dummy"
"271140",0,0,0,0,"dummy"
"271029",16,12,4,32,"dummy"
"271030",3,0,2,5,"dummy"
"271031",0,0,1,1,"dummy"
"271036",0,0,1,1,"dummy"
"271043",1,1,0,2,"dummy"
"271048",0,0,1,1,"dummy"
"271051",16,12,4,32,"dummy"
"271052",1,11,1,13,"dummy"
"271066",1,0,2,3,"dummy"
"271067",2,1,0,3,"dummy"
"271068",7,0,1,8,"dummy"
"271076",0,1,0,1,"dummy"
"271085",0,0,1,1,"dummy"
"271086",0,1,1,2,"dummy"
"271087",0,0,2,2,"dummy"
"271088",0,0,2,2,"dummy"
"271089",0,0,2,2,"dummy"
"271090",0,0,1,1,"dummy"
"271091",0,0,1,1,"dummy"
"271092",0,0,1,1,"dummy"
"271093",0,0,1,1,"dummy"
"271094",0,0,1,1,"dummy"
"271095",0,0,1,1,"dummy"
"271096",0,0,1,1,"dummy"
"271126",0,3,0,3,"dummy"
"271127",1,0,0,1,"dummy"
"271142",0,0,1,1,"dummy"
"271143",0,4,1,5,"dummy"
"271144",2,4,2,8,"dummy"
"271145",0,0,2,2,"dummy"
"271146",0,0,1,1,"dummy"
"271147",1,1,1,3,"dummy"
"271148",0,0,1,1,"dummy"
"271149",4,4,0,8,"dummy"
"271150",1,1,0,2,"dummy"
"271151",5,5,5,15,"dummy"
"271152",1,1,0,2,"dummy"
"271153",3,3,0,6,"dummy"
"271154",2,5,20,27,"dummy"
"271155",0,0,1,1,"dummy"
"271156",0,3,0,3,"dummy"
"271157",0,0,1,1,"dummy"
"271158",0,0,1,1,"dummy"
"271159",0,0,1,1,"dummy"
"271160",1,7,2,10,"dummy"
"271161",0,4,1,5,"dummy"
"271162",0,0,0,0,"dummy"
"271163",0,0,1,1,"dummy"
"271164",5,7,5,17,"dummy"
"271165",13,1,1,15,"dummy"
"271166",0,0,2,2,"dummy"
"271167",6,9,1,16,"dummy"
"271168",0,1,0,1,"dummy"
"271169",3,7,0,10,"dummy"
"271170",0,2,0,2,"dummy"
"271171",7,6,0,13,"dummy"
"271172",4,6,0,10,"dummy"
"271173",2,0,0,2,"dummy"
"271177",0,8,0,8,"dummy"
"271178",0,2,0,2,"dummy"
"271180",0,0,2,2,"dummy"
"271183",1,0,0,1,"dummy"
"271184",0,2,1,3,"dummy"
"271185",0,2,2,4,"dummy"
"271186",6,6,0,12,"dummy"
"271187",1,0,0,1,"dummy"
"271188",0,0,1,1,"dummy"
"271193",0,0,2,2,"dummy"
"271202",3,4,1,8,"dummy"
"271204",0,0,1,1,"dummy"
"271206",0,0,3,3,"dummy"
"271209",0,0,1,1,"dummy"
"271210",0,1,0,1,"dummy"
"271211",0,0,1,1,"dummy"
"271213",0,0,1,1,"dummy"
"271214",0,2,0,2,"dummy"
"271215",0,0,1,1,"dummy"
"271216",0,0,1,1,"dummy"
"271217",2,0,0,2,"dummy"
"271218",0,3,0,3,"dummy"
"271220",0,0,0,0,"dummy"
"271221",2,7,0,9,"dummy"
"271222",3,0,1,4,"dummy"
"271224",8,4,0,12,"dummy"
"271225",0,3,0,3,"dummy"
"271226",3,0,0,3,"dummy"
"271230",0,0,1,1,"dummy"
"271248",0,1,0,1,"dummy"
"271263",0,7,0,7,"dummy"
"271264",0,0,0,0,"dummy"
"271265",7,0,0,7,"dummy"
"271266",1,3,0,4,"dummy"
"271290",0,0,3,3,"dummy"
"271291",3,3,5,11,"dummy"
"271292",0,1,0,1,"dummy"
"271293",0,0,2,2,"dummy"
"271294",0,0,1,1,"dummy"
"271295",2,2,0,4,"dummy"
"271296",4,4,5,13,"dummy"
"271297",5,5,1,11,"dummy"
"271299",0,2,0,2,"dummy"
"271300",3,0,0,3,"dummy"
"271310",0,2,0,2,"dummy"
"271311",0,1,0,1,"dummy"
"271312",5,0,0,5,"dummy"
"271316",0,1,0,1,"dummy"
"271317",0,3,0,3,"dummy"
"271318",0,0,0,0,"dummy"
"271319",1,8,1,10,"dummy"
"271320",0,2,0,2,"dummy"
"271321",0,3,0,3,"dummy"
"271322",0,1,0,1,"dummy"
"271323",2,3,0,5,"dummy"
"271324",5,5,2,12,"dummy"
"271325",0,2,0,2,"dummy"
"271326",9,6,0,15,"dummy"
"271327",0,4,0,4,"dummy"
"271329",1,7,0,8,"dummy"
"271334",0,0,2,2,"dummy"
"271335",0,0,2,2,"dummy"
"271336",0,0,2,2,"dummy"
"271337",0,0,2,2,"dummy"
"271338",0,0,2,2,"dummy"
"271339",0,0,2,2,"dummy"
"271340",0,0,2,2,"dummy"
"271341",0,0,2,2,"dummy"
"271342",0,0,1,1,"dummy"
"271343",0,0,2,2,"dummy"
"271344",0,0,2,2,"dummy"
"271345",3,4,0,7,"dummy"
"271346",0,0,3,3,"dummy"
"271347",0,0,2,2,"dummy"
"271348",0,0,2,2,"dummy"
"271349",4,3,0,7,"dummy"
"271350",0,0,2,2,"dummy"
"271351",0,0,2,2,"dummy"
"271401",0,1,0,1,"dummy"
"271403",0,1,0,1,"dummy"
"271404",0,1,0,1,"dummy"
"271405",0,3,1,4,"dummy"
"271406",0,2,0,2,"dummy"
"271415",3,1,2,6,"dummy"
"271421",1,0,0,1,"dummy"
"271424",3,17,7,27,"dummy"
"271425",0,0,1,1,"dummy"
"271426",0,1,1,2,"dummy"
"271428",0,8,1,9,"dummy"
"271429",0,0,1,1,"dummy"
"271430",3,6,1,10,"dummy"
"271431",1,2,2,5,"dummy"
"271432",9,26,4,39,"dummy"
"271433",26,0,4,30,"dummy"
"271434",0,1,0,1,"dummy"
"271435",0,0,0,0,"dummy"
"271436",3,11,1,15,"dummy"
"271437",4,0,0,4,"dummy"
"271438",1,2,1,4,"dummy"
"271442",0,0,0,0,"dummy"
"271443",1,0,1,2,"dummy"
"271444",0,0,1,1,"dummy"
"271445",0,0,1,1,"dummy"
"271446",0,0,1,1,"dummy"
"271447",0,0,1,1,"dummy"
"271449",1,0,1,2,"dummy"
"271452",0,0,0,0,"dummy"
"271453",0,0,1,1,"dummy"
"271455",3,2,1,6,"dummy"
"271456",0,0,1,1,"dummy"
"271457",0,2,0,2,"dummy"
"271458",3,3,0,6,"dummy"
"271459",2,2,1,5,"dummy"
"271460",0,0,1,1,"dummy"
"271461",0,0,1,1,"dummy"
"271463",0,0,1,1,"dummy"
"271466",3,1,0,4,"dummy"
"271467",0,0,2,2,"dummy"
"271470",0,0,3,3,"dummy"
"271472",0,0,0,0,"dummy"
"271473",0,0,0,0,"dummy"
"271475",0,0,1,1,"dummy"
"271476",1,2,0,3,"dummy"
"271477",3,2,1,6,"dummy"
"271478",0,0,0,0,"dummy"
"271479",0,0,1,1,"dummy"
"271482",0,2,0,2,"dummy"
"271483",0,2,0,2,"dummy"
"271484",3,1,0,4,"dummy"
"271485",9,8,3,20,"dummy"
"271486",3,1,0,4,"dummy"
"271487",0,0,1,1,"dummy"
"271488",3,11,3,17,"dummy"
"271489",0,2,2,4,"dummy"
"271490",0,1,0,1,"dummy"
"271491",0,0,1,1,"dummy"
"271492",0,0,1,1,"dummy"
"271493",4,2,0,6,"dummy"
"271494",0,0,1,1,"dummy"
"271495",0,1,0,1,"dummy"
"271497",0,0,1,1,"dummy"
"271498",0,0,1,1,"dummy"
"271499",0,0,1,1,"dummy"
"271503",0,1,0,1,"dummy"
"271504",2,0,0,2,"dummy"
"271505",1,0,2,3,"dummy"
"271509",3,2,1,6,"dummy"
"271510",0,4,0,4,"dummy"
"271511",4,2,0,6,"dummy"
"271513",1,0,0,1,"dummy"
"271514",1,4,1,6,"dummy"
"271518",0,0,1,1,"dummy"
"271519",0,0,1,1,"dummy"
"271520",0,3,0,3,"dummy"
"271521",0,0,1,1,"dummy"
"271522",0,0,1,1,"dummy"
"271528",0,1,0,1,"dummy"
"271529",1,1,0,2,"dummy"
"271531",3,12,3,18,"dummy"
"271532",9,0,0,9,"dummy"
"271535",0,1,0,1,"dummy"
"271536",0,4,0,4,"dummy"
"271548",0,0,1,1,"dummy"
"271551",0,2,0,2,"dummy"
"271552",0,1,0,1,"dummy"
"271554",0,1,0,1,"dummy"
"271555",0,2,0,2,"dummy"
"271576",2,6,0,8,"dummy"
"271579",4,7,0,11,"dummy"
"271580",1,4,0,5,"dummy"
"271585",0,1,0,1,"dummy"
"271624",0,0,1,1,"dummy"
"271625",0,0,1,1,"dummy"
"271628",0,1,0,1,"dummy"
"271629",3,2,2,7,"dummy"
"271630",0,2,3,5,"dummy"
"271631",0,0,1,1,"dummy"
"271632",18,5,1,24,"dummy"
"271633",0,1,1,2,"dummy"
"271634",1,0,2,3,"dummy"
"271635",1,1,0,2,"dummy"
"271636",0,1,0,1,"dummy"
"271637",0,3,1,4,"dummy"
"271638",0,0,2,2,"dummy"
"271639",3,4,3,10,"dummy"
"271640",0,0,1,1,"dummy"
"271641",0,0,1,1,"dummy"
"271642",2,2,2,6,"dummy"
"271643",3,2,0,5,"dummy"
"271644",2,12,0,14,"dummy"
"271645",0,0,2,2,"dummy"
"271646",0,0,2,2,"dummy"
"271647",1,1,2,4,"dummy"
"271648",1,1,1,3,"dummy"
"271649",0,3,0,3,"dummy"
"271650",2,1,2,5,"dummy"
"271651",0,0,2,2,"dummy"
"271652",1,0,1,2,"dummy"
"271653",1,2,1,4,"dummy"
"271654",22,7,1,30,"dummy"
"271655",6,16,2,24,"dummy"
"271656",0,0,1,1,"dummy"
"271657",2,2,1,5,"dummy"
"271658",2,2,0,4,"dummy"
"271659",2,2,2,6,"dummy"
"271660",12,1,3,16,"dummy"
"271661",1,9,3,13,"dummy"
"271662",6,1,3,10,"dummy"
"271663",0,0,1,1,"dummy"
"271664",0,0,1,1,"dummy"
"271665",0,0,4,4,"dummy"
"271666",0,0,4,4,"dummy"
"271667",1,0,0,1,"dummy"
"271668",0,0,4,4,"dummy"
"271669",0,0,4,4,"dummy"
"271670",0,0,4,4,"dummy"
"271671",0,1,1,2,"dummy"
"271672",0,0,4,4,"dummy"
"271673",0,0,4,4,"dummy"
"271674",3,2,0,5,"dummy"
"271675",0,0,4,4,"dummy"
"271676",0,0,4,4,"dummy"
"271677",0,0,1,1,"dummy"
"271678",0,2,4,6,"dummy"
"271679",0,0,1,1,"dummy"
"271680",0,0,5,5,"dummy"
"271681",2,2,0,4,"dummy"
"271682",5,1,0,6,"dummy"
"271683",0,1,0,1,"dummy"
"271685",0,1,0,1,"dummy"
"271686",0,9,0,9,"dummy"
"271687",6,7,1,14,"dummy"
"271688",9,2,0,11,"dummy"
"271689",0,0,2,2,"dummy"
"271690",0,1,0,1,"dummy"
"271691",0,1,0,1,"dummy"
"271694",0,0,0,0,"dummy"
"271695",0,1,0,1,"dummy"
"271700",0,0,1,1,"dummy"
"271701",0,0,3,3,"dummy"
"271702",0,0,2,2,"dummy"
"271704",0,7,1,8,"dummy"
"271705",0,7,1,8,"dummy"
"271706",9,10,2,21,"dummy"
"271709",28,5,0,33,"dummy"
"271713",31,37,1,69,"dummy"
"271714",1,3,0,4,"dummy"
"271715",0,1,1,2,"dummy"
"271718",0,0,1,1,"dummy"
"271719",1,2,1,4,"dummy"
"271720",2,0,0,2,"dummy"
"271721",8,11,4,23,"dummy"
"271722",0,3,0,3,"dummy"
"271724",0,0,0,0,"dummy"
"271725",0,0,5,5,"dummy"
"271726",0,0,5,5,"dummy"
"271727",0,0,5,5,"dummy"
"271728",0,0,5,5,"dummy"
"271729",0,0,5,5,"dummy"
"271730",0,0,5,5,"dummy"
"271731",0,0,5,5,"dummy"
"271732",6,5,3,14,"dummy"
"271733",0,0,5,5,"dummy"
"271734",0,0,5,5,"dummy"
"271736",0,6,0,6,"dummy"
"271740",9,8,4,21,"dummy"
"271747",0,1,0,1,"dummy"
"271748",0,0,2,2,"dummy"
"271751",0,0,1,1,"dummy"
"271752",5,0,0,5,"dummy"
"271756",0,1,0,1,"dummy"
"271757",3,27,0,30,"dummy"
"271759",0,0,1,1,"dummy"
"271760",0,6,2,8,"dummy"
"271761",0,1,0,1,"dummy"
"271763",0,4,0,4,"dummy"
"271764",0,0,1,1,"dummy"
"271765",4,4,1,9,"dummy"
"271768",0,0,0,0,"dummy"
"271769",0,1,0,1,"dummy"
"271770",0,2,0,2,"dummy"
"271771",2,1,0,3,"dummy"
"271772",0,2,0,2,"dummy"
"271773",0,1,0,1,"dummy"
"271774",3,3,1,7,"dummy"
"271775",2,0,0,2,"dummy"
"271776",1,4,1,6,"dummy"
"271777",3,4,0,7,"dummy"
"271778",0,1,0,1,"dummy"
"271779",1,0,0,1,"dummy"
"271780",0,1,0,1,"dummy"
"271783",0,10,2,12,"dummy"
"271784",0,2,0,2,"dummy"
"271785",0,1,0,1,"dummy"
"271803",0,1,0,1,"dummy"
"271804",0,1,0,1,"dummy"
"271819",4,3,0,7,"dummy"
"271821",0,6,0,6,"dummy"
"271822",1,0,1,2,"dummy"
"271823",0,0,2,2,"dummy"
"271824",0,0,1,1,"dummy"
"271825",0,0,1,1,"dummy"
"271826",0,3,0,3,"dummy"
"271827",0,0,2,2,"dummy"
"271828",0,0,2,2,"dummy"
"271829",1,0,0,1,"dummy"
"271830",0,2,0,2,"dummy"
"271831",9,19,0,28,"dummy"
"271832",2,18,2,22,"dummy"
"271833",0,1,0,1,"dummy"
"271834",4,4,0,8,"dummy"
"271839",0,0,0,0,"dummy"
"271841",1,2,0,3,"dummy"
"271842",0,0,1,1,"dummy"
"271843",0,3,0,3,"dummy"
"271844",4,9,1,14,"dummy"
"271846",1,0,8,9,"dummy"
"271849",1,0,0,1,"dummy"
"271850",1,1,0,2,"dummy"
"271851",1,0,0,1,"dummy"
"271852",2,0,1,3,"dummy"
"271853",1,7,1,9,"dummy"
"271854",5,0,1,6,"dummy"
"271855",2,5,2,9,"dummy"
"271856",0,0,0,0,"dummy"
"271857",0,0,1,1,"dummy"
"271859",0,1,0,1,"dummy"
"271860",0,0,1,1,"dummy"
"271861",10,43,4,57,"dummy"
"271863",0,0,3,3,"dummy"
"271864",0,0,1,1,"dummy"
"271865",0,0,0,0,"dummy"
"271866",0,0,0,0,"dummy"
"271867",0,0,0,0,"dummy"
"271910",1,9,0,10,"dummy"
"271911",0,4,0,4,"dummy"
"271912",0,0,1,1,"dummy"
"271913",0,0,3,3,"dummy"
"271914",0,0,3,3,"dummy"
"271945",0,2,3,5,"dummy"
"271946",2,0,0,2,"dummy"
"271947",1,2,1,4,"dummy"
"271948",0,1,0,1,"dummy"
"271950",0,3,0,3,"dummy"
"271951",0,1,0,1,"dummy"
"271952",0,1,0,1,"dummy"
"271954",0,2,0,2,"dummy"
"271955",2,0,0,2,"dummy"
"271956",0,6,0,6,"dummy"
"271958",0,0,1,1,"dummy"
"271959",0,0,0,0,"dummy"
"271961",1,1,0,2,"dummy"
"271962",8,1,1,10,"dummy"
"271965",0,4,1,5,"dummy"
"272015",0,1,0,1,"dummy"
"272016",1,0,0,1,"dummy"
"272017",0,0,1,1,"dummy"
"272018",0,0,1,1,"dummy"
"272019",0,0,1,1,"dummy"
"272020",0,2,0,2,"dummy"
"272021",0,0,1,1,"dummy"
"272022",0,0,1,1,"dummy"
"272023",0,0,1,1,"dummy"
"272024",0,0,1,1,"dummy"
"272025",0,0,1,1,"dummy"
"272078",0,1,0,1,"dummy"
"272081",0,2,0,2,"dummy"
"272085",0,0,2,2,"dummy"
"272106",1,0,0,1,"dummy"
"272109",0,0,1,1,"dummy"
"272110",0,0,1,1,"dummy"
"272111",0,1,0,1,"dummy"
"272113",0,1,0,1,"dummy"
"272114",1,10,0,11,"dummy"
"272121",8,12,2,22,"dummy"
"272122",12,8,2,22,"dummy"
"272123",0,0,1,1,"dummy"
"272124",0,1,0,1,"dummy"
"272125",0,0,1,1,"dummy"
"272126",0,1,1,2,"dummy"
"272127",1,3,0,4,"dummy"
"272128",24,0,2,26,"dummy"
"272129",0,0,0,0,"dummy"
"272130",0,0,0,0,"dummy"
"272134",0,0,2,2,"dummy"
"272135",0,0,1,1,"dummy"
"272136",0,0,1,1,"dummy"
"272137",0,0,1,1,"dummy"
"272138",0,0,1,1,"dummy"
"272139",0,0,1,1,"dummy"
"272140",0,0,1,1,"dummy"
"272141",0,0,1,1,"dummy"
"272142",0,0,1,1,"dummy"
"272143",0,0,1,1,"dummy"
"272144",0,1,0,1,"dummy"
"272145",0,0,2,2,"dummy"
"272146",0,13,0,13,"dummy"
"272148",8,0,0,8,"dummy"
"272149",0,3,0,3,"dummy"
"272150",0,0,3,3,"dummy"
"272152",1,0,0,1,"dummy"
"272153",0,1,0,1,"dummy"
"272154",0,0,1,1,"dummy"
"272155",0,1,0,1,"dummy"
"272156",0,0,1,1,"dummy"
"272157",0,4,0,4,"dummy"
"272158",4,4,0,8,"dummy"
"272159",8,5,0,13,"dummy"
"272160",0,0,3,3,"dummy"
"272161",0,1,0,1,"dummy"
"272162",0,4,0,4,"dummy"
"272163",0,4,1,5,"dummy"
"272164",4,1,0,5,"dummy"
"272165",0,4,0,4,"dummy"
"272166",0,5,0,5,"dummy"
"272167",0,3,0,3,"dummy"
"272168",0,1,0,1,"dummy"
"272187",3,3,0,6,"dummy"
"272188",3,3,2,8,"dummy"
"272189",0,0,0,0,"dummy"
"272190",0,0,2,2,"dummy"
"272191",0,2,0,2,"dummy"
"272192",1,1,0,2,"dummy"
"272208",0,6,0,6,"dummy"
"272209",4,7,0,11,"dummy"
"272210",0,2,0,2,"dummy"
"272211",0,0,1,1,"dummy"
"272212",0,1,0,1,"dummy"
"272217",3,9,0,12,"dummy"
"272218",15,5,0,20,"dummy"
"272219",6,2,1,9,"dummy"
"272225",2,5,1,8,"dummy"
"272228",0,0,2,2,"dummy"
"272244",0,0,0,0,"dummy"
"272272",0,0,0,0,"dummy"
"272280",0,0,1,1,"dummy"
"272283",1,2,0,3,"dummy"
"272306",0,1,1,2,"dummy"
"272307",5,0,0,5,"dummy"
"272316",0,0,0,0,"dummy"
"272317",0,0,0,0,"dummy"
"272360",2,4,0,6,"dummy"
"272385",1,1,0,2,"dummy"
"272386",0,1,0,1,"dummy"
"272387",2,3,1,6,"dummy"
"272399",0,2,0,2,"dummy"
"272400",6,10,5,21,"dummy"
"272403",0,0,2,2,"dummy"
"272404",0,0,1,1,"dummy"
"272405",4,0,0,4,"dummy"
"272406",0,6,0,6,"dummy"
"272416",0,1,0,1,"dummy"
"272417",0,2,0,2,"dummy"
"272459",0,2,2,4,"dummy"
"272460",6,5,1,12,"dummy"
"272461",0,1,2,3,"dummy"
"272462",1,4,1,6,"dummy"
"272463",0,2,0,2,"dummy"
"272464",16,0,3,19,"dummy"
"272465",4,3,0,7,"dummy"
"272466",0,2,3,5,"dummy"
"272467",4,0,0,4,"dummy"
"272468",0,6,0,6,"dummy"
"272469",0,0,1,1,"dummy"
"272470",0,0,1,1,"dummy"
"272471",0,1,0,1,"dummy"
"272472",0,0,1,1,"dummy"
"272473",0,0,0,0,"dummy"
"272474",0,2,0,2,"dummy"
"272475",0,3,0,3,"dummy"
"272476",3,0,0,3,"dummy"
"272477",0,3,0,3,"dummy"
"272478",0,0,1,1,"dummy"
"272170",0,4,2,6,"dummy"
"272171",3,1,0,4,"dummy"
"272172",0,1,0,1,"dummy"
"272173",2,0,0,2,"dummy"
"272174",0,1,0,1,"dummy"
"272175",0,1,0,1,"dummy"
"272176",0,1,0,1,"dummy"
"272177",1,0,0,1,"dummy"
"272178",0,8,0,8,"dummy"
"272196",0,0,1,1,"dummy"
"272214",1,2,0,3,"dummy"
"272215",2,2,1,5,"dummy"
"272230",0,0,1,1,"dummy"
"272231",0,1,1,2,"dummy"
"272232",0,0,2,2,"dummy"
"272233",1,1,1,3,"dummy"
"272234",3,1,0,4,"dummy"
"272235",6,0,4,10,"dummy"
"272241",3,8,0,11,"dummy"
"272242",0,0,0,0,"dummy"
"272246",0,0,0,0,"dummy"
"272247",0,0,0,0,"dummy"
"272250",0,6,0,6,"dummy"
"272251",10,10,0,20,"dummy"
"272252",0,1,0,1,"dummy"
"272253",0,0,0,0,"dummy"
"272254",7,9,1,17,"dummy"
"272255",0,0,0,0,"dummy"
"272267",0,0,2,2,"dummy"
"272268",0,0,1,1,"dummy"
"272269",0,2,5,7,"dummy"
"272270",3,3,0,6,"dummy"
"272274",3,3,1,7,"dummy"
"272275",0,0,0,0,"dummy"
"272276",0,1,0,1,"dummy"
"272277",0,0,1,1,"dummy"
"272278",0,0,2,2,"dummy"
"272285",4,6,1,11,"dummy"
"272286",0,1,0,1,"dummy"
"272287",0,2,0,2,"dummy"
"272288",2,15,0,17,"dummy"
"272289",0,5,0,5,"dummy"
"272290",0,0,0,0,"dummy"
"272297",1,8,4,13,"dummy"
"272298",0,1,3,4,"dummy"
"272313",0,1,0,1,"dummy"
"272314",9,0,3,12,"dummy"
"272319",0,1,0,1,"dummy"
"272320",0,0,2,2,"dummy"
"272321",0,1,2,3,"dummy"
"272322",0,1,0,1,"dummy"
"272323",0,0,3,3,"dummy"
"272324",2,0,2,4,"dummy"
"272325",0,3,1,4,"dummy"
"272326",8,0,1,9,"dummy"
"272327",2,1,1,4,"dummy"
"272328",0,1,0,1,"dummy"
"272329",1,0,0,1,"dummy"
"272368",0,0,0,0,"dummy"
"272369",0,0,1,1,"dummy"
"272383",0,0,1,1,"dummy"
"272391",0,1,2,3,"dummy"
"272392",0,0,0,0,"dummy"
"272393",0,0,0,0,"dummy"
"272396",0,0,1,1,"dummy"
"272397",0,1,0,1,"dummy"
"272408",0,1,2,3,"dummy"
"272409",0,0,0,0,"dummy"
"272410",0,1,0,1,"dummy"
"272411",4,0,2,6,"dummy"
"272412",1,0,0,1,"dummy"
"272413",0,0,0,0,"dummy"
"272414",0,0,0,0,"dummy"
"272445",4,12,3,19,"dummy"
"272446",12,9,0,21,"dummy"
"272447",0,1,0,1,"dummy"
"272448",0,0,1,1,"dummy"
"272449",0,1,0,1,"dummy"
"272450",0,0,1,1,"dummy"
"272453",0,0,1,1,"dummy"
"272454",0,1,0,1,"dummy"
"272455",1,0,3,4,"dummy"
"272485",0,0,1,1,"dummy"
"272495",0,16,0,16,"dummy"
"272496",0,0,0,0,"dummy"
"272487",0,3,0,3,"dummy"
"272488",0,1,0,1,"dummy"
"272489",0,0,1,1,"dummy"
"272490",1,2,0,3,"dummy"
"272491",0,1,0,1,"dummy"
"272492",0,4,0,4,"dummy"
"272493",0,2,0,2,"dummy"
"272498",0,1,0,1,"dummy"
"272501",0,0,0,0,"dummy"
"272502",0,0,0,0,"dummy"
"272506",0,0,5,5,"dummy"
"272508",0,0,1,1,"dummy"
"272512",0,0,1,1,"dummy"
"272513",1,0,0,1,"dummy"
"272517",0,1,0,1,"dummy"
"272518",1,0,0,1,"dummy"
"272519",0,2,1,3,"dummy"
"272520",0,8,0,8,"dummy"
"272521",0,0,1,1,"dummy"
"272522",1,1,0,2,"dummy"
"272526",0,0,1,1,"dummy"
"272527",0,1,0,1,"dummy"
"272537",6,0,0,6,"dummy"
"272538",0,0,1,1,"dummy"
"272539",0,4,0,4,"dummy"
"272541",3,3,1,7,"dummy"
"272542",3,3,1,7,"dummy"
"272543",0,1,0,1,"dummy"
"272544",11,9,2,22,"dummy"
"272545",0,0,2,2,"dummy"
"272546",0,0,2,2,"dummy"
"272547",24,11,5,40,"dummy"
"272548",0,0,0,0,"dummy"
"272549",1,4,0,5,"dummy"
"272554",1,4,0,5,"dummy"
"272556",1,0,0,1,"dummy"
"272557",0,0,1,1,"dummy"
"272558",0,2,0,2,"dummy"
"272559",0,6,2,8,"dummy"
"272561",1,0,1,2,"dummy"
"272562",0,1,0,1,"dummy"
"272563",0,0,1,1,"dummy"
"272585",4,4,1,9,"dummy"
"272608",0,0,1,1,"dummy"
"272609",1,1,0,2,"dummy"
"272611",8,1,0,9,"dummy"
"272612",1,6,0,7,"dummy"
"272619",0,3,0,3,"dummy"
"272620",4,2,0,6,"dummy"
"272621",1,2,1,4,"dummy"
"272622",0,0,0,0,"dummy"
"272623",3,5,5,13,"dummy"
"272624",11,13,4,28,"dummy"
"272625",0,0,0,0,"dummy"
"272627",0,0,1,1,"dummy"
"272628",0,2,3,5,"dummy"
"272629",5,6,0,11,"dummy"
"272630",0,1,0,1,"dummy"
"272631",0,1,0,1,"dummy"
"272632",0,0,1,1,"dummy"
"272642",0,1,1,2,"dummy"
"272643",0,0,1,1,"dummy"
"272647",0,0,0,0,"dummy"
"272651",0,0,1,1,"dummy"
"272652",1,0,0,1,"dummy"
"272654",8,16,5,29,"dummy"
"272655",0,5,1,6,"dummy"
"272656",0,23,0,23,"dummy"
"272657",0,6,0,6,"dummy"
"272658",5,7,0,12,"dummy"
"272660",0,9,1,10,"dummy"
"272662",0,0,0,0,"dummy"
"272663",0,0,0,0,"dummy"
"272664",4,7,4,15,"dummy"
"272665",4,4,1,9,"dummy"
"272666",4,2,0,6,"dummy"
"272667",0,0,1,1,"dummy"
"272670",0,0,0,0,"dummy"
"272672",2,0,0,2,"dummy"
"272673",0,0,2,2,"dummy"
"272674",6,5,0,11,"dummy"
"272675",0,3,0,3,"dummy"
"272676",3,0,0,3,"dummy"
"272677",0,8,0,8,"dummy"
"272679",2,4,0,6,"dummy"
"272680",0,2,0,2,"dummy"
"272681",0,2,0,2,"dummy"
"272682",10,2,0,12,"dummy"
"272683",0,2,0,2,"dummy"
"272684",0,0,0,0,"dummy"
"272685",0,0,3,3,"dummy"
"272686",0,5,0,5,"dummy"
"272688",0,1,0,1,"dummy"
"272689",0,0,1,1,"dummy"
"272690",0,0,0,0,"dummy"
"272691",1,0,1,2,"dummy"
"272701",0,1,0,1,"dummy"
"272703",0,4,1,5,"dummy"
"272704",2,2,0,4,"dummy"
"272705",3,0,0,3,"dummy"
"272706",0,5,0,5,"dummy"
"272707",1,2,0,3,"dummy"
"272708",1,6,2,9,"dummy"
"272709",6,0,0,6,"dummy"
"272710",0,0,2,2,"dummy"
"272711",0,3,0,3,"dummy"
"272712",0,1,0,1,"dummy"
"272713",16,3,2,21,"dummy"
"272714",0,1,0,1,"dummy"
"272715",0,0,3,3,"dummy"
"272719",0,0,1,1,"dummy"
"272721",1,4,0,5,"dummy"
"272722",0,1,0,1,"dummy"
"272723",4,3,2,9,"dummy"
"272726",0,0,0,0,"dummy"
"272727",0,0,1,1,"dummy"
"272732",0,2,0,2,"dummy"
"272733",2,20,1,23,"dummy"
"272734",0,1,1,2,"dummy"
"272739",2,0,1,3,"dummy"
"272740",0,2,0,2,"dummy"
"272741",0,0,1,1,"dummy"
"272742",0,0,1,1,"dummy"
"272756",2,4,0,6,"dummy"
"272757",0,2,0,2,"dummy"
"272758",0,2,0,2,"dummy"
"272759",10,2,0,12,"dummy"
"272760",0,2,0,2,"dummy"
"272761",0,0,0,0,"dummy"
"272762",0,0,3,3,"dummy"
"272763",0,5,0,5,"dummy"
"272764",1,0,1,2,"dummy"
"272767",2,5,2,9,"dummy"
"272768",0,0,1,1,"dummy"
"272769",0,0,3,3,"dummy"
"272790",0,2,0,2,"dummy"
"272791",0,4,1,5,"dummy"
"272792",0,1,0,1,"dummy"
"272793",0,1,1,2,"dummy"
"272794",0,1,0,1,"dummy"
"272795",0,3,0,3,"dummy"
"272796",7,1,1,9,"dummy"
"272799",1,1,2,4,"dummy"
"272800",0,0,1,1,"dummy"
"272801",0,0,1,1,"dummy"
"272803",5,5,0,10,"dummy"
"272804",2,1,0,3,"dummy"
"272806",0,0,2,2,"dummy"
"272809",0,1,0,1,"dummy"
"272812",0,1,0,1,"dummy"
"272814",1,0,0,1,"dummy"
"272815",0,1,0,1,"dummy"
"272816",2,0,0,2,"dummy"
"272817",1,0,0,1,"dummy"
"272818",0,0,0,0,"dummy"
"272819",0,0,0,0,"dummy"
"272821",0,0,0,0,"dummy"
"272822",0,1,0,1,"dummy"
"272823",0,0,2,2,"dummy"
"272824",0,0,1,1,"dummy"
"272825",1,0,0,1,"dummy"
"272826",6,0,0,6,"dummy"
"272830",8,0,0,8,"dummy"
"272831",3,0,0,3,"dummy"
"272832",0,1,0,1,"dummy"
"272837",0,0,0,0,"dummy"
"272838",2,0,0,2,"dummy"
"272840",8,1,4,13,"dummy"
"272841",2,6,3,11,"dummy"
"272842",2,2,1,5,"dummy"
"272843",0,0,1,1,"dummy"
"272844",0,0,1,1,"dummy"
"272847",0,2,0,2,"dummy"
"272848",0,1,0,1,"dummy"
"272849",0,1,0,1,"dummy"
"272851",1,0,0,1,"dummy"
"272855",5,0,0,5,"dummy"
"272859",1,2,2,5,"dummy"
"272860",2,3,2,7,"dummy"
"272861",1,2,2,5,"dummy"
"272864",0,0,5,5,"dummy"
"272865",0,0,1,1,"dummy"
"272866",0,0,1,1,"dummy"
"272867",9,0,0,9,"dummy"
"272868",0,0,0,0,"dummy"
"272869",0,0,1,1,"dummy"
"272874",2,0,0,2,"dummy"
"272875",0,0,0,0,"dummy"
"272877",0,2,0,2,"dummy"
"272878",5,2,0,7,"dummy"
"272880",5,4,2,11,"dummy"
"272881",0,1,0,1,"dummy"
"272884",0,2,0,2,"dummy"
"272886",1,1,1,3,"dummy"
"272887",0,0,0,0,"dummy"
"272888",0,0,1,1,"dummy"
"272889",0,0,1,1,"dummy"
"272890",2,0,2,4,"dummy"
"272898",0,2,0,2,"dummy"
"272907",0,0,1,1,"dummy"
"272908",1,0,0,1,"dummy"
"272909",0,0,1,1,"dummy"
"272910",0,0,0,0,"dummy"
"272911",0,0,0,0,"dummy"
"272913",0,1,1,2,"dummy"
"272914",0,0,0,0,"dummy"
"272916",0,4,2,6,"dummy"
"272919",5,7,4,16,"dummy"
"272923",1,0,0,1,"dummy"
"272924",0,2,0,2,"dummy"
"272926",0,0,1,1,"dummy"
"272927",0,3,0,3,"dummy"
"272928",9,13,1,23,"dummy"
"272929",2,1,3,6,"dummy"
"272958",4,0,0,4,"dummy"
"272959",9,4,2,15,"dummy"
"272960",6,0,2,8,"dummy"
"272961",0,1,0,1,"dummy"
"272962",0,1,1,2,"dummy"
"272963",1,0,0,1,"dummy"
"272970",0,1,0,1,"dummy"
"272971",0,0,1,1,"dummy"
"272972",1,1,0,2,"dummy"
"272973",1,2,0,3,"dummy"
"272979",2,4,0,6,"dummy"
"272980",0,2,0,2,"dummy"
"272981",0,2,0,2,"dummy"
"272982",10,2,0,12,"dummy"
"272983",0,2,0,2,"dummy"
"272984",0,0,0,0,"dummy"
"272985",0,0,3,3,"dummy"
"272986",0,5,0,5,"dummy"
"272998",1,3,0,4,"dummy"
"272999",4,14,0,18,"dummy"
"273000",0,1,0,1,"dummy"
"273001",0,0,0,0,"dummy"
"273003",0,0,0,0,"dummy"
"273004",0,0,0,0,"dummy"
"273005",1,0,0,1,"dummy"
"273006",0,0,0,0,"dummy"
"273007",0,0,0,0,"dummy"
"273008",0,3,0,3,"dummy"
"273009",0,0,0,0,"dummy"
"273010",0,0,1,1,"dummy"
"273011",0,1,0,1,"dummy"
"273012",0,0,1,1,"dummy"
"273013",0,0,0,0,"dummy"
"273014",0,1,0,1,"dummy"
"273015",0,9,0,9,"dummy"
"273016",0,0,1,1,"dummy"
"273017",0,0,1,1,"dummy"
"273020",7,0,0,7,"dummy"
"273021",3,19,3,25,"dummy"
"273068",0,0,0,0,"dummy"
"273069",1,1,0,2,"dummy"
"273074",0,1,0,1,"dummy"
"273076",0,4,0,4,"dummy"
"273080",0,0,0,0,"dummy"
"273082",2,2,0,4,"dummy"
"273083",0,1,0,1,"dummy"
"273084",0,0,2,2,"dummy"
"273085",1,0,0,1,"dummy"
"273086",2,9,1,12,"dummy"
"273087",0,0,0,0,"dummy"
"273088",0,1,0,1,"dummy"
"273193",0,1,0,1,"dummy"
"273194",6,7,1,14,"dummy"
"273195",0,1,0,1,"dummy"
"273198",0,0,0,0,"dummy"
"273199",0,0,0,0,"dummy"
"273206",2,0,0,2,"dummy"
"273215",1,1,0,2,"dummy"
"273216",0,0,1,1,"dummy"
"273226",0,0,0,0,"dummy"
"273227",0,0,0,0,"dummy"
"273231",1,2,0,3,"dummy"
"273232",0,0,0,0,"dummy"
"273279",1,0,3,4,"dummy"
"273335",1,14,2,17,"dummy"
"273336",0,0,1,1,"dummy"
"273337",0,0,1,1,"dummy"
"273341",4,2,0,6,"dummy"
"273342",0,3,0,3,"dummy"
"273343",0,0,1,1,"dummy"
"273344",0,0,1,1,"dummy"
"273369",0,0,0,0,"dummy"
"273370",0,0,0,0,"dummy"
"273371",0,0,0,0,"dummy"
"273372",0,0,0,0,"dummy"
"273386",0,2,0,2,"dummy"
"273387",2,13,0,15,"dummy"
"273388",0,1,0,1,"dummy"
"273389",1,0,0,1,"dummy"
"273390",0,0,0,0,"dummy"
"273419",2,0,0,2,"dummy"
"273422",0,0,1,1,"dummy"
"273423",0,0,0,0,"dummy"
"273424",0,1,0,1,"dummy"
"273425",1,0,0,1,"dummy"
"273442",0,0,2,2,"dummy"
"273447",0,0,3,3,"dummy"
"273448",0,0,0,0,"dummy"
"273449",0,0,2,2,"dummy"
"273453",1,11,0,12,"dummy"
"273484",0,2,0,2,"dummy"
"273493",0,0,1,1,"dummy"
"273494",0,2,2,4,"dummy"
"273495",0,0,1,1,"dummy"
"273496",0,0,1,1,"dummy"
"273497",0,0,2,2,"dummy"
"273503",0,0,1,1,"dummy"
"273509",1,4,0,5,"dummy"
"273528",0,1,4,5,"dummy"
"273536",0,0,2,2,"dummy"
"273557",0,0,0,0,"dummy"
"273558",2,0,0,2,"dummy"
"273090",4,3,0,7,"dummy"
"273091",3,3,0,6,"dummy"
"273092",5,3,3,11,"dummy"
"273093",3,3,0,6,"dummy"
"273094",0,0,1,1,"dummy"
"273095",0,0,1,1,"dummy"
"273096",4,0,1,5,"dummy"
"273097",0,3,1,4,"dummy"
"273098",0,0,1,1,"dummy"
"273099",0,0,1,1,"dummy"
"273100",0,0,1,1,"dummy"
"273101",3,0,2,5,"dummy"
"273102",0,0,1,1,"dummy"
"273105",0,0,1,1,"dummy"
"273106",0,1,0,1,"dummy"
"273107",2,5,2,9,"dummy"
"273108",0,1,0,1,"dummy"
"273109",0,0,0,0,"dummy"
"273201",0,3,0,3,"dummy"
"273202",0,0,1,1,"dummy"
"273203",0,0,1,1,"dummy"
"273204",0,1,0,1,"dummy"
"273212",0,0,1,1,"dummy"
"273213",0,0,0,0,"dummy"
"273218",0,3,3,6,"dummy"
"273219",1,17,0,18,"dummy"
"273220",0,1,0,1,"dummy"
"273221",0,1,0,1,"dummy"
"273222",8,1,0,9,"dummy"
"273223",0,0,1,1,"dummy"
"273224",0,1,0,1,"dummy"
"273229",0,2,0,2,"dummy"
"273290",0,1,0,1,"dummy"
"273291",0,3,3,6,"dummy"
"273292",0,1,0,1,"dummy"
"273293",12,12,3,27,"dummy"
"273294",0,0,0,0,"dummy"
"273305",0,0,1,1,"dummy"
"273306",0,4,0,4,"dummy"
"273307",3,0,2,5,"dummy"
"273308",0,1,0,1,"dummy"
"273309",0,0,0,0,"dummy"
"273310",2,11,0,13,"dummy"
"273311",0,0,0,0,"dummy"
"273312",1,1,2,4,"dummy"
"273313",6,0,0,6,"dummy"
"273314",3,2,1,6,"dummy"
"273315",2,0,3,5,"dummy"
"273316",2,2,0,4,"dummy"
"273317",3,3,1,7,"dummy"
"273318",2,0,1,3,"dummy"
"273319",1,4,0,5,"dummy"
"273320",1,0,0,1,"dummy"
"273339",0,1,0,1,"dummy"
"273374",11,3,0,14,"dummy"
"273375",2,2,0,4,"dummy"
"273376",2,5,0,7,"dummy"
"273377",2,0,0,2,"dummy"
"273378",1,0,0,1,"dummy"
"273379",1,3,0,4,"dummy"
"273384",0,0,0,0,"dummy"
"273392",0,1,0,1,"dummy"
"273393",0,10,1,11,"dummy"
"273394",5,2,1,8,"dummy"
"273397",1,0,0,1,"dummy"
"273398",0,1,0,1,"dummy"
"273399",1,7,0,8,"dummy"
"273402",0,1,0,1,"dummy"
"273427",1,5,1,7,"dummy"
"273428",0,2,0,2,"dummy"
"273429",1,1,4,6,"dummy"
"273430",26,3,5,34,"dummy"
"273431",3,26,5,34,"dummy"
"273432",5,0,0,5,"dummy"
"273433",0,2,1,3,"dummy"
"273434",0,0,2,2,"dummy"
"273435",0,0,1,1,"dummy"
"273436",0,0,0,0,"dummy"
"273437",19,0,1,20,"dummy"
"273438",0,0,1,1,"dummy"
"273439",0,2,1,3,"dummy"
"273440",1,0,0,1,"dummy"
"273451",0,1,0,1,"dummy"
"273455",3,17,7,27,"dummy"
"273456",0,0,1,1,"dummy"
"273457",0,1,1,2,"dummy"
"273499",0,1,0,1,"dummy"
"273500",5,2,2,9,"dummy"
"273501",0,0,0,0,"dummy"
"273505",3,1,0,4,"dummy"
"273506",0,7,2,9,"dummy"
"273507",0,1,1,2,"dummy"
"273511",0,4,2,6,"dummy"
"273518",0,0,0,0,"dummy"
"273519",0,0,0,0,"dummy"
"273532",0,0,0,0,"dummy"
"273538",0,0,2,2,"dummy"
"273539",0,1,0,1,"dummy"
"273540",1,7,0,8,"dummy"
"273541",0,2,1,3,"dummy"
"273551",1,3,1,5,"dummy"
"273552",1,0,0,1,"dummy"
"273553",3,6,3,12,"dummy"
"273554",0,0,1,1,"dummy"
"273555",0,0,1,1,"dummy"
"273565",0,0,0,0,"dummy"
"273566",0,0,0,0,"dummy"
"273567",0,0,0,0,"dummy"
"273571",0,0,1,1,"dummy"
"273572",1,2,1,4,"dummy"
"273573",0,0,1,1,"dummy"
"273574",0,0,1,1,"dummy"
"273577",0,0,0,0,"dummy"
"273578",0,0,0,0,"dummy"
"273579",0,0,1,1,"dummy"
"273580",2,1,0,3,"dummy"
"273581",1,0,0,1,"dummy"
"273582",1,0,0,1,"dummy"
"273583",1,0,0,1,"dummy"
"273584",0,0,0,0,"dummy"
"273585",2,0,0,2,"dummy"
"273586",0,2,1,3,"dummy"
"273587",2,0,0,2,"dummy"
"273588",0,0,1,1,"dummy"
"273589",0,0,0,0,"dummy"
"273590",1,2,0,3,"dummy"
"273591",0,0,0,0,"dummy"
"273592",0,0,0,0,"dummy"
"273593",0,0,0,0,"dummy"
"273594",0,0,0,0,"dummy"
"273569",0,0,2,2,"dummy"
"273611",1,4,0,5,"dummy"
"273612",0,1,0,1,"dummy"
"273613",0,0,1,1,"dummy"
"273614",1,1,0,2,"dummy"
"273623",3,3,0,6,"dummy"
"273624",0,0,1,1,"dummy"
"273625",0,1,0,1,"dummy"
"273628",0,4,0,4,"dummy"
"273629",1,1,0,2,"dummy"
"273636",0,1,0,1,"dummy"
"273637",1,0,0,1,"dummy"
"273638",1,0,0,1,"dummy"
"273645",1,1,0,2,"dummy"
"273648",1,0,0,1,"dummy"
"273657",0,0,0,0,"dummy"
"273658",0,0,0,0,"dummy"
"273663",0,0,1,1,"dummy"
"273670",0,19,0,19,"dummy"
"273671",1,2,0,3,"dummy"
"273672",0,0,0,0,"dummy"
"273673",10,4,3,17,"dummy"
"273674",0,1,1,2,"dummy"
"273675",0,2,0,2,"dummy"
"273676",0,6,0,6,"dummy"
"273677",0,0,1,1,"dummy"
"273694",0,0,1,1,"dummy"
"273695",0,0,0,0,"dummy"
"273733",0,0,1,1,"dummy"
"273734",0,0,1,1,"dummy"
"273735",0,0,1,1,"dummy"
"273736",0,0,1,1,"dummy"
"273737",0,2,2,4,"dummy"
"273747",2,18,0,20,"dummy"
"273748",0,0,1,1,"dummy"
"273769",0,0,0,0,"dummy"
"273770",0,0,0,0,"dummy"
"273771",0,0,0,0,"dummy"
"273772",1,0,0,1,"dummy"
"273773",0,0,0,0,"dummy"
"273774",0,0,0,0,"dummy"
"273775",0,0,0,0,"dummy"
"273776",0,0,0,0,"dummy"
"273777",2,1,0,3,"dummy"
"273778",0,0,0,0,"dummy"
"273779",0,0,0,0,"dummy"
"273780",0,0,0,0,"dummy"
"273781",0,0,0,0,"dummy"
"273782",0,0,0,0,"dummy"
"273783",0,7,0,7,"dummy"
"273784",0,0,0,0,"dummy"
"273785",0,0,0,0,"dummy"
"273786",0,0,0,0,"dummy"
"273787",0,0,0,0,"dummy"
"273788",1,4,0,5,"dummy"
"273789",4,1,0,5,"dummy"
"273790",0,0,0,0,"dummy"
"273791",1,4,0,5,"dummy"
"273792",0,0,0,0,"dummy"
"273793",0,0,0,0,"dummy"
"273794",0,0,2,2,"dummy"
"273795",6,0,0,6,"dummy"
"273796",0,0,0,0,"dummy"
"273797",0,1,0,1,"dummy"
"273798",0,0,0,0,"dummy"
"273799",0,0,0,0,"dummy"
"273800",0,0,0,0,"dummy"
"273801",0,0,2,2,"dummy"
"273802",0,0,2,2,"dummy"
"273803",0,0,2,2,"dummy"
"273804",0,0,2,2,"dummy"
"273805",0,0,0,0,"dummy"
"273806",0,0,2,2,"dummy"
"273807",0,1,0,1,"dummy"
"273595",0,0,0,0,"dummy"
"273596",5,4,2,11,"dummy"
"273597",0,0,0,0,"dummy"
"273598",0,0,0,0,"dummy"
"273599",5,0,0,5,"dummy"
"273600",0,5,0,5,"dummy"
"273601",5,0,0,5,"dummy"
"273602",0,0,0,0,"dummy"
"273631",1,0,1,2,"dummy"
"273632",0,0,4,4,"dummy"
"273633",0,1,2,3,"dummy"
"273634",2,3,4,9,"dummy"
"273640",0,0,0,0,"dummy"
"273643",0,0,2,2,"dummy"
"273650",2,0,3,5,"dummy"
"273679",1,4,0,5,"dummy"
"273680",3,0,2,5,"dummy"
"273681",0,1,0,1,"dummy"
"273684",0,0,0,0,"dummy"
"273685",0,9,0,9,"dummy"
"273691",3,5,3,11,"dummy"
"273692",0,0,0,0,"dummy"
"273697",1,0,1,2,"dummy"
"273698",0,0,0,0,"dummy"
"273699",0,1,0,1,"dummy"
"273704",7,6,0,13,"dummy"
"273705",1,1,3,5,"dummy"
"273739",1,0,1,2,"dummy"
"273740",12,0,3,15,"dummy"
"273741",0,0,1,1,"dummy"
"273744",11,1,2,14,"dummy"
"273745",0,0,0,0,"dummy"
"273829",0,0,0,0,"dummy"
"273830",6,1,2,9,"dummy"
"273834",0,1,2,3,"dummy"
"273835",0,0,0,0,"dummy"
"273836",0,1,0,1,"dummy"
"273837",4,0,2,6,"dummy"
"273838",1,0,0,1,"dummy"
"273839",0,0,0,0,"dummy"
"273840",0,0,0,0,"dummy"
"273846",1,0,0,1,"dummy"
"273847",0,3,2,5,"dummy"
"273867",0,0,3,3,"dummy"
"273892",0,0,1,1,"dummy"
"273893",0,0,1,1,"dummy"
"273894",0,1,0,1,"dummy"
"273895",1,0,0,1,"dummy"
"273896",0,0,0,0,"dummy"
"273897",0,2,0,2,"dummy"
"273898",0,0,1,1,"dummy"
"273899",0,0,1,1,"dummy"
"273900",0,0,0,0,"dummy"
"273901",0,0,0,0,"dummy"
"273902",1,2,2,5,"dummy"
"273903",0,0,0,0,"dummy"
"273904",0,1,0,1,"dummy"
"273905",0,1,0,1,"dummy"
"273906",0,1,0,1,"dummy"
"273907",22,19,0,41,"dummy"
"273908",0,0,1,1,"dummy"
"273909",0,0,2,2,"dummy"
"273910",0,0,2,2,"dummy"
"273911",0,0,1,1,"dummy"
"273912",0,0,1,1,"dummy"
"273913",0,0,1,1,"dummy"
"273914",0,0,2,2,"dummy"
"273915",0,0,2,2,"dummy"
"273916",1,0,0,1,"dummy"
"273917",0,0,2,2,"dummy"
"273918",0,0,2,2,"dummy"
"273919",0,0,2,2,"dummy"
"273920",0,0,2,2,"dummy"
"273921",1,1,0,2,"dummy"
"273922",1,1,1,3,"dummy"
"273923",2,1,0,3,"dummy"
"273808",0,0,0,0,"dummy"
"273809",0,0,1,1,"dummy"
"273810",0,0,1,1,"dummy"
"273811",0,0,2,2,"dummy"
"273812",0,0,2,2,"dummy"
"273813",0,0,2,2,"dummy"
"273814",0,0,2,2,"dummy"
"273815",0,0,2,2,"dummy"
"273816",0,0,0,0,"dummy"
"273817",0,0,0,0,"dummy"
"273818",0,0,0,0,"dummy"
"273819",0,0,3,3,"dummy"
"273820",0,0,0,0,"dummy"
"273821",0,0,0,0,"dummy"
"273822",4,1,0,5,"dummy"
"273823",0,0,0,0,"dummy"
"273824",0,0,0,0,"dummy"
"273825",0,0,0,0,"dummy"
"273826",0,0,0,0,"dummy"
"273827",0,0,0,0,"dummy"
"273832",0,3,0,3,"dummy"
"273842",0,1,1,2,"dummy"
"273843",0,1,0,1,"dummy"
"273844",0,5,0,5,"dummy"
"273869",0,1,0,1,"dummy"
"273870",0,0,0,0,"dummy"
"273871",0,1,0,1,"dummy"
"273872",0,0,0,0,"dummy"
"273873",0,0,0,0,"dummy"
"273874",0,0,0,0,"dummy"
"273875",0,0,0,0,"dummy"
"273876",0,1,0,1,"dummy"
"273877",0,0,0,0,"dummy"
"273878",0,3,0,3,"dummy"
"273879",0,2,0,2,"dummy"
"273880",2,0,0,2,"dummy"
"273881",0,3,0,3,"dummy"
"273882",0,0,0,0,"dummy"
"273883",3,0,0,3,"dummy"
"273884",0,3,0,3,"dummy"
"273885",3,3,0,6,"dummy"
"273886",0,2,0,2,"dummy"
"273887",13,26,2,41,"dummy"
"273888",6,11,2,19,"dummy"
"273889",0,5,1,6,"dummy"
"273890",2,1,4,7,"dummy"
"273990",2,4,0,6,"dummy"
"273991",0,2,0,2,"dummy"
"273992",0,2,0,2,"dummy"
"273993",10,2,0,12,"dummy"
"273994",0,2,0,2,"dummy"
"273995",0,0,0,0,"dummy"
"273996",0,0,3,3,"dummy"
"273997",0,5,0,5,"dummy"
"273998",1,0,1,2,"dummy"
"273999",0,0,0,0,"dummy"
"274000",0,0,0,0,"dummy"
"274001",0,0,0,0,"dummy"
"273924",0,0,2,2,"dummy"
"273925",2,0,0,2,"dummy"
"273926",0,1,0,1,"dummy"
"273927",0,0,0,0,"dummy"
"273928",0,0,1,1,"dummy"
"273929",0,0,1,1,"dummy"
"273930",0,0,1,1,"dummy"
"273931",0,0,1,1,"dummy"
"273932",0,0,1,1,"dummy"
"273933",0,0,1,1,"dummy"
"273934",0,1,0,1,"dummy"
"273935",0,1,1,2,"dummy"
"273936",0,1,1,2,"dummy"
"273937",0,0,1,1,"dummy"
"273938",0,0,1,1,"dummy"
"273939",0,0,1,1,"dummy"
"273940",0,0,1,1,"dummy"
"273941",0,0,1,1,"dummy"
"273942",0,0,1,1,"dummy"
"273943",0,0,1,1,"dummy"
"273944",0,0,1,1,"dummy"
"273945",0,0,1,1,"dummy"
"273946",0,0,1,1,"dummy"
"273947",0,0,1,1,"dummy"
"273948",0,0,1,1,"dummy"
"273949",0,0,1,1,"dummy"
"273950",0,0,1,1,"dummy"
"273951",0,0,1,1,"dummy"
"273952",0,0,1,1,"dummy"
"273953",0,0,1,1,"dummy"
"273954",0,0,1,1,"dummy"
"273955",0,0,1,1,"dummy"
"273956",1,0,0,1,"dummy"
"273957",0,1,0,1,"dummy"
"273958",0,0,1,1,"dummy"
"273959",0,0,1,1,"dummy"
"273960",0,0,1,1,"dummy"
"273961",0,0,1,1,"dummy"
"273962",0,0,1,1,"dummy"
"273963",0,0,1,1,"dummy"
"273964",0,0,1,1,"dummy"
"273965",0,0,1,1,"dummy"
"273966",0,0,1,1,"dummy"
"273967",0,0,1,1,"dummy"
"273968",0,0,1,1,"dummy"
"273969",0,0,1,1,"dummy"
"273970",0,0,1,1,"dummy"
"273971",0,0,1,1,"dummy"
"273972",0,0,1,1,"dummy"
"273973",0,0,1,1,"dummy"
"273974",0,0,1,1,"dummy"
"273975",0,0,1,1,"dummy"
"273976",0,0,1,1,"dummy"
"273977",0,0,1,1,"dummy"
"273978",0,0,1,1,"dummy"
"273979",0,0,1,1,"dummy"
"273980",0,0,1,1,"dummy"
"273981",0,0,1,1,"dummy"
"273982",0,0,1,1,"dummy"
"273983",0,0,1,1,"dummy"
"273984",0,0,1,1,"dummy"
"273985",0,0,1,1,"dummy"
"274003",0,0,0,0,"dummy"
"274004",0,0,0,0,"dummy"
"274005",0,0,0,0,"dummy"
"274007",1,1,0,2,"dummy"
"274009",0,0,0,0,"dummy"
"274012",0,0,1,1,"dummy"
"274014",0,2,0,2,"dummy"
"274015",0,6,0,6,"dummy"
"274024",0,0,0,0,"dummy"
"274026",0,0,1,1,"dummy"
"274028",2,1,0,3,"dummy"
"274036",6,5,2,13,"dummy"
"274037",2,0,0,2,"dummy"
"274038",0,1,0,1,"dummy"
"274039",0,1,0,1,"dummy"
"274040",1,0,0,1,"dummy"
"274041",0,1,0,1,"dummy"
"274042",0,0,1,1,"dummy"
"274043",0,0,1,1,"dummy"
"274044",1,3,2,6,"dummy"
"274045",0,0,2,2,"dummy"
"274046",0,0,1,1,"dummy"
"274047",0,0,0,0,"dummy"
"274050",3,0,1,4,"dummy"
"274051",0,4,0,4,"dummy"
"274053",1,0,0,1,"dummy"
"274055",0,0,1,1,"dummy"
"274056",0,1,0,1,"dummy"
"274057",0,0,1,1,"dummy"
"274058",0,1,0,1,"dummy"
"274059",9,4,2,15,"dummy"
"274060",2,0,1,3,"dummy"
"274061",0,2,0,2,"dummy"
"274062",2,2,1,5,"dummy"
"274063",2,2,1,5,"dummy"
"274064",0,1,0,1,"dummy"
"274065",3,1,0,4,"dummy"
"274066",0,0,1,1,"dummy"
"274067",2,0,0,2,"dummy"
"274070",1,2,0,3,"dummy"
"274071",1,1,0,2,"dummy"
"274072",0,0,1,1,"dummy"
"274077",0,8,0,8,"dummy"
"274081",0,0,2,2,"dummy"
"274082",0,0,1,1,"dummy"
"274083",9,6,3,18,"dummy"
"274084",0,0,1,1,"dummy"
"274085",0,1,1,2,"dummy"
"274097",0,0,1,1,"dummy"
"274098",0,0,2,2,"dummy"
"274099",0,0,1,1,"dummy"
"274100",0,0,1,1,"dummy"
"274101",0,1,1,2,"dummy"
"274106",4,2,1,7,"dummy"
"274108",0,1,1,2,"dummy"
"274109",0,2,0,2,"dummy"
"274110",0,0,0,0,"dummy"
"274111",0,1,0,1,"dummy"
"274112",2,0,0,2,"dummy"
"274113",0,2,0,2,"dummy"
"274114",2,0,2,4,"dummy"
"274116",0,0,1,1,"dummy"
"274117",38,2,1,41,"dummy"
"274118",1,0,0,1,"dummy"
"274136",1,1,0,2,"dummy"
"274137",2,6,2,10,"dummy"
"274138",0,1,0,1,"dummy"
"274142",2,0,0,2,"dummy"
"274143",0,1,0,1,"dummy"
"274144",24,9,2,35,"dummy"
"274145",0,0,1,1,"dummy"
"274148",0,0,1,1,"dummy"
"274149",26,11,2,39,"dummy"
"274150",1,5,0,6,"dummy"
"274151",1,1,0,2,"dummy"
"274152",0,1,0,1,"dummy"
"274153",0,0,1,1,"dummy"
"274154",0,0,1,1,"dummy"
"274155",0,0,1,1,"dummy"
"274156",16,0,1,17,"dummy"
"274157",0,0,3,3,"dummy"
"274158",0,0,1,1,"dummy"
"274159",0,0,1,1,"dummy"
"274160",0,0,1,1,"dummy"
"274161",0,0,1,1,"dummy"
"274162",0,0,1,1,"dummy"
"274163",0,0,1,1,"dummy"
"274164",0,0,1,1,"dummy"
"274165",0,0,1,1,"dummy"
"274166",0,0,1,1,"dummy"
"274167",0,0,1,1,"dummy"
"274168",0,0,1,1,"dummy"
"274169",0,0,1,1,"dummy"
"274170",0,0,1,1,"dummy"
"274171",0,0,1,1,"dummy"
"274172",0,0,1,1,"dummy"
"274173",0,0,1,1,"dummy"
"274174",0,0,1,1,"dummy"
"274175",0,0,1,1,"dummy"
"274176",1,2,0,3,"dummy"
"274177",0,0,1,1,"dummy"
"274178",0,0,1,1,"dummy"
"274179",0,0,1,1,"dummy"
"274182",0,0,0,0,"dummy"
"274184",0,2,0,2,"dummy"
"274185",0,1,0,1,"dummy"
"274188",3,5,2,10,"dummy"
"274189",0,2,0,2,"dummy"
"274190",2,5,0,7,"dummy"
"274191",0,2,1,3,"dummy"
"274192",3,3,1,7,"dummy"
"274193",0,0,1,1,"dummy"
"274194",0,2,1,3,"dummy"
"274196",0,0,1,1,"dummy"
"274200",0,1,0,1,"dummy"
"274201",0,0,1,1,"dummy"
"274202",0,0,1,1,"dummy"
"274203",1,1,1,3,"dummy"
"274204",0,1,0,1,"dummy"
"274205",0,0,1,1,"dummy"
"274206",1,1,0,2,"dummy"
"274207",1,1,0,2,"dummy"
"274208",0,0,1,1,"dummy"
"274209",0,0,1,1,"dummy"
"274210",0,0,1,1,"dummy"
"274211",0,0,1,1,"dummy"
"274212",0,0,1,1,"dummy"
"274213",0,0,1,1,"dummy"
"274214",0,0,1,1,"dummy"
"274215",0,0,1,1,"dummy"
"274216",0,0,1,1,"dummy"
"274217",0,0,1,1,"dummy"
"274218",0,0,1,1,"dummy"
"274219",0,0,1,1,"dummy"
"274220",0,0,0,0,"dummy"
"274221",0,0,1,1,"dummy"
"274222",0,0,1,1,"dummy"
"274223",0,0,1,1,"dummy"
"274224",0,0,1,1,"dummy"
"274225",0,0,1,1,"dummy"
"274226",0,0,0,0,"dummy"
"274248",0,2,0,2,"dummy"
"274249",0,2,0,2,"dummy"
"274250",0,3,0,3,"dummy"
"274251",0,1,0,1,"dummy"
"274252",0,3,0,3,"dummy"
"274253",0,1,0,1,"dummy"
"274255",1,0,1,2,"dummy"
"274256",0,0,1,1,"dummy"
"274257",0,0,1,1,"dummy"
"274260",0,3,1,4,"dummy"
"274262",3,0,0,3,"dummy"
"274263",0,1,0,1,"dummy"
"274264",0,2,0,2,"dummy"
"274265",0,0,2,2,"dummy"
"274266",0,0,1,1,"dummy"
"274269",0,1,1,2,"dummy"
"274270",4,5,3,12,"dummy"
"274271",0,0,3,3,"dummy"
"274272",4,4,0,8,"dummy"
"274273",2,0,0,2,"dummy"
"274279",0,0,1,1,"dummy"
"274280",0,0,1,1,"dummy"
"274282",0,0,1,1,"dummy"
"274283",0,0,0,0,"dummy"
"274285",5,3,4,12,"dummy"
"274288",0,8,1,9,"dummy"
"274292",2,10,6,18,"dummy"
"274295",0,1,0,1,"dummy"
"274296",0,13,2,15,"dummy"
"274299",1,2,0,3,"dummy"
"274300",2,4,1,7,"dummy"
"274301",6,0,3,9,"dummy"
"274303",2,0,0,2,"dummy"
"274304",0,4,0,4,"dummy"
"274305",1,5,0,6,"dummy"
"274306",0,2,0,2,"dummy"
"274307",0,0,1,1,"dummy"
"274311",0,1,0,1,"dummy"
"274312",0,9,0,9,"dummy"
"274313",0,3,0,3,"dummy"
"274315",5,1,0,6,"dummy"
"274316",0,10,1,11,"dummy"
"274317",3,1,0,4,"dummy"
"274318",0,3,1,4,"dummy"
"274319",7,0,0,7,"dummy"
"274321",0,3,0,3,"dummy"
"274322",0,0,1,1,"dummy"
"274326",0,1,0,1,"dummy"
"274327",0,1,0,1,"dummy"
"274330",1,1,0,2,"dummy"
"274331",0,2,0,2,"dummy"
"274344",2,2,2,6,"dummy"
"274345",0,2,10,12,"dummy"
"274346",0,1,0,1,"dummy"
"274347",7,18,0,25,"dummy"
"274348",4,0,0,4,"dummy"
"274372",0,0,1,1,"dummy"
"274376",0,0,3,3,"dummy"
"274377",0,0,0,0,"dummy"
"274380",0,0,0,0,"dummy"
"274381",0,0,0,0,"dummy"
"274383",2,0,0,2,"dummy"
"274384",0,0,1,1,"dummy"
"274385",0,0,1,1,"dummy"
"274386",0,0,1,1,"dummy"
"274387",0,0,1,1,"dummy"
"274389",0,1,0,1,"dummy"
"274390",2,0,0,2,"dummy"
"274391",0,4,0,4,"dummy"
"274392",3,0,0,3,"dummy"
"274393",0,2,0,2,"dummy"
"274394",1,0,0,1,"dummy"
"274395",0,3,1,4,"dummy"
"274396",0,2,0,2,"dummy"
"274397",0,0,1,1,"dummy"
"274398",0,0,1,1,"dummy"
"274404",0,1,0,1,"dummy"
"274407",0,0,1,1,"dummy"
"274408",0,3,0,3,"dummy"
"274409",0,2,0,2,"dummy"
"274410",0,1,1,2,"dummy"
"274411",4,0,2,6,"dummy"
"274412",0,0,1,1,"dummy"
"274413",0,0,2,2,"dummy"
"274415",0,3,0,3,"dummy"
"274416",1,0,0,1,"dummy"
"274417",5,2,6,13,"dummy"
"274419",0,3,0,3,"dummy"
"274420",0,1,0,1,"dummy"
"274424",1,0,2,3,"dummy"
"274425",0,1,0,1,"dummy"
"274426",5,0,4,9,"dummy"
"274427",0,0,1,1,"dummy"
"274430",6,0,0,6,"dummy"
"274431",2,5,2,9,"dummy"
"274433",0,1,0,1,"dummy"
"274434",0,0,0,0,"dummy"
"274435",0,2,0,2,"dummy"
"274436",1,5,1,7,"dummy"
"274438",0,1,0,1,"dummy"
"274439",0,0,1,1,"dummy"
"274442",0,1,0,1,"dummy"
"274443",2,0,2,4,"dummy"
"274445",3,4,0,7,"dummy"
"274446",6,4,0,10,"dummy"
"274447",0,1,3,4,"dummy"
"274467",1,3,0,4,"dummy"
"274474",0,0,2,2,"dummy"
"274475",5,0,1,6,"dummy"
"274476",0,0,1,1,"dummy"
"274478",0,5,0,5,"dummy"
"274479",0,2,0,2,"dummy"
"274481",2,4,0,6,"dummy"
"274482",2,0,3,5,"dummy"
"274483",0,0,1,1,"dummy"
"274484",0,0,0,0,"dummy"
"274490",1,6,0,7,"dummy"
"274491",0,1,0,1,"dummy"
"274495",0,2,0,2,"dummy"
"274497",0,0,1,1,"dummy"
"274498",0,0,1,1,"dummy"
"274504",3,5,0,8,"dummy"
"274505",0,0,1,1,"dummy"
"274506",0,0,1,1,"dummy"
"274508",7,2,1,10,"dummy"
"274509",0,1,1,2,"dummy"
"274510",0,2,0,2,"dummy"
"274511",1,0,3,4,"dummy"
"274512",0,1,1,2,"dummy"
"274513",11,6,0,17,"dummy"
"274514",1,11,0,12,"dummy"
"274515",5,5,0,10,"dummy"
"274516",0,2,0,2,"dummy"
"274517",3,0,0,3,"dummy"
"274518",0,2,0,2,"dummy"
"274519",1,1,1,3,"dummy"
"274520",0,1,0,1,"dummy"
"274521",1,0,1,2,"dummy"
"274522",0,1,1,2,"dummy"
"274523",0,15,0,15,"dummy"
"274524",7,5,0,12,"dummy"
"274525",12,19,0,31,"dummy"
"274526",1,0,0,1,"dummy"
"274527",7,0,0,7,"dummy"
"274528",0,1,0,1,"dummy"
"274529",3,16,0,19,"dummy"
"274530",3,0,0,3,"dummy"
"274531",0,6,0,6,"dummy"
"274532",2,0,2,4,"dummy"
"274535",0,0,1,1,"dummy"
"274549",2,1,1,4,"dummy"
"274551",1,0,0,1,"dummy"
"274565",0,1,0,1,"dummy"
"274566",2,1,0,3,"dummy"
"274567",0,1,0,1,"dummy"
"274568",3,2,0,5,"dummy"
"274569",0,2,0,2,"dummy"
"274570",2,1,0,3,"dummy"
"274571",0,0,1,1,"dummy"
"274572",3,2,1,6,"dummy"
"274573",0,2,2,4,"dummy"
"274574",0,0,1,1,"dummy"
"274575",0,1,0,1,"dummy"
"274577",0,1,2,3,"dummy"
"274578",0,0,0,0,"dummy"
"274579",0,2,0,2,"dummy"
"274580",5,0,2,7,"dummy"
"274581",1,0,0,1,"dummy"
"274585",2,1,2,5,"dummy"
"274586",0,0,1,1,"dummy"
"274588",2,2,1,5,"dummy"
"274593",0,0,1,1,"dummy"
"274597",0,3,0,3,"dummy"
"274598",0,2,0,2,"dummy"
"274602",2,4,0,6,"dummy"
"274603",0,2,0,2,"dummy"
"274604",0,2,0,2,"dummy"
"274605",10,2,0,12,"dummy"
"274606",0,2,0,2,"dummy"
"274607",0,0,0,0,"dummy"
"274608",0,0,3,3,"dummy"
"274609",0,5,0,5,"dummy"
"274610",1,0,1,2,"dummy"
"274612",0,0,1,1,"dummy"
"274615",2,8,0,10,"dummy"
"274616",0,2,0,2,"dummy"
"274617",1,3,1,5,"dummy"
"274618",0,0,0,0,"dummy"
"274619",1,11,0,12,"dummy"
"274620",2,2,8,12,"dummy"
"274621",0,0,0,0,"dummy"
"274622",0,0,0,0,"dummy"
"274625",0,1,0,1,"dummy"
"274628",2,4,0,6,"dummy"
"274629",0,2,0,2,"dummy"
"274630",0,2,0,2,"dummy"
"274631",10,2,0,12,"dummy"
"274632",0,2,0,2,"dummy"
"274633",0,0,0,0,"dummy"
"274636",12,7,3,22,"dummy"
"274638",1,1,2,4,"dummy"
"274641",1,0,0,1,"dummy"
"274642",0,0,1,1,"dummy"
"274657",5,0,0,5,"dummy"
"274658",0,0,1,1,"dummy"
"274659",0,2,0,2,"dummy"
"274660",1,30,1,32,"dummy"
"274661",0,3,0,3,"dummy"
"274662",1,13,0,14,"dummy"
"274663",0,1,0,1,"dummy"
"274665",1,6,0,7,"dummy"
"274666",6,1,0,7,"dummy"
"274668",0,0,1,1,"dummy"
"274669",0,0,1,1,"dummy"
"274670",0,0,1,1,"dummy"
"274671",0,0,1,1,"dummy"
"274672",0,0,1,1,"dummy"
"274673",0,0,1,1,"dummy"
"274677",0,0,1,1,"dummy"
"274678",0,0,0,0,"dummy"
"274680",1,0,0,1,"dummy"
"274681",0,2,0,2,"dummy"
"274682",1,0,0,1,"dummy"
"274683",0,1,0,1,"dummy"
"274684",10,14,0,24,"dummy"
"274685",0,1,0,1,"dummy"
"274686",0,1,0,1,"dummy"
"274687",0,1,0,1,"dummy"
"274688",0,0,1,1,"dummy"
"274689",0,1,1,2,"dummy"
"274690",0,0,1,1,"dummy"
"274691",0,2,0,2,"dummy"
"274692",2,0,0,2,"dummy"
"274693",1,3,0,4,"dummy"
"274698",0,1,0,1,"dummy"
"274699",0,0,1,1,"dummy"
"274700",0,0,1,1,"dummy"
"274701",0,0,1,1,"dummy"
"274702",1,1,0,2,"dummy"
"274712",0,1,0,1,"dummy"
"274713",0,0,4,4,"dummy"
"274714",0,0,2,2,"dummy"
"274715",0,1,4,5,"dummy"
"274716",3,1,0,4,"dummy"
"274719",0,0,0,0,"dummy"
"274720",1,0,0,1,"dummy"
"274721",13,1,0,14,"dummy"
"274722",0,0,1,1,"dummy"
"274723",2,0,0,2,"dummy"
"274724",0,1,0,1,"dummy"
"274725",0,0,0,0,"dummy"
"274726",0,0,1,1,"dummy"
"274727",0,2,0,2,"dummy"
"274728",0,0,0,0,"dummy"
"274729",5,1,0,6,"dummy"
"274730",1,0,0,1,"dummy"
"274731",0,0,0,0,"dummy"
"274732",0,0,0,0,"dummy"
"274737",4,2,1,7,"dummy"
"274738",0,4,0,4,"dummy"
"274739",4,0,0,4,"dummy"
"274740",0,4,0,4,"dummy"
"274749",0,4,0,4,"dummy"
"274750",1,5,1,7,"dummy"
"274751",0,2,0,2,"dummy"
"274769",0,0,0,0,"dummy"
"274770",0,0,1,1,"dummy"
"274771",0,0,1,1,"dummy"
"274772",0,0,1,1,"dummy"
"274773",0,0,0,0,"dummy"
"274774",0,0,1,1,"dummy"
"274775",0,0,1,1,"dummy"
"274776",0,0,1,1,"dummy"
"274777",0,0,0,0,"dummy"
"274778",0,2,2,4,"dummy"
"274779",0,0,0,0,"dummy"
"274780",0,0,0,0,"dummy"
"274781",0,0,1,1,"dummy"
"274782",0,0,0,0,"dummy"
"274783",0,0,0,0,"dummy"
"274784",0,0,1,1,"dummy"
"274785",0,0,1,1,"dummy"
"274786",1,1,0,2,"dummy"
"274787",0,0,1,1,"dummy"
"274788",0,0,1,1,"dummy"
"274789",0,0,1,1,"dummy"
"274790",0,0,1,1,"dummy"
"274791",0,0,1,1,"dummy"
"274792",0,0,0,0,"dummy"
"274793",1,3,0,4,"dummy"
"274794",0,0,1,1,"dummy"
"274795",0,0,1,1,"dummy"
"274796",0,0,1,1,"dummy"
"274797",0,0,1,1,"dummy"
"274798",0,0,0,0,"dummy"
"274799",0,0,1,1,"dummy"
"274800",0,0,1,1,"dummy"
"274871",14,48,4,66,"dummy"
"274872",16,5,5,26,"dummy"
"274873",0,0,1,1,"dummy"
"274874",3,0,0,3,"dummy"
"274875",0,0,1,1,"dummy"
"274876",0,0,1,1,"dummy"
"274877",0,0,1,1,"dummy"
"274878",0,4,0,4,"dummy"
"274704",2,0,0,2,"dummy"
"274705",0,0,1,1,"dummy"
"274708",0,0,0,0,"dummy"
"274709",2,4,1,7,"dummy"
"274710",0,0,0,0,"dummy"
"274742",1,0,0,1,"dummy"
"274743",0,1,0,1,"dummy"
"274744",1,3,0,4,"dummy"
"274745",3,2,0,5,"dummy"
"274746",0,7,0,7,"dummy"
"274747",2,2,0,4,"dummy"
"274753",0,0,0,0,"dummy"
"274754",0,3,0,3,"dummy"
"274755",1,4,0,5,"dummy"
"274756",2,0,0,2,"dummy"
"274759",0,3,0,3,"dummy"
"274760",0,0,2,2,"dummy"
"274761",0,0,1,1,"dummy"
"274762",0,0,1,1,"dummy"
"274763",0,0,1,1,"dummy"
"274764",0,0,1,1,"dummy"
"274765",0,0,1,1,"dummy"
"274766",0,0,1,1,"dummy"
"274767",0,0,1,1,"dummy"
"274802",1,4,0,5,"dummy"
"274803",6,1,1,8,"dummy"
"274827",0,1,0,1,"dummy"
"274828",0,1,0,1,"dummy"
"274831",0,1,0,1,"dummy"
"274832",2,3,0,5,"dummy"
"274850",0,1,0,1,"dummy"
"274851",0,1,0,1,"dummy"
"274854",2,0,0,2,"dummy"
"274855",0,0,0,0,"dummy"
"274858",4,4,3,11,"dummy"
"274859",0,0,1,1,"dummy"
"274860",1,0,1,2,"dummy"
"274863",0,2,0,2,"dummy"
"274866",0,0,1,1,"dummy"
"274867",3,0,0,3,"dummy"
"274904",1,2,0,3,"dummy"
"274905",0,0,0,0,"dummy"
"274906",1,0,2,3,"dummy"
"274907",1,11,3,15,"dummy"
"274921",3,2,1,6,"dummy"
"274922",0,0,1,1,"dummy"
"274941",0,4,0,4,"dummy"
"274942",0,1,0,1,"dummy"
"274943",0,2,0,2,"dummy"
"274944",3,0,0,3,"dummy"
"274945",0,1,0,1,"dummy"
"274946",0,2,0,2,"dummy"
"274947",1,0,1,2,"dummy"
"274951",0,1,0,1,"dummy"
"274952",1,0,0,1,"dummy"
"274953",1,11,1,13,"dummy"
"274954",4,6,1,11,"dummy"
"274955",3,3,0,6,"dummy"
"274956",0,1,0,1,"dummy"
"274957",3,0,0,3,"dummy"
"274958",0,1,0,1,"dummy"
"274959",1,0,0,1,"dummy"
"274963",1,0,0,1,"dummy"
"274964",0,2,0,2,"dummy"
"275015",0,4,3,7,"dummy"
"275016",0,0,1,1,"dummy"
"275017",3,0,0,3,"dummy"
"275020",3,5,3,11,"dummy"
"274879",0,0,1,1,"dummy"
"274880",0,0,1,1,"dummy"
"274881",0,0,1,1,"dummy"
"274882",0,0,1,1,"dummy"
"274883",0,0,1,1,"dummy"
"274884",0,0,1,1,"dummy"
"274885",0,0,1,1,"dummy"
"274886",0,0,1,1,"dummy"
"274887",0,0,1,1,"dummy"
"274888",0,0,1,1,"dummy"
"274889",0,0,1,1,"dummy"
"274890",0,0,1,1,"dummy"
"274891",0,0,1,1,"dummy"
"274892",0,0,1,1,"dummy"
"274893",0,0,1,1,"dummy"
"274894",0,0,1,1,"dummy"
"274895",0,0,1,1,"dummy"
"274896",0,4,0,4,"dummy"
"274897",4,0,0,4,"dummy"
"274898",0,0,1,1,"dummy"
"274899",0,1,0,1,"dummy"
"274900",0,0,1,1,"dummy"
"274901",0,0,1,1,"dummy"
"274902",3,9,3,15,"dummy"
"274924",0,4,0,4,"dummy"
"274930",0,1,0,1,"dummy"
"274931",5,2,0,7,"dummy"
"274932",0,3,1,4,"dummy"
"274933",2,5,0,7,"dummy"
"274934",2,0,3,5,"dummy"
"274935",1,13,0,14,"dummy"
"274936",3,10,0,13,"dummy"
"274937",16,0,0,16,"dummy"
"274938",0,3,0,3,"dummy"
"274939",1,4,0,5,"dummy"
"274949",0,0,1,1,"dummy"
"274961",0,0,0,0,"dummy"
"274966",0,0,1,1,"dummy"
"274967",0,7,0,7,"dummy"
"274970",0,2,0,2,"dummy"
"274971",2,10,1,13,"dummy"
"275006",0,0,1,1,"dummy"
"275007",0,1,0,1,"dummy"
"275010",1,4,0,5,"dummy"
"275013",0,0,0,0,"dummy"
"275022",0,3,0,3,"dummy"
"275042",0,0,1,1,"dummy"
"275054",4,3,0,7,"dummy"
"275065",0,0,1,1,"dummy"
"275066",0,0,1,1,"dummy"
"275067",0,23,0,23,"dummy"
"275085",0,0,1,1,"dummy"
"275126",0,1,3,4,"dummy"
"275127",0,0,0,0,"dummy"
"275128",0,0,0,0,"dummy"
"275129",0,1,0,1,"dummy"
"275130",0,0,0,0,"dummy"
"275131",0,0,0,0,"dummy"
"275132",0,3,0,3,"dummy"
"275133",0,1,0,1,"dummy"
"275134",0,0,1,1,"dummy"
"275135",0,1,0,1,"dummy"
"275139",0,0,1,1,"dummy"
"275145",6,0,0,6,"dummy"
"275146",2,5,2,9,"dummy"
"275024",0,0,1,1,"dummy"
"275025",0,0,0,0,"dummy"
"275026",0,7,0,7,"dummy"
"275032",0,1,0,1,"dummy"
"275033",0,3,0,3,"dummy"
"275036",11,13,1,25,"dummy"
"275037",0,0,1,1,"dummy"
"275038",3,3,2,8,"dummy"
"275044",0,0,1,1,"dummy"
"275045",0,0,1,1,"dummy"
"275046",0,10,1,11,"dummy"
"275056",0,5,0,5,"dummy"
"275057",0,0,2,2,"dummy"
"275058",0,1,0,1,"dummy"
"275059",2,2,0,4,"dummy"
"275069",0,0,1,1,"dummy"
"275070",0,0,1,1,"dummy"
"275079",0,0,1,1,"dummy"
"275093",1,1,0,2,"dummy"
"275137",0,1,0,1,"dummy"
"275141",0,0,0,0,"dummy"
"275142",0,0,0,0,"dummy"
"275143",0,0,0,0,"dummy"
"275148",0,1,0,1,"dummy"
"275149",0,0,0,0,"dummy"
"275152",0,1,0,1,"dummy"
"275153",0,0,0,0,"dummy"
"275160",0,0,1,1,"dummy"
"275172",11,37,6,54,"dummy"
"275173",0,0,1,1,"dummy"
"275174",0,10,0,10,"dummy"
"275189",0,0,0,0,"dummy"
"275190",0,1,0,1,"dummy"
"275191",0,0,2,2,"dummy"
"275192",0,1,0,1,"dummy"
"275205",1,3,0,4,"dummy"
"275213",4,8,5,17,"dummy"
"275214",8,5,2,15,"dummy"
"275215",0,1,2,3,"dummy"
"275216",0,0,2,2,"dummy"
"275217",0,1,0,1,"dummy"
"275218",0,0,1,1,"dummy"
"275219",0,0,1,1,"dummy"
"275220",0,0,1,1,"dummy"
"275221",0,0,1,1,"dummy"
"275222",3,5,5,13,"dummy"
"275223",0,0,1,1,"dummy"
"275224",9,1,1,11,"dummy"
"275227",0,7,3,10,"dummy"
"275240",0,1,0,1,"dummy"
"275241",0,0,0,0,"dummy"
"275242",1,0,0,1,"dummy"
"275185",0,1,0,1,"dummy"
"275196",5,0,2,7,"dummy"
"275197",0,0,1,1,"dummy"
"275200",0,1,0,1,"dummy"
"275201",0,0,1,1,"dummy"
"275202",0,0,1,1,"dummy"
"275203",0,1,0,1,"dummy"
"275209",24,5,2,31,"dummy"
"275210",4,3,0,7,"dummy"
"275211",3,4,0,7,"dummy"
"275244",0,1,0,1,"dummy"
"275245",0,2,0,2,"dummy"
"275246",0,1,0,1,"dummy"
"275247",3,3,0,6,"dummy"
"275251",0,1,0,1,"dummy"
"275252",17,0,0,17,"dummy"
"275253",1,2,0,3,"dummy"
"275254",0,1,0,1,"dummy"
"275255",0,1,0,1,"dummy"
"275258",0,2,2,4,"dummy"
"275261",0,7,3,10,"dummy"
"275263",2,2,0,4,"dummy"
"275265",0,2,0,2,"dummy"
"275267",1,0,0,1,"dummy"
"275269",2,2,3,7,"dummy"
"275270",0,0,0,0,"dummy"
"275271",0,0,0,0,"dummy"
"275272",0,0,0,0,"dummy"
"275278",3,11,1,15,"dummy"
"275279",10,8,5,23,"dummy"
"275281",0,1,0,1,"dummy"
"275282",0,1,0,1,"dummy"
"275283",4,18,1,23,"dummy"
"275284",0,1,0,1,"dummy"
"275285",0,1,0,1,"dummy"
"275286",0,1,0,1,"dummy"
"275288",0,0,1,1,"dummy"
"275291",10,5,0,15,"dummy"
"275306",4,15,1,20,"dummy"
"275307",3,0,1,4,"dummy"
"275308",1,3,0,4,"dummy"
"275322",0,2,0,2,"dummy"
"275323",0,0,0,0,"dummy"
"275324",0,0,0,0,"dummy"
"275325",0,0,0,0,"dummy"
"275326",3,1,1,5,"dummy"
"275329",0,1,0,1,"dummy"
"275331",0,0,0,0,"dummy"
"275332",0,0,0,0,"dummy"
"275335",0,0,1,1,"dummy"
"275336",0,1,0,1,"dummy"
"275338",0,0,0,0,"dummy"
"275339",1,0,0,1,"dummy"
"275340",0,0,1,1,"dummy"
"275341",2,0,0,2,"dummy"
"275342",0,0,1,1,"dummy"
"275343",0,0,1,1,"dummy"
"275344",0,2,0,2,"dummy"
"275345",0,1,0,1,"dummy"
"275346",0,0,1,1,"dummy"
"275347",0,3,0,3,"dummy"
"275349",3,3,1,7,"dummy"
"275350",59,23,5,87,"dummy"
"275363",3,2,0,5,"dummy"
"275365",2,4,0,6,"dummy"
"275366",0,1,2,3,"dummy"
"275368",0,0,1,1,"dummy"
"275370",3,1,1,5,"dummy"
"275371",1,1,0,2,"dummy"
"275372",2,1,3,6,"dummy"
"275373",3,2,1,6,"dummy"
"275374",6,3,2,11,"dummy"
"275375",2,2,0,4,"dummy"
"275376",0,1,1,2,"dummy"
"275380",1,0,2,3,"dummy"
"275381",1,0,0,1,"dummy"
"275382",0,3,0,3,"dummy"
"275392",0,2,0,2,"dummy"
"275393",0,4,0,4,"dummy"
"275394",5,0,0,5,"dummy"
"275403",0,2,0,2,"dummy"
"275404",0,2,0,2,"dummy"
"275406",0,0,1,1,"dummy"
"275407",0,2,1,3,"dummy"
"275408",7,6,3,16,"dummy"
"275409",5,3,2,10,"dummy"
"275410",0,1,0,1,"dummy"
"275411",6,10,1,17,"dummy"
"275420",0,6,0,6,"dummy"
"275421",5,0,0,5,"dummy"
"275422",0,1,0,1,"dummy"
"275423",0,2,0,2,"dummy"
"275426",2,1,0,3,"dummy"
"275445",0,0,4,4,"dummy"
"275447",1,2,0,3,"dummy"
"275454",0,1,0,1,"dummy"
"275473",0,0,2,2,"dummy"
"275474",0,0,0,0,"dummy"
"275475",0,2,0,2,"dummy"
"275476",0,2,1,3,"dummy"
"275477",0,0,0,0,"dummy"
"275478",0,0,1,1,"dummy"
"275479",7,5,2,14,"dummy"
"275480",0,0,1,1,"dummy"
"275481",0,0,1,1,"dummy"
"275482",0,0,1,1,"dummy"
"275483",0,0,1,1,"dummy"
"275484",0,0,1,1,"dummy"
"275486",0,8,0,8,"dummy"
"275487",0,2,0,2,"dummy"
"275507",0,0,1,1,"dummy"
"275508",0,0,1,1,"dummy"
"275509",0,0,1,1,"dummy"
"275511",0,1,1,2,"dummy"
"275512",3,0,0,3,"dummy"
"275513",0,0,1,1,"dummy"
"275514",0,0,1,1,"dummy"
"275516",1,1,1,3,"dummy"
"275518",0,0,2,2,"dummy"
"275520",0,2,0,2,"dummy"
"275521",2,2,0,4,"dummy"
"275522",2,2,0,4,"dummy"
"275523",5,2,4,11,"dummy"
"275524",0,0,0,0,"dummy"
"275525",0,0,1,1,"dummy"
"275526",0,2,0,2,"dummy"
"275527",5,3,1,9,"dummy"
"275529",2,0,0,2,"dummy"
"275535",0,4,1,5,"dummy"
"275536",0,1,0,1,"dummy"
"275537",0,2,0,2,"dummy"
"275538",3,13,1,17,"dummy"
"275539",0,1,0,1,"dummy"
"275540",0,1,0,1,"dummy"
"275541",0,13,0,13,"dummy"
"275542",0,1,0,1,"dummy"
"275543",1,1,0,2,"dummy"
"275544",0,6,0,6,"dummy"
"275545",0,1,0,1,"dummy"
"275548",0,0,1,1,"dummy"
"275553",10,2,2,14,"dummy"
"275554",0,1,0,1,"dummy"
"275555",1,2,0,3,"dummy"
"275556",1,2,1,4,"dummy"
"275558",18,0,1,19,"dummy"
"275562",0,1,0,1,"dummy"
"275567",0,2,0,2,"dummy"
"275570",1,0,0,1,"dummy"
"275571",7,4,6,17,"dummy"
"275575",0,0,1,1,"dummy"
"275576",3,6,0,9,"dummy"
"275577",0,0,1,1,"dummy"
"275578",0,0,1,1,"dummy"
"275579",3,2,0,5,"dummy"
"275580",0,1,0,1,"dummy"
"275581",0,0,2,2,"dummy"
"275582",5,1,1,7,"dummy"
"275583",0,0,2,2,"dummy"
"275585",0,3,2,5,"dummy"
"275586",0,0,1,1,"dummy"
"275587",0,0,1,1,"dummy"
"275588",0,0,1,1,"dummy"
"275595",0,0,0,0,"dummy"
"275597",17,1,3,21,"dummy"
"275599",0,14,0,14,"dummy"
"275600",2,2,2,6,"dummy"
"275601",0,1,0,1,"dummy"
"275602",0,0,1,1,"dummy"
"275603",0,0,1,1,"dummy"
"275604",0,1,0,1,"dummy"
"275605",3,3,1,7,"dummy"
"275606",3,0,0,3,"dummy"
"275607",0,1,1,2,"dummy"
"275611",0,3,0,3,"dummy"
"275618",0,0,1,1,"dummy"
"275619",0,0,0,0,"dummy"
"275623",2,2,1,5,"dummy"
"275624",3,0,0,3,"dummy"
"275625",0,0,1,1,"dummy"
"275626",0,1,0,1,"dummy"
"275627",0,0,2,2,"dummy"
"275628",5,1,0,6,"dummy"
"275629",1,0,0,1,"dummy"
"275630",0,0,0,0,"dummy"
"275631",0,2,0,2,"dummy"
"275632",0,1,0,1,"dummy"
"275633",1,2,1,4,"dummy"
"275634",0,1,1,2,"dummy"
"275635",0,1,0,1,"dummy"
"275639",0,1,1,2,"dummy"
"275640",1,3,1,5,"dummy"
"275641",2,6,3,11,"dummy"
"275642",2,3,1,6,"dummy"
"275643",0,1,0,1,"dummy"
"275644",6,7,2,15,"dummy"
"275649",0,0,1,1,"dummy"
"275650",0,0,1,1,"dummy"
"275651",1,0,1,2,"dummy"
"275652",0,0,1,1,"dummy"
"275653",0,0,1,1,"dummy"
"275654",0,0,1,1,"dummy"
"275655",0,0,1,1,"dummy"
"275656",0,0,1,1,"dummy"
"275657",0,0,1,1,"dummy"
"275658",0,0,1,1,"dummy"
"275659",0,0,1,1,"dummy"
"275660",0,0,1,1,"dummy"
"275661",0,0,1,1,"dummy"
"275662",0,0,1,1,"dummy"
"275663",0,0,1,1,"dummy"
"275664",0,0,1,1,"dummy"
"275665",0,0,1,1,"dummy"
"275666",0,0,1,1,"dummy"
"275667",0,0,1,1,"dummy"
"275668",0,0,1,1,"dummy"
"275669",0,0,1,1,"dummy"
"275735",0,3,0,3,"dummy"
"275736",0,6,1,7,"dummy"
"275737",0,1,2,3,"dummy"
"275738",9,14,1,24,"dummy"
"275739",0,2,0,2,"dummy"
"275740",0,3,0,3,"dummy"
"275741",3,1,1,5,"dummy"
"275744",0,0,1,1,"dummy"
"275745",1,2,0,3,"dummy"
"275746",2,6,0,8,"dummy"
"275747",0,1,0,1,"dummy"
"275748",3,0,0,3,"dummy"
"275749",0,0,1,1,"dummy"
"275757",0,1,0,1,"dummy"
"275758",0,0,5,5,"dummy"
"275761",0,8,0,8,"dummy"
"275769",3,2,4,9,"dummy"
"275770",0,1,0,1,"dummy"
"275775",0,4,2,6,"dummy"
"275795",2,4,0,6,"dummy"
"275796",0,0,1,1,"dummy"
"275797",0,0,0,0,"dummy"
"275798",0,0,0,0,"dummy"
"275799",0,0,0,0,"dummy"
"275800",0,0,0,0,"dummy"
"275803",2,0,3,5,"dummy"
"275811",1,0,1,2,"dummy"
"275812",0,2,0,2,"dummy"
"275813",1,2,0,3,"dummy"
"275814",0,1,0,1,"dummy"
"275815",0,1,1,2,"dummy"
"275816",2,3,2,7,"dummy"
"275817",0,0,1,1,"dummy"
"275831",6,0,0,6,"dummy"
"275832",2,5,2,9,"dummy"
"275845",0,2,0,2,"dummy"
"275609",0,0,1,1,"dummy"
"275613",6,9,0,15,"dummy"
"275614",2,3,1,6,"dummy"
"275615",3,2,2,7,"dummy"
"275616",0,1,0,1,"dummy"
"275621",0,0,1,1,"dummy"
"275637",0,5,2,7,"dummy"
"275646",0,0,2,2,"dummy"
"275647",1,0,1,2,"dummy"
"275671",0,0,1,1,"dummy"
"275672",0,14,0,14,"dummy"
"275673",2,0,0,2,"dummy"
"275692",0,2,0,2,"dummy"
"275693",2,2,2,6,"dummy"
"275694",0,0,1,1,"dummy"
"275695",0,0,1,1,"dummy"
"275696",1,13,0,14,"dummy"
"275697",2,2,1,5,"dummy"
"275698",0,0,1,1,"dummy"
"275699",0,3,1,4,"dummy"
"275700",0,0,1,1,"dummy"
"275701",0,1,0,1,"dummy"
"275702",0,3,0,3,"dummy"
"275703",0,1,0,1,"dummy"
"275704",0,4,0,4,"dummy"
"275705",1,1,0,2,"dummy"
"275706",1,0,0,1,"dummy"
"275707",1,0,0,1,"dummy"
"275708",1,2,0,3,"dummy"
"275709",0,0,1,1,"dummy"
"275710",0,1,0,1,"dummy"
"275711",0,2,0,2,"dummy"
"275712",0,1,0,1,"dummy"
"275713",0,2,1,3,"dummy"
"275714",2,2,0,4,"dummy"
"275715",0,0,1,1,"dummy"
"275716",0,1,0,1,"dummy"
"275717",0,0,1,1,"dummy"
"275718",1,1,0,2,"dummy"
"275719",0,5,0,5,"dummy"
"275720",0,1,1,2,"dummy"
"275721",1,2,0,3,"dummy"
"275722",1,6,1,8,"dummy"
"275723",1,0,0,1,"dummy"
"275724",0,1,0,1,"dummy"
"275725",0,1,0,1,"dummy"
"275726",0,0,1,1,"dummy"
"275727",0,0,0,0,"dummy"
"275728",0,0,0,0,"dummy"
"275729",0,1,0,1,"dummy"
"275753",0,0,0,0,"dummy"
"275754",0,4,2,6,"dummy"
"275755",1,1,0,2,"dummy"
"275765",1,0,0,1,"dummy"
"275766",0,0,0,0,"dummy"
"275767",0,0,0,0,"dummy"
"275772",0,1,0,1,"dummy"
"275773",3,11,3,17,"dummy"
"275777",0,0,0,0,"dummy"
"275778",0,0,1,1,"dummy"
"275779",3,0,0,3,"dummy"
"275780",0,1,1,2,"dummy"
"275781",0,0,1,1,"dummy"
"275782",0,1,0,1,"dummy"
"275783",0,0,0,0,"dummy"
"275784",0,0,1,1,"dummy"
"275785",0,2,0,2,"dummy"
"275786",0,0,0,0,"dummy"
"275787",0,0,0,0,"dummy"
"275788",4,2,0,6,"dummy"
"275789",2,0,0,2,"dummy"
"275790",0,0,0,0,"dummy"
"275791",0,0,0,0,"dummy"
"275792",0,0,0,0,"dummy"
"275793",2,8,0,10,"dummy"
"275805",0,0,1,1,"dummy"
"275806",0,0,1,1,"dummy"
"275807",0,1,0,1,"dummy"
"275808",0,1,0,1,"dummy"
"275809",1,0,0,1,"dummy"
"275826",0,0,0,0,"dummy"
"275827",0,0,0,0,"dummy"
"275828",1,1,2,4,"dummy"
"275829",0,0,1,1,"dummy"
"275834",0,14,0,14,"dummy"
"275835",2,2,2,6,"dummy"
"275836",0,0,1,1,"dummy"
"275837",8,13,2,23,"dummy"
"275838",0,0,1,1,"dummy"
"275841",0,0,1,1,"dummy"
"275872",0,0,0,0,"dummy"
"275877",0,1,0,1,"dummy"
"275878",1,0,0,1,"dummy"
"275884",1,0,0,1,"dummy"
"275887",0,10,0,10,"dummy"
"275894",0,0,1,1,"dummy"
"275895",2,6,1,9,"dummy"
"275896",0,3,0,3,"dummy"
"275899",0,0,0,0,"dummy"
"275900",0,0,1,1,"dummy"
"275901",0,0,0,0,"dummy"
"275902",0,0,0,0,"dummy"
"275903",0,0,0,0,"dummy"
"275904",0,0,0,0,"dummy"
"275905",0,0,0,0,"dummy"
"275906",0,0,0,0,"dummy"
"275907",0,0,0,0,"dummy"
"275908",0,0,0,0,"dummy"
"275909",0,0,0,0,"dummy"
"275910",0,0,0,0,"dummy"
"275911",0,3,3,6,"dummy"
"275912",0,0,1,1,"dummy"
"275913",0,0,0,0,"dummy"
"275914",0,0,0,0,"dummy"
"275915",0,0,0,0,"dummy"
"275916",2,0,0,2,"dummy"
"275917",0,0,0,0,"dummy"
"275918",0,0,0,0,"dummy"
"275919",2,2,1,5,"dummy"
"275920",0,0,0,0,"dummy"
"275921",0,0,0,0,"dummy"
"275922",0,0,0,0,"dummy"
"275923",0,0,1,1,"dummy"
"275924",0,0,1,1,"dummy"
"275925",0,0,1,1,"dummy"
"275926",0,0,1,1,"dummy"
"275927",0,0,1,1,"dummy"
"275928",0,0,1,1,"dummy"
"275929",0,0,1,1,"dummy"
"275930",0,0,1,1,"dummy"
"275931",0,0,1,1,"dummy"
"275932",1,2,0,3,"dummy"
"275933",0,0,1,1,"dummy"
"275934",0,0,1,1,"dummy"
"275935",0,0,1,1,"dummy"
"275936",1,3,1,5,"dummy"
"275937",0,0,0,0,"dummy"
"275938",0,0,0,0,"dummy"
"275939",0,0,1,1,"dummy"
"275940",0,0,1,1,"dummy"
"275941",0,0,1,1,"dummy"
"275942",0,0,1,1,"dummy"
"275943",0,0,0,0,"dummy"
"275944",0,0,1,1,"dummy"
"275945",0,0,1,1,"dummy"
"275946",0,0,1,1,"dummy"
"275947",0,0,0,0,"dummy"
"275948",0,0,1,1,"dummy"
"275949",0,0,0,0,"dummy"
"275950",0,0,0,0,"dummy"
"275951",0,0,0,0,"dummy"
"275952",0,0,0,0,"dummy"
"275953",0,0,1,1,"dummy"
"275957",0,1,0,1,"dummy"
"275958",16,5,1,22,"dummy"
"275959",0,0,0,0,"dummy"
"275985",0,1,0,1,"dummy"
"275986",0,2,0,2,"dummy"
"275987",0,0,0,0,"dummy"
"275988",2,0,0,2,"dummy"
"276006",2,4,0,6,"dummy"
"276007",0,2,0,2,"dummy"
"276008",0,2,0,2,"dummy"
"276009",10,2,0,12,"dummy"
"276010",0,2,0,2,"dummy"
"276021",0,1,0,1,"dummy"
"276022",0,2,0,2,"dummy"
"276023",0,3,0,3,"dummy"
"276024",2,0,0,2,"dummy"
"276031",1,0,2,3,"dummy"
"276032",0,2,0,2,"dummy"
"275846",0,0,1,1,"dummy"
"275847",1,3,0,4,"dummy"
"275850",1,0,0,1,"dummy"
"275851",0,0,1,1,"dummy"
"275852",1,1,0,2,"dummy"
"275853",0,1,0,1,"dummy"
"275854",0,1,0,1,"dummy"
"275855",6,6,0,12,"dummy"
"275856",0,0,1,1,"dummy"
"275857",6,0,0,6,"dummy"
"275862",2,4,4,10,"dummy"
"275955",0,0,2,2,"dummy"
"275961",0,1,0,1,"dummy"
"275982",0,1,1,2,"dummy"
"275983",2,0,0,2,"dummy"
"275990",0,4,0,4,"dummy"
"275991",3,4,0,7,"dummy"
"275992",1,0,2,3,"dummy"
"275993",3,4,0,7,"dummy"
"275994",1,3,1,5,"dummy"
"275995",0,1,0,1,"dummy"
"275996",0,6,1,7,"dummy"
"275997",0,4,1,5,"dummy"
"275998",2,0,0,2,"dummy"
"276003",0,0,1,1,"dummy"
"276004",0,0,3,3,"dummy"
"276026",0,1,0,1,"dummy"
"276027",0,0,1,1,"dummy"
"276028",1,0,0,1,"dummy"
"276029",22,0,3,25,"dummy"
"276038",2,0,0,2,"dummy"
"276039",0,0,2,2,"dummy"
"276040",11,5,1,17,"dummy"
"276089",11,6,1,18,"dummy"
"276090",6,11,1,18,"dummy"
"276091",0,0,1,1,"dummy"
"276092",2,0,1,3,"dummy"
"276095",0,2,0,2,"dummy"
"276096",0,0,0,0,"dummy"
"276097",4,4,1,9,"dummy"
"276098",0,1,1,2,"dummy"
"276105",0,0,1,1,"dummy"
"276109",0,1,0,1,"dummy"
"276113",0,2,0,2,"dummy"
"276125",1,0,0,1,"dummy"
"276126",0,0,1,1,"dummy"
"276127",2,0,0,2,"dummy"
"276128",0,1,0,1,"dummy"
"276129",0,0,0,0,"dummy"
"276130",0,0,1,1,"dummy"
"276131",0,0,0,0,"dummy"
"276132",0,0,0,0,"dummy"
"276163",4,2,0,6,"dummy"
"276170",0,2,1,3,"dummy"
"276173",0,0,1,1,"dummy"
"276174",2,1,0,3,"dummy"
"276185",0,4,1,5,"dummy"
"276186",0,1,1,2,"dummy"
"276187",0,1,1,2,"dummy"
"276188",0,2,0,2,"dummy"
"276044",4,1,0,5,"dummy"
"276045",0,0,1,1,"dummy"
"276046",5,6,0,11,"dummy"
"276047",0,2,0,2,"dummy"
"276048",0,0,1,1,"dummy"
"276049",0,3,0,3,"dummy"
"276050",11,2,1,14,"dummy"
"276087",0,0,0,0,"dummy"
"276100",0,0,1,1,"dummy"
"276101",0,1,0,1,"dummy"
"276107",0,0,1,1,"dummy"
"276111",1,1,0,2,"dummy"
"276122",1,0,0,1,"dummy"
"276123",0,0,1,1,"dummy"
"276134",1,0,0,1,"dummy"
"276135",0,0,1,1,"dummy"
"276136",2,0,0,2,"dummy"
"276137",0,0,1,1,"dummy"
"276138",0,1,0,1,"dummy"
"276139",0,2,0,2,"dummy"
"276140",0,2,0,2,"dummy"
"276141",2,0,0,2,"dummy"
"276142",0,2,0,2,"dummy"
"276143",4,1,0,5,"dummy"
"276144",1,0,0,1,"dummy"
"276145",0,0,0,0,"dummy"
"276146",0,0,0,0,"dummy"
"276153",5,3,3,11,"dummy"
"276154",0,0,1,1,"dummy"
"276157",0,0,0,0,"dummy"
"276158",0,1,0,1,"dummy"
"276161",0,0,1,1,"dummy"
"276165",0,1,0,1,"dummy"
"276166",0,3,0,3,"dummy"
"276167",0,0,1,1,"dummy"
"276168",0,0,3,3,"dummy"
"276176",0,0,1,1,"dummy"
"276177",0,0,1,1,"dummy"
"276180",0,0,0,0,"dummy"
"276181",0,0,0,0,"dummy"
"276182",0,0,0,0,"dummy"
"276183",0,0,0,0,"dummy"
"276191",0,2,0,2,"dummy"
"276192",0,2,0,2,"dummy"
"276194",0,0,1,1,"dummy"
"276195",0,0,4,4,"dummy"
"276196",0,0,1,1,"dummy"
"276197",0,0,1,1,"dummy"
"276198",0,0,1,1,"dummy"
"276199",0,0,1,1,"dummy"
"276200",0,0,1,1,"dummy"
"276202",0,0,0,0,"dummy"
"276203",13,13,2,28,"dummy"
"276204",0,1,0,1,"dummy"
"276205",0,0,0,0,"dummy"
"276206",0,0,0,0,"dummy"
"276207",0,0,0,0,"dummy"
"276208",2,1,4,7,"dummy"
"276209",0,0,0,0,"dummy"
"276213",0,1,0,1,"dummy"
"276214",0,0,0,0,"dummy"
"276215",1,0,0,1,"dummy"
"276219",4,3,0,7,"dummy"
"276220",0,1,0,1,"dummy"
"276221",1,0,0,1,"dummy"
"276222",0,1,0,1,"dummy"
"276223",1,0,0,1,"dummy"
"276234",0,2,0,2,"dummy"
"276235",0,6,0,6,"dummy"
"276236",0,0,1,1,"dummy"
"276252",2,5,1,8,"dummy"
"276253",0,0,1,1,"dummy"
"276254",0,2,1,3,"dummy"
"276255",0,2,0,2,"dummy"
"276256",2,2,2,6,"dummy"
"276257",0,0,1,1,"dummy"
"276258",4,4,1,9,"dummy"
"276259",0,0,1,1,"dummy"
"276260",4,0,1,5,"dummy"
"276261",0,5,1,6,"dummy"
"276262",0,3,1,4,"dummy"
"276263",0,0,1,1,"dummy"
"276264",0,1,1,2,"dummy"
"276265",0,0,1,1,"dummy"
"276284",15,0,0,15,"dummy"
"276300",2,9,2,13,"dummy"
"276303",0,0,1,1,"dummy"
"276304",0,3,0,3,"dummy"
"276305",0,0,0,0,"dummy"
"276306",1,1,0,2,"dummy"
"276307",0,0,1,1,"dummy"
"276315",0,0,1,1,"dummy"
"276316",0,0,1,1,"dummy"
"276347",3,10,2,15,"dummy"
"276348",7,2,3,12,"dummy"
"276349",0,2,0,2,"dummy"
"276350",2,0,0,2,"dummy"
"276351",0,3,0,3,"dummy"
"276352",0,4,0,4,"dummy"
"276353",1,1,0,2,"dummy"
"276354",4,5,5,14,"dummy"
"276355",0,0,2,2,"dummy"
"276356",0,0,1,1,"dummy"
"276357",0,0,1,1,"dummy"
"276358",2,2,0,4,"dummy"
"276359",1,0,0,1,"dummy"
"276360",0,0,1,1,"dummy"
"276361",0,6,0,6,"dummy"
"276362",0,2,0,2,"dummy"
"276363",2,1,0,3,"dummy"
"276370",0,2,0,2,"dummy"
"276371",3,1,0,4,"dummy"
"276375",0,0,1,1,"dummy"
"276376",3,3,3,9,"dummy"
"276377",0,0,1,1,"dummy"
"276378",0,0,1,1,"dummy"
"276379",0,0,1,1,"dummy"
"276380",0,0,1,1,"dummy"
"276388",0,4,0,4,"dummy"
"276389",2,4,0,6,"dummy"
"276390",4,2,0,6,"dummy"
"276391",0,1,0,1,"dummy"
"276397",0,1,0,1,"dummy"
"276398",0,0,1,1,"dummy"
"276399",1,11,3,15,"dummy"
"276472",0,3,0,3,"dummy"
"276480",0,1,0,1,"dummy"
"276483",7,0,2,9,"dummy"
"276484",0,4,0,4,"dummy"
"276485",0,3,0,3,"dummy"
"276486",0,5,0,5,"dummy"
"276487",1,0,0,1,"dummy"
"276488",0,1,0,1,"dummy"
"276489",2,5,1,8,"dummy"
"276490",0,3,0,3,"dummy"
"276498",0,1,0,1,"dummy"
"276499",0,1,0,1,"dummy"
"276500",0,2,1,3,"dummy"
"276501",0,0,3,3,"dummy"
"276502",1,1,0,2,"dummy"
"276239",0,1,0,1,"dummy"
"276240",0,1,0,1,"dummy"
"276241",0,0,1,1,"dummy"
"276248",0,1,0,1,"dummy"
"276267",0,0,0,0,"dummy"
"276268",0,2,0,2,"dummy"
"276269",0,0,1,1,"dummy"
"276270",0,4,0,4,"dummy"
"276271",1,6,0,7,"dummy"
"276272",0,1,0,1,"dummy"
"276273",1,0,0,1,"dummy"
"276274",0,2,0,2,"dummy"
"276280",14,7,3,24,"dummy"
"276281",0,2,4,6,"dummy"
"276282",3,7,2,12,"dummy"
"276286",6,0,0,6,"dummy"
"276311",4,6,0,10,"dummy"
"276312",0,1,0,1,"dummy"
"276313",3,1,1,5,"dummy"
"276365",0,0,1,1,"dummy"
"276366",0,1,0,1,"dummy"
"276373",7,16,2,25,"dummy"
"276382",0,0,1,1,"dummy"
"276383",0,0,1,1,"dummy"
"276386",0,0,1,1,"dummy"
"276393",0,1,0,1,"dummy"
"276394",1,0,0,1,"dummy"
"276395",1,0,2,3,"dummy"
"276468",0,0,3,3,"dummy"
"276469",0,0,3,3,"dummy"
"276470",1,0,6,7,"dummy"
"276476",0,1,0,1,"dummy"
"276477",0,0,0,0,"dummy"
"276478",2,0,0,2,"dummy"
"276494",0,1,0,1,"dummy"
"276495",3,2,2,7,"dummy"
"276496",11,9,0,20,"dummy"
"276504",3,2,0,5,"dummy"
"276505",0,1,0,1,"dummy"
"276506",1,3,2,6,"dummy"
"276512",2,5,1,8,"dummy"
"276521",0,20,0,20,"dummy"
"276547",2,5,0,7,"dummy"
"276508",0,0,1,1,"dummy"
"276516",2,4,3,9,"dummy"
"276517",1,2,0,3,"dummy"
"276518",0,0,1,1,"dummy"
"276519",0,1,0,1,"dummy"
"276527",0,0,1,1,"dummy"
"276531",2,1,0,3,"dummy"
"276549",2,2,0,4,"dummy"
"276550",0,0,2,2,"dummy"
"276551",1,1,0,2,"dummy"
"276554",9,5,2,16,"dummy"
"276555",0,2,0,2,"dummy"
"276556",0,1,0,1,"dummy"
"276558",0,1,1,2,"dummy"
"276560",7,18,2,27,"dummy"
"276562",1,2,0,3,"dummy"
"276563",0,0,1,1,"dummy"
"276570",0,1,0,1,"dummy"
"276571",0,1,0,1,"dummy"
"276576",0,0,0,0,"dummy"
"276577",0,0,1,1,"dummy"
"276578",0,1,0,1,"dummy"
"276579",0,1,0,1,"dummy"
"276585",0,1,0,1,"dummy"
"276586",1,0,0,1,"dummy"
"276587",0,1,0,1,"dummy"
"276588",0,4,0,4,"dummy"
"276589",0,3,0,3,"dummy"
"276590",0,0,0,0,"dummy"
"276591",0,1,0,1,"dummy"
"276592",1,3,0,4,"dummy"
"276593",0,4,0,4,"dummy"
"276594",1,0,1,2,"dummy"
"276595",0,0,0,0,"dummy"
"276596",0,2,0,2,"dummy"
"276597",0,0,1,1,"dummy"
"276598",0,0,2,2,"dummy"
"276599",0,0,1,1,"dummy"
"276601",2,4,0,6,"dummy"
"276602",0,2,0,2,"dummy"
"276603",0,2,0,2,"dummy"
"276604",10,2,0,12,"dummy"
"276605",0,2,0,2,"dummy"
"276618",0,0,1,1,"dummy"
"276619",0,0,1,1,"dummy"
"276620",1,0,0,1,"dummy"
"276621",0,2,0,2,"dummy"
"276622",0,1,1,2,"dummy"
"276623",1,0,0,1,"dummy"
"276624",0,1,1,2,"dummy"
"276628",0,2,0,2,"dummy"
"276640",0,2,0,2,"dummy"
"276642",1,0,0,1,"dummy"
"276643",7,6,0,13,"dummy"
"276654",0,0,0,0,"dummy"
"276655",0,0,0,0,"dummy"
"276658",0,1,1,2,"dummy"
"276659",8,9,0,17,"dummy"
"276662",1,0,0,1,"dummy"
"276663",0,2,0,2,"dummy"
"276664",0,0,1,1,"dummy"
"276665",1,0,0,1,"dummy"
"276666",1,0,0,1,"dummy"
"276667",0,2,0,2,"dummy"
"276668",2,2,1,5,"dummy"
"276670",0,1,0,1,"dummy"
"276672",0,1,0,1,"dummy"
"276675",0,0,0,0,"dummy"
"276676",0,0,0,0,"dummy"
"276677",0,0,2,2,"dummy"
"276678",0,0,0,0,"dummy"
"276679",0,2,0,2,"dummy"
"276680",1,1,0,2,"dummy"
"276681",0,2,0,2,"dummy"
"276682",0,1,0,1,"dummy"
"276683",1,0,1,2,"dummy"
"276687",0,13,0,13,"dummy"
"276688",0,0,1,1,"dummy"
"276689",0,0,0,0,"dummy"
"276690",0,0,0,0,"dummy"
"276693",7,7,1,15,"dummy"
"276700",0,0,1,1,"dummy"
"276701",0,0,0,0,"dummy"
"276702",0,0,1,1,"dummy"
"276703",0,0,0,0,"dummy"
"276719",2,1,0,3,"dummy"
"276721",26,22,3,51,"dummy"
"276723",1,0,1,2,"dummy"
"276724",0,0,1,1,"dummy"
"276726",0,0,1,1,"dummy"
"276727",0,0,0,0,"dummy"
"276730",0,1,0,1,"dummy"
"276731",1,0,1,2,"dummy"
"276741",0,0,1,1,"dummy"
"276744",0,0,5,5,"dummy"
"276749",15,6,2,23,"dummy"
"276750",0,1,0,1,"dummy"
"276751",0,2,0,2,"dummy"
"276759",2,3,2,7,"dummy"
"276767",5,4,0,9,"dummy"
"276771",0,4,0,4,"dummy"
"276772",0,0,2,2,"dummy"
"276773",2,14,1,17,"dummy"
"276774",0,0,1,1,"dummy"
"276775",0,0,1,1,"dummy"
"276776",0,2,1,3,"dummy"
"276779",0,0,1,1,"dummy"
"276782",0,0,0,0,"dummy"
"276783",1,2,0,3,"dummy"
"276787",0,0,1,1,"dummy"
"276788",0,0,0,0,"dummy"
"276789",0,0,0,0,"dummy"
"276793",0,3,0,3,"dummy"
"276794",0,2,0,2,"dummy"
"276795",0,1,0,1,"dummy"
"276796",0,2,0,2,"dummy"
"276797",0,2,0,2,"dummy"
"276798",0,0,3,3,"dummy"
"276799",3,5,0,8,"dummy"
"276800",0,1,0,1,"dummy"
"276801",0,2,0,2,"dummy"
"276802",1,0,0,1,"dummy"
"276803",0,7,1,8,"dummy"
"276806",9,7,1,17,"dummy"
"276807",6,14,2,22,"dummy"
"276815",9,13,0,22,"dummy"
"276817",0,0,1,1,"dummy"
"276824",6,1,0,7,"dummy"
"276825",0,1,0,1,"dummy"
"276826",1,0,0,1,"dummy"
"276827",0,1,0,1,"dummy"
"276828",2,1,0,3,"dummy"
"276829",1,2,0,3,"dummy"
"276830",4,1,7,12,"dummy"
"276832",1,12,0,13,"dummy"
"276833",0,1,0,1,"dummy"
"276836",0,1,0,1,"dummy"
"276837",0,0,1,1,"dummy"
"276838",3,4,2,9,"dummy"
"276839",1,0,0,1,"dummy"
"276841",1,0,0,1,"dummy"
"276842",0,0,1,1,"dummy"
"276845",2,1,1,4,"dummy"
"276846",1,0,0,1,"dummy"
"276862",1,9,2,12,"dummy"
"276863",0,1,0,1,"dummy"
"276864",2,3,1,6,"dummy"
"276865",2,0,2,4,"dummy"
"276866",0,0,2,2,"dummy"
"276867",1,1,4,6,"dummy"
"276868",0,1,0,1,"dummy"
"276869",0,0,2,2,"dummy"
"276870",0,0,2,2,"dummy"
"276871",3,0,0,3,"dummy"
"276872",0,0,2,2,"dummy"
"276873",0,0,2,2,"dummy"
"276874",0,0,2,2,"dummy"
"276875",0,0,2,2,"dummy"
"276876",0,0,2,2,"dummy"
"276877",0,0,3,3,"dummy"
"276878",0,0,3,3,"dummy"
"276881",0,2,0,2,"dummy"
"276882",0,20,0,20,"dummy"
"276883",6,15,4,25,"dummy"
"276884",0,9,1,10,"dummy"
"276885",0,0,1,1,"dummy"
"276886",0,0,1,1,"dummy"
"276887",1,3,3,7,"dummy"
"276890",0,1,0,1,"dummy"
"276899",51,0,3,54,"dummy"
"276902",0,0,1,1,"dummy"
"276903",0,2,0,2,"dummy"
"276904",3,2,0,5,"dummy"
"276905",0,0,1,1,"dummy"
"276906",1,2,0,3,"dummy"
"276907",0,0,2,2,"dummy"
"276908",0,0,0,0,"dummy"
"276909",0,0,1,1,"dummy"
"276910",0,0,1,1,"dummy"
"276911",2,15,1,18,"dummy"
"276912",0,2,0,2,"dummy"
"276913",2,7,4,13,"dummy"
"276924",0,0,1,1,"dummy"
"276935",0,0,2,2,"dummy"
"276946",2,0,0,2,"dummy"
"276947",0,1,1,2,"dummy"
"276950",6,5,1,12,"dummy"
"276951",0,2,2,4,"dummy"
"276952",0,0,1,1,"dummy"
"276953",0,0,0,0,"dummy"
"276985",0,0,0,0,"dummy"
"276986",0,1,0,1,"dummy"
"276987",8,1,0,9,"dummy"
"276988",0,0,0,0,"dummy"
"276989",0,0,0,0,"dummy"
"276990",1,10,0,11,"dummy"
"276991",7,1,0,8,"dummy"
"276992",2,0,3,5,"dummy"
"276997",0,0,0,0,"dummy"
"276998",0,0,0,0,"dummy"
"277001",2,0,1,3,"dummy"
"277002",0,0,2,2,"dummy"
"277005",1,1,0,2,"dummy"
"277006",0,1,0,1,"dummy"
"277013",1,0,0,1,"dummy"
"277014",0,0,1,1,"dummy"
"277015",0,0,1,1,"dummy"
"277016",0,0,0,0,"dummy"
"277017",0,0,0,0,"dummy"
"277018",2,2,1,5,"dummy"
"277019",0,0,1,1,"dummy"
"277020",0,0,0,0,"dummy"
"277026",4,6,1,11,"dummy"
"277027",1,1,0,2,"dummy"
"277028",0,1,0,1,"dummy"
"277029",4,4,0,8,"dummy"
"277030",1,6,0,7,"dummy"
"277031",4,1,0,5,"dummy"
"277032",0,16,0,16,"dummy"
"277061",0,0,2,2,"dummy"
"277062",0,0,1,1,"dummy"
"277074",0,3,0,3,"dummy"
"277075",6,3,1,10,"dummy"
"277076",3,1,0,4,"dummy"
"277077",0,0,0,0,"dummy"
"277078",0,0,0,0,"dummy"
"277079",0,1,0,1,"dummy"
"277080",0,1,0,1,"dummy"
"277081",1,0,0,1,"dummy"
"277082",0,1,0,1,"dummy"
"277083",0,0,0,0,"dummy"
"277084",0,0,0,0,"dummy"
"277085",0,0,0,0,"dummy"
"277117",0,0,1,1,"dummy"
"277118",0,0,3,3,"dummy"
"277119",0,0,3,3,"dummy"
"277120",0,0,4,4,"dummy"
"277121",2,3,1,6,"dummy"
"277152",0,0,0,0,"dummy"
"277153",0,0,0,0,"dummy"
"277157",1,2,0,3,"dummy"
"277158",1,1,0,2,"dummy"
"277159",0,2,0,2,"dummy"
"277160",3,0,1,4,"dummy"
"277161",0,0,1,1,"dummy"
"277162",3,1,1,5,"dummy"
"277163",0,0,1,1,"dummy"
"277164",0,2,0,2,"dummy"
"277165",0,0,1,1,"dummy"
"277168",0,1,0,1,"dummy"
"277169",0,0,0,0,"dummy"
"277170",0,0,0,0,"dummy"
"277171",1,0,0,1,"dummy"
"277172",0,0,1,1,"dummy"
"277173",0,0,3,3,"dummy"
"277174",0,0,1,1,"dummy"
"276915",0,2,0,2,"dummy"
"276916",0,0,2,2,"dummy"
"276917",0,1,0,1,"dummy"
"276918",0,2,0,2,"dummy"
"276919",2,2,0,4,"dummy"
"276920",0,2,0,2,"dummy"
"276921",0,0,0,0,"dummy"
"276922",0,1,0,1,"dummy"
"276926",1,1,0,2,"dummy"
"276927",0,3,1,4,"dummy"
"276928",0,0,0,0,"dummy"
"276929",0,0,1,1,"dummy"
"276930",0,1,0,1,"dummy"
"276931",0,1,1,2,"dummy"
"276932",0,16,0,16,"dummy"
"276933",16,1,0,17,"dummy"
"276937",2,0,0,2,"dummy"
"276938",2,0,0,2,"dummy"
"276939",0,0,0,0,"dummy"
"276940",0,0,1,1,"dummy"
"276941",0,0,1,1,"dummy"
"276942",1,0,0,1,"dummy"
"276963",0,2,0,2,"dummy"
"276964",2,3,0,5,"dummy"
"276965",1,3,2,6,"dummy"
"276968",0,1,0,1,"dummy"
"276973",0,0,0,0,"dummy"
"276974",0,0,0,0,"dummy"
"277008",0,0,1,1,"dummy"
"277011",0,0,0,0,"dummy"
"277022",9,8,1,18,"dummy"
"277034",8,0,0,8,"dummy"
"277037",0,2,0,2,"dummy"
"277038",2,5,5,12,"dummy"
"277039",0,0,1,1,"dummy"
"277040",1,6,2,9,"dummy"
"277041",6,0,4,10,"dummy"
"277042",0,1,1,2,"dummy"
"277043",0,0,2,2,"dummy"
"277044",0,0,1,1,"dummy"
"277045",3,2,0,5,"dummy"
"277046",27,59,3,89,"dummy"
"277047",59,27,3,89,"dummy"
"277048",1,4,3,8,"dummy"
"277049",3,3,0,6,"dummy"
"277050",2,1,0,3,"dummy"
"277051",4,13,0,17,"dummy"
"277052",37,59,3,99,"dummy"
"277053",21,1,1,23,"dummy"
"277054",0,5,0,5,"dummy"
"277055",3,15,1,19,"dummy"
"277056",1,13,0,14,"dummy"
"277059",3,3,0,6,"dummy"
"277068",0,2,0,2,"dummy"
"277069",0,4,0,4,"dummy"
"277070",1,5,0,6,"dummy"
"277071",0,5,0,5,"dummy"
"277072",0,0,1,1,"dummy"
"277087",8,2,0,10,"dummy"
"277088",0,0,1,1,"dummy"
"277091",0,11,0,11,"dummy"
"277092",2,7,7,16,"dummy"
"277093",2,2,0,4,"dummy"
"277094",0,0,0,0,"dummy"
"277095",0,0,1,1,"dummy"
"277096",0,1,0,1,"dummy"
"277097",16,6,3,25,"dummy"
"277098",0,2,1,3,"dummy"
"277099",0,0,2,2,"dummy"
"277100",7,13,5,25,"dummy"
"277101",8,32,10,50,"dummy"
"277102",0,0,0,0,"dummy"
"277103",2,4,0,6,"dummy"
"277104",7,3,1,11,"dummy"
"277105",5,5,1,11,"dummy"
"277106",0,7,0,7,"dummy"
"277107",43,28,4,75,"dummy"
"277108",1,2,3,6,"dummy"
"277109",1,0,0,1,"dummy"
"277110",1,1,1,3,"dummy"
"277111",0,0,1,1,"dummy"
"277112",1,0,0,1,"dummy"
"277113",2,12,2,16,"dummy"
"277114",13,4,2,19,"dummy"
"277115",0,2,0,2,"dummy"
"277155",0,0,0,0,"dummy"
"277177",2,2,2,6,"dummy"
"277178",1,0,0,1,"dummy"
"277179",0,0,0,0,"dummy"
"277180",0,0,0,0,"dummy"
"277183",2,0,0,2,"dummy"
"277184",1,1,0,2,"dummy"
"277190",17,1,1,19,"dummy"
"277191",0,1,1,2,"dummy"
"277194",0,1,0,1,"dummy"
"277195",1,0,0,1,"dummy"
"277214",0,1,0,1,"dummy"
"277215",1,0,0,1,"dummy"
"277216",0,3,0,3,"dummy"
"277217",0,2,0,2,"dummy"
"277218",3,1,0,4,"dummy"
"277219",0,1,0,1,"dummy"
"277220",0,2,0,2,"dummy"
"277221",6,2,0,8,"dummy"
"277222",0,2,0,2,"dummy"
"277223",0,0,2,2,"dummy"
"277224",0,0,2,2,"dummy"
"277227",0,6,1,7,"dummy"
"277228",2,0,1,3,"dummy"
"277236",0,6,0,6,"dummy"
"277291",3,0,1,4,"dummy"
"277294",0,0,0,0,"dummy"
"277295",0,1,0,1,"dummy"
"277296",0,0,1,1,"dummy"
"277297",0,1,0,1,"dummy"
"277301",1,2,0,3,"dummy"
"277302",0,0,1,1,"dummy"
"277303",0,0,0,0,"dummy"
"277304",0,0,0,0,"dummy"
"277305",0,3,0,3,"dummy"
"277311",0,1,0,1,"dummy"
"277314",0,1,1,2,"dummy"
"277317",0,0,0,0,"dummy"
"277322",1,0,0,1,"dummy"
"277323",0,10,0,10,"dummy"
"277324",0,0,0,0,"dummy"
"277353",0,5,0,5,"dummy"
"277387",3,1,0,4,"dummy"
"277403",25,7,9,41,"dummy"
"277430",2,2,0,4,"dummy"
"277431",0,0,1,1,"dummy"
"277432",3,0,0,3,"dummy"
"277442",2,5,1,8,"dummy"
"277457",0,0,0,0,"dummy"
"277460",2,4,0,6,"dummy"
"277461",0,2,0,2,"dummy"
"277462",0,2,0,2,"dummy"
"277463",10,2,0,12,"dummy"
"277464",0,2,0,2,"dummy"
"277470",0,0,1,1,"dummy"
"277515",0,1,1,2,"dummy"
"277519",2,12,1,15,"dummy"
"277175",0,0,1,1,"dummy"
"277186",3,4,1,8,"dummy"
"277187",5,12,3,20,"dummy"
"277188",0,1,0,1,"dummy"
"277199",0,0,1,1,"dummy"
"277200",0,0,1,1,"dummy"
"277201",0,0,1,1,"dummy"
"277202",1,1,1,3,"dummy"
"277203",3,2,0,5,"dummy"
"277204",0,1,0,1,"dummy"
"277205",2,4,2,8,"dummy"
"277206",2,4,1,7,"dummy"
"277207",0,1,0,1,"dummy"
"277212",2,8,0,10,"dummy"
"277230",0,2,0,2,"dummy"
"277231",0,1,0,1,"dummy"
"277240",0,2,0,2,"dummy"
"277241",0,3,0,3,"dummy"
"277242",0,3,0,3,"dummy"
"277243",2,4,0,6,"dummy"
"277244",0,5,0,5,"dummy"
"277245",0,3,0,3,"dummy"
"277246",0,0,1,1,"dummy"
"277247",0,0,1,1,"dummy"
"277248",0,0,2,2,"dummy"
"277249",0,1,2,3,"dummy"
"277250",0,0,1,1,"dummy"
"277251",0,0,1,1,"dummy"
"277252",6,6,0,12,"dummy"
"277253",0,0,1,1,"dummy"
"277254",3,1,1,5,"dummy"
"277255",0,1,0,1,"dummy"
"277256",0,6,0,6,"dummy"
"277257",7,1,0,8,"dummy"
"277258",0,7,0,7,"dummy"
"277259",1,0,4,5,"dummy"
"277260",2,2,0,4,"dummy"
"277261",0,0,0,0,"dummy"
"277262",2,3,0,5,"dummy"
"277263",1,0,1,2,"dummy"
"277264",0,1,1,2,"dummy"
"277265",0,4,0,4,"dummy"
"277266",0,2,1,3,"dummy"
"277267",4,6,1,11,"dummy"
"277268",4,2,1,7,"dummy"
"277269",1,2,0,3,"dummy"
"277270",0,1,1,2,"dummy"
"277271",0,0,0,0,"dummy"
"277272",2,0,1,3,"dummy"
"277273",0,0,2,2,"dummy"
"277274",14,8,3,25,"dummy"
"277275",0,0,0,0,"dummy"
"277276",0,0,0,0,"dummy"
"277277",0,0,0,0,"dummy"
"277278",0,0,0,0,"dummy"
"277279",0,12,0,12,"dummy"
"277280",0,0,0,0,"dummy"
"277281",12,5,5,22,"dummy"
"277282",0,1,2,3,"dummy"
"277283",1,15,0,16,"dummy"
"277284",26,2,3,31,"dummy"
"277285",0,2,0,2,"dummy"
"277286",0,0,2,2,"dummy"
"277287",0,0,0,0,"dummy"
"277288",0,0,0,0,"dummy"
"277289",0,0,0,0,"dummy"
"277309",5,0,0,5,"dummy"
"277319",0,1,0,1,"dummy"
"277320",12,1,1,14,"dummy"
"277326",0,1,0,1,"dummy"
"277329",10,8,2,20,"dummy"
"277330",0,3,0,3,"dummy"
"277331",3,0,0,3,"dummy"
"277332",0,2,0,2,"dummy"
"277335",2,1,0,3,"dummy"
"277336",1,1,0,2,"dummy"
"277337",0,0,2,2,"dummy"
"277338",0,2,2,4,"dummy"
"277341",0,3,1,4,"dummy"
"277342",0,13,0,13,"dummy"
"277343",5,1,1,7,"dummy"
"277344",17,8,0,25,"dummy"
"277345",1,7,0,8,"dummy"
"277346",3,6,0,9,"dummy"
"277347",0,4,1,5,"dummy"
"277355",0,5,0,5,"dummy"
"277356",0,2,0,2,"dummy"
"277357",3,3,1,7,"dummy"
"277358",6,1,0,7,"dummy"
"277359",1,6,0,7,"dummy"
"277360",2,3,1,6,"dummy"
"277361",0,0,1,1,"dummy"
"277362",2,2,2,6,"dummy"
"277363",5,3,0,8,"dummy"
"277364",0,2,0,2,"dummy"
"277365",3,3,1,7,"dummy"
"277366",4,4,1,9,"dummy"
"277367",3,9,4,16,"dummy"
"277368",0,1,0,1,"dummy"
"277369",1,10,1,12,"dummy"
"277370",8,2,0,10,"dummy"
"277371",1,1,0,2,"dummy"
"277372",0,0,1,1,"dummy"
"277373",2,8,1,11,"dummy"
"277374",7,2,1,10,"dummy"
"277375",0,0,1,1,"dummy"
"277376",0,0,1,1,"dummy"
"277377",0,0,1,1,"dummy"
"277378",10,0,1,11,"dummy"
"277379",0,10,1,11,"dummy"
"277380",0,0,1,1,"dummy"
"277381",0,2,0,2,"dummy"
"277382",13,0,0,13,"dummy"
"277383",0,1,0,1,"dummy"
"277384",0,1,0,1,"dummy"
"277385",0,3,0,3,"dummy"
"277434",1,13,0,14,"dummy"
"277435",1,0,0,1,"dummy"
"277440",0,0,3,3,"dummy"
"277444",0,1,0,1,"dummy"
"277445",0,0,0,0,"dummy"
"277448",0,0,1,1,"dummy"
"277449",0,0,1,1,"dummy"
"277450",0,0,1,1,"dummy"
"277451",0,1,1,2,"dummy"
"277452",2,0,0,2,"dummy"
"277453",0,3,0,3,"dummy"
"277454",0,2,0,2,"dummy"
"277455",5,0,0,5,"dummy"
"277466",0,5,1,6,"dummy"
"277474",3,4,0,7,"dummy"
"277475",1,3,3,7,"dummy"
"277476",0,1,0,1,"dummy"
"277477",0,0,1,1,"dummy"
"277478",0,0,1,1,"dummy"
"277481",1,2,0,3,"dummy"
"277482",0,0,3,3,"dummy"
"277483",0,4,0,4,"dummy"
"277484",5,1,0,6,"dummy"
"277485",0,3,0,3,"dummy"
"277486",4,3,4,11,"dummy"
"277487",0,3,0,3,"dummy"
"277490",0,2,0,2,"dummy"
"277491",1,1,0,2,"dummy"
"277492",1,2,0,3,"dummy"
"277493",1,0,0,1,"dummy"
"277496",2,0,3,5,"dummy"
"277505",1,6,2,9,"dummy"
"277506",4,2,1,7,"dummy"
"277511",26,8,3,37,"dummy"
"277512",4,16,3,23,"dummy"
"277513",0,0,0,0,"dummy"
"277517",0,0,3,3,"dummy"
"277523",0,0,1,1,"dummy"
"277524",0,2,0,2,"dummy"
"277525",1,0,2,3,"dummy"
"277526",0,0,1,1,"dummy"
"277527",0,0,1,1,"dummy"
"277534",0,2,0,2,"dummy"
"277535",0,0,1,1,"dummy"
"277536",0,0,1,1,"dummy"
"277537",0,1,0,1,"dummy"
"277547",0,0,0,0,"dummy"
"277548",0,0,0,0,"dummy"
"277520",11,10,2,23,"dummy"
"277521",0,0,4,4,"dummy"
"277539",0,0,0,0,"dummy"
"277540",8,24,5,37,"dummy"
"277541",4,0,0,4,"dummy"
"277542",0,4,0,4,"dummy"
"277543",4,0,0,4,"dummy"
"277544",0,4,0,4,"dummy"
"277545",2,1,0,3,"dummy"
"277552",1,2,0,3,"dummy"
"277553",1,0,0,1,"dummy"
"277554",0,0,1,1,"dummy"
"277555",1,3,4,8,"dummy"
"277566",0,0,4,4,"dummy"
"277567",1,12,0,13,"dummy"
"277568",0,2,0,2,"dummy"
"277569",0,1,0,1,"dummy"
"277570",1,1,0,2,"dummy"
"277571",4,7,4,15,"dummy"
"277572",2,0,0,2,"dummy"
"277573",0,0,0,0,"dummy"
"277574",0,0,0,0,"dummy"
"277577",3,5,2,10,"dummy"
"277578",5,2,0,7,"dummy"
"277585",0,0,0,0,"dummy"
"277586",0,9,0,9,"dummy"
"277587",0,1,0,1,"dummy"
"277588",0,0,0,0,"dummy"
"277594",0,0,1,1,"dummy"
"277606",3,6,3,12,"dummy"
"277607",3,3,0,6,"dummy"
"277608",0,2,0,2,"dummy"
"277609",3,7,1,11,"dummy"
"277610",1,0,0,1,"dummy"
"277611",0,2,0,2,"dummy"
"277612",2,0,0,2,"dummy"
"277613",0,2,0,2,"dummy"
"277614",2,0,0,2,"dummy"
"277615",0,0,3,3,"dummy"
"277616",0,0,3,3,"dummy"
"277624",2,3,0,5,"dummy"
"277625",5,7,0,12,"dummy"
"277660",0,1,0,1,"dummy"
"277661",0,1,0,1,"dummy"
"277662",2,0,0,2,"dummy"
"277663",1,1,0,2,"dummy"
"277664",0,1,2,3,"dummy"
"277665",1,0,0,1,"dummy"
"277672",1,0,0,1,"dummy"
"277549",0,0,0,0,"dummy"
"277550",0,11,0,11,"dummy"
"277563",0,1,0,1,"dummy"
"277564",0,0,1,1,"dummy"
"277580",3,10,0,13,"dummy"
"277581",0,12,0,12,"dummy"
"277592",5,1,3,9,"dummy"
"277604",4,0,2,6,"dummy"
"277618",0,1,0,1,"dummy"
"277619",4,2,4,10,"dummy"
"277622",0,0,1,1,"dummy"
"277627",3,1,1,5,"dummy"
"277628",0,0,0,0,"dummy"
"277629",7,5,1,13,"dummy"
"277630",2,1,1,4,"dummy"
"277631",0,1,0,1,"dummy"
"277632",0,0,1,1,"dummy"
"277633",0,0,0,0,"dummy"
"277634",0,2,0,2,"dummy"
"277635",0,0,0,0,"dummy"
"277636",6,1,0,7,"dummy"
"277637",1,13,1,15,"dummy"
"277638",0,0,1,1,"dummy"
"277639",0,0,0,0,"dummy"
"277640",0,5,0,5,"dummy"
"277641",5,0,0,5,"dummy"
"277642",0,5,0,5,"dummy"
"277643",0,13,0,13,"dummy"
"277644",13,0,1,14,"dummy"
"277645",0,0,1,1,"dummy"
"277646",0,2,0,2,"dummy"
"277647",1,0,1,2,"dummy"
"277648",0,0,1,1,"dummy"
"277649",0,0,2,2,"dummy"
"277650",2,7,2,11,"dummy"
"277651",2,8,0,10,"dummy"
"277652",0,0,2,2,"dummy"
"277653",6,3,0,9,"dummy"
"277654",0,2,0,2,"dummy"
"277655",0,0,1,1,"dummy"
"277656",5,0,1,6,"dummy"
"277657",0,0,2,2,"dummy"
"277658",0,2,0,2,"dummy"
"277669",0,1,0,1,"dummy"
"277670",0,0,1,1,"dummy"
"277674",0,0,1,1,"dummy"
"277675",0,0,0,0,"dummy"
"277678",0,2,0,2,"dummy"
"277679",0,3,0,3,"dummy"
"277680",3,1,0,4,"dummy"
"277681",0,0,1,1,"dummy"
"277682",2,1,2,5,"dummy"
"277683",1,4,1,6,"dummy"
"277685",1,0,0,1,"dummy"
"277710",0,2,0,2,"dummy"
"277689",0,2,2,4,"dummy"
"277691",3,10,1,14,"dummy"
"277692",0,2,0,2,"dummy"
"277693",0,1,0,1,"dummy"
"277694",0,1,0,1,"dummy"
"277697",3,3,2,8,"dummy"
"277698",3,1,0,4,"dummy"
"277700",3,5,3,11,"dummy"
"277701",0,2,1,3,"dummy"
"277702",0,0,5,5,"dummy"
"277704",0,1,0,1,"dummy"
"277705",0,4,0,4,"dummy"
"277706",4,2,0,6,"dummy"
"277707",0,1,0,1,"dummy"
"277708",2,0,0,2,"dummy"
"277711",2,2,1,5,"dummy"
"277712",0,0,4,4,"dummy"
"277720",0,0,1,1,"dummy"
"277722",1,1,0,2,"dummy"
"277723",0,1,0,1,"dummy"
"277725",0,1,0,1,"dummy"
"277726",0,3,0,3,"dummy"
"277727",0,0,1,1,"dummy"
"277728",0,2,2,4,"dummy"
"277729",0,0,1,1,"dummy"
"277730",0,1,0,1,"dummy"
"277731",2,1,2,5,"dummy"
"277733",0,0,3,3,"dummy"
"277736",3,0,0,3,"dummy"
"277738",2,1,1,4,"dummy"
"277740",0,1,0,1,"dummy"
"277741",0,0,1,1,"dummy"
"277742",0,1,0,1,"dummy"
"277743",0,3,0,3,"dummy"
"277744",3,0,0,3,"dummy"
"277745",0,1,0,1,"dummy"
"277746",0,0,0,0,"dummy"
"277747",2,0,1,3,"dummy"
"277748",4,0,0,4,"dummy"
"277750",0,0,2,2,"dummy"
"277752",0,0,0,0,"dummy"
"277753",0,0,0,0,"dummy"
"277754",0,0,0,0,"dummy"
"277755",2,6,1,9,"dummy"
"277756",4,4,0,8,"dummy"
"277757",0,0,1,1,"dummy"
"277758",0,0,0,0,"dummy"
"277759",1,1,1,3,"dummy"
"277765",0,0,1,1,"dummy"
"277768",0,3,3,6,"dummy"
"277769",3,3,0,6,"dummy"
"277770",3,0,3,6,"dummy"
"277774",0,0,0,0,"dummy"
"277775",0,0,0,0,"dummy"
"277778",0,0,0,0,"dummy"
"277779",6,6,1,13,"dummy"
"277781",0,1,0,1,"dummy"
"277787",0,1,0,1,"dummy"
"277788",0,0,1,1,"dummy"
"277789",0,1,0,1,"dummy"
"277790",0,4,0,4,"dummy"
"277793",0,0,1,1,"dummy"
"277796",0,1,0,1,"dummy"
"277798",0,0,1,1,"dummy"
"277799",0,1,0,1,"dummy"
"277800",0,0,1,1,"dummy"
"277801",0,2,0,2,"dummy"
"277803",0,1,0,1,"dummy"
"277804",0,4,0,4,"dummy"
"277805",0,1,0,1,"dummy"
"277807",0,0,0,0,"dummy"
"277808",1,0,0,1,"dummy"
"277809",13,1,0,14,"dummy"
"277810",0,0,1,1,"dummy"
"277811",2,0,0,2,"dummy"
"277812",0,1,0,1,"dummy"
"277813",0,0,0,0,"dummy"
"277814",0,0,1,1,"dummy"
"277815",0,2,0,2,"dummy"
"277817",4,2,0,6,"dummy"
"277818",1,3,2,6,"dummy"
"277822",1,2,1,4,"dummy"
"277823",0,0,0,0,"dummy"
"277824",0,0,0,0,"dummy"
"277825",0,2,0,2,"dummy"
"277827",0,3,0,3,"dummy"
"277828",0,0,4,4,"dummy"
"277830",0,1,0,1,"dummy"
"277831",0,0,0,0,"dummy"
"277834",0,1,0,1,"dummy"
"277840",0,1,0,1,"dummy"
"277841",0,1,0,1,"dummy"
"277843",5,7,4,16,"dummy"
"277844",0,0,1,1,"dummy"
"277845",0,0,1,1,"dummy"
"277851",0,0,1,1,"dummy"
"277852",0,1,1,2,"dummy"
"277853",0,0,1,1,"dummy"
"277855",2,2,4,8,"dummy"
"277856",1,1,1,3,"dummy"
"277865",1,0,0,1,"dummy"
"277866",1,2,0,3,"dummy"
"277867",2,4,0,6,"dummy"
"277868",0,7,0,7,"dummy"
"277874",0,52,0,52,"dummy"
"277875",14,10,2,26,"dummy"
"277876",0,1,0,1,"dummy"
"277879",0,1,0,1,"dummy"
"277880",0,1,0,1,"dummy"
"277881",0,9,0,9,"dummy"
"277882",0,0,1,1,"dummy"
"277884",1,0,1,2,"dummy"
"277887",1,0,0,1,"dummy"
"277891",0,2,0,2,"dummy"
"277894",0,0,0,0,"dummy"
"277897",0,0,1,1,"dummy"
"277898",0,0,1,1,"dummy"
"277899",0,0,1,1,"dummy"
"277900",0,0,1,1,"dummy"
"277901",0,0,1,1,"dummy"
"277903",1,2,7,10,"dummy"
"277904",0,0,1,1,"dummy"
"277905",0,8,0,8,"dummy"
"277906",0,0,1,1,"dummy"
"277907",0,0,3,3,"dummy"
"277909",0,1,0,1,"dummy"
"277911",0,1,2,3,"dummy"
"277912",0,1,8,9,"dummy"
"277919",8,7,5,20,"dummy"
"277920",0,0,1,1,"dummy"
"277922",0,0,0,0,"dummy"
"277923",0,0,1,1,"dummy"
"277924",3,0,0,3,"dummy"
"277925",0,0,1,1,"dummy"
"277926",0,1,0,1,"dummy"
"277927",0,2,0,2,"dummy"
"277928",0,0,0,0,"dummy"
"277929",0,0,0,0,"dummy"
"277930",4,1,0,5,"dummy"
"277931",1,0,0,1,"dummy"
"277932",0,0,0,0,"dummy"
"277933",0,0,0,0,"dummy"
"277940",8,17,0,25,"dummy"
"277941",0,0,1,1,"dummy"
"277942",0,0,1,1,"dummy"
"277943",1,9,0,10,"dummy"
"277944",3,2,0,5,"dummy"
"277945",0,0,1,1,"dummy"
"277946",0,0,1,1,"dummy"
"277947",0,0,1,1,"dummy"
"277948",0,0,1,1,"dummy"
"277949",0,0,0,0,"dummy"
"277950",0,0,1,1,"dummy"
"277951",0,0,1,1,"dummy"
"277952",0,0,2,2,"dummy"
"277953",0,0,1,1,"dummy"
"277954",0,0,1,1,"dummy"
"277955",0,0,1,1,"dummy"
"277956",0,0,1,1,"dummy"
"277957",0,0,1,1,"dummy"
"277958",5,6,0,11,"dummy"
"277959",0,0,1,1,"dummy"
"277960",0,0,1,1,"dummy"
"277961",0,1,1,2,"dummy"
"277962",0,0,1,1,"dummy"
"277963",0,0,1,1,"dummy"
"277964",3,0,0,3,"dummy"
"277965",0,0,1,1,"dummy"
"277966",0,0,1,1,"dummy"
"277967",0,0,1,1,"dummy"
"277968",0,0,1,1,"dummy"
"277969",0,0,1,1,"dummy"
"277970",0,0,1,1,"dummy"
"277971",3,0,0,3,"dummy"
"277972",0,5,0,5,"dummy"
"277973",0,0,1,1,"dummy"
"277976",4,7,5,16,"dummy"
"277984",0,0,0,0,"dummy"
"277985",0,0,0,0,"dummy"
"277986",0,1,0,1,"dummy"
"277994",0,1,0,1,"dummy"
"278011",0,1,0,1,"dummy"
"278012",0,1,0,1,"dummy"
"278013",1,9,0,10,"dummy"
"278014",0,2,0,2,"dummy"
"278015",6,2,0,8,"dummy"
"278016",0,4,1,5,"dummy"
"278017",1,1,3,5,"dummy"
"278025",3,3,0,6,"dummy"
"278026",0,2,0,2,"dummy"
"278027",5,0,0,5,"dummy"
"278029",0,0,3,3,"dummy"
"278030",2,2,2,6,"dummy"
"278032",0,1,0,1,"dummy"
"278046",0,0,1,1,"dummy"
"278096",0,0,1,1,"dummy"
"278097",2,0,3,5,"dummy"
"278098",0,0,1,1,"dummy"
"278100",0,0,1,1,"dummy"
"278101",3,1,2,6,"dummy"
"278102",0,5,2,7,"dummy"
"278116",1,1,0,2,"dummy"
"278117",0,0,1,1,"dummy"
"278120",0,2,0,2,"dummy"
"278126",0,1,0,1,"dummy"
"278127",3,0,0,3,"dummy"
"278128",32,28,0,60,"dummy"
"278129",6,6,0,12,"dummy"
"278130",9,9,0,18,"dummy"
"278131",8,12,0,20,"dummy"
"278132",0,2,1,3,"dummy"
"278133",0,3,0,3,"dummy"
"278134",3,0,0,3,"dummy"
"278135",0,0,0,0,"dummy"
"278143",0,3,0,3,"dummy"
"278144",0,0,1,1,"dummy"
"278145",3,3,0,6,"dummy"
"278146",12,6,0,18,"dummy"
"278148",0,5,0,5,"dummy"
"278151",0,0,4,4,"dummy"
"278152",0,2,0,2,"dummy"
"278153",0,0,1,1,"dummy"
"278157",0,0,0,0,"dummy"
"278159",0,0,0,0,"dummy"
"278160",0,0,3,3,"dummy"
"278162",7,19,2,28,"dummy"
"278166",0,0,3,3,"dummy"
"278167",0,0,1,1,"dummy"
"278168",0,4,1,5,"dummy"
"278169",0,1,1,2,"dummy"
"278170",7,0,0,7,"dummy"
"278171",0,7,3,10,"dummy"
"278172",4,0,3,7,"dummy"
"278173",0,0,0,0,"dummy"
"278174",0,3,0,3,"dummy"
"278175",1,0,0,1,"dummy"
"278176",3,0,0,3,"dummy"
"278177",0,0,1,1,"dummy"
"278178",0,3,0,3,"dummy"
"278179",0,0,1,1,"dummy"
"278180",0,0,3,3,"dummy"
"278181",0,1,0,1,"dummy"
"278184",0,1,0,1,"dummy"
"278186",0,0,0,0,"dummy"
"278187",0,0,0,0,"dummy"
"278189",2,6,0,8,"dummy"
"278190",0,2,1,3,"dummy"
"278192",1,2,1,4,"dummy"
"278193",1,0,2,3,"dummy"
"278194",0,0,2,2,"dummy"
"278195",1,0,1,2,"dummy"
"278196",0,0,1,1,"dummy"
"278197",0,1,0,1,"dummy"
"278199",0,13,1,14,"dummy"
"278200",0,0,1,1,"dummy"
"278201",1,0,2,3,"dummy"
"278202",2,2,0,4,"dummy"
"278203",5,0,0,5,"dummy"
"278212",0,0,0,0,"dummy"
"278213",0,1,0,1,"dummy"
"278215",0,0,1,1,"dummy"
"278216",1,1,0,2,"dummy"
"278219",0,1,0,1,"dummy"
"278220",0,0,1,1,"dummy"
"278224",0,2,0,2,"dummy"
"278225",0,11,0,11,"dummy"
"278227",1,1,0,2,"dummy"
"278228",0,1,1,2,"dummy"
"278230",0,1,0,1,"dummy"
"278232",1,2,0,3,"dummy"
"278234",0,1,0,1,"dummy"
"278235",0,1,0,1,"dummy"
"278237",1,0,3,4,"dummy"
"278238",0,1,0,1,"dummy"
"278239",0,0,0,0,"dummy"
"278240",0,0,2,2,"dummy"
"278242",0,9,0,9,"dummy"
"278244",0,0,1,1,"dummy"
"278246",0,0,1,1,"dummy"
"278248",0,0,1,1,"dummy"
"278249",0,0,4,4,"dummy"
"278256",0,0,0,0,"dummy"
"278257",0,0,1,1,"dummy"
"278258",0,0,1,1,"dummy"
"278259",0,0,1,1,"dummy"
"278260",0,0,1,1,"dummy"
"278261",0,0,1,1,"dummy"
"278262",1,6,1,8,"dummy"
"278263",3,4,1,8,"dummy"
"278264",0,2,2,4,"dummy"
"278265",0,1,1,2,"dummy"
"278266",0,0,2,2,"dummy"
"278267",4,6,0,10,"dummy"
"278268",5,4,0,9,"dummy"
"278270",0,0,1,1,"dummy"
"278271",0,0,0,0,"dummy"
"278334",3,0,0,3,"dummy"
"278335",0,0,1,1,"dummy"
"278336",0,12,1,13,"dummy"
"278337",6,4,0,10,"dummy"
"278338",2,4,0,6,"dummy"
"278340",0,0,3,3,"dummy"
"278343",1,0,0,1,"dummy"
"278345",1,2,0,3,"dummy"
"278346",0,10,1,11,"dummy"
"278348",0,0,1,1,"dummy"
"278349",0,1,0,1,"dummy"
"278350",4,4,3,11,"dummy"
"278364",0,0,1,1,"dummy"
"278366",0,0,3,3,"dummy"
"278367",0,2,0,2,"dummy"
"278368",1,3,0,4,"dummy"
"278370",0,0,1,1,"dummy"
"278372",0,1,1,2,"dummy"
"278374",0,0,0,0,"dummy"
"278376",0,1,0,1,"dummy"
"278377",0,0,1,1,"dummy"
"278380",0,13,0,13,"dummy"
"278386",0,1,2,3,"dummy"
"278387",0,0,0,0,"dummy"
"278388",0,2,0,2,"dummy"
"278389",5,0,2,7,"dummy"
"278390",1,0,0,1,"dummy"
"278393",18,0,0,18,"dummy"
"278394",0,3,0,3,"dummy"
"278395",2,2,0,4,"dummy"
"278396",0,0,1,1,"dummy"
"278397",0,1,0,1,"dummy"
"278398",1,18,0,19,"dummy"
"278399",0,1,0,1,"dummy"
"278400",3,3,1,7,"dummy"
"278401",0,2,0,2,"dummy"
"278402",2,4,0,6,"dummy"
"278403",1,2,0,3,"dummy"
"278404",3,0,0,3,"dummy"
"278406",0,2,0,2,"dummy"
"278407",0,1,0,1,"dummy"
"278408",5,12,2,19,"dummy"
"278409",0,0,3,3,"dummy"
"278410",0,0,0,0,"dummy"
"278422",0,1,0,1,"dummy"
"278423",2,0,4,6,"dummy"
"278424",0,6,0,6,"dummy"
"278425",0,1,0,1,"dummy"
"278426",0,3,0,3,"dummy"
"278431",0,4,0,4,"dummy"
"278432",0,0,2,2,"dummy"
"278465",0,5,1,6,"dummy"
"278466",1,0,0,1,"dummy"
"278467",0,2,0,2,"dummy"
"278468",0,1,0,1,"dummy"
"278469",0,0,1,1,"dummy"
"278472",0,0,1,1,"dummy"
"278473",0,0,1,1,"dummy"
"278474",1,3,2,6,"dummy"
"278475",0,0,1,1,"dummy"
"278506",4,17,9,30,"dummy"
"278516",1,2,0,3,"dummy"
"278517",4,4,0,8,"dummy"
"278524",0,0,1,1,"dummy"
"278525",0,0,1,1,"dummy"
"278526",0,1,0,1,"dummy"
"278527",0,0,1,1,"dummy"
"278528",0,1,0,1,"dummy"
"278529",1,1,0,2,"dummy"
"278530",0,0,1,1,"dummy"
"278531",0,2,0,2,"dummy"
"278532",0,0,1,1,"dummy"
"278533",0,0,0,0,"dummy"
"278534",0,0,1,1,"dummy"
"278535",1,0,0,1,"dummy"
"278536",0,0,0,0,"dummy"
"278537",0,0,1,1,"dummy"
"278544",1,2,0,3,"dummy"
"278582",22,1,2,25,"dummy"
"278583",0,0,1,1,"dummy"
"278584",0,0,1,1,"dummy"
"278604",0,2,0,2,"dummy"
"278605",2,2,0,4,"dummy"
"278608",0,2,0,2,"dummy"
"278609",1,1,1,3,"dummy"
"278610",1,1,0,2,"dummy"
"278611",1,0,1,2,"dummy"
"278624",4,10,5,19,"dummy"
"278627",40,13,3,56,"dummy"
"278628",0,1,0,1,"dummy"
"278629",0,2,0,2,"dummy"
"278630",0,1,0,1,"dummy"
"278641",1,6,0,7,"dummy"
"278642",0,1,0,1,"dummy"
"278647",0,7,0,7,"dummy"
"278648",3,12,1,16,"dummy"
"278649",1,2,1,4,"dummy"
"278650",0,0,1,1,"dummy"
"278651",0,1,0,1,"dummy"
"278652",1,0,0,1,"dummy"
"278653",0,2,0,2,"dummy"
"278661",0,0,1,1,"dummy"
"278670",0,1,3,4,"dummy"
"278671",1,0,0,1,"dummy"
"278672",0,0,0,0,"dummy"
"278676",2,1,1,4,"dummy"
"278677",0,3,0,3,"dummy"
"278678",2,5,0,7,"dummy"
"278679",1,11,2,14,"dummy"
"278680",1,2,0,3,"dummy"
"278681",1,0,0,1,"dummy"
"278684",0,1,0,1,"dummy"
"278685",0,0,0,0,"dummy"
"278686",0,8,0,8,"dummy"
"278687",0,0,1,1,"dummy"
"278688",0,1,0,1,"dummy"
"278689",1,20,0,21,"dummy"
"278690",0,0,2,2,"dummy"
"278691",2,1,0,3,"dummy"
"278428",1,0,0,1,"dummy"
"278429",1,1,0,2,"dummy"
"278463",0,0,3,3,"dummy"
"278477",7,15,1,23,"dummy"
"278478",3,4,3,10,"dummy"
"278481",2,2,4,8,"dummy"
"278482",1,1,1,3,"dummy"
"278510",0,1,0,1,"dummy"
"278511",0,1,0,1,"dummy"
"278512",0,1,0,1,"dummy"
"278513",10,2,0,12,"dummy"
"278514",0,0,0,0,"dummy"
"278519",0,0,1,1,"dummy"
"278520",0,0,1,1,"dummy"
"278521",0,0,1,1,"dummy"
"278522",0,0,1,1,"dummy"
"278539",2,0,3,5,"dummy"
"278540",1,0,0,1,"dummy"
"278541",0,1,0,1,"dummy"
"278542",0,1,1,2,"dummy"
"278546",0,1,1,2,"dummy"
"278594",1,2,0,3,"dummy"
"278595",0,1,0,1,"dummy"
"278596",0,1,0,1,"dummy"
"278597",0,4,0,4,"dummy"
"278598",0,0,1,1,"dummy"
"278599",1,1,1,3,"dummy"
"278600",4,0,1,5,"dummy"
"278601",4,0,0,4,"dummy"
"278602",2,0,1,3,"dummy"
"278615",0,2,0,2,"dummy"
"278616",0,1,0,1,"dummy"
"278617",0,1,0,1,"dummy"
"278618",4,5,4,13,"dummy"
"278619",1,1,0,2,"dummy"
"278622",0,0,0,0,"dummy"
"278655",0,0,2,2,"dummy"
"278674",0,0,1,1,"dummy"
"278694",3,0,1,4,"dummy"
"278703",1,2,1,4,"dummy"
"278704",0,0,1,1,"dummy"
"278705",0,0,1,1,"dummy"
"278706",0,0,1,1,"dummy"
"278723",0,0,1,1,"dummy"
"278724",0,0,1,1,"dummy"
"278725",2,1,0,3,"dummy"
"278726",0,0,1,1,"dummy"
"278740",29,5,1,35,"dummy"
"278741",0,2,0,2,"dummy"
"278759",0,1,0,1,"dummy"
"278760",0,0,1,1,"dummy"
"278761",0,0,1,1,"dummy"
"278762",0,0,1,1,"dummy"
"278763",0,0,1,1,"dummy"
"278772",0,1,0,1,"dummy"
"278773",0,0,1,1,"dummy"
"278692",1,0,0,1,"dummy"
"278698",0,1,1,2,"dummy"
"278699",5,0,0,5,"dummy"
"278700",0,2,0,2,"dummy"
"278701",0,1,0,1,"dummy"
"278713",0,0,1,1,"dummy"
"278716",0,16,0,16,"dummy"
"278717",12,4,0,16,"dummy"
"278718",4,41,1,46,"dummy"
"278719",43,2,0,45,"dummy"
"278728",0,0,1,1,"dummy"
"278729",0,0,1,1,"dummy"
"278730",0,1,0,1,"dummy"
"278733",0,0,1,1,"dummy"
"278734",3,2,0,5,"dummy"
"278735",0,0,0,0,"dummy"
"278736",0,0,2,2,"dummy"
"278743",0,0,2,2,"dummy"
"278744",0,2,0,2,"dummy"
"278745",0,4,1,5,"dummy"
"278746",1,1,0,2,"dummy"
"278747",0,0,1,1,"dummy"
"278752",1,0,0,1,"dummy"
"278753",0,3,0,3,"dummy"
"278754",1,0,0,1,"dummy"
"278755",21,3,1,25,"dummy"
"278756",0,6,1,7,"dummy"
"278757",0,0,1,1,"dummy"
"278765",0,0,1,1,"dummy"
"278766",0,0,0,0,"dummy"
"278767",0,7,6,13,"dummy"
"278768",0,1,0,1,"dummy"
"278769",0,0,1,1,"dummy"
"278770",0,0,0,0,"dummy"
"278782",0,0,0,0,"dummy"
"278803",1,3,1,5,"dummy"
"278804",0,1,0,1,"dummy"
"278805",0,5,0,5,"dummy"
"278818",0,0,3,3,"dummy"
"278821",0,0,0,0,"dummy"
"278822",0,0,0,0,"dummy"
"278823",0,0,0,0,"dummy"
"278824",0,0,1,1,"dummy"
"278825",0,0,0,0,"dummy"
"278826",0,0,0,0,"dummy"
"278827",0,0,0,0,"dummy"
"278828",0,0,0,0,"dummy"
"278832",0,0,1,1,"dummy"
"278833",1,0,0,1,"dummy"
"278838",1,8,0,9,"dummy"
"278839",1,1,0,2,"dummy"
"278840",0,2,1,3,"dummy"
"278841",0,1,1,2,"dummy"
"278774",0,0,1,1,"dummy"
"278777",0,2,0,2,"dummy"
"278780",0,0,2,2,"dummy"
"278784",0,2,0,2,"dummy"
"278785",0,7,0,7,"dummy"
"278786",4,1,0,5,"dummy"
"278787",0,1,0,1,"dummy"
"278788",0,4,0,4,"dummy"
"278789",0,1,0,1,"dummy"
"278790",0,2,0,2,"dummy"
"278791",2,11,1,14,"dummy"
"278796",0,2,0,2,"dummy"
"278799",7,3,1,11,"dummy"
"278800",0,0,1,1,"dummy"
"278801",1,2,2,5,"dummy"
"278807",2,1,0,3,"dummy"
"278808",0,3,0,3,"dummy"
"278809",3,0,0,3,"dummy"
"278810",0,7,0,7,"dummy"
"278811",2,0,0,2,"dummy"
"278812",3,1,0,4,"dummy"
"278813",2,0,0,2,"dummy"
"278814",4,0,0,4,"dummy"
"278815",0,8,0,8,"dummy"
"278816",0,0,0,0,"dummy"
"278830",0,0,2,2,"dummy"
"278843",0,6,0,6,"dummy"
"278844",0,2,0,2,"dummy"
"278845",0,0,1,1,"dummy"
"278846",0,0,0,0,"dummy"
"278849",0,2,0,2,"dummy"
"278851",6,0,1,7,"dummy"
"278852",0,4,1,5,"dummy"
"278853",2,5,0,7,"dummy"
"278857",0,0,0,0,"dummy"
"278860",0,0,0,0,"dummy"
"278861",0,0,1,1,"dummy"
"278866",0,11,1,12,"dummy"
"278867",2,2,3,7,"dummy"
"278869",0,0,0,0,"dummy"
"278871",1,9,0,10,"dummy"
"278872",1,1,1,3,"dummy"
"278875",1,6,4,11,"dummy"
"278877",0,0,1,1,"dummy"
"278878",0,1,0,1,"dummy"
"278879",0,0,1,1,"dummy"
"278881",0,2,1,3,"dummy"
"278882",0,0,4,4,"dummy"
"278884",0,1,0,1,"dummy"
"278885",11,2,0,13,"dummy"
"278886",0,12,1,13,"dummy"
"278889",0,1,0,1,"dummy"
"278890",0,0,1,1,"dummy"
"278891",0,1,0,1,"dummy"
"278894",0,0,2,2,"dummy"
"278896",0,1,0,1,"dummy"
"278897",0,2,0,2,"dummy"
"278898",0,9,0,9,"dummy"
"278902",1,0,0,1,"dummy"
"278904",1,0,0,1,"dummy"
"278905",0,2,0,2,"dummy"
"278907",0,1,0,1,"dummy"
"278908",0,2,0,2,"dummy"
"278911",0,1,2,3,"dummy"
"278912",0,0,0,0,"dummy"
"278913",0,1,0,1,"dummy"
"278914",4,0,2,6,"dummy"
"278915",1,0,0,1,"dummy"
"278916",0,0,0,0,"dummy"
"278917",0,0,0,0,"dummy"
"278923",0,0,1,1,"dummy"
"278924",0,0,1,1,"dummy"
"278926",9,0,0,9,"dummy"
"278937",0,0,1,1,"dummy"
"278938",2,1,1,4,"dummy"
"278939",0,0,2,2,"dummy"
"278940",0,0,1,1,"dummy"
"278941",0,0,1,1,"dummy"
"278942",0,0,1,1,"dummy"
"278943",0,0,1,1,"dummy"
"278944",0,0,1,1,"dummy"
"278945",0,0,1,1,"dummy"
"278946",0,1,2,3,"dummy"
"278947",0,0,1,1,"dummy"
"278948",0,0,1,1,"dummy"
"278949",0,2,1,3,"dummy"
"278950",0,1,0,1,"dummy"
"278957",0,1,0,1,"dummy"
"278958",0,2,0,2,"dummy"
"278959",6,0,2,8,"dummy"
"278960",0,0,1,1,"dummy"
"278961",4,0,2,6,"dummy"
"278964",11,1,0,12,"dummy"
"278965",0,2,0,2,"dummy"
"278967",0,1,0,1,"dummy"
"278970",0,13,0,13,"dummy"
"278971",0,11,1,12,"dummy"
"278973",0,2,0,2,"dummy"
"278976",0,2,1,3,"dummy"
"278977",0,0,1,1,"dummy"
"278978",0,0,1,1,"dummy"
"278979",0,0,1,1,"dummy"
"278981",0,1,0,1,"dummy"
"278982",0,0,1,1,"dummy"
"278983",0,0,2,2,"dummy"
"278985",2,5,4,11,"dummy"
"278986",0,4,2,6,"dummy"
"278987",0,1,0,1,"dummy"
"278988",0,1,0,1,"dummy"
"278989",1,0,0,1,"dummy"
"278993",1,5,2,8,"dummy"
"278998",0,2,0,2,"dummy"
"278999",0,4,0,4,"dummy"
"279001",0,1,0,1,"dummy"
"279002",0,1,0,1,"dummy"
"279003",10,3,1,14,"dummy"
"279004",0,0,1,1,"dummy"
"279005",0,1,1,2,"dummy"
"279006",1,2,0,3,"dummy"
"279007",2,0,0,2,"dummy"
"279008",1,1,0,2,"dummy"
"279009",1,1,0,2,"dummy"
"279010",0,4,1,5,"dummy"
"279011",4,2,1,7,"dummy"
"279012",2,0,1,3,"dummy"
"279013",0,2,1,3,"dummy"
"279014",0,1,1,2,"dummy"
"279015",2,0,0,2,"dummy"
"279016",0,1,0,1,"dummy"
"279017",5,12,2,19,"dummy"
"279018",2,0,0,2,"dummy"
"279019",0,1,0,1,"dummy"
"279020",2,1,1,4,"dummy"
"279021",0,2,0,2,"dummy"
"279022",1,0,0,1,"dummy"
"279023",0,1,0,1,"dummy"
"279024",0,1,0,1,"dummy"
"279025",0,1,0,1,"dummy"
"279026",4,0,0,4,"dummy"
"279027",0,3,0,3,"dummy"
"279028",0,0,1,1,"dummy"
"279029",4,1,0,5,"dummy"
"279030",0,1,0,1,"dummy"
"279031",1,0,0,1,"dummy"
"279032",2,2,1,5,"dummy"
"279033",0,0,1,1,"dummy"
"279034",0,0,1,1,"dummy"
"279035",0,1,0,1,"dummy"
"279036",0,1,0,1,"dummy"
"279037",1,1,0,2,"dummy"
"279038",1,2,0,3,"dummy"
"279039",2,0,0,2,"dummy"
"279040",0,1,0,1,"dummy"
"279041",0,1,0,1,"dummy"
"279042",1,1,0,2,"dummy"
"279043",2,0,0,2,"dummy"
"279044",1,0,0,1,"dummy"
"279045",0,2,0,2,"dummy"
"279046",0,2,0,2,"dummy"
"279047",2,0,0,2,"dummy"
"279048",0,1,0,1,"dummy"
"279049",3,0,0,3,"dummy"
"279050",1,2,0,3,"dummy"
"279051",0,2,0,2,"dummy"
"279052",0,1,0,1,"dummy"
"279053",12,3,1,16,"dummy"
"279054",2,0,0,2,"dummy"
"279055",3,9,1,13,"dummy"
"279056",8,3,1,12,"dummy"
"279057",1,0,0,1,"dummy"
"279058",0,0,1,1,"dummy"
"279059",0,0,0,0,"dummy"
"279060",0,3,0,3,"dummy"
"279061",0,0,0,0,"dummy"
"279062",0,1,0,1,"dummy"
"279063",0,0,0,0,"dummy"
"279064",0,1,0,1,"dummy"
"279065",0,1,0,1,"dummy"
"279066",1,1,0,2,"dummy"
"279067",1,1,0,2,"dummy"
"279068",0,0,0,0,"dummy"
"279069",1,2,0,3,"dummy"
"279071",0,2,0,2,"dummy"
"279072",6,10,0,16,"dummy"
"279073",2,1,0,3,"dummy"
"279074",0,0,2,2,"dummy"
"279075",0,0,0,0,"dummy"
"279076",0,0,0,0,"dummy"
"279077",0,0,0,0,"dummy"
"279080",0,4,1,5,"dummy"
"279086",0,3,0,3,"dummy"
"279087",0,2,4,6,"dummy"
"279091",0,0,0,0,"dummy"
"279092",0,5,1,6,"dummy"
"279094",3,4,3,10,"dummy"
"279095",0,0,2,2,"dummy"
"279096",0,0,1,1,"dummy"
"279101",0,0,0,0,"dummy"
"279110",21,98,2,121,"dummy"
"279111",0,2,0,2,"dummy"
"279112",2,4,0,6,"dummy"
"279113",2,3,0,5,"dummy"
"279114",59,4,0,63,"dummy"
"279115",0,3,0,3,"dummy"
"279125",16,18,4,38,"dummy"
"279127",1,0,1,2,"dummy"
"279139",1,5,1,7,"dummy"
"279140",5,0,1,6,"dummy"
"279141",0,1,0,1,"dummy"
"279142",0,0,0,0,"dummy"
"279143",1,0,0,1,"dummy"
"279145",0,0,1,1,"dummy"
"279160",0,0,1,1,"dummy"
"279161",6,6,1,13,"dummy"
"279166",0,2,2,4,"dummy"
"279167",1,0,0,1,"dummy"
"279169",0,0,0,0,"dummy"
"279170",0,3,0,3,"dummy"
"279171",5,0,4,9,"dummy"
"279172",0,0,1,1,"dummy"
"279175",0,0,1,1,"dummy"
"279177",9,10,0,19,"dummy"
"279179",1,2,0,3,"dummy"
"279181",0,0,1,1,"dummy"
"279182",2,0,0,2,"dummy"
"279183",0,1,0,1,"dummy"
"279185",0,0,1,1,"dummy"
"279186",0,0,1,1,"dummy"
"279187",0,0,2,2,"dummy"
"279188",0,0,1,1,"dummy"
"279189",0,0,0,0,"dummy"
"279190",0,2,0,2,"dummy"
"279191",2,0,0,2,"dummy"
"279192",0,0,1,1,"dummy"
"279193",0,2,0,2,"dummy"
"279194",2,2,0,4,"dummy"
"279195",0,2,0,2,"dummy"
"279196",6,0,0,6,"dummy"
"279197",0,6,1,7,"dummy"
"279198",6,0,0,6,"dummy"
"279199",0,0,1,1,"dummy"
"279200",0,1,0,1,"dummy"
"279201",0,1,0,1,"dummy"
"279202",0,2,0,2,"dummy"
"279203",0,2,0,2,"dummy"
"279204",0,5,0,5,"dummy"
"279205",6,3,1,10,"dummy"
"279206",0,7,0,7,"dummy"
"279207",0,1,0,1,"dummy"
"279208",2,0,0,2,"dummy"
"279209",0,1,0,1,"dummy"
"279210",2,2,0,4,"dummy"
"279211",0,2,0,2,"dummy"
"279212",0,0,0,0,"dummy"
"279213",0,0,0,0,"dummy"
"279214",0,0,2,2,"dummy"
"279215",10,2,0,12,"dummy"
"279216",2,0,0,2,"dummy"
"279217",0,0,0,0,"dummy"
"279218",0,0,0,0,"dummy"
"279219",0,0,0,0,"dummy"
"279220",5,0,1,6,"dummy"
"279222",4,4,0,8,"dummy"
"279245",0,1,0,1,"dummy"
"279246",0,1,0,1,"dummy"
"279247",2,0,0,2,"dummy"
"279260",0,0,3,3,"dummy"
"279261",0,1,0,1,"dummy"
"279262",3,3,1,7,"dummy"
"279263",1,0,0,1,"dummy"
"279264",3,0,0,3,"dummy"
"279265",0,0,1,1,"dummy"
"279266",0,1,1,2,"dummy"
"279267",0,0,1,1,"dummy"
"279268",3,2,2,7,"dummy"
"279269",0,1,0,1,"dummy"
"279270",0,0,2,2,"dummy"
"279271",0,2,0,2,"dummy"
"279273",1,0,0,1,"dummy"
"279274",0,1,0,1,"dummy"
"279276",0,1,0,1,"dummy"
"279278",0,1,2,3,"dummy"
"279281",6,0,0,6,"dummy"
"279282",2,5,2,9,"dummy"
"279284",4,1,0,5,"dummy"
"279285",0,0,0,0,"dummy"
"279286",0,0,1,1,"dummy"
"279287",0,0,0,0,"dummy"
"279288",0,0,0,0,"dummy"
"279289",0,0,0,0,"dummy"
"279290",0,0,0,0,"dummy"
"279291",0,0,0,0,"dummy"
"279292",0,0,1,1,"dummy"
"279293",0,0,0,0,"dummy"
"279294",0,0,0,0,"dummy"
"279295",0,0,0,0,"dummy"
"279296",0,0,0,0,"dummy"
"279299",0,0,1,1,"dummy"
"279300",0,0,1,1,"dummy"
"279301",4,4,0,8,"dummy"
"279332",1,2,0,3,"dummy"
"279333",8,8,0,16,"dummy"
"279334",0,0,1,1,"dummy"
"279335",8,1,1,10,"dummy"
"279338",3,17,7,27,"dummy"
"279339",0,0,1,1,"dummy"
"279340",0,1,1,2,"dummy"
"279345",0,1,0,1,"dummy"
"279346",0,3,0,3,"dummy"
"279367",0,0,1,1,"dummy"
"279374",3,0,0,3,"dummy"
"279375",0,1,0,1,"dummy"
"279376",0,0,1,1,"dummy"
"279377",30,2,0,32,"dummy"
"279385",1,3,0,4,"dummy"
"279386",0,0,1,1,"dummy"
"279387",4,6,0,10,"dummy"
"279388",3,6,0,9,"dummy"
"279389",0,2,0,2,"dummy"
"279390",8,0,0,8,"dummy"
"279391",2,4,0,6,"dummy"
"279392",0,0,1,1,"dummy"
"279393",0,0,6,6,"dummy"
"279394",0,0,5,5,"dummy"
"279395",0,2,1,3,"dummy"
"279396",3,1,0,4,"dummy"
"279397",2,0,0,2,"dummy"
"279398",0,1,0,1,"dummy"
"279399",1,1,0,2,"dummy"
"279407",0,1,0,1,"dummy"
"279408",1,1,0,2,"dummy"
"279409",0,1,0,1,"dummy"
"279417",0,0,1,1,"dummy"
"279418",1,0,0,1,"dummy"
"279419",1,0,1,2,"dummy"
"279420",0,0,0,0,"dummy"
"279421",2,0,0,2,"dummy"
"279422",0,8,1,9,"dummy"
"279423",2,0,0,2,"dummy"
"279424",0,0,0,0,"dummy"
"279425",0,0,1,1,"dummy"
"279426",0,4,0,4,"dummy"
"279427",1,0,0,1,"dummy"
"279428",11,2,1,14,"dummy"
"279429",0,0,1,1,"dummy"
"279430",0,0,1,1,"dummy"
"279431",0,1,0,1,"dummy"
"279432",1,0,0,1,"dummy"
"279433",0,5,0,5,"dummy"
"279434",0,0,1,1,"dummy"
"279435",2,0,0,2,"dummy"
"279436",0,0,2,2,"dummy"
"279437",0,0,0,0,"dummy"
"279438",0,0,1,1,"dummy"
"279439",0,0,1,1,"dummy"
"279440",0,0,1,1,"dummy"
"279441",0,0,1,1,"dummy"
"279442",0,0,1,1,"dummy"
"279443",0,0,2,2,"dummy"
"279444",0,0,2,2,"dummy"
"279445",0,0,2,2,"dummy"
"279446",0,0,2,2,"dummy"
"279447",0,0,2,2,"dummy"
"279448",0,0,2,2,"dummy"
"279449",2,1,1,4,"dummy"
"279450",0,0,2,2,"dummy"
"279451",0,0,0,0,"dummy"
"279452",1,1,0,2,"dummy"
"279453",0,0,2,2,"dummy"
"279454",1,1,0,2,"dummy"
"279455",0,0,3,3,"dummy"
"279456",0,0,2,2,"dummy"
"279457",0,0,1,1,"dummy"
"279458",0,0,0,0,"dummy"
"279459",0,0,0,0,"dummy"
"279460",0,0,1,1,"dummy"
"279461",0,0,1,1,"dummy"
"279462",0,0,1,1,"dummy"
"279463",0,1,0,1,"dummy"
"279464",0,1,1,2,"dummy"
"279465",0,0,1,1,"dummy"
"279466",0,0,1,1,"dummy"
"279467",0,0,1,1,"dummy"
"279468",0,0,1,1,"dummy"
"279469",0,0,1,1,"dummy"
"279470",0,0,1,1,"dummy"
"279471",0,0,1,1,"dummy"
"279472",0,0,1,1,"dummy"
"279473",0,0,1,1,"dummy"
"279303",0,0,1,1,"dummy"
"279304",0,1,0,1,"dummy"
"279305",0,0,1,1,"dummy"
"279306",0,0,2,2,"dummy"
"279307",0,0,1,1,"dummy"
"279348",3,5,2,10,"dummy"
"279349",5,10,2,17,"dummy"
"279350",0,0,1,1,"dummy"
"279355",0,0,1,1,"dummy"
"279360",0,0,1,1,"dummy"
"279361",0,0,1,1,"dummy"
"279362",0,1,0,1,"dummy"
"279363",1,0,0,1,"dummy"
"279364",0,0,1,1,"dummy"
"279365",1,0,0,1,"dummy"
"279379",1,2,0,3,"dummy"
"279380",7,3,2,12,"dummy"
"279381",2,1,2,5,"dummy"
"279382",0,1,0,1,"dummy"
"279383",1,0,0,1,"dummy"
"279401",0,2,0,2,"dummy"
"279402",0,8,0,8,"dummy"
"279403",0,1,0,1,"dummy"
"279404",2,5,0,7,"dummy"
"279405",0,1,0,1,"dummy"
"279496",2,1,0,3,"dummy"
"279502",0,2,1,3,"dummy"
"279505",0,2,0,2,"dummy"
"279506",0,0,1,1,"dummy"
"279507",0,0,2,2,"dummy"
"279508",0,2,0,2,"dummy"
"279509",0,3,0,3,"dummy"
"279510",0,0,2,2,"dummy"
"279511",0,1,0,1,"dummy"
"279512",0,1,0,1,"dummy"
"279513",0,0,1,1,"dummy"
"279514",5,4,3,12,"dummy"
"279515",0,0,0,0,"dummy"
"279516",0,0,1,1,"dummy"
"279517",0,0,1,1,"dummy"
"279518",0,0,1,1,"dummy"
"279519",1,0,0,1,"dummy"
"279528",0,0,1,1,"dummy"
"279529",0,1,0,1,"dummy"
"279533",6,5,1,12,"dummy"
"279534",2,5,1,8,"dummy"
"279535",2,4,1,7,"dummy"
"279543",1,0,1,2,"dummy"
"279555",2,2,0,4,"dummy"
"279556",0,0,1,1,"dummy"
"279557",0,1,0,1,"dummy"
"279558",1,1,0,2,"dummy"
"279559",3,8,1,12,"dummy"
"279560",0,12,1,13,"dummy"
"279565",1,4,0,5,"dummy"
"279566",0,0,1,1,"dummy"
"279567",1,2,1,4,"dummy"
"279568",0,0,1,1,"dummy"
"279583",1,2,0,3,"dummy"
"279584",4,8,0,12,"dummy"
"279585",0,1,0,1,"dummy"
"279586",5,16,2,23,"dummy"
"279587",0,0,1,1,"dummy"
"279588",1,4,0,5,"dummy"
"279589",3,22,4,29,"dummy"
"279590",0,3,1,4,"dummy"
"279591",0,1,0,1,"dummy"
"279592",39,10,5,54,"dummy"
"279600",0,3,0,3,"dummy"
"279601",0,0,1,1,"dummy"
"279602",2,0,1,3,"dummy"
"279603",0,0,1,1,"dummy"
"279604",0,0,1,1,"dummy"
"279609",4,3,0,7,"dummy"
"279610",0,0,1,1,"dummy"
"279611",3,0,2,5,"dummy"
"279474",0,0,1,1,"dummy"
"279475",0,0,1,1,"dummy"
"279476",0,0,1,1,"dummy"
"279477",0,0,1,1,"dummy"
"279478",0,0,1,1,"dummy"
"279479",0,0,1,1,"dummy"
"279480",0,0,1,1,"dummy"
"279481",0,0,1,1,"dummy"
"279482",0,0,1,1,"dummy"
"279483",0,0,1,1,"dummy"
"279484",0,0,1,1,"dummy"
"279485",0,0,1,1,"dummy"
"279486",0,1,0,1,"dummy"
"279487",0,0,1,1,"dummy"
"279488",0,0,1,1,"dummy"
"279489",0,0,1,1,"dummy"
"279492",0,2,0,2,"dummy"
"279498",0,1,4,5,"dummy"
"279521",0,5,0,5,"dummy"
"279522",2,6,0,8,"dummy"
"279523",0,0,1,1,"dummy"
"279524",4,0,2,6,"dummy"
"279525",0,0,1,1,"dummy"
"279526",0,2,0,2,"dummy"
"279531",0,0,1,1,"dummy"
"279537",1,2,0,3,"dummy"
"279538",0,0,2,2,"dummy"
"279539",2,2,3,7,"dummy"
"279545",0,0,1,1,"dummy"
"279546",0,1,0,1,"dummy"
"279547",0,0,1,1,"dummy"
"279548",7,8,0,15,"dummy"
"279549",0,5,0,5,"dummy"
"279550",6,5,0,11,"dummy"
"279551",1,6,1,8,"dummy"
"279552",1,4,1,6,"dummy"
"279553",2,4,1,7,"dummy"
"279570",3,0,0,3,"dummy"
"279571",0,5,1,6,"dummy"
"279572",0,1,0,1,"dummy"
"279594",0,0,2,2,"dummy"
"279595",0,1,0,1,"dummy"
"279596",0,1,0,1,"dummy"
"279618",4,6,0,10,"dummy"
"279619",1,0,0,1,"dummy"
"279620",0,1,0,1,"dummy"
"279621",0,0,1,1,"dummy"
"279622",0,3,0,3,"dummy"
"279623",3,7,0,10,"dummy"
"279624",0,1,0,1,"dummy"
"279625",0,1,0,1,"dummy"
"279626",1,0,0,1,"dummy"
"279627",0,0,0,0,"dummy"
"279630",0,1,0,1,"dummy"
"279631",0,1,0,1,"dummy"
"279635",1,20,1,22,"dummy"
"279646",0,0,0,0,"dummy"
"279647",0,0,0,0,"dummy"
"279648",0,0,0,0,"dummy"
"279649",0,0,1,1,"dummy"
"279650",4,0,1,5,"dummy"
"279651",0,0,0,0,"dummy"
"279652",0,0,0,0,"dummy"
"279653",0,0,0,0,"dummy"
"279654",0,14,0,14,"dummy"
"279655",2,4,1,7,"dummy"
"279656",0,2,0,2,"dummy"
"279657",0,0,1,1,"dummy"
"279658",0,0,0,0,"dummy"
"279659",0,0,1,1,"dummy"
"279660",0,0,0,0,"dummy"
"279661",0,0,0,0,"dummy"
"279662",0,0,0,0,"dummy"
"279663",0,0,1,1,"dummy"
"279664",0,0,1,1,"dummy"
"279667",1,0,0,1,"dummy"
"279668",5,2,2,9,"dummy"
"279669",0,0,1,1,"dummy"
"279670",1,0,0,1,"dummy"
"279673",0,0,1,1,"dummy"
"279674",0,0,2,2,"dummy"
"279612",0,0,1,1,"dummy"
"279633",0,0,2,2,"dummy"
"279644",0,0,5,5,"dummy"
"279694",1,20,0,21,"dummy"
"279697",0,2,0,2,"dummy"
"279705",0,0,0,0,"dummy"
"279706",4,6,1,11,"dummy"
"279707",0,0,1,1,"dummy"
"279729",0,0,1,1,"dummy"
"279730",0,0,1,1,"dummy"
"279731",1,5,0,6,"dummy"
"279732",0,1,0,1,"dummy"
"279739",0,2,0,2,"dummy"
"279740",0,6,0,6,"dummy"
"279741",14,18,2,34,"dummy"
"279742",14,13,2,29,"dummy"
"279743",0,0,0,0,"dummy"
"279744",1,0,1,2,"dummy"
"279745",0,1,0,1,"dummy"
"279746",0,6,0,6,"dummy"
"279747",1,0,0,1,"dummy"
"279748",0,1,0,1,"dummy"
"279749",7,27,0,34,"dummy"
"279750",29,85,13,127,"dummy"
"279763",0,1,0,1,"dummy"
"279764",0,1,2,3,"dummy"
"279765",0,0,2,2,"dummy"
"279768",0,1,1,2,"dummy"
"279769",3,2,4,9,"dummy"
"279772",0,1,0,1,"dummy"
"279773",2,5,1,8,"dummy"
"279774",0,3,0,3,"dummy"
"279779",0,0,2,2,"dummy"
"279791",0,2,0,2,"dummy"
"279792",0,2,0,2,"dummy"
"279793",1,0,0,1,"dummy"
"279794",0,0,3,3,"dummy"
"279795",0,3,1,4,"dummy"
"279796",5,1,0,6,"dummy"
"279797",5,0,0,5,"dummy"
"279798",10,3,4,17,"dummy"
"279801",0,0,1,1,"dummy"
"279805",3,5,3,11,"dummy"
"279806",2,3,0,5,"dummy"
"279807",3,1,0,4,"dummy"
"279808",0,0,2,2,"dummy"
"279809",3,6,2,11,"dummy"
"279810",0,0,0,0,"dummy"
"279811",1,0,0,1,"dummy"
"279812",0,2,0,2,"dummy"
"279813",2,2,0,4,"dummy"
"279814",0,1,0,1,"dummy"
"279815",2,0,0,2,"dummy"
"279818",0,2,0,2,"dummy"
"279821",0,7,0,7,"dummy"
"279822",0,0,1,1,"dummy"
"279823",0,0,1,1,"dummy"
"279824",3,2,1,6,"dummy"
"279825",0,0,1,1,"dummy"
"279826",0,0,3,3,"dummy"
"279827",0,0,1,1,"dummy"
"279838",0,1,0,1,"dummy"
"279841",1,4,3,8,"dummy"
"279842",6,4,2,12,"dummy"
"279843",0,1,0,1,"dummy"
"279844",1,2,3,6,"dummy"
"279853",3,1,4,8,"dummy"
"279854",2,8,5,15,"dummy"
"279855",0,2,1,3,"dummy"
"279856",2,3,1,6,"dummy"
"279675",0,1,1,2,"dummy"
"279676",0,0,1,1,"dummy"
"279677",0,0,1,1,"dummy"
"279678",0,0,1,1,"dummy"
"279679",0,0,1,1,"dummy"
"279680",0,0,1,1,"dummy"
"279689",0,0,1,1,"dummy"
"279690",0,0,1,1,"dummy"
"279691",0,0,2,2,"dummy"
"279692",0,0,0,0,"dummy"
"279701",1,1,0,2,"dummy"
"279709",0,1,0,1,"dummy"
"279712",0,0,1,1,"dummy"
"279713",0,0,1,1,"dummy"
"279714",10,6,0,16,"dummy"
"279715",0,0,0,0,"dummy"
"279716",1,2,0,3,"dummy"
"279717",0,9,1,10,"dummy"
"279718",0,0,1,1,"dummy"
"279719",1,1,0,2,"dummy"
"279720",4,6,4,14,"dummy"
"279721",1,6,2,9,"dummy"
"279722",0,1,0,1,"dummy"
"279723",0,0,1,1,"dummy"
"279724",0,0,1,1,"dummy"
"279725",0,0,2,2,"dummy"
"279726",0,0,1,1,"dummy"
"279727",0,0,2,2,"dummy"
"279736",0,1,0,1,"dummy"
"279737",0,2,0,2,"dummy"
"279761",0,2,0,2,"dummy"
"279776",0,2,0,2,"dummy"
"279777",2,0,0,2,"dummy"
"279781",0,3,0,3,"dummy"
"279782",0,0,1,1,"dummy"
"279783",6,5,2,13,"dummy"
"279786",5,2,0,7,"dummy"
"279789",0,0,2,2,"dummy"
"279803",0,0,0,0,"dummy"
"279831",2,5,4,11,"dummy"
"279832",0,1,0,1,"dummy"
"279833",0,3,0,3,"dummy"
"279834",0,0,1,1,"dummy"
"279848",0,1,2,3,"dummy"
"279849",1,3,1,5,"dummy"
"279874",1,1,0,2,"dummy"
"279875",0,1,0,1,"dummy"
"279876",0,8,0,8,"dummy"
"279877",0,0,0,0,"dummy"
"279878",0,0,0,0,"dummy"
"279879",0,1,0,1,"dummy"
"279880",8,0,0,8,"dummy"
"279881",1,6,3,10,"dummy"
"279882",20,7,2,29,"dummy"
"279898",0,0,1,1,"dummy"
"279909",0,3,0,3,"dummy"
"279910",0,1,1,2,"dummy"
"279963",0,4,1,5,"dummy"
"279964",1,3,1,5,"dummy"
"279975",0,0,1,1,"dummy"
"279976",0,1,0,1,"dummy"
"279977",0,0,1,1,"dummy"
"279857",0,0,1,1,"dummy"
"279858",0,0,1,1,"dummy"
"279859",2,0,0,2,"dummy"
"279860",0,0,2,2,"dummy"
"279871",1,0,1,2,"dummy"
"279872",2,0,0,2,"dummy"
"279884",0,1,0,1,"dummy"
"279887",4,1,0,5,"dummy"
"279888",2,5,1,8,"dummy"
"279889",0,0,1,1,"dummy"
"279900",1,0,0,1,"dummy"
"279905",1,0,0,1,"dummy"
"279906",0,2,0,2,"dummy"
"279907",0,0,1,1,"dummy"
"279945",1,1,1,3,"dummy"
"279946",4,1,1,6,"dummy"
"279947",1,5,0,6,"dummy"
"279948",1,1,0,2,"dummy"
"279949",0,3,0,3,"dummy"
"279950",13,8,8,29,"dummy"
"279951",0,0,1,1,"dummy"
"279952",0,0,2,2,"dummy"
"279953",0,0,2,2,"dummy"
"279954",0,1,0,1,"dummy"
"279959",0,7,0,7,"dummy"
"279960",0,0,1,1,"dummy"
"279961",0,0,1,1,"dummy"
"279966",0,0,4,4,"dummy"
"279967",0,0,4,4,"dummy"
"279968",0,0,4,4,"dummy"
"279969",0,0,4,4,"dummy"
"279970",0,0,4,4,"dummy"
"279971",0,0,4,4,"dummy"
"280008",0,1,0,1,"dummy"
"280009",0,2,0,2,"dummy"
"280010",0,1,0,1,"dummy"
"280016",0,0,1,1,"dummy"
"280022",3,11,2,16,"dummy"
"280023",0,1,1,2,"dummy"
"280024",0,1,0,1,"dummy"
"280025",1,3,0,4,"dummy"
"280026",0,1,0,1,"dummy"
"280027",0,0,1,1,"dummy"
"280036",0,1,0,1,"dummy"
"280037",0,1,1,2,"dummy"
"280038",0,1,0,1,"dummy"
"280045",0,1,0,1,"dummy"
"280048",0,0,1,1,"dummy"
"280056",0,4,0,4,"dummy"
"280059",0,2,0,2,"dummy"
"280069",9,2,0,11,"dummy"
"280070",0,3,0,3,"dummy"
"280071",0,0,1,1,"dummy"
"280072",5,4,8,17,"dummy"
"280075",0,6,0,6,"dummy"
"280076",0,2,0,2,"dummy"
"280077",0,1,2,3,"dummy"
"280078",0,0,0,0,"dummy"
"280079",0,4,0,4,"dummy"
"280080",0,2,0,2,"dummy"
"280081",0,2,0,2,"dummy"
"280082",4,3,1,8,"dummy"
"280083",3,3,0,6,"dummy"
"280084",0,1,1,2,"dummy"
"280085",1,1,4,6,"dummy"
"280086",1,1,0,2,"dummy"
"280087",0,1,0,1,"dummy"
"280088",6,4,0,10,"dummy"
"280089",0,1,0,1,"dummy"
"280090",0,0,0,0,"dummy"
"280091",0,1,1,2,"dummy"
"280092",1,0,0,1,"dummy"
"280093",3,3,0,6,"dummy"
"280094",11,10,5,26,"dummy"
"280099",1,7,0,8,"dummy"
"279978",0,0,0,0,"dummy"
"279979",0,0,0,0,"dummy"
"279982",0,0,1,1,"dummy"
"279983",0,0,1,1,"dummy"
"279984",0,0,2,2,"dummy"
"279985",0,0,1,1,"dummy"
"279986",2,0,0,2,"dummy"
"279987",0,0,1,1,"dummy"
"279988",0,0,1,1,"dummy"
"279989",0,0,1,1,"dummy"
"279990",0,1,0,1,"dummy"
"279991",0,2,0,2,"dummy"
"279992",0,2,0,2,"dummy"
"279993",0,1,0,1,"dummy"
"279994",0,2,0,2,"dummy"
"279995",2,2,0,4,"dummy"
"279996",0,2,0,2,"dummy"
"279997",2,2,0,4,"dummy"
"279998",2,2,0,4,"dummy"
"279999",2,2,0,4,"dummy"
"280000",4,1,0,5,"dummy"
"280001",1,0,0,1,"dummy"
"280002",0,2,0,2,"dummy"
"280003",0,0,0,0,"dummy"
"280004",0,0,0,0,"dummy"
"280005",0,0,0,0,"dummy"
"280006",4,0,0,4,"dummy"
"280012",0,0,1,1,"dummy"
"280018",9,7,1,17,"dummy"
"280029",0,0,4,4,"dummy"
"280030",0,3,0,3,"dummy"
"280031",0,1,0,1,"dummy"
"280034",0,0,1,1,"dummy"
"280042",2,5,2,9,"dummy"
"280043",0,0,1,1,"dummy"
"280050",0,3,0,3,"dummy"
"280051",0,1,0,1,"dummy"
"280052",2,1,0,3,"dummy"
"280061",0,0,1,1,"dummy"
"280066",0,0,0,0,"dummy"
"280067",0,1,2,3,"dummy"
"280101",0,1,0,1,"dummy"
"280130",4,2,2,8,"dummy"
"280133",9,2,0,11,"dummy"
"280134",0,3,0,3,"dummy"
"280135",0,0,1,1,"dummy"
"280136",5,4,8,17,"dummy"
"280139",2,20,3,25,"dummy"
"280140",3,2,0,5,"dummy"
"280141",0,1,0,1,"dummy"
"280142",0,0,0,0,"dummy"
"280143",1,3,1,5,"dummy"
"280145",2,4,0,6,"dummy"
"280146",2,0,1,3,"dummy"
"280147",0,1,1,2,"dummy"
"280151",0,3,0,3,"dummy"
"280152",0,0,1,1,"dummy"
"280153",0,2,2,4,"dummy"
"280162",3,3,0,6,"dummy"
"280163",0,0,1,1,"dummy"
"280164",5,2,0,7,"dummy"
"280165",0,9,0,9,"dummy"
"280166",1,2,0,3,"dummy"
"280168",1,2,0,3,"dummy"
"280169",0,0,1,1,"dummy"
"280170",3,31,0,34,"dummy"
"280171",0,1,1,2,"dummy"
"280172",4,3,0,7,"dummy"
"280173",0,0,1,1,"dummy"
"280174",1,2,0,3,"dummy"
"280175",0,3,1,4,"dummy"
"280176",0,1,0,1,"dummy"
"280177",0,1,0,1,"dummy"
"280178",3,19,0,22,"dummy"
"280179",40,3,0,43,"dummy"
"280180",0,0,2,2,"dummy"
"280184",0,1,0,1,"dummy"
"280185",0,0,1,1,"dummy"
"280186",0,1,0,1,"dummy"
"280187",0,0,1,1,"dummy"
"280189",0,1,0,1,"dummy"
"280190",3,16,0,19,"dummy"
"280193",4,0,1,5,"dummy"
"280195",0,6,0,6,"dummy"
"280199",0,0,1,1,"dummy"
"280200",0,0,1,1,"dummy"
"280201",0,0,2,2,"dummy"
"280202",26,3,7,36,"dummy"
"280204",1,0,0,1,"dummy"
"280206",1,0,1,2,"dummy"
"280208",0,0,1,1,"dummy"
"280209",0,1,2,3,"dummy"
"280210",1,0,1,2,"dummy"
"280211",0,0,2,2,"dummy"
"280212",0,0,2,2,"dummy"
"280213",0,1,3,4,"dummy"
"280214",1,0,1,2,"dummy"
"280215",0,9,2,11,"dummy"
"280216",0,0,0,0,"dummy"
"280217",0,0,2,2,"dummy"
"280218",5,1,2,8,"dummy"
"280220",2,2,1,5,"dummy"
"280221",0,2,0,2,"dummy"
"280234",2,1,1,4,"dummy"
"280235",2,17,2,21,"dummy"
"280236",0,6,8,14,"dummy"
"280237",1,2,0,3,"dummy"
"280238",2,1,2,5,"dummy"
"280239",0,6,6,12,"dummy"
"280240",2,2,2,6,"dummy"
"280241",0,0,3,3,"dummy"
"280242",0,1,0,1,"dummy"
"280243",8,8,11,27,"dummy"
"280244",0,1,0,1,"dummy"
"280245",0,0,5,5,"dummy"
"280246",20,2,8,30,"dummy"
"280247",0,1,9,10,"dummy"
"280248",0,10,15,25,"dummy"
"280249",0,0,4,4,"dummy"
"280250",0,0,2,2,"dummy"
"280252",0,0,4,4,"dummy"
"280253",0,0,1,1,"dummy"
"280297",1,0,0,1,"dummy"
"280298",0,2,0,2,"dummy"
"280299",1,0,0,1,"dummy"
"280300",0,1,0,1,"dummy"
"280301",14,5,3,22,"dummy"
"280302",0,0,1,1,"dummy"
"280304",0,16,0,16,"dummy"
"280305",0,0,0,0,"dummy"
"280306",0,0,4,4,"dummy"
"280307",0,0,1,1,"dummy"
"280308",0,2,0,2,"dummy"
"280309",0,1,0,1,"dummy"
"280310",1,0,0,1,"dummy"
"280311",0,2,2,4,"dummy"
"280312",4,8,2,14,"dummy"
"280313",0,2,2,4,"dummy"
"280314",2,0,0,2,"dummy"
"280315",0,0,0,0,"dummy"
"280316",0,3,0,3,"dummy"
"280317",3,4,0,7,"dummy"
"280318",0,4,0,4,"dummy"
"280319",0,1,0,1,"dummy"
"280320",1,2,0,3,"dummy"
"280321",0,1,0,1,"dummy"
"280322",0,1,0,1,"dummy"
"280323",4,7,0,11,"dummy"
"280324",1,1,0,2,"dummy"
"280327",1,14,1,16,"dummy"
"280328",14,17,1,32,"dummy"
"280329",0,5,0,5,"dummy"
"280330",0,6,0,6,"dummy"
"280331",0,2,0,2,"dummy"
"280332",6,0,0,6,"dummy"
"280333",2,3,0,5,"dummy"
"280334",1,0,0,1,"dummy"
"280335",0,1,0,1,"dummy"
"280336",19,0,1,20,"dummy"
"280337",0,0,1,1,"dummy"
"280338",1,0,0,1,"dummy"
"280339",0,0,1,1,"dummy"
"280341",1,7,1,9,"dummy"
"280342",0,0,1,1,"dummy"
"280343",2,2,2,6,"dummy"
"280344",0,1,2,3,"dummy"
"280345",2,2,1,5,"dummy"
"280346",0,2,0,2,"dummy"
"280347",0,0,1,1,"dummy"
"280350",0,1,0,1,"dummy"
"280353",3,0,0,3,"dummy"
"280360",0,5,1,6,"dummy"
"280361",0,1,3,4,"dummy"
"280367",9,7,1,17,"dummy"
"280368",0,0,1,1,"dummy"
"280369",0,2,0,2,"dummy"
"280370",0,0,0,0,"dummy"
"280371",0,2,0,2,"dummy"
"280372",0,0,1,1,"dummy"
"280373",0,1,0,1,"dummy"
"280374",0,0,0,0,"dummy"
"280375",0,0,0,0,"dummy"
"280376",0,0,0,0,"dummy"
"280377",0,0,0,0,"dummy"
"280378",0,4,0,4,"dummy"
"280379",0,0,0,0,"dummy"
"280380",0,1,0,1,"dummy"
"280384",0,0,2,2,"dummy"
"280385",4,7,1,12,"dummy"
"280386",0,1,2,3,"dummy"
"280387",0,0,1,1,"dummy"
"280388",1,4,0,5,"dummy"
"280389",0,1,0,1,"dummy"
"280390",1,1,2,4,"dummy"
"280391",0,1,1,2,"dummy"
"280392",7,4,1,12,"dummy"
"280393",0,0,0,0,"dummy"
"280394",0,0,0,0,"dummy"
"280395",0,0,0,0,"dummy"
"280396",1,1,0,2,"dummy"
"280397",0,0,1,1,"dummy"
"280398",0,2,0,2,"dummy"
"280399",0,0,1,1,"dummy"
"280400",3,4,1,8,"dummy"
"280403",1,0,0,1,"dummy"
"280404",1,4,0,5,"dummy"
"280405",1,4,1,6,"dummy"
"280406",0,1,0,1,"dummy"
"280407",7,0,0,7,"dummy"
"280408",1,2,0,3,"dummy"
"280409",0,0,0,0,"dummy"
"280411",18,8,4,30,"dummy"
"280412",0,0,0,0,"dummy"
"280413",1,1,0,2,"dummy"
"280414",4,1,0,5,"dummy"
"280415",0,0,1,1,"dummy"
"280420",0,1,0,1,"dummy"
"280421",0,5,0,5,"dummy"
"280422",0,2,0,2,"dummy"
"280423",0,1,0,1,"dummy"
"280424",0,2,0,2,"dummy"
"280425",0,3,0,3,"dummy"
"280426",0,2,0,2,"dummy"
"280427",0,1,0,1,"dummy"
"280429",0,0,1,1,"dummy"
"280430",0,2,0,2,"dummy"
"280431",4,1,0,5,"dummy"
"280432",1,1,0,2,"dummy"
"280435",0,0,2,2,"dummy"
"280439",0,0,1,1,"dummy"
"280440",3,0,1,4,"dummy"
"280442",0,1,0,1,"dummy"
"280445",0,1,2,3,"dummy"
"280446",0,0,0,0,"dummy"
"280447",0,1,0,1,"dummy"
"280448",4,0,2,6,"dummy"
"280449",1,0,0,1,"dummy"
"280450",0,0,0,0,"dummy"
"280451",0,0,0,0,"dummy"
"280453",1,9,1,11,"dummy"
"280454",2,3,0,5,"dummy"
"280455",0,1,0,1,"dummy"
"280456",0,10,0,10,"dummy"
"280457",0,2,0,2,"dummy"
"280458",0,1,0,1,"dummy"
"280459",0,0,0,0,"dummy"
"280460",0,0,1,1,"dummy"
"280461",0,6,0,6,"dummy"
"280462",0,0,0,0,"dummy"
"280463",0,2,0,2,"dummy"
"280464",0,2,0,2,"dummy"
"280465",0,0,1,1,"dummy"
"280467",1,0,0,1,"dummy"
"280470",0,1,0,1,"dummy"
"280471",0,2,0,2,"dummy"
"280472",0,4,1,5,"dummy"
"280475",0,18,0,18,"dummy"
"280476",0,0,2,2,"dummy"
"280478",2,13,1,16,"dummy"
"280479",0,0,0,0,"dummy"
"280481",1,0,0,1,"dummy"
"280488",0,0,0,0,"dummy"
"280506",0,3,2,5,"dummy"
"280507",0,4,0,4,"dummy"
"280508",0,0,0,0,"dummy"
"280509",0,0,1,1,"dummy"
"280510",0,0,1,1,"dummy"
"280511",2,2,0,4,"dummy"
"280513",34,9,5,48,"dummy"
"280515",0,0,0,0,"dummy"
"280516",1,2,0,3,"dummy"
"280517",2,1,0,3,"dummy"
"280518",1,2,0,3,"dummy"
"280519",2,1,1,4,"dummy"
"280520",1,2,1,4,"dummy"
"280521",2,1,1,4,"dummy"
"280527",0,0,1,1,"dummy"
"280528",0,0,1,1,"dummy"
"280529",0,1,0,1,"dummy"
"280532",8,3,6,17,"dummy"
"280533",0,1,1,2,"dummy"
"280534",10,1,4,15,"dummy"
"280536",2,6,3,11,"dummy"
"280538",1,2,0,3,"dummy"
"280539",0,1,0,1,"dummy"
"280540",1,0,0,1,"dummy"
"280541",0,1,0,1,"dummy"
"280542",0,1,1,2,"dummy"
"280543",1,4,0,5,"dummy"
"280544",4,1,0,5,"dummy"
"280548",0,3,0,3,"dummy"
"280550",4,9,1,14,"dummy"
"280551",1,1,3,5,"dummy"
"280552",0,0,1,1,"dummy"
"280553",0,1,2,3,"dummy"
"280555",0,0,0,0,"dummy"
"280557",3,30,0,33,"dummy"
"280558",0,0,1,1,"dummy"
"280559",5,4,1,10,"dummy"
"280560",14,1,3,18,"dummy"
"280561",1,3,0,4,"dummy"
"280562",0,2,0,2,"dummy"
"280563",2,3,0,5,"dummy"
"280564",1,2,0,3,"dummy"
"280566",0,1,0,1,"dummy"
"280567",0,1,0,1,"dummy"
"280576",0,1,0,1,"dummy"
"280577",0,0,1,1,"dummy"
"280578",0,4,0,4,"dummy"
"280579",4,1,0,5,"dummy"
"280580",0,0,1,1,"dummy"
"280581",0,2,0,2,"dummy"
"280582",0,1,0,1,"dummy"
"280583",1,0,0,1,"dummy"
"280584",2,0,0,2,"dummy"
"280585",0,2,0,2,"dummy"
"280586",0,0,1,1,"dummy"
"280587",1,1,3,5,"dummy"
"280588",0,0,1,1,"dummy"
"280589",0,0,1,1,"dummy"
"280590",0,0,4,4,"dummy"
"280598",0,2,0,2,"dummy"
"280599",0,2,1,3,"dummy"
"280602",0,0,0,0,"dummy"
"280603",0,0,1,1,"dummy"
"280604",1,0,0,1,"dummy"
"280605",0,0,1,1,"dummy"
"280606",0,0,1,1,"dummy"
"280607",0,0,1,1,"dummy"
"280608",2,0,1,3,"dummy"
"280610",0,0,1,1,"dummy"
"280611",1,1,0,2,"dummy"
"280612",0,0,1,1,"dummy"
"280613",0,1,0,1,"dummy"
"280614",0,0,0,0,"dummy"
"280615",1,0,1,2,"dummy"
"280616",0,0,0,0,"dummy"
"280617",0,17,4,21,"dummy"
"280618",0,0,0,0,"dummy"
"280620",0,1,0,1,"dummy"
"280623",0,1,0,1,"dummy"
"280626",0,1,0,1,"dummy"
"280627",0,1,0,1,"dummy"
"280631",0,2,0,2,"dummy"
"280632",0,0,0,0,"dummy"
"280633",1,0,1,2,"dummy"
"280636",9,22,4,35,"dummy"
"280637",0,0,1,1,"dummy"
"280638",1,0,1,2,"dummy"
"280639",19,9,1,29,"dummy"
"280640",0,0,2,2,"dummy"
"280641",0,5,0,5,"dummy"
"280642",1,0,1,2,"dummy"
"280643",2,0,1,3,"dummy"
"280644",0,1,0,1,"dummy"
"280645",0,1,0,1,"dummy"
"280646",16,29,8,53,"dummy"
"280647",0,2,1,3,"dummy"
"280648",1,1,0,2,"dummy"
"280649",0,0,1,1,"dummy"
"280650",0,0,1,1,"dummy"
"280651",1,1,0,2,"dummy"
"280652",0,0,3,3,"dummy"
"280653",2,0,1,3,"dummy"
"280661",0,2,0,2,"dummy"
"280662",0,2,0,2,"dummy"
"280663",0,1,0,1,"dummy"
"280664",0,0,3,3,"dummy"
"280665",2,0,0,2,"dummy"
"280666",1,0,0,1,"dummy"
"280667",0,0,2,2,"dummy"
"280669",1,1,0,2,"dummy"
"280670",1,1,0,2,"dummy"
"280671",0,0,1,1,"dummy"
"280672",0,0,1,1,"dummy"
"280673",0,1,0,1,"dummy"
"280675",0,1,0,1,"dummy"
"280676",0,2,0,2,"dummy"
"280679",0,7,0,7,"dummy"
"280680",0,0,1,1,"dummy"
"280681",0,1,0,1,"dummy"
"280682",0,1,0,1,"dummy"
"280683",0,2,0,2,"dummy"
"280687",0,0,1,1,"dummy"
"280688",0,0,1,1,"dummy"
"280689",0,0,1,1,"dummy"
"280690",0,0,1,1,"dummy"
"280691",0,14,1,15,"dummy"
"280692",0,0,1,1,"dummy"
"280693",0,0,1,1,"dummy"
"280694",3,3,4,10,"dummy"
"280695",0,0,1,1,"dummy"
"280696",0,0,1,1,"dummy"
"280697",0,0,1,1,"dummy"
"280698",0,0,2,2,"dummy"
"280699",0,0,1,1,"dummy"
"280700",0,0,1,1,"dummy"
"280701",0,0,1,1,"dummy"
"280702",0,0,1,1,"dummy"
"280703",0,0,1,1,"dummy"
"280704",0,0,1,1,"dummy"
"280705",3,0,1,4,"dummy"
"280706",0,0,1,1,"dummy"
"280707",0,0,1,1,"dummy"
"280708",0,1,1,2,"dummy"
"280709",0,0,1,1,"dummy"
"280710",0,0,1,1,"dummy"
"280711",0,1,1,2,"dummy"
"280712",0,0,2,2,"dummy"
"280713",0,1,1,2,"dummy"
"280714",0,0,1,1,"dummy"
"280715",0,0,1,1,"dummy"
"280716",0,0,1,1,"dummy"
"280717",0,0,1,1,"dummy"
"280718",0,1,1,2,"dummy"
"280719",0,1,1,2,"dummy"
"280720",0,0,1,1,"dummy"
"280721",0,0,2,2,"dummy"
"280722",0,0,1,1,"dummy"
"280723",1,2,1,4,"dummy"
"280724",0,0,1,1,"dummy"
"280725",0,0,1,1,"dummy"
"280726",0,1,0,1,"dummy"
"280727",1,0,0,1,"dummy"
"280728",0,1,0,1,"dummy"
"280729",0,0,1,1,"dummy"
"280730",0,1,1,2,"dummy"
"280731",0,0,1,1,"dummy"
"280732",0,0,1,1,"dummy"
"280733",5,0,1,6,"dummy"
"280734",9,0,1,10,"dummy"
"280735",0,0,1,1,"dummy"
"280736",0,0,1,1,"dummy"
"280737",0,0,1,1,"dummy"
"280738",0,0,1,1,"dummy"
"280739",0,0,1,1,"dummy"
"280740",0,7,2,9,"dummy"
"280741",0,0,1,1,"dummy"
"280742",0,2,1,3,"dummy"
"280743",0,0,2,2,"dummy"
"280744",0,0,2,2,"dummy"
"280745",0,0,2,2,"dummy"
"280746",1,0,1,2,"dummy"
"280747",0,0,1,1,"dummy"
"280748",0,2,1,3,"dummy"
"280749",0,0,1,1,"dummy"
"280750",0,0,2,2,"dummy"
"280751",0,0,2,2,"dummy"
"280752",0,0,2,2,"dummy"
"280753",0,1,0,1,"dummy"
"280754",0,0,1,1,"dummy"
"280755",0,0,1,1,"dummy"
"280756",13,0,3,16,"dummy"
"280757",0,0,1,1,"dummy"
"280758",0,0,1,1,"dummy"
"280759",0,0,1,1,"dummy"
"280760",0,0,1,1,"dummy"
"280761",0,0,1,1,"dummy"
"280762",0,0,2,2,"dummy"
"280763",0,0,1,1,"dummy"
"280764",0,0,1,1,"dummy"
"280765",0,0,1,1,"dummy"
"280786",0,0,1,1,"dummy"
"280787",0,1,3,4,"dummy"
"280791",0,2,0,2,"dummy"
"280792",1,0,3,4,"dummy"
"280793",0,0,1,1,"dummy"
"280794",0,0,1,1,"dummy"
"280795",2,0,1,3,"dummy"
"280796",1,0,0,1,"dummy"
"280797",0,1,0,1,"dummy"
"280798",0,10,2,12,"dummy"
"280799",0,0,1,1,"dummy"
"280800",0,1,0,1,"dummy"
"280801",1,1,3,5,"dummy"
"280802",0,1,2,3,"dummy"
"280803",0,1,0,1,"dummy"
"280804",1,0,0,1,"dummy"
"280805",0,1,0,1,"dummy"
"280806",3,1,0,4,"dummy"
"280807",1,1,0,2,"dummy"
"280808",11,2,3,16,"dummy"
"280809",2,11,3,16,"dummy"
"280810",0,1,0,1,"dummy"
"280811",0,0,0,0,"dummy"
"280815",0,0,1,1,"dummy"
"280816",0,0,1,1,"dummy"
"280817",0,0,1,1,"dummy"
"280818",0,0,0,0,"dummy"
"280819",2,2,1,5,"dummy"
"280824",0,0,0,0,"dummy"
"280825",0,5,2,7,"dummy"
"280826",3,9,1,13,"dummy"
"280841",0,1,3,4,"dummy"
"280842",0,1,1,2,"dummy"
"280865",0,0,1,1,"dummy"
"280866",0,1,1,2,"dummy"
"280867",0,0,1,1,"dummy"
"280868",0,0,3,3,"dummy"
"280871",4,5,0,9,"dummy"
"280872",0,0,1,1,"dummy"
"280873",0,1,1,2,"dummy"
"280874",1,0,1,2,"dummy"
"280875",1,9,0,10,"dummy"
"280876",0,0,0,0,"dummy"
"280877",0,3,0,3,"dummy"
"280878",0,4,0,4,"dummy"
"280879",0,2,0,2,"dummy"
"280886",2,0,0,2,"dummy"
"280887",0,2,0,2,"dummy"
"280890",0,1,0,1,"dummy"
"280891",0,0,1,1,"dummy"
"280892",0,1,0,1,"dummy"
"280893",1,1,0,2,"dummy"
"280894",0,1,1,2,"dummy"
"280895",0,0,1,1,"dummy"
"280896",0,0,1,1,"dummy"
"280897",1,2,1,4,"dummy"
"280898",0,0,1,1,"dummy"
"280899",1,1,1,3,"dummy"
"280771",0,1,0,1,"dummy"
"280772",2,2,0,4,"dummy"
"280773",1,1,1,3,"dummy"
"280774",1,2,1,4,"dummy"
"280775",0,0,5,5,"dummy"
"280778",5,25,2,32,"dummy"
"280779",0,0,1,1,"dummy"
"280780",0,0,1,1,"dummy"
"280781",0,0,1,1,"dummy"
"280784",1,2,0,3,"dummy"
"280789",2,8,1,11,"dummy"
"280813",0,0,1,1,"dummy"
"280821",0,2,0,2,"dummy"
"280822",2,1,2,5,"dummy"
"280844",4,4,0,8,"dummy"
"280847",0,1,0,1,"dummy"
"280848",0,0,0,0,"dummy"
"280849",3,3,0,6,"dummy"
"280850",0,1,0,1,"dummy"
"280851",2,0,0,2,"dummy"
"280852",0,0,3,3,"dummy"
"280853",0,3,0,3,"dummy"
"280854",1,0,0,1,"dummy"
"280855",0,1,0,1,"dummy"
"280856",0,1,1,2,"dummy"
"280857",1,0,1,2,"dummy"
"280858",0,0,0,0,"dummy"
"280859",17,5,0,22,"dummy"
"280860",0,3,0,3,"dummy"
"280861",0,0,0,0,"dummy"
"280862",0,2,0,2,"dummy"
"280863",0,0,0,0,"dummy"
"280881",13,0,0,13,"dummy"
"280884",0,1,0,1,"dummy"
"280918",0,0,0,0,"dummy"
"280951",0,0,1,1,"dummy"
"280974",2,7,1,10,"dummy"
"280975",3,1,1,5,"dummy"
"280976",0,1,1,2,"dummy"
"280977",0,1,1,2,"dummy"
"280978",1,0,0,1,"dummy"
"280979",0,1,0,1,"dummy"
"280980",0,1,3,4,"dummy"
"280981",13,5,3,21,"dummy"
"280982",0,0,2,2,"dummy"
"280983",2,0,0,2,"dummy"
"280984",28,6,2,36,"dummy"
"280985",0,2,0,2,"dummy"
"280986",0,0,1,1,"dummy"
"280987",0,0,1,1,"dummy"
"281030",0,3,1,4,"dummy"
"280900",1,3,1,5,"dummy"
"280901",0,0,1,1,"dummy"
"280902",0,0,2,2,"dummy"
"280903",0,0,2,2,"dummy"
"280904",0,0,1,1,"dummy"
"280905",2,6,0,8,"dummy"
"280906",1,0,1,2,"dummy"
"280907",0,0,2,2,"dummy"
"280908",0,0,1,1,"dummy"
"280909",3,6,9,18,"dummy"
"280910",1,0,0,1,"dummy"
"280916",0,0,1,1,"dummy"
"280920",0,0,2,2,"dummy"
"280937",0,0,0,0,"dummy"
"280938",1,0,0,1,"dummy"
"280939",0,0,1,1,"dummy"
"280940",2,0,0,2,"dummy"
"280941",0,3,0,3,"dummy"
"280942",0,0,1,1,"dummy"
"280943",0,0,0,0,"dummy"
"280944",0,0,0,0,"dummy"
"280945",6,2,0,8,"dummy"
"280946",2,0,0,2,"dummy"
"280947",0,0,0,0,"dummy"
"280948",0,0,0,0,"dummy"
"280949",0,0,1,1,"dummy"
"280955",2,0,0,2,"dummy"
"280956",0,0,0,0,"dummy"
"280963",0,4,0,4,"dummy"
"280964",0,0,0,0,"dummy"
"280965",0,7,0,7,"dummy"
"280966",0,0,1,1,"dummy"
"280967",4,0,0,4,"dummy"
"280970",0,1,0,1,"dummy"
"280971",0,12,0,12,"dummy"
"280972",0,0,1,1,"dummy"
"280989",0,1,0,1,"dummy"
"280990",0,0,1,1,"dummy"
"280991",0,0,1,1,"dummy"
"280992",0,1,0,1,"dummy"
"280993",0,0,1,1,"dummy"
"280994",0,1,0,1,"dummy"
"280995",0,0,0,0,"dummy"
"280996",1,0,0,1,"dummy"
"280997",0,2,0,2,"dummy"
"280998",0,1,0,1,"dummy"
"280999",0,5,0,5,"dummy"
"281000",1,0,0,1,"dummy"
"281001",1,0,0,1,"dummy"
"281002",0,1,0,1,"dummy"
"281003",1,0,0,1,"dummy"
"281008",0,9,0,9,"dummy"
"281009",4,9,0,13,"dummy"
"281014",0,1,1,2,"dummy"
"281015",0,0,1,1,"dummy"
"281016",1,3,1,5,"dummy"
"281017",0,4,0,4,"dummy"
"281018",0,0,1,1,"dummy"
"281019",0,1,0,1,"dummy"
"281020",0,0,1,1,"dummy"
"281021",3,0,1,4,"dummy"
"281022",0,4,0,4,"dummy"
"281023",0,0,1,1,"dummy"
"281024",0,8,2,10,"dummy"
"281027",2,11,1,14,"dummy"
"281028",0,1,0,1,"dummy"
"281032",2,0,3,5,"dummy"
"281037",2,1,1,4,"dummy"
"281038",0,1,0,1,"dummy"
"281039",0,0,1,1,"dummy"
"281079",2,0,1,3,"dummy"
"281080",1,28,1,30,"dummy"
"281081",0,3,1,4,"dummy"
"281082",18,19,2,39,"dummy"
"281087",0,0,1,1,"dummy"
"281088",6,0,2,8,"dummy"
"281089",1,2,1,4,"dummy"
"281090",0,0,1,1,"dummy"
"281091",0,0,1,1,"dummy"
"281119",1,0,0,1,"dummy"
"281120",0,0,1,1,"dummy"
"281121",0,1,0,1,"dummy"
"281122",2,0,1,3,"dummy"
"281123",0,0,4,4,"dummy"
"281124",0,1,0,1,"dummy"
"281084",0,0,1,1,"dummy"
"281085",0,2,1,3,"dummy"
"281165",2,0,0,2,"dummy"
"281166",0,4,0,4,"dummy"
"281188",0,3,0,3,"dummy"
"281189",2,2,0,4,"dummy"
"281190",0,10,0,10,"dummy"
"281191",0,2,0,2,"dummy"
"281192",1,0,0,1,"dummy"
"281193",39,21,0,60,"dummy"
"281194",1,0,0,1,"dummy"
"281195",0,8,0,8,"dummy"
"281196",0,8,0,8,"dummy"
"281197",1,0,1,2,"dummy"
"281198",3,1,0,4,"dummy"
"281199",0,0,1,1,"dummy"
"281200",0,6,0,6,"dummy"
"281201",0,3,0,3,"dummy"
"281202",3,3,1,7,"dummy"
"281203",1,0,0,1,"dummy"
"281204",4,8,1,13,"dummy"
"281205",3,3,0,6,"dummy"
"281206",0,2,0,2,"dummy"
"281207",0,0,1,1,"dummy"
"281208",10,5,4,19,"dummy"
"281209",0,2,0,2,"dummy"
"281210",0,1,0,1,"dummy"
"281211",0,4,0,4,"dummy"
"281212",0,1,0,1,"dummy"
"281213",0,0,1,1,"dummy"
"281214",0,0,1,1,"dummy"
"281215",0,0,1,1,"dummy"
"281216",2,4,0,6,"dummy"
"281234",0,0,1,1,"dummy"
"281239",0,34,0,34,"dummy"
"281240",2,7,0,9,"dummy"
"281241",1,0,0,1,"dummy"
"281242",1,0,0,1,"dummy"
"281243",29,29,1,59,"dummy"
"281244",3,3,0,6,"dummy"
"281245",2,1,0,3,"dummy"
"281246",4,4,0,8,"dummy"
"281247",16,17,0,33,"dummy"
"281248",0,0,2,2,"dummy"
"281249",0,0,2,2,"dummy"
"281250",0,2,1,3,"dummy"
"281251",0,0,2,2,"dummy"
"281252",0,0,2,2,"dummy"
"281253",0,0,1,1,"dummy"
"281266",0,0,0,0,"dummy"
"281280",0,0,1,1,"dummy"
"281296",0,5,1,6,"dummy"
"281297",0,0,2,2,"dummy"
"281298",4,1,0,5,"dummy"
"281299",6,7,1,14,"dummy"
"281300",0,0,1,1,"dummy"
"281307",0,0,1,1,"dummy"
"281341",0,0,1,1,"dummy"
"281342",3,2,0,5,"dummy"
"281343",1,2,3,6,"dummy"
"281125",0,1,0,1,"dummy"
"281126",1,2,0,3,"dummy"
"281127",0,1,0,1,"dummy"
"281128",0,0,1,1,"dummy"
"281129",0,5,0,5,"dummy"
"281130",0,3,0,3,"dummy"
"281131",0,1,0,1,"dummy"
"281132",0,2,1,3,"dummy"
"281133",0,2,0,2,"dummy"
"281134",0,1,0,1,"dummy"
"281135",2,0,0,2,"dummy"
"281136",2,0,1,3,"dummy"
"281137",0,1,0,1,"dummy"
"281138",0,0,1,1,"dummy"
"281139",0,0,1,1,"dummy"
"281140",0,1,0,1,"dummy"
"281141",0,1,0,1,"dummy"
"281142",11,4,0,15,"dummy"
"281143",0,1,0,1,"dummy"
"281144",1,4,1,6,"dummy"
"281145",4,1,1,6,"dummy"
"281146",1,0,0,1,"dummy"
"281147",1,0,0,1,"dummy"
"281148",2,3,0,5,"dummy"
"281149",0,0,1,1,"dummy"
"281150",0,1,1,2,"dummy"
"281151",0,0,1,1,"dummy"
"281152",0,0,1,1,"dummy"
"281153",0,0,1,1,"dummy"
"281154",0,0,1,1,"dummy"
"281155",0,0,1,1,"dummy"
"281156",1,0,2,3,"dummy"
"281157",0,1,1,2,"dummy"
"281158",1,0,0,1,"dummy"
"281159",0,0,1,1,"dummy"
"281160",0,0,1,1,"dummy"
"281161",0,0,1,1,"dummy"
"281162",0,0,1,1,"dummy"
"281163",1,0,0,1,"dummy"
"281168",0,0,0,0,"dummy"
"281169",1,4,1,6,"dummy"
"281170",8,5,3,16,"dummy"
"281171",2,5,2,9,"dummy"
"281172",0,1,0,1,"dummy"
"281173",3,9,0,12,"dummy"
"281174",1,0,0,1,"dummy"
"281179",2,2,0,4,"dummy"
"281180",0,1,0,1,"dummy"
"281183",1,6,1,8,"dummy"
"281184",4,0,0,4,"dummy"
"281185",0,0,0,0,"dummy"
"281186",0,0,0,0,"dummy"
"281222",3,1,1,5,"dummy"
"281227",4,2,2,8,"dummy"
"281228",0,1,0,1,"dummy"
"281229",0,1,0,1,"dummy"
"281230",0,4,0,4,"dummy"
"281231",0,1,0,1,"dummy"
"281232",6,1,1,8,"dummy"
"281255",0,1,1,2,"dummy"
"281256",0,0,1,1,"dummy"
"281257",0,1,1,2,"dummy"
"281260",2,4,0,6,"dummy"
"281261",0,2,0,2,"dummy"
"281262",0,2,0,2,"dummy"
"281263",10,2,0,12,"dummy"
"281264",0,2,0,2,"dummy"
"281268",2,7,1,10,"dummy"
"281269",12,8,4,24,"dummy"
"281270",6,14,5,25,"dummy"
"281271",0,1,1,2,"dummy"
"281272",11,4,5,20,"dummy"
"281273",0,0,1,1,"dummy"
"281274",0,0,1,1,"dummy"
"281275",2,0,0,2,"dummy"
"281276",4,0,0,4,"dummy"
"281277",0,0,1,1,"dummy"
"281278",0,1,0,1,"dummy"
"281289",0,0,1,1,"dummy"
"281290",0,2,0,2,"dummy"
"281291",0,0,1,1,"dummy"
"281292",1,1,1,3,"dummy"
"281293",3,0,0,3,"dummy"
"281294",0,0,1,1,"dummy"
"281305",0,0,1,1,"dummy"
"281338",11,17,0,28,"dummy"
"281339",0,3,2,5,"dummy"
"281347",0,0,0,0,"dummy"
"281348",0,1,0,1,"dummy"
"281349",1,0,0,1,"dummy"
"281368",0,1,0,1,"dummy"
"281369",1,1,0,2,"dummy"
"281375",3,7,2,12,"dummy"
"281376",0,2,0,2,"dummy"
"281377",3,2,0,5,"dummy"
"281380",38,8,9,55,"dummy"
"281393",0,2,1,3,"dummy"
"281398",0,1,0,1,"dummy"
"281405",7,3,2,12,"dummy"
"281406",0,0,1,1,"dummy"
"281410",0,0,2,2,"dummy"
"281411",3,5,0,8,"dummy"
"281412",0,1,1,2,"dummy"
"281413",19,12,6,37,"dummy"
"281418",0,1,0,1,"dummy"
"281419",0,0,1,1,"dummy"
"281420",0,0,1,1,"dummy"
"281421",0,0,1,1,"dummy"
"281422",0,0,1,1,"dummy"
"281450",0,1,0,1,"dummy"
"281499",1,3,3,7,"dummy"
"281500",0,2,0,2,"dummy"
"281501",11,5,4,20,"dummy"
"281507",0,0,1,1,"dummy"
"281508",0,0,0,0,"dummy"
"281514",1,1,2,4,"dummy"
"281515",0,5,0,5,"dummy"
"281516",0,3,0,3,"dummy"
"281517",0,0,1,1,"dummy"
"281549",0,0,1,1,"dummy"
"281553",0,0,1,1,"dummy"
"281554",0,0,0,0,"dummy"
"281559",12,19,3,34,"dummy"
"281589",4,13,0,17,"dummy"
"281590",3,3,1,7,"dummy"
"281604",1,0,0,1,"dummy"
"281605",0,6,0,6,"dummy"
"281606",0,1,0,1,"dummy"
"281607",0,0,1,1,"dummy"
"281608",0,0,1,1,"dummy"
"281613",0,4,1,5,"dummy"
"281614",0,0,1,1,"dummy"
"281344",0,0,1,1,"dummy"
"281345",1,0,1,2,"dummy"
"281351",0,0,0,0,"dummy"
"281352",0,0,1,1,"dummy"
"281353",0,1,0,1,"dummy"
"281354",0,1,0,1,"dummy"
"281364",0,0,0,0,"dummy"
"281371",0,12,0,12,"dummy"
"281372",0,0,1,1,"dummy"
"281373",0,1,0,1,"dummy"
"281382",6,4,0,10,"dummy"
"281383",0,2,0,2,"dummy"
"281384",2,0,0,2,"dummy"
"281387",0,0,1,1,"dummy"
"281400",0,0,0,0,"dummy"
"281401",0,0,0,0,"dummy"
"281408",0,0,1,1,"dummy"
"281415",0,2,2,4,"dummy"
"281416",2,6,0,8,"dummy"
"281428",5,5,0,10,"dummy"
"281429",1,4,1,6,"dummy"
"281430",1,0,1,2,"dummy"
"281431",0,0,2,2,"dummy"
"281432",0,2,0,2,"dummy"
"281433",1,0,0,1,"dummy"
"281434",0,1,1,2,"dummy"
"281435",0,20,0,20,"dummy"
"281436",0,4,0,4,"dummy"
"281437",0,0,0,0,"dummy"
"281448",0,0,0,0,"dummy"
"281452",0,2,1,3,"dummy"
"281453",0,0,3,3,"dummy"
"281493",1,6,2,9,"dummy"
"281494",0,1,0,1,"dummy"
"281503",0,0,1,1,"dummy"
"281510",2,2,1,5,"dummy"
"281519",5,0,2,7,"dummy"
"281520",0,0,0,0,"dummy"
"281546",0,4,0,4,"dummy"
"281547",0,1,0,1,"dummy"
"281551",0,1,1,2,"dummy"
"281561",1,0,0,1,"dummy"
"281570",0,0,0,0,"dummy"
"281571",0,2,0,2,"dummy"
"281572",0,2,0,2,"dummy"
"281573",0,1,0,1,"dummy"
"281585",0,0,1,1,"dummy"
"281586",0,0,0,0,"dummy"
"281587",0,0,1,1,"dummy"
"281602",16,5,3,24,"dummy"
"281632",5,0,0,5,"dummy"
"281634",0,0,1,1,"dummy"
"281635",1,0,0,1,"dummy"
"281636",0,0,1,1,"dummy"
"281637",1,4,0,5,"dummy"
"281639",0,0,0,0,"dummy"
"281640",0,2,0,2,"dummy"
"281641",0,2,0,2,"dummy"
"281642",0,1,0,1,"dummy"
"281650",1,0,1,2,"dummy"
"281652",3,1,2,6,"dummy"
"281656",0,0,1,1,"dummy"
"281675",0,1,0,1,"dummy"
"281676",0,0,1,1,"dummy"
"281677",1,5,1,7,"dummy"
"281679",2,0,3,5,"dummy"
"281681",0,3,0,3,"dummy"
"281682",0,0,1,1,"dummy"
"281683",0,10,0,10,"dummy"
"281684",2,10,0,12,"dummy"
"281687",0,1,0,1,"dummy"
"281688",1,2,1,4,"dummy"
"281689",2,1,0,3,"dummy"
"281690",0,3,1,4,"dummy"
"281691",0,0,1,1,"dummy"
"281692",1,3,0,4,"dummy"
"281693",1,3,1,5,"dummy"
"281694",1,0,0,1,"dummy"
"281695",3,9,1,13,"dummy"
"281699",3,13,1,17,"dummy"
"281700",11,3,0,14,"dummy"
"281701",0,4,0,4,"dummy"
"281702",4,0,0,4,"dummy"
"281706",0,4,0,4,"dummy"
"281707",0,0,0,0,"dummy"
"281714",0,0,1,1,"dummy"
"281715",4,10,3,17,"dummy"
"281716",1,4,0,5,"dummy"
"281733",0,0,0,0,"dummy"
"281734",1,7,0,8,"dummy"
"281735",2,0,0,2,"dummy"
"281737",0,1,0,1,"dummy"
"281738",0,1,0,1,"dummy"
"281740",0,2,0,2,"dummy"
"281741",0,0,1,1,"dummy"
"281742",0,0,1,1,"dummy"
"281743",0,1,0,1,"dummy"
"281744",0,0,1,1,"dummy"
"281745",0,0,1,1,"dummy"
"281746",0,0,1,1,"dummy"
"281747",0,0,1,1,"dummy"
"281748",0,0,1,1,"dummy"
"281749",0,0,1,1,"dummy"
"281750",1,0,2,3,"dummy"
"281751",0,0,1,1,"dummy"
"281752",12,1,1,14,"dummy"
"281753",0,0,1,1,"dummy"
"281754",0,0,1,1,"dummy"
"281755",0,1,0,1,"dummy"
"281756",1,2,0,3,"dummy"
"281757",0,0,1,1,"dummy"
"281758",0,0,1,1,"dummy"
"281759",3,4,2,9,"dummy"
"281760",0,0,1,1,"dummy"
"281761",0,0,3,3,"dummy"
"281762",0,0,1,1,"dummy"
"281763",0,0,1,1,"dummy"
"281764",0,0,1,1,"dummy"
"281765",0,0,1,1,"dummy"
"281766",0,0,1,1,"dummy"
"281767",0,0,1,1,"dummy"
"281768",0,0,1,1,"dummy"
"281770",0,0,1,1,"dummy"
"281781",6,0,2,8,"dummy"
"281787",0,0,0,0,"dummy"
"281788",3,7,0,10,"dummy"
"281789",4,4,1,9,"dummy"
"281790",5,0,1,6,"dummy"
"281791",0,1,0,1,"dummy"
"281792",0,0,1,1,"dummy"
"281793",2,0,1,3,"dummy"
"281794",0,0,1,1,"dummy"
"281798",0,1,0,1,"dummy"
"281800",0,0,1,1,"dummy"
"281802",5,1,0,6,"dummy"
"281803",0,10,1,11,"dummy"
"281805",0,1,0,1,"dummy"
"281811",3,1,0,4,"dummy"
"281812",0,1,1,2,"dummy"
"281814",0,1,0,1,"dummy"
"281816",0,1,0,1,"dummy"
"281817",0,1,0,1,"dummy"
"281818",0,1,0,1,"dummy"
"281820",0,0,1,1,"dummy"
"281821",0,0,1,1,"dummy"
"281822",0,0,2,2,"dummy"
"281823",26,3,7,36,"dummy"
"281825",1,0,1,2,"dummy"
"281826",0,27,2,29,"dummy"
"281827",0,1,0,1,"dummy"
"281828",0,1,0,1,"dummy"
"281829",0,2,0,2,"dummy"
"281831",0,0,3,3,"dummy"
"281832",0,1,0,1,"dummy"
"281833",0,2,1,3,"dummy"
"281834",5,1,5,11,"dummy"
"281837",0,1,1,2,"dummy"
"281838",0,0,1,1,"dummy"
"281839",0,0,1,1,"dummy"
"281840",0,0,1,1,"dummy"
"281842",0,0,0,0,"dummy"
"281843",0,0,0,0,"dummy"
"281846",0,1,1,2,"dummy"
"281848",0,1,0,1,"dummy"
"281851",0,0,3,3,"dummy"
"281859",0,2,0,2,"dummy"
"281860",2,0,0,2,"dummy"
"281861",0,1,0,1,"dummy"
"281863",5,2,5,12,"dummy"
"281870",0,0,1,1,"dummy"
"281871",0,0,3,3,"dummy"
"281874",0,2,3,5,"dummy"
"281875",2,6,2,10,"dummy"
"281877",3,2,1,6,"dummy"
"281880",0,3,0,3,"dummy"
"281881",0,1,0,1,"dummy"
"281882",0,1,0,1,"dummy"
"281888",1,0,2,3,"dummy"
"281890",0,0,2,2,"dummy"
"281891",0,0,2,2,"dummy"
"281893",5,1,1,7,"dummy"
"281894",0,5,4,9,"dummy"
"281895",0,0,0,0,"dummy"
"281896",5,8,1,14,"dummy"
"281897",9,5,1,15,"dummy"
"281898",5,8,1,14,"dummy"
"281899",17,3,3,23,"dummy"
"281900",15,5,3,23,"dummy"
"281901",0,3,0,3,"dummy"
"281902",1,1,9,11,"dummy"
"281904",1,4,1,6,"dummy"
"281905",2,3,4,9,"dummy"
"281906",3,2,4,9,"dummy"
"281911",0,6,0,6,"dummy"
"281912",0,0,1,1,"dummy"
"281915",3,0,0,3,"dummy"
"281916",0,0,1,1,"dummy"
"281917",1,0,0,1,"dummy"
"281918",4,4,1,9,"dummy"
"281919",1,0,0,1,"dummy"
"281920",0,0,5,5,"dummy"
"281923",2,3,2,7,"dummy"
"281924",0,1,0,1,"dummy"
"281925",1,0,0,1,"dummy"
"281926",0,3,0,3,"dummy"
"281927",3,0,0,3,"dummy"
"281928",0,1,1,2,"dummy"
"281929",1,6,0,7,"dummy"
"281930",0,1,0,1,"dummy"
"281932",12,1,2,15,"dummy"
"281933",0,0,3,3,"dummy"
"281937",0,2,0,2,"dummy"
"281938",1,0,0,1,"dummy"
"281939",0,0,0,0,"dummy"
"281940",0,0,0,0,"dummy"
"281941",2,3,0,5,"dummy"
"281942",3,0,0,3,"dummy"
"281943",0,3,0,3,"dummy"
"281944",0,0,0,0,"dummy"
"281949",1,10,1,12,"dummy"
"281950",0,5,1,6,"dummy"
"281951",7,2,1,10,"dummy"
"281952",0,0,2,2,"dummy"
"281953",14,13,5,32,"dummy"
"281957",0,0,0,0,"dummy"
"281958",0,0,2,2,"dummy"
"281960",0,0,1,1,"dummy"
"281961",0,0,1,1,"dummy"
"281964",1,0,0,1,"dummy"
"281965",0,0,1,1,"dummy"
"281966",0,2,0,2,"dummy"
"281967",3,9,1,13,"dummy"
"281968",1,16,0,17,"dummy"
"281969",0,0,1,1,"dummy"
"281970",1,1,0,2,"dummy"
"281971",0,0,1,1,"dummy"
"281972",3,1,1,5,"dummy"
"281973",2,2,1,5,"dummy"
"281974",0,1,0,1,"dummy"
"281975",0,0,2,2,"dummy"
"281977",8,4,0,12,"dummy"
"281978",5,5,0,10,"dummy"
"281981",0,0,1,1,"dummy"
"281982",2,3,3,8,"dummy"
"281983",6,7,2,15,"dummy"
"281984",0,0,5,5,"dummy"
"281985",0,0,3,3,"dummy"
"281986",0,0,2,2,"dummy"
"281987",0,0,3,3,"dummy"
"281989",1,2,0,3,"dummy"
"281990",2,1,0,3,"dummy"
"281995",0,0,2,2,"dummy"
"281996",0,0,2,2,"dummy"
"281997",0,2,0,2,"dummy"
"281998",0,0,1,1,"dummy"
"282007",0,0,2,2,"dummy"
"282009",0,1,1,2,"dummy"
"282010",0,1,0,1,"dummy"
"282011",0,0,1,1,"dummy"
"282012",5,15,0,20,"dummy"
"282014",0,4,2,6,"dummy"
"282016",2,4,3,9,"dummy"
"282017",0,1,0,1,"dummy"
"282018",0,3,1,4,"dummy"
"282020",3,6,2,11,"dummy"
"282022",1,0,0,1,"dummy"
"282023",0,0,0,0,"dummy"
"282035",3,2,4,9,"dummy"
"282036",0,2,0,2,"dummy"
"282037",1,7,0,8,"dummy"
"282038",6,26,4,36,"dummy"
"282039",0,3,0,3,"dummy"
"282040",0,0,1,1,"dummy"
"282042",1,1,0,2,"dummy"
"282043",0,0,1,1,"dummy"
"282050",1,0,0,1,"dummy"
"282053",0,1,0,1,"dummy"
"282054",0,2,1,3,"dummy"
"282055",0,1,0,1,"dummy"
"282058",0,1,0,1,"dummy"
"282084",0,1,0,1,"dummy"
"282085",0,0,0,0,"dummy"
"282086",0,1,0,1,"dummy"
"282087",0,0,0,0,"dummy"
"282088",0,1,0,1,"dummy"
"282089",0,0,3,3,"dummy"
"282090",0,0,3,3,"dummy"
"282091",2,5,0,7,"dummy"
"282092",1,0,0,1,"dummy"
"282093",0,0,0,0,"dummy"
"282094",0,2,0,2,"dummy"
"282095",0,1,1,2,"dummy"
"282097",0,0,2,2,"dummy"
"282098",2,0,0,2,"dummy"
"282099",2,0,0,2,"dummy"
"282100",0,3,1,4,"dummy"
"282102",0,0,1,1,"dummy"
"282103",1,0,0,1,"dummy"
"282104",0,1,1,2,"dummy"
"282124",0,7,0,7,"dummy"
"282126",0,1,2,3,"dummy"
"282127",0,0,0,0,"dummy"
"282128",0,1,0,1,"dummy"
"282129",4,0,2,6,"dummy"
"282130",1,0,0,1,"dummy"
"282131",0,0,0,0,"dummy"
"282133",6,0,3,9,"dummy"
"282134",0,0,3,3,"dummy"
"282168",0,0,1,1,"dummy"
"282175",1,0,2,3,"dummy"
"282189",4,3,2,9,"dummy"
"282190",0,1,0,1,"dummy"
"282191",2,6,0,8,"dummy"
"282192",6,3,0,9,"dummy"
"282193",9,0,0,9,"dummy"
"282194",1,6,1,8,"dummy"
"282195",1,3,4,8,"dummy"
"282196",2,0,0,2,"dummy"
"282197",0,0,2,2,"dummy"
"282203",5,6,1,12,"dummy"
"282204",0,2,0,2,"dummy"
"282205",0,1,0,1,"dummy"
"282206",0,1,0,1,"dummy"
"282207",3,3,0,6,"dummy"
"282208",0,0,0,0,"dummy"
"282209",0,3,0,3,"dummy"
"282210",1,0,0,1,"dummy"
"282211",0,0,0,0,"dummy"
"282212",0,0,1,1,"dummy"
"282213",0,12,0,12,"dummy"
"282214",2,0,0,2,"dummy"
"282215",10,6,1,17,"dummy"
"282225",0,0,2,2,"dummy"
"282226",0,0,0,0,"dummy"
"282227",1,0,0,1,"dummy"
"282228",1,3,3,7,"dummy"
"282229",0,0,2,2,"dummy"
"282230",0,0,1,1,"dummy"
"282231",0,0,2,2,"dummy"
"282242",5,2,1,8,"dummy"
"282243",2,2,0,4,"dummy"
"282244",0,2,0,2,"dummy"
"282245",0,6,0,6,"dummy"
"282246",0,2,0,2,"dummy"
"282247",0,2,0,2,"dummy"
"282248",0,2,0,2,"dummy"
"282249",4,7,0,11,"dummy"
"282250",0,4,0,4,"dummy"
"282251",0,2,0,2,"dummy"
"282252",6,0,0,6,"dummy"
"282253",0,3,0,3,"dummy"
"282254",0,0,2,2,"dummy"
"282255",1,3,0,4,"dummy"
"282256",0,0,1,1,"dummy"
"282257",7,0,3,10,"dummy"
"282258",0,0,1,1,"dummy"
"282259",0,0,1,1,"dummy"
"282260",0,0,1,1,"dummy"
"282261",0,0,1,1,"dummy"
"282262",0,0,1,1,"dummy"
"282263",0,0,1,1,"dummy"
"282264",0,0,1,1,"dummy"
"282265",10,17,0,27,"dummy"
"282270",0,0,1,1,"dummy"
"282320",0,0,1,1,"dummy"
"282321",0,0,1,1,"dummy"
"282322",0,2,0,2,"dummy"
"282326",0,2,0,2,"dummy"
"282327",0,0,1,1,"dummy"
"282328",1,1,0,2,"dummy"
"282329",0,0,1,1,"dummy"
"282332",0,0,2,2,"dummy"
"282333",2,1,1,4,"dummy"
"282358",0,0,1,1,"dummy"
"282371",1,0,0,1,"dummy"
"282381",0,1,0,1,"dummy"
"282420",9,21,0,30,"dummy"
"282423",1,6,0,7,"dummy"
"282160",4,7,14,25,"dummy"
"282161",5,1,9,15,"dummy"
"282162",1,0,2,3,"dummy"
"282163",0,0,2,2,"dummy"
"282164",0,0,1,1,"dummy"
"282165",0,2,4,6,"dummy"
"282166",0,3,3,6,"dummy"
"282172",7,0,1,8,"dummy"
"282173",0,0,0,0,"dummy"
"282177",21,18,1,40,"dummy"
"282178",1,1,0,2,"dummy"
"282179",0,2,0,2,"dummy"
"282184",0,0,0,0,"dummy"
"282185",0,0,1,1,"dummy"
"282199",4,0,1,5,"dummy"
"282200",0,0,0,0,"dummy"
"282201",0,2,0,2,"dummy"
"282217",0,5,0,5,"dummy"
"282218",7,1,0,8,"dummy"
"282219",0,6,0,6,"dummy"
"282220",1,0,0,1,"dummy"
"282221",0,2,0,2,"dummy"
"282233",1,0,0,1,"dummy"
"282236",0,0,1,1,"dummy"
"282267",6,0,0,6,"dummy"
"282268",2,5,2,9,"dummy"
"282272",0,0,0,0,"dummy"
"282273",20,1,0,21,"dummy"
"282274",0,0,0,0,"dummy"
"282275",1,0,4,5,"dummy"
"282283",3,3,0,6,"dummy"
"282284",2,8,4,14,"dummy"
"282285",0,0,1,1,"dummy"
"282286",0,0,1,1,"dummy"
"282287",0,0,1,1,"dummy"
"282290",2,2,0,4,"dummy"
"282291",0,1,0,1,"dummy"
"282292",4,0,0,4,"dummy"
"282293",0,0,1,1,"dummy"
"282294",0,0,1,1,"dummy"
"282295",0,1,1,2,"dummy"
"282296",0,0,1,1,"dummy"
"282297",0,0,2,2,"dummy"
"282298",0,0,1,1,"dummy"
"282299",0,0,1,1,"dummy"
"282300",0,0,1,1,"dummy"
"282301",0,0,2,2,"dummy"
"282302",0,0,1,1,"dummy"
"282303",0,0,2,2,"dummy"
"282304",0,0,1,1,"dummy"
"282309",0,0,0,0,"dummy"
"282310",0,0,1,1,"dummy"
"282311",0,1,0,1,"dummy"
"282312",0,0,1,1,"dummy"
"282313",0,1,0,1,"dummy"
"282314",0,0,1,1,"dummy"
"282315",0,1,0,1,"dummy"
"282316",1,0,0,1,"dummy"
"282324",0,0,0,0,"dummy"
"282335",0,0,0,0,"dummy"
"282336",2,0,0,2,"dummy"
"282337",0,3,1,4,"dummy"
"282338",0,0,1,1,"dummy"
"282339",1,0,0,1,"dummy"
"282340",1,0,0,1,"dummy"
"282341",0,1,0,1,"dummy"
"282342",1,0,0,1,"dummy"
"282343",0,1,0,1,"dummy"
"282344",1,0,0,1,"dummy"
"282345",2,0,0,2,"dummy"
"282346",0,0,3,3,"dummy"
"282347",0,5,0,5,"dummy"
"282348",0,3,0,3,"dummy"
"282349",3,0,0,3,"dummy"
"282350",3,0,0,3,"dummy"
"282351",1,0,0,1,"dummy"
"282352",0,3,0,3,"dummy"
"282353",0,1,0,1,"dummy"
"282354",5,3,0,8,"dummy"
"282364",3,0,1,4,"dummy"
"282365",0,1,0,1,"dummy"
"282366",0,2,0,2,"dummy"
"282367",1,0,0,1,"dummy"
"282368",10,9,0,19,"dummy"
"282369",3,2,0,5,"dummy"
"282373",6,0,3,9,"dummy"
"282385",0,2,0,2,"dummy"
"282386",0,1,0,1,"dummy"
"282387",0,0,1,1,"dummy"
"282388",0,0,1,1,"dummy"
"282389",1,4,0,5,"dummy"
"282390",0,1,0,1,"dummy"
"282391",0,1,0,1,"dummy"
"282392",0,1,0,1,"dummy"
"282393",0,1,0,1,"dummy"
"282394",0,1,0,1,"dummy"
"282395",1,5,0,6,"dummy"
"282396",5,0,0,5,"dummy"
"282397",6,2,0,8,"dummy"
"282415",1,4,1,6,"dummy"
"282416",11,5,1,17,"dummy"
"282417",1,0,1,2,"dummy"
"282418",3,0,0,3,"dummy"
"282425",2,2,1,5,"dummy"
"282439",0,0,0,0,"dummy"
"282440",0,1,1,2,"dummy"
"282441",0,0,0,0,"dummy"
"282442",1,1,1,3,"dummy"
"282443",3,1,0,4,"dummy"
"282444",0,0,0,0,"dummy"
"282445",6,0,0,6,"dummy"
"282448",0,1,0,1,"dummy"
"282484",0,0,1,1,"dummy"
"282485",4,3,2,9,"dummy"
"282495",0,1,3,4,"dummy"
"282503",0,0,3,3,"dummy"
"282510",0,0,0,0,"dummy"
"282514",0,0,1,1,"dummy"
"282515",0,0,1,1,"dummy"
"282516",0,0,3,3,"dummy"
"282517",1,0,1,2,"dummy"
"282536",8,1,2,11,"dummy"
"282558",1,0,0,1,"dummy"
"282567",0,0,0,0,"dummy"
"282568",0,0,0,0,"dummy"
"282571",0,0,1,1,"dummy"
"282574",0,0,3,3,"dummy"
"282575",0,2,1,3,"dummy"
"282576",2,1,0,3,"dummy"
"282577",0,0,1,1,"dummy"
"282578",0,0,1,1,"dummy"
"282579",2,0,1,3,"dummy"
"282597",0,2,0,2,"dummy"
"282598",6,2,0,8,"dummy"
"282599",0,0,0,0,"dummy"
"282600",0,1,0,1,"dummy"
"282601",0,19,1,20,"dummy"
"282602",1,1,0,2,"dummy"
"282603",6,8,3,17,"dummy"
"282604",0,1,0,1,"dummy"
"282605",1,2,0,3,"dummy"
"282606",0,1,0,1,"dummy"
"282607",0,0,0,0,"dummy"
"282608",0,0,0,0,"dummy"
"282609",0,6,1,7,"dummy"
"282610",20,1,1,22,"dummy"
"282611",0,5,0,5,"dummy"
"282612",2,0,0,2,"dummy"
"282618",6,9,0,15,"dummy"
"282619",0,1,0,1,"dummy"
"282620",0,0,0,0,"dummy"
"282621",2,11,1,14,"dummy"
"282622",2,2,0,4,"dummy"
"282623",0,1,0,1,"dummy"
"282624",0,1,0,1,"dummy"
"282625",3,6,0,9,"dummy"
"282626",0,2,1,3,"dummy"
"282627",0,1,0,1,"dummy"
"282628",2,3,0,5,"dummy"
"282433",0,0,0,0,"dummy"
"282477",0,0,1,1,"dummy"
"282478",0,0,0,0,"dummy"
"282487",0,0,1,1,"dummy"
"282488",0,0,1,1,"dummy"
"282489",0,0,1,1,"dummy"
"282490",0,0,1,1,"dummy"
"282491",0,0,1,1,"dummy"
"282492",9,3,0,12,"dummy"
"282493",0,0,1,1,"dummy"
"282497",0,0,0,0,"dummy"
"282498",0,1,0,1,"dummy"
"282499",0,2,0,2,"dummy"
"282500",0,0,3,3,"dummy"
"282501",0,0,2,2,"dummy"
"282505",0,0,1,1,"dummy"
"282508",0,0,1,1,"dummy"
"282512",1,1,0,2,"dummy"
"282519",1,0,5,6,"dummy"
"282520",24,14,5,43,"dummy"
"282521",8,7,4,19,"dummy"
"282522",2,3,1,6,"dummy"
"282523",0,2,0,2,"dummy"
"282524",2,3,0,5,"dummy"
"282525",1,2,0,3,"dummy"
"282526",2,1,0,3,"dummy"
"282527",0,1,0,1,"dummy"
"282528",2,6,3,11,"dummy"
"282529",4,7,2,13,"dummy"
"282530",0,0,1,1,"dummy"
"282531",0,0,2,2,"dummy"
"282532",4,4,1,9,"dummy"
"282533",0,4,0,4,"dummy"
"282534",0,2,0,2,"dummy"
"282538",14,50,4,68,"dummy"
"282539",50,14,4,68,"dummy"
"282540",0,2,0,2,"dummy"
"282541",1,0,0,1,"dummy"
"282542",12,17,4,33,"dummy"
"282543",10,10,1,21,"dummy"
"282544",10,10,1,21,"dummy"
"282545",10,10,1,21,"dummy"
"282546",7,6,1,14,"dummy"
"282547",0,3,0,3,"dummy"
"282548",2,2,0,4,"dummy"
"282549",2,2,0,4,"dummy"
"282550",2,2,0,4,"dummy"
"282551",2,2,0,4,"dummy"
"282552",0,2,0,2,"dummy"
"282553",0,9,0,9,"dummy"
"282554",0,3,0,3,"dummy"
"282555",0,2,0,2,"dummy"
"282556",4,17,0,21,"dummy"
"282581",1,3,5,9,"dummy"
"282582",0,1,0,1,"dummy"
"282583",0,12,0,12,"dummy"
"282584",0,7,0,7,"dummy"
"282585",0,1,0,1,"dummy"
"282586",0,0,1,1,"dummy"
"282587",0,1,0,1,"dummy"
"282588",0,0,1,1,"dummy"
"282589",21,1,1,23,"dummy"
"282616",0,0,1,1,"dummy"
"282686",0,0,1,1,"dummy"
"282695",7,25,2,34,"dummy"
"282696",0,0,0,0,"dummy"
"282703",0,1,0,1,"dummy"
"282704",0,0,0,0,"dummy"
"282705",0,3,0,3,"dummy"
"282706",0,0,0,0,"dummy"
"282707",0,0,1,1,"dummy"
"282708",0,2,0,2,"dummy"
"282709",0,0,0,0,"dummy"
"282710",0,1,0,1,"dummy"
"282711",0,2,0,2,"dummy"
"282712",0,0,1,1,"dummy"
"282713",1,0,0,1,"dummy"
"282629",3,2,0,5,"dummy"
"282630",1,1,0,2,"dummy"
"282631",0,1,0,1,"dummy"
"282632",0,0,2,2,"dummy"
"282633",1,3,1,5,"dummy"
"282634",2,0,0,2,"dummy"
"282635",0,0,1,1,"dummy"
"282636",1,0,0,1,"dummy"
"282637",0,1,1,2,"dummy"
"282638",1,1,0,2,"dummy"
"282639",3,2,0,5,"dummy"
"282640",0,1,0,1,"dummy"
"282641",2,2,0,4,"dummy"
"282642",2,0,0,2,"dummy"
"282643",9,5,1,15,"dummy"
"282644",2,2,0,4,"dummy"
"282645",2,2,1,5,"dummy"
"282646",1,1,0,2,"dummy"
"282647",1,1,0,2,"dummy"
"282648",0,0,0,0,"dummy"
"282649",0,0,0,0,"dummy"
"282650",1,13,1,15,"dummy"
"282651",1,2,0,3,"dummy"
"282652",3,3,0,6,"dummy"
"282653",2,2,0,4,"dummy"
"282654",0,1,0,1,"dummy"
"282655",2,2,0,4,"dummy"
"282656",1,1,0,2,"dummy"
"282657",0,0,1,1,"dummy"
"282658",1,0,0,1,"dummy"
"282659",1,0,0,1,"dummy"
"282660",0,0,1,1,"dummy"
"282661",0,1,0,1,"dummy"
"282681",3,13,1,17,"dummy"
"282682",11,3,0,14,"dummy"
"282683",0,4,0,4,"dummy"
"282684",4,0,0,4,"dummy"
"282688",9,25,2,36,"dummy"
"282689",0,3,0,3,"dummy"
"282690",0,0,1,1,"dummy"
"282691",0,0,2,2,"dummy"
"282698",1,0,0,1,"dummy"
"282699",19,29,1,49,"dummy"
"282700",7,11,7,25,"dummy"
"282701",0,1,0,1,"dummy"
"282784",1,0,1,2,"dummy"
"282785",0,0,2,2,"dummy"
"282786",0,0,1,1,"dummy"
"282787",0,0,1,1,"dummy"
"282788",0,0,3,3,"dummy"
"282789",0,0,2,2,"dummy"
"282790",0,1,0,1,"dummy"
"282791",0,1,0,1,"dummy"
"282792",0,0,0,0,"dummy"
"282793",0,1,1,2,"dummy"
"282794",0,0,0,0,"dummy"
"282798",0,2,0,2,"dummy"
"282802",0,0,1,1,"dummy"
"282803",1,1,4,6,"dummy"
"282806",0,0,2,2,"dummy"
"282807",1,0,2,3,"dummy"
"282808",0,2,1,3,"dummy"
"282809",0,0,1,1,"dummy"
"282810",2,1,0,3,"dummy"
"282813",1,3,0,4,"dummy"
"282814",3,2,1,6,"dummy"
"282815",1,1,0,2,"dummy"
"282816",0,2,0,2,"dummy"
"282817",1,8,0,9,"dummy"
"282818",2,1,0,3,"dummy"
"282819",1,2,1,4,"dummy"
"282820",0,0,1,1,"dummy"
"282826",0,1,0,1,"dummy"
"282827",0,0,0,0,"dummy"
"282828",0,0,0,0,"dummy"
"282829",0,1,1,2,"dummy"
"282841",0,0,2,2,"dummy"
"282844",0,0,2,2,"dummy"
"282845",0,0,1,1,"dummy"
"282846",1,1,0,2,"dummy"
"282847",0,1,1,2,"dummy"
"282848",1,0,1,2,"dummy"
"282849",1,1,0,2,"dummy"
"282850",0,0,1,1,"dummy"
"282851",0,0,0,0,"dummy"
"282852",0,1,0,1,"dummy"
"282853",0,0,0,0,"dummy"
"282854",1,1,0,2,"dummy"
"282855",1,1,0,2,"dummy"
"282856",0,0,0,0,"dummy"
"282857",0,1,0,1,"dummy"
"282858",0,0,0,0,"dummy"
"282859",3,0,0,3,"dummy"
"282860",0,2,0,2,"dummy"
"282861",0,1,0,1,"dummy"
"282862",0,1,1,2,"dummy"
"282978",0,0,1,1,"dummy"
"282979",0,0,1,1,"dummy"
"282980",0,0,2,2,"dummy"
"282981",26,3,7,36,"dummy"
"282989",0,1,1,2,"dummy"
"282796",0,0,3,3,"dummy"
"282800",2,1,0,3,"dummy"
"282822",0,1,0,1,"dummy"
"282823",1,9,0,10,"dummy"
"282824",0,5,0,5,"dummy"
"282831",0,0,1,1,"dummy"
"282832",0,0,1,1,"dummy"
"282833",0,0,1,1,"dummy"
"282834",0,0,1,1,"dummy"
"282835",0,0,0,0,"dummy"
"282987",0,1,0,1,"dummy"
"282997",0,1,0,1,"dummy"
"282998",0,2,0,2,"dummy"
"282999",7,2,0,9,"dummy"
"283002",2,0,1,3,"dummy"
"283003",0,0,0,0,"dummy"
"283004",0,0,0,0,"dummy"
"283016",0,0,2,2,"dummy"
"283017",0,0,1,1,"dummy"
"283018",0,0,1,1,"dummy"
"283019",0,4,0,4,"dummy"
"283020",0,0,1,1,"dummy"
"283021",2,1,0,3,"dummy"
"283022",0,0,1,1,"dummy"
"283023",0,2,1,3,"dummy"
"283024",3,5,1,9,"dummy"
"283025",1,0,0,1,"dummy"
"283026",0,0,1,1,"dummy"
"283027",0,2,0,2,"dummy"
"283028",0,0,1,1,"dummy"
"283035",1,2,0,3,"dummy"
"283036",0,1,0,1,"dummy"
"283037",0,1,1,2,"dummy"
"283043",0,1,0,1,"dummy"
"283044",0,1,0,1,"dummy"
"283045",5,2,0,7,"dummy"
"282994",1,10,0,11,"dummy"
"282995",1,10,0,11,"dummy"
"283006",0,0,1,1,"dummy"
"283007",0,1,0,1,"dummy"
"283008",2,3,2,7,"dummy"
"283009",0,2,1,3,"dummy"
"283010",0,0,0,0,"dummy"
"283011",0,0,1,1,"dummy"
"283012",0,2,0,2,"dummy"
"283013",0,1,0,1,"dummy"
"283014",7,2,2,11,"dummy"
"283030",0,2,0,2,"dummy"
"283031",0,1,0,1,"dummy"
"283039",6,1,0,7,"dummy"
"283047",1,0,0,1,"dummy"
"283048",0,0,0,0,"dummy"
"283049",0,6,0,6,"dummy"
"283050",0,2,0,2,"dummy"
"283051",0,3,1,4,"dummy"
"283052",0,0,1,1,"dummy"
"283053",0,0,1,1,"dummy"
"283054",0,1,0,1,"dummy"
"283055",0,0,1,1,"dummy"
"283056",0,2,1,3,"dummy"
"283057",0,0,2,2,"dummy"
"283058",0,0,1,1,"dummy"
"283059",0,0,2,2,"dummy"
"283060",0,0,1,1,"dummy"
"283063",0,0,1,1,"dummy"
"283068",1,2,0,3,"dummy"
"283069",2,21,0,23,"dummy"
"283070",1,2,0,3,"dummy"
"283071",0,1,0,1,"dummy"
"283072",0,1,1,2,"dummy"
"283073",11,11,1,23,"dummy"
"283074",0,1,0,1,"dummy"
"283075",1,3,0,4,"dummy"
"283076",0,0,1,1,"dummy"
"283077",0,0,1,1,"dummy"
"283078",0,0,3,3,"dummy"
"283079",0,0,1,1,"dummy"
"283080",7,0,0,7,"dummy"
"283086",0,0,1,1,"dummy"
"283087",2,0,1,3,"dummy"
"283088",0,0,1,1,"dummy"
"283092",0,8,0,8,"dummy"
"283093",0,1,0,1,"dummy"
"283097",13,2,1,16,"dummy"
"283098",0,1,0,1,"dummy"
"283099",0,2,1,3,"dummy"
"283102",7,0,0,7,"dummy"
"283103",0,0,1,1,"dummy"
"283110",0,0,1,1,"dummy"
"283111",0,4,0,4,"dummy"
"283112",1,0,1,2,"dummy"
"283113",2,2,3,7,"dummy"
"283114",0,0,1,1,"dummy"
"283115",15,11,1,27,"dummy"
"283116",0,1,0,1,"dummy"
"283117",0,7,0,7,"dummy"
"283118",0,0,0,0,"dummy"
"283119",0,0,0,0,"dummy"
"283120",0,1,3,4,"dummy"
"283121",0,1,0,1,"dummy"
"283122",0,1,0,1,"dummy"
"283123",0,0,1,1,"dummy"
"283124",0,0,1,1,"dummy"
"283126",0,2,4,6,"dummy"
"283127",0,0,1,1,"dummy"
"283133",2,6,6,14,"dummy"
"283135",0,1,0,1,"dummy"
"283136",9,7,0,16,"dummy"
"283137",0,1,0,1,"dummy"
"283139",3,4,2,9,"dummy"
"283143",0,1,0,1,"dummy"
"283146",0,0,2,2,"dummy"
"283147",1,0,0,1,"dummy"
"283148",1,0,0,1,"dummy"
"283155",0,1,0,1,"dummy"
"283173",0,5,0,5,"dummy"
"283174",1,0,0,1,"dummy"
"283179",1,0,0,1,"dummy"
"283180",0,0,2,2,"dummy"
"283181",0,0,1,1,"dummy"
"283182",0,0,0,0,"dummy"
"283183",0,1,0,1,"dummy"
"283184",1,0,0,1,"dummy"
"283189",0,3,0,3,"dummy"
"283190",4,10,0,14,"dummy"
"283191",0,4,0,4,"dummy"
"283192",0,1,0,1,"dummy"
"283193",12,5,0,17,"dummy"
"283194",0,3,1,4,"dummy"
"283195",12,22,1,35,"dummy"
"283196",1,0,0,1,"dummy"
"283197",1,0,0,1,"dummy"
"283198",1,3,0,4,"dummy"
"283199",0,4,0,4,"dummy"
"283200",0,1,0,1,"dummy"
"283202",1,0,0,1,"dummy"
"283204",6,0,1,7,"dummy"
"283206",0,0,1,1,"dummy"
"283207",0,0,1,1,"dummy"
"283209",2,13,0,15,"dummy"
"283210",0,1,0,1,"dummy"
"283211",0,0,2,2,"dummy"
"283231",0,1,0,1,"dummy"
"283232",0,2,0,2,"dummy"
"283233",0,1,0,1,"dummy"
"283236",2,5,2,9,"dummy"
"283243",0,0,1,1,"dummy"
"283244",0,0,1,1,"dummy"
"283245",2,3,3,8,"dummy"
"283246",0,0,1,1,"dummy"
"283247",0,0,1,1,"dummy"
"283248",1,1,0,2,"dummy"
"283251",0,6,0,6,"dummy"
"283252",6,0,0,6,"dummy"
"283253",0,0,0,0,"dummy"
"283254",0,3,0,3,"dummy"
"283255",0,0,0,0,"dummy"
"283256",0,1,0,1,"dummy"
"283257",2,0,1,3,"dummy"
"283258",0,1,0,1,"dummy"
"283259",1,1,1,3,"dummy"
"283260",0,0,0,0,"dummy"
"283261",5,15,1,21,"dummy"
"283262",0,0,1,1,"dummy"
"283263",0,0,0,0,"dummy"
"283264",2,2,0,4,"dummy"
"283265",0,2,0,2,"dummy"
"283266",0,0,2,2,"dummy"
"283268",0,0,3,3,"dummy"
"283269",0,4,1,5,"dummy"
"283270",0,1,0,1,"dummy"
"283271",0,0,1,1,"dummy"
"283272",2,1,0,3,"dummy"
"283273",0,1,0,1,"dummy"
"283274",0,1,0,1,"dummy"
"283275",0,2,1,3,"dummy"
"283276",3,5,4,12,"dummy"
"283277",0,0,1,1,"dummy"
"283278",0,0,1,1,"dummy"
"283279",0,0,1,1,"dummy"
"283280",4,0,1,5,"dummy"
"283281",0,0,1,1,"dummy"
"283282",0,1,0,1,"dummy"
"283283",0,0,1,1,"dummy"
"283284",1,1,3,5,"dummy"
"283285",0,0,1,1,"dummy"
"283286",0,0,1,1,"dummy"
"283287",0,0,1,1,"dummy"
"283288",0,0,1,1,"dummy"
"283289",0,0,1,1,"dummy"
"283292",1,19,0,20,"dummy"
"283293",19,1,0,20,"dummy"
"283294",0,1,0,1,"dummy"
"283295",0,2,0,2,"dummy"
"283296",0,4,0,4,"dummy"
"283300",0,3,0,3,"dummy"
"283303",1,1,0,2,"dummy"
"283304",0,0,1,1,"dummy"
"283305",0,0,1,1,"dummy"
"283306",1,2,0,3,"dummy"
"283307",2,1,0,3,"dummy"
"283308",1,2,0,3,"dummy"
"283309",2,1,0,3,"dummy"
"283310",1,2,0,3,"dummy"
"283311",2,1,0,3,"dummy"
"283312",0,0,1,1,"dummy"
"283313",2,2,2,6,"dummy"
"283314",0,0,1,1,"dummy"
"283315",0,0,1,1,"dummy"
"283316",0,2,1,3,"dummy"
"283317",0,1,0,1,"dummy"
"283318",4,1,0,5,"dummy"
"283319",0,0,1,1,"dummy"
"283320",0,4,2,6,"dummy"
"283321",0,0,1,1,"dummy"
"283322",0,1,1,2,"dummy"
"283323",0,0,1,1,"dummy"
"283324",0,0,2,2,"dummy"
"283325",0,0,1,1,"dummy"
"283326",0,0,1,1,"dummy"
"283327",0,0,1,1,"dummy"
"283328",7,2,2,11,"dummy"
"283329",0,0,1,1,"dummy"
"283374",0,1,0,1,"dummy"
"283375",0,0,0,0,"dummy"
"283380",0,1,0,1,"dummy"
"283381",5,1,1,7,"dummy"
"283382",1,5,1,7,"dummy"
"283383",5,1,1,7,"dummy"
"283384",2,1,0,3,"dummy"
"283385",1,2,0,3,"dummy"
"283386",0,0,1,1,"dummy"
"283387",2,1,1,4,"dummy"
"283390",0,0,2,2,"dummy"
"283392",0,1,0,1,"dummy"
"283393",0,0,1,1,"dummy"
"283394",4,1,0,5,"dummy"
"283397",0,0,1,1,"dummy"
"283399",0,0,0,0,"dummy"
"283401",0,4,2,6,"dummy"
"283402",0,3,1,4,"dummy"
"283403",0,0,3,3,"dummy"
"283404",0,0,0,0,"dummy"
"283405",0,0,0,0,"dummy"
"283406",0,0,0,0,"dummy"
"283407",0,0,0,0,"dummy"
"283408",0,0,0,0,"dummy"
"283425",0,3,1,4,"dummy"
"283435",0,0,0,0,"dummy"
"283436",0,1,0,1,"dummy"
"283437",0,0,0,0,"dummy"
"283439",0,0,1,1,"dummy"
"283442",0,0,1,1,"dummy"
"283443",0,0,4,4,"dummy"
"283444",0,2,2,4,"dummy"
"283445",0,3,0,3,"dummy"
"283451",0,21,0,21,"dummy"
"283452",0,0,1,1,"dummy"
"283455",0,1,0,1,"dummy"
"283456",1,0,0,1,"dummy"
"283457",0,1,0,1,"dummy"
"283458",0,0,3,3,"dummy"
"283460",0,0,1,1,"dummy"
"283461",2,2,0,4,"dummy"
"283462",4,0,1,5,"dummy"
"283464",1,0,0,1,"dummy"
"283465",0,0,1,1,"dummy"
"283466",0,2,0,2,"dummy"
"283467",0,1,0,1,"dummy"
"283468",0,2,0,2,"dummy"
"283469",0,1,0,1,"dummy"
"283473",0,1,1,2,"dummy"
"283478",1,1,0,2,"dummy"
"283479",0,1,0,1,"dummy"
"283480",0,1,0,1,"dummy"
"283481",0,0,1,1,"dummy"
"283482",0,1,0,1,"dummy"
"283483",0,0,1,1,"dummy"
"283484",3,6,0,9,"dummy"
"283485",2,0,0,2,"dummy"
"283486",1,2,1,4,"dummy"
"283490",2,0,3,5,"dummy"
"283493",0,3,0,3,"dummy"
"283494",1,3,0,4,"dummy"
"283495",0,0,1,1,"dummy"
"283496",2,0,2,4,"dummy"
"283497",1,0,1,2,"dummy"
"283498",5,8,1,14,"dummy"
"283499",2,2,0,4,"dummy"
"283501",0,5,0,5,"dummy"
"283502",20,12,4,36,"dummy"
"283503",2,0,0,2,"dummy"
"283504",0,1,0,1,"dummy"
"283505",0,1,0,1,"dummy"
"283506",2,3,0,5,"dummy"
"283507",0,3,0,3,"dummy"
"283508",1,6,2,9,"dummy"
"283509",1,1,0,2,"dummy"
"283511",0,13,0,13,"dummy"
"283512",0,0,1,1,"dummy"
"283513",0,0,1,1,"dummy"
"283514",0,0,1,1,"dummy"
"283515",0,1,0,1,"dummy"
"283516",0,0,3,3,"dummy"
"283517",0,1,0,1,"dummy"
"283518",1,0,0,1,"dummy"
"283519",2,0,0,2,"dummy"
"283521",2,3,0,5,"dummy"
"283522",0,0,0,0,"dummy"
"283523",0,0,0,0,"dummy"
"283524",0,0,1,1,"dummy"
"283525",0,0,1,1,"dummy"
"283526",0,0,1,1,"dummy"
"283527",0,0,0,0,"dummy"
"283528",0,0,1,1,"dummy"
"283529",0,0,0,0,"dummy"
"283531",7,13,3,23,"dummy"
"283532",1,7,3,11,"dummy"
"283533",7,1,3,11,"dummy"
"283534",1,7,1,9,"dummy"
"283535",2,2,4,8,"dummy"
"283536",2,2,4,8,"dummy"
"283537",0,0,1,1,"dummy"
"283539",0,2,0,2,"dummy"
"283548",0,2,0,2,"dummy"
"283549",1,3,1,5,"dummy"
"283550",0,0,0,0,"dummy"
"283551",0,0,0,0,"dummy"
"283552",0,0,1,1,"dummy"
"283553",0,0,1,1,"dummy"
"283554",0,0,1,1,"dummy"
"283555",0,0,1,1,"dummy"
"283556",0,0,1,1,"dummy"
"283557",7,5,2,14,"dummy"
"283558",0,0,1,1,"dummy"
"283559",0,2,0,2,"dummy"
"283560",4,2,0,6,"dummy"
"283561",0,0,1,1,"dummy"
"283562",0,0,1,1,"dummy"
"283563",0,0,1,1,"dummy"
"283564",0,0,1,1,"dummy"
"283565",0,0,1,1,"dummy"
"283568",6,12,4,22,"dummy"
"283569",12,6,4,22,"dummy"
"283570",5,9,1,15,"dummy"
"283571",1,1,1,3,"dummy"
"283572",0,1,0,1,"dummy"
"283573",0,2,0,2,"dummy"
"283578",2,0,0,2,"dummy"
"283582",0,2,0,2,"dummy"
"283587",0,1,0,1,"dummy"
"283589",0,1,0,1,"dummy"
"283590",0,7,1,8,"dummy"
"283591",6,4,0,10,"dummy"
"283592",0,0,1,1,"dummy"
"283593",0,0,1,1,"dummy"
"283594",3,9,0,12,"dummy"
"283595",0,0,1,1,"dummy"
"283597",3,2,2,7,"dummy"
"283598",0,0,3,3,"dummy"
"283600",0,2,0,2,"dummy"
"283606",8,1,2,11,"dummy"
"283607",3,4,4,11,"dummy"
"283608",8,8,8,24,"dummy"
"283609",0,1,1,2,"dummy"
"283615",20,13,5,38,"dummy"
"283616",0,1,0,1,"dummy"
"283617",7,11,4,22,"dummy"
"283618",13,17,5,35,"dummy"
"283619",27,13,4,44,"dummy"
"283624",1,5,0,6,"dummy"
"283625",0,4,1,5,"dummy"
"283626",0,0,3,3,"dummy"
"283627",0,0,1,1,"dummy"
"283628",25,21,4,50,"dummy"
"283629",0,0,0,0,"dummy"
"283633",0,1,0,1,"dummy"
"283634",0,1,0,1,"dummy"
"283636",0,1,0,1,"dummy"
"283638",0,0,1,1,"dummy"
"283639",0,0,1,1,"dummy"
"283651",0,0,1,1,"dummy"
"283652",1,0,0,1,"dummy"
"283653",1,2,0,3,"dummy"
"283654",2,9,1,12,"dummy"
"283655",2,6,0,8,"dummy"
"283656",0,0,1,1,"dummy"
"283657",0,0,1,1,"dummy"
"283658",9,0,0,9,"dummy"
"283671",0,0,1,1,"dummy"
"283672",0,1,0,1,"dummy"
"283673",0,3,5,8,"dummy"
"283674",5,6,5,16,"dummy"
"283675",0,0,5,5,"dummy"
"283676",1,0,0,1,"dummy"
"283677",0,1,0,1,"dummy"
"283679",0,0,1,1,"dummy"
"283681",0,1,0,1,"dummy"
"283682",5,4,0,9,"dummy"
"283683",0,1,0,1,"dummy"
"283684",12,24,5,41,"dummy"
"283688",0,0,1,1,"dummy"
"283689",0,1,0,1,"dummy"
"283692",2,0,0,2,"dummy"
"283695",0,0,2,2,"dummy"
"283699",5,3,2,10,"dummy"
"283700",0,0,1,1,"dummy"
"283702",2,0,2,4,"dummy"
"283703",1,2,3,6,"dummy"
"283704",0,0,1,1,"dummy"
"283705",1,0,1,2,"dummy"
"283706",0,0,0,0,"dummy"
"283709",0,21,0,21,"dummy"
"283710",6,4,0,10,"dummy"
"283711",2,16,0,18,"dummy"
"283712",0,0,0,0,"dummy"
"283724",0,0,0,0,"dummy"
"283725",0,0,1,1,"dummy"
"283726",0,0,1,1,"dummy"
"283729",1,0,0,1,"dummy"
"283730",0,2,0,2,"dummy"
"283732",1,2,0,3,"dummy"
"283808",0,0,1,1,"dummy"
"283825",10,19,2,31,"dummy"
"283827",0,0,2,2,"dummy"
"283828",0,0,1,1,"dummy"
"283835",0,2,0,2,"dummy"
"283836",0,0,1,1,"dummy"
"283837",0,0,0,0,"dummy"
"283838",0,2,0,2,"dummy"
"283839",1,0,0,1,"dummy"
"283840",4,19,3,26,"dummy"
"283842",0,0,1,1,"dummy"
"283843",0,0,3,3,"dummy"
"283846",0,3,0,3,"dummy"
"283848",12,2,0,14,"dummy"
"283849",0,0,1,1,"dummy"
"283850",4,1,2,7,"dummy"
"283851",4,10,3,17,"dummy"
"283852",0,3,2,5,"dummy"
"283853",3,1,2,6,"dummy"
"283854",0,3,2,5,"dummy"
"283855",5,2,3,10,"dummy"
"283856",0,0,1,1,"dummy"
"283857",5,4,3,12,"dummy"
"283858",4,5,3,12,"dummy"
"283859",1,1,1,3,"dummy"
"283860",1,2,1,4,"dummy"
"283863",7,1,1,9,"dummy"
"283864",0,0,1,1,"dummy"
"283865",0,2,0,2,"dummy"
"283866",0,1,0,1,"dummy"
"283867",0,0,1,1,"dummy"
"283868",12,0,1,13,"dummy"
"283869",0,1,1,2,"dummy"
"283870",0,0,1,1,"dummy"
"283871",0,0,2,2,"dummy"
"283872",0,0,1,1,"dummy"
"283873",4,1,0,5,"dummy"
"283874",0,0,2,2,"dummy"
"283893",0,0,2,2,"dummy"
"283895",0,6,1,7,"dummy"
"283896",1,0,0,1,"dummy"
"283897",5,2,0,7,"dummy"
"283898",0,2,0,2,"dummy"
"283899",0,1,0,1,"dummy"
"283900",0,1,0,1,"dummy"
"283901",0,1,0,1,"dummy"
"283902",0,1,0,1,"dummy"
"283903",1,5,0,6,"dummy"
"283904",0,1,0,1,"dummy"
"283905",0,0,1,1,"dummy"
"283906",0,1,0,1,"dummy"
"283908",1,2,0,3,"dummy"
"283909",0,2,0,2,"dummy"
"283911",1,6,0,7,"dummy"
"283912",2,7,1,10,"dummy"
"283913",5,0,1,6,"dummy"
"283914",0,1,0,1,"dummy"
"283915",0,0,0,0,"dummy"
"283916",2,2,0,4,"dummy"
"283917",7,3,4,14,"dummy"
"283918",0,1,0,1,"dummy"
"283919",0,0,0,0,"dummy"
"283920",0,0,0,0,"dummy"
"283921",4,8,1,13,"dummy"
"283922",1,1,1,3,"dummy"
"283923",0,1,0,1,"dummy"
"283927",16,4,2,22,"dummy"
"283928",0,1,0,1,"dummy"
"283930",24,14,5,43,"dummy"
"283931",4,1,2,7,"dummy"
"283951",0,1,0,1,"dummy"
"283952",0,2,0,2,"dummy"
"283955",2,8,1,11,"dummy"
"283957",0,2,1,3,"dummy"
"283958",0,0,1,1,"dummy"
"283959",0,1,0,1,"dummy"
"283960",2,2,1,5,"dummy"
"283961",1,0,1,2,"dummy"
"283962",5,3,3,11,"dummy"
"283963",2,2,1,5,"dummy"
"283964",0,0,1,1,"dummy"
"283965",4,0,1,5,"dummy"
"283966",2,1,2,5,"dummy"
"283967",2,1,1,4,"dummy"
"283968",0,0,3,3,"dummy"
"283969",0,0,1,1,"dummy"
"283970",0,3,2,5,"dummy"
"283971",2,2,8,12,"dummy"
"283972",4,2,3,9,"dummy"
"283973",0,0,1,1,"dummy"
"283974",0,0,1,1,"dummy"
"283975",0,0,1,1,"dummy"
"283976",0,0,2,2,"dummy"
"283979",0,0,1,1,"dummy"
"283981",0,0,2,2,"dummy"
"283982",0,0,1,1,"dummy"
"283984",3,9,0,12,"dummy"
"283985",0,0,1,1,"dummy"
"283986",0,0,1,1,"dummy"
"283987",0,0,3,3,"dummy"
"283988",0,0,1,1,"dummy"
"283989",1,1,4,6,"dummy"
"283990",0,0,5,5,"dummy"
"283991",0,0,1,1,"dummy"
"283992",0,0,1,1,"dummy"
"283994",2,7,1,10,"dummy"
"283995",3,1,0,4,"dummy"
"283996",2,0,0,2,"dummy"
"283997",0,2,0,2,"dummy"
"283999",12,7,2,21,"dummy"
"284000",6,4,0,10,"dummy"
"284001",0,0,1,1,"dummy"
"284002",0,0,1,1,"dummy"
"284003",3,7,0,10,"dummy"
"284004",0,0,1,1,"dummy"
"284018",0,1,0,1,"dummy"
"284023",1,0,0,1,"dummy"
"284025",2,9,0,11,"dummy"
"284026",0,0,1,1,"dummy"
"284032",0,0,1,1,"dummy"
"284033",0,0,1,1,"dummy"
"284034",0,0,1,1,"dummy"
"284037",0,0,0,0,"dummy"
"284043",0,3,0,3,"dummy"
"284044",0,1,0,1,"dummy"
"284045",0,3,0,3,"dummy"
"284046",0,28,0,28,"dummy"
"284047",0,0,0,0,"dummy"
"284048",0,1,0,1,"dummy"
"284049",8,0,0,8,"dummy"
"284050",1,1,0,2,"dummy"
"284051",2,3,0,5,"dummy"
"284052",0,1,0,1,"dummy"
"284053",1,0,0,1,"dummy"
"284054",0,0,0,0,"dummy"
"284055",3,0,2,5,"dummy"
"284056",0,0,1,1,"dummy"
"284057",0,0,1,1,"dummy"
"284058",0,0,1,1,"dummy"
"284060",3,1,4,8,"dummy"
"284062",0,0,0,0,"dummy"
"284063",2,3,1,6,"dummy"
"284064",0,5,0,5,"dummy"
"284065",5,0,0,5,"dummy"
"284066",0,2,0,2,"dummy"
"284067",0,2,0,2,"dummy"
"284068",0,0,1,1,"dummy"
"284069",5,5,0,10,"dummy"
"284070",2,4,2,8,"dummy"
"284074",2,2,0,4,"dummy"
"284075",2,1,0,3,"dummy"
"284076",0,2,0,2,"dummy"
"284078",5,3,2,10,"dummy"
"284079",2,2,1,5,"dummy"
"284080",0,1,0,1,"dummy"
"284081",1,0,0,1,"dummy"
"284082",2,2,0,4,"dummy"
"284083",2,10,0,12,"dummy"
"284084",2,2,0,4,"dummy"
"284085",0,1,0,1,"dummy"
"284088",0,1,0,1,"dummy"
"284093",2,3,1,6,"dummy"
"284094",0,1,0,1,"dummy"
"284095",1,0,0,1,"dummy"
"284096",1,0,0,1,"dummy"
"284099",0,0,1,1,"dummy"
"284102",0,1,1,2,"dummy"
"284103",0,0,1,1,"dummy"
"284104",0,0,1,1,"dummy"
"284105",0,0,1,1,"dummy"
"284109",0,3,1,4,"dummy"
"284123",2,0,1,3,"dummy"
"284124",0,6,1,7,"dummy"
"284125",1,0,0,1,"dummy"
"284126",3,2,0,5,"dummy"
"284154",2,4,1,7,"dummy"
"284155",0,1,0,1,"dummy"
"284156",0,1,0,1,"dummy"
"284157",0,2,0,2,"dummy"
"284162",0,1,0,1,"dummy"
"284173",0,0,1,1,"dummy"
"284174",0,8,0,8,"dummy"
"284175",0,0,2,2,"dummy"
"284176",0,0,1,1,"dummy"
"284177",1,0,1,2,"dummy"
"284178",2,2,1,5,"dummy"
"284179",0,0,1,1,"dummy"
"284180",0,0,0,0,"dummy"
"284181",8,24,5,37,"dummy"
"284189",0,1,0,1,"dummy"
"284190",0,1,0,1,"dummy"
"284191",5,1,1,7,"dummy"
"284197",0,0,2,2,"dummy"
"284198",1,0,0,1,"dummy"
"284201",0,0,1,1,"dummy"
"284202",0,0,0,0,"dummy"
"284203",3,8,4,15,"dummy"
"284204",0,0,2,2,"dummy"
"284205",7,7,5,19,"dummy"
"284209",2,0,0,2,"dummy"
"284210",0,2,0,2,"dummy"
"284217",2,3,2,7,"dummy"
"284218",0,0,0,0,"dummy"
"284233",0,1,0,1,"dummy"
"284269",0,0,2,2,"dummy"
"284270",0,0,2,2,"dummy"
"284271",0,1,1,2,"dummy"
"284272",0,0,1,1,"dummy"
"284273",0,3,0,3,"dummy"
"284274",0,0,1,1,"dummy"
"284275",0,0,1,1,"dummy"
"284276",0,0,1,1,"dummy"
"284286",0,2,0,2,"dummy"
"284287",1,2,1,4,"dummy"
"284288",2,11,2,15,"dummy"
"284289",3,0,0,3,"dummy"
"284298",0,0,1,1,"dummy"
"284299",0,1,0,1,"dummy"
"284300",0,0,0,0,"dummy"
"284107",0,0,1,1,"dummy"
"284111",2,0,2,4,"dummy"
"284112",0,1,0,1,"dummy"
"284117",0,1,0,1,"dummy"
"284130",0,2,0,2,"dummy"
"284159",0,2,0,2,"dummy"
"284160",0,0,0,0,"dummy"
"284166",3,1,1,5,"dummy"
"284167",0,1,0,1,"dummy"
"284168",0,4,0,4,"dummy"
"284169",0,2,0,2,"dummy"
"284183",0,0,2,2,"dummy"
"284184",0,1,0,1,"dummy"
"284185",0,1,0,1,"dummy"
"284186",1,1,1,3,"dummy"
"284187",6,2,4,12,"dummy"
"284193",0,0,1,1,"dummy"
"284207",0,0,1,1,"dummy"
"284212",0,0,4,4,"dummy"
"284213",1,9,4,14,"dummy"
"284214",5,7,4,16,"dummy"
"284215",0,5,0,5,"dummy"
"284224",0,0,6,6,"dummy"
"284225",0,0,1,1,"dummy"
"284226",0,1,0,1,"dummy"
"284231",0,1,0,1,"dummy"
"284258",0,1,0,1,"dummy"
"284259",0,5,0,5,"dummy"
"284260",6,6,0,12,"dummy"
"284261",0,0,5,5,"dummy"
"284262",0,0,0,0,"dummy"
"284263",0,0,4,4,"dummy"
"284264",1,0,0,1,"dummy"
"284265",0,1,0,1,"dummy"
"284266",0,3,0,3,"dummy"
"284267",0,1,0,1,"dummy"
"284293",0,0,1,1,"dummy"
"284294",0,7,4,11,"dummy"
"284295",2,3,0,5,"dummy"
"284296",1,2,0,3,"dummy"
"284302",0,0,2,2,"dummy"
"284303",0,0,2,2,"dummy"
"284341",0,0,1,1,"dummy"
"284317",1,1,0,2,"dummy"
"284325",0,1,0,1,"dummy"
"284326",1,0,0,1,"dummy"
"284328",0,2,0,2,"dummy"
"284329",0,1,0,1,"dummy"
"284330",0,0,0,0,"dummy"
"284331",0,2,0,2,"dummy"
"284333",0,1,0,1,"dummy"
"284334",1,0,0,1,"dummy"
"284337",0,2,0,2,"dummy"
"284338",2,0,0,2,"dummy"
"284340",0,0,1,1,"dummy"
"284342",1,0,0,1,"dummy"
"284343",1,0,0,1,"dummy"
"284346",0,0,1,1,"dummy"
"284347",0,4,5,9,"dummy"
"284349",0,0,1,1,"dummy"
"284350",0,0,1,1,"dummy"
"284351",1,1,0,2,"dummy"
"284352",0,3,0,3,"dummy"
"284353",4,6,0,10,"dummy"
"284354",0,0,0,0,"dummy"
"284355",0,0,2,2,"dummy"
"284356",14,0,2,16,"dummy"
"284376",1,1,0,2,"dummy"
"284379",0,2,1,3,"dummy"
"284380",1,3,0,4,"dummy"
"284381",1,1,0,2,"dummy"
"284382",12,10,3,25,"dummy"
"284383",0,0,1,1,"dummy"
"284384",0,0,1,1,"dummy"
"284385",0,1,2,3,"dummy"
"284388",0,3,2,5,"dummy"
"284389",0,0,1,1,"dummy"
"284390",0,0,0,0,"dummy"
"284391",0,0,1,1,"dummy"
"284392",0,2,0,2,"dummy"
"284393",3,1,3,7,"dummy"
"284402",7,2,4,13,"dummy"
"284403",2,1,0,3,"dummy"
"284404",0,0,2,2,"dummy"
"284405",2,3,0,5,"dummy"
"284406",2,22,0,24,"dummy"
"284407",22,3,0,25,"dummy"
"284408",5,0,2,7,"dummy"
"284409",0,0,2,2,"dummy"
"284410",0,0,0,0,"dummy"
"284411",0,0,2,2,"dummy"
"284412",0,1,0,1,"dummy"
"284413",0,2,2,4,"dummy"
"284414",2,4,0,6,"dummy"
"284415",1,0,0,1,"dummy"
"284416",9,8,5,22,"dummy"
"284417",4,0,1,5,"dummy"
"284418",0,3,0,3,"dummy"
"284419",0,1,1,2,"dummy"
"284420",0,0,1,1,"dummy"
"284424",0,0,1,1,"dummy"
"284425",2,2,1,5,"dummy"
"284426",0,1,0,1,"dummy"
"284427",2,7,0,9,"dummy"
"284428",1,1,0,2,"dummy"
"284429",1,2,0,3,"dummy"
"284430",0,0,1,1,"dummy"
"284431",7,3,0,10,"dummy"
"284432",0,0,1,1,"dummy"
"284433",0,0,1,1,"dummy"
"284434",0,0,1,1,"dummy"
"284435",4,8,1,13,"dummy"
"284436",0,0,1,1,"dummy"
"284437",0,6,1,7,"dummy"
"284438",0,1,0,1,"dummy"
"284439",0,0,1,1,"dummy"
"284442",0,0,0,0,"dummy"
"284444",0,0,0,0,"dummy"
"284446",0,1,0,1,"dummy"
"284447",0,1,0,1,"dummy"
"284448",1,5,1,7,"dummy"
"284449",13,0,2,15,"dummy"
"284454",2,0,0,2,"dummy"
"284455",0,2,0,2,"dummy"
"284456",0,0,1,1,"dummy"
"284458",4,0,0,4,"dummy"
"284462",1,1,0,2,"dummy"
"284464",1,2,0,3,"dummy"
"284465",0,0,0,0,"dummy"
"284466",0,1,0,1,"dummy"
"284467",0,1,0,1,"dummy"
"284468",11,4,3,18,"dummy"
"284471",0,0,1,1,"dummy"
"284472",0,0,1,1,"dummy"
"284473",1,0,0,1,"dummy"
"284474",0,0,3,3,"dummy"
"284479",2,6,0,8,"dummy"
"284480",1,0,0,1,"dummy"
"284481",0,4,0,4,"dummy"
"284482",3,4,0,7,"dummy"
"284483",1,0,6,7,"dummy"
"284484",0,1,0,1,"dummy"
"284485",0,4,0,4,"dummy"
"284487",0,0,2,2,"dummy"
"284488",9,6,5,20,"dummy"
"284489",0,1,1,2,"dummy"
"284490",1,0,2,3,"dummy"
"284491",0,0,1,1,"dummy"
"284492",0,0,3,3,"dummy"
"284493",2,1,2,5,"dummy"
"284494",1,2,2,5,"dummy"
"284495",0,0,1,1,"dummy"
"284496",0,0,1,1,"dummy"
"284499",1,0,1,2,"dummy"
"284500",7,6,2,15,"dummy"
"284504",0,9,4,13,"dummy"
"284505",0,1,0,1,"dummy"
"284533",16,0,0,16,"dummy"
"284534",5,5,6,16,"dummy"
"284536",1,0,0,1,"dummy"
"284539",0,1,0,1,"dummy"
"284544",0,0,1,1,"dummy"
"284547",23,49,2,74,"dummy"
"284550",5,1,0,6,"dummy"
"284551",1,21,6,28,"dummy"
"284552",0,1,1,2,"dummy"
"284553",21,1,0,22,"dummy"
"284564",0,4,1,5,"dummy"
"284566",0,2,1,3,"dummy"
"284567",0,1,0,1,"dummy"
"284568",1,0,0,1,"dummy"
"284569",2,0,1,3,"dummy"
"284570",0,0,1,1,"dummy"
"284571",0,19,1,20,"dummy"
"284572",0,0,1,1,"dummy"
"284573",0,1,0,1,"dummy"
"284574",0,0,0,0,"dummy"
"284575",0,0,1,1,"dummy"
"284576",0,1,0,1,"dummy"
"284577",0,9,1,10,"dummy"
"284578",0,1,1,2,"dummy"
"284579",22,0,0,22,"dummy"
"284580",0,2,0,2,"dummy"
"284581",0,1,0,1,"dummy"
"284583",6,12,1,19,"dummy"
"284585",6,1,3,10,"dummy"
"284586",0,2,0,2,"dummy"
"284587",1,2,0,3,"dummy"
"284588",0,0,1,1,"dummy"
"284599",1,2,1,4,"dummy"
"284601",0,0,2,2,"dummy"
"284602",0,0,2,2,"dummy"
"284603",0,0,2,2,"dummy"
"284604",0,0,3,3,"dummy"
"284606",0,0,1,1,"dummy"
"284607",0,0,1,1,"dummy"
"284608",0,0,1,1,"dummy"
"284609",0,0,1,1,"dummy"
"284611",0,1,1,2,"dummy"
"284615",1,0,0,1,"dummy"
"284616",0,3,0,3,"dummy"
"284617",0,3,0,3,"dummy"
"284618",0,0,1,1,"dummy"
"284619",0,0,1,1,"dummy"
"284621",0,4,0,4,"dummy"
"284622",0,2,0,2,"dummy"
"284623",0,1,0,1,"dummy"
"284624",0,2,0,2,"dummy"
"284625",0,2,0,2,"dummy"
"284626",1,1,0,2,"dummy"
"284627",8,5,1,14,"dummy"
"284628",8,2,0,10,"dummy"
"284629",3,0,2,5,"dummy"
"284630",0,1,0,1,"dummy"
"284631",0,1,0,1,"dummy"
"284632",0,1,0,1,"dummy"
"284633",0,1,0,1,"dummy"
"284635",0,1,0,1,"dummy"
"284636",0,1,0,1,"dummy"
"284637",0,0,3,3,"dummy"
"284638",0,0,1,1,"dummy"
"284639",2,3,2,7,"dummy"
"284640",0,0,1,1,"dummy"
"284641",1,5,1,7,"dummy"
"284642",1,0,1,2,"dummy"
"284644",0,3,0,3,"dummy"
"284645",0,0,0,0,"dummy"
"284646",0,0,1,1,"dummy"
"284649",0,3,0,3,"dummy"
"284650",0,11,0,11,"dummy"
"284651",0,1,0,1,"dummy"
"284653",0,3,3,6,"dummy"
"284655",2,0,0,2,"dummy"
"284656",0,0,0,0,"dummy"
"284658",1,0,0,1,"dummy"
"284659",0,0,1,1,"dummy"
"284660",0,1,0,1,"dummy"
"284663",0,1,0,1,"dummy"
"284665",0,0,1,1,"dummy"
"284666",0,0,1,1,"dummy"
"284667",0,0,1,1,"dummy"
"284668",0,0,1,1,"dummy"
"284669",0,0,1,1,"dummy"
"284670",0,0,1,1,"dummy"
"284671",0,0,0,0,"dummy"
"284672",0,0,1,1,"dummy"
"284673",0,0,1,1,"dummy"
"284674",0,0,1,1,"dummy"
"284675",0,0,1,1,"dummy"
"284676",0,0,1,1,"dummy"
"284677",0,0,1,1,"dummy"
"284678",0,0,1,1,"dummy"
"284679",0,0,1,1,"dummy"
"284680",0,0,1,1,"dummy"
"284681",0,0,1,1,"dummy"
"284682",0,0,1,1,"dummy"
"284683",0,0,1,1,"dummy"
"284684",0,0,1,1,"dummy"
"284685",0,0,1,1,"dummy"
"284688",0,0,2,2,"dummy"
"284690",0,0,1,1,"dummy"
"284708",0,1,0,1,"dummy"
"284712",7,4,0,11,"dummy"
"284713",2,3,0,5,"dummy"
"284714",12,14,0,26,"dummy"
"284715",4,4,1,9,"dummy"
"284716",10,3,0,13,"dummy"
"284717",0,0,1,1,"dummy"
"284718",0,3,0,3,"dummy"
"284719",0,3,2,5,"dummy"
"284720",0,0,1,1,"dummy"
"284721",2,2,0,4,"dummy"
"284722",3,4,0,7,"dummy"
"284723",2,1,0,3,"dummy"
"284767",0,0,0,0,"dummy"
"284768",0,0,1,1,"dummy"
"284769",0,0,1,1,"dummy"
"284802",0,0,0,0,"dummy"
"284803",0,0,1,1,"dummy"
"284804",0,0,1,1,"dummy"
"284808",0,3,2,5,"dummy"
"284811",0,0,1,1,"dummy"
"284812",0,2,0,2,"dummy"
"284813",1,0,2,3,"dummy"
"284814",0,0,1,1,"dummy"
"284815",0,0,1,1,"dummy"
"284819",1,6,4,11,"dummy"
"284821",0,2,0,2,"dummy"
"284822",3,0,0,3,"dummy"
"284823",3,14,0,17,"dummy"
"284824",0,4,0,4,"dummy"
"284826",2,4,0,6,"dummy"
"284827",0,2,0,2,"dummy"
"284828",0,2,0,2,"dummy"
"284829",10,2,0,12,"dummy"
"284830",0,2,0,2,"dummy"
"284831",0,0,0,0,"dummy"
"284832",0,0,3,3,"dummy"
"284833",0,5,0,5,"dummy"
"284847",0,2,0,2,"dummy"
"284849",2,2,3,7,"dummy"
"284850",4,5,3,12,"dummy"
"284861",4,0,2,6,"dummy"
"284862",1,3,0,4,"dummy"
"284863",0,14,0,14,"dummy"
"284864",16,0,0,16,"dummy"
"284865",0,14,0,14,"dummy"
"284866",8,9,1,18,"dummy"
"284867",4,3,1,8,"dummy"
"284868",0,0,0,0,"dummy"
"284869",0,0,0,0,"dummy"
"284870",6,10,5,21,"dummy"
"284871",0,0,0,0,"dummy"
"284872",3,1,2,6,"dummy"
"284873",0,6,0,6,"dummy"
"284874",7,12,2,21,"dummy"
"284875",15,4,2,21,"dummy"
"284876",4,6,1,11,"dummy"
"284877",2,16,1,19,"dummy"
"284878",4,6,6,16,"dummy"
"284879",0,5,1,6,"dummy"
"284880",0,0,1,1,"dummy"
"284881",0,1,3,4,"dummy"
"284882",1,0,0,1,"dummy"
"284883",0,0,1,1,"dummy"
"284884",0,2,0,2,"dummy"
"284885",0,0,0,0,"dummy"
"284886",7,2,1,10,"dummy"
"284887",1,7,1,9,"dummy"
"284888",0,0,1,1,"dummy"
"284889",7,2,1,10,"dummy"
"284890",0,0,2,2,"dummy"
"284891",9,6,8,23,"dummy"
"284892",4,8,2,14,"dummy"
"284893",4,8,1,13,"dummy"
"284898",0,2,0,2,"dummy"
"284899",0,2,0,2,"dummy"
"284900",0,1,1,2,"dummy"
"284901",3,1,0,4,"dummy"
"284902",0,0,2,2,"dummy"
"284903",4,4,2,10,"dummy"
"284904",0,4,1,5,"dummy"
"284905",0,6,0,6,"dummy"
"284906",0,1,0,1,"dummy"
"284907",0,1,0,1,"dummy"
"284908",0,3,1,4,"dummy"
"284909",0,6,0,6,"dummy"
"284910",2,0,1,3,"dummy"
"284911",0,6,0,6,"dummy"
"284912",5,0,0,5,"dummy"
"284913",2,2,0,4,"dummy"
"284914",0,1,0,1,"dummy"
"284915",1,2,0,3,"dummy"
"284916",0,3,1,4,"dummy"
"284917",3,0,0,3,"dummy"
"284918",0,17,0,17,"dummy"
"284919",0,1,0,1,"dummy"
"284920",0,4,0,4,"dummy"
"284921",23,0,5,28,"dummy"
"284922",5,4,1,10,"dummy"
"284923",1,5,0,6,"dummy"
"284924",9,3,4,16,"dummy"
"284925",2,7,4,13,"dummy"
"284926",2,2,1,5,"dummy"
"284927",0,1,1,2,"dummy"
"284928",0,6,0,6,"dummy"
"284929",2,0,2,4,"dummy"
"284930",0,0,1,1,"dummy"
"284933",0,1,0,1,"dummy"
"284934",0,0,1,1,"dummy"
"284935",1,1,0,2,"dummy"
"284936",4,0,1,5,"dummy"
"284937",2,6,3,11,"dummy"
"284938",0,0,1,1,"dummy"
"284939",0,0,1,1,"dummy"
"284940",8,7,2,17,"dummy"
"284942",0,1,0,1,"dummy"
"284945",0,1,0,1,"dummy"
"284946",0,0,1,1,"dummy"
"284947",1,2,0,3,"dummy"
"284952",0,1,0,1,"dummy"
"284953",0,0,0,0,"dummy"
"284965",0,0,0,0,"dummy"
"284972",0,0,1,1,"dummy"
"284977",1,4,3,8,"dummy"
"284978",0,1,0,1,"dummy"
"284979",0,4,0,4,"dummy"
"284980",0,0,1,1,"dummy"
"284981",0,1,0,1,"dummy"
"284982",0,1,0,1,"dummy"
"284983",0,1,0,1,"dummy"
"284984",2,0,2,4,"dummy"
"284986",1,0,1,2,"dummy"
"284987",0,2,0,2,"dummy"
"284988",0,0,0,0,"dummy"
"284989",0,1,0,1,"dummy"
"284990",0,0,2,2,"dummy"
"284991",0,4,0,4,"dummy"
"284992",2,12,0,14,"dummy"
"284993",0,0,1,1,"dummy"
"284994",1,0,0,1,"dummy"
"284995",0,0,2,2,"dummy"
"284998",0,0,1,1,"dummy"
"284999",0,0,1,1,"dummy"
"285000",1,4,2,7,"dummy"
"285001",0,7,0,7,"dummy"
"285002",1,3,1,5,"dummy"
"285003",13,1,1,15,"dummy"
"285004",1,7,0,8,"dummy"
"285005",0,1,0,1,"dummy"
"285006",1,3,0,4,"dummy"
"285007",2,0,1,3,"dummy"
"285008",1,0,3,4,"dummy"
"285014",0,1,0,1,"dummy"
"285020",0,0,1,1,"dummy"
"285022",0,3,0,3,"dummy"
"285023",0,0,1,1,"dummy"
"285024",21,4,1,26,"dummy"
"285025",0,9,0,9,"dummy"
"285026",5,2,2,9,"dummy"
"285027",0,1,0,1,"dummy"
"285028",0,1,0,1,"dummy"
"285029",0,0,0,0,"dummy"
"285030",0,1,0,1,"dummy"
"285031",0,0,1,1,"dummy"
"285032",1,2,1,4,"dummy"
"285033",0,0,1,1,"dummy"
"285034",2,2,0,4,"dummy"
"285035",4,16,0,20,"dummy"
"285036",0,0,0,0,"dummy"
"285037",2,1,0,3,"dummy"
"285038",0,0,1,1,"dummy"
"285039",3,0,0,3,"dummy"
"285040",0,0,0,0,"dummy"
"285041",0,0,0,0,"dummy"
"285042",0,0,1,1,"dummy"
"285043",1,2,0,3,"dummy"
"285044",0,4,0,4,"dummy"
"285045",3,2,0,5,"dummy"
"285052",0,0,0,0,"dummy"
"285053",0,0,1,1,"dummy"
"285054",0,2,0,2,"dummy"
"285055",0,0,2,2,"dummy"
"285056",0,0,1,1,"dummy"
"285083",0,0,0,0,"dummy"
"285084",0,0,0,0,"dummy"
"285058",1,2,0,3,"dummy"
"285059",0,1,0,1,"dummy"
"285060",0,3,0,3,"dummy"
"285061",0,4,0,4,"dummy"
"285064",0,5,0,5,"dummy"
"285065",0,0,4,4,"dummy"
"285066",0,1,0,1,"dummy"
"285067",0,2,0,2,"dummy"
"285068",0,0,1,1,"dummy"
"285069",2,0,0,2,"dummy"
"285070",0,1,0,1,"dummy"
"285071",0,3,0,3,"dummy"
"285072",0,0,1,1,"dummy"
"285073",0,4,0,4,"dummy"
"285074",0,1,0,1,"dummy"
"285075",0,0,0,0,"dummy"
